matchId,blueTeamControlWardsPlaced,blueTeamWardsPlaced,blueTeamTotalKills,blueTeamDragonKills,blueTeamHeraldKills,blueTeamTowersDestroyed,blueTeamInhibitorsDestroyed,blueTeamTurretPlatesDestroyed,blueTeamFirstBlood,blueTeamMinionsKilled,blueTeamJungleMinions,blueTeamTotalGold,blueTeamXp,blueTeamTotalDamageToChamps,redTeamControlWardsPlaced,redTeamWardsPlaced,redTeamTotalKills,redTeamDragonKills,redTeamHeraldKills,redTeamTowersDestroyed,redTeamInhibitorsDestroyed,redTeamTurretPlatesDestroyed,redTeamMinionsKilled,redTeamJungleMinions,redTeamTotalGold,redTeamXp,redTeamTotalDamageToChamps,blueWin,diffMinionsKilled,diffJungleMinions,diffTotalGold,diffTotalKills,diffXp,diffTotalDamageToChamps,diffDragonKills,diffHeraldKills,diffTowersDestroyed,diffInhibitorsDestroyed,diffTurretPlatesDestroyed
EUW1_6882489515',2,23,4,2,0,0,0,7,0,388,106,23923,29798,21842,6,34,16,0,0,2,0,1,400,94,29637,32613,27239,1,-12,12,-5714,-12,-2815,-5397,2,0,-2,0,6
EUW1_6882416210',2,46,12,1,0,1,0,10,0,348,98,27852,30530,35817,6,26,17,0,0,1,0,4,373,76,28970,30320,36585,0,-25,22,-1118,-5,210,-768,1,0,0,0,6
EUW1_6881092720',2,19,13,0,0,0,0,11,0,331,96,28126,29501,38039,3,241,18,1,0,2,0,3,340,84,30510,29464,42984,0,-9,12,-2384,-5,37,-4945,-1,0,-2,0,8
EUW1_6879405717',3,28,8,0,1,1,0,9,1,355,84,27333,30466,31338,0,23,10,1,0,0,0,5,378,87,25157,31069,28229,0,-23,-3,2176,-2,-603,3109,-1,1,1,0,4
EUW1_6879389461',3,30,11,1,1,1,0,7,0,370,100,27772,31066,26676,7,26,7,1,0,1,0,5,382,96,26052,29475,19245,1,-12,4,1720,4,1591,7431,0,1,0,0,2
EUW1_6879371828',2,24,3,0,0,0,0,16,0,369,80,24011,26872,22414,1,33,15,2,1,3,0,3,357,70,28368,30422,30967,0,12,10,-4357,-12,-3550,-8553,-2,-1,-3,0,13
EUW1_6878383684',3,22,15,2,0,1,0,10,0,331,96,27717,30575,31257,3,128,9,0,0,1,0,5,403,96,28584,29831,31563,1,-72,0,-867,6,744,-306,2,0,0,0,5
EUW1_6878298308',0,30,11,1,0,0,0,8,1,392,104,27834,31205,24044,0,23,5,0,0,0,0,2,359,100,24105,29335,24014,1,33,4,3729,6,1870,30,1,0,0,0,6
EUW1_6878182424',2,30,7,0,0,1,0,9,1,403,88,27339,30398,31853,2,23,11,1,0,0,0,4,397,88,26470,30053,25791,1,6,0,869,-4,345,6062,-1,0,1,0,5
EUW1_6878139143',2,34,15,0,1,0,0,9,0,314,96,28220,30249,31888,5,28,16,1,0,0,0,2,381,88,28806,31373,37085,0,-67,8,-586,-1,-1124,-5197,-1,1,0,0,7
EUW1_6878103014',4,28,15,0,0,1,0,5,1,339,94,29311,30297,43314,6,33,16,2,1,0,0,7,357,77,29016,31764,36013,1,-18,17,295,-1,-1467,7301,-2,-1,1,0,-2
EUW1_6878057215',5,29,6,0,0,0,0,8,0,314,95,23614,28459,22594,8,37,10,2,0,1,0,1,424,104,28919,31398,33019,0,-110,-9,-5305,-4,-2939,-10425,-2,0,-1,0,7
EUW1_6878033584',2,27,7,0,0,0,0,10,0,397,81,25028,29998,24117,4,32,14,2,0,1,0,0,392,102,29252,29621,24888,0,5,-21,-4224,-7,377,-771,-2,0,-1,0,10
EUW1_6878003846',4,53,15,2,0,0,0,10,0,388,104,30853,31942,32641,2,50,9,0,0,1,0,5,349,82,25976,26594,25047,1,39,22,4877,6,5348,7594,2,0,-1,0,5
EUW1_6877975035',7,33,9,1,1,1,0,7,1,395,125,28301,32824,21349,6,31,8,1,0,1,0,5,384,96,26185,29361,21848,1,11,29,2116,1,3463,-499,0,1,0,0,2
EUW1_6875344552',6,61,7,0,0,0,0,12,0,340,69,25720,26327,30631,4,66,26,2,0,2,0,4,370,95,33463,31967,42121,0,-30,-26,-7743,-19,-5640,-11490,-2,0,-2,0,8
EUW1_6875306770',3,26,8,0,0,0,0,12,1,388,81,26121,28171,26093,7,27,17,2,0,1,0,5,378,99,30069,31943,34386,0,10,-18,-3948,-9,-3772,-8293,-2,0,-1,0,7
EUW1_6875259973',1,42,21,1,0,0,0,6,1,315,73,29574,29142,44096,3,22,15,0,0,1,0,4,320,100,29312,29536,32448,0,-5,-27,262,6,-394,11648,1,0,-1,0,2
EUW1_6875217596',7,42,8,1,1,1,0,5,1,396,112,26832,31931,28387,8,34,4,1,0,0,0,2,351,92,22703,28019,18604,1,45,20,4129,4,3912,9783,0,1,1,0,3
EUW1_6875197822',8,35,11,0,0,1,0,9,1,365,92,27995,29827,28544,6,29,14,2,0,0,0,6,356,87,27464,29406,32283,0,9,5,531,-3,421,-3739,-2,0,1,0,3
EUW1_6879360874',1,22,11,0,0,1,0,14,0,360,98,28509,30266,28945,5,27,22,2,0,2,0,5,365,86,30744,32658,39159,0,-5,12,-2235,-11,-2392,-10214,-2,0,-1,0,9
EUW1_6869300631',3,268,6,2,0,1,0,11,1,372,97,24998,29079,22569,4,29,10,0,0,1,0,4,366,89,26747,30308,30912,0,6,8,-1749,-4,-1229,-8343,2,0,0,0,7
EUW1_6869276441',2,18,9,0,0,0,0,8,0,373,103,26596,29128,29244,2,22,18,2,0,0,0,2,345,92,28966,30154,32658,0,28,11,-2370,-9,-1026,-3414,-2,0,0,0,6
EUW1_6869246594',4,29,13,0,0,1,0,10,0,383,90,30241,30863,33538,3,100,22,1,0,1,0,5,337,96,31071,30097,48610,0,46,-6,-830,-9,766,-15072,-1,0,0,0,5
EUW1_6829920333',2,22,25,0,0,1,0,8,1,395,100,33987,34071,46331,1,21,8,0,0,2,0,5,329,76,24540,28461,22942,1,66,24,9447,17,5610,23389,0,0,-1,0,3
EUW1_6882482484',1,21,16,2,0,2,0,8,1,385,81,30746,31305,39856,1,29,9,0,0,0,0,7,343,94,26009,28740,38566,1,42,-13,4737,7,2565,1290,2,0,2,0,1
EUW1_6882456043',3,29,18,2,1,2,0,7,1,391,83,29687,31892,29104,7,41,0,0,0,0,0,5,328,96,20460,26145,17407,1,63,-13,9227,18,5747,11697,2,1,2,0,2
EUW1_6882436994',9,32,19,0,0,0,0,8,1,359,80,29789,30957,36645,3,154,16,2,0,1,0,7,301,75,27379,29385,39105,1,58,5,2410,3,1572,-2460,-2,0,-1,0,1
EUW1_6882425551',1,28,22,1,1,0,0,8,1,332,108,30938,32232,43051,1,272,8,0,0,1,0,4,293,79,24170,25255,29871,1,39,29,6768,14,6977,13180,1,1,-1,0,4
EUW1_6880935420',3,27,12,0,0,3,0,6,1,413,98,30662,31213,34023,2,44,7,1,0,0,0,8,302,80,23702,26397,22266,1,111,18,6960,5,4816,11757,-1,0,3,0,-2
EUW1_6880909380',7,30,19,2,0,2,0,10,1,344,74,31101,29363,35754,5,43,11,0,0,1,0,5,340,82,27309,27810,28042,1,4,-8,3792,8,1553,7712,2,0,1,0,5
EUW1_6880890229',2,27,16,0,0,0,0,15,0,331,81,27437,28886,34026,5,30,11,2,0,3,0,2,341,97,29032,28818,31365,0,-10,-16,-1595,5,68,2661,-2,0,-3,0,13
EUW1_6879474161',4,31,6,0,0,0,0,13,0,344,79,23847,27298,25426,3,38,17,2,0,3,0,2,390,96,31306,30319,30775,0,-46,-17,-7459,-11,-3021,-5349,-2,0,-3,0,11
EUW1_6879450066',5,46,12,1,0,1,0,6,0,411,80,28053,30926,34027,4,27,5,1,0,0,0,2,345,87,23338,28548,28547,1,66,-7,4715,7,2378,5480,0,0,1,0,4
EUW1_6879424931',7,31,15,0,0,1,0,9,1,355,83,29346,28824,33708,4,67,13,2,0,0,0,6,363,85,27430,29290,32796,0,-8,-2,1916,2,-466,912,-2,0,1,0,3
EUW1_6879325614',4,37,12,1,0,0,0,13,0,348,90,27347,29964,37081,2,22,17,1,0,1,0,2,300,90,28539,30511,36305,0,48,0,-1192,-5,-547,776,0,0,-1,0,11
EUW1_6879310911',4,26,14,0,0,0,0,17,0,329,64,27083,27569,33027,2,34,27,1,0,3,0,1,361,85,35265,32112,46623,0,-32,-21,-8182,-13,-4543,-13596,-1,0,-3,0,16
EUW1_6878006751',4,26,14,0,0,1,0,12,0,306,84,27074,26000,28797,1,30,19,2,0,1,0,5,349,80,30509,29369,35569,0,-43,4,-3435,-5,-3369,-6772,-2,0,0,0,7
EUW1_6877969177',6,36,11,0,1,1,0,4,0,392,102,28874,29002,33397,5,26,11,2,0,0,0,6,349,98,26139,27984,24444,0,43,4,2735,0,1018,8953,-2,1,1,0,-2
EUW1_6877956644',2,24,10,1,0,1,0,10,1,367,120,28396,32017,31968,3,29,12,1,0,0,0,3,355,92,25854,31575,35226,1,12,28,2542,-2,442,-3258,0,0,1,0,7
EUW1_6877891153',2,24,10,1,0,1,0,8,0,332,84,25763,28626,25258,2,31,16,1,0,0,0,2,353,93,28343,31125,35053,0,-21,-9,-2580,-6,-2499,-9795,0,0,1,0,6
EUW1_6877879899',4,22,17,0,1,1,0,3,1,342,100,29527,28610,34602,1,26,16,1,0,1,0,4,304,76,28109,28481,31889,0,38,24,1418,1,129,2713,-1,1,0,0,-1
EUW1_6877867925',3,27,8,0,0,0,0,8,0,355,89,24049,29168,28111,6,35,20,2,0,2,0,0,391,98,31219,32491,37809,0,-36,-9,-7170,-12,-3323,-9698,-2,0,-2,0,8
EUW1_6877850091',2,139,22,0,0,0,0,11,1,349,95,30558,32138,37954,6,31,17,1,0,0,0,1,334,90,29064,30293,34778,1,15,5,1494,5,1845,3176,-1,0,0,0,10
EUW1_6879349198',5,29,16,2,1,0,0,17,0,282,87,27176,29756,36660,4,339,11,0,0,3,0,0,349,94,28460,28904,37620,0,-67,-7,-1284,5,852,-960,2,1,-3,0,17
EUW1_6872767863',5,25,9,2,0,0,0,9,1,361,81,25626,27579,34533,4,30,23,0,0,1,0,3,333,94,31185,31803,37413,0,28,-13,-5559,-14,-4224,-2880,2,0,-1,0,6
EUW1_6872712198',2,25,14,2,0,1,0,7,0,366,99,27864,31232,33145,1,91,12,0,0,0,0,4,321,62,26001,29789,36100,1,45,37,1863,2,1443,-2955,2,0,1,0,3
EUW1_6872638403',0,78,14,1,0,0,0,7,0,320,90,27617,29772,34928,5,28,16,0,0,0,0,2,359,74,27682,29944,33949,1,-39,16,-65,-2,-172,979,1,0,0,0,5
EUW1_6872613273',7,31,18,1,0,1,0,8,1,354,82,31940,31827,39475,3,26,11,0,0,0,0,6,345,114,27343,28639,28239,1,9,-32,4597,7,3188,11236,1,0,1,0,2
EUW1_6870154666',7,28,16,2,0,2,0,4,1,425,98,31944,34857,36283,3,21,8,0,0,1,0,11,328,102,23056,28357,17286,1,97,-4,8888,8,6500,18997,2,0,1,0,-7
EUW1_6869224469',0,28,14,0,0,1,0,12,1,393,73,30464,29607,34030,5,28,18,2,0,2,0,9,302,74,30630,28913,42849,1,91,-1,-166,-4,694,-8819,-2,0,-1,0,3
EUW1_6869187175',5,27,12,1,1,0,0,8,1,389,78,26737,30627,27915,1,49,10,1,0,0,0,2,384,106,26876,29744,29125,1,5,-28,-139,2,883,-1210,0,1,0,0,6
EUW1_6869159452',6,25,14,1,0,1,0,7,1,348,90,27655,28707,37093,0,59,3,1,0,0,0,6,332,66,22073,26423,25049,1,16,24,5582,11,2284,12044,0,0,1,0,1
EUW1_6867771512',1,28,12,2,0,1,0,2,1,346,87,27783,28145,27689,6,26,7,0,0,0,0,8,298,93,23582,26925,29605,1,48,-6,4201,5,1220,-1916,2,0,1,0,-6
EUW1_6867736241',5,31,18,1,0,0,0,7,1,359,92,30561,28250,37614,6,31,19,0,0,1,0,5,334,46,29558,27292,42885,1,25,46,1003,-1,958,-5271,1,0,-1,0,2
EUW1_6867728692',4,32,16,2,0,1,0,9,1,317,98,29175,29354,38685,3,24,8,0,0,0,0,8,346,82,25114,25451,29751,1,-29,16,4061,8,3903,8934,2,0,1,0,1
EUW1_6867706172',5,29,14,2,0,1,0,8,1,402,100,29460,31824,39774,5,32,10,0,1,1,0,6,311,84,26199,28528,25218,1,91,16,3261,4,3296,14556,2,-1,0,0,2
EUW1_6867692806',6,145,8,0,0,1,0,10,0,377,94,26499,28791,24753,7,28,9,2,0,1,0,6,379,101,26157,29110,27036,0,-2,-7,342,-1,-319,-2283,-2,0,0,0,4
EUW1_6867677699',4,28,24,1,0,1,0,9,1,345,76,33338,31437,39880,5,25,11,1,0,1,0,6,372,83,26812,30418,35138,1,-27,-7,6526,13,1019,4742,0,0,0,0,3
EUW1_6867663986',1,24,12,2,0,2,0,4,1,405,96,28678,31269,32626,2,25,5,0,0,0,0,7,299,96,22444,27514,25548,1,106,0,6234,7,3755,7078,2,0,2,0,-3
EUW1_6867658653',1,22,14,1,1,1,0,7,0,419,115,31349,34393,31047,3,22,7,1,0,1,0,4,357,94,23627,28779,26528,1,62,21,7722,7,5614,4519,0,1,0,0,3
EUW1_6866602810',4,32,16,2,0,1,0,5,0,405,119,30335,33535,25004,2,27,5,0,0,0,0,6,351,80,23384,28136,24560,1,54,39,6951,11,5399,444,2,0,1,0,-1
EUW1_6883322609',6,36,16,2,0,2,0,5,1,418,94,30604,32596,34017,2,39,4,0,0,0,0,7,347,81,22483,27193,20910,1,71,13,8121,12,5403,13107,2,0,2,0,-2
EUW1_6883246513',4,26,15,1,0,0,0,7,1,343,101,27906,29574,37902,2,28,10,1,0,1,0,5,310,79,25822,28918,28201,0,33,22,2084,5,656,9701,0,0,-1,0,2
EUW1_6883171691',2,22,17,0,1,2,0,9,0,342,88,31416,30196,36086,1,25,9,1,0,2,0,6,355,92,27830,27670,28491,1,-13,-4,3586,8,2526,7595,-1,1,0,0,3
EUW1_6882840815',3,26,15,0,0,1,0,11,0,385,81,29741,29018,35869,8,32,16,2,0,1,0,3,351,89,29374,29028,34226,0,34,-8,367,-1,-10,1643,-2,0,0,0,8
EUW1_6882786083',2,18,16,2,1,1,0,6,1,375,104,29762,32538,33015,3,46,7,0,0,1,0,3,384,88,25318,30709,25051,1,-9,16,4444,9,1829,7964,2,1,0,0,3
EUW1_6881799024',7,50,17,1,0,1,0,7,1,323,100,31603,32525,32609,5,26,8,0,0,1,0,6,340,72,24497,26104,27954,1,-17,28,7106,9,6421,4655,1,0,0,0,1
EUW1_6881697918',4,31,10,2,0,0,0,7,0,330,86,24931,28697,29936,5,22,12,0,0,0,0,2,343,73,26694,28708,27557,0,-13,13,-1763,-2,-11,2379,2,0,0,0,5
EUW1_6879962130',5,220,11,0,0,1,0,10,0,355,84,28238,30106,42473,1,20,16,2,0,1,0,5,363,85,28946,31468,32417,0,-8,-1,-708,-5,-1362,10056,-2,0,0,0,5
EUW1_6879899279',5,43,19,1,0,1,0,7,0,336,70,29540,29629,42962,2,28,15,0,0,0,0,6,325,74,27258,27584,33268,1,11,-4,2282,4,2045,9694,1,0,1,0,1
EUW1_6879616200',3,23,18,1,0,0,0,9,1,360,78,30083,30783,35613,8,26,9,0,0,2,0,3,343,75,24933,28126,27750,0,17,3,5150,9,2657,7863,1,0,-2,0,6
EUW1_6879474038',4,28,10,1,0,0,0,7,1,360,94,26233,30015,26304,2,25,14,1,0,0,0,1,387,84,27586,31379,37983,1,-27,10,-1353,-4,-1364,-11679,0,0,0,0,6
EUW1_6879440356',5,25,11,0,0,1,0,6,1,387,111,28025,32477,33124,2,34,6,1,0,0,0,6,346,76,24007,28966,23335,1,41,35,4018,5,3511,9789,-1,0,1,0,0
EUW1_6879427639',2,149,14,1,0,0,0,14,1,301,96,28739,27809,30611,7,40,18,1,0,1,0,8,343,82,30490,28248,36223,0,-42,14,-1751,-4,-439,-5612,0,0,-1,0,6
EUW1_6879399367',3,30,11,0,0,0,0,4,1,387,79,27383,29323,37709,5,26,14,1,0,0,0,6,314,74,26325,29945,28880,1,73,5,1058,-3,-622,8829,-1,0,0,0,-2
EUW1_6878860917',6,37,18,1,0,1,0,12,1,356,73,30081,31068,34350,2,20,7,1,0,3,0,7,383,91,27529,29101,30316,1,-27,-18,2552,11,1967,4034,0,0,-2,0,5
EUW1_6878800720',2,23,12,2,0,1,0,9,1,391,110,29659,32536,31568,0,20,10,0,0,0,0,5,370,90,26568,29411,26821,1,21,20,3091,2,3125,4747,2,0,1,0,4
EUW1_6878753644',2,20,14,0,1,0,0,8,0,338,81,27793,30573,31487,1,30,13,2,0,0,0,4,341,113,27452,29245,30663,1,-3,-32,341,1,1328,824,-2,1,0,0,4
EUW1_6878702910',2,24,8,2,0,0,0,8,0,349,95,25397,28712,27370,2,21,10,0,1,1,0,0,380,87,27198,31275,31902,0,-31,8,-1801,-2,-2563,-4532,2,-1,-1,0,8
EUW1_6878658793',4,39,9,1,0,0,0,9,0,320,105,25650,28052,26145,1,24,16,0,0,1,0,2,356,84,28314,30545,29003,0,-36,21,-2664,-7,-2493,-2858,1,0,-1,0,7
EUW1_6881065995',4,28,15,1,0,1,0,11,0,338,88,28522,30670,30220,5,23,11,0,0,1,0,8,390,88,28930,30390,34536,0,-52,0,-408,4,280,-4316,1,0,0,0,3
EUW1_6881016403',0,25,12,0,0,0,0,14,0,320,75,27316,27304,29014,4,29,19,2,0,3,0,3,356,96,32073,29540,33631,0,-36,-21,-4757,-7,-2236,-4617,-2,0,-3,0,11
EUW1_6880972212',3,41,15,0,0,1,0,11,0,385,80,30089,31246,33555,5,25,16,1,0,1,0,6,348,92,28283,30780,27613,1,37,-12,1806,-1,466,5942,-1,0,0,0,5
EUW1_6880905919',3,21,11,1,0,0,0,6,1,392,95,27039,30485,28629,7,33,8,0,0,1,0,0,391,80,25187,28590,25327,0,1,15,1852,3,1895,3302,1,0,-1,0,6
EUW1_6880887817',6,26,13,0,0,0,0,16,0,288,80,25462,24315,28391,6,29,19,2,0,3,0,1,335,88,32124,30600,38322,0,-47,-8,-6662,-6,-6285,-9931,-2,0,-3,0,15
EUW1_6880876517',2,22,16,0,0,1,0,10,1,320,93,29822,28329,43252,7,76,17,2,1,1,0,5,331,102,30493,28801,42525,0,-11,-9,-671,-1,-472,727,-2,-1,0,0,5
EUW1_6880857669',2,64,16,0,0,1,0,8,1,324,71,28823,29780,31919,2,62,4,2,0,1,0,5,382,113,25049,29202,27762,0,-58,-42,3774,12,578,4157,-2,0,0,0,3
EUW1_6879724981',4,32,16,1,0,0,0,13,1,363,104,29199,29438,31805,0,24,16,0,0,2,0,4,382,74,30628,30333,32670,1,-19,30,-1429,0,-895,-865,1,0,-2,0,9
EUW1_6879641249',2,56,9,1,0,0,0,8,0,381,68,26474,28920,25939,3,70,10,0,0,1,0,3,386,67,26720,29258,24849,0,-5,1,-246,-1,-338,1090,1,0,-1,0,5
EUW1_6879605389',3,32,19,1,0,0,0,15,0,331,78,30883,29339,37066,3,31,19,1,0,4,0,3,369,90,33574,29832,41016,0,-38,-12,-2691,0,-493,-3950,0,0,-4,0,12
EUW1_6879548140',4,33,6,0,0,0,0,9,0,398,87,25015,29196,21215,7,29,10,2,0,0,0,3,405,108,27455,31539,29113,0,-7,-21,-2440,-4,-2343,-7898,-2,0,0,0,6
EUW1_6879516026',7,37,18,1,0,2,0,7,1,336,83,31541,30003,36318,2,33,17,0,0,1,0,9,322,83,28105,27953,40786,1,14,0,3436,1,2050,-4468,1,0,1,0,-2
EUW1_6879477830',4,42,16,1,0,0,0,15,1,366,77,27962,28060,32946,4,27,16,0,0,1,0,1,379,83,30226,29232,32441,0,-13,-6,-2264,0,-1172,505,1,0,-1,0,14
EUW1_6879416454',4,26,7,0,0,0,0,10,1,369,94,24527,28897,22761,2,22,14,1,0,0,0,0,427,78,29210,32530,31309,0,-58,16,-4683,-7,-3633,-8548,-1,0,0,0,10
EUW1_6879395202',1,48,17,1,0,2,0,3,1,395,92,30724,31640,35107,4,33,7,0,0,0,0,11,337,81,23539,26465,25721,1,58,11,7185,10,5175,9386,1,0,2,0,-8
EUW1_6878727750',4,22,14,1,0,1,0,16,1,333,90,28970,28972,34610,3,28,17,1,0,2,0,5,331,97,30415,30674,38893,0,2,-7,-1445,-3,-1702,-4283,0,0,-1,0,11
EUW1_6878668033',3,29,10,0,0,1,0,10,1,364,114,27243,29557,30583,1,29,6,1,0,1,0,3,368,84,26254,29297,28251,1,-4,30,989,4,260,2332,-1,0,0,0,7
EUW1_6878594652',3,34,13,0,1,1,0,13,0,351,94,28701,31138,29472,4,27,19,2,0,1,0,3,382,93,30421,31086,35746,1,-31,1,-1720,-6,52,-6274,-2,1,0,0,10
EUW1_6883426016',6,131,16,2,0,1,0,18,0,348,90,29738,30344,43204,3,36,15,0,0,3,0,5,324,109,30173,29032,36531,1,24,-19,-435,1,1312,6673,2,0,-2,0,13
EUW1_6882923538',2,35,9,0,0,0,0,13,0,295,93,24770,24765,22111,2,28,15,2,0,4,0,1,393,93,31766,29997,30645,0,-98,0,-6996,-6,-5232,-8534,-2,0,-4,0,12
EUW1_6882415490',2,26,28,0,0,4,0,6,1,356,89,35856,31009,43704,1,40,5,0,0,1,0,9,312,48,21666,24770,21042,1,44,41,14190,23,6239,22662,0,0,3,0,-3
EUW1_6882392893',5,26,10,0,0,0,0,9,0,298,75,24936,27994,30518,3,71,17,2,0,2,0,3,382,85,30790,31950,33046,0,-84,-10,-5854,-7,-3956,-2528,-2,0,-2,0,6
EUW1_6881540057',2,30,15,0,0,1,0,12,1,355,72,30990,28496,36875,1,53,27,1,0,2,0,8,331,70,32143,29523,47029,0,24,2,-1153,-12,-1027,-10154,-1,0,-1,0,4
EUW1_6881474931',4,32,17,2,1,0,0,12,1,373,98,28812,31413,33243,2,23,6,0,0,1,0,2,366,106,25883,29599,24076,0,7,-8,2929,11,1814,9167,2,1,-1,0,10
EUW1_6881140491',6,25,10,0,0,0,0,11,1,360,73,25579,28429,29716,4,30,13,1,0,1,0,1,336,77,27011,29406,36277,0,24,-4,-1432,-3,-977,-6561,-1,0,-1,0,10
EUW1_6881049630',4,25,10,1,0,0,0,12,1,353,97,25945,28293,26426,3,23,17,1,0,2,0,3,364,94,31250,29319,36640,1,-11,3,-5305,-7,-1026,-10214,0,0,-2,0,9
EUW1_6881015899',6,29,20,0,0,2,0,8,1,351,95,32366,30873,36347,5,30,16,2,0,0,0,5,281,84,27767,28265,32962,1,70,11,4599,4,2608,3385,-2,0,2,0,3
EUW1_6880971360',3,58,15,0,1,1,0,3,0,397,84,29875,32018,27894,2,80,17,1,0,0,0,7,330,108,28318,29712,29103,1,67,-24,1557,-2,2306,-1209,-1,1,1,0,-4
EUW1_6880953683',4,28,14,0,0,2,0,10,1,397,82,29847,31712,34977,1,22,8,2,0,1,0,2,281,124,25458,29197,23189,1,116,-42,4389,6,2515,11788,-2,0,1,0,8
EUW1_6880919285',0,21,19,0,1,0,0,13,0,382,103,32307,33898,32517,0,25,5,1,0,3,0,7,364,108,23764,29005,24412,1,18,-5,8543,14,4893,8105,-1,1,-3,0,6
EUW1_6880708911',4,31,10,1,0,0,0,6,0,305,93,26084,28809,30556,1,20,12,0,0,1,0,3,364,70,26633,30084,31374,1,-59,23,-549,-2,-1275,-818,1,0,-1,0,3
EUW1_6880677044',3,34,8,0,0,0,0,13,0,320,83,25239,27427,18256,5,22,13,2,1,2,0,3,392,106,29158,32194,27962,0,-72,-23,-3919,-5,-4767,-9706,-2,-1,-2,0,10
EUW1_6880486949',3,30,9,0,0,1,0,13,0,360,86,27807,29637,35630,3,39,14,2,0,0,0,5,356,77,26856,28774,36924,1,4,9,951,-5,863,-1294,-2,0,1,0,8
EUW1_6880419347',3,26,11,0,0,0,0,7,1,357,85,26748,29593,30634,4,25,13,2,0,0,0,6,361,77,28045,29200,35500,0,-4,8,-1297,-2,393,-4866,-2,0,0,0,1
EUW1_6880357829',4,296,18,1,0,1,0,5,1,330,102,30332,29335,42236,2,24,11,1,0,0,0,3,336,77,25573,28227,33802,0,-6,25,4759,7,1108,8434,0,0,1,0,2
EUW1_6880291602',3,130,8,1,1,2,0,7,1,354,102,27142,27158,21067,2,27,5,1,0,1,0,9,373,146,25451,30933,15583,0,-19,-44,1691,3,-3775,5484,0,1,1,0,-2
EUW1_6879986819',5,43,12,1,0,1,0,9,0,376,112,27806,30680,31850,3,29,9,1,0,0,0,6,319,84,24333,26162,25025,1,57,28,3473,3,4518,6825,0,0,1,0,3
EUW1_6879774455',5,24,15,1,0,0,0,10,0,327,87,30034,29347,39010,6,31,19,1,0,2,0,5,316,88,29935,30029,36217,1,11,-1,99,-4,-682,2793,0,0,-2,0,5
EUW1_6879533217',4,132,8,1,0,0,0,16,0,331,85,25095,29201,26084,3,19,15,1,0,1,0,1,369,86,29702,30939,35179,0,-38,-1,-4607,-7,-1738,-9095,0,0,-1,0,15
EUW1_6879504011',7,28,13,0,1,1,0,8,0,372,91,28480,29160,26943,4,27,11,2,0,0,0,4,314,98,25647,26366,24090,0,58,-7,2833,2,2794,2853,-2,1,1,0,4
EUW1_6879473510',1,27,10,1,0,2,0,9,1,349,103,27923,29440,32017,4,31,10,0,0,0,0,6,309,84,24310,29092,26201,1,40,19,3613,0,348,5816,1,0,2,0,3
EUW1_6879429807',2,46,5,1,0,1,0,6,0,338,93,24950,27940,23259,1,23,12,1,0,1,0,6,353,76,26290,27083,30552,1,-15,17,-1340,-7,857,-7293,0,0,0,0,0
EUW1_6879415577',2,39,12,0,0,1,0,6,0,390,83,29959,30078,27214,5,24,8,1,0,1,0,3,379,76,25515,28898,19860,1,11,7,4444,4,1180,7354,-1,0,0,0,3
EUW1_6879369009',2,23,13,1,0,1,0,9,1,365,98,29322,31023,30611,1,24,14,1,0,1,0,7,336,97,28449,30575,28669,1,29,1,873,-1,448,1942,0,0,0,0,2
EUW1_6879362596',3,27,12,0,0,0,0,13,0,291,65,25970,26494,32316,7,29,23,2,0,2,0,1,367,90,32924,32434,44800,0,-76,-25,-6954,-11,-5940,-12484,-2,0,-2,0,12
EUW1_6879328443',2,25,13,0,0,1,0,8,1,343,84,27915,29099,36849,5,50,13,2,0,0,0,1,303,80,26328,27406,36512,0,40,4,1587,0,1693,337,-2,0,1,0,7
EUW1_6879320011',4,34,8,0,0,0,0,8,0,347,96,25557,29068,30025,4,49,14,2,0,1,0,1,382,82,28082,31410,28489,0,-35,14,-2525,-6,-2342,1536,-2,0,-1,0,7
EUW1_6878045943',2,27,13,1,0,1,0,15,1,343,73,28068,29030,35529,2,25,19,1,0,2,0,3,338,98,30612,32041,38761,0,5,-25,-2544,-6,-3011,-3232,0,0,-1,0,12
EUW1_6878001527',3,26,11,0,0,0,0,8,0,329,94,26491,29961,29885,6,100,6,2,1,1,0,4,362,80,24810,28461,28493,1,-33,14,1681,5,1500,1392,-2,-1,-1,0,4
EUW1_6877966845',4,25,12,1,0,0,0,9,1,295,79,26540,27194,34101,5,46,18,1,0,1,0,3,329,73,29646,26989,36588,1,-34,6,-3106,-6,205,-2487,0,0,-1,0,6
EUW1_6883451934',2,26,17,1,0,1,0,8,1,357,100,30436,31017,32381,4,20,12,0,0,0,0,3,359,84,26138,28867,30050,0,-2,16,4298,5,2150,2331,1,0,1,0,5
EUW1_6883396806',4,21,5,0,0,0,0,6,1,370,72,23557,29318,23462,3,22,5,2,0,0,0,3,401,99,24685,30302,22126,1,-31,-27,-1128,0,-984,1336,-2,0,0,0,3
EUW1_6880795048',4,27,6,0,0,0,0,10,1,320,72,23250,26234,26426,8,25,17,2,0,1,0,2,343,116,29496,31497,38374,0,-23,-44,-6246,-11,-5263,-11948,-2,0,-1,0,8
EUW1_6880775183',3,60,12,0,0,2,0,5,0,382,80,29082,30272,30833,3,29,9,2,0,0,0,8,331,86,24028,28550,29476,0,51,-6,5054,3,1722,1357,-2,0,2,0,-3
EUW1_6880761807',3,24,12,1,0,1,0,12,0,361,107,27853,31373,30551,3,26,14,1,0,1,0,3,354,100,29542,30571,37116,1,7,7,-1689,-2,802,-6565,0,0,0,0,9
EUW1_6879619336',6,26,7,0,0,0,0,8,0,325,84,24616,28065,22059,4,30,14,2,0,2,0,1,374,104,29769,30809,36177,0,-49,-20,-5153,-7,-2744,-14118,-2,0,-2,0,7
EUW1_6879561243',4,36,12,2,0,0,0,12,0,372,107,27141,32148,31015,4,26,13,0,0,1,0,0,380,88,28437,30639,28108,1,-8,19,-1296,-1,1509,2907,2,0,-1,0,12
EUW1_6879356460',5,27,19,2,0,0,0,13,1,298,88,28245,30421,41639,4,27,9,0,0,1,0,3,340,92,26731,28725,40287,1,-42,-4,1514,10,1696,1352,2,0,-1,0,10
EUW1_6879339844',4,62,24,1,0,1,0,8,0,356,88,32032,31081,44039,4,61,9,1,0,1,0,7,317,80,25333,27329,24780,1,39,8,6699,15,3752,19259,0,0,0,0,1
EUW1_6868199566',5,32,19,0,0,2,0,2,1,380,106,33427,32077,37975,2,134,7,2,0,1,0,9,337,98,24264,27556,29601,1,43,8,9163,12,4521,8374,-2,0,1,0,-7
EUW1_6868139201',4,30,22,1,0,1,0,8,0,364,108,34770,32826,39422,0,66,12,1,0,2,0,9,337,84,28235,28640,36295,1,27,24,6535,10,4186,3127,0,0,-1,0,-1
EUW1_6868082263',3,26,8,0,0,1,0,12,1,384,102,26559,30464,22348,5,27,10,2,1,1,0,1,365,90,26681,29858,26757,0,19,12,-122,-2,606,-4409,-2,-1,0,0,11
EUW1_6808036707',4,60,10,0,0,1,0,16,1,332,78,27305,28654,30573,5,78,16,1,0,3,0,7,338,74,30751,30077,40087,1,-6,4,-3446,-6,-1423,-9514,-1,0,-2,0,9
EUW1_6793327751',5,46,28,0,0,1,0,6,1,358,92,36963,33238,51369,5,39,9,1,0,4,0,6,291,76,25051,25922,33985,1,67,16,11912,19,7316,17384,-1,0,-3,0,0
EUW1_6793280673',5,30,15,2,1,0,0,9,1,340,98,27812,31000,37593,3,39,5,0,0,1,0,7,355,110,25868,28816,23097,1,-15,-12,1944,10,2184,14496,2,1,-1,0,2
EUW1_6782802885',4,49,7,0,0,0,0,5,1,392,86,26163,28957,24570,2,31,7,2,1,1,0,2,392,95,25704,29812,24955,1,0,-9,459,0,-855,-385,-2,-1,-1,0,3
EUW1_6883090969',6,27,14,0,0,0,0,9,0,372,98,28204,31120,28038,2,26,11,1,0,1,0,4,402,86,27353,30591,29095,1,-30,12,851,3,529,-1057,-1,0,-1,0,5
EUW1_6882971613',4,34,12,0,0,0,0,6,1,387,90,28860,30118,32855,11,104,15,2,0,2,0,2,397,105,29432,32367,32565,0,-10,-15,-572,-3,-2249,290,-2,0,-2,0,4
EUW1_6881336498',3,39,3,0,0,0,0,9,0,348,93,23773,27615,21662,5,220,10,2,0,1,0,0,405,83,26788,30121,36074,0,-57,10,-3015,-7,-2506,-14412,-2,0,-1,0,9
EUW1_6880977444',2,38,6,0,0,0,0,8,1,415,87,27755,30161,27390,3,29,7,2,0,1,0,6,361,99,25052,29988,22634,1,54,-12,2703,-1,173,4756,-2,0,-1,0,2
EUW1_6880831027',2,25,14,0,0,0,0,11,1,336,101,28568,30328,39262,4,39,13,1,0,1,0,2,323,97,27461,29300,34487,1,13,4,1107,1,1028,4775,-1,0,-1,0,9
EUW1_6880019896',3,25,14,1,0,0,0,10,1,353,82,28302,29838,28812,3,26,15,1,0,1,0,6,358,97,28705,29402,36191,0,-5,-15,-403,-1,436,-7379,0,0,-1,0,4
EUW1_6879984965',3,40,23,2,0,1,0,12,1,265,78,31409,28259,39713,2,22,12,0,1,1,0,7,330,82,27189,26988,35325,1,-65,-4,4220,11,1271,4388,2,-1,0,0,5
EUW1_6879392451',3,23,9,0,0,0,0,12,1,375,93,26164,30920,24079,2,22,14,2,0,1,0,1,390,94,28504,32374,28579,0,-15,-1,-2340,-5,-1454,-4500,-2,0,-1,0,11
EUW1_6878691339',5,82,10,0,0,1,0,13,0,382,71,26801,30011,28554,3,19,13,2,0,2,0,2,328,96,28651,30168,30555,0,54,-25,-1850,-3,-157,-2001,-2,0,-1,0,11
EUW1_6878618879',2,23,7,1,0,0,0,7,1,350,92,23924,28554,25177,8,141,2,0,1,0,0,3,410,84,23052,28948,22321,1,-60,8,872,5,-394,2856,1,-1,0,0,4
EUW1_6849046095',2,82,17,1,0,1,0,6,1,332,94,30294,31336,40200,2,56,10,0,0,0,0,4,354,88,26448,30015,29352,1,-22,6,3846,7,1321,10848,1,0,1,0,2
EUW1_6838707119',3,21,21,1,1,1,0,11,0,361,100,32463,31349,39682,2,29,6,1,0,1,0,6,336,58,24700,26142,32088,1,25,42,7763,15,5207,7594,0,1,0,0,5
EUW1_6838495999',6,25,10,1,0,0,0,11,0,379,72,26623,28573,29646,2,25,12,0,0,1,0,3,393,96,29080,32010,33746,0,-14,-24,-2457,-2,-3437,-4100,1,0,-1,0,8
EUW1_6838429031',2,59,2,0,0,0,0,10,0,396,92,22621,29733,17015,4,34,12,1,0,1,0,0,420,101,29686,32540,35078,0,-24,-9,-7065,-10,-2807,-18063,-1,0,-1,0,10
EUW1_6819232669',1,32,3,0,0,1,0,11,0,316,88,24261,24035,31503,5,51,21,1,1,2,0,5,337,60,30320,28704,34997,0,-21,28,-6059,-18,-4669,-3494,-1,-1,-1,0,6
EUW1_6816947440',6,88,16,0,0,1,0,9,1,318,74,28490,29740,35488,4,30,10,1,0,1,0,5,362,80,26914,29713,27669,0,-44,-6,1576,6,27,7819,-1,0,0,0,4
EUW1_6816888146',2,36,18,0,0,0,0,11,1,327,97,31002,29785,33325,2,79,11,1,0,2,0,3,394,93,27842,29044,29481,1,-67,4,3160,7,741,3844,-1,0,-2,0,8
EUW1_6813819315',11,53,11,1,0,0,0,10,1,398,92,28773,29642,35897,3,24,12,1,0,1,0,4,368,84,28349,28925,30704,0,30,8,424,-1,717,5193,0,0,-1,0,6
EUW1_6813780009',3,32,12,1,1,1,0,6,1,400,108,29442,33450,31304,4,30,3,1,0,0,0,2,368,86,23163,28769,20352,1,32,22,6279,9,4681,10952,0,1,1,0,4
EUW1_6883736386',3,24,11,1,0,0,0,17,0,364,81,27084,29950,30246,8,33,10,1,1,1,0,1,408,85,28367,28746,29654,0,-44,-4,-1283,1,1204,592,0,-1,-1,0,16
EUW1_6883726492',7,27,12,2,0,1,0,8,1,395,82,27489,30778,31371,4,31,11,0,0,2,0,1,412,101,28953,33322,33983,1,-17,-19,-1464,1,-2544,-2612,2,0,-1,0,7
EUW1_6882964887',5,33,7,1,0,0,0,8,0,370,106,26080,28896,31318,3,27,13,0,0,3,0,1,393,98,29926,31242,32445,0,-23,8,-3846,-6,-2346,-1127,1,0,-3,0,7
EUW1_6882485375',4,23,8,2,0,1,0,10,0,386,114,26684,31763,21555,9,37,9,0,0,2,0,2,359,106,28042,28612,22444,0,27,8,-1358,-1,3151,-889,2,0,-1,0,8
EUW1_6882461379',4,24,12,0,0,0,0,12,0,389,96,28853,30752,35635,4,28,16,2,1,1,0,2,362,85,29959,31701,24884,0,27,11,-1106,-4,-949,10751,-2,-1,-1,0,10
EUW1_6882367191',2,38,11,1,0,1,0,10,1,399,79,27020,31108,33341,1,25,7,1,0,1,0,3,371,120,26242,30491,28700,1,28,-41,778,4,617,4641,0,0,0,0,7
EUW1_6881208146',2,157,14,1,0,1,0,8,0,401,92,30472,30458,32761,5,25,9,1,0,0,0,4,337,78,25383,27800,25514,1,64,14,5089,5,2658,7247,0,0,1,0,4
EUW1_6881172520',2,19,17,0,0,0,0,11,0,360,70,30053,29696,33043,0,27,18,1,0,2,0,3,374,91,30124,30568,40429,1,-14,-21,-71,-1,-872,-7386,-1,0,-2,0,8
EUW1_6880959372',3,35,19,2,0,2,0,14,1,399,106,30838,32397,36504,4,41,8,0,0,1,0,4,352,86,26119,28852,27747,1,47,20,4719,11,3545,8757,2,0,1,0,10
EUW1_6879380283',5,25,12,1,0,1,0,6,0,342,94,27414,27622,31873,1,27,12,1,1,1,0,7,335,82,26242,28941,31746,1,7,12,1172,0,-1319,127,0,-1,0,0,-1
EUW1_6879360353',2,25,17,1,0,2,0,14,0,333,86,30325,27944,40151,6,35,18,1,0,2,0,6,353,96,30878,32887,44447,0,-20,-10,-553,-1,-4943,-4296,0,0,0,0,8
EUW1_6878596740',5,30,7,0,0,0,0,7,1,332,100,24480,28442,27233,6,30,20,1,1,1,0,0,398,88,31761,32413,33979,0,-66,12,-7281,-13,-3971,-6746,-1,-1,-1,0,7
EUW1_6878567709',1,128,7,0,0,0,0,14,0,341,88,24081,28523,23477,0,74,20,2,0,3,0,2,406,88,33118,33945,41047,0,-65,0,-9037,-13,-5422,-17570,-2,0,-3,0,12
EUW1_6878521823',8,36,18,1,0,1,0,14,0,364,100,30796,30737,40797,0,29,12,1,0,2,0,6,334,72,28682,29166,29750,0,30,28,2114,6,1571,11047,0,0,-1,0,8
EUW1_6878469892',3,28,6,0,0,0,0,10,0,333,111,24185,28320,23251,5,33,14,1,1,1,0,0,378,92,28894,30246,32395,0,-45,19,-4709,-8,-1926,-9144,-1,-1,-1,0,10
EUW1_6878436527',5,29,14,2,0,1,0,6,1,437,98,30806,32511,36491,5,29,11,0,0,2,0,10,355,84,25911,27661,26963,1,82,14,4895,3,4850,9528,2,0,-1,0,-4
EUW1_6878318723',7,65,9,1,0,0,0,6,0,378,75,24936,29184,23263,11,71,12,1,0,1,0,2,415,100,28579,31861,30362,1,-37,-25,-3643,-3,-2677,-7099,0,0,-1,0,4
EUW1_6878246309',6,27,23,2,0,2,0,5,1,347,80,32615,29989,41104,5,32,17,0,0,0,0,8,297,104,28884,28736,38579,1,50,-24,3731,6,1253,2525,2,0,2,0,-3
EUW1_6878213684',2,23,11,0,0,0,0,7,0,375,85,27463,32320,26938,9,36,12,2,0,1,0,3,410,93,28381,30586,24627,1,-35,-8,-918,-1,1734,2311,-2,0,-1,0,4
EUW1_6881559835',5,47,21,1,0,0,0,8,1,349,93,31527,29881,36309,3,30,10,0,0,1,0,3,328,94,26623,28666,24783,1,21,-1,4904,11,1215,11526,1,0,-1,0,5
EUW1_6881481936',4,30,8,0,0,1,0,8,0,361,77,27234,26659,37898,6,33,17,1,0,0,0,1,341,96,29221,31070,36000,1,20,-19,-1987,-9,-4411,1898,-1,0,1,0,7
EUW1_6881443646',2,253,10,2,0,3,0,3,1,436,91,31699,32165,30701,3,26,5,0,0,1,0,12,352,84,23535,27021,20158,1,84,7,8164,5,5144,10543,2,0,2,0,-9
EUW1_6881361419',1,31,17,1,0,1,0,11,0,299,70,27773,28487,35932,2,30,17,0,0,1,0,1,359,87,30400,30431,48059,0,-60,-17,-2627,0,-1944,-12127,1,0,0,0,10
EUW1_6881306887',8,29,2,0,0,0,0,11,0,303,73,20548,24593,23411,5,24,14,1,1,2,0,0,412,82,29219,31090,29635,0,-109,-9,-8671,-12,-6497,-6224,-1,-1,-2,0,11
EUW1_6881258688',7,55,12,1,0,1,0,5,0,356,94,27667,28486,31343,3,31,11,1,0,1,0,6,335,82,25936,27619,30321,0,21,12,1731,1,867,1022,0,0,0,0,-1
EUW1_6881197251',3,33,18,1,0,0,0,6,1,389,108,30339,32946,34570,0,128,7,0,0,0,0,3,347,87,25190,28990,29010,1,42,21,5149,11,3956,5560,1,0,0,0,3
EUW1_6880902720',6,36,10,0,0,0,0,13,1,325,88,26116,26549,20065,4,23,9,1,1,0,0,3,341,68,25471,26749,24042,0,-16,20,645,1,-200,-3977,-1,-1,0,0,10
EUW1_6880881273',2,27,7,0,0,0,0,14,0,340,57,24279,27366,25149,6,25,16,1,0,3,0,0,448,122,33236,33810,39152,0,-108,-65,-8957,-9,-6444,-14003,-1,0,-3,0,14
EUW1_6879369836',3,118,3,0,0,0,0,6,1,381,84,23162,28125,22430,6,30,14,2,0,2,0,4,397,103,29629,33135,32483,0,-16,-19,-6467,-11,-5010,-10053,-2,0,-2,0,2
EUW1_6879337283',4,25,9,0,1,0,0,15,0,340,90,25658,29298,30002,4,30,19,1,0,2,0,1,378,89,32389,31806,40120,0,-38,1,-6731,-10,-2508,-10118,-1,1,-2,0,14
EUW1_6879322449',4,37,12,1,0,2,0,8,1,380,107,30684,30153,29929,1,25,11,0,0,0,0,8,388,92,27184,30153,32304,0,-8,15,3500,1,0,-2375,1,0,2,0,0
EUW1_6879316876',8,47,10,1,0,0,0,7,1,335,98,25894,27877,27682,2,95,10,0,0,0,0,3,345,86,25913,27890,29062,0,-10,12,-19,0,-13,-1380,1,0,0,0,4
EUW1_6879305890',0,29,14,1,0,0,0,13,1,308,111,28957,29476,39774,1,17,30,0,1,2,0,3,345,100,34338,33076,39637,0,-37,11,-5381,-16,-3600,137,1,-1,-2,0,10
EUW1_6879285795',3,24,13,2,0,2,0,9,1,342,98,30514,29410,37718,8,32,18,0,0,0,0,10,348,70,28603,30354,33328,1,-6,28,1911,-5,-944,4390,2,0,2,0,-1
EUW1_6879257540',2,21,8,0,0,1,0,13,0,342,96,26537,29703,24154,2,24,13,2,0,3,0,4,392,92,31383,31480,33794,0,-50,4,-4846,-5,-1777,-9640,-2,0,-2,0,9
EUW1_6879215084',4,32,8,0,0,0,0,7,1,327,78,24104,27292,29265,1,36,5,1,0,1,0,1,368,86,24589,27606,29371,0,-41,-8,-485,3,-314,-106,-1,0,-1,0,6
EUW1_6877959455',6,31,16,2,0,1,0,12,1,335,90,28072,28770,38767,2,38,14,0,0,1,0,1,344,84,28944,29793,32009,1,-9,6,-872,2,-1023,6758,2,0,0,0,11
EUW1_6877938062',3,26,11,1,0,0,0,18,0,358,82,27062,28700,31555,4,42,16,1,0,3,0,1,375,92,30507,31709,40324,1,-17,-10,-3445,-5,-3009,-8769,0,0,-3,0,17
EUW1_6883768747',5,26,11,1,0,0,0,9,0,345,53,27260,29188,33309,4,27,18,0,0,2,0,4,342,123,30274,31332,42397,0,3,-70,-3014,-7,-2144,-9088,1,0,-2,0,5
EUW1_6883649421',7,36,10,0,0,0,0,6,0,347,84,27574,27668,34861,6,40,16,2,0,1,0,4,369,68,29895,29910,34951,0,-22,16,-2321,-6,-2242,-90,-2,0,-1,0,2
EUW1_6883632185',3,21,8,0,0,0,0,14,0,323,84,24421,26825,30992,3,25,27,1,0,2,0,2,366,111,34304,34692,46855,0,-43,-27,-9883,-19,-7867,-15863,-1,0,-2,0,12
EUW1_6883516203',2,27,8,1,0,0,0,6,1,387,84,26299,29426,33093,2,32,12,1,0,1,0,3,379,112,28367,32204,38604,1,8,-28,-2068,-4,-2778,-5511,0,0,-1,0,3
EUW1_6883482493',4,28,16,1,0,0,0,11,0,335,87,28754,29342,37613,4,29,16,0,0,2,0,5,392,80,32386,32745,37113,0,-57,7,-3632,0,-3403,500,1,0,-2,0,6
EUW1_6883442460',6,30,13,0,0,1,0,12,0,379,67,29692,30681,26922,2,21,21,2,0,3,0,3,390,97,32835,32910,35811,0,-11,-30,-3143,-8,-2229,-8889,-2,0,-2,0,9
EUW1_6883394231',2,27,6,0,0,0,0,9,0,324,72,22381,25872,19899,3,29,14,1,0,2,0,0,391,100,29861,30799,34269,0,-67,-28,-7480,-8,-4927,-14370,-1,0,-2,0,9
EUW1_6882750553',5,22,14,0,1,0,0,14,0,359,74,27289,30735,30559,5,29,15,1,0,0,0,2,391,82,29492,31128,30024,0,-32,-8,-2203,-1,-393,535,-1,1,0,0,12
EUW1_6882665091',5,33,7,0,1,0,0,13,0,328,94,26031,29085,26997,7,23,15,2,0,2,0,2,396,80,30228,31296,30903,1,-68,14,-4197,-8,-2211,-3906,-2,1,-2,0,11
EUW1_6882634513',5,28,13,2,0,0,0,11,1,387,103,29097,31765,37657,6,97,7,0,0,1,0,2,375,84,25221,29206,25975,1,12,19,3876,6,2559,11682,2,0,-1,0,9
EUW1_6882591708',5,35,13,1,0,2,0,8,1,403,84,29299,31509,35778,2,227,11,0,0,0,0,4,361,92,26654,31289,30452,0,42,-8,2645,2,220,5326,1,0,2,0,4
EUW1_6882471906',5,27,15,0,0,2,0,7,1,398,99,31288,32615,34249,2,24,6,0,0,1,0,9,294,68,22342,25068,24556,1,104,31,8946,9,7547,9693,0,0,1,0,-2
EUW1_6882440457',5,56,6,0,0,0,0,9,1,335,76,23091,26951,31311,4,48,13,1,0,0,0,1,383,85,28301,30995,34424,0,-48,-9,-5210,-7,-4044,-3113,-1,0,0,0,8
EUW1_6882381419',4,31,8,0,0,0,0,17,1,347,72,23984,28251,23326,4,26,14,1,0,3,0,1,382,110,31050,30971,29079,0,-35,-38,-7066,-6,-2720,-5753,-1,0,-3,0,16
EUW1_6882211110',10,36,12,0,0,0,0,7,1,363,100,27165,30952,31737,4,35,11,1,0,0,0,3,360,88,26285,29088,31187,1,3,12,880,1,1864,550,-1,0,0,0,4
EUW1_6881389247',7,33,12,2,1,2,0,4,1,430,94,30080,30878,29371,4,154,8,0,0,0,0,7,360,83,25395,29143,26632,1,70,11,4685,4,1735,2739,2,1,2,0,-3
EUW1_6881254628',3,30,7,0,0,0,0,11,0,316,84,23343,27979,29612,4,31,21,1,1,2,0,0,378,79,31073,31147,40619,0,-62,5,-7730,-14,-3168,-11007,-1,-1,-2,0,11
EUW1_6881205666',2,22,10,1,0,0,0,14,0,323,68,25459,28370,34243,3,27,15,1,0,2,0,3,413,98,29738,31643,38225,0,-90,-30,-4279,-5,-3273,-3982,0,0,-2,0,11
EUW1_6883756729',9,42,6,1,0,0,0,8,0,370,82,24528,28628,25007,4,37,9,1,1,1,0,1,401,122,28630,33075,30372,0,-31,-40,-4102,-3,-4447,-5365,0,-1,-1,0,7
EUW1_6883745706',0,21,4,0,0,1,0,11,0,366,80,23853,26414,24560,5,36,18,2,1,1,0,3,330,91,29134,30256,35927,0,36,-11,-5281,-14,-3842,-11367,-2,-1,0,0,8
EUW1_6883368045',5,32,14,1,0,1,0,6,1,376,76,29640,29602,29809,0,41,7,0,0,0,0,8,364,59,24066,26237,30521,1,12,17,5574,7,3365,-712,1,0,1,0,-2
EUW1_6883007615',4,62,7,1,0,0,0,12,0,372,102,25996,29089,28945,2,64,17,1,1,2,0,6,372,98,31003,30596,32404,0,0,4,-5007,-10,-1507,-3459,0,-1,-2,0,6
EUW1_6882954907',4,62,16,0,0,0,0,9,1,349,90,28291,31599,38563,1,54,8,1,0,1,0,2,382,98,24694,29496,27252,1,-33,-8,3597,8,2103,11311,-1,0,-1,0,7
EUW1_6882638680',8,118,18,1,0,3,0,10,1,342,113,31389,31592,38766,1,57,12,1,0,0,0,5,327,74,27245,27786,33384,1,15,39,4144,6,3806,5382,0,0,3,0,5
EUW1_6882585770',5,35,11,0,1,0,0,8,1,354,89,26314,28780,26004,5,43,8,2,0,1,0,5,376,106,26328,29450,30165,0,-22,-17,-14,3,-670,-4161,-2,1,-1,0,3
EUW1_6882077668',6,35,12,0,0,0,0,2,1,322,102,27012,26944,30747,6,27,12,2,0,0,0,6,363,64,26115,28390,31907,0,-41,38,897,0,-1446,-1160,-2,0,0,0,-4
EUW1_6882003350',4,38,27,1,0,1,0,10,1,371,87,35368,33072,44646,4,23,16,0,0,0,0,3,328,91,28836,29729,32069,1,43,-4,6532,11,3343,12577,1,0,1,0,7
EUW1_6881531470',3,29,9,0,1,0,0,9,1,397,86,26949,29728,36931,2,32,15,1,0,2,0,3,382,78,28784,31258,30021,1,15,8,-1835,-6,-1530,6910,-1,1,-2,0,6
EUW1_6881453186',6,28,16,2,0,1,0,9,1,339,86,29657,31141,29553,9,33,13,0,0,1,0,5,360,89,29342,29408,30753,0,-21,-3,315,3,1733,-1200,2,0,0,0,4
EUW1_6881277729',1,26,6,0,0,1,0,14,1,356,100,25850,28904,21744,3,34,13,2,0,2,0,2,369,104,30160,29697,34532,0,-13,-4,-4310,-7,-793,-12788,-2,0,-1,0,12
EUW1_6881223965',4,30,15,2,0,1,0,9,1,383,94,29498,32010,31247,3,23,10,0,0,0,0,4,397,90,27433,28857,29670,1,-14,4,2065,5,3153,1577,2,0,1,0,5
EUW1_6880530945',5,23,15,1,0,3,0,8,1,388,87,31184,31605,34633,5,31,4,1,0,1,0,11,334,84,23019,27681,19007,1,54,3,8165,11,3924,15626,0,0,2,0,-3
EUW1_6880429581',5,27,11,2,0,0,0,6,1,345,93,26352,28229,35098,6,39,15,0,0,1,0,3,341,64,28113,29963,32605,0,4,29,-1761,-4,-1734,2493,2,0,-1,0,3
EUW1_6880327429',3,37,20,0,0,1,0,15,0,300,44,29839,27046,34475,4,47,14,1,0,1,0,3,296,91,28333,26821,38009,1,4,-47,1506,6,225,-3534,-1,0,0,0,12
EUW1_6880216498',7,41,7,1,0,0,0,8,0,394,102,25208,29954,27560,4,46,14,1,1,1,0,1,415,93,28870,32264,31335,0,-21,9,-3662,-7,-2310,-3775,0,-1,-1,0,7
EUW1_6880004149',5,31,13,0,0,0,0,8,1,380,80,27884,30356,32144,2,23,12,2,0,0,0,3,369,103,27661,30967,31491,1,11,-23,223,1,-611,653,-2,0,0,0,5
EUW1_6879962678',3,22,6,0,0,0,0,13,0,341,87,24129,26963,20915,5,25,21,2,0,1,0,1,396,86,31095,32796,44153,0,-55,1,-6966,-15,-5833,-23238,-2,0,-1,0,12
EUW1_6879884994',4,27,9,1,0,0,0,12,1,328,108,25031,30212,21352,3,51,7,1,0,0,0,3,387,77,25314,30594,26729,0,-59,31,-283,2,-382,-5377,0,0,0,0,9
EUW1_6882250226',6,27,15,2,0,1,0,10,0,309,89,27863,28540,33943,4,460,9,0,0,0,0,5,313,83,24148,27880,28124,0,-4,6,3715,6,660,5819,2,0,1,0,5
EUW1_6882233394',8,276,25,2,0,2,0,10,1,363,88,33157,33439,46212,1,49,13,0,0,0,0,8,312,86,27569,27849,37428,1,51,2,5588,12,5590,8784,2,0,2,0,2
EUW1_6882216219',3,80,14,1,0,1,0,11,0,293,86,27988,28350,38087,6,371,14,0,1,2,0,4,342,88,29142,28302,37307,1,-49,-2,-1154,0,48,780,1,-1,-1,0,7
EUW1_6882041448',3,238,7,2,0,0,0,10,0,393,98,25124,30610,23743,2,22,8,0,0,1,0,3,394,114,26840,30486,28234,1,-1,-16,-1716,-1,124,-4491,2,0,-1,0,7
EUW1_6881979904',3,322,18,1,0,1,0,7,1,345,96,30337,30262,35537,1,23,9,0,0,0,0,9,352,83,25863,29544,38915,1,-7,13,4474,9,718,-3378,1,0,1,0,-2
EUW1_6881905108',4,290,10,2,0,0,0,15,0,362,72,25894,28777,35298,8,43,13,0,0,3,0,2,343,78,28062,29701,34491,1,19,-6,-2168,-3,-924,807,2,0,-3,0,13
EUW1_6881832212',3,187,13,0,0,0,0,13,1,336,99,27376,31572,25924,1,21,12,1,0,3,0,1,388,92,29773,30312,37592,1,-52,7,-2397,1,1260,-11668,-1,0,-3,0,12
EUW1_6881782467',5,192,13,1,0,1,0,7,1,368,109,29155,32312,32506,4,19,6,1,0,1,0,6,352,88,24736,29212,31426,1,16,21,4419,7,3100,1080,0,0,0,0,1
EUW1_6881707718',9,315,16,2,0,0,0,9,0,353,74,27976,29255,31349,4,31,15,0,0,1,0,5,349,92,29728,30152,35278,1,4,-18,-1752,1,-897,-3929,2,0,-1,0,4
EUW1_6881461686',4,166,10,0,0,0,0,8,1,299,91,25063,28441,21955,7,32,16,1,0,3,0,1,409,104,31453,33022,32932,0,-110,-13,-6390,-6,-4581,-10977,-1,0,-3,0,7
EUW1_6881427470',2,27,20,1,0,2,0,7,1,431,106,35909,34819,37540,4,27,7,0,0,1,0,6,313,62,23044,26131,24728,1,118,44,12865,13,8688,12812,1,0,1,0,1
EUW1_6881372685',5,268,7,0,0,0,0,11,1,360,108,26249,28827,26838,0,28,13,2,0,1,0,6,407,87,29521,31379,35432,0,-47,21,-3272,-6,-2552,-8594,-2,0,-1,0,5
EUW1_6881251914',4,223,20,2,0,0,0,8,1,355,108,30144,31404,41625,2,27,9,0,0,0,0,3,331,83,25375,28289,29683,1,24,25,4769,11,3115,11942,2,0,0,0,5
EUW1_6881183366',4,266,15,0,1,0,0,14,0,321,78,27829,29136,31665,5,35,16,2,0,2,0,1,375,77,30023,28506,35615,0,-54,1,-2194,-1,630,-3950,-2,1,-2,0,13
EUW1_6881142909',3,38,13,0,0,0,0,11,0,301,77,26322,25615,27540,3,266,16,2,1,1,0,2,354,90,29355,28771,34596,0,-53,-13,-3033,-3,-3156,-7056,-2,-1,-1,0,9
EUW1_6881110704',10,256,17,1,1,2,0,9,1,376,104,30937,30688,30292,4,40,10,0,0,1,0,10,315,72,25498,26698,28822,1,61,32,5439,7,3990,1470,1,1,1,0,-1
EUW1_6881072795',2,262,6,0,1,1,0,6,0,386,108,26037,30316,28910,3,26,10,2,0,0,0,4,354,88,25757,30356,34464,0,32,20,280,-4,-40,-5554,-2,1,1,0,2
EUW1_6881027918',8,28,14,0,0,2,0,5,1,372,90,29174,30750,31070,4,257,9,2,0,0,0,4,386,97,25610,29078,27880,1,-14,-7,3564,5,1672,3190,-2,0,2,0,1
EUW1_6879366724',3,425,20,1,1,0,0,13,1,323,96,31109,29070,41868,0,33,15,1,0,2,0,8,297,84,27543,26896,43894,0,26,12,3566,5,2174,-2026,0,1,-2,0,5
EUW1_6882200739',4,28,14,1,0,1,0,5,0,352,83,28538,29093,35565,2,25,8,0,0,0,0,4,320,68,24334,26321,30754,1,32,15,4204,6,2772,4811,1,0,1,0,1
EUW1_6881747858',2,26,12,1,0,0,0,3,0,342,92,28310,28591,36672,3,28,14,1,0,2,0,10,343,96,27312,29874,28898,1,-1,-4,998,-2,-1283,7774,0,0,-2,0,-7
EUW1_6879337200',2,55,15,1,0,4,0,8,1,392,77,31211,30002,37858,2,24,12,0,0,0,0,10,291,100,27081,28640,28243,1,101,-23,4130,3,1362,9615,1,0,4,0,-2
EUW1_6877060901',2,30,13,1,0,0,0,9,1,334,94,28070,29785,34298,2,21,9,1,0,2,0,6,365,88,25699,28123,23800,1,-31,6,2371,4,1662,10498,0,0,-2,0,3
EUW1_6877018230',3,30,21,2,1,2,0,6,1,379,102,32473,32950,40174,2,27,8,0,0,0,0,8,301,76,24570,25886,29056,1,78,26,7903,13,7064,11118,2,1,2,0,-2
EUW1_6876971960',5,23,13,1,0,1,0,7,0,335,112,27853,31640,36929,5,30,15,1,0,0,0,2,355,106,28558,30620,35974,0,-20,6,-705,-2,1020,955,0,0,1,0,5
EUW1_6876938702',5,26,25,1,0,1,0,13,1,394,105,33132,32557,49449,1,57,13,1,0,1,0,8,294,63,25911,25558,34064,1,100,42,7221,12,6999,15385,0,0,0,0,5
EUW1_6875587112',5,31,17,0,0,1,0,8,1,338,80,28771,28357,31760,3,33,14,2,0,0,0,7,307,80,27430,28926,28692,0,31,0,1341,3,-569,3068,-2,0,1,0,1
EUW1_6875541157',5,30,21,1,0,2,0,7,1,383,81,32686,33068,38820,5,41,7,0,0,1,0,7,319,92,23977,27532,28746,1,64,-11,8709,14,5536,10074,1,0,1,0,0
EUW1_6875508171',8,31,16,1,0,0,0,6,1,349,88,29589,29276,27760,3,29,11,1,0,1,0,4,310,86,26434,26373,25451,1,39,2,3155,5,2903,2309,0,0,-1,0,2
EUW1_6875002938',3,26,8,1,1,0,0,13,0,356,86,25888,28947,32696,2,26,16,1,0,2,0,3,369,82,29549,31228,38460,0,-13,4,-3661,-8,-2281,-5764,0,1,-2,0,10
EUW1_6874992720',5,30,16,2,0,1,0,7,0,412,96,30748,31297,36508,2,57,11,0,0,1,0,7,320,64,25688,26288,24197,1,92,32,5060,5,5009,12311,2,0,0,0,0
EUW1_6874361327',8,38,14,1,0,0,0,9,0,359,82,29205,29109,33277,5,32,12,1,0,1,0,3,380,110,28530,30374,31345,0,-21,-28,675,2,-1265,1932,0,0,-1,0,6
EUW1_6874109314',5,32,20,2,1,2,0,5,1,387,100,32275,32108,36901,1,29,8,0,0,0,0,7,354,100,25409,29349,32514,1,33,0,6866,12,2759,4387,2,1,2,0,-2
EUW1_6874072096',2,32,6,1,0,0,0,15,1,376,108,25059,28573,20855,1,21,10,1,1,3,0,2,412,123,31055,32371,34858,0,-36,-15,-5996,-4,-3798,-14003,0,-1,-3,0,13
EUW1_6874036095',1,26,16,2,1,3,0,10,1,360,93,31970,32098,36477,6,36,6,0,0,0,0,10,337,112,24969,29366,28948,1,23,-19,7001,10,2732,7529,2,1,3,0,0
EUW1_6874006538',3,23,14,0,0,0,0,12,0,310,76,26876,27710,28637,4,36,17,2,0,2,0,1,398,88,32038,29494,38050,0,-88,-12,-5162,-3,-1784,-9413,-2,0,-2,0,11
EUW1_6883748453',2,26,8,0,0,0,0,3,0,375,101,26478,30189,29910,3,26,14,1,0,1,0,7,366,101,29203,32142,36208,0,9,0,-2725,-6,-1953,-6298,-1,0,-1,0,-4
EUW1_6883736487',4,35,11,0,0,2,0,4,1,379,71,28723,29331,35872,3,22,10,1,0,0,0,8,354,96,24936,28833,26176,1,25,-25,3787,1,498,9696,-1,0,2,0,-4
EUW1_6882628166',3,27,17,1,0,4,0,8,1,340,70,31516,29277,36903,5,29,8,0,0,0,0,6,320,78,24624,26728,28332,1,20,-8,6892,9,2549,8571,1,0,4,0,2
EUW1_6882564620',1,25,9,0,0,1,0,17,0,394,98,28035,31538,31516,4,24,18,2,0,2,0,2,363,85,31337,33160,30073,0,31,13,-3302,-9,-1622,1443,-2,0,-1,0,15
EUW1_6882532507',3,28,14,2,1,1,0,7,0,376,106,29539,30904,36165,1,21,11,0,0,0,0,4,361,90,27357,30909,29847,1,15,16,2182,3,-5,6318,2,1,1,0,3
EUW1_6882321727',3,35,12,1,0,0,0,13,0,313,76,26461,28680,24214,3,24,15,1,0,2,0,2,364,78,28285,29861,34243,0,-51,-2,-1824,-3,-1181,-10029,0,0,-2,0,11
EUW1_6882301849',2,27,18,1,0,1,0,11,0,378,79,30619,30792,36657,2,25,15,1,0,1,0,4,319,104,27950,29392,32414,1,59,-25,2669,3,1400,4243,0,0,0,0,7
EUW1_6880997682',2,28,9,0,0,1,0,1,0,361,104,27322,31046,26686,2,27,7,1,1,0,0,8,385,80,24529,29738,26678,1,-24,24,2793,2,1308,8,-1,-1,1,0,-7
EUW1_6880956220',3,24,8,1,1,0,0,10,1,391,88,27579,28896,25685,4,32,7,1,0,1,0,5,383,96,26749,29515,34667,0,8,-8,830,1,-619,-8982,0,1,-1,0,5
EUW1_6880891364',4,27,12,0,0,0,0,9,0,338,78,26433,27416,31935,9,37,18,2,0,1,0,2,348,86,30310,30154,37845,0,-10,-8,-3877,-6,-2738,-5910,-2,0,-1,0,7
EUW1_6880883575',3,74,12,1,0,2,0,4,1,352,87,28653,29523,45317,1,99,9,1,0,0,0,9,337,88,26290,27698,38847,1,15,-1,2363,3,1825,6470,0,0,2,0,-5
EUW1_6880860784',0,182,3,0,0,0,0,16,0,310,71,20945,24150,22127,6,21,17,1,1,6,0,0,381,96,34465,30317,32066,0,-71,-25,-13520,-14,-6167,-9939,-1,-1,-6,0,16
EUW1_6879327200',6,66,14,1,1,1,0,9,1,343,103,28812,29470,35739,4,101,9,1,0,0,0,4,312,68,24964,27043,25127,1,31,35,3848,5,2427,10612,0,1,1,0,5
EUW1_6879293193',3,29,17,1,1,1,0,6,0,372,104,30440,30678,37008,1,27,14,1,0,0,0,6,324,84,26987,26313,32936,1,48,20,3453,3,4365,4072,0,1,1,0,0
EUW1_6879285900',5,49,26,2,0,2,0,8,0,362,94,33561,33368,45939,1,31,13,0,0,0,0,8,285,78,28226,26241,41846,1,77,16,5335,13,7127,4093,2,0,2,0,0
EUW1_6877924362',1,26,13,0,1,0,0,8,1,372,76,28749,31084,31382,3,35,18,2,0,0,0,2,339,111,29066,31371,42730,1,33,-35,-317,-5,-287,-11348,-2,1,0,0,6
EUW1_6877919936',0,23,21,1,0,3,0,13,1,370,72,34143,29535,41165,1,27,11,1,0,1,0,9,334,84,26268,26120,26410,0,36,-12,7875,10,3415,14755,0,0,2,0,4
EUW1_6877906540',0,28,14,0,1,2,0,3,1,321,96,29653,27121,30572,3,173,10,2,0,0,0,8,323,84,24715,27086,28012,1,-2,12,4938,4,35,2560,-2,1,2,0,-5
EUW1_6883753591',3,32,18,1,0,0,0,6,1,330,86,29172,29969,39094,3,33,15,1,1,0,0,6,328,76,28840,28566,38641,1,2,10,332,3,1403,453,0,-1,0,0,0
EUW1_6883725319',3,26,6,0,0,0,0,9,0,323,76,23851,26569,30514,6,27,19,2,0,2,0,0,431,101,32697,33156,36889,0,-108,-25,-8846,-13,-6587,-6375,-2,0,-2,0,9
EUW1_6883567739',2,84,19,1,0,1,0,8,1,323,100,29760,26560,26860,6,73,2,0,0,1,0,5,345,68,23070,25131,18898,0,-22,32,6690,17,1429,7962,1,0,0,0,3
EUW1_6883535555',3,27,10,0,0,0,0,9,1,341,71,26619,28941,41227,5,39,14,1,0,0,0,2,334,83,27439,29863,36933,0,7,-12,-820,-4,-922,4294,-1,0,0,0,7
EUW1_6883492299',1,22,14,0,0,0,0,11,0,350,72,26546,30053,30659,4,24,14,2,0,2,0,2,396,86,30347,31501,39610,1,-46,-14,-3801,0,-1448,-8951,-2,0,-2,0,9
EUW1_6883455127',3,32,13,1,0,0,0,9,0,334,72,27179,28192,38107,4,28,15,1,1,0,0,3,299,98,28404,28412,33680,0,35,-26,-1225,-2,-220,4427,0,-1,0,0,6
EUW1_6883407256',6,29,13,1,0,0,0,5,0,381,91,27665,31524,28289,5,40,9,0,0,0,0,3,370,80,25518,27572,22403,1,11,11,2147,4,3952,5886,1,0,0,0,2
EUW1_6883360182',4,22,10,2,0,1,0,9,1,358,84,26829,29469,23925,2,21,6,0,0,2,0,4,402,112,25396,29533,18236,1,-44,-28,1433,4,-64,5689,2,0,-1,0,5
EUW1_6882728661',2,26,14,1,1,1,0,8,0,383,111,31469,30729,30483,3,57,13,1,0,1,0,8,341,72,27204,28179,36307,1,42,39,4265,1,2550,-5824,0,1,0,0,0
EUW1_6882699792',5,29,24,1,0,2,0,9,0,398,91,34531,34041,44518,3,28,10,0,0,0,0,5,337,81,26101,28902,32079,1,61,10,8430,14,5139,12439,1,0,2,0,4
EUW1_6882658494',3,28,13,0,0,0,0,11,0,355,56,26429,27448,28958,4,67,9,0,0,0,0,2,338,72,25114,27678,31359,1,17,-16,1315,4,-230,-2401,0,0,0,0,9
EUW1_6882547435',3,22,8,1,0,0,0,12,1,387,105,25417,29555,30992,2,28,14,0,0,2,0,2,410,90,29761,31114,30643,1,-23,15,-4344,-6,-1559,349,1,0,-2,0,10
EUW1_6882522022',5,117,14,1,0,2,0,6,1,420,122,33503,33268,38231,1,41,5,1,0,3,0,10,364,60,23542,28000,21379,1,56,62,9961,9,5268,16852,0,0,-1,0,-4
EUW1_6882466953',1,22,17,1,0,1,0,7,1,404,85,30753,32801,33682,2,35,3,0,0,0,0,5,389,97,23315,28135,20003,1,15,-12,7438,14,4666,13679,1,0,1,0,2
EUW1_6882443287',5,27,7,1,0,0,0,8,1,388,76,25025,27761,26035,4,23,9,1,0,1,0,4,377,92,27188,30780,28985,0,11,-16,-2163,-2,-3019,-2950,0,0,-1,0,4
EUW1_6882428746',2,23,15,0,0,0,0,17,0,361,85,28728,30281,32833,6,27,13,0,0,4,0,1,354,86,29927,28564,31032,0,7,-1,-1199,2,1717,1801,0,0,-4,0,16
EUW1_6882408050',3,24,15,1,1,1,0,10,0,344,98,28289,30546,35494,4,87,13,1,0,0,0,1,333,110,27951,30036,29317,1,11,-12,338,2,510,6177,0,1,1,0,9
EUW1_6882391914',3,26,8,0,0,0,0,9,0,363,90,25858,28465,26299,1,27,17,1,0,1,0,2,381,81,30281,31429,38721,0,-18,9,-4423,-9,-2964,-12422,-1,0,-1,0,7
EUW1_6882369633',1,21,14,1,0,0,0,10,1,324,48,27549,28513,33617,1,94,19,0,0,2,0,3,357,86,30756,31613,33910,0,-33,-38,-3207,-5,-3100,-293,1,0,-2,0,7
EUW1_6883046460',9,37,13,1,0,1,0,7,0,352,88,27787,28804,30197,2,100,13,0,0,1,0,1,367,90,28706,29360,30329,0,-15,-2,-919,0,-556,-132,1,0,0,0,6
EUW1_6882958022',4,30,12,1,0,1,0,6,1,367,82,27513,27684,27888,4,31,8,1,1,1,0,5,363,110,26234,28765,27489,0,4,-28,1279,4,-1081,399,0,-1,0,0,1
EUW1_6882878374',4,27,12,0,0,0,0,12,1,345,91,26335,27068,34217,6,30,20,2,0,1,0,1,371,76,30511,30448,37340,0,-26,15,-4176,-8,-3380,-3123,-2,0,-1,0,11
EUW1_6882823760',2,24,11,0,0,1,0,7,1,378,89,27884,29366,28374,5,44,10,2,0,0,0,3,377,94,26358,28361,25141,1,1,-5,1526,1,1005,3233,-2,0,1,0,4
EUW1_6882784203',4,31,24,1,0,2,0,8,1,390,90,34200,33805,39360,2,25,7,1,0,0,0,4,353,90,25230,27846,27653,1,37,0,8970,17,5959,11707,0,0,2,0,4
EUW1_6882698849',4,22,10,1,1,1,0,11,1,370,113,28732,29801,39136,3,256,14,0,0,0,0,2,313,86,26202,28998,34037,1,57,27,2530,-4,803,5099,1,1,1,0,9
EUW1_6882646729',4,29,7,0,0,0,0,13,0,350,85,23701,27685,33403,6,36,17,1,0,3,0,0,385,113,31672,33740,34799,0,-35,-28,-7971,-10,-6055,-1396,-1,0,-3,0,13
EUW1_6882550214',4,32,12,0,0,1,0,7,1,411,93,30250,31966,36891,4,27,13,2,0,1,0,7,367,66,28001,30943,32032,1,44,27,2249,-1,1023,4859,-2,0,0,0,0
EUW1_6882462267',2,100,2,0,0,0,0,6,0,388,90,23363,28400,16526,8,34,7,2,1,1,0,5,404,101,26634,31085,26361,0,-16,-11,-3271,-5,-2685,-9835,-2,-1,-1,0,1
EUW1_6881757671',1,24,9,0,0,2,0,9,0,407,83,27883,30121,36135,4,26,18,2,1,0,0,9,342,92,28762,30351,31448,0,65,-9,-879,-9,-230,4687,-2,-1,2,0,0
EUW1_6881683469',2,27,11,1,0,1,0,12,0,361,104,28007,29641,27842,4,20,9,1,0,1,0,4,363,80,26614,28528,25840,1,-2,24,1393,2,1113,2002,0,0,0,0,8
EUW1_6881630482',4,27,3,0,0,1,0,14,0,366,112,26104,28090,27266,6,29,14,2,0,3,0,8,356,114,29416,31994,30183,0,10,-2,-3312,-11,-3904,-2917,-2,0,-2,0,6
EUW1_6881579065',3,33,7,0,0,0,0,10,0,351,73,23833,27206,27922,3,45,13,1,0,1,0,0,378,86,27625,30544,28246,0,-27,-13,-3792,-6,-3338,-324,-1,0,-1,0,10
EUW1_6879467989',4,33,13,0,0,1,0,7,1,353,66,26431,27703,37081,4,31,11,1,0,0,0,2,382,86,26842,30916,32969,0,-29,-20,-411,2,-3213,4112,-1,0,1,0,5
EUW1_6879441993',3,29,15,0,1,2,0,7,1,376,105,29528,31952,28628,2,29,9,2,0,1,0,6,389,93,26172,29797,28204,1,-13,12,3356,6,2155,424,-2,1,1,0,1
EUW1_6879416896',3,70,12,1,0,0,0,6,1,365,86,27872,30611,32623,6,26,16,0,0,0,0,3,347,102,29032,31345,36164,0,18,-16,-1160,-4,-734,-3541,1,0,0,0,3
EUW1_6878812536',3,25,6,0,0,0,0,11,0,335,116,24437,29235,25822,2,118,12,2,0,0,0,2,410,83,27467,32478,29037,0,-75,33,-3030,-6,-3243,-3215,-2,0,0,0,9
EUW1_6878745552',4,32,15,1,0,1,0,4,1,339,69,28923,30349,27210,5,35,12,1,0,0,0,2,349,91,26553,29513,26605,1,-10,-22,2370,3,836,605,0,0,1,0,2
EUW1_6883413720',2,30,11,0,0,0,0,13,0,337,108,26833,29026,35136,4,29,22,2,0,2,0,2,405,63,33609,31597,45852,0,-68,45,-6776,-11,-2571,-10716,-2,0,-2,0,11
EUW1_6883340427',1,26,14,0,0,1,0,7,1,376,94,29913,32398,36863,4,29,15,2,0,1,0,7,358,94,29080,30366,38016,1,18,0,833,-1,2032,-1153,-2,0,0,0,0
EUW1_6883294778',4,37,10,0,0,0,0,7,1,341,88,26583,26367,23144,3,29,18,1,0,2,0,3,406,92,31918,33506,35166,0,-65,-4,-5335,-8,-7139,-12022,-1,0,-2,0,4
EUW1_6883232334',3,23,1,2,0,0,0,15,0,367,110,22040,28920,16322,7,168,11,0,0,3,0,2,436,102,30615,32782,24365,0,-69,8,-8575,-10,-3862,-8043,2,0,-3,0,13
EUW1_6882713200',1,28,8,2,0,0,0,5,0,371,106,25645,31331,23704,2,25,6,0,0,1,0,3,394,80,25027,28826,27590,1,-23,26,618,2,2505,-3886,2,0,-1,0,2
EUW1_6882662351',3,29,7,0,0,0,0,16,0,302,75,23148,25203,24795,4,25,18,2,0,4,0,2,354,103,33162,31859,39482,0,-52,-28,-10014,-11,-6656,-14687,-2,0,-4,0,14
EUW1_6882588759',7,29,8,0,0,1,0,9,1,383,107,26774,33295,29689,5,27,8,2,0,1,0,4,430,107,27250,31518,37135,1,-47,0,-476,0,1777,-7446,-2,0,0,0,5
EUW1_6882455915',2,27,22,0,0,2,0,7,1,327,74,31651,32287,39529,0,28,11,2,1,1,0,7,328,89,26290,28958,34306,1,-1,-15,5361,11,3329,5223,-2,-1,1,0,0
EUW1_6882446636',20,43,1,0,0,0,0,10,0,351,74,21039,25722,14375,4,25,10,1,1,1,0,1,403,93,27453,31324,30869,0,-52,-19,-6414,-9,-5602,-16494,-1,-1,-1,0,9
EUW1_6882410589',5,24,12,1,0,1,0,8,1,340,94,26695,27207,25115,2,26,9,1,0,1,0,1,388,70,25926,28253,27442,1,-48,24,769,3,-1046,-2327,0,0,0,0,7
EUW1_6882382135',7,35,7,1,0,0,0,3,0,333,95,23713,28843,25938,7,40,7,0,0,0,0,2,401,92,24952,30067,27369,1,-68,3,-1239,0,-1224,-1431,1,0,0,0,1
EUW1_6882379524',1,35,13,0,0,0,0,8,0,345,82,27542,30874,38347,6,30,14,1,0,0,0,4,315,109,27518,31912,32715,1,30,-27,24,-1,-1038,5632,-1,0,0,0,4
EUW1_6882096566',5,25,9,0,0,1,0,5,0,331,96,25922,28385,23793,2,30,14,2,0,1,0,5,348,86,27132,29419,31302,1,-17,10,-1210,-5,-1034,-7509,-2,0,0,0,0
EUW1_6882039335',1,26,13,0,0,1,0,8,0,366,91,29814,30467,23946,5,31,9,2,0,2,0,9,299,104,25585,27073,26889,1,67,-13,4229,4,3394,-2943,-2,0,-1,0,-1
EUW1_6882000768',2,23,15,1,0,1,0,7,1,350,91,29048,29814,40328,5,27,24,1,0,0,0,8,312,64,30639,29547,39189,1,38,27,-1591,-9,267,1139,0,0,1,0,-1
EUW1_6881934670',5,24,13,0,0,0,0,7,1,360,92,27218,29063,32186,4,69,15,1,0,1,0,0,389,98,30829,30832,36143,1,-29,-6,-3611,-2,-1769,-3957,-1,0,-1,0,7
EUW1_6880931895',6,30,8,0,1,0,0,6,0,393,105,26841,31040,27838,7,24,11,2,0,0,0,1,396,102,27721,31201,26420,0,-3,3,-880,-3,-161,1418,-2,1,0,0,5
EUW1_6880002389',3,44,9,1,0,0,0,3,1,385,94,26747,29996,26425,4,30,12,1,1,1,0,2,364,102,27094,31414,31432,1,21,-8,-347,-3,-1418,-5007,0,-1,-1,0,1
EUW1_6879899082',5,30,9,0,0,0,0,5,1,328,68,24550,28554,25462,5,27,16,2,0,1,0,2,288,83,27914,30070,38585,0,40,-15,-3364,-7,-1516,-13123,-2,0,-1,0,3
EUW1_6879738962',2,48,13,1,0,1,0,11,0,341,77,28502,28975,31234,4,22,19,1,0,1,0,2,343,93,31692,30194,32273,0,-2,-16,-3190,-6,-1219,-1039,0,0,0,0,9
EUW1_6879683276',3,25,14,1,1,1,0,3,0,363,88,28769,30228,31232,4,33,6,0,0,0,0,3,370,85,24399,28721,24952,1,-7,3,4370,8,1507,6280,1,1,1,0,0
EUW1_6879571892',4,165,16,0,0,2,0,9,1,362,76,30478,29992,32232,4,35,15,1,0,0,0,6,366,88,29182,30461,34337,1,-4,-12,1296,1,-469,-2105,-1,0,2,0,3
EUW1_6879531527',5,23,14,1,0,1,0,12,1,409,116,30243,32760,34934,7,28,6,0,0,1,0,4,408,88,26779,30662,25721,1,1,28,3464,8,2098,9213,1,0,0,0,8
EUW1_6879484880',8,62,15,1,0,1,0,6,1,356,107,29781,30480,34155,7,31,12,1,0,1,0,7,399,116,29073,31574,32612,0,-43,-9,708,3,-1094,1543,0,0,0,0,-1
EUW1_6879440067',5,22,15,2,0,0,0,4,1,344,88,27386,30459,35921,4,104,5,0,1,0,0,5,345,84,23831,28445,25791,1,-1,4,3555,10,2014,10130,2,-1,0,0,-1
EUW1_6878416750',2,26,9,1,0,0,0,7,1,334,86,25413,27742,27775,6,44,15,1,0,1,0,5,361,66,28461,29069,32168,0,-27,20,-3048,-6,-1327,-4393,0,0,-1,0,2
EUW1_6878202362',2,47,11,0,0,2,0,9,1,381,104,28972,31624,33283,3,19,9,2,0,1,0,7,329,91,25137,28306,25811,1,52,13,3835,2,3318,7472,-2,0,1,0,2
EUW1_6878167270',6,42,16,1,0,1,0,8,0,378,80,30485,31142,33193,0,34,9,1,0,0,0,3,354,87,25954,28431,31536,1,24,-7,4531,7,2711,1657,0,0,1,0,5
EUW1_6878020349',3,19,15,1,0,0,0,3,1,374,105,28313,30980,27997,2,27,13,1,0,1,0,2,363,126,27649,32407,33089,0,11,-21,664,2,-1427,-5092,0,0,-1,0,1
EUW1_6877606779',3,27,13,1,0,0,0,11,0,360,86,26718,28703,27211,2,35,14,1,0,1,0,1,343,74,27506,28909,30231,0,17,12,-788,-1,-206,-3020,0,0,-1,0,10
EUW1_6877551847',7,262,12,1,0,3,0,8,0,360,102,29943,30172,34906,2,197,9,1,0,2,0,9,339,79,25507,29446,26068,1,21,23,4436,3,726,8838,0,0,1,0,-1
EUW1_6877198497',4,22,21,1,0,1,0,12,1,367,60,33094,31956,41520,6,33,20,1,0,1,0,7,339,74,30551,30006,34649,0,28,-14,2543,1,1950,6871,0,0,0,0,5
EUW1_6877146684',5,259,14,1,0,1,0,4,1,385,90,30091,31538,37467,5,33,3,1,0,1,0,5,362,98,23409,28061,30731,1,23,-8,6682,11,3477,6736,0,0,0,0,-1
EUW1_6877088986',1,28,16,1,0,1,0,6,1,364,81,29592,29940,32118,1,29,7,0,0,0,0,7,358,108,25784,28408,26336,1,6,-27,3808,9,1532,5782,1,0,1,0,-1
EUW1_6876917346',10,46,14,2,0,0,0,9,0,364,72,26992,29645,31346,0,31,10,0,1,0,0,1,371,91,27750,28954,31417,0,-7,-19,-758,4,691,-71,2,-1,0,0,8
EUW1_6876855323',7,33,13,0,0,0,0,15,0,314,80,27214,29048,32161,6,30,21,2,0,1,0,2,378,89,32299,31110,45157,0,-64,-9,-5085,-8,-2062,-12996,-2,0,-1,0,13
EUW1_6883755694',5,41,11,0,0,0,0,8,1,368,103,26242,30231,23807,5,27,6,1,0,0,0,2,414,80,25493,29148,21958,1,-46,23,749,5,1083,1849,-1,0,0,0,6
EUW1_6883725455',5,32,11,1,0,0,0,5,1,387,91,28208,31530,28482,3,35,10,0,0,1,0,4,352,100,25790,29273,28046,1,35,-9,2418,1,2257,436,1,0,-1,0,1
EUW1_6883711227',4,25,21,2,0,1,0,14,0,308,109,30353,30725,39353,3,33,15,0,0,2,0,5,307,74,29475,27107,34566,1,1,35,878,6,3618,4787,2,0,-1,0,9
EUW1_6883637304',3,32,10,0,0,0,0,9,1,374,90,26419,29445,36358,7,192,15,2,0,0,0,3,363,98,29016,28956,32535,0,11,-8,-2597,-5,489,3823,-2,0,0,0,6
EUW1_6883608843',3,26,9,0,0,0,0,13,0,399,116,28513,31225,33379,9,33,17,2,0,2,0,3,341,100,29765,30221,35034,0,58,16,-1252,-8,1004,-1655,-2,0,-2,0,10
EUW1_6883503868',3,37,14,0,0,1,0,3,0,378,87,29491,32065,36901,4,48,11,2,0,2,0,6,363,98,27586,30065,32790,1,15,-11,1905,3,2000,4111,-2,0,-1,0,-3
EUW1_6883255472',6,44,17,0,0,0,0,15,0,334,85,30146,28822,40205,5,36,18,1,0,3,0,5,340,68,30798,30149,35869,1,-6,17,-652,-1,-1327,4336,-1,0,-3,0,10
EUW1_6883164098',8,31,24,2,0,4,0,12,0,367,74,35591,32284,46331,4,18,14,0,0,1,0,7,331,84,28159,27804,35744,1,36,-10,7432,10,4480,10587,2,0,3,0,5
EUW1_6882291036',6,27,10,2,0,1,0,8,1,376,84,27890,28319,36389,3,30,13,0,0,1,0,8,399,107,29893,30991,35880,0,-23,-23,-2003,-3,-2672,509,2,0,0,0,0
EUW1_6882276576',0,21,22,1,0,1,0,16,1,329,92,32405,31215,34450,3,123,20,1,0,1,0,2,358,84,31529,28975,48735,0,-29,8,876,2,2240,-14285,0,0,0,0,14
EUW1_6881877054',2,21,12,0,0,1,0,9,0,329,87,27637,28122,28802,2,30,15,1,0,1,0,8,317,84,27409,28182,32769,0,12,3,228,-3,-60,-3967,-1,0,0,0,1
EUW1_6881565112',4,25,8,0,0,1,0,6,1,375,81,26491,29205,23211,9,32,6,2,1,1,0,5,390,86,26461,30102,23248,0,-15,-5,30,2,-897,-37,-2,-1,0,0,1
EUW1_6881505021',8,30,10,1,0,0,0,3,1,337,86,25679,26925,36991,6,26,12,1,0,1,0,0,296,90,25224,25492,32920,1,41,-4,455,-2,1433,4071,0,0,-1,0,3
EUW1_6880469168',5,27,21,1,0,0,0,7,1,302,88,28880,28076,39481,4,25,20,1,0,1,0,2,356,72,31608,30108,45361,0,-54,16,-2728,1,-2032,-5880,0,0,-1,0,5
EUW1_6880402597',4,68,7,0,0,0,0,15,0,378,73,24359,27065,18471,6,34,21,2,0,3,0,1,445,114,34752,34384,40143,0,-67,-41,-10393,-14,-7319,-21672,-2,0,-3,0,14
EUW1_6880043334',6,24,13,0,0,0,0,8,0,320,100,27046,28464,32378,8,50,21,1,0,1,0,1,333,67,29959,31129,43067,0,-13,33,-2913,-8,-2665,-10689,-1,0,-1,0,7
EUW1_6879225998',4,34,9,0,0,1,0,9,0,382,106,28405,29815,37521,3,201,18,1,0,1,0,4,351,71,29835,31064,37718,0,31,35,-1430,-9,-1249,-197,-1,0,0,0,5
EUW1_6879122020',6,34,17,1,0,1,0,7,1,371,79,30908,29949,33876,6,38,12,1,0,0,0,9,347,116,27326,29305,31116,1,24,-37,3582,5,644,2760,0,0,1,0,-2
EUW1_6883232167',8,29,15,2,0,0,0,12,1,377,93,30662,29563,39261,1,17,15,0,0,2,0,5,331,81,28404,28788,38689,0,46,12,2258,0,775,572,2,0,-2,0,7
EUW1_6882693028',4,22,19,1,0,1,0,11,0,361,95,32486,31424,39997,3,28,19,0,1,2,0,5,337,96,31781,30779,44092,1,24,-1,705,0,645,-4095,1,-1,-1,0,6
EUW1_6882632191',2,29,18,0,0,2,0,14,0,356,98,30540,30834,31720,3,33,23,2,0,2,0,4,322,73,31136,30389,45403,0,34,25,-596,-5,445,-13683,-2,0,0,0,10
EUW1_6882584163',4,33,17,1,0,0,0,12,0,322,71,28473,27643,35977,3,26,16,1,1,3,0,3,348,88,31220,28767,38498,0,-26,-17,-2747,1,-1124,-2521,0,-1,-3,0,9
EUW1_6882248137',4,18,17,1,0,2,0,8,0,372,90,31099,31191,43758,5,62,12,0,0,0,0,10,347,73,27423,29128,32585,1,25,17,3676,5,2063,11173,1,0,2,0,-2
EUW1_6882237819',10,60,30,1,1,2,0,12,0,345,107,35570,32693,55589,3,30,8,0,0,2,0,5,300,68,25831,26194,32511,1,45,39,9739,22,6499,23078,1,1,0,0,7
EUW1_6882213057',7,29,16,0,0,0,0,12,1,349,47,28202,28875,42772,5,27,19,1,0,1,0,2,370,80,30793,32665,48926,0,-21,-33,-2591,-3,-3790,-6154,-1,0,-1,0,10
EUW1_6882130666',3,23,11,0,0,0,0,15,0,299,103,26206,27060,31768,6,38,23,2,1,2,0,2,370,108,35111,33492,39106,0,-71,-5,-8905,-12,-6432,-7338,-2,-1,-2,0,13
EUW1_6882076110',1,24,16,0,0,0,0,12,0,325,65,27369,29048,38021,3,20,23,0,0,1,0,2,389,72,32502,31584,49363,0,-64,-7,-5133,-7,-2536,-11342,0,0,-1,0,10
EUW1_6882013396',4,34,12,1,0,2,0,9,1,373,110,30324,31350,36349,3,32,18,1,0,1,0,5,388,64,30079,32390,36678,1,-15,46,245,-6,-1040,-329,0,0,1,0,4
EUW1_6881961127',0,20,11,0,0,0,0,14,1,332,105,28342,30978,31618,3,41,20,2,0,3,0,2,365,94,32446,32500,46081,0,-33,11,-4104,-9,-1522,-14463,-2,0,-3,0,12
EUW1_6881851725',4,37,20,0,0,2,0,10,0,355,99,31125,31819,42434,4,28,15,1,0,2,0,8,351,76,28963,28558,41161,1,4,23,2162,5,3261,1273,-1,0,0,0,2
EUW1_6880701834',5,40,17,2,0,0,0,5,1,353,96,28918,30258,39114,1,25,13,0,0,1,0,3,321,89,26225,27847,38709,0,32,7,2693,4,2411,405,2,0,-1,0,2
EUW1_6880674670',6,35,10,0,0,0,0,7,1,343,74,25237,27975,33167,1,24,13,2,0,1,0,4,373,86,28823,31528,35295,0,-30,-12,-3586,-3,-3553,-2128,-2,0,-1,0,3
EUW1_6880629826',5,31,14,1,1,1,0,10,0,396,90,28553,30885,31916,5,164,11,0,0,1,0,2,352,121,28812,30278,30497,1,44,-31,-259,3,607,1419,1,1,0,0,8
EUW1_6880596478',0,28,16,1,0,1,0,10,1,332,98,29975,29020,37408,3,21,14,1,0,0,0,4,330,82,26835,28159,41430,1,2,16,3140,2,861,-4022,0,0,1,0,6
EUW1_6880535071',4,23,13,1,0,0,0,11,0,331,62,26886,27759,39515,0,22,19,1,0,2,0,1,321,88,30869,29376,36231,0,10,-26,-3983,-6,-1617,3284,0,0,-2,0,10
EUW1_6880271467',0,19,3,0,0,0,0,15,0,294,73,20744,24822,20186,5,38,23,1,1,5,0,0,409,110,35390,35852,38289,0,-115,-37,-14646,-20,-11030,-18103,-1,-1,-5,0,15
EUW1_6880216591',4,22,26,1,0,1,0,12,0,308,62,32128,27281,45698,3,141,18,0,1,2,0,4,298,78,30451,29943,36909,1,10,-16,1677,8,-2662,8789,1,-1,-1,0,8
EUW1_6883329187',5,31,20,0,1,3,0,5,1,406,91,33666,34229,33796,6,33,7,1,0,0,0,9,373,120,25895,29968,22758,1,33,-29,7771,13,4261,11038,-1,1,3,0,-4
EUW1_6883264377',10,34,18,1,0,2,0,16,0,322,73,30499,27164,38220,3,20,13,1,0,2,0,3,389,98,31093,29630,33573,0,-67,-25,-594,5,-2466,4647,0,0,0,0,13
EUW1_6883017845',3,33,7,0,0,1,0,7,0,358,96,24988,29599,23126,6,28,10,2,0,0,0,2,377,87,25309,28550,29177,0,-19,9,-321,-3,1049,-6051,-2,0,1,0,5
EUW1_6882979020',4,30,6,0,0,0,0,11,0,373,90,25085,28015,20429,6,30,20,1,0,1,0,3,373,76,31440,31853,32616,0,0,14,-6355,-14,-3838,-12187,-1,0,-1,0,8
EUW1_6882952656',8,32,3,0,0,0,0,12,0,330,86,21989,26697,20703,3,25,16,1,1,3,0,1,391,94,31253,32516,31061,0,-61,-8,-9264,-13,-5819,-10358,-1,-1,-3,0,11
EUW1_6882871486',6,25,8,1,0,1,0,4,1,360,96,26373,27812,23318,5,33,13,1,1,1,0,1,368,115,29599,31356,32673,0,-8,-19,-3226,-5,-3544,-9355,0,-1,0,0,3
EUW1_6882827763',5,42,8,1,1,1,0,8,0,369,79,26997,29782,26404,9,30,12,1,0,1,0,3,355,91,27238,29579,23737,1,14,-12,-241,-4,203,2667,0,1,0,0,5
EUW1_6882782194',3,43,7,1,0,0,0,8,0,383,95,25335,29258,29227,8,32,17,1,0,1,0,3,387,128,30423,34724,33490,1,-4,-33,-5088,-10,-5466,-4263,0,0,-1,0,5
EUW1_6882740098',3,22,15,0,1,1,0,8,1,351,82,29864,29085,31575,3,34,14,2,0,1,0,4,352,120,29245,30666,36863,0,-1,-38,619,1,-1581,-5288,-2,1,0,0,4
EUW1_6882698137',9,27,15,0,0,1,0,6,1,359,90,29726,29718,29721,3,45,12,1,0,2,0,11,326,73,26414,25624,28112,1,33,17,3312,3,4094,1609,-1,0,-1,0,-5
EUW1_6882659376',7,32,19,0,0,2,0,8,0,369,72,32510,29812,46631,3,24,19,2,0,2,0,10,366,87,31017,29252,41988,0,3,-15,1493,0,560,4643,-2,0,0,0,-2
EUW1_6882622277',3,26,8,0,0,0,0,9,0,347,88,25704,28222,28170,3,322,11,2,1,1,0,1,375,112,27662,29984,35840,0,-28,-24,-1958,-3,-1762,-7670,-2,-1,-1,0,8
EUW1_6882599432',11,291,22,2,0,3,0,10,1,405,111,35763,32795,44347,6,31,13,0,0,1,0,8,305,63,25983,27540,33116,1,100,48,9780,9,5255,11231,2,0,2,0,2
EUW1_6882570739',4,34,10,1,0,1,0,7,1,378,106,27498,29582,25049,6,30,8,1,0,1,0,5,431,106,27375,30494,24811,0,-53,0,123,2,-912,238,0,0,0,0,2
EUW1_6882547652',3,28,8,0,0,0,0,10,1,366,60,24951,28961,29069,10,50,14,2,1,1,0,2,358,103,28803,30745,31161,0,8,-43,-3852,-6,-1784,-2092,-2,-1,-1,0,8
EUW1_6882508925',4,21,1,0,0,0,0,12,0,322,91,20907,25600,20349,6,27,19,2,1,6,0,1,434,93,34669,33598,35477,0,-112,-2,-13762,-18,-7998,-15128,-2,-1,-6,0,11
EUW1_6881796687',6,38,12,0,0,1,0,9,0,366,82,29636,27669,28307,7,50,18,1,0,1,0,8,377,74,29889,28812,34595,1,-11,8,-253,-6,-1143,-6288,-1,0,0,0,1
EUW1_6877265126',3,28,13,0,0,1,0,8,1,390,90,30191,30964,34973,2,28,9,1,0,0,0,5,355,110,26094,30068,24883,0,35,-20,4097,4,896,10090,-1,0,1,0,3
EUW1_6877169136',0,19,10,0,0,1,0,10,0,388,100,27123,31717,31250,8,34,8,1,0,1,0,2,390,88,26146,28688,31308,0,-2,12,977,2,3029,-58,-1,0,0,0,8
EUW1_6877114092',9,32,9,2,0,0,0,13,1,338,84,24679,26474,29736,4,77,12,0,1,1,0,2,373,91,28206,30142,33980,0,-35,-7,-3527,-3,-3668,-4244,2,-1,-1,0,11
EUW1_6876901353',1,33,15,1,1,0,0,7,1,344,128,29859,31200,38105,2,27,11,0,0,1,0,2,357,67,26074,28995,30781,1,-13,61,3785,4,2205,7324,1,1,-1,0,5
EUW1_6876373487',6,35,8,0,0,0,0,4,0,342,70,23827,26334,26320,4,30,13,2,0,0,0,2,337,82,26503,27301,33144,0,5,-12,-2676,-5,-967,-6824,-2,0,0,0,2
EUW1_6876347539',4,27,9,1,0,0,0,9,1,375,65,26149,27481,31532,6,96,18,1,0,2,0,5,354,106,32670,31971,37789,0,21,-41,-6521,-9,-4490,-6257,0,0,-2,0,4
EUW1_6876187816',4,29,17,1,0,0,0,5,1,331,96,29406,28749,31164,4,35,12,1,0,0,0,3,335,90,27428,28518,30676,1,-4,6,1978,5,231,488,0,0,0,0,2
EUW1_6875457374',2,22,8,0,0,1,0,17,1,346,98,28065,28535,28256,2,29,18,1,0,3,0,5,383,94,30881,32265,33999,0,-37,4,-2816,-10,-3730,-5743,-1,0,-2,0,12
EUW1_6875412122',4,26,7,0,0,1,0,9,0,333,82,24806,28584,29745,4,28,15,2,0,1,0,7,371,86,28595,29795,35134,0,-38,-4,-3789,-8,-1211,-5389,-2,0,0,0,2
EUW1_6875352530',2,45,11,0,0,0,0,5,1,332,108,26247,28481,34727,3,28,12,2,0,0,0,2,326,95,25796,29059,30805,0,6,13,451,-1,-578,3922,-2,0,0,0,3
EUW1_6874544701',3,31,20,1,0,0,0,12,1,378,83,31473,31735,38550,5,27,14,0,0,3,0,2,389,105,29385,30117,26597,0,-11,-22,2088,6,1618,11953,1,0,-3,0,10
EUW1_6872967257',6,32,7,0,0,0,0,9,1,341,94,26457,26013,33624,8,38,15,2,0,4,0,8,308,82,28474,27126,30939,0,33,12,-2017,-8,-1113,2685,-2,0,-4,0,1
EUW1_6872715627',3,23,12,1,0,0,0,5,1,342,104,26417,28691,29625,5,33,6,1,0,0,0,2,344,98,23668,27781,32018,0,-2,6,2749,6,910,-2393,0,0,0,0,3
EUW1_6852872454',3,31,6,0,0,0,0,15,0,251,64,22542,22475,23292,3,27,20,1,1,3,0,1,356,112,33176,28549,31420,0,-105,-48,-10634,-14,-6074,-8128,-1,-1,-3,0,14
EUW1_6882541559',5,28,5,1,0,0,0,8,0,400,100,25898,29562,18363,2,139,10,1,0,1,0,7,422,92,29275,32939,33722,0,-22,8,-3377,-5,-3377,-15359,0,0,-1,0,1
EUW1_6878188600',3,64,12,0,0,0,0,11,0,365,92,27562,29029,33406,3,30,19,2,1,2,0,3,333,82,30296,32826,40306,0,32,10,-2734,-7,-3797,-6900,-2,-1,-2,0,8
EUW1_6877576196',6,32,15,0,0,0,0,6,1,375,106,29603,30836,34276,5,31,11,1,0,1,0,7,332,98,26831,29088,25091,0,43,8,2772,4,1748,9185,-1,0,-1,0,-1
EUW1_6877051418',3,27,10,1,0,1,0,11,1,347,99,26233,29340,24479,1,24,8,1,0,1,0,1,371,80,26207,28360,28858,0,-24,19,26,2,980,-4379,0,0,0,0,10
EUW1_6876825809',5,29,16,1,0,1,0,9,1,411,90,30035,31692,32519,0,23,5,0,0,1,0,2,398,96,25840,30062,25714,1,13,-6,4195,11,1630,6805,1,0,0,0,7
EUW1_6876216948',4,36,17,1,0,1,0,8,1,374,103,30867,31922,33983,2,20,10,1,0,0,0,3,363,84,25767,29152,28107,0,11,19,5100,7,2770,5876,0,0,1,0,5
EUW1_6876151010',3,30,17,0,0,1,0,8,1,373,128,31577,32237,35720,1,23,8,1,0,1,0,4,344,83,25549,27557,27603,1,29,45,6028,9,4680,8117,-1,0,0,0,4
EUW1_6876019465',1,34,15,1,0,0,0,12,1,338,76,29318,29038,32276,2,29,25,1,0,3,0,1,344,87,35864,31093,47518,0,-6,-11,-6546,-10,-2055,-15242,0,0,-3,0,11
EUW1_6875747723',4,56,12,0,0,0,0,16,0,323,68,28539,27604,39298,3,28,21,1,0,2,0,3,373,94,32896,30415,37205,0,-50,-26,-4357,-9,-2811,2093,-1,0,-2,0,13
EUW1_6875679721',6,38,8,1,0,0,0,9,0,329,64,24557,28746,25805,3,26,13,0,0,2,0,4,407,111,30285,30962,34014,0,-78,-47,-5728,-5,-2216,-8209,1,0,-2,0,5
EUW1_6875472334',4,27,10,1,0,0,0,12,0,352,98,26472,28600,30446,3,87,18,1,0,2,0,3,391,82,31640,32259,33738,0,-39,16,-5168,-8,-3659,-3292,0,0,-2,0,9
EUW1_6875442574',3,23,7,0,0,0,0,11,1,357,102,25533,29178,31435,4,34,15,2,0,1,0,2,351,104,28732,31210,35881,0,6,-2,-3199,-8,-2032,-4446,-2,0,-1,0,9
EUW1_6875408525',7,30,9,1,0,1,0,6,1,397,112,27292,32522,26580,4,28,9,1,0,0,0,4,383,83,25997,30638,35691,0,14,29,1295,0,1884,-9111,0,0,1,0,2
EUW1_6874350098',1,59,7,0,0,1,0,9,0,368,68,24837,27726,27888,2,101,11,1,1,1,0,3,359,92,27012,30279,30715,0,9,-24,-2175,-4,-2553,-2827,-1,-1,0,0,6
EUW1_6874294053',2,30,10,0,0,0,0,9,0,402,102,28959,32439,27482,2,24,12,2,0,1,0,4,394,84,28017,29006,31545,1,8,18,942,-2,3433,-4063,-2,0,-1,0,5
EUW1_6874247786',3,26,18,1,1,2,0,14,1,363,100,30204,32067,35960,2,26,8,1,0,2,0,8,419,80,27177,29964,24757,1,-56,20,3027,10,2103,11203,0,1,0,0,6
EUW1_6874075296',4,30,15,2,0,1,0,10,1,368,106,29867,32730,34731,9,35,12,0,0,1,0,6,368,74,27293,29142,35449,1,0,32,2574,3,3588,-718,2,0,0,0,4
EUW1_6874042005',3,25,15,0,1,1,0,17,0,311,79,28747,28806,35962,1,25,17,2,0,2,0,6,344,92,30240,31955,36819,0,-33,-13,-1493,-2,-3149,-857,-2,1,-1,0,11
EUW1_6874016494',2,25,14,1,0,0,0,11,1,351,81,28585,28121,35853,2,26,16,0,1,1,0,2,342,82,28133,29894,34053,1,9,-1,452,-2,-1773,1800,1,-1,-1,0,9
EUW1_6883592067',7,29,15,0,0,1,0,8,0,344,76,29193,29090,32647,1,24,20,2,0,0,0,7,331,104,30734,30105,36163,0,13,-28,-1541,-5,-1015,-3516,-2,0,1,0,1
EUW1_6883566594',2,23,16,2,0,1,0,4,1,374,90,29708,29487,36239,7,38,12,0,0,1,0,3,325,76,26601,27882,33082,1,49,14,3107,4,1605,3157,2,0,0,0,1
EUW1_6882120958',3,59,16,0,1,0,0,10,0,371,100,30537,32007,36425,4,64,14,1,0,1,0,4,347,95,28532,30487,30416,1,24,5,2005,2,1520,6009,-1,1,-1,0,6
EUW1_6876887994',8,33,10,1,0,0,0,10,0,349,97,26235,30063,36121,3,95,17,1,0,0,0,3,377,118,30420,33625,35752,0,-28,-21,-4185,-7,-3562,369,0,0,0,0,7
EUW1_6876854017',2,25,9,0,0,0,0,12,1,294,72,23811,27529,34084,4,25,17,2,0,3,0,1,337,80,30791,30654,42457,0,-43,-8,-6980,-8,-3125,-8373,-2,0,-3,0,11
EUW1_6876819733',2,58,12,0,0,0,0,3,0,409,94,27935,32564,30035,5,131,6,1,0,1,0,7,364,106,24806,30655,27337,1,45,-12,3129,6,1909,2698,-1,0,-1,0,-4
EUW1_6876743204',6,30,22,1,0,1,0,11,1,323,76,31315,29883,43183,4,34,16,1,0,1,0,8,363,56,30595,31463,44652,0,-40,20,720,6,-1580,-1469,0,0,0,0,3
EUW1_6876076786',2,20,8,0,0,0,0,8,1,323,94,24746,27548,27055,8,30,13,2,0,0,0,0,394,82,28073,30250,39678,0,-71,12,-3327,-5,-2702,-12623,-2,0,0,0,8
EUW1_6876016519',5,25,14,1,0,0,0,9,1,364,82,27372,29748,32946,3,36,9,1,0,0,0,2,319,126,26188,30079,31064,0,45,-44,1184,5,-331,1882,0,0,0,0,7
EUW1_6875946313',8,38,22,1,0,0,0,15,1,334,73,31715,29729,47351,4,24,26,0,0,1,0,3,339,86,34842,31493,58007,0,-5,-13,-3127,-4,-1764,-10656,1,0,-1,0,12
EUW1_6875577339',1,24,17,1,0,3,0,13,1,372,83,32654,31873,46439,4,30,13,1,0,1,0,5,318,98,27682,28503,31812,1,54,-15,4972,4,3370,14627,0,0,2,0,8
EUW1_6875540827',3,36,16,0,0,0,0,10,1,311,80,29155,27033,42383,1,26,22,1,1,2,0,3,382,92,33200,31986,46056,0,-71,-12,-4045,-6,-4953,-3673,-1,-1,-2,0,7
EUW1_6875494854',3,28,19,1,0,1,0,8,1,304,94,31823,31750,44673,2,25,19,1,0,0,0,3,353,85,30076,30213,34184,1,-49,9,1747,0,1537,10489,0,0,1,0,5
EUW1_6875461531',3,27,24,2,0,0,0,9,1,389,81,33821,33091,44820,2,26,17,0,0,1,0,4,304,74,29516,29696,34558,1,85,7,4305,7,3395,10262,2,0,-1,0,5
EUW1_6875399080',1,58,17,1,1,1,0,14,0,259,92,28263,28576,33921,5,64,15,1,0,2,0,3,351,72,29263,28252,41821,0,-92,20,-1000,2,324,-7900,0,1,-1,0,11
EUW1_6875350846',0,62,8,0,0,2,0,7,1,398,100,26717,30468,27789,4,25,5,2,0,1,0,5,370,88,24835,29890,22554,0,28,12,1882,3,578,5235,-2,0,1,0,2
EUW1_6875318072',0,80,10,0,0,3,0,6,1,371,102,29319,30564,34771,5,29,15,2,0,1,0,7,316,92,26569,30267,34673,1,55,10,2750,-5,297,98,-2,0,2,0,-1
EUW1_6875191146',3,23,28,2,0,3,0,4,1,394,108,35203,33152,50082,1,32,11,0,0,0,0,11,261,92,26285,26913,29768,1,133,16,8918,17,6239,20314,2,0,3,0,-7
EUW1_6875167936',3,107,10,1,0,2,0,8,1,410,100,29174,31075,33111,5,88,7,0,0,2,0,6,305,84,23677,26533,28976,1,105,16,5497,3,4542,4135,1,0,0,0,2
EUW1_6883198069',6,26,15,0,0,2,0,9,0,315,69,28926,28143,26031,1,30,14,2,0,2,0,9,332,98,29338,28551,29843,0,-17,-29,-412,1,-408,-3812,-2,0,0,0,0
EUW1_6882756178',5,30,12,1,0,1,0,12,0,347,81,28245,28261,31822,7,25,15,1,0,2,0,4,373,97,30629,30298,31168,0,-26,-16,-2384,-3,-2037,654,0,0,-1,0,8
EUW1_6882717931',2,25,9,0,0,0,0,9,0,357,83,26673,29694,35925,4,26,19,2,1,0,0,2,360,84,30022,32932,47254,1,-3,-1,-3349,-10,-3238,-11329,-2,-1,0,0,7
EUW1_6882677791',4,24,25,1,0,2,0,12,0,362,78,33215,29537,43549,3,28,10,0,0,2,0,6,334,78,27322,26854,26495,1,28,0,5893,15,2683,17054,1,0,0,0,6
EUW1_6882634049',4,36,6,0,0,0,0,13,1,329,85,23416,27966,29918,5,33,12,2,1,4,0,1,380,88,29877,32226,37012,1,-51,-3,-6461,-6,-4260,-7094,-2,-1,-4,0,12
EUW1_6882540177',6,23,5,0,0,0,0,12,0,364,90,24486,28446,31519,6,26,17,2,1,3,0,1,363,90,30790,32037,37591,0,1,0,-6304,-12,-3591,-6072,-2,-1,-3,0,11
EUW1_6882526463',4,24,15,0,0,0,0,13,0,314,65,27521,27148,30387,8,29,15,2,0,1,0,6,328,81,29393,28373,33833,0,-14,-16,-1872,0,-1225,-3446,-2,0,-1,0,7
EUW1_6882492881',5,35,12,1,0,0,0,8,1,317,96,27920,27609,35773,3,26,20,0,0,0,0,4,302,76,30031,28890,39999,0,15,20,-2111,-8,-1281,-4226,1,0,0,0,4
EUW1_6882025693',0,24,19,2,1,4,0,4,1,405,127,34725,34788,33735,3,45,5,0,0,0,0,11,318,84,22433,26367,20364,1,87,43,12292,14,8421,13371,2,1,4,0,-7
EUW1_6881960064',3,31,8,0,0,1,0,7,1,376,85,25713,29014,28516,3,28,11,2,0,0,0,4,336,118,26551,29671,31838,1,40,-33,-838,-3,-657,-3322,-2,0,1,0,3
EUW1_6881901077',4,29,22,1,0,3,0,10,1,383,78,33002,32498,40442,3,28,10,0,0,1,0,10,352,80,25413,28965,29904,0,31,-2,7589,12,3533,10538,1,0,2,0,0
EUW1_6881839618',0,32,16,0,0,0,0,9,1,315,88,30286,29720,34030,4,29,18,1,0,1,0,6,336,72,29733,30097,44107,0,-21,16,553,-2,-377,-10077,-1,0,-1,0,3
EUW1_6881777707',4,26,15,0,0,1,0,2,0,335,66,27770,28272,32156,0,23,11,1,0,0,0,1,314,82,25293,25949,30663,0,21,-16,2477,4,2323,1493,-1,0,1,0,1
EUW1_6881730527',2,38,6,0,0,0,0,11,0,305,79,22966,26461,28225,6,33,25,2,0,1,0,0,326,88,31670,32300,44958,0,-21,-9,-8704,-19,-5839,-16733,-2,0,-1,0,11
EUW1_6880993506',7,31,8,1,0,0,0,7,0,349,110,25642,31020,26456,2,22,12,1,0,1,0,2,362,94,28118,30405,33518,0,-13,16,-2476,-4,615,-7062,0,0,-1,0,5
EUW1_6880958782',6,27,19,2,0,0,0,4,1,353,78,29730,31662,37235,2,24,8,0,0,1,0,6,313,85,24411,27613,34980,1,40,-7,5319,11,4049,2255,2,0,-1,0,-2
EUW1_6879475523',7,22,18,2,0,1,0,11,1,345,98,31569,31353,32370,2,22,15,0,0,1,0,4,357,80,27830,30382,27409,1,-12,18,3739,3,971,4961,2,0,0,0,7
EUW1_6878254499',4,24,15,1,0,1,0,6,0,397,88,28852,31209,35010,5,22,5,1,0,0,0,6,322,91,22917,25825,29747,1,75,-3,5935,10,5384,5263,0,0,1,0,0
EUW1_6878171096',3,19,13,0,0,0,0,5,0,426,80,28750,30432,24304,4,23,11,2,0,0,0,5,434,92,27882,31813,26115,1,-8,-12,868,2,-1381,-1811,-2,0,0,0,0
EUW1_6878125767',1,26,7,0,0,0,0,3,1,319,85,23571,26024,28536,9,32,11,2,0,0,0,0,338,69,25070,28378,32209,1,-19,16,-1499,-4,-2354,-3673,-2,0,0,0,3
EUW1_6881994779',2,22,7,0,0,0,0,7,1,383,103,26500,28277,28615,5,26,9,2,1,0,0,2,379,92,25933,29637,27820,0,4,11,567,-2,-1360,795,-2,-1,0,0,5
EUW1_6881371848',1,26,14,0,0,0,0,12,0,321,68,26599,27510,28272,3,23,22,1,0,2,0,1,358,92,32272,34043,45775,1,-37,-24,-5673,-8,-6533,-17503,-1,0,-2,0,11
EUW1_6880444494',4,78,22,1,0,2,0,11,1,373,82,33688,33070,39068,1,24,5,1,0,1,0,9,291,90,22853,26662,28059,1,82,-8,10835,17,6408,11009,0,0,1,0,2
EUW1_6880282874',4,86,9,0,1,0,0,6,0,347,98,25649,30758,24734,2,27,6,2,0,1,0,2,376,104,24592,29103,26842,1,-29,-6,1057,3,1655,-2108,-2,1,-1,0,4
EUW1_6879533407',2,22,20,2,0,2,0,10,1,361,67,31099,31007,40943,8,32,12,0,0,1,0,3,321,78,28157,28149,38173,1,40,-11,2942,8,2858,2770,2,0,1,0,7
EUW1_6879001300',5,30,14,0,0,0,0,8,1,328,90,28539,29886,33949,2,29,15,2,0,0,0,7,340,104,28587,28882,31171,1,-12,-14,-48,-1,1004,2778,-2,0,0,0,1
EUW1_6876082470',6,38,9,0,0,0,0,11,0,320,79,24636,26695,30030,2,24,17,2,0,3,0,1,360,79,30744,30122,36781,1,-40,0,-6108,-8,-3427,-6751,-2,0,-3,0,10
EUW1_6875445856',1,24,10,2,0,0,0,10,0,405,104,26660,31394,28699,4,26,9,0,0,1,0,0,394,100,28331,30254,25962,1,11,4,-1671,1,1140,2737,2,0,-1,0,10
EUW1_6869983166',8,35,16,1,1,1,0,4,0,381,120,30924,32899,32730,1,28,8,1,0,0,0,6,325,79,24377,25973,29687,1,56,41,6547,8,6926,3043,0,1,1,0,-2
EUW1_6869809156',3,32,13,1,1,0,0,7,1,369,98,29927,31565,33343,7,29,17,0,0,1,0,4,358,82,29150,29445,39250,1,11,16,777,-4,2120,-5907,1,1,-1,0,3
EUW1_6869738352',3,27,20,1,0,0,0,7,1,347,88,30739,30308,50305,0,23,12,1,0,1,0,8,286,88,25803,27914,30894,1,61,0,4936,8,2394,19411,0,0,-1,0,-1
EUW1_6869300473',3,22,13,1,0,1,0,17,0,315,78,27470,26827,34351,4,47,19,0,0,4,0,7,307,73,32034,29326,42039,0,8,5,-4564,-6,-2499,-7688,1,0,-3,0,10
EUW1_6869279747',2,19,8,0,0,0,0,8,0,355,72,24366,27699,31205,4,26,19,2,0,2,0,1,355,108,31362,32420,35416,0,0,-36,-6996,-11,-4721,-4211,-2,0,-2,0,7
EUW1_6869259161',1,53,13,1,0,0,0,7,0,322,85,26900,28924,35047,4,58,22,1,0,1,0,1,387,78,30984,30589,45098,0,-65,7,-4084,-9,-1665,-10051,0,0,-1,0,6
EUW1_6869237206',3,25,13,0,0,1,0,10,1,369,116,28638,31902,34536,7,31,4,2,0,2,0,2,361,100,24440,28956,26528,0,8,16,4198,9,2946,8008,-2,0,-1,0,8
EUW1_6869223561',5,29,16,1,1,1,0,7,1,370,80,28802,32931,32758,5,24,6,1,0,0,0,3,388,94,25295,30513,29128,1,-18,-14,3507,10,2418,3630,0,1,1,0,4
EUW1_6882410079',4,68,8,0,0,0,0,10,1,359,72,24545,28115,27909,3,74,11,1,0,0,0,1,351,99,27837,29231,28826,0,8,-27,-3292,-3,-1116,-917,-1,0,0,0,9
EUW1_6882318635',3,30,12,1,0,1,0,7,1,361,60,26773,28558,35269,3,107,6,0,0,0,0,4,311,98,23092,27365,27183,1,50,-38,3681,6,1193,8086,1,0,1,0,3
EUW1_6882295397',4,91,21,2,0,1,0,6,0,323,90,29122,31318,38644,2,262,9,0,0,0,0,1,356,89,24806,27921,29015,1,-33,1,4316,12,3397,9629,2,0,1,0,5
EUW1_6881631095',2,40,10,2,0,0,0,11,0,350,104,26186,29534,34948,6,28,7,0,0,1,0,2,344,92,24449,26420,22733,1,6,12,1737,3,3114,12215,2,0,-1,0,9
EUW1_6881274788',4,30,6,1,0,0,0,12,0,352,62,24241,27666,26383,1,239,23,1,0,2,0,2,363,102,31348,32749,43424,0,-11,-40,-7107,-17,-5083,-17041,0,0,-2,0,10
EUW1_6881195863',7,29,11,0,0,1,0,4,1,378,118,29188,31891,35551,3,29,8,1,0,0,0,6,388,109,25092,29801,21291,0,-10,9,4096,3,2090,14260,-1,0,1,0,-2
EUW1_6881131476',6,30,13,0,1,1,0,7,1,339,96,28567,29082,34745,2,60,10,1,0,1,0,5,321,88,25296,28382,33865,0,18,8,3271,3,700,880,-1,1,0,0,2
EUW1_6881095771',0,25,13,2,0,1,0,7,1,373,84,28501,31139,32377,0,27,10,0,0,0,0,6,342,103,25863,30300,27741,1,31,-19,2638,3,839,4636,2,0,1,0,1
EUW1_6881040572',7,241,18,0,0,2,0,11,1,332,86,29953,29569,36318,3,229,14,2,0,1,0,3,337,79,28612,27972,29574,0,-5,7,1341,4,1597,6744,-2,0,1,0,8
EUW1_6881011737',3,65,19,1,0,1,0,8,1,308,64,29669,29464,34625,2,27,10,0,0,0,0,6,350,96,26014,29206,35828,1,-42,-32,3655,9,258,-1203,1,0,1,0,2
EUW1_6880037476',3,27,19,2,1,1,0,10,1,340,93,30064,30823,33063,4,43,11,0,0,1,0,4,345,112,27739,29379,32916,1,-5,-19,2325,8,1444,147,2,1,0,0,6
EUW1_6879971872',1,20,14,1,0,1,0,8,0,377,88,29716,31059,37257,4,29,18,1,0,1,0,5,322,110,27721,30954,29597,1,55,-22,1995,-4,105,7660,0,0,0,0,3
EUW1_6879929086',2,26,12,2,0,2,0,5,1,376,79,28571,30274,31069,5,35,7,0,0,1,0,10,349,86,23513,27167,25690,1,27,-7,5058,5,3107,5379,2,0,1,0,-5
EUW1_6879890780',5,27,6,1,0,1,0,5,1,387,85,26205,29174,27336,9,31,12,1,0,1,0,7,389,91,29016,31536,24982,0,-2,-6,-2811,-6,-2362,2354,0,0,0,0,-2
EUW1_6879803247',3,23,12,2,0,0,0,9,1,401,100,28112,30511,35781,3,35,4,0,0,1,0,3,355,79,24470,27551,25994,1,46,21,3642,8,2960,9787,2,0,-1,0,6
EUW1_6879754336',4,34,19,1,0,1,0,8,1,325,76,29715,31772,37399,2,26,10,0,0,0,0,3,327,93,26335,27032,33987,1,-2,-17,3380,9,4740,3412,1,0,1,0,5
EUW1_6879734697',7,60,18,1,0,1,0,11,1,374,95,31046,31316,31601,3,25,5,0,0,1,0,4,369,72,24431,26742,21610,1,5,23,6615,13,4574,9991,1,0,0,0,7
EUW1_6879674746',5,34,22,1,0,1,0,10,1,364,76,31258,30174,46048,2,27,15,1,0,0,0,8,347,78,28119,29331,40987,0,17,-2,3139,7,843,5061,0,0,1,0,2
EUW1_6879617320',0,24,10,1,1,0,0,8,1,381,97,25649,30073,32030,3,25,13,1,0,0,0,4,393,78,27991,29902,26933,0,-12,19,-2342,-3,171,5097,0,1,0,0,4
EUW1_6879540714',3,37,15,0,0,2,0,17,1,388,120,32156,32117,40387,3,41,10,1,0,1,0,6,355,71,26215,28996,27043,1,33,49,5941,5,3121,13344,-1,0,1,0,11
EUW1_6879492891',5,32,5,0,1,1,0,4,0,435,96,26436,30702,27194,3,30,4,1,0,0,0,5,350,96,22797,28836,16744,1,85,0,3639,1,1866,10450,-1,1,1,0,-1
EUW1_6877162688',6,36,21,1,0,2,0,14,1,379,107,32184,32602,37917,1,28,6,1,0,1,0,2,316,88,24114,27516,27574,1,63,19,8070,15,5086,10343,0,0,1,0,12
EUW1_6877106905',1,21,2,0,0,0,0,15,0,292,74,20365,22753,20342,2,38,16,1,0,3,0,3,383,95,30751,31033,31882,0,-91,-21,-10386,-14,-8280,-11540,-1,0,-3,0,12
EUW1_6877048048',5,37,6,0,1,1,0,8,1,401,98,25722,29671,21565,3,28,5,2,0,1,0,4,397,114,25496,30071,15981,1,4,-16,226,1,-400,5584,-2,1,0,0,4
EUW1_6876901727',4,44,13,0,0,1,0,10,1,401,83,29208,30323,36295,4,23,6,2,0,0,0,4,321,96,24084,26991,25671,1,80,-13,5124,7,3332,10624,-2,0,1,0,6
EUW1_6876855770',4,30,16,0,0,0,0,11,1,318,68,27537,27284,31155,3,27,8,2,0,0,0,4,337,98,25469,27138,32600,0,-19,-30,2068,8,146,-1445,-2,0,0,0,7
EUW1_6881038475',9,30,12,0,0,0,0,9,0,287,68,25527,25244,34829,4,25,18,2,0,1,0,3,341,95,29856,30531,41504,1,-54,-27,-4329,-6,-5287,-6675,-2,0,-1,0,6
EUW1_6880995062',3,25,9,0,0,1,0,7,1,409,87,27987,30524,22927,0,21,8,2,0,0,0,5,377,70,24775,30149,29144,0,32,17,3212,1,375,-6217,-2,0,1,0,2
EUW1_6875371911',4,29,10,0,0,0,0,12,1,381,82,26198,27982,24563,4,30,6,2,0,1,0,3,383,90,26630,28038,21189,0,-2,-8,-432,4,-56,3374,-2,0,-1,0,9
EUW1_6875266194',2,22,8,0,1,0,0,8,0,355,99,25999,29942,33481,3,25,13,1,0,0,0,2,355,104,27742,30647,32000,0,0,-5,-1743,-5,-705,1481,-1,1,0,0,6
EUW1_6875203058',5,22,9,0,0,0,0,11,0,324,86,25182,26233,32375,3,33,21,2,0,1,0,1,362,96,30971,32140,38219,1,-38,-10,-5789,-12,-5907,-5844,-2,0,-1,0,10
EUW1_6883576933',1,18,13,0,0,0,0,11,0,269,87,26080,27367,33744,5,27,27,2,0,3,0,1,362,68,33978,32972,56087,0,-93,19,-7898,-14,-5605,-22343,-2,0,-3,0,10
EUW1_6883547471',3,23,11,0,0,0,0,8,1,385,82,27352,29542,29653,3,26,11,1,0,1,0,2,359,101,27564,28360,31037,0,26,-19,-212,0,1182,-1384,-1,0,-1,0,6
EUW1_6883501748',1,28,22,1,1,1,0,8,0,344,102,32159,32054,44783,5,38,14,0,0,0,0,7,327,80,27675,28395,37703,1,17,22,4484,8,3659,7080,1,1,1,0,1
EUW1_6883441396',5,30,16,1,0,1,0,8,0,313,86,28732,27968,31563,5,28,18,0,0,0,0,8,313,72,30202,27253,34705,1,0,14,-1470,-2,715,-3142,1,0,1,0,0
EUW1_6883407250',8,29,20,1,0,0,0,9,1,302,96,29722,30664,38303,4,27,12,1,0,1,0,6,339,76,27495,28390,32425,0,-37,20,2227,8,2274,5878,0,0,-1,0,3
EUW1_6883344731',4,29,16,1,0,0,0,9,0,309,90,27212,28262,33154,4,25,18,0,0,2,0,0,335,73,30441,30487,39082,1,-26,17,-3229,-2,-2225,-5928,1,0,-2,0,9
EUW1_6883290660',6,29,11,1,0,3,0,9,0,354,111,29646,29594,25690,1,29,10,0,0,1,0,11,364,84,26878,29030,29776,1,-10,27,2768,1,564,-4086,1,0,2,0,-2
EUW1_6883210685',6,25,12,1,0,1,0,9,0,335,88,27230,28321,29276,6,31,8,1,0,1,0,5,365,84,25230,27644,28233,1,-30,4,2000,4,677,1043,0,0,0,0,4
EUW1_6883140312',5,24,21,2,0,4,0,4,0,381,122,34512,33551,43620,6,94,12,0,0,0,0,9,318,62,26427,26846,31201,1,63,60,8085,9,6705,12419,2,0,4,0,-5
EUW1_6882861550',4,27,11,0,0,1,0,16,0,329,84,28485,26824,27809,4,31,26,1,0,3,0,7,354,95,34686,31548,40367,0,-25,-11,-6201,-15,-4724,-12558,-1,0,-2,0,9
EUW1_6882812194',3,35,9,0,0,0,0,10,0,347,112,25511,30143,23200,4,36,17,2,0,1,0,6,383,99,30659,32425,38215,0,-36,13,-5148,-8,-2282,-15015,-2,0,-1,0,4
EUW1_6882768405',3,35,10,1,0,1,0,7,0,311,76,25205,27262,24137,5,30,16,1,1,1,0,6,364,99,31046,30397,32640,0,-53,-23,-5841,-6,-3135,-8503,0,-1,0,0,1
EUW1_6882723749',7,36,8,2,0,0,0,8,0,357,86,25208,29448,25449,4,26,15,0,0,0,0,1,372,69,27182,27735,30171,0,-15,17,-1974,-7,1713,-4722,2,0,0,0,7
EUW1_6882677048',4,36,17,0,0,2,0,8,1,354,81,31468,30687,33842,4,51,15,1,0,0,0,7,375,58,27954,29008,38346,1,-21,23,3514,2,1679,-4504,-1,0,2,0,1
EUW1_6882636836',6,32,15,2,0,0,0,10,0,334,90,27326,29326,27225,6,23,11,0,0,1,0,4,380,81,28374,28598,30051,1,-46,9,-1048,4,728,-2826,2,0,-1,0,6
EUW1_6882601874',5,33,12,1,0,1,0,2,0,372,108,29302,32638,37337,3,20,11,1,0,0,0,7,365,92,26516,30600,29076,1,7,16,2786,1,2038,8261,0,0,1,0,-5
EUW1_6882564146',3,58,19,0,0,1,0,9,1,353,82,31079,31326,42579,4,68,14,2,0,1,0,2,323,112,27757,28738,32738,1,30,-30,3322,5,2588,9841,-2,0,0,0,7
EUW1_6882542021',6,30,8,2,0,0,0,5,0,338,94,25451,28991,32240,3,96,12,0,0,0,0,2,371,92,26797,30065,30146,1,-33,2,-1346,-4,-1074,2094,2,0,0,0,3
EUW1_6882200449',4,28,17,2,0,0,0,8,0,360,99,29828,30314,37707,7,36,15,0,0,1,0,5,356,75,28163,28999,28978,1,4,24,1665,2,1315,8729,2,0,-1,0,3
EUW1_6882174124',1,19,17,0,0,0,0,17,0,332,86,31920,30277,35000,7,204,20,1,0,5,0,8,353,73,33572,29978,33414,0,-21,13,-1652,-3,299,1586,-1,0,-5,0,9
EUW1_6883751921',1,41,17,1,0,0,0,12,0,325,56,27336,27262,36444,2,23,16,0,0,2,0,0,394,92,31930,31460,36672,0,-69,-36,-4594,1,-4198,-228,1,0,-2,0,12
EUW1_6883746518',3,30,10,1,0,2,0,8,1,402,104,29319,32749,28578,4,25,6,1,0,0,0,6,366,123,25029,30663,25157,1,36,-19,4290,4,2086,3421,0,0,2,0,2
EUW1_6883263051',3,27,14,0,0,0,0,4,0,337,84,27744,29776,35196,4,22,16,2,0,0,0,1,338,96,28318,32014,38040,0,-1,-12,-574,-2,-2238,-2844,-2,0,0,0,3
EUW1_6883209100',2,26,16,2,1,0,0,9,1,354,101,28408,30676,39972,3,32,4,0,0,0,0,2,337,70,22974,26493,26085,1,17,31,5434,12,4183,13887,2,1,0,0,7
EUW1_6883147927',5,29,24,2,0,1,0,5,1,377,98,34036,33864,38598,5,50,9,0,0,1,0,10,307,90,24646,28161,28234,1,70,8,9390,15,5703,10364,2,0,0,0,-5
EUW1_6883086589',2,311,11,2,0,1,0,8,1,352,102,28279,30318,32147,4,28,9,0,0,1,0,1,351,78,26234,29489,31774,0,1,24,2045,2,829,373,2,0,0,0,7
EUW1_6882550120',3,29,5,0,0,0,0,7,1,388,96,24844,30681,27079,9,60,12,1,0,0,0,2,387,100,28123,31667,33535,0,1,-4,-3279,-7,-986,-6456,-1,0,0,0,5
EUW1_6882525028',1,188,12,2,0,1,0,3,0,392,94,28375,30916,22385,1,20,4,0,0,0,0,5,350,94,22767,27451,17286,1,42,0,5608,8,3465,5099,2,0,1,0,-2
EUW1_6882493814',2,28,10,1,1,1,0,4,0,397,106,28297,31261,26020,5,39,9,0,0,0,0,5,387,90,25475,29538,25737,0,10,16,2822,1,1723,283,1,1,1,0,-1
EUW1_6882461992',2,26,15,1,0,1,0,14,0,330,84,29467,30200,36088,4,43,14,0,0,2,0,5,343,73,28223,29263,28732,0,-13,11,1244,1,937,7356,1,0,-1,0,9
EUW1_6882388966',3,28,8,0,1,1,0,12,0,362,90,25671,29435,22824,3,28,16,2,0,2,0,4,367,108,30754,31219,34515,0,-5,-18,-5083,-8,-1784,-11691,-2,1,-1,0,8
EUW1_6882374812',5,24,17,1,0,1,0,14,1,354,97,30396,31500,38128,0,33,5,0,0,2,0,5,368,82,26870,28175,29591,0,-14,15,3526,12,3325,8537,1,0,-1,0,9
EUW1_6881849129',6,140,16,1,0,1,0,8,0,360,90,28822,30686,32077,6,36,10,0,0,0,0,3,329,69,25768,27842,28771,1,31,21,3054,6,2844,3306,1,0,1,0,5
EUW1_6881789138',5,132,19,1,1,1,0,9,1,374,94,31139,31745,36434,2,24,8,1,0,1,0,7,326,110,25594,29338,29582,1,48,-16,5545,11,2407,6852,0,1,0,0,2
EUW1_6881710773',3,30,8,0,0,0,0,4,0,340,74,24741,27902,33422,5,25,11,1,0,0,0,3,365,90,26508,29684,31326,0,-25,-16,-1767,-3,-1782,2096,-1,0,0,0,1
EUW1_6881660573',0,25,10,0,0,1,0,8,0,363,65,26868,29183,28411,1,23,15,1,1,2,0,2,357,82,29064,30503,28389,0,6,-17,-2196,-5,-1320,22,-1,-1,-1,0,6
EUW1_6881609058',6,52,5,1,0,0,0,14,0,316,89,22085,25734,28491,2,42,14,0,0,3,0,1,359,98,29788,31087,27549,0,-43,-9,-7703,-9,-5353,942,1,0,-3,0,13
EUW1_6881559986',6,33,19,2,0,2,0,10,1,346,108,31766,29914,39953,1,23,14,0,0,0,0,5,299,72,26388,27076,32073,1,47,36,5378,5,2838,7880,2,0,2,0,5
EUW1_6881518434',2,22,20,0,0,0,0,8,0,375,85,30412,31050,44671,6,35,8,1,0,1,0,3,296,98,23702,27434,27155,1,79,-13,6710,12,3616,17516,-1,0,-1,0,5
EUW1_6883465166',2,19,23,0,0,0,0,9,0,368,94,32265,30110,41461,5,29,19,2,0,1,0,4,347,74,30774,29694,40318,0,21,20,1491,4,416,1143,-2,0,-1,0,5
EUW1_6882019476',4,29,9,1,0,1,0,12,0,374,92,27820,29724,28663,2,29,14,1,0,1,0,8,330,85,28465,28706,29311,1,44,7,-645,-5,1018,-648,0,0,0,0,4
EUW1_6881959556',5,32,21,1,0,0,0,11,0,339,78,31466,30890,36024,5,32,13,0,0,2,0,2,387,88,30163,29789,30213,1,-48,-10,1303,8,1101,5811,1,0,-2,0,9
EUW1_6881858340',5,100,7,0,0,0,0,7,1,373,72,24511,26983,29250,10,36,6,1,0,0,0,2,331,80,23877,27291,26238,1,42,-8,634,1,-308,3012,-1,0,0,0,5
EUW1_6881330157',7,31,7,2,0,0,0,7,1,374,98,26032,28471,27702,6,29,8,0,0,0,0,6,381,89,25498,31671,29568,1,-7,9,534,-1,-3200,-1866,2,0,0,0,1
EUW1_6880372046',5,28,11,2,0,2,0,8,1,385,98,29265,30393,29282,2,29,8,0,0,0,0,11,291,111,24808,28331,21594,1,94,-13,4457,3,2062,7688,2,0,2,0,-3
EUW1_6880155348',11,48,21,0,1,0,0,12,1,334,79,31324,31473,37645,2,29,10,2,0,2,0,5,338,108,26825,27884,31667,1,-4,-29,4499,11,3589,5978,-2,1,-2,0,7
EUW1_6880068906',2,25,10,0,0,0,0,9,0,371,84,26842,27195,31266,9,29,20,2,0,1,0,6,322,110,31414,30380,43701,0,49,-26,-4572,-10,-3185,-12435,-2,0,-1,0,3
EUW1_6879977182',7,27,10,1,0,1,0,10,0,344,73,26841,26048,25712,8,94,20,1,0,1,0,2,300,101,29939,29083,32495,0,44,-28,-3098,-10,-3035,-6783,0,0,0,0,8
EUW1_6879948666',4,65,21,1,1,2,0,8,1,382,114,33687,33478,40594,2,51,4,0,0,0,0,7,357,64,22801,26216,23565,1,25,50,10886,17,7262,17029,1,1,2,0,1
EUW1_6879549540',6,28,18,2,1,4,0,10,1,395,91,34042,32288,30931,4,27,8,0,0,0,0,6,331,78,25120,26956,26431,1,64,13,8922,10,5332,4500,2,1,4,0,4
EUW1_6878287893',3,67,11,0,0,0,0,10,0,356,71,26547,28425,29094,5,159,16,2,0,1,0,0,346,104,28909,29677,42158,0,10,-33,-2362,-5,-1252,-13064,-2,0,-1,0,10
EUW1_6878241368',7,194,12,1,0,1,0,14,1,345,66,27532,26732,32963,9,28,19,0,0,1,0,1,371,98,31428,29880,35979,0,-26,-32,-3896,-7,-3148,-3016,1,0,0,0,13
EUW1_6878180785',6,57,4,0,0,0,0,9,0,346,98,24118,26825,27634,6,26,8,1,0,1,0,1,352,92,25570,27439,26146,0,-6,6,-1452,-4,-614,1488,-1,0,-1,0,8
EUW1_6878142242',8,35,15,0,0,0,0,12,1,316,70,27523,28355,34116,4,28,14,2,0,3,0,2,359,97,30050,29735,35500,0,-43,-27,-2527,1,-1380,-1384,-2,0,-3,0,10
EUW1_6877102670',5,28,12,0,0,0,0,12,1,317,89,26977,30439,32930,4,28,14,2,1,1,0,0,369,106,29545,30281,30607,0,-52,-17,-2568,-2,158,2323,-2,-1,-1,0,12
EUW1_6876917570',3,27,13,0,0,1,0,13,1,351,72,28329,28804,33483,3,52,14,2,0,2,0,5,341,77,28932,30346,29484,0,10,-5,-603,-1,-1542,3999,-2,0,-1,0,8
EUW1_6876542774',5,33,12,0,0,0,0,6,0,383,86,28100,30961,35153,2,56,16,2,0,1,0,2,333,61,26981,29198,34757,1,50,25,1119,-4,1763,396,-2,0,-1,0,4
EUW1_6882558791',3,26,28,2,0,4,0,5,1,381,93,35225,33277,46228,2,28,3,0,0,0,0,13,287,90,21067,23805,25018,1,94,3,14158,25,9472,21210,2,0,4,0,-8
EUW1_6881072837',5,30,8,2,1,0,0,2,1,387,110,26307,30550,18436,1,25,2,0,0,0,0,6,389,90,22894,28310,23809,1,-2,20,3413,6,2240,-5373,2,1,0,0,-4
EUW1_6880946142',4,35,15,1,0,1,0,12,1,353,86,29335,30415,36581,6,38,13,1,0,0,0,3,353,94,26990,29647,28171,1,0,-8,2345,2,768,8410,0,0,1,0,9
EUW1_6880153143',5,34,17,1,0,0,0,6,1,355,112,30480,32052,36488,2,26,6,0,0,1,0,6,289,76,22861,25247,21362,1,66,36,7619,11,6805,15126,1,0,-1,0,0
EUW1_6879616150',4,57,11,0,0,0,0,8,1,424,96,27060,30997,27658,4,29,5,2,0,0,0,1,376,96,24768,29258,28029,0,48,0,2292,6,1739,-371,-2,0,0,0,7
EUW1_6879577140',6,33,15,2,1,0,0,10,1,337,88,29157,29247,33995,4,34,5,0,0,3,0,8,357,96,24452,27084,22868,1,-20,-8,4705,10,2163,11127,2,1,-3,0,2
EUW1_6879513038',2,37,11,1,0,0,0,12,1,337,84,25865,27340,25170,7,53,13,1,0,1,0,1,383,83,28725,29796,36852,1,-46,1,-2860,-2,-2456,-11682,0,0,-1,0,11
EUW1_6879483734',6,88,12,1,0,0,0,6,1,407,76,27378,30928,30761,3,27,6,0,0,1,0,3,372,75,25581,30049,23535,1,35,1,1797,6,879,7226,1,0,-1,0,3
EUW1_6878069885',3,24,3,0,0,0,0,13,1,321,63,22711,25896,23495,2,28,15,2,0,2,0,1,406,96,30665,30742,32140,0,-85,-33,-7954,-12,-4846,-8645,-2,0,-2,0,12
EUW1_6877996594',1,20,12,1,0,0,0,14,0,336,97,27415,29080,31149,5,54,22,1,0,0,0,1,336,93,31204,31606,40424,0,0,4,-3789,-10,-2526,-9275,0,0,0,0,13
EUW1_6877979756',2,29,8,0,0,0,0,13,0,321,90,25978,27268,32138,5,23,13,1,0,1,0,3,362,90,28953,30474,35142,0,-41,0,-2975,-5,-3206,-3004,-1,0,-1,0,10
EUW1_6877014761',7,33,15,0,0,0,0,10,1,306,74,27713,26663,31481,5,54,16,2,0,2,0,4,391,89,31344,31352,38507,0,-85,-15,-3631,-1,-4689,-7026,-2,0,-2,0,6
EUW1_6876808838',5,29,5,1,0,0,0,7,0,403,104,24087,30032,30971,4,36,14,1,1,1,0,2,402,132,30868,33501,29580,0,1,-28,-6781,-9,-3469,1391,0,-1,-1,0,5
EUW1_6872673229',5,81,11,2,0,0,0,7,0,364,90,27353,29761,31360,6,68,17,0,0,1,0,2,373,92,29682,31757,36489,0,-9,-2,-2329,-6,-1996,-5129,2,0,-1,0,5
EUW1_6872640783',3,14,10,0,0,1,0,10,0,352,73,25724,28265,29795,4,116,17,2,0,1,0,1,371,75,28969,29936,33404,0,-19,-2,-3245,-7,-1671,-3609,-2,0,0,0,9
EUW1_6872599163',3,27,16,1,0,1,0,10,1,331,104,29718,29605,39388,2,94,15,0,0,1,0,5,304,94,28869,28461,35610,1,27,10,849,1,1144,3778,1,0,0,0,5
EUW1_6872566268',1,79,8,1,1,0,0,12,1,348,97,25350,29340,25869,12,76,14,0,0,1,0,3,366,90,27905,30484,28656,1,-18,7,-2555,-6,-1144,-2787,1,1,-1,0,9
EUW1_6872516878',5,26,15,1,0,1,0,10,1,377,95,29700,29152,28815,6,97,11,1,1,0,0,5,321,103,26816,27755,26234,1,56,-8,2884,4,1397,2581,0,-1,1,0,5
EUW1_6867508663',2,66,24,0,0,4,0,13,1,344,118,35292,32499,37474,5,66,9,0,0,2,0,8,306,62,26263,24751,27691,1,38,56,9029,15,7748,9783,0,0,2,0,5
EUW1_6867450187',6,32,17,2,0,0,0,9,1,401,72,30343,31954,34126,0,92,11,0,1,1,0,3,363,112,28471,32131,26677,1,38,-40,1872,6,-177,7449,2,-1,-1,0,6
EUW1_6867374096',4,23,4,1,0,1,0,8,1,324,89,23428,28048,20148,6,32,12,1,0,0,0,2,378,76,26827,29595,36014,0,-54,13,-3399,-8,-1547,-15866,0,0,1,0,6
EUW1_6867305622',6,61,9,0,0,0,0,7,0,395,75,26292,31149,28652,6,88,8,2,0,0,0,3,366,113,25084,29230,28920,1,29,-38,1208,1,1919,-268,-2,0,0,0,4
EUW1_6866912298',3,58,5,0,0,0,0,15,0,323,82,22847,26238,24911,5,65,20,2,0,3,0,0,381,97,33127,32373,36580,0,-58,-15,-10280,-15,-6135,-11669,-2,0,-3,0,15
EUW1_6866891586',0,53,3,0,0,0,0,15,0,292,75,20965,24316,18559,7,71,20,2,0,5,0,0,400,120,35138,34196,32907,0,-108,-45,-14173,-17,-9880,-14348,-2,0,-5,0,15
EUW1_6866832752',3,65,12,0,0,2,0,10,1,371,96,28489,31449,31297,6,68,13,2,0,0,0,5,347,98,27752,29918,28591,0,24,-2,737,-1,1531,2706,-2,0,2,0,5
EUW1_6866794537',0,69,6,0,0,0,0,7,1,290,78,22389,25433,27257,3,346,20,2,0,1,0,0,366,106,30304,33787,41580,0,-76,-28,-7915,-14,-8354,-14323,-2,0,-1,0,7
EUW1_6866526345',7,25,12,1,0,1,0,7,1,341,86,27654,27650,32116,5,96,9,1,0,0,0,5,375,82,26615,29277,31045,1,-34,4,1039,3,-1627,1071,0,0,1,0,2
EUW1_6866497809',4,34,12,0,0,1,0,11,0,360,101,29055,29447,36138,1,88,14,2,0,1,0,5,311,82,26817,28856,31153,1,49,19,2238,-2,591,4985,-2,0,0,0,6
EUW1_6864903198',2,98,17,1,0,0,0,8,1,317,88,28203,29915,35095,6,63,10,1,0,1,0,1,380,111,27413,30671,35707,1,-63,-23,790,7,-756,-612,0,0,-1,0,7
EUW1_6864858677',1,66,9,1,0,0,0,9,1,351,87,25596,29091,26600,1,79,15,0,0,1,0,0,409,116,30236,33096,33903,0,-58,-29,-4640,-6,-4005,-7303,1,0,-1,0,9
EUW1_6864818604',2,73,10,1,0,1,0,4,0,386,76,28173,30160,29358,5,62,8,0,0,0,0,4,351,80,25073,29058,29480,1,35,-4,3100,2,1102,-122,1,0,1,0,0
EUW1_6864022792',4,156,17,0,0,0,0,10,1,334,92,29308,30582,28228,0,94,11,2,0,0,0,2,345,68,25959,29398,27253,1,-11,24,3349,6,1184,975,-2,0,0,0,8
EUW1_6883597036',3,25,3,0,0,0,0,16,0,330,98,22049,26680,26414,2,29,17,2,0,5,0,0,389,114,33115,32737,29322,0,-59,-16,-11066,-14,-6057,-2908,-2,0,-5,0,16
EUW1_6883572091',4,25,26,1,0,3,0,7,1,420,101,38294,35243,51698,3,87,13,0,0,3,0,8,264,66,25744,26863,25161,1,156,35,12550,13,8380,26537,1,0,0,0,-1
EUW1_6883537633',5,39,8,0,0,1,0,7,0,365,83,26348,28272,23632,4,92,15,1,0,1,0,5,348,100,28399,29092,32567,0,17,-17,-2051,-7,-820,-8935,-1,0,0,0,2
EUW1_6882847840',5,28,16,1,0,1,0,8,1,361,126,31345,32975,29949,2,25,8,0,0,2,0,6,378,64,26231,29783,25953,1,-17,62,5114,8,3192,3996,1,0,-1,0,2
EUW1_6882786358',4,44,18,1,0,2,0,6,1,363,94,30296,31438,43593,3,85,8,1,0,0,0,5,311,82,23674,26848,32757,1,52,12,6622,10,4590,10836,0,0,2,0,1
EUW1_6882748034',5,29,18,1,0,1,0,6,1,373,78,31764,29901,40962,10,39,16,1,0,1,0,8,295,98,27780,28759,34526,1,78,-20,3984,2,1142,6436,0,0,0,0,-2
EUW1_6882705066',3,25,7,0,0,0,0,8,1,336,68,24182,26086,27329,2,26,18,2,1,1,0,2,352,82,29904,31190,40687,0,-16,-14,-5722,-11,-5104,-13358,-2,-1,-1,0,6
EUW1_6882225553',2,86,25,0,0,1,0,10,1,350,82,31429,32230,45892,3,64,10,0,0,1,0,6,308,65,24511,25478,30887,1,42,17,6918,15,6752,15005,0,0,0,0,4
EUW1_6882166201',5,84,23,1,0,1,0,10,0,326,66,33280,29850,43453,3,26,20,1,0,2,0,5,335,104,31108,29481,38856,1,-9,-38,2172,3,369,4597,0,0,-1,0,5
EUW1_6872901483',3,32,15,0,0,0,0,7,0,385,73,28033,30342,44232,3,29,21,1,0,0,0,2,305,104,29941,30003,38684,1,80,-31,-1908,-6,339,5548,-1,0,0,0,5
EUW1_6872833104',1,25,14,1,0,0,0,8,0,395,94,29579,31292,39057,4,27,17,1,0,0,0,3,350,94,29376,31509,32994,1,45,0,203,-3,-217,6063,0,0,0,0,5
EUW1_6872603192',4,28,8,0,0,1,0,6,0,347,84,26619,28136,33314,7,28,15,2,0,1,0,4,379,115,29607,32288,30205,0,-32,-31,-2988,-7,-4152,3109,-2,0,0,0,2
EUW1_6872533821',1,29,16,0,0,0,0,12,1,375,76,30331,30269,40234,1,21,13,1,0,0,0,0,317,95,27212,29188,34615,0,58,-19,3119,3,1081,5619,-1,0,0,0,12
EUW1_6872476064',2,23,9,0,0,2,0,6,1,368,69,27452,28271,26917,2,20,11,2,0,0,0,9,348,110,26923,30263,29086,0,20,-41,529,-2,-1992,-2169,-2,0,2,0,-3
EUW1_6822021733',1,26,9,1,0,1,0,13,1,357,99,28155,28118,29893,5,45,11,1,0,3,0,6,358,97,28417,30699,28123,0,-1,2,-262,-2,-2581,1770,0,0,-2,0,7
EUW1_6821930297',8,28,11,0,0,0,0,9,0,316,96,25325,29812,26733,3,22,12,2,0,0,0,1,361,100,27657,31069,35344,1,-45,-4,-2332,-1,-1257,-8611,-2,0,0,0,8
EUW1_6821853361',2,88,14,2,0,1,0,6,1,348,104,28677,32332,38491,3,29,9,0,0,1,0,4,338,63,25047,28199,27473,1,10,41,3630,5,4133,11018,2,0,0,0,2
EUW1_6820931928',4,25,21,2,0,2,0,13,1,314,89,33216,30781,38031,3,103,17,0,1,0,0,8,351,81,29426,28897,34838,1,-37,8,3790,4,1884,3193,2,-1,2,0,5
EUW1_6798072792',3,25,10,1,0,0,0,12,0,296,104,26365,28175,29917,4,39,24,0,0,2,0,1,405,90,34852,33002,41163,1,-109,14,-8487,-14,-4827,-11246,1,0,-2,0,11
EUW1_6873948889',5,29,17,0,0,1,0,16,0,332,72,29576,28345,35553,5,28,20,2,0,1,0,2,348,80,30116,30563,36193,0,-16,-8,-540,-3,-2218,-640,-2,0,0,0,14
EUW1_6873910988',2,19,12,0,0,1,0,8,0,368,70,28072,28796,35604,1,33,14,2,0,0,0,3,373,98,27891,31277,37711,0,-5,-28,181,-2,-2481,-2107,-2,0,1,0,5
EUW1_6873886582',1,27,11,0,0,0,0,16,0,325,96,27087,28235,28676,3,30,26,2,0,3,0,1,382,135,36197,34783,44039,0,-57,-39,-9110,-15,-6548,-15363,-2,0,-3,0,15
EUW1_6873835505',7,30,12,1,1,0,0,9,1,413,83,28705,31605,30941,6,29,9,1,0,2,0,4,355,86,26591,29808,22871,0,58,-3,2114,3,1797,8070,0,1,-2,0,5
EUW1_6873818956',1,23,9,0,0,1,0,18,0,325,84,27761,27667,31547,4,21,28,2,0,6,0,2,385,92,37523,33737,47654,0,-60,-8,-9762,-19,-6070,-16107,-2,0,-5,0,16
EUW1_6873785407',2,22,8,2,0,0,0,6,1,396,105,26590,32624,32030,0,21,5,0,0,0,0,6,364,78,23832,28267,31169,1,32,27,2758,3,4357,861,2,0,0,0,0
EUW1_6873769433',2,22,10,1,0,0,0,12,0,345,86,25552,28339,25630,3,56,16,0,0,1,0,0,395,90,30470,30431,34413,0,-50,-4,-4918,-6,-2092,-8783,1,0,-1,0,12
EUW1_6873767748',1,28,6,1,0,0,0,5,1,377,82,24357,28390,31376,2,57,11,0,0,0,0,3,395,79,27098,32079,37710,0,-18,3,-2741,-5,-3689,-6334,1,0,0,0,2
EUW1_6873748414',7,37,33,1,0,5,0,7,1,360,111,40121,32610,53897,0,21,17,0,0,0,0,10,262,68,28009,25260,33023,1,98,43,12112,16,7350,20874,1,0,5,0,-3
EUW1_6872390258',0,21,7,0,0,0,0,17,0,366,73,25012,28733,23051,3,26,29,2,0,3,0,4,411,84,35627,34284,43906,0,-45,-11,-10615,-22,-5551,-20855,-2,0,-3,0,13
EUW1_6872381590',2,336,11,0,0,0,0,10,0,325,79,26261,28599,31147,6,25,12,1,1,1,0,3,357,92,28521,30645,35052,0,-32,-13,-2260,-1,-2046,-3905,-1,-1,-1,0,7
EUW1_6872338255',1,27,15,2,0,1,0,8,1,374,80,28789,29212,28229,4,42,6,0,0,1,0,5,360,89,25031,28227,24295,1,14,-9,3758,9,985,3934,2,0,0,0,3
EUW1_6872333007',1,27,21,0,1,0,0,15,0,281,68,31040,27965,41694,1,23,30,2,0,3,0,2,343,98,36342,32032,54808,0,-62,-30,-5302,-9,-4067,-13114,-2,1,-3,0,13
EUW1_6872330593',3,28,17,0,0,2,0,2,1,382,96,32207,32774,39663,4,30,10,1,0,1,0,9,327,84,23737,27644,37550,1,55,12,8470,7,5130,2113,-1,0,1,0,-7
EUW1_6872321758',2,34,17,1,1,2,0,10,1,407,116,34094,32447,35317,3,25,10,1,0,1,0,7,319,87,25922,27584,31140,1,88,29,8172,7,4863,4177,0,1,1,0,3
EUW1_6872307686',2,29,22,1,0,0,0,10,0,305,104,30367,30860,47041,0,25,21,1,0,1,0,1,333,76,31795,29534,45349,0,-28,28,-1428,1,1326,1692,0,0,-1,0,9
EUW1_6869389996',1,29,9,1,0,0,0,11,0,308,85,26050,26384,27701,4,34,19,1,0,2,0,3,355,75,30861,28914,39025,1,-47,10,-4811,-10,-2530,-11324,0,0,-2,0,8
EUW1_6883150313',3,20,10,2,0,0,0,14,0,305,86,25348,27921,28665,7,24,18,0,0,3,0,1,393,102,32885,31770,34458,1,-88,-16,-7537,-8,-3849,-5793,2,0,-3,0,13
EUW1_6872927058',7,26,14,2,0,1,0,5,0,338,114,28138,30452,29691,4,25,10,0,0,1,0,7,354,80,26482,30187,26842,1,-16,34,1656,4,265,2849,2,0,0,0,-2
EUW1_6872885555',5,37,15,2,0,0,0,9,1,365,92,28389,29026,36686,3,40,11,0,0,0,0,3,349,76,26958,29188,31004,1,16,16,1431,4,-162,5682,2,0,0,0,6
EUW1_6872831120',7,30,11,0,0,0,0,8,1,368,107,27676,31341,33673,3,29,10,2,0,1,0,4,393,72,27522,30358,26659,1,-25,35,154,1,983,7014,-2,0,-1,0,4
EUW1_6872772029',9,30,12,0,0,0,0,7,1,364,78,26972,29270,28656,3,71,13,2,0,1,0,1,357,110,28891,30446,31159,0,7,-32,-1919,-1,-1176,-2503,-2,0,-1,0,6
EUW1_6872698763',3,28,15,2,0,2,0,11,0,380,92,29521,32086,40252,2,27,8,0,0,1,0,6,356,92,26396,28876,30749,1,24,0,3125,7,3210,9503,2,0,1,0,5
EUW1_6871667210',4,41,18,1,0,1,0,9,1,359,98,30386,31547,38533,4,31,7,0,0,0,0,6,311,66,24262,27127,28824,1,48,32,6124,11,4420,9709,1,0,1,0,3
EUW1_6871399540',5,26,10,1,0,0,0,12,0,388,86,26983,30488,32870,6,29,19,1,0,2,0,3,341,82,30388,30149,36825,0,47,4,-3405,-9,339,-3955,0,0,-2,0,9
EUW1_6870490033',3,25,10,0,0,0,0,7,1,373,80,26298,28445,32473,3,24,15,1,0,0,0,1,333,90,26979,29111,40939,0,40,-10,-681,-5,-666,-8466,-1,0,0,0,6
EUW1_6870397130',3,53,7,0,0,0,0,10,1,361,86,26874,27534,27251,3,24,9,1,0,1,0,2,347,90,26044,28290,23009,0,14,-4,830,-2,-756,4242,-1,0,-1,0,8
EUW1_6870295141',3,29,9,1,0,0,0,7,0,383,88,25479,27971,27459,4,62,7,0,0,0,0,1,357,75,24339,27282,20349,1,26,13,1140,2,689,7110,1,0,0,0,6
EUW1_6869954350',3,38,10,0,0,0,0,7,1,394,93,26297,29620,24134,4,34,11,2,0,0,0,0,391,97,28311,30903,30236,1,3,-4,-2014,-1,-1283,-6102,-2,0,0,0,7
EUW1_6869898648',4,23,14,1,0,0,0,14,1,262,62,25707,26381,33374,3,23,12,0,0,2,0,3,392,79,28949,29412,34523,0,-130,-17,-3242,2,-3031,-1149,1,0,-2,0,11
EUW1_6869834307',6,41,19,1,0,0,0,11,1,341,85,31891,30293,35090,1,20,10,0,0,2,0,8,287,84,24823,26764,32253,1,54,1,7068,9,3529,2837,1,0,-2,0,3
EUW1_6869756473',6,76,7,0,0,0,0,6,1,345,78,23938,28502,19506,3,55,10,2,0,0,0,1,366,88,25831,30908,26199,0,-21,-10,-1893,-3,-2406,-6693,-2,0,0,0,5
EUW1_6869040703',4,27,14,0,0,1,0,6,1,335,104,28728,29262,30634,0,37,11,1,0,0,0,7,361,84,26192,28150,29666,1,-26,20,2536,3,1112,968,-1,0,1,0,-1
EUW1_6868977050',4,25,6,0,0,1,0,10,1,369,88,26168,26344,27251,5,20,16,1,0,1,0,5,341,112,28558,30669,31641,0,28,-24,-2390,-10,-4325,-4390,-1,0,0,0,5
EUW1_6868918327',4,25,24,2,1,0,0,11,1,283,112,30437,30605,42995,1,23,14,0,0,0,0,7,333,84,27145,28615,36914,1,-50,28,3292,10,1990,6081,2,1,0,0,4
EUW1_6868838379',3,19,13,0,0,0,0,9,1,345,84,27592,29446,35430,0,24,10,2,0,0,0,4,315,96,24869,28394,35991,0,30,-12,2723,3,1052,-561,-2,0,0,0,5
EUW1_6873826520',0,28,10,0,0,0,0,9,0,336,123,27615,29034,23070,5,25,13,2,0,1,0,2,382,96,29050,29474,28961,0,-46,27,-1435,-3,-440,-5891,-2,0,-1,0,7
EUW1_6873804839',5,27,12,1,0,1,0,10,1,359,126,27829,32627,34312,2,28,7,1,0,1,0,3,378,88,26069,29782,35433,1,-19,38,1760,5,2845,-1121,0,0,0,0,7
EUW1_6873777886',0,26,12,2,0,2,0,12,0,378,89,29970,30732,29946,2,24,15,0,0,0,0,7,389,84,29177,30036,35826,0,-11,5,793,-3,696,-5880,2,0,2,0,5
EUW1_6872714870',4,40,14,1,0,1,0,5,0,387,68,28617,31126,35292,2,32,8,0,0,0,0,5,330,92,24131,28950,30105,1,57,-24,4486,6,2176,5187,1,0,1,0,0
EUW1_6872627504',4,44,16,1,0,1,0,9,1,367,104,30861,31673,34561,0,26,5,0,0,1,0,5,336,90,23872,28167,25801,1,31,14,6989,11,3506,8760,1,0,0,0,4
EUW1_6871288572',4,33,11,0,1,0,0,10,0,385,99,27777,30278,27683,1,23,7,1,0,1,0,4,357,92,25158,29773,26358,1,28,7,2619,4,505,1325,-1,1,-1,0,6
EUW1_6869358848',5,36,12,1,0,0,0,8,1,282,72,25508,26017,31202,0,27,13,1,0,2,0,1,347,115,29354,30594,38153,0,-65,-43,-3846,-1,-4577,-6951,0,0,-2,0,7
EUW1_6867890795',7,31,11,1,0,0,0,10,0,297,82,25471,28074,35410,3,31,15,1,0,2,0,1,339,82,28780,27518,36426,0,-42,0,-3309,-4,556,-1016,0,0,-2,0,9
EUW1_6867790035',5,30,13,1,0,1,0,4,1,379,67,28282,28372,35705,5,28,11,0,0,0,0,6,368,87,27267,31479,24878,0,11,-20,1015,2,-3107,10827,1,0,1,0,-2
EUW1_6867761064',5,29,13,2,0,0,0,5,0,394,120,29253,31580,32918,4,33,7,0,0,1,0,6,336,76,24721,28456,30930,1,58,44,4532,6,3124,1988,2,0,-1,0,-1
EUW1_6867722867',1,26,11,1,0,1,0,6,1,367,82,27653,28507,35845,4,131,11,0,0,1,0,5,345,85,27256,28862,36591,1,22,-3,397,0,-355,-746,1,0,0,0,1
EUW1_6867708484',2,25,14,2,0,1,0,10,1,388,106,33178,32334,30740,3,33,6,0,0,1,0,6,375,92,25400,29674,29557,1,13,14,7778,8,2660,1183,2,0,0,0,4
EUW1_6866619440',7,31,11,2,0,1,0,9,0,299,96,26599,27201,33832,2,28,14,0,0,0,0,2,285,80,25938,28411,38609,1,14,16,661,-3,-1210,-4777,2,0,1,0,7
EUW1_6866563544',2,18,13,0,0,0,0,12,0,372,82,28740,30434,36972,8,34,18,2,0,1,0,2,340,106,31100,30138,42690,0,32,-24,-2360,-5,296,-5718,-2,0,-1,0,10
EUW1_6866508170',1,30,9,1,0,1,0,6,1,364,74,26198,29004,33398,1,24,11,0,0,1,0,4,360,102,27176,30389,29577,0,4,-28,-978,-2,-1385,3821,1,0,0,0,2
EUW1_6883357126',3,24,11,0,0,0,0,14,0,313,83,27139,29630,31671,3,28,19,2,0,4,0,1,411,112,33496,34394,43550,0,-98,-29,-6357,-8,-4764,-11879,-2,0,-4,0,13
EUW1_6883099183',1,40,11,1,0,2,0,10,1,428,107,30720,31756,27366,2,26,3,1,0,1,0,6,333,91,22196,26181,16544,1,95,16,8524,8,5575,10822,0,0,1,0,4
EUW1_6883024319',5,342,9,1,1,1,0,11,0,367,114,26605,31974,28630,3,73,5,1,0,1,0,3,404,93,25839,29195,22736,1,-37,21,766,4,2779,5894,0,1,0,0,8
EUW1_6882984474',3,27,18,2,1,2,0,10,1,404,132,30511,32646,40852,1,24,6,0,0,0,0,5,371,96,25623,28744,24578,1,33,36,4888,12,3902,16274,2,1,2,0,5
EUW1_6882306972',2,23,20,1,0,2,0,9,1,374,91,32216,32178,43600,1,56,9,0,0,2,0,7,361,73,26400,30117,31284,0,13,18,5816,11,2061,12316,1,0,0,0,2
EUW1_6882292888',3,25,13,0,0,2,0,12,0,332,80,29076,28860,29957,4,40,18,1,0,1,0,8,343,77,29538,29652,39542,1,-11,3,-462,-5,-792,-9585,-1,0,1,0,4
EUW1_6882279576',0,19,8,0,0,0,0,15,0,269,68,22724,22467,25974,1,68,28,1,0,4,0,1,378,103,35223,32385,38108,0,-109,-35,-12499,-20,-9918,-12134,-1,0,-4,0,14
EUW1_6882232159',3,28,14,1,0,2,0,10,1,376,93,30807,29669,31243,7,30,17,1,0,0,0,5,346,86,28769,29093,31398,0,30,7,2038,-3,576,-155,0,0,2,0,5
EUW1_6882201130',4,63,12,1,0,1,0,9,0,332,107,27256,30809,32033,0,57,11,1,0,0,0,0,371,92,26313,30984,33783,1,-39,15,943,1,-175,-1750,0,0,1,0,9
EUW1_6882163742',5,24,13,0,0,0,0,11,0,388,83,30321,31895,25491,4,29,8,2,0,2,0,5,310,92,24469,25894,28595,1,78,-9,5852,5,6001,-3104,-2,0,-2,0,6
EUW1_6882108735',5,27,5,1,0,0,0,8,0,361,71,23035,28191,26485,2,33,10,0,0,1,0,0,389,99,26919,30644,27766,1,-28,-28,-3884,-5,-2453,-1281,1,0,-1,0,8
EUW1_6882065788',5,25,9,2,0,0,0,16,0,350,64,26517,28775,28253,7,35,14,0,1,2,0,4,400,122,29905,31357,35347,0,-50,-58,-3388,-5,-2582,-7094,2,-1,-2,0,12
EUW1_6879125692',3,23,20,2,1,1,0,11,0,382,124,32622,33170,32191,5,31,6,0,0,2,0,4,305,80,23761,26439,22890,1,77,44,8861,14,6731,9301,2,1,-1,0,7
EUW1_6879083596',9,31,9,0,1,1,0,10,0,368,104,27835,30929,22802,5,61,10,2,0,0,0,4,406,88,27075,29372,28476,0,-38,16,760,-1,1557,-5674,-2,1,1,0,6
EUW1_6879029040',4,34,20,1,0,1,0,8,0,364,86,31594,31585,40392,3,169,15,1,0,2,0,5,344,85,28038,28076,38534,0,20,1,3556,5,3509,1858,0,0,-1,0,3
EUW1_6873723454',4,31,13,1,0,1,0,11,0,277,82,27393,24953,31880,3,30,21,0,1,1,0,2,360,92,31493,29358,41274,0,-83,-10,-4100,-8,-4405,-9394,1,-1,0,0,9
EUW1_6873719452',3,25,12,0,0,0,0,7,0,333,95,27391,28857,36012,1,27,19,1,0,1,0,3,351,76,30294,29556,36275,1,-18,19,-2903,-7,-699,-263,-1,0,-1,0,4
EUW1_6873716068',1,41,11,1,1,1,0,11,0,382,96,26878,30881,26073,6,44,10,0,0,1,0,3,378,71,26372,29414,28856,1,4,25,506,1,1467,-2783,1,1,0,0,8
EUW1_6879984093',0,34,8,0,0,0,0,12,0,338,80,24795,27104,34140,0,22,19,1,0,2,0,0,400,76,31865,33060,36037,0,-62,4,-7070,-11,-5956,-1897,-1,0,-2,0,12
EUW1_6879940052',8,30,17,1,0,0,0,4,0,359,74,28805,29584,34111,4,31,14,0,0,0,0,3,335,90,26812,28075,30464,1,24,-16,1993,3,1509,3647,1,0,0,0,1
EUW1_6883028968',1,27,11,1,0,0,0,8,0,300,86,25118,28623,36497,1,286,12,0,0,1,0,3,362,118,28563,30623,34361,1,-62,-32,-3445,-1,-2000,2136,1,0,-1,0,5
EUW1_6882850844',6,33,15,0,0,0,0,9,1,373,80,29992,30069,33366,9,33,22,1,0,2,0,5,357,90,31120,31494,35797,0,16,-10,-1128,-7,-1425,-2431,-1,0,-2,0,4
EUW1_6882809099',4,42,22,2,0,0,0,12,0,344,94,30775,31687,48694,1,19,12,0,0,0,0,4,345,65,27061,28302,40711,1,-1,29,3714,10,3385,7983,2,0,0,0,8
EUW1_6881578576',4,27,14,0,1,0,0,12,0,263,96,26855,27525,33490,5,27,15,2,0,1,0,2,366,87,29509,30292,44253,0,-103,9,-2654,-1,-2767,-10763,-2,1,-1,0,10
EUW1_6881479352',1,27,16,2,0,1,0,10,0,367,124,30635,32799,41497,2,20,14,0,0,1,0,3,381,60,27413,30649,31196,1,-14,64,3222,2,2150,10301,2,0,0,0,7
EUW1_6881366565',5,28,16,2,1,0,0,14,0,384,78,29257,32448,36479,1,27,10,0,0,1,0,3,387,97,27441,28781,27299,1,-3,-19,1816,6,3667,9180,2,1,-1,0,11
EUW1_6881267621',8,23,17,0,0,0,0,8,1,349,100,28408,31363,35782,2,22,18,1,0,1,0,3,377,98,30030,32059,41391,0,-28,2,-1622,-1,-696,-5609,-1,0,-1,0,5
EUW1_6881182449',3,24,8,1,1,4,0,7,1,397,87,28933,29159,34305,5,33,14,1,0,1,0,7,314,70,26855,29203,32559,1,83,17,2078,-6,-44,1746,0,1,3,0,0
EUW1_6871947448',4,25,12,0,0,0,0,15,1,313,64,27827,29263,41674,2,33,26,1,0,5,0,1,375,91,35737,33088,47620,0,-62,-27,-7910,-14,-3825,-5946,-1,0,-5,0,14
EUW1_6871856381',2,54,14,0,0,2,0,9,1,318,94,28605,28391,34679,4,59,13,1,0,1,0,5,356,71,27534,29302,37161,0,-38,23,1071,1,-911,-2482,-1,0,1,0,4
EUW1_6871655139',0,27,16,0,0,0,0,9,0,378,72,27986,31534,38629,3,22,9,1,1,0,0,1,353,92,25597,30304,39460,0,25,-20,2389,7,1230,-831,-1,-1,0,0,8
EUW1_6871519020',2,65,7,0,0,0,0,10,0,368,76,25507,28410,35061,3,55,11,1,0,2,0,6,394,84,29098,30147,34964,0,-26,-8,-3591,-4,-1737,97,-1,0,-2,0,4
EUW1_6871486602',5,26,14,1,0,0,0,11,1,350,81,27027,28758,35663,0,20,14,1,0,2,0,2,410,74,30378,31297,33809,0,-60,7,-3351,0,-2539,1854,0,0,-2,0,9
EUW1_6871444058',2,26,10,0,0,0,0,12,1,341,82,25666,28116,33102,2,64,16,2,0,1,0,2,409,92,30539,30982,37349,0,-68,-10,-4873,-6,-2866,-4247,-2,0,-1,0,10
EUW1_6871400710',2,25,10,0,0,0,0,5,1,375,79,26747,29649,30626,3,21,8,2,0,0,0,4,364,112,25185,28859,26034,0,11,-33,1562,2,790,4592,-2,0,0,0,1
EUW1_6870260447',2,26,15,1,1,1,0,5,1,364,107,30097,32019,32072,1,23,12,0,0,1,0,8,326,68,25763,28015,28222,1,38,39,4334,3,4004,3850,1,1,0,0,-3
EUW1_6870073929',4,50,15,1,0,0,0,10,0,349,70,28707,29736,37872,3,26,19,1,0,1,0,4,348,101,30665,31295,38467,1,1,-31,-1958,-4,-1559,-595,0,0,-1,0,6
EUW1_6869986642',3,31,13,0,0,1,0,8,1,331,98,28907,28404,31514,6,28,16,1,0,2,0,7,325,89,29054,29301,32806,0,6,9,-147,-3,-897,-1292,-1,0,-1,0,1
EUW1_6869628145',6,36,14,0,0,1,0,9,1,357,88,27436,29746,35591,5,32,12,1,0,1,0,1,350,72,26275,28136,34225,1,7,16,1161,2,1610,1366,-1,0,0,0,8
EUW1_6880966515',3,308,18,0,0,0,0,5,0,383,112,30126,33676,33274,6,41,11,1,0,0,0,3,291,79,24814,25947,33780,1,92,33,5312,7,7729,-506,-1,0,0,0,2
EUW1_6880946672',2,31,26,1,0,4,0,7,1,419,88,35358,33915,47001,2,29,4,0,0,0,0,7,354,89,22135,26343,27631,1,65,-1,13223,22,7572,19370,1,0,4,0,0
EUW1_6880915171',4,29,16,1,0,1,0,6,1,370,100,30780,31177,39526,4,38,8,1,0,2,0,11,353,62,24306,27387,30690,1,17,38,6474,8,3790,8836,0,0,-1,0,-5
EUW1_6879692793',2,51,17,0,0,0,0,6,1,354,78,30045,29175,31621,4,25,12,1,0,3,0,8,326,104,28611,29908,35050,1,28,-26,1434,5,-733,-3429,-1,0,-3,0,-2
EUW1_6879627452',7,34,14,1,0,0,0,12,0,312,96,28875,29583,28026,5,39,13,1,0,1,0,3,357,88,28412,28275,38856,0,-45,8,463,1,1308,-10830,0,0,-1,0,9
EUW1_6879598347',1,25,12,2,1,2,0,3,1,391,104,28825,30570,36244,2,34,9,0,0,0,0,4,300,74,23955,27122,24594,1,91,30,4870,3,3448,11650,2,1,2,0,-1
EUW1_6879564885',4,34,11,1,0,3,0,4,0,352,83,28521,28337,38647,3,52,6,1,0,0,0,8,323,71,23490,26365,27184,0,29,12,5031,5,1972,11463,0,0,3,0,-4
EUW1_6879527058',4,41,6,0,0,0,0,8,1,361,80,24664,27798,29000,8,31,14,2,0,1,0,5,351,102,28656,30300,30511,0,10,-22,-3992,-8,-2502,-1511,-2,0,-1,0,3
EUW1_6877329023',5,39,9,1,0,0,0,4,1,306,74,25148,26144,22020,7,49,15,1,0,0,0,2,352,76,27638,28258,33313,1,-46,-2,-2490,-6,-2114,-11293,0,0,0,0,2
EUW1_6877276231',4,30,8,1,0,0,0,10,1,377,83,25657,28880,30487,3,164,17,0,0,1,0,1,398,83,31189,32890,34362,0,-21,0,-5532,-9,-4010,-3875,1,0,-1,0,9
EUW1_6877225901',3,42,15,0,0,0,0,6,1,348,87,27857,29523,42269,1,25,12,0,0,0,0,2,314,52,24771,27542,36884,1,34,35,3086,3,1981,5385,0,0,0,0,4
EUW1_6877185704',6,140,18,1,0,1,0,9,0,328,83,28361,29619,38014,5,28,8,0,0,1,0,5,319,68,25848,25786,27738,1,9,15,2513,10,3833,10276,1,0,0,0,4
EUW1_6877129862',2,50,16,1,1,0,0,9,1,334,99,29141,30985,40222,7,33,14,1,0,0,0,2,365,84,27537,28638,35260,0,-31,15,1604,2,2347,4962,0,1,0,0,7
EUW1_6877073143',5,27,8,2,1,2,0,8,0,356,108,27120,28773,23640,1,15,12,0,0,0,0,9,306,80,26679,26551,25341,0,50,28,441,-4,2222,-1701,2,1,2,0,-1
EUW1_6875222176',4,24,13,1,0,0,0,8,1,388,101,28604,30258,28686,1,23,12,0,0,2,0,8,348,70,27075,28325,27403,0,40,31,1529,1,1933,1283,1,0,-2,0,0
EUW1_6875201924',8,29,12,1,0,1,0,7,1,312,106,26793,28180,38200,1,24,12,1,0,0,0,1,356,90,27001,30277,41361,0,-44,16,-208,0,-2097,-3161,0,0,1,0,6
EUW1_6875178913',5,30,13,1,1,0,0,7,0,393,84,28853,31673,34497,5,34,11,0,0,1,0,2,376,63,26046,28384,31542,1,17,21,2807,2,3289,2955,1,1,-1,0,5
EUW1_6875161718',3,31,9,1,0,1,0,11,1,386,86,27128,29968,27309,2,28,11,1,0,1,0,5,352,88,27939,30056,34247,0,34,-2,-811,-2,-88,-6938,0,0,0,0,6
EUW1_6873864806',5,31,6,0,0,0,0,13,0,357,120,25749,30897,22804,4,25,8,2,0,2,0,2,422,89,28571,30489,28596,0,-65,31,-2822,-2,408,-5792,-2,0,-2,0,11
EUW1_6873838980',5,38,12,0,0,0,0,8,0,357,97,26948,28207,24865,6,25,12,2,1,2,0,1,351,98,28127,28451,32450,0,6,-1,-1179,0,-244,-7585,-2,-1,-2,0,7
EUW1_6883508777',6,31,13,0,0,1,0,6,1,292,94,27163,26179,31772,6,32,17,1,0,0,0,3,310,77,27653,27138,35578,1,-18,17,-490,-4,-959,-3806,-1,0,1,0,3
EUW1_6883468769',1,27,10,1,0,0,0,12,0,309,74,26045,25458,36038,5,27,22,1,0,2,0,4,299,77,32080,28573,42068,0,10,-3,-6035,-12,-3115,-6030,0,0,-2,0,8
EUW1_6883348905',3,22,14,0,0,0,0,4,0,366,102,28818,30826,37743,4,24,7,1,0,1,0,8,354,78,25080,29093,33601,0,12,24,3738,7,1733,4142,-1,0,-1,0,-4
EUW1_6883284407',7,32,16,0,0,0,0,9,0,362,85,28859,31443,36589,2,23,6,1,0,0,0,3,392,90,25175,29763,25108,1,-30,-5,3684,10,1680,11481,-1,0,0,0,6
EUW1_6883196002',3,29,14,0,0,2,0,11,1,327,74,28961,27269,29484,1,32,22,1,1,1,0,7,317,82,31152,29320,39406,0,10,-8,-2191,-8,-2051,-9922,-1,-1,1,0,4
EUW1_6883138276',5,69,6,0,0,0,0,12,1,357,74,25015,27410,23893,7,30,16,0,1,2,0,1,417,99,31676,31676,33919,0,-60,-25,-6661,-10,-4266,-10026,0,-1,-2,0,11
EUW1_6877566981',3,44,8,0,0,0,0,6,0,360,86,24843,29631,26559,4,28,13,1,0,0,0,3,346,104,26878,30775,32469,0,14,-18,-2035,-5,-1144,-5910,-1,0,0,0,3
EUW1_6877344721',3,26,10,0,0,0,0,7,1,357,66,25269,28153,29710,7,32,9,1,0,0,0,0,343,82,24393,28161,27735,1,14,-16,876,1,-8,1975,-1,0,0,0,7
EUW1_6877092097',0,23,8,0,0,0,0,10,1,356,106,25141,29731,31637,7,28,12,2,0,0,0,3,369,85,26505,30987,37395,0,-13,21,-1364,-4,-1256,-5758,-2,0,0,0,7
EUW1_6876771528',9,32,13,1,0,1,0,8,1,369,77,28026,28967,35827,8,103,17,1,0,0,0,5,345,98,28364,31294,33429,1,24,-21,-338,-4,-2327,2398,0,0,1,0,3
EUW1_6876726289',4,37,16,1,0,1,0,5,1,405,110,30475,33820,33805,0,21,4,1,0,0,0,7,360,97,23198,29127,27805,1,45,13,7277,12,4693,6000,0,0,1,0,-2
EUW1_6876685760',5,28,9,0,1,1,0,6,0,383,101,27923,32429,33887,5,31,8,2,0,0,0,7,347,100,25548,29058,27036,0,36,1,2375,1,3371,6851,-2,1,1,0,-1
EUW1_6881465791',1,20,14,0,0,0,0,6,0,373,82,28532,29730,30193,3,28,16,2,1,1,0,3,413,107,30996,32833,27232,1,-40,-25,-2464,-2,-3103,2961,-2,-1,-1,0,3
EUW1_6881401880',4,21,13,0,0,0,0,10,1,363,103,28576,31533,31309,1,106,13,2,0,1,0,1,356,104,28648,31629,36046,0,7,-1,-72,0,-96,-4737,-2,0,-1,0,9
EUW1_6881350116',0,18,9,0,0,0,0,11,0,306,88,25108,27506,28629,3,95,24,1,0,3,0,2,387,68,33885,32626,45755,0,-81,20,-8777,-15,-5120,-17126,-1,0,-3,0,9
EUW1_6878811272',1,21,11,0,0,0,0,14,0,349,92,26745,29106,32063,3,24,11,1,0,0,0,2,347,107,27321,28817,33476,0,2,-15,-576,0,289,-1413,-1,0,0,0,12
EUW1_6878747392',4,35,17,2,1,0,0,13,1,340,98,29277,30294,32759,7,46,7,0,0,0,0,3,384,72,27151,27332,29148,1,-44,26,2126,10,2962,3611,2,1,0,0,10
EUW1_6878549880',0,25,14,1,0,1,0,8,0,355,94,29243,30657,35517,3,30,10,0,0,0,0,0,366,87,25981,28149,28517,1,-11,7,3262,4,2508,7000,1,0,1,0,8
EUW1_6874287962',3,25,15,0,0,1,0,11,0,336,93,30137,28685,34190,2,25,25,2,0,1,0,8,340,86,33503,32225,42292,0,-4,7,-3366,-10,-3540,-8102,-2,0,0,0,3
EUW1_6874247939',2,30,18,1,0,1,0,12,0,365,86,29777,32958,34933,7,511,13,1,0,1,0,4,356,78,28922,29186,40638,1,9,8,855,5,3772,-5705,0,0,0,0,8
EUW1_6874183280',5,31,13,0,0,2,0,9,1,344,81,29309,27683,29079,2,31,15,1,0,0,0,4,337,89,27722,28338,30312,0,7,-8,1587,-2,-655,-1233,-1,0,2,0,5
EUW1_6873929490',4,39,20,1,0,0,0,5,0,395,84,30294,34318,41319,5,20,6,1,0,0,0,2,356,112,24722,29090,34005,1,39,-28,5572,14,5228,7314,0,0,0,0,3
EUW1_6873367457',4,20,13,1,0,0,0,8,1,346,92,27363,30112,31060,4,27,12,1,0,2,0,5,348,124,28365,31375,34422,0,-2,-32,-1002,1,-1263,-3362,0,0,-2,0,3
EUW1_6873307859',8,46,19,2,0,0,0,15,1,358,84,29972,30880,31154,3,25,9,0,0,2,0,1,380,88,28237,29428,32812,1,-22,-4,1735,10,1452,-1658,2,0,-2,0,14
EUW1_6873064068',6,26,11,1,1,0,0,9,0,350,106,26746,30237,34808,5,33,12,1,0,1,0,1,325,97,26795,30220,29291,1,25,9,-49,-1,17,5517,0,1,-1,0,8
EUW1_6872696719',4,25,15,2,0,0,0,7,1,362,92,29909,29948,35741,2,35,13,0,0,2,0,6,311,87,26323,28264,28008,1,51,5,3586,2,1684,7733,2,0,-2,0,1
EUW1_6870534576',4,27,16,2,0,0,0,10,0,361,99,30223,29591,34644,2,29,11,0,0,2,0,4,363,108,27877,29836,28974,0,-2,-9,2346,5,-245,5670,2,0,-2,0,6
EUW1_6870290628',3,45,13,1,0,0,0,10,1,321,90,26908,28659,24507,1,23,11,1,0,1,0,3,333,104,27272,28631,30658,0,-12,-14,-364,2,28,-6151,0,0,-1,0,7
EUW1_6870205425',6,33,16,2,1,2,0,12,1,379,100,30982,31838,32447,4,24,5,0,0,1,0,8,388,87,25976,29263,24978,1,-9,13,5006,11,2575,7469,2,1,1,0,4
EUW1_6870159514',9,36,23,2,0,3,0,11,1,372,72,33654,29378,38136,4,24,11,0,0,0,0,10,323,84,26707,25974,32720,1,49,-12,6947,12,3404,5416,2,0,3,0,1
EUW1_6870001708',4,27,11,0,0,1,0,9,0,354,58,27427,27516,29200,3,32,14,2,0,0,0,5,336,86,26171,27982,33599,0,18,-28,1256,-3,-466,-4399,-2,0,1,0,4
EUW1_6869925280',4,147,14,0,0,2,0,10,0,389,117,30798,32032,31985,2,51,12,2,0,0,0,8,382,87,28312,30160,26343,0,7,30,2486,2,1872,5642,-2,0,2,0,2
EUW1_6869844623',3,21,11,2,0,1,0,4,1,384,101,29050,29832,32515,3,32,15,0,0,0,0,9,387,79,29028,31679,33906,0,-3,22,22,-4,-1847,-1391,2,0,1,0,-5
EUW1_6868012055',7,29,7,0,0,0,0,12,0,350,81,23835,27044,34218,2,21,22,2,1,1,0,3,349,122,32758,35086,44199,0,1,-41,-8923,-15,-8042,-9981,-2,-1,-1,0,9
EUW1_6881946509',2,23,10,1,0,0,0,8,0,347,76,26466,27375,30307,4,27,13,1,0,2,0,4,366,88,27933,29918,33933,0,-19,-12,-1467,-3,-2543,-3626,0,0,-2,0,4
EUW1_6881841959',6,30,12,2,0,0,0,4,0,401,114,27523,33731,33220,4,27,4,0,0,0,0,2,387,95,23222,28835,24581,0,14,19,4301,8,4896,8639,2,0,0,0,2
EUW1_6880627958',2,27,15,1,1,1,0,6,1,352,80,29372,28962,35285,7,30,16,1,0,0,0,5,283,79,27313,27839,31585,1,69,1,2059,-1,1123,3700,0,1,1,0,1
EUW1_6880577015',2,26,13,1,0,2,0,6,0,402,114,29759,32533,30683,2,23,9,1,0,0,0,9,354,73,24896,28031,26831,1,48,41,4863,4,4502,3852,0,0,2,0,-3
EUW1_6880513456',3,30,13,1,0,1,0,6,1,367,100,28798,30387,36837,4,25,9,0,0,1,0,9,293,70,23023,25722,30922,1,74,30,5775,4,4665,5915,1,0,0,0,-3
EUW1_6880395592',5,45,9,1,0,2,0,4,0,415,93,28795,31398,32100,3,25,9,0,0,0,0,7,340,106,25720,29691,21261,0,75,-13,3075,0,1707,10839,1,0,2,0,-3
EUW1_6880310802',4,30,17,0,1,0,0,9,1,369,76,30497,32097,36919,0,23,9,2,0,1,0,2,330,120,26175,31284,32182,1,39,-44,4322,8,813,4737,-2,1,-1,0,7
EUW1_6880223342',3,24,13,2,0,1,0,12,0,342,86,27883,29100,37680,4,30,17,0,0,1,0,7,312,76,29134,28516,35676,0,30,10,-1251,-4,584,2004,2,0,0,0,5
EUW1_6880164971',3,23,16,2,0,0,0,10,1,331,88,29377,28942,34006,5,37,13,0,0,1,0,6,323,68,26458,27912,33944,0,8,20,2919,3,1030,62,2,0,-1,0,4
EUW1_6880125261',2,23,23,1,1,4,0,12,1,357,103,33704,33019,42809,5,22,8,1,0,2,0,9,307,78,27417,27786,29660,1,50,25,6287,15,5233,13149,0,1,2,0,3
EUW1_6880079702',1,27,9,0,0,0,0,15,0,330,78,23823,28242,24490,6,25,12,2,0,2,0,0,380,86,28854,29752,33837,0,-50,-8,-5031,-3,-1510,-9347,-2,0,-2,0,15
EUW1_6880005729',3,28,15,1,0,0,0,12,1,363,92,28612,29121,34423,7,28,20,1,0,2,0,3,374,84,32220,31226,38024,1,-11,8,-3608,-5,-2105,-3601,0,0,-2,0,9
EUW1_6879939726',2,18,7,0,0,0,0,11,0,338,94,24289,28364,23306,3,26,10,2,0,0,0,2,343,102,26165,30196,35004,0,-5,-8,-1876,-3,-1832,-11698,-2,0,0,0,9
EUW1_6879896139',3,19,24,2,0,3,0,11,1,356,85,36296,31555,40121,3,20,8,0,0,0,0,5,299,89,23879,25454,24451,1,57,-4,12417,16,6101,15670,2,0,3,0,6
EUW1_6879807312',4,29,23,1,0,3,0,7,0,411,69,33557,33051,39592,3,26,8,1,0,0,0,9,285,72,23393,24224,26773,1,126,-3,10164,15,8827,12819,0,0,3,0,-2
EUW1_6879269979',7,33,14,0,0,0,0,9,1,349,77,27747,29905,31548,1,30,8,1,0,1,0,2,354,98,26301,29279,25590,1,-5,-21,1446,6,626,5958,-1,0,-1,0,7
EUW1_6879170910',8,31,19,0,0,0,0,10,1,321,76,31350,29788,37124,2,24,20,2,0,1,0,4,360,104,30613,31555,39010,1,-39,-28,737,-1,-1767,-1886,-2,0,-1,0,6
EUW1_6879070170',2,26,12,0,0,1,0,8,1,349,84,28218,29731,38244,2,26,18,2,0,2,0,6,389,62,30704,32376,36302,1,-40,22,-2486,-6,-2645,1942,-2,0,-1,0,2
EUW1_6878848613',0,39,12,0,0,0,0,6,1,304,96,26032,29140,35319,9,34,20,1,0,1,0,2,380,76,31240,31566,42135,0,-76,20,-5208,-8,-2426,-6816,-1,0,-1,0,4
EUW1_6878780173',2,28,13,1,0,1,0,8,0,369,98,30120,31172,40089,3,26,10,1,0,0,0,4,327,78,25400,29348,31151,0,42,20,4720,3,1824,8938,0,0,1,0,4
EUW1_6881452127',2,25,11,0,0,0,0,8,1,356,96,27557,29565,28704,6,27,21,2,0,1,0,3,348,79,31800,30119,35845,0,8,17,-4243,-10,-554,-7141,-2,0,-1,0,5
EUW1_6881397964',5,20,22,1,0,0,0,7,1,336,96,32218,29986,43071,2,46,10,0,0,1,0,5,335,96,25828,29812,29790,1,1,0,6390,12,174,13281,1,0,-1,0,2
EUW1_6881342497',3,152,9,0,0,0,0,13,0,325,70,24956,29521,28994,4,31,13,1,0,2,0,5,375,104,29942,31160,47184,0,-50,-34,-4986,-4,-1639,-18190,-1,0,-2,0,8
EUW1_6880678141',4,27,16,0,0,0,0,7,0,431,88,31366,32936,36507,2,21,5,0,0,2,0,6,358,92,22704,28280,27585,1,73,-4,8662,11,4656,8922,0,0,-2,0,1
EUW1_6880646993',2,31,9,0,0,0,0,5,1,345,102,25045,28639,27079,3,23,8,1,0,0,0,3,388,75,25253,29178,26632,0,-43,27,-208,1,-539,447,-1,0,0,0,2
EUW1_6880389142',8,31,17,0,0,1,0,6,1,368,94,30124,32583,32394,0,24,12,2,0,0,0,2,347,130,26284,30301,26498,0,21,-36,3840,5,2282,5896,-2,0,1,0,4
EUW1_6880324831',2,31,11,0,0,0,0,15,1,316,88,25634,27990,30899,3,26,20,2,0,3,0,0,375,92,34497,31118,40064,1,-59,-4,-8863,-9,-3128,-9165,-2,0,-3,0,15
EUW1_6878988361',4,27,11,2,0,1,0,12,0,368,90,28521,28935,34906,1,29,13,0,0,0,0,2,341,80,27435,27698,31495,0,27,10,1086,-2,1237,3411,2,0,1,0,10
EUW1_6878920141',6,148,17,1,0,0,0,13,0,356,94,29280,30020,43687,3,30,14,0,1,2,0,3,389,80,29945,31472,36459,0,-33,14,-665,3,-1452,7228,1,-1,-2,0,10
EUW1_6878411359',0,26,27,1,0,1,0,7,1,321,91,33981,32765,45640,5,69,16,0,0,1,0,4,285,76,27403,26858,28714,1,36,15,6578,11,5907,16926,1,0,0,0,3
EUW1_6878278088',2,26,12,0,0,0,0,9,0,323,75,26383,28316,32062,5,50,13,2,0,1,0,1,344,92,28464,28752,38848,1,-21,-17,-2081,-1,-436,-6786,-2,0,-1,0,8
EUW1_6878231398',0,25,10,2,0,1,0,9,1,367,106,27744,30178,31022,4,52,5,0,0,0,0,7,358,90,23906,30027,22938,1,9,16,3838,5,151,8084,2,0,1,0,2
EUW1_6878195686',2,23,9,0,0,0,0,12,0,345,80,25613,27314,26922,4,24,24,2,0,2,0,2,378,102,34586,33139,37290,0,-33,-22,-8973,-15,-5825,-10368,-2,0,-2,0,10
EUW1_6878044862',4,39,16,1,0,0,0,9,0,360,88,28950,30420,37296,2,24,13,1,0,0,0,6,349,88,27479,30020,32956,1,11,0,1471,3,400,4340,0,0,0,0,3
EUW1_6874412931',1,24,7,0,0,2,0,12,1,388,93,27253,29344,38032,2,28,14,2,1,0,0,6,360,98,27045,31618,32080,1,28,-5,208,-7,-2274,5952,-2,-1,2,0,6
EUW1_6874196715',5,29,24,1,1,5,0,8,1,376,82,35713,30534,41537,7,33,11,0,0,0,0,11,304,77,25278,25855,30939,1,72,5,10435,13,4679,10598,1,1,5,0,-3
EUW1_6873287460',8,91,7,1,0,0,0,9,0,362,96,25151,29406,26297,4,32,7,1,0,1,0,3,371,81,25314,28823,24262,1,-9,15,-163,0,583,2035,0,0,-1,0,6
EUW1_6872752554',4,19,11,0,1,1,0,6,0,384,112,28386,32407,30188,4,25,6,2,0,0,0,3,365,80,23711,28827,24876,1,19,32,4675,5,3580,5312,-2,1,1,0,3
EUW1_6883621411',3,29,10,1,0,2,0,12,1,367,96,28693,28552,30996,5,40,14,0,1,0,0,5,376,75,27431,28939,38597,0,-9,21,1262,-4,-387,-7601,1,-1,2,0,7
EUW1_6883606514',4,36,6,1,0,1,0,6,0,405,100,25467,29824,24160,3,41,7,1,1,0,0,0,382,92,24690,29090,20195,1,23,8,777,-1,734,3965,0,-1,1,0,6
EUW1_6883395835',3,96,15,1,0,0,0,14,0,333,79,28210,30528,26767,2,22,10,0,0,4,0,6,393,108,28683,29947,29005,1,-60,-29,-473,5,581,-2238,1,0,-4,0,8
EUW1_6883107053',5,22,18,2,1,6,0,5,1,374,112,35156,31907,43388,1,30,5,0,0,0,0,13,327,80,23333,27975,25048,1,47,32,11823,13,3932,18340,2,1,6,0,-8
EUW1_6883035774',3,26,13,1,0,0,0,11,0,395,102,28223,32152,27433,5,37,5,0,0,0,0,5,384,102,24322,29315,19868,1,11,0,3901,8,2837,7565,1,0,0,0,6
EUW1_6881914012',5,26,13,1,0,0,0,8,0,357,92,27711,28869,30133,2,26,14,1,0,0,0,2,371,87,28237,30498,33500,1,-14,5,-526,-1,-1629,-3367,0,0,0,0,6
EUW1_6881747193',4,30,12,1,0,0,0,7,1,314,62,24833,28357,29455,0,28,16,0,0,1,0,0,378,90,28656,30024,38424,0,-64,-28,-3823,-4,-1667,-8969,1,0,-1,0,7
EUW1_6881625551',6,44,13,1,0,1,0,7,0,384,90,28201,30007,32021,6,31,12,0,0,0,0,3,329,81,26802,29502,27786,1,55,9,1399,1,505,4235,1,0,1,0,4
EUW1_6881470859',2,32,9,0,1,1,0,9,0,406,103,27412,32581,27750,4,41,5,2,0,0,0,1,376,75,23550,27913,21785,1,30,28,3862,4,4668,5965,-2,1,1,0,8
EUW1_6881404583',0,26,6,0,1,0,0,8,0,326,116,24864,29297,22208,3,54,15,2,0,1,0,1,379,111,29730,30798,30532,0,-53,5,-4866,-9,-1501,-8324,-2,1,-1,0,7
EUW1_6880649713',5,30,16,1,0,1,0,11,0,334,81,28030,28637,32031,2,22,11,0,0,1,0,6,354,106,27076,28041,31794,1,-20,-25,954,5,596,237,1,0,0,0,5
EUW1_6880376888',3,29,6,0,0,0,0,7,1,350,122,24276,29796,39714,4,27,15,2,0,1,0,0,414,78,28822,32877,30769,0,-64,44,-4546,-9,-3081,8945,-2,0,-1,0,7
EUW1_6880131837',6,23,12,1,0,0,0,4,1,398,101,28312,29766,33283,8,36,15,0,0,0,0,4,367,86,28584,32140,29678,1,31,15,-272,-3,-2374,3605,1,0,0,0,0
EUW1_6879797600',2,27,18,0,0,0,0,14,0,305,86,29935,29619,36047,5,246,18,2,0,1,0,3,327,86,29923,29162,37147,1,-22,0,12,0,457,-1100,-2,0,-1,0,11
EUW1_6877004182',2,26,16,2,1,2,0,8,1,374,93,29740,32726,31308,4,26,4,0,0,0,0,8,378,113,25049,28915,21950,1,-4,-20,4691,12,3811,9358,2,1,2,0,0
EUW1_6882575411',1,25,7,2,0,0,0,14,1,325,80,23935,26061,26895,5,30,14,0,0,1,0,5,360,120,30067,31883,34875,0,-35,-40,-6132,-7,-5822,-7980,2,0,-1,0,9
EUW1_6882549887',5,28,11,0,1,0,0,7,1,349,79,26910,27696,27048,3,37,9,2,0,1,0,2,408,86,27767,30243,25658,0,-59,-7,-857,2,-2547,1390,-2,1,-1,0,5
EUW1_6882531610',4,25,24,2,1,2,0,9,1,359,108,34415,32037,42318,3,96,9,0,0,0,0,8,312,86,24680,26802,31442,1,47,22,9735,15,5235,10876,2,1,2,0,1
EUW1_6880850786',4,21,13,0,0,0,0,3,1,333,108,27886,28454,36548,4,23,19,0,0,1,0,4,361,95,30738,31326,34827,0,-28,13,-2852,-6,-2872,1721,0,0,-1,0,-1
EUW1_6880837668',4,28,9,0,0,1,0,12,1,357,105,26911,29038,29267,3,31,21,2,0,1,0,2,367,90,31024,32154,39775,0,-10,15,-4113,-12,-3116,-10508,-2,0,0,0,10
EUW1_6880827658',9,35,18,1,1,1,0,11,0,375,105,30875,31575,38760,1,24,7,0,0,0,0,4,369,86,25821,29551,24794,0,6,19,5054,11,2024,13966,1,1,1,0,7
EUW1_6880811107',5,35,20,0,0,2,0,8,0,360,78,32215,31669,35217,3,31,12,1,0,0,0,6,364,107,27241,29351,31877,1,-4,-29,4974,8,2318,3340,-1,0,2,0,2
EUW1_6880806537',3,23,12,1,0,0,0,10,0,342,94,27661,29296,31849,4,44,16,1,0,2,0,5,377,117,31565,33530,39697,1,-35,-23,-3904,-4,-4234,-7848,0,0,-2,0,5
EUW1_6880796498',3,33,8,0,0,0,0,12,0,321,94,24073,26288,23463,3,30,14,2,0,2,0,3,396,105,30188,31346,28975,0,-75,-11,-6115,-6,-5058,-5512,-2,0,-2,0,9
EUW1_6880680967',4,62,4,1,0,0,0,7,0,396,94,23832,29403,22964,8,80,11,0,0,0,0,0,369,94,25473,28330,22874,1,27,0,-1641,-7,1073,90,1,0,0,0,7
EUW1_6883346718',3,28,10,0,0,1,0,10,0,359,94,26913,29883,31549,0,14,12,2,0,1,0,2,348,105,27662,30412,32765,0,11,-11,-749,-2,-529,-1216,-2,0,0,0,8
EUW1_6881990050',2,25,14,0,0,1,0,10,0,375,90,28725,29829,38210,4,23,16,1,0,0,0,4,340,74,28249,28743,29842,0,35,16,476,-2,1086,8368,-1,0,1,0,6
EUW1_6881919466',6,27,7,0,0,1,0,5,1,362,96,25876,28928,26069,4,28,6,1,0,0,0,4,366,86,23799,29679,27091,1,-4,10,2077,1,-751,-1022,-1,0,1,0,1
EUW1_6881830040',7,27,15,1,0,1,0,6,0,399,76,29536,29277,34026,1,21,15,0,0,2,0,3,387,98,30105,30604,38114,0,12,-22,-569,0,-1327,-4088,1,0,-1,0,3
EUW1_6880530107',9,32,6,0,1,0,0,9,0,322,90,24392,28316,25533,5,27,15,2,0,1,0,0,407,110,29466,32798,35201,0,-85,-20,-5074,-9,-4482,-9668,-2,1,-1,0,9
EUW1_6880449257',4,36,13,0,0,0,0,11,0,321,80,27463,28922,31326,2,24,16,1,0,0,0,2,361,100,29949,30494,35194,0,-40,-20,-2486,-3,-1572,-3868,-1,0,0,0,9
EUW1_6880411929',3,21,5,0,0,0,0,15,0,299,65,21439,25116,22962,3,28,19,1,1,3,0,0,345,97,33117,30933,40725,0,-46,-32,-11678,-14,-5817,-17763,-1,-1,-3,0,15
EUW1_6880336718',4,29,16,1,1,3,0,10,1,383,95,30313,31881,32302,4,60,9,0,0,0,0,8,348,84,26032,28195,29897,0,35,11,4281,7,3686,2405,1,1,3,0,2
EUW1_6880288480',3,25,14,0,1,1,0,3,0,362,109,30703,30390,34416,2,20,9,1,0,1,0,10,375,97,25599,29384,27134,1,-13,12,5104,5,1006,7282,-1,1,0,0,-7
EUW1_6879024885',3,18,13,2,0,0,0,12,0,383,95,28319,30411,31812,3,28,16,0,0,1,0,4,347,96,30874,30982,32674,1,36,-1,-2555,-3,-571,-862,2,0,-1,0,8
EUW1_6878959302',4,29,16,0,0,1,0,2,0,328,90,28745,28700,36938,0,25,12,1,0,1,0,6,289,94,26638,26766,32995,1,39,-4,2107,4,1934,3943,-1,0,0,0,-4
EUW1_6878887167',3,23,12,0,0,2,0,8,1,367,99,30104,30288,34739,3,57,10,1,0,0,0,8,353,91,25871,29931,27746,1,14,8,4233,2,357,6993,-1,0,2,0,0
EUW1_6878835282',5,128,12,1,0,3,0,10,0,359,100,28818,30673,35422,1,89,9,1,0,0,0,5,325,95,25073,30137,27743,1,34,5,3745,3,536,7679,0,0,3,0,5
EUW1_6878781333',1,27,13,0,0,0,0,15,1,312,54,26331,25995,31668,1,30,25,2,0,4,0,2,357,125,36056,33377,45980,0,-45,-71,-9725,-12,-7382,-14312,-2,0,-4,0,13
EUW1_6878706857',2,25,10,0,0,0,0,11,1,402,88,26689,29383,21435,8,30,15,2,1,1,0,0,375,95,29202,30754,28412,0,27,-7,-2513,-5,-1371,-6977,-2,-1,-1,0,11
EUW1_6878658570',0,60,15,1,0,0,0,6,1,385,92,30019,32418,37279,5,66,7,0,0,1,0,6,332,79,24060,28726,28513,1,53,13,5959,8,3692,8766,1,0,-1,0,0
EUW1_6878602273',5,29,17,0,0,0,0,9,1,363,38,28171,28753,31080,3,95,12,1,0,1,0,5,364,114,29240,32107,31587,1,-1,-76,-1069,5,-3354,-507,-1,0,-1,0,4
EUW1_6878546843',6,43,13,2,0,1,0,6,1,368,83,27797,29808,27205,1,24,3,0,0,0,0,2,404,80,23025,27395,17830,1,-36,3,4772,10,2413,9375,2,0,1,0,4
EUW1_6877654169',3,27,10,0,0,0,0,8,0,336,78,25676,28455,30585,5,28,15,1,0,0,0,3,354,109,28884,31563,32496,0,-18,-31,-3208,-5,-3108,-1911,-1,0,0,0,5
EUW1_6876934102',1,35,7,1,0,0,0,9,1,352,57,23980,27020,29650,4,27,13,0,0,3,0,6,391,88,29592,31945,33723,0,-39,-31,-5612,-6,-4925,-4073,1,0,-3,0,3
EUW1_6875147071',1,45,3,0,0,0,0,9,0,340,87,22138,26955,20630,10,36,14,2,0,1,0,2,376,118,28686,32769,37970,0,-36,-31,-6548,-11,-5814,-17340,-2,0,-1,0,7
EUW1_6874182999',5,28,18,0,0,2,0,8,1,347,110,32757,30701,40852,3,28,16,1,0,0,0,9,341,82,29109,28473,34741,1,6,28,3648,2,2228,6111,-1,0,2,0,-1
EUW1_6874150513',5,28,15,1,1,0,0,8,0,328,123,28820,30888,29699,5,94,10,0,0,2,0,4,371,76,27338,29431,33003,1,-43,47,1482,5,1457,-3304,1,1,-2,0,4
EUW1_6872644898',4,29,11,1,0,1,0,12,1,333,90,27393,27559,29112,3,28,8,1,0,2,0,3,336,86,25928,26143,27515,0,-3,4,1465,3,1416,1597,0,0,-1,0,9
EUW1_6872581232',3,26,9,0,1,0,0,9,0,363,86,26549,29614,32148,2,23,11,1,0,1,0,0,375,90,28886,30544,29678,0,-12,-4,-2337,-2,-930,2470,-1,1,-1,0,9
EUW1_6872558517',5,37,12,1,0,2,0,6,1,400,102,29370,31592,34973,3,31,7,0,1,0,0,4,372,94,25135,30519,29763,1,28,8,4235,5,1073,5210,1,-1,2,0,2
EUW1_6872528589',2,49,13,1,0,0,0,11,0,325,88,26010,28497,28303,3,25,19,1,0,2,0,3,402,55,31512,32330,45465,0,-77,33,-5502,-6,-3833,-17162,0,0,-2,0,8
EUW1_6872399136',3,29,11,0,1,1,0,6,1,376,102,27623,31428,27874,2,27,6,2,0,1,0,4,348,104,24601,30263,23262,0,28,-2,3022,5,1165,4612,-2,1,0,0,2
EUW1_6871726490',6,50,9,1,0,3,0,11,1,381,115,29357,31857,24384,4,25,9,1,0,2,0,11,360,88,26420,29524,25896,1,21,27,2937,0,2333,-1512,0,0,1,0,0
EUW1_6871179390',4,63,22,2,0,2,0,10,1,362,78,31404,31420,46996,2,66,14,0,0,1,0,2,312,97,28937,29392,39011,1,50,-19,2467,8,2028,7985,2,0,1,0,8
EUW1_6871131368',5,225,1,2,0,0,0,11,0,334,74,20781,25108,24588,5,34,16,0,1,3,0,2,399,112,32806,32983,35244,0,-65,-38,-12025,-15,-7875,-10656,2,-1,-3,0,9
EUW1_6871090614',7,37,17,1,0,2,0,8,1,373,108,31902,32127,40459,1,32,15,0,0,1,0,5,348,72,28880,28772,36106,1,25,36,3022,2,3355,4353,1,0,1,0,3
EUW1_6869617098',2,99,18,1,1,7,1,1,1,408,98,34008,31838,28372,0,24,3,0,0,0,0,14,311,54,19681,23053,16794,1,97,44,14327,15,8785,11578,1,1,7,1,-13
EUW1_6869569144',2,25,7,0,0,0,0,9,1,370,78,24594,27816,23772,5,64,15,2,1,1,0,4,408,102,31265,30743,39053,0,-38,-24,-6671,-8,-2927,-15281,-2,-1,-1,0,5
EUW1_6869529979',1,30,12,0,0,0,0,15,0,334,95,26681,29022,28179,1,24,12,1,0,1,0,3,315,100,27989,29674,29843,0,19,-5,-1308,0,-652,-1664,-1,0,-1,0,12
EUW1_6876106085',3,24,6,0,0,0,0,11,0,312,64,22798,25590,42425,5,29,24,2,0,1,0,0,342,102,32062,32098,37217,0,-30,-38,-9264,-18,-6508,5208,-2,0,-1,0,11
EUW1_6876033212',5,33,25,2,0,2,0,14,1,305,100,33848,32264,46338,0,34,12,0,0,1,0,5,372,80,28283,30532,37486,0,-67,20,5565,13,1732,8852,2,0,1,0,9
EUW1_6875801459',5,42,15,1,0,2,0,8,1,375,80,30271,30229,34629,5,31,7,1,0,1,0,5,363,80,25410,28155,28292,1,12,0,4861,8,2074,6337,0,0,1,0,3
EUW1_6875745078',6,32,16,1,0,1,0,9,0,345,89,28969,31163,30302,1,25,8,0,1,2,0,6,378,78,25874,28430,30490,1,-33,11,3095,8,2733,-188,1,-1,-1,0,3
EUW1_6872135757',5,24,18,1,1,0,0,5,0,351,92,29603,31555,31842,3,22,9,1,0,1,0,6,335,82,24451,28383,32913,1,16,10,5152,9,3172,-1071,0,1,-1,0,-1
EUW1_6872078918',6,27,9,2,0,0,0,14,0,372,72,25388,29204,31650,6,34,11,0,1,2,0,1,354,103,28424,30067,24653,1,18,-31,-3036,-2,-863,6997,2,-1,-2,0,13
EUW1_6872022796',4,46,17,0,0,0,0,11,1,381,70,31100,30421,36942,1,24,9,1,0,2,0,5,311,98,26391,28241,29875,1,70,-28,4709,8,2180,7067,-1,0,-2,0,6
EUW1_6871969734',8,26,11,0,0,0,0,9,0,336,74,26105,28359,24406,2,23,16,2,0,1,0,4,371,97,29770,30791,39139,1,-35,-23,-3665,-5,-2432,-14733,-2,0,-1,0,5
EUW1_6870869552',5,319,3,1,0,0,0,10,0,366,106,23432,28452,28575,2,31,14,0,0,1,0,4,374,94,28805,31152,34262,0,-8,12,-5373,-11,-2700,-5687,1,0,-1,0,6
EUW1_6870837632',4,32,20,0,0,1,0,9,1,333,85,30208,30212,42964,6,24,16,1,0,1,0,3,297,61,28079,29141,36181,1,36,24,2129,4,1071,6783,-1,0,0,0,6
EUW1_6870809288',5,28,9,0,0,0,0,14,0,259,82,24261,26037,32381,4,27,26,2,0,3,0,1,366,75,34012,32000,45964,0,-107,7,-9751,-17,-5963,-13583,-2,0,-3,0,13
EUW1_6870787040',2,26,15,0,0,1,0,8,1,372,86,29258,30172,30672,3,36,7,2,0,0,0,5,343,90,24487,28253,40208,1,29,-4,4771,8,1919,-9536,-2,0,1,0,3
EUW1_6869002123',3,56,18,0,0,1,0,16,0,338,84,31190,31280,42788,2,53,16,2,0,2,0,5,373,97,30229,30120,37103,1,-35,-13,961,2,1160,5685,-2,0,-1,0,11
EUW1_6868946660',7,35,14,1,1,1,0,12,0,343,100,28634,30541,32762,5,77,15,0,0,1,0,2,393,92,30964,31975,36190,1,-50,8,-2330,-1,-1434,-3428,1,1,0,0,10
EUW1_6868893265',3,25,8,2,0,3,0,3,1,383,96,28608,30519,34335,5,29,6,0,0,0,0,11,321,86,23026,28025,24736,1,62,10,5582,2,2494,9599,2,0,3,0,-8
EUW1_6868828370',5,30,11,0,0,3,0,7,0,392,89,29491,30247,33361,5,104,10,2,0,1,0,10,344,97,27061,30341,31131,0,48,-8,2430,1,-94,2230,-2,0,2,0,-3
EUW1_6868779860',2,22,7,0,0,0,0,11,1,359,58,24739,27956,28089,7,31,15,1,0,2,0,3,378,118,31100,31176,32995,0,-19,-60,-6361,-8,-3220,-4906,-1,0,-2,0,8
EUW1_6868710795',5,45,11,1,0,1,0,7,1,375,99,27461,30536,32396,1,25,8,1,0,1,0,5,327,100,24720,28926,27232,1,48,-1,2741,3,1610,5164,0,0,0,0,2
EUW1_6868629636',5,29,8,1,1,2,0,9,0,360,88,26652,29194,30416,4,27,10,1,0,1,0,5,322,95,26441,27306,24824,1,38,-7,211,-2,1888,5592,0,1,1,0,4
EUW1_6868454654',2,29,14,1,0,0,0,11,0,331,108,28649,30426,38082,3,23,11,0,0,2,0,5,358,84,27097,30019,37442,0,-27,24,1552,3,407,640,1,0,-2,0,6
EUW1_6868391619',9,46,10,1,0,0,0,8,0,405,92,27457,30045,28701,4,33,18,1,1,1,0,2,429,109,32310,34883,30286,0,-24,-17,-4853,-8,-4838,-1585,0,-1,-1,0,6
EUW1_6867168704',3,23,10,0,0,0,0,6,1,387,84,27493,29618,31431,1,29,12,2,0,0,0,4,365,91,26120,29496,31081,0,22,-7,1373,-2,122,350,-2,0,0,0,2
EUW1_6867108344',3,24,12,1,0,1,0,8,1,363,96,27531,30764,33444,3,22,6,0,0,0,0,3,326,92,22474,26485,20491,1,37,4,5057,6,4279,12953,1,0,1,0,5
EUW1_6867050246',3,29,13,2,0,2,0,8,0,402,103,29984,33069,33252,5,33,4,0,0,0,0,7,360,84,22884,26976,26514,1,42,19,7100,9,6093,6738,2,0,2,0,1
EUW1_6866914732',3,31,14,0,0,0,0,10,1,368,94,29738,31137,34404,3,31,7,1,0,1,0,3,382,65,24296,27379,26586,0,-14,29,5442,7,3758,7818,-1,0,-1,0,7
EUW1_6866860647',6,35,8,0,0,0,0,8,1,315,97,23853,27622,25429,9,24,10,1,0,1,0,2,389,80,27182,29715,29006,0,-74,17,-3329,-2,-2093,-3577,-1,0,-1,0,6
EUW1_6866800518',5,29,23,1,1,0,0,6,1,349,108,32154,32784,43263,3,25,14,0,0,0,0,3,363,66,28636,28518,35832,0,-14,42,3518,9,4266,7431,1,1,0,0,3
EUW1_6866723324',3,22,15,1,0,0,0,11,0,336,74,27841,28916,42990,1,23,17,0,0,1,0,3,342,78,30496,31604,37066,0,-6,-4,-2655,-2,-2688,5924,1,0,-1,0,8
EUW1_6866673357',2,86,8,2,0,2,0,8,0,365,92,27576,28711,31492,6,143,9,0,0,0,0,7,370,72,25677,28308,31035,1,-5,20,1899,-1,403,457,2,0,2,0,1
EUW1_6866627158',4,21,9,0,0,0,0,7,0,326,60,24501,27360,30661,6,26,19,1,0,2,0,1,346,92,30012,30806,44911,0,-20,-32,-5511,-10,-3446,-14250,-1,0,-2,0,6
EUW1_6866585918',7,41,8,0,0,1,0,7,1,405,97,27781,29259,28409,5,27,7,1,0,0,0,4,331,84,23779,27712,16951,1,74,13,4002,1,1547,11458,-1,0,1,0,3
EUW1_6880665872',8,40,9,0,1,1,0,13,0,343,84,26649,29513,31094,5,30,15,2,0,3,0,4,382,84,30886,31859,38358,0,-39,0,-4237,-6,-2346,-7264,-2,1,-2,0,9
EUW1_6880636965',1,25,10,1,0,0,0,12,0,303,72,25501,25158,32944,3,23,22,1,0,3,0,7,329,124,32409,33041,45771,0,-26,-52,-6908,-12,-7883,-12827,0,0,-3,0,5
EUW1_6880584486',3,28,10,2,0,0,0,8,0,338,102,25045,31017,25218,5,67,11,0,1,1,0,2,384,86,27680,31051,29523,1,-46,16,-2635,-1,-34,-4305,2,-1,-1,0,6
EUW1_6880513481',3,20,11,2,0,1,0,13,0,300,76,26154,28972,32794,4,24,21,0,0,1,0,3,347,88,32624,32434,42589,0,-47,-12,-6470,-10,-3462,-9795,2,0,0,0,10
EUW1_6880427763',2,254,20,1,0,0,0,11,1,300,99,29424,29458,39736,3,32,13,0,0,1,0,2,328,88,27631,29623,36580,0,-28,11,1793,7,-165,3156,1,0,-1,0,9
EUW1_6880321656',2,23,21,1,0,3,0,10,0,353,74,33687,29171,45369,2,171,14,1,0,3,0,10,312,93,29673,27671,37323,1,41,-19,4014,7,1500,8046,0,0,0,0,0
EUW1_6880258082',3,24,15,1,0,1,0,10,1,250,68,27627,26039,33164,6,315,17,1,0,1,0,6,291,72,27427,25895,36905,1,-41,-4,200,-2,144,-3741,0,0,0,0,4
EUW1_6880208074',5,30,12,1,1,0,0,11,0,351,80,26433,29133,31919,4,30,17,1,0,0,0,0,389,100,30576,32269,40929,0,-38,-20,-4143,-5,-3136,-9010,0,1,0,0,11
EUW1_6880141654',1,23,6,1,0,1,0,8,0,367,94,25097,27656,29568,5,27,11,0,0,0,0,3,384,72,26487,30273,31009,0,-17,22,-1390,-5,-2617,-1441,1,0,1,0,5
EUW1_6877762284',6,30,16,1,0,1,0,8,1,427,90,30561,33357,32734,6,30,10,0,0,1,0,7,360,86,26051,28234,31139,0,67,4,4510,6,5123,1595,1,0,0,0,1
EUW1_6877731532',5,292,14,0,0,0,0,9,0,365,80,27512,30560,34840,4,24,6,2,0,0,0,3,349,76,24235,28635,28897,1,16,4,3277,8,1925,5943,-2,0,0,0,6
EUW1_6876171377',5,21,15,2,0,1,0,10,1,375,78,30228,30161,32702,3,32,10,0,0,0,0,8,350,109,25842,29744,21487,1,25,-31,4386,5,417,11215,2,0,1,0,2
EUW1_6876101316',3,30,10,1,0,0,0,12,1,323,86,25489,29240,25806,5,32,13,1,0,0,0,1,382,70,28126,28874,36708,0,-59,16,-2637,-3,366,-10902,0,0,0,0,11
EUW1_6875874078',0,27,10,0,0,0,0,14,0,366,115,26904,30258,31459,4,27,18,2,1,2,0,4,383,84,30512,33316,31706,1,-17,31,-3608,-8,-3058,-247,-2,-1,-2,0,10
EUW1_6875816063',3,28,7,0,1,0,0,6,1,391,98,25834,31090,21662,6,27,13,2,0,1,0,0,393,88,26890,30746,23824,0,-2,10,-1056,-6,344,-2162,-2,1,-1,0,6
EUW1_6875738342',5,27,12,1,0,0,0,12,1,349,81,26359,30414,27149,4,35,8,1,0,2,0,2,354,106,27188,28771,30575,0,-5,-25,-829,4,1643,-3426,0,0,-2,0,10
EUW1_6874836390',3,48,19,0,1,1,0,6,0,347,82,30676,28674,41423,4,29,18,2,0,0,0,2,327,114,30138,30532,41002,0,20,-32,538,1,-1858,421,-2,1,1,0,4
EUW1_6874773556',6,25,15,2,1,0,0,10,1,380,108,28498,31472,30732,4,214,6,0,0,0,0,2,376,71,24400,28806,26056,1,4,37,4098,9,2666,4676,2,1,0,0,8
EUW1_6874694709',6,28,13,1,0,1,0,12,0,393,68,28244,31412,29081,1,27,8,0,0,1,0,4,349,112,27699,29754,27600,1,44,-44,545,5,1658,1481,1,0,0,0,8
EUW1_6874602643',1,28,16,1,0,1,0,14,1,377,84,29983,30604,33717,0,21,13,0,1,1,0,3,336,84,29030,27782,30612,1,41,0,953,3,2822,3105,1,-1,0,0,11
EUW1_6874268431',7,138,13,1,0,1,0,10,1,337,100,28795,29448,31346,6,29,13,1,0,1,0,1,368,92,28337,29709,29540,0,-31,8,458,0,-261,1806,0,0,0,0,9
EUW1_6874222519',4,21,18,1,0,1,0,10,1,305,86,29142,28816,36494,2,29,12,0,0,1,0,5,327,93,27535,28960,35789,0,-22,-7,1607,6,-144,705,1,0,0,0,5
EUW1_6870203145',0,25,14,1,1,1,0,7,1,376,109,29200,29807,32829,2,59,13,0,0,1,0,6,342,68,27007,28942,24757,1,34,41,2193,1,865,8072,1,1,0,0,1
EUW1_6870037652',6,26,17,1,1,2,0,6,1,383,106,30782,32102,35925,4,32,6,1,0,0,0,7,321,94,23671,26143,30438,1,62,12,7111,11,5959,5487,0,1,2,0,-1
EUW1_6869914266',5,27,8,0,0,0,0,4,1,395,94,26742,30332,22587,3,31,6,2,1,0,0,3,402,107,25489,31542,23080,1,-7,-13,1253,2,-1210,-493,-2,-1,0,0,1
EUW1_6869871683',3,87,13,2,1,4,0,6,1,370,88,31618,30008,30702,2,32,8,0,0,0,0,10,337,83,25238,26577,26908,1,33,5,6380,5,3431,3794,2,1,4,0,-4
EUW1_6869714334',2,21,9,1,0,0,0,9,0,347,78,25799,25973,37179,6,28,16,1,0,0,0,0,337,104,28546,29784,43646,1,10,-26,-2747,-7,-3811,-6467,0,0,0,0,9
EUW1_6869669164',5,27,6,0,1,1,0,12,0,362,100,25802,30436,27154,1,25,8,2,0,2,0,5,421,76,27238,30240,23386,0,-59,24,-1436,-2,196,3768,-2,1,-1,0,7
EUW1_6869509197',1,33,9,1,0,0,0,6,1,420,92,28239,32017,32189,6,29,5,1,0,1,0,5,353,94,23484,28950,24550,0,67,-2,4755,4,3067,7639,0,0,-1,0,1
EUW1_6869479586',5,58,11,1,0,0,0,5,1,366,105,27763,31961,29938,4,64,7,0,0,1,0,6,350,71,24092,30371,26756,1,16,34,3671,4,1590,3182,1,0,-1,0,-1
EUW1_6869438013',5,33,11,0,0,0,0,12,0,282,96,26084,28339,30342,5,25,12,2,0,2,0,2,358,76,28348,29591,35430,0,-76,20,-2264,-1,-1252,-5088,-2,0,-2,0,10
EUW1_6868494360',3,31,12,0,0,1,0,12,0,376,94,28591,29515,38373,3,26,12,2,0,1,0,4,380,88,28621,31438,30599,0,-4,6,-30,0,-1923,7774,-2,0,0,0,8
EUW1_6868446806',2,35,12,0,0,1,0,9,0,323,79,27499,28235,35220,5,29,19,2,0,2,0,4,327,91,30253,31231,37999,1,-4,-12,-2754,-7,-2996,-2779,-2,0,-1,0,5
EUW1_6868346765',2,19,20,2,0,1,0,13,1,350,84,32294,30058,47903,5,30,18,0,0,2,0,6,311,79,30198,29645,40993,0,39,5,2096,2,413,6910,2,0,-1,0,7
EUW1_6868247972',5,23,22,1,0,1,0,4,1,348,90,32506,31256,41769,4,21,13,0,0,1,0,5,330,62,26028,28536,33524,1,18,28,6478,9,2720,8245,1,0,0,0,-1
EUW1_6882741449',3,24,10,0,0,0,0,9,0,357,122,27198,29034,29683,4,30,13,2,0,1,0,2,381,66,29031,29223,41540,0,-24,56,-1833,-3,-189,-11857,-2,0,-1,0,7
EUW1_6880931645',1,28,9,1,0,0,0,13,0,283,84,25051,26474,30122,7,35,18,1,1,1,0,2,347,92,30024,29943,38458,0,-64,-8,-4973,-9,-3469,-8336,0,-1,-1,0,11
EUW1_6880903848',5,38,12,1,0,1,0,7,1,412,124,28946,34022,26990,6,29,6,0,0,0,0,5,379,84,23452,27445,25226,1,33,40,5494,6,6577,1764,1,0,1,0,2
EUW1_6878194925',6,26,18,0,0,0,0,9,1,352,82,29431,30335,43549,2,32,14,2,0,1,0,7,367,85,29895,29037,41972,0,-15,-3,-464,4,1298,1577,-2,0,-1,0,2
EUW1_6878148834',5,32,12,0,0,1,0,10,1,330,80,26563,28540,34545,6,35,14,1,0,1,0,2,396,96,31028,30493,34030,0,-66,-16,-4465,-2,-1953,515,-1,0,0,0,8
EUW1_6877988557',5,29,14,0,0,0,0,9,0,377,114,29325,31927,38596,4,39,18,2,0,0,0,1,349,98,28810,30984,37869,0,28,16,515,-4,943,727,-2,0,0,0,8
EUW1_6877292636',4,39,10,1,0,1,0,7,1,372,89,27602,29050,32050,1,148,12,1,0,0,0,1,364,89,26827,30332,33164,0,8,0,775,-2,-1282,-1114,0,0,1,0,6
EUW1_6876690037',3,51,20,1,0,1,0,9,1,387,81,32777,31264,41710,2,37,18,1,0,1,0,10,361,67,30289,30331,34668,0,26,14,2488,2,933,7042,0,0,0,0,-1
EUW1_6876661073',5,55,16,0,0,0,0,11,0,339,83,28887,29133,42183,3,32,23,2,0,1,0,2,361,86,33946,32062,35792,0,-22,-3,-5059,-7,-2929,6391,-2,0,-1,0,9
EUW1_6876550295',1,21,8,0,0,0,0,6,1,362,79,25726,28042,32680,3,27,19,2,0,0,0,4,370,93,29599,32226,39530,0,-8,-14,-3873,-11,-4184,-6850,-2,0,0,0,2
EUW1_6876530175',4,26,11,0,0,1,0,7,1,345,82,27236,27094,26425,5,28,17,1,0,1,0,4,375,82,30016,30521,37871,0,-30,0,-2780,-6,-3427,-11446,-1,0,0,0,3
EUW1_6876502373',4,30,8,0,0,1,0,6,1,337,82,25595,28154,34704,8,233,12,2,0,0,0,3,338,82,25705,30075,29083,1,-1,0,-110,-4,-1921,5621,-2,0,1,0,3
EUW1_6876500712',3,31,27,1,0,5,1,7,1,371,103,39976,34546,49925,2,19,10,0,0,2,0,12,305,59,24246,23751,27846,1,66,44,15730,17,10795,22079,1,0,3,1,-5
EUW1_6873851065',5,88,10,1,0,0,0,10,1,314,78,25220,27869,34096,4,33,6,1,0,2,0,4,352,89,26683,28716,32501,1,-38,-11,-1463,4,-847,1595,0,0,-2,0,6
EUW1_6873832314',2,30,13,0,0,1,0,5,1,384,81,29686,31356,39269,2,27,13,2,0,1,0,6,319,102,26877,28953,29482,1,65,-21,2809,0,2403,9787,-2,0,0,0,-1
EUW1_6872576017',5,30,8,1,0,0,0,5,1,383,94,25893,30361,23741,2,29,6,0,0,0,0,0,403,90,24586,30278,29001,0,-20,4,1307,2,83,-5260,1,0,0,0,5
EUW1_6872544659',4,26,14,0,0,2,0,9,0,388,113,31660,32308,34184,3,24,10,1,1,0,0,2,359,74,25743,29086,24778,1,29,39,5917,4,3222,9406,-1,-1,2,0,7
EUW1_6872506593',1,53,12,0,0,1,0,9,1,367,75,27469,29650,28071,4,26,8,1,0,0,0,4,345,104,24860,28067,29265,1,22,-29,2609,4,1583,-1194,-1,0,1,0,5
EUW1_6871940763',5,141,17,1,0,2,0,8,1,338,86,29988,29405,34405,2,28,12,0,0,0,0,7,311,82,27591,27767,34586,0,27,4,2397,5,1638,-181,1,0,2,0,1
EUW1_6871870586',4,30,17,2,0,1,0,9,1,322,74,28470,30404,35907,2,28,12,0,0,1,0,5,370,85,28081,29157,34986,0,-48,-11,389,5,1247,921,2,0,0,0,4
EUW1_6871442287',2,40,10,1,0,1,0,10,0,357,78,26993,27979,20083,2,28,10,1,0,1,0,1,364,70,26511,27402,28440,1,-7,8,482,0,577,-8357,0,0,0,0,9
EUW1_6870203218',3,28,16,2,0,1,0,10,0,323,109,29112,31960,34050,2,25,10,0,0,1,0,3,355,86,26664,29575,29123,0,-32,23,2448,6,2385,4927,2,0,0,0,7
EUW1_6870066859',3,23,7,1,0,0,0,11,0,346,106,24353,28718,27143,1,24,13,1,0,2,0,2,404,98,29855,32064,32427,0,-58,8,-5502,-6,-3346,-5284,0,0,-2,0,9
EUW1_6869988655',2,37,15,1,0,0,0,6,1,375,94,29270,32159,33257,3,28,10,1,0,1,0,5,357,94,25893,28801,27846,1,18,0,3377,5,3358,5411,0,0,-1,0,1
EUW1_6883391621',5,40,9,0,0,0,0,7,0,384,98,26212,30956,26773,2,24,10,2,0,0,0,2,384,81,26712,29777,27295,0,0,17,-500,-1,1179,-522,-2,0,0,0,5
EUW1_6878435637',12,222,8,2,0,0,0,4,1,349,107,25980,28561,28452,2,31,9,0,1,1,0,2,370,92,25639,29126,27976,1,-21,15,341,-1,-565,476,2,-1,-1,0,2
EUW1_6878345719',5,36,10,0,0,0,0,6,0,388,113,27529,30846,23821,3,29,11,2,1,0,0,3,391,94,27770,31973,27252,0,-3,19,-241,-1,-1127,-3431,-2,-1,0,0,3
EUW1_6878281546',6,29,20,1,0,1,0,6,1,354,106,30989,31308,48376,2,15,14,1,0,0,0,5,348,88,29253,30345,38007,1,6,18,1736,6,963,10369,0,0,1,0,1
EUW1_6878225627',2,30,14,0,0,0,0,9,0,402,104,30728,32874,30938,3,32,14,2,0,1,0,8,384,115,28930,32315,31636,0,18,-11,1798,0,559,-698,-2,0,-1,0,1
EUW1_6878166806',5,32,10,1,0,1,0,9,0,399,104,27779,30273,30020,7,81,11,1,1,1,0,2,401,119,30481,32760,32370,0,-2,-15,-2702,-1,-2487,-2350,0,-1,0,0,7
EUW1_6878093887',2,16,6,1,0,0,0,15,1,319,98,24021,26918,21931,4,23,15,1,1,2,0,4,378,105,30147,30821,30353,0,-59,-7,-6126,-9,-3903,-8422,0,-1,-2,0,11
EUW1_6877429640',8,45,10,0,0,1,0,8,0,373,81,26869,28815,28186,6,39,15,1,0,0,0,3,372,104,29930,32715,29318,0,1,-23,-3061,-5,-3900,-1132,-1,0,1,0,5
EUW1_6877363105',5,38,17,1,0,1,0,8,1,369,92,31421,29828,36551,3,51,11,0,0,0,0,6,313,70,25322,26212,32273,1,56,22,6099,6,3616,4278,1,0,1,0,2
EUW1_6877305449',3,63,8,1,0,0,0,11,1,377,64,25671,28785,30013,3,27,19,1,0,2,0,3,364,117,30772,32384,37112,0,13,-53,-5101,-11,-3599,-7099,0,0,-2,0,8
EUW1_6877223885',3,27,15,2,0,2,0,11,1,375,101,30078,29497,36432,4,26,12,0,0,0,0,4,323,99,26960,28712,29354,1,52,2,3118,3,785,7078,2,0,2,0,7
EUW1_6877163819',6,35,10,0,0,0,0,10,1,370,86,27364,29064,29468,2,29,14,2,0,1,0,5,394,94,29112,31816,39435,0,-24,-8,-1748,-4,-2752,-9967,-2,0,-1,0,5
EUW1_6877041329',4,29,14,0,0,1,0,11,1,383,64,29298,29062,29541,3,60,20,2,0,1,0,3,291,118,31453,29150,37699,0,92,-54,-2155,-6,-88,-8158,-2,0,0,0,8
EUW1_6876966308',6,29,14,0,0,0,0,8,0,345,105,29031,29231,33298,3,28,14,2,0,1,0,3,369,72,28183,30714,33912,0,-24,33,848,0,-1483,-614,-2,0,-1,0,5
EUW1_6876820603',4,25,14,1,0,0,0,17,1,346,69,27492,28275,32573,8,34,18,1,0,2,0,2,358,117,31986,31786,34807,0,-12,-48,-4494,-4,-3511,-2234,0,0,-2,0,15
EUW1_6876730531',4,25,12,0,0,2,0,11,1,339,114,28622,29491,25947,4,37,8,2,0,1,0,7,363,104,27108,28525,29585,0,-24,10,1514,4,966,-3638,-2,0,1,0,4
EUW1_6876678656',4,25,13,1,1,1,0,9,1,404,80,28772,31074,31668,5,33,12,1,0,1,0,3,388,100,27942,29997,23574,1,16,-20,830,1,1077,8094,0,1,0,0,6
EUW1_6876637028',5,29,13,2,0,2,0,5,1,403,104,30437,30431,29740,5,30,10,0,0,0,0,8,341,106,27630,30381,26246,1,62,-2,2807,3,50,3494,2,0,2,0,-3
EUW1_6876602552',6,244,20,1,0,1,0,5,1,334,100,31674,31749,46758,1,38,14,1,0,0,0,5,311,84,27141,28064,32067,1,23,16,4533,6,3685,14691,0,0,1,0,0
EUW1_6876564874',7,27,8,1,0,0,0,3,1,412,110,28066,32074,23626,9,35,6,1,0,0,0,2,403,102,25530,30791,25161,1,9,8,2536,2,1283,-1535,0,0,0,0,1
EUW1_6883243858',4,25,19,1,0,2,0,5,1,370,106,31112,30191,30776,5,29,14,0,0,1,0,5,357,81,28324,30027,28607,1,13,25,2788,5,164,2169,1,0,1,0,0
EUW1_6871698624',2,22,7,1,0,0,0,6,0,359,78,23934,28357,27546,8,42,14,1,0,0,0,5,354,65,26045,28874,29628,0,5,13,-2111,-7,-517,-2082,0,0,0,0,1
EUW1_6871623045',4,24,5,0,0,1,0,9,0,381,85,24163,29389,22098,4,35,8,2,0,1,0,2,404,80,26806,30503,34294,1,-23,5,-2643,-3,-1114,-12196,-2,0,0,0,7
EUW1_6870750452',0,25,22,1,0,2,0,6,1,373,88,32414,30531,39722,2,20,11,0,0,1,0,7,370,86,25993,26776,25957,1,3,2,6421,11,3755,13765,1,0,1,0,-1
EUW1_6870567979',4,24,15,2,0,0,0,6,0,397,110,29513,32526,30314,4,29,3,0,0,1,0,6,354,77,22179,27239,20728,1,43,33,7334,12,5287,9586,2,0,-1,0,0
EUW1_6870354936',3,22,15,2,0,3,0,10,1,388,120,31730,33016,28524,2,22,7,0,0,0,0,8,331,83,24981,28880,29822,1,57,37,6749,8,4136,-1298,2,0,3,0,2
EUW1_6870239515',2,19,14,2,0,1,0,2,0,363,111,29320,31104,32705,3,22,6,0,1,1,0,8,340,74,23629,26460,17556,1,23,37,5691,8,4644,15149,2,-1,0,0,-6
EUW1_6870054115',3,23,8,1,0,1,0,13,0,372,100,25956,29887,28124,5,25,9,0,0,2,0,3,416,91,28967,31968,27173,0,-44,9,-3011,-1,-2081,951,1,0,-1,0,10
EUW1_6869995001',4,32,8,0,0,0,0,14,0,314,84,25049,27063,24582,2,105,22,1,1,2,0,1,422,90,34801,33549,50365,0,-108,-6,-9752,-14,-6486,-25783,-1,-1,-2,0,13
EUW1_6869943531',4,43,7,0,0,0,0,8,0,388,92,25661,30513,34227,0,26,11,2,0,1,0,4,375,92,27448,29785,25948,0,13,0,-1787,-4,728,8279,-2,0,-1,0,4
EUW1_6869795861',1,16,12,0,0,1,0,7,0,345,86,27219,28722,31603,3,28,8,1,0,0,0,5,382,62,25187,28494,28511,0,-37,24,2032,4,228,3092,-1,0,1,0,2
EUW1_6869723970',3,18,15,1,0,1,0,6,1,328,88,28294,28644,25849,3,27,12,1,0,1,0,5,359,107,28178,30566,32425,1,-31,-19,116,3,-1922,-6576,0,0,0,0,1
EUW1_6869659129',4,39,12,0,0,1,0,8,0,392,74,29998,30045,32804,2,27,11,1,0,2,0,9,328,100,26375,28850,23795,1,64,-26,3623,1,1195,9009,-1,0,-1,0,-1
EUW1_6869587753',4,19,6,0,0,1,0,10,0,384,92,25890,29971,25134,6,87,16,1,1,2,0,4,390,96,31250,31005,30342,0,-6,-4,-5360,-10,-1034,-5208,-1,-1,-1,0,6
EUW1_6869543805',7,32,9,0,0,0,0,3,1,384,124,26761,31486,28673,2,27,12,2,1,0,0,2,413,99,28744,32073,31282,0,-29,25,-1983,-3,-587,-2609,-2,-1,0,0,1
EUW1_6875558198',3,25,2,0,0,0,0,7,0,378,92,22011,29462,25584,4,27,11,2,1,1,0,1,391,108,28288,32413,25033,0,-13,-16,-6277,-9,-2951,551,-2,-1,-1,0,6
EUW1_6874643112',5,26,16,1,0,0,0,7,1,365,104,29150,29809,34278,3,28,13,1,0,0,0,4,344,84,26776,29138,25039,1,21,20,2374,3,671,9239,0,0,0,0,3
EUW1_6874423203',3,27,12,1,0,0,0,5,0,390,82,27867,29726,32893,5,40,10,1,0,1,0,4,382,98,27473,31426,34753,0,8,-16,394,2,-1700,-1860,0,0,-1,0,1
EUW1_6874165791',4,26,9,0,0,0,0,8,0,347,101,25356,29314,31208,3,29,14,2,0,1,0,1,360,82,28399,29713,33670,0,-13,19,-3043,-5,-399,-2462,-2,0,-1,0,7
EUW1_6871469676',3,30,8,0,0,0,0,10,1,329,93,26744,28176,29806,0,20,14,2,0,2,0,3,358,82,28161,30297,28958,1,-29,11,-1417,-6,-2121,848,-2,0,-2,0,7
EUW1_6871413078',3,22,9,0,0,0,0,12,0,348,57,24157,28232,30826,3,27,14,0,0,1,0,2,352,90,28441,28835,31762,0,-4,-33,-4284,-5,-603,-936,0,0,-1,0,10
EUW1_6871235185',3,28,10,0,0,0,0,9,1,345,96,27079,28509,31094,5,35,11,1,0,1,0,5,387,81,26109,28900,32335,1,-42,15,970,-1,-391,-1241,-1,0,-1,0,4
EUW1_6871109919',4,28,4,1,0,0,0,8,0,391,82,22856,28630,13928,6,25,8,1,0,0,0,2,417,94,26714,30856,22235,0,-26,-12,-3858,-4,-2226,-8307,0,0,0,0,6
EUW1_6871081540',4,36,10,1,1,0,0,7,1,378,112,26448,31015,27978,4,27,8,0,0,0,0,1,335,90,24671,28498,23880,1,43,22,1777,2,2517,4098,1,1,0,0,6
EUW1_6870596637',4,27,19,1,0,0,0,6,1,356,74,29130,30227,35195,2,27,12,1,0,0,0,0,355,88,26333,28237,29631,1,1,-14,2797,7,1990,5564,0,0,0,0,6
EUW1_6870473921',3,26,19,2,1,1,0,9,0,376,98,31133,31071,44588,3,25,12,0,0,0,0,5,331,102,28635,30168,33935,0,45,-4,2498,7,903,10653,2,1,1,0,4
EUW1_6870396125',3,26,8,2,0,0,0,11,0,318,64,23749,25109,25527,7,27,14,0,0,1,0,0,422,84,29013,29975,27956,0,-104,-20,-5264,-6,-4866,-2429,2,0,-1,0,11
EUW1_6870236042',4,19,5,1,1,0,0,6,0,365,105,24259,28799,25894,5,43,6,1,0,1,0,3,408,96,25950,28284,28971,1,-43,9,-1691,-1,515,-3077,0,1,-1,0,3
EUW1_6870022127',1,30,8,0,1,0,0,3,1,353,92,26675,27917,27136,2,63,12,2,0,0,0,7,359,84,26323,27538,30289,0,-6,8,352,-4,379,-3153,-2,1,0,0,-4
EUW1_6869952592',2,28,14,2,0,2,0,8,0,352,85,29539,29442,40402,8,31,17,0,0,0,0,6,302,62,27714,26910,33115,1,50,23,1825,-3,2532,7287,2,0,2,0,2
EUW1_6883624881',0,27,10,0,0,0,0,6,0,382,111,27440,30942,24340,3,28,12,2,0,1,0,2,352,87,27169,29349,25931,0,30,24,271,-2,1593,-1591,-2,0,-1,0,4
EUW1_6883601953',3,25,8,0,1,1,0,8,0,386,102,26538,30114,26895,7,30,16,1,0,1,0,5,378,94,29069,30585,32960,0,8,8,-2531,-8,-471,-6065,-1,1,0,0,3
EUW1_6883576140',6,38,10,1,0,0,0,11,0,374,68,26471,29041,26841,8,47,17,1,0,0,0,3,372,110,30407,31251,38203,0,2,-42,-3936,-7,-2210,-11362,0,0,0,0,8
EUW1_6883558949',5,32,9,1,0,0,0,10,1,303,71,24911,25857,29633,5,19,19,1,0,2,0,0,407,92,32213,32844,34305,0,-104,-21,-7302,-10,-6987,-4672,0,0,-2,0,10
EUW1_6883523058',4,24,8,1,0,1,0,5,1,373,82,25915,29340,29404,6,27,10,1,0,1,0,5,366,84,25627,28717,28490,0,7,-2,288,-2,623,914,0,0,0,0,0
EUW1_6883459794',8,30,16,1,0,1,0,9,1,340,115,29329,30033,37283,2,29,6,0,0,1,0,8,344,81,23760,27610,20560,1,-4,34,5569,10,2423,16723,1,0,0,0,1
EUW1_6880282092',2,24,5,0,0,0,0,10,1,378,105,24669,29479,27011,4,28,12,1,0,1,0,4,347,84,27207,29621,37207,0,31,21,-2538,-7,-142,-10196,-1,0,-1,0,6
EUW1_6880216030',3,20,17,0,1,1,0,7,1,369,92,29941,33119,34660,1,25,11,2,0,1,0,5,371,88,27989,30892,29368,1,-2,4,1952,6,2227,5292,-2,1,0,0,2
EUW1_6879181809',5,29,18,2,0,0,0,14,1,359,100,29553,32473,33723,2,28,13,0,0,1,0,2,412,78,30452,31769,39835,1,-53,22,-899,5,704,-6112,2,0,-1,0,12
EUW1_6879138182',4,24,12,2,0,1,0,11,0,364,116,28457,30670,32112,7,34,13,0,0,1,0,4,348,67,27260,29724,35381,0,16,49,1197,-1,946,-3269,2,0,0,0,7
EUW1_6879089445',0,20,12,0,0,0,0,11,0,333,87,25598,28765,31749,2,27,20,1,0,1,0,0,355,109,31303,32984,36339,0,-22,-22,-5705,-8,-4219,-4590,-1,0,-1,0,11
EUW1_6878824571',3,38,9,0,0,0,0,7,0,370,110,26413,29191,21078,3,121,13,2,0,1,0,1,342,80,26593,28875,36238,0,28,30,-180,-4,316,-15160,-2,0,-1,0,6
EUW1_6878751937',2,23,13,0,0,2,0,7,0,370,82,28478,30740,37689,3,99,10,1,0,0,0,5,382,94,26424,30660,34794,0,-12,-12,2054,3,80,2895,-1,0,2,0,2
EUW1_6878706949',2,23,18,1,0,0,0,8,0,330,95,29103,29895,35779,4,32,13,0,0,0,0,1,383,76,28748,28722,36652,1,-53,19,355,5,1173,-873,1,0,0,0,7
EUW1_6878659343',2,28,14,0,0,0,0,6,1,370,74,26925,29722,31826,2,34,9,2,0,0,0,1,360,104,25999,29626,30174,1,10,-30,926,5,96,1652,-2,0,0,0,5
EUW1_6878624851',2,28,12,0,0,0,0,12,0,299,102,25831,28613,30274,2,24,14,2,0,1,0,1,372,106,29692,31149,34461,0,-73,-4,-3861,-2,-2536,-4187,-2,0,-1,0,11
EUW1_6877853136',0,14,9,0,0,0,0,11,0,300,86,25499,27956,32884,0,24,24,1,0,2,0,5,352,116,33632,32533,46069,0,-52,-30,-8133,-15,-4577,-13185,-1,0,-2,0,6
EUW1_6877849530',2,330,10,0,0,0,0,9,1,319,79,25387,27511,26655,3,29,22,1,0,2,0,1,370,94,32362,31668,36135,0,-51,-15,-6975,-12,-4157,-9480,-1,0,-2,0,8
EUW1_6877816283',5,32,5,2,0,0,0,7,0,363,110,24516,29737,16091,3,59,9,0,0,1,0,2,386,90,27428,29620,27867,1,-23,20,-2912,-4,117,-11776,2,0,-1,0,5
EUW1_6882745321',1,22,8,0,0,1,0,6,0,353,81,25422,27047,27054,3,22,11,1,0,0,0,4,332,110,25447,28426,26493,1,21,-29,-25,-3,-1379,561,-1,0,1,0,2
EUW1_6882617661',3,26,8,0,1,0,0,5,0,413,96,26987,31084,30278,3,30,4,2,0,1,0,4,385,91,23032,27578,19969,1,28,5,3955,4,3506,10309,-2,1,-1,0,1
EUW1_6882567490',3,27,9,2,0,4,0,8,1,381,84,28703,29758,31524,0,24,8,0,0,1,0,13,375,87,26107,29649,26277,0,6,-3,2596,1,109,5247,2,0,3,0,-5
EUW1_6882523341',3,133,17,1,1,3,0,7,1,381,131,32191,32748,35625,4,26,10,0,0,0,0,11,330,76,25865,28211,26724,1,51,55,6326,7,4537,8901,1,1,3,0,-4
EUW1_6874980841',4,281,23,1,0,2,0,10,0,347,96,32735,29221,38262,4,22,14,1,0,2,0,4,343,77,30005,30089,37542,0,4,19,2730,9,-868,720,0,0,0,0,6
EUW1_6874952107',5,34,20,0,1,0,0,9,1,366,116,31580,33147,40356,2,21,18,1,0,1,0,5,342,62,29158,30780,37469,1,24,54,2422,2,2367,2887,-1,1,-1,0,4
EUW1_6872698777',1,33,12,1,0,2,0,12,1,388,68,27855,28527,36808,6,99,13,0,0,1,0,3,346,76,27986,28322,29218,0,42,-8,-131,-1,205,7590,1,0,1,0,9
EUW1_6871814386',3,27,4,0,1,0,0,8,0,320,88,22763,26709,21714,5,26,6,1,0,0,0,1,381,87,24647,29418,21033,1,-61,1,-1884,-2,-2709,681,-1,1,0,0,7
EUW1_6870743339',4,26,5,0,0,0,0,9,0,347,84,24028,27304,21346,6,26,19,2,0,2,0,0,419,103,31159,32548,36264,0,-72,-19,-7131,-14,-5244,-14918,-2,0,-2,0,9
EUW1_6869836015',8,31,11,0,0,1,0,4,0,401,90,28028,29047,29763,2,33,9,2,0,0,0,5,355,89,25997,28309,26711,1,46,1,2031,2,738,3052,-2,0,1,0,-1
EUW1_6869766288',4,62,9,0,0,1,0,9,0,334,82,26101,28123,27410,6,66,21,2,0,1,0,3,380,81,31298,32997,43755,0,-46,1,-5197,-12,-4874,-16345,-2,0,0,0,6
EUW1_6868331914',0,15,10,0,0,0,0,12,0,382,72,26102,29271,33555,2,22,17,2,0,1,0,1,347,80,29340,29066,40443,0,35,-8,-3238,-7,205,-6888,-2,0,-1,0,11
EUW1_6868261933',2,25,8,1,1,0,0,9,1,375,95,25514,29822,30202,6,37,9,1,0,0,0,0,401,102,26895,30843,26863,1,-26,-7,-1381,-1,-1021,3339,0,1,0,0,9
EUW1_6868208062',2,28,25,1,0,1,0,7,1,373,72,33101,32413,42508,5,23,8,0,0,1,0,4,341,72,25427,27687,35997,1,32,0,7674,17,4726,6511,1,0,0,0,3
EUW1_6868151231',4,44,17,1,0,1,0,10,0,350,90,29849,30763,34869,5,30,12,0,0,1,0,3,345,102,28896,31618,37248,0,5,-12,953,5,-855,-2379,1,0,0,0,7
EUW1_6867227718',6,27,12,1,0,0,0,8,1,404,96,26693,30405,29885,5,35,12,1,0,1,0,2,347,107,28177,28658,29051,1,57,-11,-1484,0,1747,834,0,0,-1,0,6
EUW1_6867160024',4,34,19,0,0,1,0,12,0,338,86,30825,31427,35404,0,26,21,2,0,1,0,4,359,100,32077,32320,40465,0,-21,-14,-1252,-2,-893,-5061,-2,0,0,0,8
EUW1_6867018349',0,23,8,0,0,0,0,7,1,319,72,23498,26798,22528,5,27,11,1,1,1,0,0,363,77,26601,30646,32003,0,-44,-5,-3103,-3,-3848,-9475,-1,-1,-1,0,7
EUW1_6866943462',4,33,9,2,0,3,0,4,1,446,111,30899,31733,27578,5,28,11,0,0,0,0,10,347,88,25265,29336,36886,1,99,23,5634,-2,2397,-9308,2,0,3,0,-6
EUW1_6869279325',6,20,7,0,0,0,0,11,0,342,80,24027,28861,23601,5,27,20,2,0,3,0,2,418,110,34479,34714,37545,0,-76,-30,-10452,-13,-5853,-13944,-2,0,-3,0,9
EUW1_6869256201',0,41,14,1,0,1,0,14,0,327,70,29192,27105,34883,6,24,27,1,0,6,0,5,363,115,38727,33425,46033,0,-36,-45,-9535,-13,-6320,-11150,0,0,-5,0,9
EUW1_6869245583',2,264,23,2,0,1,0,5,0,351,98,34013,33248,48819,2,24,21,0,0,0,0,5,323,85,31176,29227,40710,1,28,13,2837,2,4021,8109,2,0,1,0,0
EUW1_6869093048',5,30,12,0,0,0,0,10,0,312,99,27025,27965,33284,8,36,23,2,0,1,0,2,373,84,32560,31039,43776,0,-61,15,-5535,-11,-3074,-10492,-2,0,-1,0,8
EUW1_6869033332',3,25,6,0,0,0,0,11,0,310,84,23472,26567,29976,4,42,21,2,0,2,0,1,347,109,31261,31930,43567,0,-37,-25,-7789,-15,-5363,-13591,-2,0,-2,0,10
EUW1_6868957203',6,27,5,1,0,0,0,10,0,382,72,23400,28364,22683,6,35,10,1,0,1,0,0,392,120,27699,30979,29473,0,-10,-48,-4299,-5,-2615,-6790,0,0,-1,0,10
EUW1_6868870860',3,28,10,0,1,1,0,6,1,371,137,27325,33127,28476,5,130,5,1,0,0,0,2,416,62,24117,30136,23343,1,-45,75,3208,5,2991,5133,-1,1,1,0,4
EUW1_6868701595',0,23,10,0,0,0,0,10,1,322,65,25920,27670,26863,5,34,22,1,0,2,0,3,374,122,33455,34954,49135,0,-52,-57,-7535,-12,-7284,-22272,-1,0,-2,0,7
EUW1_6868618410',3,32,9,0,0,1,0,13,1,346,110,26272,29862,25376,3,24,11,2,0,2,0,2,391,94,27960,30671,34809,0,-45,16,-1688,-2,-809,-9433,-2,0,-1,0,11
EUW1_6868559355',4,22,10,0,0,0,0,7,0,378,64,25018,29634,36804,5,35,14,2,0,1,0,1,358,136,29256,33293,29986,0,20,-72,-4238,-4,-3659,6818,-2,0,-1,0,6
EUW1_6868503912',4,274,11,0,0,1,0,13,0,350,70,27691,29118,35205,6,46,15,1,0,0,0,1,390,121,30237,31966,34191,0,-40,-51,-2546,-4,-2848,1014,-1,0,1,0,12
EUW1_6868443910',5,30,11,1,0,0,0,6,1,370,89,26586,30774,34160,3,35,13,1,0,0,0,2,336,114,27642,30470,39761,0,34,-25,-1056,-2,304,-5601,0,0,0,0,4
EUW1_6867476137',3,29,13,1,0,0,0,7,1,333,110,28091,30569,38809,4,31,15,0,0,1,0,3,336,94,28595,30492,35553,0,-3,16,-504,-2,77,3256,1,0,-1,0,4
EUW1_6867429749',4,31,17,1,0,2,0,5,0,407,105,31871,33331,32220,3,23,8,0,0,0,0,5,331,68,24825,26444,28494,1,76,37,7046,9,6887,3726,1,0,2,0,0
EUW1_6865232231',4,25,19,1,1,2,0,7,1,377,102,32012,32798,38340,3,24,8,1,0,0,0,7,348,74,25008,28432,25665,1,29,28,7004,11,4366,12675,0,1,2,0,0
EUW1_6865165485',5,147,6,0,0,0,0,10,1,342,92,24302,29467,19536,6,37,14,2,0,1,0,0,389,107,27898,31540,30873,0,-47,-15,-3596,-8,-2073,-11337,-2,0,-1,0,10
EUW1_6883490988',2,43,16,1,0,1,0,12,0,324,91,28238,28852,37659,1,288,13,0,0,1,0,3,340,80,26408,27109,30256,1,-16,11,1830,3,1743,7403,1,0,0,0,9
EUW1_6883440836',7,38,15,2,0,0,0,6,0,393,88,29008,30581,32084,5,36,13,0,1,0,0,6,403,100,28313,33162,37854,0,-10,-12,695,2,-2581,-5770,2,-1,0,0,0
EUW1_6883373880',7,30,13,0,0,0,0,17,0,365,72,27648,28551,27097,4,27,19,1,0,5,0,1,365,90,34187,29280,40357,0,0,-18,-6539,-6,-729,-13260,-1,0,-5,0,16
EUW1_6883297405',2,27,9,1,0,1,0,12,1,345,88,24556,26741,25017,2,27,4,1,0,0,0,3,387,98,24989,28015,14926,1,-42,-10,-433,5,-1274,10091,0,0,1,0,9
EUW1_6883153990',5,30,14,0,0,2,0,9,0,353,92,29097,28735,28225,5,59,12,1,0,1,0,4,393,74,28479,29292,30962,0,-40,18,618,2,-557,-2737,-1,0,1,0,5
EUW1_6882951904',3,35,18,1,1,2,0,5,1,335,99,31381,29084,40756,3,72,14,1,0,0,0,10,315,88,26673,28705,38343,1,20,11,4708,4,379,2413,0,1,2,0,-5
EUW1_6882759448',3,27,15,2,0,2,0,10,1,371,70,29269,29095,28477,5,33,6,0,0,1,0,6,372,109,25424,27152,24027,1,-1,-39,3845,9,1943,4450,2,0,1,0,4
EUW1_6882694631',8,33,16,0,1,0,0,16,1,356,73,28456,30585,31769,3,26,11,2,0,1,0,1,373,130,29015,31234,33408,0,-17,-57,-559,5,-649,-1639,-2,1,-1,0,15
EUW1_6882651936',5,30,11,1,0,1,0,16,0,379,108,28917,30076,32056,3,56,11,1,0,3,0,7,390,99,29524,29898,34428,0,-11,9,-607,0,178,-2372,0,0,-2,0,9
EUW1_6882603642',5,63,7,1,0,2,0,6,1,389,93,27172,28271,26129,1,27,7,1,1,0,0,5,377,86,24968,28237,21246,0,12,7,2204,0,34,4883,0,-1,2,0,1
EUW1_6882562635',5,34,16,1,1,0,0,8,0,388,112,30784,32306,33055,6,32,6,1,0,1,0,3,355,88,25076,28155,20021,1,33,24,5708,10,4151,13034,0,1,-1,0,5
EUW1_6882525742',6,39,11,0,0,0,0,8,1,363,86,26817,28099,33585,6,181,15,2,0,1,0,3,377,95,30154,31623,30128,0,-14,-9,-3337,-4,-3524,3457,-2,0,-1,0,5
EUW1_6882199843',6,29,18,0,1,1,0,7,1,363,107,30372,31736,36064,2,103,10,1,0,0,0,6,329,112,26670,30613,32235,0,34,-5,3702,8,1123,3829,-1,1,1,0,1
EUW1_6882180800',5,99,23,0,1,4,0,6,1,365,99,35514,33016,44783,6,33,10,2,0,0,0,13,337,88,26598,27253,29333,1,28,11,8916,13,5763,15450,-2,1,4,0,-7
EUW1_6882153939',1,25,11,0,0,0,0,12,0,286,66,25625,27376,34833,2,55,19,2,0,2,0,1,360,112,32536,32678,46007,0,-74,-46,-6911,-8,-5302,-11174,-2,0,-2,0,11
EUW1_6881668809',4,22,10,0,0,1,0,11,0,344,82,26352,28344,30547,4,24,16,1,0,1,0,4,385,81,29794,29555,35911,0,-41,1,-3442,-6,-1211,-5364,-1,0,0,0,7
EUW1_6881623363',2,22,10,0,0,1,0,12,1,385,36,26408,27523,36309,6,33,24,2,1,2,0,7,325,86,32177,31009,47513,0,60,-50,-5769,-14,-3486,-11204,-2,-1,-1,0,5
EUW1_6879895048',6,35,4,0,0,1,0,7,0,374,99,23817,29523,18396,6,30,10,2,0,1,0,1,439,72,27648,31337,29310,0,-65,27,-3831,-6,-1814,-10914,-2,0,0,0,6
EUW1_6879853302',7,35,18,2,0,3,0,14,1,365,86,31227,31719,41179,6,64,6,0,0,2,0,8,364,73,26056,26347,26351,1,1,13,5171,12,5372,14828,2,0,1,0,6
EUW1_6879757469',4,35,7,2,0,0,0,14,0,330,86,24518,27759,24027,7,26,16,0,0,3,0,1,417,94,33369,30329,34430,1,-87,-8,-8851,-9,-2570,-10403,2,0,-3,0,13
EUW1_6883664399',6,32,15,2,0,1,0,9,0,372,90,29312,31039,41967,4,29,13,0,0,1,0,3,385,90,29456,29338,33929,1,-13,0,-144,2,1701,8038,2,0,0,0,6
EUW1_6882150401',0,29,9,0,0,0,0,11,1,391,84,26338,29424,30302,8,29,13,1,0,0,0,2,368,84,28450,29851,25865,0,23,0,-2112,-4,-427,4437,-1,0,0,0,9
EUW1_6882109511',7,39,12,1,0,0,0,10,1,370,70,26995,28698,29139,4,24,8,1,0,1,0,3,384,79,26493,28694,31959,0,-14,-9,502,4,4,-2820,0,0,-1,0,7
EUW1_6882055499',2,42,16,0,0,0,0,8,0,394,82,30836,31894,31585,4,28,13,2,1,1,0,8,358,110,29286,29814,28828,1,36,-28,1550,3,2080,2757,-2,-1,-1,0,0
EUW1_6876409264',6,33,11,1,0,0,0,10,1,339,88,25664,27408,31125,4,39,6,1,0,1,0,3,392,78,25542,27850,29250,1,-53,10,122,5,-442,1875,0,0,-1,0,7
EUW1_6876398376',4,102,14,2,1,0,0,7,1,353,90,27589,30306,33816,6,156,10,0,0,0,0,1,329,63,24273,27386,30334,1,24,27,3316,4,2920,3482,2,1,0,0,6
EUW1_6876393530',6,20,15,0,0,1,0,10,0,331,74,28880,28158,39608,2,28,18,1,0,2,0,2,357,74,28994,29898,43801,0,-26,0,-114,-3,-1740,-4193,-1,0,-1,0,8
EUW1_6876372034',4,25,12,0,0,0,0,7,0,336,83,26643,28919,34527,1,133,22,1,0,1,0,2,393,92,32358,33194,36118,0,-57,-9,-5715,-10,-4275,-1591,-1,0,-1,0,5
EUW1_6873719527',4,56,13,0,0,1,0,9,1,350,96,28394,29124,36339,4,54,14,1,0,1,0,6,354,83,28459,28651,35332,0,-4,13,-65,-1,473,1007,-1,0,0,0,3
EUW1_6873703166',7,31,16,1,0,2,0,7,1,351,66,30059,28944,30607,6,34,10,1,0,0,0,5,336,105,25862,28573,29638,1,15,-39,4197,6,371,969,0,0,2,0,2
EUW1_6873685115',2,17,5,1,0,0,0,8,0,413,100,24768,29760,22638,0,100,9,1,0,1,0,2,379,100,27716,31136,22796,0,34,0,-2948,-4,-1376,-158,0,0,-1,0,6
EUW1_6873670598',3,173,6,0,0,0,0,9,0,345,70,23559,27951,19340,2,97,9,2,0,0,0,0,398,84,26092,30894,27954,0,-53,-14,-2533,-3,-2943,-8614,-2,0,0,0,9
EUW1_6873645890',4,46,6,0,0,0,0,6,0,391,81,25096,28195,23675,7,30,4,2,0,0,0,3,378,98,24112,27965,24383,1,13,-17,984,2,230,-708,-2,0,0,0,3
EUW1_6873620990',7,32,11,2,0,0,0,11,0,332,92,26229,28269,33029,2,31,13,0,0,2,0,2,395,75,29118,31003,35500,0,-63,17,-2889,-2,-2734,-2471,2,0,-2,0,9
EUW1_6864552088',2,21,17,0,0,0,0,8,0,267,92,28004,25713,31258,3,28,17,2,0,2,0,0,359,110,33138,30571,38626,0,-92,-18,-5134,0,-4858,-7368,-2,0,-2,0,8
EUW1_6864537445',1,44,20,0,1,2,0,6,1,364,103,31037,32916,33771,0,22,10,2,0,0,0,7,339,104,26781,28995,28235,1,25,-1,4256,10,3921,5536,-2,1,2,0,-1
EUW1_6864528215',2,28,13,2,1,0,0,9,0,342,89,27916,27552,35942,2,27,14,0,0,2,0,1,366,103,29863,30576,37620,0,-24,-14,-1947,-1,-3024,-1678,2,1,-2,0,8
EUW1_6883669040',5,37,7,1,0,0,0,8,0,360,98,24983,28059,36712,6,36,12,1,1,0,0,1,360,86,26354,30351,30354,1,0,12,-1371,-5,-2292,6358,0,-1,0,0,7
EUW1_6883620858',4,24,8,0,0,1,0,8,1,388,98,26464,29464,29515,3,27,15,1,0,1,0,4,387,82,29037,32255,35545,1,1,16,-2573,-7,-2791,-6030,-1,0,0,0,4
EUW1_6883599964',3,21,6,0,0,0,0,7,0,352,82,23957,27186,28434,5,26,16,1,1,1,0,4,377,98,29726,32920,34596,0,-25,-16,-5769,-10,-5734,-6162,-1,-1,-1,0,3
EUW1_6883563613',7,74,23,1,0,2,0,5,1,349,87,32944,29986,45002,0,20,10,1,0,2,0,8,323,96,26612,28596,35578,0,26,-9,6332,13,1390,9424,0,0,0,0,-3
EUW1_6883522564',4,27,10,0,0,0,0,9,0,370,100,26151,32193,25842,6,35,13,1,0,2,0,1,408,93,29819,32936,39579,0,-38,7,-3668,-3,-743,-13737,-1,0,-2,0,8
EUW1_6883478365',5,26,7,0,0,0,0,14,0,295,72,23534,26456,29301,5,27,20,2,0,3,0,1,442,96,32748,33282,38538,0,-147,-24,-9214,-13,-6826,-9237,-2,0,-3,0,13
EUW1_6883417701',6,31,15,1,1,0,0,8,0,370,104,28928,32046,35629,7,30,7,1,0,0,0,3,390,86,25886,29031,39832,0,-20,18,3042,8,3015,-4203,0,1,0,0,5
EUW1_6883344727',2,37,15,1,0,0,0,6,0,333,76,26718,29306,35380,1,22,14,0,0,0,0,5,270,108,26540,28121,32599,1,63,-32,178,1,1185,2781,1,0,0,0,1
EUW1_6882968427',3,28,12,0,0,0,0,13,0,372,103,26671,28950,29415,4,35,19,2,0,1,0,0,406,84,32025,33321,30770,0,-34,19,-5354,-7,-4371,-1355,-2,0,-1,0,13
EUW1_6882921838',14,37,15,1,0,0,0,7,1,367,92,29514,30222,40323,3,33,9,1,0,1,0,4,337,100,26270,28352,36555,1,30,-8,3244,6,1870,3768,0,0,-1,0,3
EUW1_6882873749',3,26,9,0,0,1,0,8,0,342,78,25623,28805,32143,0,33,11,1,0,1,0,5,362,110,28002,31433,36752,0,-20,-32,-2379,-2,-2628,-4609,-1,0,0,0,3
EUW1_6882815414',6,57,17,0,0,1,0,10,1,317,88,29322,28757,34393,4,59,13,1,0,0,0,6,346,72,27659,27738,37061,0,-29,16,1663,4,1019,-2668,-1,0,1,0,4
EUW1_6882775391',4,28,12,0,0,0,0,8,1,322,94,25759,28130,33743,4,23,12,1,0,1,0,1,387,74,28377,31775,34312,1,-65,20,-2618,0,-3645,-569,-1,0,-1,0,7
EUW1_6882647730',8,34,10,2,0,2,0,9,1,386,88,28046,29953,26582,5,33,11,0,1,0,0,5,369,112,26300,30391,24275,0,17,-24,1746,-1,-438,2307,2,-1,2,0,4
EUW1_6882605647',4,28,14,1,0,1,0,10,1,376,92,30305,30600,29572,1,21,16,1,1,1,0,4,375,79,30366,31565,34749,1,1,13,-61,-2,-965,-5177,0,-1,0,0,6
EUW1_6882569974',3,26,15,2,0,1,0,5,0,373,89,29053,31394,30608,4,23,5,0,0,0,0,6,380,91,24168,28342,29745,0,-7,-2,4885,10,3052,863,2,0,1,0,-1
EUW1_6882543825',2,31,12,0,0,0,0,8,0,355,80,26825,28994,29159,9,34,13,2,0,1,0,1,384,95,28912,30780,26927,0,-29,-15,-2087,-1,-1786,2232,-2,0,-1,0,7
EUW1_6882165762',3,41,11,0,0,1,0,11,1,385,64,27087,29012,27038,4,42,20,1,0,1,0,1,360,116,31733,32251,37045,0,25,-52,-4646,-9,-3239,-10007,-1,0,0,0,10
EUW1_6882121745',2,27,11,0,1,0,0,8,0,328,99,27551,30327,35868,3,60,15,1,0,1,0,6,361,71,29609,31767,41565,1,-33,28,-2058,-4,-1440,-5697,-1,1,-1,0,2
EUW1_6882009473',3,24,19,0,0,1,0,9,0,305,71,30262,28736,38035,5,26,14,2,0,1,0,3,352,92,28720,29076,39761,0,-47,-21,1542,5,-340,-1726,-2,0,0,0,6
EUW1_6883494307',8,32,11,2,0,2,0,6,1,381,83,27912,28121,34632,3,21,10,0,0,0,0,6,315,86,25967,26569,29599,0,66,-3,1945,1,1552,5033,2,0,2,0,0
EUW1_6883460739',2,23,19,1,1,2,0,10,1,376,104,32057,32870,36662,2,24,17,1,0,0,0,7,350,79,31491,31082,36824,0,26,25,566,2,1788,-162,0,1,2,0,3
EUW1_6883409715',3,32,12,1,0,0,0,7,0,374,85,26672,30855,33130,3,28,9,1,0,1,0,5,376,92,26933,28198,33498,0,-2,-7,-261,3,2657,-368,0,0,-1,0,2
EUW1_6883322646',4,26,18,0,0,2,0,10,0,358,70,31233,29758,34912,5,39,14,1,0,1,0,10,335,93,27529,27850,29295,1,23,-23,3704,4,1908,5617,-1,0,1,0,0
EUW1_6883249737',6,52,11,2,0,0,0,11,1,280,84,24802,24380,29346,3,77,16,0,0,1,0,1,286,67,27661,24375,34250,0,-6,17,-2859,-5,5,-4904,2,0,-1,0,10
EUW1_6883151938',5,32,13,1,0,0,0,13,0,333,98,28317,29686,29136,1,24,20,1,0,2,0,4,354,94,32289,30926,35288,0,-21,4,-3972,-7,-1240,-6152,0,0,-2,0,9
EUW1_6883094605',5,23,5,1,0,1,0,15,1,357,88,25128,27052,20712,3,204,10,1,0,2,0,2,403,88,29475,29101,30265,0,-46,0,-4347,-5,-2049,-9553,0,0,-1,0,13
EUW1_6883051112',7,29,13,2,0,3,0,12,1,413,124,32032,33904,25817,3,22,4,0,0,0,0,7,339,66,22479,26532,20684,1,74,58,9553,9,7372,5133,2,0,3,0,5
EUW1_6882137222',4,89,15,1,0,0,0,13,1,362,74,29594,30145,32647,2,26,15,1,0,3,0,2,368,132,31461,32323,37079,0,-6,-58,-1867,0,-2178,-4432,0,0,-3,0,11
EUW1_6882122583',3,23,9,0,0,0,0,11,1,303,78,24842,26054,26785,2,27,26,2,0,2,0,1,361,86,33632,31995,48652,0,-58,-8,-8790,-17,-5941,-21867,-2,0,-2,0,10
EUW1_6882070745',3,54,18,1,0,1,0,17,0,259,75,28524,26049,41717,9,33,28,0,1,4,0,1,362,109,36281,31491,42433,0,-103,-34,-7757,-10,-5442,-716,1,-1,-3,0,16
EUW1_6880682859',4,26,9,0,0,0,0,9,0,350,85,25506,27125,23627,4,28,18,0,0,2,0,4,347,94,30542,30332,42639,0,3,-9,-5036,-9,-3207,-19012,0,0,-2,0,5
EUW1_6883374422',5,35,7,0,0,1,0,5,1,380,93,26308,28798,24228,4,27,9,2,0,0,0,4,409,102,25687,30674,22457,0,-29,-9,621,-2,-1876,1771,-2,0,1,0,1
EUW1_6883302096',4,27,12,1,0,0,0,7,0,393,65,26714,29606,30354,5,30,8,0,0,0,0,4,385,87,25639,28691,26583,0,8,-22,1075,4,915,3771,1,0,0,0,3
EUW1_6883240781',1,24,21,1,0,2,0,12,0,343,96,32625,30454,37848,7,42,21,0,0,1,0,6,369,48,31291,28699,37972,1,-26,48,1334,0,1755,-124,1,0,1,0,6
EUW1_6883099996',3,22,12,0,0,0,0,12,0,364,87,26969,28775,28943,3,28,14,2,0,2,0,3,360,100,29828,29237,29914,0,4,-13,-2859,-2,-462,-971,-2,0,-2,0,9
EUW1_6883048893',1,28,14,1,0,0,0,11,0,390,88,29128,31038,30499,2,32,11,1,0,2,0,4,384,124,28031,31840,27392,1,6,-36,1097,3,-802,3107,0,0,-2,0,7
EUW1_6882983982',4,27,6,0,0,0,0,4,0,419,100,25409,30849,27819,7,28,10,1,0,0,0,2,373,99,26794,31062,24779,0,46,1,-1385,-4,-213,3040,-1,0,0,0,2
EUW1_6882926365',5,44,5,0,0,0,0,13,0,359,82,23379,27567,29891,3,136,10,1,1,2,0,5,368,102,29591,31312,43279,0,-9,-20,-6212,-5,-3745,-13388,-1,-1,-2,0,8
EUW1_6882889978',1,24,7,0,0,1,0,10,0,377,96,27861,28639,26369,3,31,22,2,0,2,0,5,384,72,32546,32825,38046,0,-7,24,-4685,-15,-4186,-11677,-2,0,-1,0,5
EUW1_6882830391',1,24,8,2,0,0,0,12,1,370,83,25238,29880,22479,5,30,13,0,0,1,0,2,414,115,29464,33035,32790,0,-44,-32,-4226,-5,-3155,-10311,2,0,-1,0,10
EUW1_6882701001',2,22,11,1,0,1,0,14,0,319,77,26999,27539,38035,3,55,13,1,0,2,0,6,347,85,28812,29178,29233,0,-28,-8,-1813,-2,-1639,8802,0,0,-1,0,8
EUW1_6882658177',2,52,10,2,0,1,0,5,1,359,90,26609,28427,27452,3,39,10,0,0,0,0,5,373,75,26151,28597,30097,0,-14,15,458,0,-170,-2645,2,0,1,0,0
EUW1_6882579661',2,31,11,0,0,2,0,10,1,351,82,27519,28383,27938,8,36,22,2,0,1,0,8,385,82,32284,31059,39101,1,-34,0,-4765,-11,-2676,-11163,-2,0,1,0,2
EUW1_6882542367',3,21,15,1,0,3,0,9,1,359,86,30617,30510,37689,4,26,9,0,0,0,0,11,321,68,24997,27863,35257,1,38,18,5620,6,2647,2432,1,0,3,0,-2
EUW1_6874830554',1,24,4,0,0,0,0,9,0,388,86,24449,29531,22011,3,99,12,1,1,2,0,4,380,121,28244,31896,32470,0,8,-35,-3795,-8,-2365,-10459,-1,-1,-2,0,5
EUW1_6874749273',8,33,5,2,0,0,0,3,0,401,92,24398,30129,27390,5,33,11,0,0,0,0,2,393,108,27587,31764,27923,0,8,-16,-3189,-6,-1635,-533,2,0,0,0,1
EUW1_6874576370',3,24,17,2,0,2,0,5,1,411,102,29922,33563,40066,4,50,3,0,0,0,0,9,364,81,22879,27261,27345,1,47,21,7043,14,6302,12721,2,0,2,0,-4
EUW1_6874526873',0,27,8,1,0,0,0,10,1,344,108,25734,29604,26843,2,25,13,1,0,0,0,5,404,92,27885,30585,40803,0,-60,16,-2151,-5,-981,-13960,0,0,0,0,5
EUW1_6874465470',6,27,14,1,0,0,0,10,1,335,72,27269,27007,35832,8,31,21,0,0,0,0,3,370,94,30305,31077,42103,0,-35,-22,-3036,-7,-4070,-6271,1,0,0,0,7
EUW1_6874405068',3,31,9,0,1,0,0,6,1,378,88,27147,31024,29961,5,28,7,2,0,1,0,4,380,88,25298,28166,27525,1,-2,0,1849,2,2858,2436,-2,1,-1,0,2
EUW1_6882017886',1,20,17,1,0,2,0,7,1,393,78,30791,31928,37827,3,37,5,0,0,1,0,6,371,86,24228,28110,25149,1,22,-8,6563,12,3818,12678,1,0,1,0,1
EUW1_6881939204',3,23,16,0,0,0,0,9,0,370,86,28645,28815,38293,5,32,15,1,0,0,0,3,315,61,26591,27458,29314,1,55,25,2054,1,1357,8979,-1,0,0,0,6
EUW1_6881847951',3,30,11,0,0,0,0,19,0,317,76,27047,28629,30932,5,26,20,2,0,4,0,4,338,87,30907,28631,38847,0,-21,-11,-3860,-9,-2,-7915,-2,0,-4,0,15
EUW1_6881765148',6,27,11,0,0,1,0,10,1,390,80,27634,28228,23213,4,31,13,2,0,0,0,6,337,86,28383,28324,33283,0,53,-6,-749,-2,-96,-10070,-2,0,1,0,4
EUW1_6881691925',2,21,17,1,0,1,0,9,1,372,88,30135,30719,35669,5,32,4,1,0,0,0,6,336,97,22109,26224,21323,1,36,-9,8026,13,4495,14346,0,0,1,0,3
EUW1_6880460047',7,29,8,0,0,0,0,5,0,347,98,25291,27400,28444,1,21,11,2,0,1,0,3,401,62,27775,28614,26000,0,-54,36,-2484,-3,-1214,2444,-2,0,-1,0,2
EUW1_6880412365',3,27,25,2,1,3,0,8,1,371,76,35448,33769,46396,10,35,11,0,0,2,0,9,316,79,26629,26386,32785,1,55,-3,8819,14,7383,13611,2,1,1,0,-1
EUW1_6879136900',4,30,15,1,0,3,0,7,0,363,97,30408,28784,34107,11,46,13,1,1,0,0,9,315,80,26974,27407,32146,1,48,17,3434,2,1377,1961,0,-1,3,0,-2
EUW1_6879079434',6,33,17,0,0,2,0,11,0,310,64,29722,29467,44220,6,31,16,2,0,0,0,9,317,76,28469,29912,41233,0,-7,-12,1253,1,-445,2987,-2,0,2,0,2
EUW1_6879026969',4,35,2,0,0,0,0,13,0,350,97,22512,28044,16825,5,29,7,1,0,2,0,2,414,84,27039,29878,24340,0,-64,13,-4527,-5,-1834,-7515,-1,0,-2,0,11
EUW1_6878948742',3,31,16,1,0,0,0,8,0,398,88,30340,31744,36068,7,34,10,0,0,1,0,6,379,93,27902,27952,31454,0,19,-5,2438,6,3792,4614,1,0,-1,0,2
EUW1_6878387952',2,29,24,0,0,1,0,9,0,368,115,33229,33287,39506,2,21,11,1,0,3,0,7,345,40,26471,26383,29742,1,23,75,6758,13,6904,9764,-1,0,-2,0,2
EUW1_6877831562',2,33,19,1,0,1,0,13,1,373,124,32700,32487,38151,3,31,11,0,0,2,0,3,325,66,26704,27521,30714,1,48,58,5996,8,4966,7437,1,0,-1,0,10
EUW1_6877799774',3,26,14,0,0,0,0,8,1,324,86,26104,28513,29226,1,95,12,2,0,0,0,0,357,85,28100,29264,32546,0,-33,1,-1996,2,-751,-3320,-2,0,0,0,8
EUW1_6877783539',5,48,23,1,0,2,0,3,0,394,82,32468,32651,50662,1,30,7,0,0,1,0,8,268,64,21619,23579,32694,1,126,18,10849,16,9072,17968,1,0,1,0,-5
EUW1_6877727283',0,31,11,1,0,0,0,13,0,324,111,25960,30709,24585,6,36,13,1,0,2,0,2,403,79,29771,30739,31316,0,-79,32,-3811,-2,-30,-6731,0,0,-2,0,11
EUW1_6874837040',4,34,22,0,0,3,0,11,1,353,92,33362,33019,39457,2,26,13,2,0,1,0,12,396,91,28211,30496,39027,1,-43,1,5151,9,2523,430,-2,0,2,0,-1
EUW1_6874795263',1,24,16,2,0,1,0,12,0,331,93,28389,29820,32051,3,26,7,0,0,0,0,3,410,78,27327,29287,33161,1,-79,15,1062,9,533,-1110,2,0,1,0,9
EUW1_6874739074',3,24,15,2,0,1,0,14,1,409,97,31070,32182,31905,1,23,10,0,1,2,0,5,334,85,27088,27916,30211,0,75,12,3982,5,4266,1694,2,-1,-1,0,9
EUW1_6874667982',5,22,11,2,0,2,0,7,1,390,118,29197,30520,29097,1,27,9,0,0,1,0,6,357,85,26789,30321,26794,1,33,33,2408,2,199,2303,2,0,1,0,1
EUW1_6874607937',3,60,18,2,0,6,1,8,0,368,104,35260,30559,36613,0,59,14,0,0,3,0,9,248,67,25649,25878,28508,1,120,37,9611,4,4681,8105,2,0,3,1,-1
EUW1_6872182856',3,45,9,0,0,1,0,15,1,356,71,26478,27331,45136,4,34,23,1,0,2,0,4,375,80,32240,33763,42262,0,-19,-9,-5762,-14,-6432,2874,-1,0,-1,0,11
EUW1_6872036090',8,38,17,1,0,2,0,9,1,397,95,31567,31377,31006,5,37,10,1,0,1,0,8,372,80,26845,27718,25402,1,25,15,4722,7,3659,5604,0,0,1,0,1
EUW1_6871981377',4,26,21,1,0,1,0,7,1,360,89,31465,32359,39720,0,136,12,1,0,0,0,5,363,90,28467,29964,34643,1,-3,-1,2998,9,2395,5077,0,0,1,0,2
EUW1_6870889031',1,29,9,0,0,0,0,14,0,371,90,26967,30284,36623,4,31,25,2,0,3,0,3,353,97,34770,34558,42238,0,18,-7,-7803,-16,-4274,-5615,-2,0,-3,0,11
EUW1_6870872256',7,40,13,2,0,2,0,11,0,383,94,28621,30410,38685,12,57,11,0,0,0,0,5,336,86,26703,27634,38846,1,47,8,1918,2,2776,-161,2,0,2,0,6
EUW1_6870794314',2,22,11,0,0,0,0,14,1,356,89,28161,29031,32962,3,26,23,2,0,0,0,2,350,80,29389,30243,41944,1,6,9,-1228,-12,-1212,-8982,-2,0,0,0,12
EUW1_6870694464',3,24,21,0,0,1,0,11,1,347,91,32052,32092,40716,5,23,18,1,0,0,0,5,350,58,27781,29853,38734,0,-3,33,4271,3,2239,1982,-1,0,1,0,6
EUW1_6880318943',7,33,10,1,0,1,0,12,1,294,88,25642,27361,32683,1,26,13,1,0,2,0,5,378,80,28729,30953,32713,0,-84,8,-3087,-3,-3592,-30,0,0,-1,0,7
EUW1_6879975543',3,28,10,1,1,0,0,11,1,385,104,27848,31616,40482,5,28,10,1,0,1,0,3,389,72,27565,29055,39355,0,-4,32,283,0,2561,1127,0,1,-1,0,8
EUW1_6879889569',2,47,15,2,0,0,0,11,0,316,85,26880,27330,35471,6,35,13,0,0,1,0,4,374,91,29473,29681,32094,0,-58,-6,-2593,2,-2351,3377,2,0,-1,0,7
EUW1_6879742861',4,173,27,1,1,0,0,14,0,295,91,33097,31794,43410,5,30,13,0,0,1,0,4,358,79,28190,28392,33478,1,-63,12,4907,14,3402,9932,1,1,-1,0,10
EUW1_6879671250',2,31,11,0,1,1,0,13,0,396,92,28721,29362,28715,9,27,16,2,0,1,0,6,392,91,31371,31286,33143,0,4,1,-2650,-5,-1924,-4428,-2,1,0,0,7
EUW1_6879063234',6,34,6,1,0,0,0,10,0,383,102,26265,29984,29004,5,23,17,1,0,2,0,4,422,82,31693,30962,33257,0,-39,20,-5428,-11,-978,-4253,0,0,-2,0,6
EUW1_6879000263',1,215,10,0,0,0,0,16,0,324,103,25787,30141,26247,6,25,21,1,0,3,0,1,339,108,32892,31840,40390,1,-15,-5,-7105,-11,-1699,-14143,-1,0,-3,0,15
EUW1_6878962563',2,28,10,0,0,0,0,11,0,303,76,24134,26479,30059,6,28,18,2,0,2,0,3,380,96,31325,30945,42724,0,-77,-20,-7191,-8,-4466,-12665,-2,0,-2,0,8
EUW1_6878778786',1,63,7,1,1,2,0,6,0,353,102,27015,28712,24302,1,59,13,1,0,1,0,4,392,74,27984,29795,32174,0,-39,28,-969,-6,-1083,-7872,0,1,1,0,2
EUW1_6878740645',5,30,14,1,0,2,0,7,1,436,84,30905,32118,39560,3,26,6,0,0,1,0,12,311,87,23021,28694,30087,1,125,-3,7884,8,3424,9473,1,0,1,0,-5
EUW1_6878690176',5,28,15,0,0,0,0,10,0,340,86,29643,30047,40827,4,25,15,2,0,1,0,5,367,66,29123,29642,37054,0,-27,20,520,0,405,3773,-2,0,-1,0,5
EUW1_6878557454',2,19,12,0,0,1,0,9,1,366,82,29395,30352,32631,7,31,21,2,0,1,0,7,328,85,30127,31040,37525,0,38,-3,-732,-9,-688,-4894,-2,0,0,0,2
EUW1_6878292996',4,62,18,1,0,1,0,12,1,334,87,28735,29289,42926,2,61,22,0,0,2,0,3,311,64,30724,30696,39611,0,23,23,-1989,-4,-1407,3315,1,0,-1,0,9
EUW1_6878226310',3,24,22,2,0,1,0,11,0,330,120,31728,31031,37463,6,28,13,0,1,1,0,5,379,72,29275,31146,36972,1,-49,48,2453,9,-115,491,2,-1,0,0,6
EUW1_6878193405',0,52,2,0,0,0,0,7,0,333,91,21289,25607,26673,4,32,20,1,0,2,0,3,386,92,30230,33332,42521,0,-53,-1,-8941,-18,-7725,-15848,-1,0,-2,0,4
EUW1_6877829797',3,43,18,1,0,1,0,7,0,357,96,30527,31070,32248,1,24,6,0,0,2,0,10,351,87,24752,27038,25607,1,6,9,5775,12,4032,6641,1,0,-1,0,-3
EUW1_6877689051',1,23,10,0,0,0,0,7,1,341,70,26056,26165,27429,4,26,18,2,0,0,0,3,329,89,28536,28868,32517,0,12,-19,-2480,-8,-2703,-5088,-2,0,0,0,4
EUW1_6877297380',4,24,13,0,0,0,0,11,1,352,96,28862,28184,34144,4,29,9,1,0,3,0,6,333,99,25456,28561,26402,0,19,-3,3406,4,-377,7742,-1,0,-3,0,5
EUW1_6877025724',2,30,9,1,0,0,0,5,0,358,78,25684,28013,24783,2,27,13,1,0,0,0,1,380,76,27051,30256,30389,1,-22,2,-1367,-4,-2243,-5606,0,0,0,0,4
EUW1_6875572149',2,38,21,1,1,1,0,9,1,332,86,31200,30455,41341,3,18,12,1,0,1,0,7,360,105,28961,29574,33709,1,-28,-19,2239,9,881,7632,0,1,0,0,2
EUW1_6871400940',5,29,8,0,1,0,0,11,1,380,106,25995,31565,23021,2,26,5,2,0,2,0,6,398,102,26381,30304,30097,0,-18,4,-386,3,1261,-7076,-2,1,-2,0,5
EUW1_6870927373',2,69,13,1,0,0,0,10,1,333,86,27082,28821,31593,3,68,9,0,0,0,0,0,350,82,25404,28605,28658,1,-17,4,1678,4,216,2935,1,0,0,0,10
EUW1_6870917083',3,26,14,1,0,0,0,12,1,323,86,27000,28073,32876,3,30,18,0,0,1,0,0,364,95,31654,30997,33990,0,-41,-9,-4654,-4,-2924,-1114,1,0,-1,0,12
EUW1_6870892375',4,40,13,0,1,0,0,8,1,369,66,27398,29130,30000,3,26,15,1,0,0,0,2,401,85,28900,30318,30989,0,-32,-19,-1502,-2,-1188,-989,-1,1,0,0,6
EUW1_6870872266',3,26,13,1,0,0,0,15,0,322,98,28175,28521,35995,5,27,11,0,0,3,0,5,406,74,29007,30629,34945,1,-84,24,-832,2,-2108,1050,1,0,-3,0,10
EUW1_6870857838',1,29,24,1,0,0,0,11,1,375,79,31915,31122,40813,3,23,5,1,0,1,0,4,339,64,22869,26554,33507,1,36,15,9046,19,4568,7306,0,0,-1,0,7
EUW1_6870834525',4,45,15,0,0,1,0,7,0,322,132,29400,31309,34761,7,31,9,1,0,0,0,6,343,68,25108,27389,25965,1,-21,64,4292,6,3920,8796,-1,0,1,0,1
EUW1_6870078365',2,28,5,0,0,0,0,7,0,371,86,24162,29157,21079,5,32,11,1,1,0,0,3,391,102,27629,29973,22851,0,-20,-16,-3467,-6,-816,-1772,-1,-1,0,0,4
EUW1_6870028179',6,45,9,2,0,2,0,5,1,386,87,27388,29263,24826,4,32,7,0,0,0,0,10,332,104,24425,30105,24687,1,54,-17,2963,2,-842,139,2,0,2,0,-5
EUW1_6869263923',1,33,18,1,0,0,0,9,0,343,97,30298,31570,40924,0,23,19,1,0,1,0,4,335,55,29794,28619,39778,0,8,42,504,-1,2951,1146,0,0,-1,0,5
EUW1_6869247907',1,23,7,2,0,0,0,17,0,302,74,24361,27583,32670,3,26,19,0,0,3,0,1,362,102,32177,30457,42569,0,-60,-28,-7816,-12,-2874,-9899,2,0,-3,0,16
EUW1_6869229804',3,24,16,1,1,2,0,7,1,361,84,30080,33191,38246,4,39,10,0,0,0,0,2,345,77,24486,29037,28465,1,16,7,5594,6,4154,9781,1,1,2,0,5
EUW1_6869138240',0,31,11,0,0,0,0,12,0,388,100,26995,30188,25037,6,36,17,2,1,1,0,2,395,116,30316,33064,34358,0,-7,-16,-3321,-6,-2876,-9321,-2,-1,-1,0,10
EUW1_6869111151',1,20,6,1,0,0,0,13,0,322,84,24154,27443,27550,3,22,20,1,0,3,0,2,399,104,32755,33439,37060,0,-77,-20,-8601,-14,-5996,-9510,0,0,-3,0,11
EUW1_6869077414',3,22,12,2,0,1,0,8,1,369,118,29824,30406,28146,6,36,10,0,0,1,0,6,331,89,25312,28574,28107,1,38,29,4512,2,1832,39,2,0,0,0,2
EUW1_6869030893',2,26,14,1,0,1,0,6,1,323,97,28615,28976,27221,5,28,16,1,0,0,0,3,379,97,28270,31296,35034,1,-56,0,345,-2,-2320,-7813,0,0,1,0,3
EUW1_6868985289',4,29,12,0,0,1,0,10,0,367,94,28591,31628,30029,3,35,12,1,1,0,0,7,363,81,27081,30693,35266,0,4,13,1510,0,935,-5237,-1,-1,1,0,3
EUW1_6881612632',2,28,12,0,0,0,0,13,1,341,78,27440,27289,31476,2,40,17,1,0,3,0,5,363,90,31265,30358,36181,0,-22,-12,-3825,-5,-3069,-4705,-1,0,-3,0,8
EUW1_6881553019',6,61,9,0,0,1,0,11,0,350,90,26456,28481,27024,4,170,14,2,0,3,0,4,379,86,29902,30325,25049,0,-29,4,-3446,-5,-1844,1975,-2,0,-2,0,7
EUW1_6881190955',5,26,17,2,1,2,0,8,1,386,92,32207,31390,32865,5,30,5,0,0,1,0,6,276,88,21978,23957,21569,1,110,4,10229,12,7433,11296,2,1,1,0,2
EUW1_6881127780',7,27,11,0,1,2,0,13,0,398,72,30007,30557,29797,9,30,12,1,0,0,0,6,364,83,27358,28900,28559,0,34,-11,2649,-1,1657,1238,-1,1,2,0,7
EUW1_6880744203',2,74,19,1,0,1,0,10,0,290,80,30275,27482,43519,3,389,16,0,0,3,0,4,328,76,30476,28215,35679,1,-38,4,-201,3,-733,7840,1,0,-2,0,6
EUW1_6880727062',3,29,19,2,1,1,0,5,1,381,92,31186,31111,35623,6,77,6,0,0,0,0,5,316,88,23136,26905,26563,1,65,4,8050,13,4206,9060,2,1,1,0,0
EUW1_6880709687',5,36,17,2,0,0,0,12,1,360,76,31043,28898,39734,2,26,12,0,0,2,0,3,338,91,26221,28173,29829,1,22,-15,4822,5,725,9905,2,0,-2,0,9
EUW1_6880675764',1,34,7,0,0,1,0,6,1,353,105,26501,29420,30472,0,93,6,1,0,0,0,8,374,78,23638,29669,24724,1,-21,27,2863,1,-249,5748,-1,0,1,0,-2
EUW1_6880638070',2,21,18,1,0,0,0,8,0,403,86,30860,32100,33658,7,33,9,1,0,1,0,6,306,96,26060,27684,30795,1,97,-10,4800,9,4416,2863,0,0,-1,0,2
EUW1_6880576727',1,18,8,0,0,0,0,8,0,350,72,24786,28275,22226,5,32,12,2,0,1,0,2,368,104,29092,30808,30505,0,-18,-32,-4306,-4,-2533,-8279,-2,0,-1,0,6
EUW1_6880513356',2,20,12,2,0,0,0,10,0,289,112,26586,28385,32157,3,31,10,0,0,1,0,2,377,84,26622,29080,30092,0,-88,28,-36,2,-695,2065,2,0,-1,0,8
EUW1_6880456574',4,28,8,1,0,1,0,9,0,402,76,26250,30459,25628,2,48,9,1,0,0,0,4,369,100,25865,29834,27737,0,33,-24,385,-1,625,-2109,0,0,1,0,5
EUW1_6880386426',4,32,14,2,0,1,0,3,1,410,106,29148,33934,30761,1,21,8,0,0,0,0,5,368,82,24333,28511,28543,1,42,24,4815,6,5423,2218,2,0,1,0,-2
EUW1_6880342687',6,32,17,1,0,2,0,7,0,388,102,31860,32425,35250,2,20,10,1,0,1,0,7,314,93,25663,29097,26969,1,74,9,6197,7,3328,8281,0,0,1,0,0
EUW1_6880206407',6,25,17,1,0,0,0,9,0,293,92,27255,29412,32542,3,38,11,1,0,1,0,1,349,92,28517,29703,44185,1,-56,0,-1262,6,-291,-11643,0,0,-1,0,8
EUW1_6880125693',6,29,12,0,0,0,0,13,1,333,64,25891,27246,33807,2,24,17,1,1,2,0,2,384,91,31381,32159,33957,1,-51,-27,-5490,-5,-4913,-150,-1,-1,-2,0,11
EUW1_6876685334',5,33,7,1,0,0,0,7,1,369,116,25535,30895,27846,7,32,10,1,0,0,0,4,383,63,26133,30990,26881,0,-14,53,-598,-3,-95,965,0,0,0,0,3
EUW1_6875860707',6,29,15,0,0,0,0,8,0,366,67,28097,30157,31910,3,31,11,1,0,1,0,0,365,95,28368,29371,33036,0,1,-28,-271,4,786,-1126,-1,0,-1,0,8
EUW1_6883583568',7,32,16,0,1,0,0,11,0,330,72,28550,29009,40625,6,33,14,2,0,2,0,4,362,88,29670,30644,42064,1,-32,-16,-1120,2,-1635,-1439,-2,1,-2,0,7
EUW1_6883548126',5,27,8,0,0,0,0,7,0,367,115,25463,29790,22540,4,30,15,1,0,1,0,1,386,94,28696,31565,31852,0,-19,21,-3233,-7,-1775,-9312,-1,0,-1,0,6
EUW1_6877258071',4,31,17,2,0,0,0,7,0,349,80,28730,27709,39874,7,28,18,0,0,0,0,3,311,94,28974,28299,37781,1,38,-14,-244,-1,-590,2093,2,0,0,0,4
EUW1_6875874207',3,32,10,0,0,0,0,10,0,358,88,26508,29424,27637,7,29,15,2,1,1,0,1,414,103,30169,31835,30201,0,-56,-15,-3661,-5,-2411,-2564,-2,-1,-1,0,9
EUW1_6875838925',1,68,13,2,0,1,0,9,1,317,99,28487,26062,33959,5,81,19,0,0,2,0,2,305,88,31185,29809,40267,0,12,11,-2698,-6,-3747,-6308,2,0,-1,0,7
EUW1_6869219800',7,32,18,0,1,1,0,7,1,390,76,31381,29190,35321,5,40,10,2,0,1,0,7,350,105,26335,28695,30273,0,40,-29,5046,8,495,5048,-2,1,0,0,0
EUW1_6869162685',4,54,16,0,0,0,0,10,1,342,91,28762,31163,33930,3,27,16,2,0,1,0,2,368,84,29199,30744,38471,0,-26,7,-437,0,419,-4541,-2,0,-1,0,8
EUW1_6869106227',6,29,16,2,0,2,0,10,1,345,88,30657,29855,37099,6,33,9,0,0,0,0,8,324,72,24870,26250,43928,1,21,16,5787,7,3605,-6829,2,0,2,0,2
EUW1_6867573057',5,41,19,1,0,3,0,10,0,319,77,31116,28363,41737,2,30,15,0,0,1,0,9,356,94,30530,29187,37472,1,-37,-17,586,4,-824,4265,1,0,2,0,1
EUW1_6867554868',1,14,12,0,1,1,0,14,0,366,71,28690,28474,42914,2,22,24,2,0,3,0,4,358,110,33758,33302,46933,0,8,-39,-5068,-12,-4828,-4019,-2,1,-2,0,10
EUW1_6867526306',2,21,14,0,0,1,0,7,1,413,74,29333,32268,41186,4,28,8,1,0,0,0,4,350,94,25023,29076,26952,1,63,-20,4310,6,3192,14234,-1,0,1,0,3
EUW1_6867502881',1,27,6,1,0,0,0,8,0,387,116,24729,30326,20697,3,33,11,0,0,1,0,2,361,75,27071,30146,28827,0,26,41,-2342,-5,180,-8130,1,0,-1,0,6
EUW1_6864492952',5,24,16,0,0,0,0,9,0,329,71,28293,27320,40065,8,32,15,2,0,1,0,5,311,77,27644,27233,34323,1,18,-6,649,1,87,5742,-2,0,-1,0,4
EUW1_6864467977',6,32,15,0,1,1,0,7,0,310,106,27889,29581,30999,3,28,12,2,0,0,0,4,332,86,25287,27397,22926,1,-22,20,2602,3,2184,8073,-2,1,1,0,3
EUW1_6864447668',1,30,15,0,0,0,0,9,1,331,88,27533,28062,30627,3,27,16,1,0,1,0,3,314,95,27809,29980,30131,0,17,-7,-276,-1,-1918,496,-1,0,-1,0,6
EUW1_6864401217',5,29,17,2,0,1,0,6,0,382,89,31042,31504,36182,4,24,13,0,0,1,0,7,303,75,25762,27190,32133,1,79,14,5280,4,4314,4049,2,0,0,0,-1
EUW1_6864364797',6,35,8,2,0,0,0,8,0,406,99,26279,30561,33357,1,22,10,0,0,1,0,4,386,96,28555,31218,33713,0,20,3,-2276,-2,-657,-356,2,0,-1,0,4
EUW1_6859136640',6,32,10,1,0,2,0,5,0,371,74,27129,28303,32707,4,32,13,1,1,0,0,9,295,94,26973,26629,25092,0,76,-20,156,-3,1674,7615,0,-1,2,0,-4
EUW1_6857763424',3,24,18,0,0,0,0,15,0,294,86,29473,29316,42560,5,25,17,2,0,3,0,7,345,76,31590,28055,37870,0,-51,10,-2117,1,1261,4690,-2,0,-3,0,8
EUW1_6883530139',11,45,17,1,0,0,0,11,0,334,86,29891,31183,42721,9,28,21,0,0,1,0,4,393,98,32065,32150,33269,0,-59,-12,-2174,-4,-967,9452,1,0,-1,0,7
EUW1_6883507177',3,31,9,0,0,0,0,13,0,390,90,27965,28070,21534,1,26,15,2,1,3,0,4,377,93,31062,30795,26777,0,13,-3,-3097,-6,-2725,-5243,-2,-1,-3,0,9
EUW1_6883341343',4,27,10,1,0,2,0,13,1,367,76,27938,29322,27519,3,25,7,1,0,1,0,6,390,120,26247,31412,26956,1,-23,-44,1691,3,-2090,563,0,0,1,0,7
EUW1_6883284737',7,78,16,0,0,0,0,7,0,351,76,29684,28544,38297,3,62,17,2,1,1,0,4,352,82,30976,30424,39370,0,-1,-6,-1292,-1,-1880,-1073,-2,-1,-1,0,3
EUW1_6883220031',1,24,12,1,0,0,0,11,1,368,116,27721,31734,25643,2,32,3,1,1,1,0,2,388,107,25147,29434,29155,1,-20,9,2574,9,2300,-3512,0,-1,-1,0,9
EUW1_6882814252',7,31,25,0,0,2,0,8,1,366,75,33201,31429,38163,3,26,5,2,0,0,0,8,338,103,23533,27632,24147,1,28,-28,9668,20,3797,14016,-2,0,2,0,0
EUW1_6882610881',4,58,17,1,0,0,0,9,1,380,80,30038,30682,35413,5,27,11,0,1,1,0,4,340,97,27185,29504,42796,1,40,-17,2853,6,1178,-7383,1,-1,-1,0,5
EUW1_6882583762',4,22,9,0,0,1,0,8,0,372,80,26870,28286,27828,2,28,19,2,0,1,0,6,393,96,31534,32181,40227,0,-21,-16,-4664,-10,-3895,-12399,-2,0,0,0,2
EUW1_6882555860',2,21,9,1,0,0,0,9,0,365,88,25276,29241,34163,0,20,17,1,0,4,0,4,334,116,32795,32691,41825,0,31,-28,-7519,-8,-3450,-7662,0,0,-4,0,5
EUW1_6882517279',3,27,8,1,1,0,0,13,0,378,86,27347,28185,28600,1,29,19,1,0,0,0,2,315,70,29080,28485,39928,1,63,16,-1733,-11,-300,-11328,0,1,0,0,11
EUW1_6882282268',8,27,24,2,0,0,0,11,1,317,84,33373,29937,50356,6,27,14,0,0,3,0,8,330,63,28157,25930,38306,1,-13,21,5216,10,4007,12050,2,0,-3,0,3
EUW1_6882260455',3,29,13,0,0,1,0,7,1,384,86,28578,29621,32472,3,29,11,1,0,0,0,6,335,90,26147,30379,32860,0,49,-4,2431,2,-758,-388,-1,0,1,0,1
EUW1_6882241279',4,30,9,0,0,0,0,12,0,337,88,25617,28722,27504,6,30,20,1,0,2,0,3,386,114,32759,33495,44627,0,-49,-26,-7142,-11,-4773,-17123,-1,0,-2,0,9
EUW1_6882203455',5,38,14,0,0,1,0,4,0,391,96,29808,29790,32724,9,44,12,1,0,0,0,5,383,63,27866,27735,30720,1,8,33,1942,2,2055,2004,-1,0,1,0,-1
EUW1_6882175400',3,33,12,1,0,1,0,13,0,362,104,28962,31420,32569,1,21,19,0,0,1,0,4,391,84,30999,32005,38502,0,-29,20,-2037,-7,-585,-5933,1,0,0,0,9
EUW1_6882168609',6,33,5,0,0,0,0,10,0,361,64,22877,25716,26744,6,30,16,2,0,1,0,3,412,106,30469,32163,36726,0,-51,-42,-7592,-11,-6447,-9982,-2,0,-1,0,7
EUW1_6882145554',2,24,35,1,1,2,0,7,1,364,104,36285,33093,50842,4,27,10,0,0,0,0,10,284,67,25217,25483,27835,1,80,37,11068,25,7610,23007,1,1,2,0,-3
EUW1_6881970340',2,23,11,0,0,2,0,13,0,390,101,29158,31290,32746,3,25,12,2,0,1,0,5,381,81,27997,31040,25800,0,9,20,1161,-1,250,6946,-2,0,1,0,8
EUW1_6881918361',3,27,5,0,0,0,0,8,0,345,82,22990,29075,20098,5,26,11,2,0,1,0,0,395,85,27517,30662,25815,0,-50,-3,-4527,-6,-1587,-5717,-2,0,-1,0,8
EUW1_6881855130',2,18,10,1,0,0,0,11,0,293,76,24669,27011,23652,1,21,26,0,0,2,0,0,358,116,35015,34182,49434,0,-65,-40,-10346,-16,-7171,-25782,1,0,-2,0,11
EUW1_6883727568',5,26,5,0,0,0,0,9,0,335,93,23462,27992,26282,5,33,14,1,1,1,0,0,398,105,29433,32157,30998,1,-63,-12,-5971,-9,-4165,-4716,-1,-1,-1,0,9
EUW1_6883716706',4,26,15,1,0,1,0,14,1,326,77,28358,28595,31089,4,30,18,1,1,1,0,4,375,99,29524,30576,36247,0,-49,-22,-1166,-3,-1981,-5158,0,-1,0,0,10
EUW1_6882987149',4,30,8,0,1,1,0,9,1,353,94,26629,28358,32105,1,22,8,1,0,0,0,6,374,84,24641,28075,24129,1,-21,10,1988,0,283,7976,-1,1,1,0,3
EUW1_6882893565',2,26,13,1,0,0,0,11,1,307,76,25335,25864,33460,1,25,14,1,0,1,0,2,355,81,27676,29898,32880,0,-48,-5,-2341,-1,-4034,580,0,0,-1,0,9
EUW1_6882836332',5,44,12,0,1,1,0,9,0,386,103,28980,31999,43188,3,19,13,1,0,2,0,6,282,68,26404,27497,34942,1,104,35,2576,-1,4502,8246,-1,1,-1,0,3
EUW1_6882474419',2,29,9,0,0,1,0,14,1,342,77,26346,29274,29114,3,24,16,2,0,3,0,5,363,129,32178,30796,33576,0,-21,-52,-5832,-7,-1522,-4462,-2,0,-2,0,9
EUW1_6882470468',6,72,15,2,1,3,0,2,1,395,116,31686,33433,29080,3,30,6,0,0,0,0,12,316,88,23125,26534,23761,1,79,28,8561,9,6899,5319,2,1,3,0,-10
EUW1_6882394494',3,32,7,0,0,0,0,13,1,332,94,25288,28491,22006,1,26,15,1,0,2,0,2,388,116,31124,32143,34321,0,-56,-22,-5836,-8,-3652,-12315,-1,0,-2,0,11
EUW1_6882379628',2,35,21,0,0,3,0,9,1,366,86,32548,30877,41336,6,57,10,1,0,0,0,3,313,60,25297,26838,25563,1,53,26,7251,11,4039,15773,-1,0,3,0,6
EUW1_6882355138',1,28,13,2,0,1,0,13,1,341,74,28906,28993,25397,5,27,16,0,0,3,0,8,338,70,30300,27803,31318,1,3,4,-1394,-3,1190,-5921,2,0,-2,0,5
EUW1_6881575077',1,32,16,0,0,0,0,9,1,284,54,27867,25705,36269,6,28,19,1,0,2,0,3,323,73,30415,27550,36102,0,-39,-19,-2548,-3,-1845,167,-1,0,-2,0,6
EUW1_6881492704',3,24,16,2,0,2,0,5,0,356,87,29666,30049,29931,3,30,11,0,0,0,0,4,336,100,26725,26910,23359,1,20,-13,2941,5,3139,6572,2,0,2,0,1
EUW1_6881438048',3,24,22,0,0,2,0,8,1,342,84,32508,31090,36360,2,27,12,2,0,0,0,7,347,67,26898,27163,30802,1,-5,17,5610,10,3927,5558,-2,0,2,0,1
EUW1_6881374018',6,33,14,2,0,1,0,6,0,359,82,28784,29656,30070,5,33,11,0,0,0,0,4,348,81,27101,27546,28328,1,11,1,1683,3,2110,1742,2,0,1,0,2
EUW1_6881102531',5,25,13,1,0,2,0,7,0,375,88,28131,30533,39694,2,24,10,0,0,0,0,6,327,83,25485,28571,29328,0,48,5,2646,3,1962,10366,1,0,2,0,1
EUW1_6881014232',1,294,6,1,0,0,0,6,1,332,100,23696,28253,23070,1,19,4,1,0,0,0,2,390,90,24300,28799,25121,1,-58,10,-604,2,-546,-2051,0,0,0,0,4
EUW1_6876207207',1,20,10,1,0,0,0,10,0,344,101,24767,30108,27498,2,28,8,1,0,0,0,3,364,91,26112,31021,22711,1,-20,10,-1345,2,-913,4787,0,0,0,0,7
EUW1_6876164837',1,46,15,2,0,2,0,15,1,410,102,29316,31551,24372,0,28,0,0,0,2,0,3,390,61,22997,26568,20155,1,20,41,6319,15,4983,4217,2,0,0,0,12
EUW1_6875945967',4,51,9,0,0,0,0,7,0,397,89,27101,29704,31700,5,31,13,1,0,1,0,3,382,71,28304,30862,32133,0,15,18,-1203,-4,-1158,-433,-1,0,-1,0,4
EUW1_6873624917',4,29,11,0,1,0,0,10,0,377,82,26021,29995,27967,4,34,15,1,0,3,0,1,389,93,29629,31234,38074,1,-12,-11,-3608,-4,-1239,-10107,-1,1,-3,0,9
EUW1_6873590923',1,21,7,1,0,1,0,8,0,344,84,25255,29648,27072,4,39,7,0,0,0,0,5,358,87,25139,30192,35640,0,-14,-3,116,0,-544,-8568,1,0,1,0,3
EUW1_6873174777',0,24,10,0,0,0,0,16,0,295,72,23995,25687,28745,7,31,21,1,1,4,0,0,405,122,35262,33887,37445,0,-110,-50,-11267,-11,-8200,-8700,-1,-1,-4,0,16
EUW1_6873027797',0,25,20,1,1,2,0,12,0,376,80,32915,31781,42317,6,81,12,1,0,1,0,4,365,88,28381,28198,36292,1,11,-8,4534,8,3583,6025,0,1,1,0,8
EUW1_6872019684',3,23,7,0,0,1,0,11,0,348,72,24795,27915,25818,4,26,10,2,0,1,0,2,410,88,27885,30900,26106,0,-62,-16,-3090,-3,-2985,-288,-2,0,0,0,9
EUW1_6871664452',3,31,9,0,0,1,0,11,0,421,139,28669,32826,27297,3,28,6,2,1,1,0,2,388,84,25081,29006,15520,1,33,55,3588,3,3820,11777,-2,-1,0,0,9
EUW1_6871473738',2,26,7,0,0,0,0,10,1,375,94,25257,29662,27842,2,29,12,2,0,1,0,4,397,94,28547,30615,33016,0,-22,0,-3290,-5,-953,-5174,-2,0,-1,0,6
EUW1_6871337758',2,29,9,1,0,1,0,8,0,351,84,25869,29970,28667,4,96,10,0,0,0,0,4,344,120,26132,32301,28074,1,7,-36,-263,-1,-2331,593,1,0,1,0,4
EUW1_6870880818',4,27,8,1,0,0,0,14,0,278,87,23324,25263,27317,2,26,15,0,0,2,0,0,383,96,29321,30832,39351,0,-105,-9,-5997,-7,-5569,-12034,1,0,-2,0,14
EUW1_6870808532',5,32,17,1,1,0,0,10,0,365,100,29399,32725,37659,3,23,9,0,0,1,0,2,367,74,25786,28455,36857,1,-2,26,3613,8,4270,802,1,1,-1,0,8
EUW1_6870770048',4,31,16,2,1,3,0,5,1,399,100,32329,31459,40308,2,31,11,0,0,0,0,11,320,100,25554,28245,24565,1,79,0,6775,5,3214,15743,2,1,3,0,-6
EUW1_6870708617',4,28,9,0,0,1,0,11,1,370,89,26907,29647,25355,5,124,12,2,0,1,0,4,365,90,28123,31654,26534,0,5,-1,-1216,-3,-2007,-1179,-2,0,0,0,7
EUW1_6870638947',4,27,5,0,0,0,0,10,1,344,62,23047,26714,24558,3,27,16,2,0,1,0,2,416,98,30776,33890,38495,0,-72,-36,-7729,-11,-7176,-13937,-2,0,-1,0,8
EUW1_6870557977',4,26,11,2,0,0,0,12,0,328,82,25747,28407,26725,3,180,15,0,0,1,0,3,353,85,29268,30068,42772,1,-25,-3,-3521,-4,-1661,-16047,2,0,-1,0,9
EUW1_6870507287',6,29,16,2,1,1,0,2,1,365,128,31893,31419,36886,4,50,5,0,0,1,0,10,324,49,22579,26258,21753,1,41,79,9314,11,5161,15133,2,1,0,0,-8
EUW1_6883503346',6,180,9,1,1,1,0,12,1,342,96,26507,27122,29963,1,38,13,1,0,1,0,4,361,68,27849,29046,33171,0,-19,28,-1342,-4,-1924,-3208,0,1,0,0,8
EUW1_6883462919',1,19,15,1,0,1,0,6,0,394,84,29341,29942,41965,3,25,14,1,1,0,0,3,338,80,27642,28867,30455,1,56,4,1699,1,1075,11510,0,-1,1,0,3
EUW1_6883407859',1,26,9,0,0,0,0,8,1,342,98,26958,29348,24720,1,45,15,1,0,1,0,3,392,71,28698,29764,33833,0,-50,27,-1740,-6,-416,-9113,-1,0,-1,0,5
EUW1_6883350649',3,31,9,1,0,1,0,6,0,407,109,28079,32234,21879,3,60,4,1,0,0,0,5,422,74,23980,28887,24085,1,-15,35,4099,5,3347,-2206,0,0,1,0,1
EUW1_6881877813',4,25,17,1,0,0,0,6,1,401,96,29290,32203,33675,3,33,10,1,0,0,0,4,365,79,26530,31162,30775,0,36,17,2760,7,1041,2900,0,0,0,0,2
EUW1_6881784536',3,57,18,2,0,2,0,6,1,370,100,31880,31708,35353,3,28,11,0,0,1,0,8,288,106,25781,28183,29039,1,82,-6,6099,7,3525,6314,2,0,1,0,-2
EUW1_6881475044',8,189,11,0,0,0,0,11,1,352,90,25576,28869,23431,5,24,11,2,0,1,0,1,399,101,28461,31600,32065,0,-47,-11,-2885,0,-2731,-8634,-2,0,-1,0,10
EUW1_6881105345',3,16,4,0,0,0,0,15,0,315,80,21513,25984,13155,1,25,16,2,0,3,0,1,379,124,31282,31802,24815,0,-64,-44,-9769,-12,-5818,-11660,-2,0,-3,0,14
EUW1_6880666751',0,31,11,0,0,0,0,11,0,345,91,27276,29758,38723,2,25,25,1,0,0,0,2,355,88,31164,32449,43227,0,-10,3,-3888,-14,-2691,-4504,-1,0,0,0,9
EUW1_6879749151',2,21,8,0,0,0,0,9,0,273,86,23802,26204,28977,2,39,14,0,0,1,0,0,383,82,28346,30315,37783,0,-110,4,-4544,-6,-4111,-8806,0,0,-1,0,9
EUW1_6883669003',5,38,12,1,0,1,0,7,0,356,100,27728,29775,35351,6,34,12,0,0,0,0,3,345,66,26290,28156,32040,1,11,34,1438,0,1619,3311,1,0,1,0,4
EUW1_6883658385',1,22,5,0,0,0,0,13,0,310,75,21964,25683,25819,3,35,20,2,0,4,0,2,376,98,33464,33244,40718,0,-66,-23,-11500,-15,-7561,-14899,-2,0,-4,0,11
EUW1_6883653757',3,26,17,2,0,1,0,14,1,322,88,29437,29320,28626,6,28,7,0,0,1,0,5,373,96,26104,28309,28278,1,-51,-8,3333,10,1011,348,2,0,0,0,9
EUW1_6883605301',1,56,15,0,0,1,0,16,0,348,88,28648,29922,34631,4,31,15,1,1,1,0,2,322,93,28981,28851,37869,1,26,-5,-333,0,1071,-3238,-1,-1,0,0,14
EUW1_6883593581',4,27,8,0,0,0,0,9,1,317,97,24650,26588,29618,3,29,18,2,1,2,0,2,368,108,31537,34148,38225,0,-51,-11,-6887,-10,-7560,-8607,-2,-1,-2,0,7
EUW1_6883545424',2,31,11,2,0,0,0,8,0,342,87,25886,28067,30127,3,37,14,0,0,1,0,5,352,104,29638,29940,34190,0,-10,-17,-3752,-3,-1873,-4063,2,0,-1,0,3
EUW1_6869185268',4,30,14,1,1,1,0,8,0,321,116,27753,30285,29315,5,30,11,1,0,1,0,1,363,62,26287,28020,28103,1,-42,54,1466,3,2265,1212,0,1,0,0,7
EUW1_6868917771',2,19,6,0,0,0,0,13,0,361,85,25498,26648,20637,6,30,19,2,1,2,0,4,381,86,29903,31078,38372,0,-20,-1,-4405,-13,-4430,-17735,-2,-1,-2,0,9
EUW1_6868866689',6,26,24,1,0,2,0,10,1,365,111,34235,33093,37854,1,22,9,0,0,0,0,7,355,48,25484,27560,36908,1,10,63,8751,15,5533,946,1,0,2,0,3
EUW1_6877661603',4,29,22,1,1,0,0,9,0,307,92,29264,30073,39655,4,48,12,1,0,0,0,0,311,72,25481,26118,31430,1,-4,20,3783,10,3955,8225,0,1,0,0,9
EUW1_6879415392',6,31,6,1,1,0,0,5,1,400,112,25250,31612,23620,4,147,6,1,0,0,0,3,404,88,25053,30964,29917,1,-4,24,197,0,648,-6297,0,1,0,0,2
EUW1_6879406795',1,161,6,0,0,0,0,13,1,338,83,23707,26028,28768,3,33,21,1,0,2,0,3,379,84,31116,31335,40031,0,-41,-1,-7409,-15,-5307,-11263,-1,0,-2,0,10
EUW1_6878810293',8,29,16,0,0,0,0,10,0,355,70,28557,29654,40729,6,57,15,1,0,1,0,3,368,88,28930,28757,32418,0,-13,-18,-373,1,897,8311,-1,0,-1,0,7
EUW1_6878767865',5,24,19,2,0,2,0,10,1,353,96,31552,29747,37803,4,25,17,0,0,0,0,9,265,68,27442,26246,40673,0,88,28,4110,2,3501,-2870,2,0,2,0,1
EUW1_6878728622',2,24,13,0,1,0,0,8,1,374,100,28209,31297,31943,1,31,12,2,0,0,0,4,343,116,27614,29844,28002,0,31,-16,595,1,1453,3941,-2,1,0,0,4
EUW1_6878673701',2,26,11,0,0,0,0,14,0,317,86,25285,28433,31238,1,28,10,2,0,3,0,3,366,90,28471,28909,37590,1,-49,-4,-3186,1,-476,-6352,-2,0,-3,0,11
EUW1_6878630612',3,27,8,0,0,0,0,6,0,334,75,23648,28253,31680,5,30,12,1,0,1,0,1,358,80,27186,28095,27831,0,-24,-5,-3538,-4,158,3849,-1,0,-1,0,5
EUW1_6878239563',1,32,9,0,0,1,0,9,0,344,117,26867,32033,29306,2,23,14,2,0,1,0,7,358,78,27345,28233,38242,0,-14,39,-478,-5,3800,-8936,-2,0,0,0,2
EUW1_6878200388',2,39,15,0,0,0,0,8,1,351,107,27834,31515,36147,4,33,18,2,0,0,0,0,370,84,29460,33220,42177,0,-19,23,-1626,-3,-1705,-6030,-2,0,0,0,8
EUW1_6878169190',1,24,12,2,1,0,0,7,1,391,99,29703,30674,33660,0,27,8,0,0,1,0,4,369,92,26556,29977,32215,0,22,7,3147,4,697,1445,2,1,-1,0,3
EUW1_6877967492',3,24,16,0,0,1,0,13,1,347,122,29926,31271,39314,3,23,8,2,0,2,0,8,352,99,25028,29277,27104,1,-5,23,4898,8,1994,12210,-2,0,-1,0,5
EUW1_6877949990',6,56,8,0,0,0,0,12,0,339,77,25124,27516,31815,6,25,17,1,0,3,0,2,399,86,31372,31418,35858,0,-60,-9,-6248,-9,-3902,-4043,-1,0,-3,0,10
EUW1_6875070718',2,90,15,1,0,0,0,8,1,296,80,27206,28077,46468,1,136,10,1,1,0,0,5,332,100,26062,29826,38092,0,-36,-20,1144,5,-1749,8376,0,-1,0,0,3
EUW1_6875054177',2,20,12,0,0,0,0,13,0,310,100,25807,27377,31758,2,30,16,1,0,3,0,2,376,91,31725,29744,42088,0,-66,9,-5918,-4,-2367,-10330,-1,0,-3,0,11
EUW1_6875045102',3,26,11,0,0,1,0,13,1,337,82,29180,27468,30312,5,20,25,1,0,2,0,6,339,88,32698,31276,46746,0,-2,-6,-3518,-14,-3808,-16434,-1,0,-1,0,7
EUW1_6872386003',1,22,2,0,0,0,0,8,1,357,98,22775,28001,27143,2,26,13,1,0,4,0,2,406,84,30289,32603,32732,0,-49,14,-7514,-11,-4602,-5589,-1,0,-4,0,6
EUW1_6872367112',6,27,25,0,1,0,0,11,0,335,101,32129,30459,47697,4,139,19,1,0,0,0,5,282,66,28025,27125,35731,0,53,35,4104,6,3334,11966,-1,1,0,0,6
EUW1_6872319371',0,20,10,0,0,2,0,10,1,357,89,27819,28818,33920,2,29,21,2,0,2,0,8,299,73,29658,30911,41648,0,58,16,-1839,-11,-2093,-7728,-2,0,0,0,2
EUW1_6872319750',1,24,5,1,0,0,0,9,0,354,84,24354,28124,36501,4,25,17,0,0,1,0,4,361,87,30399,32053,35285,0,-7,-3,-6045,-12,-3929,1216,1,0,-1,0,5
EUW1_6872307793',4,34,20,0,0,0,0,13,0,297,72,28401,29654,42453,7,34,18,1,0,2,0,3,271,85,30210,27261,40531,0,26,-13,-1809,2,2393,1922,-1,0,-2,0,10
EUW1_6877221666',3,27,1,0,0,0,0,11,0,362,106,22586,28660,23011,10,86,13,1,1,1,0,2,387,106,28423,31051,30298,0,-25,0,-5837,-12,-2391,-7287,-1,-1,-1,0,9
EUW1_6870843167',3,70,13,0,0,0,0,8,1,341,68,26065,28210,25211,3,65,10,2,0,2,0,1,396,87,27885,30865,30999,1,-55,-19,-1820,3,-2655,-5788,-2,0,-2,0,7
EUW1_6870003642',4,225,12,1,0,0,0,8,0,359,102,27333,29658,38083,6,28,12,0,0,1,0,1,362,97,28423,30400,35569,0,-3,5,-1090,0,-742,2514,1,0,-1,0,7
EUW1_6869923138',2,25,12,0,0,0,0,15,0,323,84,25966,26520,31846,4,64,21,2,0,1,0,0,367,80,30795,30097,36099,0,-44,4,-4829,-9,-3577,-4253,-2,0,-1,0,15
EUW1_6869648322',8,73,18,0,0,2,0,8,1,362,110,31905,30398,38187,1,87,15,2,0,1,0,5,357,70,28419,28429,33211,1,5,40,3486,3,1969,4976,-2,0,1,0,3
EUW1_6867362160',1,60,9,1,0,1,0,11,1,314,62,25593,25540,38137,2,110,25,0,1,0,0,3,337,70,30878,31515,44614,0,-23,-8,-5285,-16,-5975,-6477,1,-1,1,0,8
EUW1_6850508385',2,53,16,0,0,0,0,8,1,317,58,27992,28137,32114,2,84,16,2,0,0,0,0,344,84,29187,29326,37743,1,-27,-26,-1195,0,-1189,-5629,-2,0,0,0,8
EUW1_6850482153',0,24,13,1,0,0,0,13,1,272,60,25706,26002,35222,4,71,29,1,0,3,0,2,344,80,33440,30858,49712,0,-72,-20,-7734,-16,-4856,-14490,0,0,-3,0,11
EUW1_6850458555',2,23,6,0,0,0,0,12,1,335,90,24531,26869,25564,5,74,19,2,0,1,0,1,385,90,30799,31454,37497,0,-50,0,-6268,-13,-4585,-11933,-2,0,-1,0,11
EUW1_6850400042',6,350,19,1,0,1,0,8,0,310,62,30128,29308,36573,4,39,14,0,0,0,0,7,340,65,26635,27384,44316,1,-30,-3,3493,5,1924,-7743,1,0,1,0,1
EUW1_6849953554',4,69,12,2,0,0,0,11,0,371,80,27737,28502,33315,3,26,9,0,0,2,0,5,307,67,25735,26263,27032,0,64,13,2002,3,2239,6283,2,0,-2,0,6
EUW1_6849907352',4,243,7,0,0,0,0,11,1,315,63,23111,25130,20640,6,29,19,1,0,3,0,2,377,72,32601,30794,35611,0,-62,-9,-9490,-12,-5664,-14971,-1,0,-3,0,9
EUW1_6849870381',5,158,9,0,0,0,0,14,0,304,72,24084,25351,27437,6,29,19,2,1,1,0,2,354,89,31395,30988,41680,0,-50,-17,-7311,-10,-5637,-14243,-2,-1,-1,0,12
EUW1_6849820001',5,279,18,1,0,2,0,3,1,382,82,31818,30476,40724,10,80,11,0,0,0,0,10,284,89,24542,26971,30750,1,98,-7,7276,7,3505,9974,1,0,2,0,-7
EUW1_6849192054',2,140,16,2,0,0,0,16,0,324,82,28547,29694,29588,2,24,8,0,0,1,0,3,338,86,25219,27349,35836,1,-14,-4,3328,8,2345,-6248,2,0,-1,0,13
EUW1_6848523507',1,52,16,1,1,1,0,8,1,340,88,29812,28144,33879,0,276,11,0,0,1,0,4,306,80,26714,25398,26983,1,34,8,3098,5,2746,6896,1,1,0,0,4
EUW1_6883537262',10,39,13,1,0,0,0,12,1,330,63,26757,27390,29505,4,26,13,0,0,2,0,3,314,100,29211,28757,29191,0,16,-37,-2454,0,-1367,314,1,0,-2,0,9
EUW1_6883481240',5,30,16,2,0,2,0,11,1,357,84,30931,30518,33860,3,29,14,0,0,0,0,6,359,55,27319,28899,34960,1,-2,29,3612,2,1619,-1100,2,0,2,0,5
EUW1_6882229225',3,26,16,1,0,2,0,10,0,325,112,31017,31506,42794,1,28,13,1,0,0,0,7,348,98,27910,29781,31322,1,-23,14,3107,3,1725,11472,0,0,2,0,3
EUW1_6882178259',1,43,13,1,1,0,0,6,0,303,80,27564,27261,37167,8,27,18,1,0,0,0,1,377,99,29088,32429,35620,1,-74,-19,-1524,-5,-5168,1547,0,1,0,0,5
EUW1_6874544226',1,31,12,1,0,0,0,6,0,398,112,28063,33323,31276,2,23,8,1,0,0,0,1,400,104,26829,30960,36421,1,-2,8,1234,4,2363,-5145,0,0,0,0,5
EUW1_6874264014',3,28,17,1,0,2,0,9,1,381,79,30611,31388,37393,3,35,6,0,0,0,0,4,363,88,24086,28437,27530,1,18,-9,6525,11,2951,9863,1,0,2,0,5
EUW1_6874212439',5,25,15,0,0,2,0,11,1,312,76,29722,28061,44329,6,35,29,1,0,0,0,4,285,107,32393,31715,43586,0,27,-31,-2671,-14,-3654,743,-1,0,2,0,7
EUW1_6869059887',1,23,14,1,0,0,0,11,1,336,74,27997,28382,36795,3,30,18,0,0,1,0,2,371,80,31242,29934,38397,0,-35,-6,-3245,-4,-1552,-1602,1,0,-1,0,9
EUW1_6868990052',3,24,14,2,0,4,0,5,1,381,100,31079,31976,26312,2,26,1,0,0,0,0,9,307,86,20822,23384,17749,1,74,14,10257,13,8592,8563,2,0,4,0,-4
EUW1_6863144651',2,40,6,0,0,0,0,17,0,312,59,23316,25200,25531,3,25,21,1,0,4,0,2,463,120,35481,36146,41010,0,-151,-61,-12165,-15,-10946,-15479,-1,0,-4,0,15
EUW1_6863121727',2,20,19,1,0,2,0,11,0,382,116,33669,30309,37299,3,46,19,0,0,1,0,6,301,100,31063,28678,36455,1,81,16,2606,0,1631,844,1,0,1,0,5
EUW1_6883138516',5,34,13,1,0,1,0,7,1,337,97,27228,30055,34485,5,28,7,1,0,2,0,2,370,81,25466,28126,29027,1,-33,16,1762,6,1929,5458,0,0,-1,0,5
EUW1_6883074745',4,43,7,0,0,0,0,12,0,331,70,24723,26429,26927,2,22,20,1,1,2,0,2,390,94,33404,31500,36691,0,-59,-24,-8681,-13,-5071,-9764,-1,-1,-2,0,10
EUW1_6883029068',3,26,4,1,0,0,0,13,0,383,72,23421,28389,20248,4,32,15,1,0,2,0,2,401,110,32169,32793,29401,0,-18,-38,-8748,-11,-4404,-9153,0,0,-2,0,11
EUW1_6882976914',4,24,13,1,1,2,0,9,0,405,82,29900,30459,33900,5,31,13,1,0,0,0,5,351,98,27002,30531,26912,1,54,-16,2898,0,-72,6988,0,1,2,0,4
EUW1_6882917955',6,44,16,0,0,2,0,6,1,378,85,30375,29989,33309,6,24,8,1,0,0,0,7,324,102,24585,25616,27215,1,54,-17,5790,8,4373,6094,-1,0,2,0,-1
EUW1_6882338775',5,29,6,2,0,0,0,12,1,399,100,25344,29222,19685,3,18,9,0,0,2,0,0,362,87,27710,30431,22833,1,37,13,-2366,-3,-1209,-3148,2,0,-2,0,12
EUW1_6882283664',3,25,20,2,0,0,0,4,1,401,94,32274,32693,44021,6,28,12,0,0,1,0,6,331,90,26316,30265,32898,0,70,4,5958,8,2428,11123,2,0,-1,0,-2
EUW1_6882266151',3,33,10,0,0,1,0,8,0,331,62,24882,25540,29444,3,31,20,1,0,1,0,0,353,102,30032,30224,37991,0,-22,-40,-5150,-10,-4684,-8547,-1,0,0,0,8
EUW1_6882248086',2,24,16,2,0,1,0,8,1,339,100,31549,29974,40213,3,33,7,0,0,2,0,4,321,88,24876,27877,32035,1,18,12,6673,9,2097,8178,2,0,-1,0,4
EUW1_6882201606',2,26,12,0,0,2,0,14,0,288,69,28014,27562,33415,5,30,21,2,1,2,0,4,305,102,31242,28777,47210,0,-17,-33,-3228,-9,-1215,-13795,-2,-1,0,0,10
EUW1_6882165937',5,33,11,0,0,1,0,12,1,367,71,28282,28947,28762,4,29,21,2,0,1,0,7,344,102,31495,31240,32447,0,23,-31,-3213,-10,-2293,-3685,-2,0,0,0,5
EUW1_6881796051',2,41,22,0,0,1,0,7,1,354,76,32060,31270,44886,5,36,16,1,0,1,0,4,300,80,27142,28115,34271,1,54,-4,4918,6,3155,10615,-1,0,0,0,3
EUW1_6881734324',7,32,21,1,0,0,0,9,1,382,126,30796,33624,31971,4,33,9,0,0,0,0,4,381,62,25897,27757,27149,1,1,64,4899,12,5867,4822,1,0,0,0,5
EUW1_6881518292',3,44,10,0,0,0,0,10,0,337,79,25087,28348,30419,3,34,12,1,0,1,0,1,369,117,27822,31497,33243,0,-32,-38,-2735,-2,-3149,-2824,-1,0,-1,0,9
EUW1_6880565256',5,32,12,0,0,0,0,6,0,373,73,28116,28326,35100,6,28,13,2,1,2,0,3,363,111,28425,30339,30490,1,10,-38,-309,-1,-2013,4610,-2,-1,-2,0,3
EUW1_6880506647',9,81,8,0,0,0,0,9,0,357,86,24904,28174,32669,1,18,14,1,0,0,0,4,327,93,28700,31220,32130,1,30,-7,-3796,-6,-3046,539,-1,0,0,0,5
EUW1_6880358936',5,25,15,1,0,0,0,6,1,354,92,28340,29602,31846,6,31,11,1,0,1,0,5,350,100,28396,29584,30073,1,4,-8,-56,4,18,1773,0,0,-1,0,1
EUW1_6880314944',8,29,24,1,0,1,0,5,1,338,78,31786,30757,42546,4,29,13,0,0,0,0,4,356,88,27495,29280,38837,1,-18,-10,4291,11,1477,3709,1,0,1,0,1
EUW1_6873713245',2,26,9,2,0,0,0,20,1,327,77,25975,25806,27708,1,30,12,0,0,2,0,1,361,98,28090,31462,30184,0,-34,-21,-2115,-3,-5656,-2476,2,0,-2,0,19
EUW1_6873700236',4,27,24,0,1,0,0,7,0,322,90,32026,30119,45091,3,31,22,1,0,0,0,3,335,69,31347,29256,40803,1,-13,21,679,2,863,4288,-1,1,0,0,4
EUW1_6873680085',0,19,19,1,0,1,0,11,0,329,88,30447,31433,49256,4,31,18,1,0,1,0,6,326,80,31189,31421,48500,1,3,8,-742,1,12,756,0,0,0,0,5
EUW1_6873664279',7,35,11,2,0,0,0,4,1,391,98,27426,31880,26459,3,35,5,0,0,0,0,5,362,86,23470,27453,24370,1,29,12,3956,6,4427,2089,2,0,0,0,-1
EUW1_6873655514',4,23,10,1,0,0,0,15,0,343,88,25191,28178,36145,5,26,12,0,0,1,0,1,360,104,28526,28985,37308,0,-17,-16,-3335,-2,-807,-1163,1,0,-1,0,14
EUW1_6873622448',3,162,16,1,0,2,0,11,1,375,114,31066,32164,39327,5,35,5,1,0,1,0,6,349,84,25197,28122,22124,1,26,30,5869,11,4042,17203,0,0,1,0,5
EUW1_6873607129',5,36,11,2,0,3,0,6,1,412,92,29825,31803,31445,4,29,4,0,0,0,0,12,351,91,22903,27454,23705,1,61,1,6922,7,4349,7740,2,0,3,0,-6
EUW1_6873564982',4,26,12,1,0,0,0,5,1,382,94,28480,31983,40357,1,27,13,0,0,0,0,7,364,90,27198,31635,33716,0,18,4,1282,-1,348,6641,1,0,0,0,-2
EUW1_6873519854',3,28,9,0,0,0,0,8,1,369,76,26287,28914,32779,8,33,12,1,0,0,0,3,379,95,27940,31559,35846,1,-10,-19,-1653,-3,-2645,-3067,-1,0,0,0,5
EUW1_6873468025',3,31,8,0,0,1,0,9,1,348,90,26107,28596,28250,4,30,11,2,0,0,0,7,368,86,27601,30375,27737,0,-20,4,-1494,-3,-1779,513,-2,0,1,0,2
EUW1_6873385513',5,31,16,1,0,1,0,12,0,348,90,29522,30053,45104,12,39,15,0,0,0,0,3,345,98,28706,28689,30910,0,3,-8,816,1,1364,14194,1,0,1,0,9
EUW1_6873169472',5,29,12,1,0,0,0,14,1,291,72,25673,27334,28049,8,30,13,0,1,2,0,3,399,74,29466,31140,32516,0,-108,-2,-3793,-1,-3806,-4467,1,-1,-2,0,11
EUW1_6873118488',6,29,9,0,0,0,0,11,1,363,77,24667,29445,30978,3,32,13,2,1,1,0,1,414,102,29403,32889,39089,0,-51,-25,-4736,-4,-3444,-8111,-2,-1,-1,0,10
EUW1_6873062494',3,89,8,1,0,0,0,10,0,320,72,23561,26140,29499,7,35,14,1,0,2,0,0,384,95,29604,31624,40253,0,-64,-23,-6043,-6,-5484,-10754,0,0,-2,0,10
EUW1_6872329400',5,38,10,1,0,0,0,7,1,370,76,27380,28050,30718,0,32,14,1,0,0,0,5,398,104,29387,31428,33703,1,-28,-28,-2007,-4,-3378,-2985,0,0,0,0,2
EUW1_6872335533',1,79,14,1,1,0,0,7,0,346,118,29624,32726,29561,1,15,5,0,0,1,0,8,356,86,23500,27342,27106,1,-10,32,6124,9,5384,2455,1,1,-1,0,-1
EUW1_6872316158',5,23,8,1,0,0,0,7,0,389,74,24986,27533,36799,5,27,14,0,0,0,0,2,346,70,27005,28710,32957,1,43,4,-2019,-6,-1177,3842,1,0,0,0,5
EUW1_6872315472',1,101,10,0,0,1,0,13,0,364,90,28168,30173,39978,6,29,15,2,0,0,0,4,344,86,27826,30246,28156,1,20,4,342,-5,-73,11822,-2,0,1,0,9
EUW1_6872298593',4,24,11,2,0,0,0,11,1,420,96,29737,31668,31665,2,26,5,0,0,1,0,3,376,76,24439,28837,22279,1,44,20,5298,6,2831,9386,2,0,-1,0,8
EUW1_6872282627',5,30,16,2,0,2,0,8,0,342,90,30480,28891,47101,2,26,8,0,0,1,0,6,319,82,25491,26446,27851,0,23,8,4989,8,2445,19250,2,0,1,0,2
EUW1_6882207573',4,25,18,2,0,1,0,11,1,314,72,29579,28414,34623,7,43,13,0,1,2,0,5,350,116,29768,29244,40053,1,-36,-44,-189,5,-830,-5430,2,-1,-1,0,6
EUW1_6882170173',6,31,11,0,1,0,0,8,1,346,100,28044,28895,26060,4,32,13,1,0,1,0,6,346,81,27048,27568,27824,0,0,19,996,-2,1327,-1764,-1,1,-1,0,2
EUW1_6879136559',2,23,21,2,0,2,0,3,1,387,102,33204,33287,43167,4,35,11,0,0,0,0,10,331,94,27475,29004,35992,1,56,8,5729,10,4283,7175,2,0,2,0,-7
EUW1_6878344623',2,27,7,0,0,0,0,11,0,358,91,23991,28348,24208,7,32,15,1,0,1,0,2,380,103,30355,32449,33650,0,-22,-12,-6364,-8,-4101,-9442,-1,0,-1,0,9
EUW1_6878276748',2,27,14,1,0,0,0,6,1,354,75,27207,29395,31248,4,26,12,0,0,0,0,1,363,96,27180,30782,35768,1,-9,-21,27,2,-1387,-4520,1,0,0,0,5
EUW1_6878183357',6,26,15,0,0,1,0,5,1,361,94,29174,31155,31172,5,33,10,2,0,1,0,3,364,97,27799,30021,28810,0,-3,-3,1375,5,1134,2362,-2,0,0,0,2
EUW1_6878090509',6,42,7,1,0,0,0,8,1,363,83,24577,31555,20655,1,27,7,1,0,2,0,1,410,108,27988,32524,29756,0,-47,-25,-3411,0,-969,-9101,0,0,-2,0,7
EUW1_6876754632',5,39,19,1,0,0,0,4,0,361,74,29041,31006,38669,2,368,9,0,0,0,0,3,351,73,26174,28128,33700,1,10,1,2867,10,2878,4969,1,0,0,0,1
EUW1_6876622061',1,23,8,2,0,0,0,4,1,391,96,27370,31385,25267,8,39,4,0,0,1,0,6,388,79,22922,28930,24187,0,3,17,4448,4,2455,1080,2,0,-1,0,-2
EUW1_6871477385',4,32,13,0,1,0,0,8,1,352,87,29466,29899,30812,6,56,17,2,0,1,0,1,317,80,28675,29333,36867,0,35,7,791,-4,566,-6055,-2,1,-1,0,7
EUW1_6871436974',6,26,10,0,0,1,0,8,0,357,82,27141,28948,25927,4,30,18,2,0,1,0,7,382,86,30016,31376,38596,0,-25,-4,-2875,-8,-2428,-12669,-2,0,0,0,1
EUW1_6881265716',5,29,13,0,0,1,0,8,0,330,58,26031,28162,29703,0,17,15,1,0,0,0,4,379,84,29492,29812,33817,0,-49,-26,-3461,-2,-1650,-4114,-1,0,1,0,4
EUW1_6881214669',3,28,16,1,0,2,0,14,1,371,80,30152,29180,29632,2,18,13,1,0,1,0,1,369,85,28644,29170,31490,1,2,-5,1508,3,10,-1858,0,0,1,0,13
EUW1_6881160292',5,27,11,1,0,0,0,11,0,330,45,25580,25344,33383,5,34,21,1,0,0,0,0,337,148,30360,33767,33093,0,-7,-103,-4780,-10,-8423,290,0,0,0,0,11
EUW1_6881075243',2,79,9,2,0,2,0,13,1,374,104,27651,30147,31552,5,111,6,0,0,1,0,1,346,87,25106,30716,22753,0,28,17,2545,3,-569,8799,2,0,1,0,12
EUW1_6881021836',4,27,11,0,0,0,0,14,1,374,94,28283,28253,21364,5,31,14,1,0,3,0,2,393,82,29908,30078,32499,1,-19,12,-1625,-3,-1825,-11135,-1,0,-3,0,12
EUW1_6879529386',5,79,14,0,0,0,0,9,0,347,64,26973,30133,34999,4,28,15,2,0,0,0,2,345,100,28360,28568,38204,0,2,-36,-1387,-1,1565,-3205,-2,0,0,0,7
EUW1_6879497232',1,25,8,0,0,0,0,11,0,337,117,26516,30444,32139,5,23,16,1,0,1,0,0,331,98,28386,31901,29442,0,6,19,-1870,-8,-1457,2697,-1,0,-1,0,11
EUW1_6879469059',9,40,9,0,0,3,0,4,1,436,97,30766,31223,29531,4,104,8,1,0,0,0,8,359,106,25471,31602,24358,0,77,-9,5295,1,-379,5173,-1,0,3,0,-4
EUW1_6879154015',3,34,15,0,0,1,0,9,1,357,70,28238,29736,34142,6,26,12,1,0,1,0,3,367,58,26645,27608,36763,0,-10,12,1593,3,2128,-2621,-1,0,0,0,6
EUW1_6879104933',8,33,18,0,0,1,0,9,0,357,74,30266,29921,32669,2,23,16,1,0,0,0,2,377,92,29871,30167,34664,0,-20,-18,395,2,-246,-1995,-1,0,1,0,7
EUW1_6879026679',5,28,19,2,0,1,0,11,1,369,92,30913,30884,33041,1,25,10,0,0,0,0,5,357,96,27073,28400,32755,1,12,-4,3840,9,2484,286,2,0,1,0,6
EUW1_6878940312',0,20,14,0,0,1,0,10,1,376,109,29111,31078,33831,6,29,10,1,0,0,0,2,360,66,26434,29395,31850,0,16,43,2677,4,1683,1981,-1,0,1,0,8
EUW1_6878373379',3,33,9,0,0,0,0,11,0,365,88,25207,28271,25108,2,26,14,2,0,1,0,2,360,100,29179,29928,31818,0,5,-12,-3972,-5,-1657,-6710,-2,0,-1,0,9
EUW1_6878330955',5,22,14,0,0,0,0,8,0,368,76,27705,29327,39685,3,26,21,1,0,1,0,0,366,75,30882,30797,41438,1,2,1,-3177,-7,-1470,-1753,-1,0,-1,0,8
EUW1_6878270894',3,29,9,1,1,0,0,3,0,358,76,25385,28206,34718,4,29,15,1,0,0,0,5,366,96,28675,30919,37057,0,-8,-20,-3290,-6,-2713,-2339,0,1,0,0,-2
EUW1_6878199273',3,33,9,2,0,0,0,15,1,349,92,25491,29531,25235,6,32,6,0,1,1,0,3,382,104,26157,29462,23046,1,-33,-12,-666,3,69,2189,2,-1,-1,0,12
EUW1_6878130496',3,26,12,0,0,1,0,12,0,358,74,28800,28746,30450,1,34,8,2,0,2,0,6,364,110,26895,29673,21339,1,-6,-36,1905,4,-927,9111,-2,0,-1,0,6
EUW1_6878076729',5,82,11,0,0,2,0,9,1,349,87,27480,29527,34297,5,42,11,1,0,0,0,3,370,60,26032,29583,32116,0,-21,27,1448,0,-56,2181,-1,0,2,0,6
EUW1_6878032407',6,29,21,1,1,1,0,6,0,371,116,31973,32737,41496,3,38,12,0,0,0,0,2,330,72,26884,26245,30306,1,41,44,5089,9,6492,11190,1,1,1,0,4
EUW1_6883202235',2,36,9,1,0,0,0,12,1,359,94,26394,30496,30604,9,36,15,1,0,3,0,3,419,80,30752,32273,39889,0,-60,14,-4358,-6,-1777,-9285,0,0,-3,0,9
EUW1_6883147222',2,26,5,0,0,0,0,11,1,283,88,22722,24107,24074,3,31,17,2,1,2,0,2,403,94,31662,32086,33743,0,-120,-6,-8940,-12,-7979,-9669,-2,-1,-2,0,9
EUW1_6883019045',4,32,18,0,0,1,0,10,0,354,101,30316,30269,35132,4,22,11,1,0,0,0,3,347,94,26753,29628,30875,0,7,7,3563,7,641,4257,-1,0,1,0,7
EUW1_6882974795',2,22,6,0,0,0,0,7,0,368,96,24033,30589,20161,6,29,12,2,0,0,0,0,396,116,28555,32896,37841,0,-28,-20,-4522,-6,-2307,-17680,-2,0,0,0,7
EUW1_6881800195',6,33,10,0,0,1,0,5,0,358,91,26958,27678,35275,8,101,11,2,0,0,0,5,370,78,26479,28889,32346,0,-12,13,479,-1,-1211,2929,-2,0,1,0,0
EUW1_6881721775',2,43,16,0,0,1,0,7,0,392,79,29220,29251,32680,2,31,18,1,0,2,0,5,358,73,30469,30762,37835,0,34,6,-1249,-2,-1511,-5155,-1,0,-1,0,2
EUW1_6880966611',6,36,8,0,0,0,0,5,0,420,95,26182,31308,29796,5,27,6,1,0,0,0,3,395,92,24582,30904,26253,1,25,3,1600,2,404,3543,-1,0,0,0,2
EUW1_6880933466',1,23,6,2,0,1,0,12,0,365,83,25566,29259,27679,3,54,9,0,0,2,0,4,387,86,26940,30814,26836,0,-22,-3,-1374,-3,-1555,843,2,0,-1,0,8
EUW1_6880905581',4,244,26,1,0,4,0,4,0,395,78,34284,32920,44709,4,94,6,0,0,0,0,9,292,85,22043,23738,30120,1,103,-7,12241,20,9182,14589,1,0,4,0,-5
EUW1_6880878258',1,29,19,1,0,1,0,4,0,385,76,31563,31666,34875,4,30,10,1,0,1,0,5,360,80,26365,28563,32174,1,25,-4,5198,9,3103,2701,0,0,0,0,-1
EUW1_6880425331',2,27,4,1,1,0,0,7,0,401,82,23368,29972,21189,3,26,5,0,0,0,0,3,414,113,26308,31913,22231,0,-13,-31,-2940,-1,-1941,-1042,1,1,0,0,4
EUW1_6879580278',2,32,4,1,0,0,0,9,0,346,98,23273,26418,22792,5,30,13,1,0,1,0,1,392,96,29618,31558,35821,0,-46,2,-6345,-9,-5140,-13029,0,0,-1,0,8
EUW1_6879558169',4,31,17,1,0,1,0,9,1,354,123,32699,32552,40160,4,38,6,1,0,2,0,7,316,64,22795,25929,25577,1,38,59,9904,11,6623,14583,0,0,-1,0,2
EUW1_6879527472',6,32,17,1,0,0,0,15,1,298,71,28823,27342,38441,2,21,24,0,0,1,0,2,391,84,33524,31193,46137,0,-93,-13,-4701,-7,-3851,-7696,1,0,-1,0,13
EUW1_6877034248',1,24,6,1,0,1,0,8,0,396,80,25947,29738,28171,3,24,13,1,0,1,0,5,384,100,28542,31139,24898,0,12,-20,-2595,-7,-1401,3273,0,0,0,0,3
EUW1_6876605037',2,23,13,2,0,0,0,5,0,351,92,26852,29081,39247,5,26,8,0,0,1,0,2,388,104,26306,27906,30204,1,-37,-12,546,5,1175,9043,2,0,-1,0,3
EUW1_6876555312',4,22,13,0,0,2,0,7,1,399,108,30440,32408,27873,5,99,7,2,0,0,0,2,393,79,24952,29000,19626,1,6,29,5488,6,3408,8247,-2,0,2,0,5
EUW1_6876540630',5,64,5,0,0,0,0,6,0,407,84,24983,30644,25672,5,65,6,1,0,0,0,3,398,80,26284,30822,25672,0,9,4,-1301,-1,-178,0,-1,0,0,0,3
EUW1_6881348748',3,23,4,1,0,2,0,10,0,367,100,24732,29441,17608,5,28,9,1,0,1,0,3,400,83,26964,31794,30972,0,-33,17,-2232,-5,-2353,-13364,0,0,1,0,7
EUW1_6881121320',4,33,13,0,0,2,0,10,0,298,107,29101,29578,33145,2,51,19,1,1,2,0,3,336,88,30835,30473,40317,0,-38,19,-1734,-6,-895,-7172,-1,-1,0,0,7
EUW1_6881040296',0,27,10,1,0,1,0,14,0,344,113,27061,29004,25869,1,28,11,0,0,1,0,1,364,109,28288,31130,26652,0,-20,4,-1227,-1,-2126,-783,1,0,0,0,13
EUW1_6880957504',2,115,15,2,1,1,0,8,1,338,104,29927,30897,32256,6,27,14,0,0,1,0,5,322,75,26256,26749,27915,1,16,29,3671,1,4148,4341,2,1,0,0,3
EUW1_6880879342',4,24,10,2,0,0,0,14,0,314,92,24833,29480,29399,4,30,11,0,0,2,0,0,404,78,30097,30570,30284,0,-90,14,-5264,-1,-1090,-885,2,0,-2,0,14
EUW1_6880597506',3,26,9,1,0,0,0,6,1,382,92,28255,29653,26212,4,39,11,0,1,2,0,8,376,106,26938,31481,34643,0,6,-14,1317,-2,-1828,-8431,1,-1,-2,0,-2
EUW1_6880038502',4,25,12,1,1,1,0,3,1,392,107,28407,32403,27235,2,30,8,0,0,0,0,1,367,88,24144,30471,27619,1,25,19,4263,4,1932,-384,1,1,1,0,2
EUW1_6877086856',4,27,17,1,0,0,0,13,0,335,99,28029,31794,35878,4,34,8,1,0,2,0,2,365,88,27749,30280,35044,0,-30,11,280,9,1514,834,0,0,-2,0,11
EUW1_6874662519',5,31,10,1,0,2,0,6,0,398,96,28473,29748,36921,4,28,12,1,0,0,0,7,325,91,25994,29008,23817,1,73,5,2479,-2,740,13104,0,0,2,0,-1
EUW1_6874512012',2,35,13,1,0,1,0,9,0,358,99,28113,29606,32189,1,35,20,0,0,1,0,2,349,64,30768,29990,43515,0,9,35,-2655,-7,-384,-11326,1,0,0,0,7
EUW1_6874458478',7,30,16,1,0,1,0,7,0,402,100,31805,31280,34518,3,32,10,1,0,1,0,7,370,79,25875,28993,22695,0,32,21,5930,6,2287,11823,0,0,0,0,0
EUW1_6874395742',4,28,16,0,0,1,0,9,0,353,70,29808,28919,30954,8,33,14,2,0,0,0,4,349,102,28852,28524,42386,1,4,-32,956,2,395,-11432,-2,0,1,0,5
EUW1_6873408139',6,28,12,0,0,1,0,8,0,337,88,27521,28981,36851,13,32,17,2,0,0,0,5,366,120,30573,31814,42179,0,-29,-32,-3052,-5,-2833,-5328,-2,0,1,0,3
EUW1_6873336409',3,27,11,0,0,1,0,12,0,390,91,28707,30352,33889,4,26,11,1,0,1,0,2,366,80,28060,29903,28323,1,24,11,647,0,449,5566,-1,0,0,0,10
EUW1_6873082730',6,29,20,1,1,3,0,13,1,338,74,32150,31206,42558,1,27,12,1,0,0,0,5,359,89,27438,30105,31310,1,-21,-15,4712,8,1101,11248,0,1,3,0,8
EUW1_6873051507',5,167,16,1,0,1,0,4,1,378,95,29921,33204,34436,0,63,6,1,0,0,0,2,335,104,23603,28624,24453,1,43,-9,6318,10,4580,9983,0,0,1,0,2
EUW1_6872907777',2,30,20,0,0,2,0,10,1,347,74,31610,31709,35954,4,46,10,1,0,1,0,10,342,82,26721,27745,32471,1,5,-8,4889,10,3964,3483,-1,0,1,0,0
EUW1_6872847223',8,31,14,1,0,0,0,6,1,356,73,28036,29879,30048,7,31,16,1,0,0,0,2,380,86,29615,29976,33319,1,-24,-13,-1579,-2,-97,-3271,0,0,0,0,4
EUW1_6872186167',4,26,13,1,0,0,0,6,1,347,73,27468,28442,31873,5,27,15,0,0,0,0,1,385,76,28644,29749,32945,1,-38,-3,-1176,-2,-1307,-1072,1,0,0,0,5
EUW1_6872128949',2,22,6,0,0,0,0,17,0,360,90,25489,28974,25611,6,75,17,2,0,3,0,1,371,89,29551,31476,35258,0,-11,1,-4062,-11,-2502,-9647,-2,0,-3,0,16
EUW1_6882813913',3,28,16,2,0,0,0,9,1,403,94,31839,31128,40018,7,32,15,0,0,3,0,6,315,74,27486,28761,35209,1,88,20,4353,1,2367,4809,2,0,-3,0,3
EUW1_6882260442',4,28,5,0,0,0,0,17,0,306,82,22092,24672,23727,4,25,27,1,0,3,0,2,350,98,35399,32378,37867,0,-44,-16,-13307,-22,-7706,-14140,-1,0,-3,0,15
EUW1_6882250783',5,30,8,0,0,1,0,6,1,407,84,27121,29661,29061,6,30,11,2,0,1,0,7,374,100,27034,30961,26503,1,33,-16,87,-3,-1300,2558,-2,0,0,0,-1
EUW1_6882225969',3,28,12,0,0,0,0,10,1,361,72,27028,28771,39127,2,22,12,2,0,0,0,1,346,98,27044,29668,31596,0,15,-26,-16,0,-897,7531,-2,0,0,0,9
EUW1_6879275247',5,30,6,0,0,0,0,5,0,374,86,24638,28080,31645,4,138,10,1,0,0,0,1,391,73,25009,28815,25450,0,-17,13,-371,-4,-735,6195,-1,0,0,0,4
EUW1_6878062978',2,27,7,0,0,0,0,13,0,342,83,25610,27850,28037,5,25,18,2,0,0,0,1,365,92,29658,31445,31542,0,-23,-9,-4048,-11,-3595,-3505,-2,0,0,0,12
EUW1_6878037012',0,19,13,2,0,0,0,5,1,347,106,27386,29974,29542,6,35,10,0,0,1,0,4,322,83,25158,27707,30676,0,25,23,2228,3,2267,-1134,2,0,-1,0,1
EUW1_6876459702',3,24,14,0,0,0,0,9,0,320,106,27983,31232,31606,6,27,13,2,0,0,0,1,407,93,27477,30436,29378,0,-87,13,506,1,796,2228,-2,0,0,0,8
EUW1_6873806293',6,29,9,1,0,0,0,4,1,354,69,25340,28487,30052,6,27,13,0,0,0,0,0,360,88,26785,29898,27972,1,-6,-19,-1445,-4,-1411,2080,1,0,0,0,4
EUW1_6872101326',5,30,10,1,0,1,0,6,0,418,80,29290,30033,26504,5,97,4,1,0,0,0,6,363,88,23638,28830,18061,1,55,-8,5652,6,1203,8443,0,0,1,0,0
EUW1_6870894167',5,32,10,0,0,0,0,12,0,366,80,26225,29478,29891,0,22,9,1,0,1,0,4,374,96,28297,30391,36285,0,-8,-16,-2072,1,-913,-6394,-1,0,-1,0,8
EUW1_6870838717',7,41,8,1,0,0,0,7,1,389,118,26059,31530,21777,2,29,8,1,1,0,0,1,408,100,25859,30917,24769,0,-19,18,200,0,613,-2992,0,-1,0,0,6
EUW1_6870798030',6,37,7,1,0,1,0,4,1,391,78,26186,28549,28238,2,24,9,0,0,1,0,5,379,90,26891,29957,27826,1,12,-12,-705,-2,-1408,412,1,0,0,0,-1
EUW1_6869392940',3,28,7,1,0,0,0,11,0,295,78,23125,26492,30264,4,41,15,1,0,2,0,0,324,96,28081,29275,40048,0,-29,-18,-4956,-8,-2783,-9784,0,0,-2,0,11
EUW1_6863302648',4,31,10,2,0,1,0,9,0,394,105,28167,31177,26512,2,21,1,0,0,1,0,4,336,74,21145,25811,24896,1,58,31,7022,9,5366,1616,2,0,0,0,5
EUW1_6863091544',2,53,2,0,0,1,0,6,0,410,90,23907,29065,23070,4,36,8,1,0,1,0,1,380,97,26178,31486,23270,0,30,-7,-2271,-6,-2421,-200,-1,0,0,0,5
EUW1_6863052545',4,42,11,0,0,0,0,12,1,381,116,27800,30738,30475,9,30,12,2,0,1,0,3,340,72,27995,28387,32976,1,41,44,-195,-1,2351,-2501,-2,0,-1,0,9
EUW1_6883773555',7,34,8,0,0,0,0,10,0,378,86,25446,29644,23211,6,29,14,2,0,2,0,2,419,118,30747,33113,33430,0,-41,-32,-5301,-6,-3469,-10219,-2,0,-2,0,8
EUW1_6883749101',3,23,5,1,0,0,0,6,1,328,90,24339,27088,21008,5,32,10,1,1,1,0,4,323,94,25010,28688,28114,0,5,-4,-671,-5,-1600,-7106,0,-1,-1,0,2
EUW1_6881605179',4,27,13,0,0,1,0,7,1,386,88,28951,29895,39494,3,30,11,2,0,0,0,7,320,76,24891,27915,39073,1,66,12,4060,2,1980,421,-2,0,1,0,0
EUW1_6881047614',5,28,14,2,1,2,0,14,0,328,85,27972,30717,32930,2,35,6,0,0,1,0,2,366,90,26115,28180,31691,1,-38,-5,1857,8,2537,1239,2,1,1,0,12
EUW1_6881014815',6,33,13,0,0,1,0,9,1,410,81,29459,32334,32381,5,39,9,1,0,0,0,7,364,90,26708,28606,27907,0,46,-9,2751,4,3728,4474,-1,0,1,0,2
EUW1_6880968087',4,59,11,2,1,1,0,8,1,323,94,26288,30801,27559,9,65,7,0,0,1,0,5,371,90,25630,27775,25006,1,-48,4,658,4,3026,2553,2,1,0,0,3
EUW1_6880173995',2,32,10,0,0,0,0,7,1,424,72,27502,31657,26018,2,27,6,2,0,0,0,4,401,114,26114,31338,22701,1,23,-42,1388,4,319,3317,-2,0,0,0,3
EUW1_6876559617',8,31,12,0,0,1,0,7,0,380,81,28105,30889,31640,4,30,9,2,0,0,0,4,379,72,25433,28027,26549,0,1,9,2672,3,2862,5091,-2,0,1,0,3
EUW1_6876537902',3,19,15,0,0,1,0,11,1,284,74,28281,27535,38845,4,28,21,1,0,1,0,6,304,86,30504,30448,39086,0,-20,-12,-2223,-6,-2913,-241,-1,0,0,0,5
EUW1_6876527568',3,19,16,1,1,0,0,13,1,353,77,28546,30680,34227,2,27,12,1,0,2,0,0,392,105,29797,31831,30962,0,-39,-28,-1251,4,-1151,3265,0,1,-2,0,13
EUW1_6876113648',4,23,11,0,1,1,0,10,1,336,76,28147,28662,30026,4,53,15,1,0,0,0,1,359,81,28260,28680,33021,0,-23,-5,-113,-4,-18,-2995,-1,1,1,0,9
EUW1_6876604001',8,32,6,0,0,0,0,9,1,358,87,24884,29257,25688,5,32,11,2,0,2,0,2,404,108,28838,32083,27447,0,-46,-21,-3954,-5,-2826,-1759,-2,0,-2,0,7
EUW1_6876571342',6,22,11,0,0,1,0,9,1,406,88,28817,27925,29448,4,44,17,2,0,1,0,5,374,92,29186,30422,26275,0,32,-4,-369,-6,-2497,3173,-2,0,0,0,4
EUW1_6876555744',3,27,7,0,0,0,0,10,0,371,93,24377,30128,21760,4,41,16,2,0,1,0,0,385,111,30661,32925,29740,0,-14,-18,-6284,-9,-2797,-7980,-2,0,-1,0,10
EUW1_6876534591',3,35,4,0,0,0,0,14,0,317,78,23032,25131,26765,7,41,20,2,0,2,0,1,369,106,30978,30213,34053,0,-52,-28,-7946,-16,-5082,-7288,-2,0,-2,0,13
EUW1_6876509480',5,32,13,1,0,0,0,10,0,311,78,27773,27228,31221,2,22,18,0,1,2,0,6,375,97,32799,32249,34428,1,-64,-19,-5026,-5,-5021,-3207,1,-1,-2,0,4
EUW1_6876485040',3,24,7,2,0,0,0,14,0,347,92,25682,27074,25467,5,32,19,0,0,2,0,7,376,92,31228,31329,32180,0,-29,0,-5546,-12,-4255,-6713,2,0,-2,0,7
EUW1_6875946352',3,31,18,1,1,0,0,12,1,342,100,31164,31318,37015,1,25,12,1,0,2,0,2,354,98,28150,29501,38401,1,-12,2,3014,6,1817,-1386,0,1,-2,0,10
EUW1_6875825982',5,44,15,2,0,0,0,11,1,361,82,28475,29697,33403,1,26,9,0,0,1,0,4,326,94,25159,27755,32274,1,35,-12,3316,6,1942,1129,2,0,-1,0,7
EUW1_6875750255',6,35,16,1,0,1,0,13,1,376,90,29518,30275,35645,2,27,10,1,0,2,0,4,398,84,28455,29555,30032,1,-22,6,1063,6,720,5613,0,0,-1,0,9
EUW1_6875725625',3,221,9,2,0,1,0,9,1,360,82,26175,27851,30105,0,23,15,0,1,1,0,4,323,106,28521,29298,31159,0,37,-24,-2346,-6,-1447,-1054,2,-1,0,0,5
EUW1_6875677884',3,33,6,0,0,0,0,7,1,330,100,24151,27624,24351,8,93,11,2,0,1,0,3,379,68,26915,29599,25825,1,-49,32,-2764,-5,-1975,-1474,-2,0,-1,0,4
EUW1_6875634987',5,46,20,2,0,1,0,6,1,372,115,31172,31427,35209,2,21,5,0,0,0,0,3,331,88,22743,25930,25127,1,41,27,8429,15,5497,10082,2,0,1,0,3
EUW1_6875462054',1,21,15,0,0,1,0,8,0,375,70,29335,30151,30684,0,28,17,2,1,2,0,4,364,104,29428,30076,34263,1,11,-34,-93,-2,75,-3579,-2,-1,-1,0,4
EUW1_6875203956',2,23,6,1,0,0,0,11,1,375,100,26092,29451,23281,6,83,9,1,0,1,0,3,378,72,26199,30431,25470,1,-3,28,-107,-3,-980,-2189,0,0,-1,0,8
EUW1_6875111746',3,28,17,0,0,0,0,6,1,368,74,29052,29841,35144,5,28,17,1,0,1,0,2,344,73,29424,29422,35313,0,24,1,-372,0,419,-169,-1,0,-1,0,4
EUW1_6874609265',2,34,21,2,1,1,0,12,0,340,96,32529,31312,44504,3,42,18,0,0,2,0,7,357,60,31899,30015,49366,0,-17,36,630,3,1297,-4862,2,1,-1,0,5
EUW1_6874569631',5,26,24,0,0,2,0,9,1,403,100,35388,34826,52475,0,102,13,0,0,1,0,10,328,88,27696,29183,31222,1,75,12,7692,11,5643,21253,0,0,1,0,-1
EUW1_6874486990',4,26,17,0,0,1,0,5,0,359,70,29326,30348,37067,3,27,14,1,1,0,0,4,339,114,28014,28456,32961,1,20,-44,1312,3,1892,4106,-1,-1,1,0,1
EUW1_6874276464',9,30,14,2,1,1,0,7,1,387,106,31031,30122,38694,1,41,8,0,0,1,0,4,322,58,22946,24532,32044,1,65,48,8085,6,5590,6650,2,1,0,0,3
EUW1_6874134768',5,26,11,0,0,0,0,14,1,368,86,28337,29054,35294,2,24,15,1,0,3,0,4,374,86,29933,30090,36085,1,-6,0,-1596,-4,-1036,-791,-1,0,-3,0,10
EUW1_6882999613',1,29,15,0,0,0,0,3,0,347,103,30511,29414,43545,5,25,20,2,0,0,0,2,272,66,28213,27654,36577,0,75,37,2298,-5,1760,6968,-2,0,0,0,1
EUW1_6882927431',5,43,3,0,0,0,0,12,0,374,72,22606,27925,23309,5,44,20,2,0,1,0,0,390,107,31661,32384,41499,0,-16,-35,-9055,-17,-4459,-18190,-2,0,-1,0,12
EUW1_6882867358',1,23,6,0,0,2,0,9,0,390,104,27702,29920,33477,4,31,12,2,0,0,0,7,330,95,26346,30215,20774,1,60,9,1356,-6,-295,12703,-2,0,2,0,2
EUW1_6882818103',1,209,20,0,0,2,0,12,1,336,87,31644,29654,41399,7,25,10,2,0,0,0,11,372,102,26655,28759,29112,0,-36,-15,4989,10,895,12287,-2,0,2,0,1
EUW1_6882777139',4,25,11,1,0,1,0,13,0,341,98,29031,29259,34011,3,21,17,0,0,2,0,6,363,85,30288,30905,39802,1,-22,13,-1257,-6,-1646,-5791,1,0,-1,0,7
EUW1_6882706242',2,109,14,2,0,1,0,7,0,386,86,30791,31829,39796,1,26,9,0,0,2,0,9,337,80,25558,26626,27733,1,49,6,5233,5,5203,12063,2,0,-1,0,-2
EUW1_6882674011',5,29,10,1,0,1,0,11,1,342,84,26619,26538,24610,3,31,14,1,0,2,0,1,326,95,27563,28477,33541,0,16,-11,-944,-4,-1939,-8931,0,0,-1,0,10
EUW1_6882630077',3,528,11,1,1,1,0,5,1,328,106,27832,28437,32285,3,24,14,1,0,0,0,9,314,78,26260,28002,30666,1,14,28,1572,-3,435,1619,0,1,1,0,-4
EUW1_6882024137',7,38,18,2,0,0,0,10,1,339,92,28201,31350,36665,2,33,10,0,0,0,0,1,363,74,26219,28993,35663,1,-24,18,1982,8,2357,1002,2,0,0,0,9
EUW1_6881701306',4,43,12,0,0,0,0,7,1,361,107,26602,29812,26679,2,22,8,2,0,0,0,1,369,84,25329,30334,24733,1,-8,23,1273,4,-522,1946,-2,0,0,0,6
EUW1_6881622308',6,64,1,0,0,0,0,9,0,392,104,22956,29935,27456,3,382,6,2,0,1,0,0,407,83,26463,31861,27153,0,-15,21,-3507,-5,-1926,303,-2,0,-1,0,9
EUW1_6881562799',3,29,16,1,0,0,0,13,0,312,86,27128,28169,34627,0,26,16,0,0,2,0,4,334,94,30099,28359,31347,0,-22,-8,-2971,0,-190,3280,1,0,-2,0,9
EUW1_6881508686',4,27,13,0,0,0,0,11,1,346,90,27631,29533,35882,6,36,10,2,0,1,0,2,388,89,26717,30098,24740,0,-42,1,914,3,-565,11142,-2,0,-1,0,9
EUW1_6881351252',6,28,11,0,1,3,0,5,0,380,92,29427,30261,33048,1,22,7,1,0,0,0,13,353,110,25308,29761,29130,1,27,-18,4119,4,500,3918,-1,1,3,0,-8
EUW1_6881288075',3,29,12,0,0,0,0,10,0,339,82,26874,29302,34192,2,33,17,2,0,1,0,6,338,92,29232,30114,37528,0,1,-10,-2358,-5,-812,-3336,-2,0,-1,0,4
EUW1_6881248816',6,32,16,2,1,1,0,7,1,437,98,32363,33419,36358,2,31,9,0,0,1,0,6,326,94,23950,26860,21898,1,111,4,8413,7,6559,14460,2,1,0,0,1
EUW1_6881210705',4,25,9,0,0,1,0,4,0,386,70,27065,28020,28811,3,136,11,1,0,0,0,5,387,106,27005,30927,30059,0,-1,-36,60,-2,-2907,-1248,-1,0,1,0,-1
EUW1_6881137172',6,28,4,0,0,1,0,12,0,370,94,23942,29174,20009,2,31,7,2,0,1,0,2,397,82,26957,30239,23732,0,-27,12,-3015,-3,-1065,-3723,-2,0,0,0,10
EUW1_6881093792',3,31,23,2,1,3,0,6,0,338,78,32814,30555,36466,2,36,10,0,0,1,0,11,294,110,25868,27270,24545,1,44,-32,6946,13,3285,11921,2,1,2,0,-5
EUW1_6880294558',3,27,8,1,1,0,0,7,1,405,95,27216,31204,24024,1,23,5,1,0,0,0,6,372,93,23859,29231,16489,1,33,2,3357,3,1973,7535,0,1,0,0,1
EUW1_6874602559',1,32,8,0,0,0,0,10,0,340,79,23598,27446,24577,4,101,15,2,0,1,0,0,360,83,29529,31556,35722,0,-20,-4,-5931,-7,-4110,-11145,-2,0,-1,0,10
EUW1_6873281346',4,42,10,2,0,0,0,12,1,384,114,28034,31230,20564,4,28,12,0,1,2,0,6,387,93,28330,31704,33365,1,-3,21,-296,-2,-474,-12801,2,-1,-2,0,6
EUW1_6871800992',2,26,7,0,0,0,0,2,1,406,87,25410,30453,30591,6,30,10,2,0,1,0,2,372,82,26445,31308,26217,0,34,5,-1035,-3,-855,4374,-2,0,-1,0,0
EUW1_6870535310',3,30,14,0,0,1,0,6,1,395,76,27226,31333,33327,5,34,7,1,0,0,0,5,327,96,24439,27827,25523,1,68,-20,2787,7,3506,7804,-1,0,1,0,1
EUW1_6870146068',7,33,10,1,0,2,0,10,1,394,78,29525,30332,38032,1,46,11,1,0,2,0,6,349,94,27051,29584,28808,0,45,-16,2474,-1,748,9224,0,0,0,0,4
EUW1_6870075198',7,29,2,0,0,0,0,5,0,382,106,23821,28712,23232,5,42,9,2,0,0,0,2,373,89,25477,30446,22791,0,9,17,-1656,-7,-1734,441,-2,0,0,0,3
EUW1_6869733454',3,56,12,1,0,0,0,7,1,362,94,26434,33680,30673,2,168,9,0,0,0,0,1,352,72,25034,32691,30572,1,10,22,1400,3,989,101,1,0,0,0,6
EUW1_6869683703',3,24,17,0,0,0,0,10,1,344,92,29576,30748,30050,9,31,14,1,0,1,0,0,386,103,30970,31265,36662,0,-42,-11,-1394,3,-517,-6612,-1,0,-1,0,10
EUW1_6869641451',2,22,4,0,0,0,0,16,1,325,78,23641,26438,28591,5,34,21,2,1,3,0,2,412,113,33434,34801,46812,0,-87,-35,-9793,-17,-8363,-18221,-2,-1,-3,0,14
EUW1_6869411930',5,30,10,1,0,1,0,10,0,366,80,27249,30641,29214,2,66,10,1,0,1,0,5,363,90,26547,30223,26427,0,3,-10,702,0,418,2787,0,0,0,0,5
EUW1_6869392582',4,28,21,2,0,4,0,8,1,398,116,35085,31142,40334,4,23,11,0,0,0,0,7,282,60,25449,25328,25052,1,116,56,9636,10,5814,15282,2,0,4,0,1
EUW1_6868894147',8,36,18,0,0,1,0,7,1,364,132,32941,29881,38456,5,268,11,2,0,1,0,4,298,84,25140,25884,28810,1,66,48,7801,7,3997,9646,-2,0,0,0,3
EUW1_6868730041',3,32,17,0,0,0,0,11,0,343,92,30230,31218,35996,4,25,17,1,0,2,0,7,394,92,30956,31516,31332,1,-51,0,-726,0,-298,4664,-1,0,-2,0,4
EUW1_6868655834',6,28,19,1,0,1,0,10,1,359,69,30340,30468,38456,2,23,9,0,0,1,0,3,375,95,26606,29867,26258,1,-16,-26,3734,10,601,12198,1,0,0,0,7
EUW1_6868318424',5,30,13,1,0,1,0,3,1,370,102,28750,30215,33996,2,27,7,1,0,0,0,5,368,72,24346,28976,22647,1,2,30,4404,6,1239,11349,0,0,1,0,-2
EUW1_6868273260',2,32,12,0,0,1,0,14,0,329,86,28062,26071,32017,6,50,24,2,0,3,0,5,370,78,34274,30986,39643,0,-41,8,-6212,-12,-4915,-7626,-2,0,-2,0,9
EUW1_6868203231',2,36,6,0,0,0,0,6,0,398,72,26220,29053,26394,7,31,7,1,0,0,0,1,407,98,25486,29065,24169,0,-9,-26,734,-1,-12,2225,-1,0,0,0,5
EUW1_6868071828',5,83,15,1,0,2,0,3,0,404,67,29998,31933,35154,6,31,9,0,0,0,0,3,365,79,24969,29494,27163,1,39,-12,5029,6,2439,7991,1,0,2,0,0
EUW1_6868027089',5,29,16,1,0,0,0,15,1,379,95,29425,32781,38801,5,146,6,1,0,2,0,3,394,100,27851,29691,26319,1,-15,-5,1574,10,3090,12482,0,0,-2,0,12
EUW1_6867997670',0,39,7,1,0,0,0,11,0,338,64,24885,27040,36109,3,33,23,1,0,2,0,1,374,87,33003,32976,40329,0,-36,-23,-8118,-16,-5936,-4220,0,0,-2,0,10
EUW1_6882578189',4,30,9,1,0,1,0,12,1,313,88,26960,26539,25043,4,91,12,0,1,0,0,4,325,100,26684,29442,26815,0,-12,-12,276,-3,-2903,-1772,1,-1,1,0,8
EUW1_6882550165',3,27,8,2,0,2,0,9,0,340,96,26842,28201,29903,6,28,11,0,0,1,0,7,362,75,26836,29807,25677,1,-22,21,6,-3,-1606,4226,2,0,1,0,2
EUW1_6881464587',7,33,15,2,0,2,0,9,0,414,91,30661,29636,34614,3,26,9,0,0,0,0,6,373,87,26013,28913,30884,1,41,4,4648,6,723,3730,2,0,2,0,3
EUW1_6881406044',5,29,16,0,0,1,0,12,1,343,116,29389,30788,32942,1,30,13,2,0,1,0,4,414,87,30809,33397,30986,0,-71,29,-1420,3,-2609,1956,-2,0,0,0,8
EUW1_6881293469',1,30,28,1,0,2,0,7,1,319,75,33187,28018,56213,4,26,16,1,0,0,0,8,326,86,28298,28502,34465,1,-7,-11,4889,12,-484,21748,0,0,2,0,-1
EUW1_6881241372',3,31,8,0,0,0,0,13,0,282,90,24197,25691,21763,3,34,17,1,1,2,0,3,330,102,29426,29903,40423,0,-48,-12,-5229,-9,-4212,-18660,-1,-1,-2,0,10
EUW1_6881195156',6,34,19,1,0,3,0,3,1,361,88,32721,31210,37497,4,28,9,0,0,0,0,12,292,88,26270,27029,31473,1,69,0,6451,10,4181,6024,1,0,3,0,-9
EUW1_6881130276',4,30,9,0,1,0,0,4,0,369,90,25580,29641,17630,4,29,7,2,0,0,0,1,393,93,24665,29398,26161,1,-24,-3,915,2,243,-8531,-2,1,0,0,3
EUW1_6881065404',3,26,12,1,0,3,0,6,0,392,117,30739,32679,32421,7,49,10,0,0,0,0,9,361,87,26182,29245,24359,0,31,30,4557,2,3434,8062,1,0,3,0,-3
EUW1_6881032269',4,30,9,1,0,1,0,6,1,370,100,26928,30458,30613,2,35,9,0,0,0,0,4,380,85,25630,32025,23552,1,-10,15,1298,0,-1567,7061,1,0,1,0,2
EUW1_6880990699',7,31,10,0,0,0,0,9,1,367,110,26258,30393,23459,5,30,10,1,0,0,0,2,336,81,25948,27552,28204,0,31,29,310,0,2841,-4745,-1,0,0,0,7
EUW1_6880959174',6,26,4,0,0,2,0,9,0,397,72,24846,28863,17728,3,27,14,1,1,0,0,4,391,98,29119,31766,31164,0,6,-26,-4273,-10,-2903,-13436,-1,-1,2,0,5
EUW1_6880867648',6,34,11,0,0,1,0,8,0,360,58,26353,28170,32047,5,24,12,1,0,1,0,3,379,85,27473,30261,37178,1,-19,-27,-1120,-1,-2091,-5131,-1,0,0,0,5
EUW1_6880846112',4,25,11,0,0,0,0,7,1,326,78,25827,27214,30082,1,42,14,2,0,2,0,0,381,110,29328,31493,34803,0,-55,-32,-3501,-3,-4279,-4721,-2,0,-2,0,7
EUW1_6880831391',5,28,13,2,1,0,0,10,0,352,111,28410,30866,33252,4,32,9,0,0,2,0,4,371,86,26466,28457,24565,1,-19,25,1944,4,2409,8687,2,1,-2,0,6
EUW1_6880819450',5,31,11,0,0,0,0,12,1,353,99,27521,28908,25963,1,23,18,2,0,1,0,6,361,89,30482,28631,35063,1,-8,10,-2961,-7,277,-9100,-2,0,-1,0,6
EUW1_6880821550',6,32,10,1,0,0,0,13,0,380,76,25997,30869,30447,1,27,10,0,0,2,0,7,315,86,27253,28445,28526,0,65,-10,-1256,0,2424,1921,1,0,-2,0,6
EUW1_6880801292',5,153,24,2,0,1,0,6,1,334,88,32308,30186,45755,2,27,14,0,0,0,0,6,255,82,27205,26050,33502,1,79,6,5103,10,4136,12253,2,0,1,0,0
EUW1_6880795330',2,27,4,0,0,0,0,11,0,307,87,22116,24435,32057,1,28,22,1,0,2,0,1,375,86,31638,30685,36007,0,-68,1,-9522,-18,-6250,-3950,-1,0,-2,0,10
EUW1_6879626706',2,19,12,1,0,2,0,13,0,395,120,30005,32777,27748,5,34,10,1,1,1,0,6,320,104,27391,28560,33065,1,75,16,2614,2,4217,-5317,0,-1,1,0,7
EUW1_6879586660',2,27,9,1,0,0,0,7,0,386,109,25890,30762,36371,1,25,13,1,0,1,0,1,375,108,28456,32687,34106,0,11,1,-2566,-4,-1925,2265,0,0,-1,0,6
EUW1_6879522925',7,41,17,0,0,0,0,7,1,369,104,30538,31118,39071,6,33,8,1,0,1,0,5,344,83,25073,28248,26484,1,25,21,5465,9,2870,12587,-1,0,-1,0,2
EUW1_6879475110',5,34,10,1,0,0,0,10,1,360,102,26754,30237,24651,7,36,11,1,0,1,0,2,366,77,26974,29561,29295,0,-6,25,-220,-1,676,-4644,0,0,-1,0,8
EUW1_6881260727',4,53,14,0,1,1,0,10,0,396,102,31144,31890,29429,4,34,11,2,0,3,0,5,392,106,28782,30631,30244,1,4,-4,2362,3,1259,-815,-2,1,-2,0,5
EUW1_6878073415',3,29,18,1,0,3,0,14,0,384,101,31557,33598,39461,4,27,6,0,0,1,0,6,350,85,25662,27096,23698,1,34,16,5895,12,6502,15763,1,0,2,0,8
EUW1_6867799192',8,34,10,0,0,0,0,14,1,318,81,24735,26843,33538,2,24,13,2,0,4,0,2,381,81,32188,31611,43875,0,-63,0,-7453,-3,-4768,-10337,-2,0,-4,0,12
EUW1_6867342371',5,42,15,0,0,0,0,3,1,401,108,29230,31523,26679,6,34,10,2,0,0,0,4,337,95,24976,28298,30100,0,64,13,4254,5,3225,-3421,-2,0,0,0,-1
EUW1_6867256315',1,42,7,1,0,0,0,8,1,339,90,25842,28350,26762,5,71,18,0,0,1,0,4,401,106,28651,32168,28342,0,-62,-16,-2809,-11,-3818,-1580,1,0,-1,0,4
EUW1_6865282769',7,32,10,0,1,0,0,9,1,390,86,26752,29131,26073,3,40,8,1,0,1,0,4,374,85,26478,29177,27751,1,16,1,274,2,-46,-1678,-1,1,-1,0,5
EUW1_6863362537',2,32,7,1,0,1,0,9,0,375,82,24596,28123,22460,8,25,15,1,0,1,0,2,365,118,29509,32544,27815,0,10,-36,-4913,-8,-4421,-5355,0,0,0,0,7
EUW1_6863332122',1,23,4,0,0,0,0,9,0,322,95,21972,27376,19874,1,24,13,2,1,2,0,0,409,112,29873,32469,33582,0,-87,-17,-7901,-9,-5093,-13708,-2,-1,-2,0,9
EUW1_6863318902',6,31,4,0,0,1,0,7,1,334,72,23795,26819,24247,4,32,14,2,0,1,0,1,377,93,28261,31398,25436,0,-43,-21,-4466,-10,-4579,-1189,-2,0,0,0,6
EUW1_6862580083',0,26,13,0,0,0,0,15,0,301,104,27763,27377,37665,2,27,26,2,1,3,0,2,368,103,36341,34617,46498,0,-67,1,-8578,-13,-7240,-8833,-2,-1,-3,0,13
EUW1_6862178906',1,21,6,0,0,1,0,14,0,314,80,23852,25408,31021,6,29,25,2,1,2,0,2,346,75,32488,30488,42120,0,-32,5,-8636,-19,-5080,-11099,-2,-1,-1,0,12
EUW1_6861818712',5,24,14,1,0,0,0,5,0,386,87,28933,29596,23605,2,36,9,1,0,1,0,3,350,104,25294,28687,24238,0,36,-17,3639,5,909,-633,0,0,-1,0,2
EUW1_6861758102',0,33,11,1,0,0,0,11,0,339,84,26541,29452,30842,3,28,14,0,0,1,0,1,386,104,29520,30420,36003,0,-47,-20,-2979,-3,-968,-5161,1,0,-1,0,10
EUW1_6860672811',2,31,6,1,1,0,0,7,1,346,85,24397,27884,23508,3,32,12,1,0,0,0,3,392,91,27700,31074,28540,0,-46,-6,-3303,-6,-3190,-5032,0,1,0,0,4
EUW1_6860643201',3,49,19,1,0,2,0,9,0,348,89,31660,31105,36567,2,45,14,1,0,0,0,7,331,82,27996,28615,36500,1,17,7,3664,5,2490,67,0,0,2,0,2
EUW1_6858669453',4,36,21,1,0,1,0,9,1,390,92,31870,33365,43389,5,28,10,1,0,1,0,4,277,84,23739,26365,33372,1,113,8,8131,11,7000,10017,0,0,0,0,5
EUW1_6856495739',3,30,2,0,0,0,0,10,0,369,97,23370,27103,23882,7,34,13,2,0,2,0,3,380,110,29451,32272,28556,0,-11,-13,-6081,-11,-5169,-4674,-2,0,-2,0,7
EUW1_6883765195',1,26,14,0,0,1,0,8,0,383,92,28992,31389,34298,2,29,7,1,0,0,0,3,349,96,25546,30022,25801,1,34,-4,3446,7,1367,8497,-1,0,1,0,5
EUW1_6882403837',3,30,16,2,0,0,0,9,0,357,92,28379,30882,33889,6,103,10,0,0,0,0,3,349,96,26418,29617,24217,1,8,-4,1961,6,1265,9672,2,0,0,0,6
EUW1_6881605273',2,31,7,1,0,0,0,9,1,398,74,25253,29389,27411,4,28,6,1,1,3,0,2,437,115,27899,32459,28311,0,-39,-41,-2646,1,-3070,-900,0,-1,-3,0,7
EUW1_6869637126',1,24,12,1,0,2,0,12,1,367,110,29078,31459,31269,6,153,9,1,0,1,0,5,365,83,25908,28284,26049,1,2,27,3170,3,3175,5220,0,0,1,0,7
EUW1_6869594380',8,29,7,1,1,0,0,4,0,383,91,25178,29705,16979,5,25,3,1,0,1,0,4,405,110,24554,28869,15913,1,-22,-19,624,4,836,1066,0,1,-1,0,0
EUW1_6869348196',5,28,15,1,0,0,0,7,1,327,94,28972,30382,32979,7,27,14,1,1,0,0,2,386,102,29209,32101,36251,0,-59,-8,-237,1,-1719,-3272,0,-1,0,0,5
EUW1_6875427975',7,34,19,0,0,1,0,12,1,332,86,29385,29368,36677,0,24,17,2,0,3,0,2,350,78,31065,27812,37141,0,-18,8,-1680,2,1556,-464,-2,0,-2,0,10
EUW1_6875379873',3,43,14,1,0,0,0,9,1,295,91,26805,28752,35155,3,23,10,0,1,1,0,3,397,69,27213,29831,35126,0,-102,22,-408,4,-1079,29,1,-1,-1,0,6
EUW1_6875353290',3,153,9,1,0,0,0,11,0,308,82,24208,27521,28576,4,57,21,1,0,2,0,1,380,102,32802,33784,44561,0,-72,-20,-8594,-12,-6263,-15985,0,0,-2,0,10
EUW1_6875331806',3,35,16,1,1,3,0,8,0,374,84,30779,31057,36793,5,71,5,0,0,0,0,9,347,87,24122,27308,22925,1,27,-3,6657,11,3749,13868,1,1,3,0,-1
EUW1_6875304011',4,31,10,0,0,0,0,15,0,251,60,24288,23258,30301,5,28,26,2,0,7,0,1,376,119,38998,33808,47182,0,-125,-59,-14710,-16,-10550,-16881,-2,0,-7,0,14
EUW1_6874114468',3,104,7,0,0,0,0,9,0,377,76,24646,29352,24112,6,218,10,1,1,1,0,2,382,117,28325,30782,29255,0,-5,-41,-3679,-3,-1430,-5143,-1,-1,-1,0,7
EUW1_6871484548',2,21,18,0,0,2,0,13,0,332,84,32194,29761,40166,5,30,10,1,0,2,0,9,364,90,27802,28707,26418,1,-32,-6,4392,8,1054,13748,-1,0,0,0,4
EUW1_6871340095',1,14,26,0,0,1,0,12,1,307,74,31065,30428,42492,2,31,18,1,0,1,0,5,332,84,30588,30343,39686,1,-25,-10,477,8,85,2806,-1,0,0,0,7
EUW1_6871314570',3,60,18,1,0,0,0,5,1,365,88,29658,29691,36031,1,22,12,0,1,0,0,3,361,55,26864,28011,37456,1,4,33,2794,6,1680,-1425,1,-1,0,0,2
EUW1_6867773004',3,28,9,1,0,0,0,10,1,371,98,26462,28062,25269,4,96,16,1,0,1,0,3,384,89,30419,30282,38031,0,-13,9,-3957,-7,-2220,-12762,0,0,-1,0,7
EUW1_6860854494',4,29,4,1,0,0,0,8,0,360,100,23562,28636,33054,3,22,10,0,0,1,0,3,378,76,26634,29601,29577,1,-18,24,-3072,-6,-965,3477,1,0,-1,0,5
EUW1_6860842600',3,21,10,0,0,0,0,10,1,375,92,27126,29720,32305,0,22,16,1,1,0,0,5,363,103,29663,31393,35791,0,12,-11,-2537,-6,-1673,-3486,-1,-1,0,0,5
EUW1_6859150836',1,30,5,0,0,0,0,11,1,363,80,23876,28291,27128,2,29,14,1,0,1,0,1,412,85,29907,32933,33828,0,-49,-5,-6031,-9,-4642,-6700,-1,0,-1,0,10
EUW1_6859062296',2,28,11,1,0,1,0,5,1,357,98,27169,30428,32916,2,41,10,1,0,0,0,4,384,82,26258,30789,37171,0,-27,16,911,1,-361,-4255,0,0,1,0,1
EUW1_6859024761',4,64,14,0,0,0,0,12,1,308,77,27132,28243,33388,1,25,15,1,1,2,0,4,358,97,30752,30772,42294,0,-50,-20,-3620,-1,-2529,-8906,-1,-1,-2,0,8
EUW1_6858968926',2,35,8,0,0,0,0,8,1,366,78,25885,29599,29416,6,30,12,2,1,1,0,1,437,118,30446,33498,37347,0,-71,-40,-4561,-4,-3899,-7931,-2,-1,-1,0,7
EUW1_6858926688',2,28,6,0,0,0,0,18,0,266,92,23153,24900,25976,1,45,24,2,0,4,0,1,349,85,34970,31191,44424,0,-83,7,-11817,-18,-6291,-18448,-2,0,-4,0,17
EUW1_6858886590',1,23,2,0,0,0,0,13,0,317,64,20236,24999,17927,3,27,13,2,0,3,0,0,418,120,31709,33020,30083,0,-101,-56,-11473,-11,-8021,-12156,-2,0,-3,0,13
EUW1_6858830455',0,24,15,0,0,1,0,10,1,308,94,29245,27673,36238,5,35,10,2,1,2,0,2,320,102,26941,28030,28010,1,-12,-8,2304,5,-357,8228,-2,-1,-1,0,8
EUW1_6882701316',6,22,20,2,0,1,0,6,1,373,74,32662,32054,37234,4,28,6,0,0,1,0,9,316,85,23645,26907,24677,1,57,-11,9017,14,5147,12557,2,0,0,0,-3
EUW1_6882670019',3,36,14,1,0,0,0,10,1,345,86,28225,29597,40061,5,23,15,1,1,3,0,5,353,85,29150,30848,32917,0,-8,1,-925,-1,-1251,7144,0,-1,-3,0,5
EUW1_6882139064',4,26,20,1,0,2,0,9,0,352,102,32150,30650,47293,6,28,14,1,0,1,0,5,272,43,25622,27985,36029,1,80,59,6528,6,2665,11264,0,0,1,0,4
EUW1_6882087218',5,28,12,2,0,1,0,5,1,353,96,27663,29316,30970,3,29,10,0,0,0,0,4,328,64,24374,25715,31066,1,25,32,3289,2,3601,-96,2,0,1,0,1
EUW1_6881641983',5,224,18,2,0,2,0,9,1,402,94,30874,33192,30255,2,21,7,0,0,2,0,4,328,77,24397,28387,32637,1,74,17,6477,11,4805,-2382,2,0,0,0,5
EUW1_6881205225',3,41,12,0,0,0,0,7,0,358,54,25348,28064,26780,6,41,11,1,0,0,0,4,362,69,26093,28474,29082,0,-4,-15,-745,1,-410,-2302,-1,0,0,0,3
EUW1_6881173248',1,26,13,0,0,0,0,15,0,331,90,27702,28171,27058,2,22,22,2,0,4,0,3,405,114,35330,34222,35445,0,-74,-24,-7628,-9,-6051,-8387,-2,0,-4,0,12
EUW1_6881109343',3,28,14,0,0,0,0,15,0,336,98,30038,29656,28696,4,29,20,2,0,3,0,3,316,77,30721,29377,40333,0,20,21,-683,-6,279,-11637,-2,0,-3,0,12
EUW1_6880706111',4,30,16,1,0,0,0,8,1,339,65,27892,28988,33824,2,27,14,1,0,1,0,2,357,86,28388,30060,35834,0,-18,-21,-496,2,-1072,-2010,0,0,-1,0,6
EUW1_6880676067',3,26,18,1,0,0,0,12,1,285,75,28713,26543,33043,7,149,16,0,0,1,0,3,373,84,29706,29108,27727,1,-88,-9,-993,2,-2565,5316,1,0,-1,0,9
EUW1_6880635013',3,25,12,0,0,1,0,10,1,372,76,27831,29236,35969,4,27,13,2,0,1,0,5,379,96,28146,30754,29762,1,-7,-20,-315,-1,-1518,6207,-2,0,0,0,5
EUW1_6879673215',4,28,6,1,0,1,0,15,0,314,72,24943,24842,30966,11,109,26,1,0,3,0,5,369,99,33978,32190,42506,0,-55,-27,-9035,-20,-7348,-11540,0,0,-2,0,10
EUW1_6879636529',1,21,11,0,0,0,0,9,1,351,96,26188,29252,28081,3,24,16,2,0,0,0,2,381,100,29623,31631,34722,0,-30,-4,-3435,-5,-2379,-6641,-2,0,0,0,7
EUW1_6879593965',7,30,8,1,0,0,0,5,1,405,76,25667,30545,23081,3,47,4,1,0,0,0,1,426,108,24889,30371,22942,0,-21,-32,778,4,174,139,0,0,0,0,4
EUW1_6878126433',7,34,17,2,1,0,0,6,1,350,92,28724,29508,43449,7,32,13,0,0,0,0,5,351,83,27144,28975,38392,1,-1,9,1580,4,533,5057,2,1,0,0,1
EUW1_6878091444',2,27,8,0,0,0,0,10,0,394,78,26190,29693,30353,5,28,12,2,0,0,0,5,391,117,27898,32462,26784,0,3,-39,-1708,-4,-2769,3569,-2,0,0,0,5
EUW1_6878069149',2,29,8,0,0,0,0,11,0,388,92,26090,27578,31045,3,24,13,2,0,1,0,4,323,86,27457,27208,32652,0,65,6,-1367,-5,370,-1607,-2,0,-1,0,7
EUW1_6877630502',4,40,8,2,0,0,0,9,0,375,76,25257,30089,28650,8,31,7,0,0,0,0,3,373,118,25559,30560,31133,0,2,-42,-302,1,-471,-2483,2,0,0,0,6
EUW1_6877570305',3,32,12,0,0,0,0,15,0,295,82,26670,28091,33766,5,29,20,1,1,2,0,2,329,74,29987,28161,44282,0,-34,8,-3317,-8,-70,-10516,-1,-1,-2,0,13
EUW1_6882373414',3,32,16,2,0,0,0,5,1,434,102,31770,32812,30538,5,31,3,0,0,2,0,6,353,98,23073,27885,23365,1,81,4,8697,13,4927,7173,2,0,-2,0,-1
EUW1_6882362093',6,32,9,0,0,0,0,12,0,306,96,24503,27030,35717,6,28,9,1,0,1,0,1,320,83,24674,28395,28239,1,-14,13,-171,0,-1365,7478,-1,0,-1,0,11
EUW1_6882348245',6,31,19,1,0,2,0,10,1,381,117,34057,30116,36730,4,31,7,0,0,2,0,8,271,65,23284,24528,24519,1,110,52,10773,12,5588,12211,1,0,0,0,2
EUW1_6882337580',6,26,14,1,0,1,0,7,1,368,110,29105,29711,31260,1,30,8,0,0,0,0,4,394,93,26207,29747,30291,1,-26,17,2898,6,-36,969,1,0,1,0,3
EUW1_6882316453',3,29,13,1,0,1,0,6,0,362,116,29001,31457,35022,1,21,8,1,0,1,0,10,319,56,25127,26091,26753,1,43,60,3874,5,5366,8269,0,0,0,0,-4
EUW1_6876180530',6,32,11,0,0,0,0,5,1,396,72,27798,30817,25115,4,28,7,1,0,1,0,4,378,88,24615,28356,26922,0,18,-16,3183,4,2461,-1807,-1,0,-1,0,1
EUW1_6876106985',6,32,8,0,0,0,0,5,0,351,72,24287,28313,29846,5,36,10,1,0,1,0,2,377,94,26329,29830,30849,0,-26,-22,-2042,-2,-1517,-1003,-1,0,-1,0,3
EUW1_6876059534',4,31,16,2,1,1,0,8,0,394,94,30762,31572,34360,4,28,5,0,0,1,0,6,345,98,24250,27051,23170,1,49,-4,6512,11,4521,11190,2,1,0,0,2
EUW1_6876002128',4,26,11,0,1,1,0,8,1,378,98,28465,29637,23649,8,43,16,1,0,1,0,9,383,85,28430,31049,36094,0,-5,13,35,-5,-1412,-12445,-1,1,0,0,-1
EUW1_6875934330',4,25,13,1,0,1,0,6,1,379,100,28910,30593,29041,4,38,8,0,0,0,0,4,331,79,24050,26789,27721,1,48,21,4860,5,3804,1320,1,0,1,0,2
EUW1_6875865643',2,26,8,0,0,1,0,9,0,358,80,25974,28117,27053,9,29,19,2,0,2,0,2,356,73,30525,31295,33524,1,2,7,-4551,-11,-3178,-6471,-2,0,-1,0,7
EUW1_6869775604',1,32,7,0,0,0,0,13,0,321,75,24248,26610,26854,3,22,14,1,0,1,0,3,369,102,29630,31454,38805,0,-48,-27,-5382,-7,-4844,-11951,-1,0,-1,0,10
EUW1_6869702441',2,30,10,0,0,0,0,13,1,388,89,25979,29760,24946,5,226,4,1,1,2,0,2,364,86,24962,27436,21308,0,24,3,1017,6,2324,3638,-1,-1,-2,0,11
EUW1_6869645062',3,203,5,0,0,1,0,14,1,377,77,24600,29870,25816,2,28,9,2,0,1,0,3,396,110,29058,31095,29645,0,-19,-33,-4458,-4,-1225,-3829,-2,0,0,0,11
EUW1_6869600648',6,26,13,2,0,0,0,7,1,346,69,27202,29365,40259,4,39,9,0,0,0,0,3,368,82,25485,28887,28150,1,-22,-13,1717,4,478,12109,2,0,0,0,4
EUW1_6869570484',3,25,8,0,0,0,0,10,0,285,63,22971,24581,21516,7,39,23,2,1,2,0,1,371,111,34530,32122,41013,0,-86,-48,-11559,-15,-7541,-19497,-2,-1,-2,0,9
EUW1_6869517883',2,27,14,1,0,1,0,9,1,316,78,27274,28972,34685,2,28,8,1,0,1,0,3,348,92,25826,27066,28794,0,-32,-14,1448,6,1906,5891,0,0,0,0,6
EUW1_6868849307',1,25,7,0,0,0,0,14,1,342,79,25069,29968,28984,2,29,21,1,1,3,0,0,413,112,34868,35875,38579,0,-71,-33,-9799,-14,-5907,-9595,-1,-1,-3,0,14
EUW1_6868426940',0,25,19,1,1,2,0,5,0,386,126,35206,34106,44573,1,35,18,0,0,2,0,8,300,74,28350,29684,31067,0,86,52,6856,1,4422,13506,1,1,0,0,-3
EUW1_6879297284',6,55,18,1,0,1,0,13,1,315,73,29236,29618,38193,5,50,17,1,0,2,0,7,365,94,32020,30545,35611,0,-50,-21,-2784,1,-927,2582,0,0,-1,0,6
EUW1_6879291062',4,34,8,2,0,0,0,15,0,275,99,24499,24858,29851,5,29,19,0,0,4,0,2,364,107,32782,30765,41012,0,-89,-8,-8283,-11,-5907,-11161,2,0,-4,0,13
EUW1_6879265294',4,28,15,1,0,3,0,6,1,413,111,33690,31909,32888,2,19,11,1,0,1,0,10,337,79,25800,27067,21681,1,76,32,7890,4,4842,11207,0,0,2,0,-4
EUW1_6879249099',8,33,19,0,0,1,0,11,0,321,95,31210,27879,36323,3,31,24,2,0,2,0,4,340,89,33804,31834,42199,0,-19,6,-2594,-5,-3955,-5876,-2,0,-1,0,7
EUW1_6879235808',4,25,5,0,0,0,0,13,0,359,77,23115,28250,25094,1,24,15,2,0,3,0,1,425,133,32950,35157,35605,0,-66,-56,-9835,-10,-6907,-10511,-2,0,-3,0,12
EUW1_6879206140',2,24,11,0,0,0,0,15,0,346,90,27477,28809,36707,4,25,23,1,0,2,0,2,257,102,32967,29060,46114,0,89,-12,-5490,-12,-251,-9407,-1,0,-2,0,13
EUW1_6870288760',4,26,20,1,1,2,0,10,1,362,96,32350,31720,35947,3,30,6,0,0,0,0,9,304,91,24682,25698,27379,1,58,5,7668,14,6022,8568,1,1,2,0,1
EUW1_6870218692',6,27,13,0,0,0,0,6,0,365,76,27074,29075,31126,2,32,11,1,0,2,0,1,389,95,29471,32381,29245,0,-24,-19,-2397,2,-3306,1881,-1,0,-2,0,5
EUW1_6870162345',3,32,4,0,0,0,0,10,0,373,88,22643,29110,25157,7,263,14,2,0,1,0,0,401,116,30015,32401,27794,0,-28,-28,-7372,-10,-3291,-2637,-2,0,-1,0,10
EUW1_6868187665',2,40,5,0,0,0,0,12,0,329,93,23047,27198,31099,4,21,22,0,0,3,0,2,394,71,32244,34390,38760,0,-65,22,-9197,-17,-7192,-7661,0,0,-3,0,10
EUW1_6867772337',5,30,8,2,1,0,0,11,0,374,86,25377,29694,24247,6,31,6,0,0,1,0,0,375,119,25881,30222,26618,0,-1,-33,-504,2,-528,-2371,2,1,-1,0,11
EUW1_6867743237',3,22,5,0,1,0,0,6,1,363,90,24188,29508,21173,1,27,11,2,0,2,0,2,415,118,29058,32357,27897,0,-52,-28,-4870,-6,-2849,-6724,-2,1,-2,0,4
EUW1_6867371244',3,24,17,0,0,3,0,9,1,355,65,30575,30049,36607,2,26,12,1,0,1,0,5,323,86,27009,27958,35879,0,32,-21,3566,5,2091,728,-1,0,2,0,4
EUW1_6867308594',1,24,6,0,0,0,0,15,0,338,76,23814,26703,22640,7,29,25,1,1,3,0,4,416,104,35043,33973,42522,0,-78,-28,-11229,-19,-7270,-19882,-1,-1,-3,0,11
EUW1_6866786682',3,27,9,2,0,0,0,16,0,317,91,25721,29447,35129,1,97,15,0,0,3,0,0,411,94,30815,32521,37281,0,-94,-3,-5094,-6,-3074,-2152,2,0,-3,0,16
EUW1_6866298916',5,26,10,1,0,1,0,4,0,400,84,27136,30926,27473,4,34,9,0,0,0,0,7,347,103,25874,29417,26635,1,53,-19,1262,1,1509,838,1,0,1,0,-3
EUW1_6866277667',7,30,14,0,1,1,0,9,1,369,76,29644,28728,33183,8,37,16,2,0,0,0,5,330,102,28316,30252,29519,0,39,-26,1328,-2,-1524,3664,-2,1,1,0,4
EUW1_6865770327',3,31,10,0,0,0,0,12,1,343,89,26171,28784,23619,6,37,9,1,0,1,0,2,382,86,26184,29526,24035,0,-39,3,-13,1,-742,-416,-1,0,-1,0,10
EUW1_6865698170',4,30,12,2,0,1,0,8,1,344,68,26688,29537,23985,6,45,9,0,1,0,0,4,367,111,26459,30320,31387,0,-23,-43,229,3,-783,-7402,2,-1,1,0,4
EUW1_6864679717',2,37,9,0,0,1,0,11,0,350,106,27969,29419,27085,3,22,25,2,0,1,0,3,340,94,31826,33304,42060,0,10,12,-3857,-16,-3885,-14975,-2,0,0,0,8
EUW1_6881765752',2,24,6,1,0,0,0,9,0,315,108,24397,28671,29076,5,81,17,1,0,1,0,3,336,56,28271,27834,37970,0,-21,52,-3874,-11,837,-8894,0,0,-1,0,6
EUW1_6880716617',4,29,21,1,0,0,0,8,1,331,58,29991,29886,43296,2,266,14,1,0,1,0,5,350,123,27357,31380,30729,1,-19,-65,2634,7,-1494,12567,0,0,-1,0,3
EUW1_6880689859',2,26,13,1,0,0,0,9,0,366,77,27756,28462,25560,3,27,19,0,0,3,0,2,406,97,31989,33320,33617,0,-40,-20,-4233,-6,-4858,-8057,1,0,-3,0,7
EUW1_6877506870',3,54,8,0,0,0,0,16,0,364,82,25414,28421,27651,6,25,20,2,0,3,0,2,371,80,32547,31489,35322,0,-7,2,-7133,-12,-3068,-7671,-2,0,-3,0,14
EUW1_6874407445',3,28,16,0,1,0,0,12,1,338,89,29604,30168,30973,5,24,18,1,0,1,0,4,355,86,30631,30064,39052,1,-17,3,-1027,-2,104,-8079,-1,1,-1,0,8
EUW1_6874353292',3,36,10,1,0,0,0,13,0,353,97,26491,29276,27322,3,28,15,0,1,2,0,4,361,101,31217,30556,31048,0,-8,-4,-4726,-5,-1280,-3726,1,-1,-2,0,9
EUW1_6873056727',12,43,22,0,0,3,0,10,1,356,102,33676,32581,39048,8,34,14,1,0,1,0,7,349,55,28501,27299,36134,1,7,47,5175,8,5282,2914,-1,0,2,0,3
EUW1_6873009457',2,30,11,1,1,2,0,12,0,357,82,28446,28914,32788,5,23,12,0,0,1,0,3,360,101,27877,29314,22986,0,-3,-19,569,-1,-400,9802,1,1,1,0,9
EUW1_6872732214',3,26,11,0,0,1,0,8,0,371,90,27488,29325,24102,4,36,9,1,1,0,0,2,351,102,25962,29202,30388,1,20,-12,1526,2,123,-6286,-1,-1,1,0,6
EUW1_6872703498',3,22,14,1,0,0,0,3,1,357,64,27379,27563,30582,1,27,18,1,1,0,0,2,320,110,29288,31224,34708,0,37,-46,-1909,-4,-3661,-4126,0,-1,0,0,1
EUW1_6871989469',3,29,10,1,0,0,0,8,1,387,77,27219,29161,26005,0,42,11,1,0,2,0,2,364,96,26274,29751,27895,1,23,-19,945,-1,-590,-1890,0,0,-2,0,6
EUW1_6871921270',0,24,10,0,0,0,0,11,0,383,0,26472,26360,31980,3,24,22,1,1,3,0,4,377,116,32506,30524,32555,0,6,-116,-6034,-12,-4164,-575,-1,-1,-3,0,7
EUW1_6871833789',2,39,12,1,0,1,0,13,0,348,86,28201,27779,34546,5,24,7,0,1,1,0,3,320,81,24612,25989,24078,1,28,5,3589,5,1790,10468,1,-1,0,0,10
EUW1_6871774797',2,21,10,0,0,0,0,7,1,324,99,25937,28948,32216,4,44,6,2,0,1,0,2,354,82,23447,27658,23973,1,-30,17,2490,4,1290,8243,-2,0,-1,0,5
EUW1_6871734581',6,28,22,1,0,1,0,10,1,352,48,30429,30832,32382,2,29,9,0,0,1,0,5,317,88,24994,25379,31067,1,35,-40,5435,13,5453,1315,1,0,0,0,5
EUW1_6871651243',2,31,16,1,0,1,0,9,0,391,89,31033,32864,40598,4,32,12,1,0,0,0,5,339,98,27133,30090,31970,1,52,-9,3900,4,2774,8628,0,0,1,0,4
EUW1_6871574675',3,41,13,2,0,1,0,7,1,387,80,30029,32233,31556,5,26,9,0,0,3,0,9,359,94,25916,28740,33675,1,28,-14,4113,4,3493,-2119,2,0,-2,0,-2
EUW1_6868552519',4,83,16,1,0,0,0,6,0,359,72,28938,30584,36703,0,51,16,1,0,1,0,1,371,78,29396,29210,32552,0,-12,-6,-458,0,1374,4151,0,0,-1,0,5
EUW1_6868509899',7,24,6,2,0,0,0,12,1,371,90,24740,28099,24026,4,35,15,0,0,1,0,0,429,114,31933,34476,40287,0,-58,-24,-7193,-9,-6377,-16261,2,0,-1,0,12
EUW1_6868469989',3,37,2,1,0,0,0,8,0,371,81,22483,27992,17086,3,27,11,0,0,0,0,2,403,105,27418,31487,27590,0,-32,-24,-4935,-9,-3495,-10504,1,0,0,0,6
EUW1_6868311617',1,22,8,1,0,0,0,11,1,352,78,24643,27718,26888,6,27,18,1,0,2,0,4,379,81,30602,31999,32060,0,-27,-3,-5959,-10,-4281,-5172,0,0,-2,0,7
EUW1_6868249422',7,29,22,1,1,0,0,14,1,326,76,29746,29742,39075,1,24,14,0,0,2,0,5,346,84,28874,28523,41605,1,-20,-8,872,8,1219,-2530,1,1,-2,0,9
EUW1_6868172012',2,35,15,1,0,1,0,7,1,338,90,30688,28995,35554,7,31,21,0,0,1,0,6,291,86,28913,26477,38971,0,47,4,1775,-6,2518,-3417,1,0,0,0,1
EUW1_6868109190',6,39,12,1,0,1,0,10,0,339,62,26765,28116,34716,2,24,15,1,0,2,0,3,358,97,30687,28914,34602,0,-19,-35,-3922,-3,-798,114,0,0,-1,0,7
EUW1_6868064617',4,38,8,2,0,0,0,7,0,356,78,27376,28795,32265,1,25,10,0,0,1,0,4,347,112,24906,28886,25978,1,9,-34,2470,-2,-91,6287,2,0,-1,0,3
EUW1_6867940005',3,25,15,1,0,1,0,11,1,351,96,28719,30092,31592,5,27,11,0,0,0,0,2,348,100,27673,30356,29791,1,3,-4,1046,4,-264,1801,1,0,1,0,9
EUW1_6867896865',5,29,21,1,0,1,0,8,1,383,106,31939,31700,42867,4,29,10,0,0,2,0,9,325,45,25297,26640,31399,1,58,61,6642,11,5060,11468,1,0,-1,0,-1
EUW1_6867869803',7,54,23,1,0,1,0,9,1,352,92,31616,32019,40415,1,27,13,1,1,0,0,5,308,96,27825,29338,35175,1,44,-4,3791,10,2681,5240,0,-1,1,0,4
EUW1_6867836767',3,32,16,1,0,0,0,9,0,332,87,28889,28889,33421,3,30,12,1,0,0,0,4,403,95,28052,30679,30280,0,-71,-8,837,4,-1790,3141,0,0,0,0,5
EUW1_6867766680',3,24,13,0,0,0,0,13,1,353,80,28501,29243,35163,3,41,17,1,0,2,0,3,359,73,29953,29665,34053,1,-6,7,-1452,-4,-422,1110,-1,0,-2,0,10
EUW1_6867738972',4,29,5,0,1,0,0,8,0,388,110,24869,29812,19813,2,30,6,2,0,0,0,3,393,68,24833,29837,19837,0,-5,42,36,-1,-25,-24,-2,1,0,0,5
EUW1_6866972780',1,27,13,0,0,1,0,9,0,338,96,27180,28272,33059,4,32,10,1,0,1,0,3,353,92,25759,28105,34003,0,-15,4,1421,3,167,-944,-1,0,0,0,6
EUW1_6865247230',3,40,24,0,1,1,0,6,1,345,100,33169,31865,43998,8,34,9,2,0,0,0,7,331,104,25218,28200,31272,1,14,-4,7951,15,3665,12726,-2,1,1,0,-1
EUW1_6860820181',2,22,9,1,0,0,0,16,0,335,91,26190,29576,30764,1,25,17,1,0,1,0,3,358,87,29989,30938,34869,0,-23,4,-3799,-8,-1362,-4105,0,0,-1,0,13
EUW1_6881014052',10,36,10,0,0,0,0,12,0,378,67,26526,28667,27494,9,169,13,1,0,4,0,2,398,123,31463,31302,32550,0,-20,-56,-4937,-3,-2635,-5056,-1,0,-4,0,10
EUW1_6880983091',6,25,21,1,1,1,0,5,1,403,104,32375,33797,37879,3,34,9,0,0,0,0,4,356,92,26110,28967,28792,1,47,12,6265,12,4830,9087,1,1,1,0,1
EUW1_6880956685',2,22,4,1,0,0,0,6,0,408,102,24923,30736,28616,5,29,9,1,0,1,0,2,385,108,26835,31212,25292,1,23,-6,-1912,-5,-476,3324,0,0,-1,0,4
EUW1_6880920180',5,27,13,0,0,1,0,13,0,376,78,29457,30375,28550,4,157,17,2,0,2,0,7,396,96,32650,31396,34029,0,-20,-18,-3193,-4,-1021,-5479,-2,0,-1,0,6
EUW1_6880899754',7,31,16,1,0,1,0,6,1,396,86,31396,30397,30059,1,29,18,1,0,1,0,5,339,72,29348,29518,27624,0,57,14,2048,-2,879,2435,0,0,0,0,1
EUW1_6880133589',2,24,21,2,0,4,0,7,1,375,104,33816,32783,35941,1,26,7,0,0,1,0,10,352,104,25616,28394,28348,1,23,0,8200,14,4389,7593,2,0,3,0,-3
EUW1_6880088634',3,137,9,0,0,0,0,10,0,324,88,26273,28701,26661,2,37,22,2,0,1,0,2,397,84,32672,32021,38173,0,-73,4,-6399,-13,-3320,-11512,-2,0,-1,0,8
EUW1_6880038508',4,368,14,2,0,0,0,6,0,342,89,27957,26746,34794,2,32,13,0,0,1,0,4,307,99,26607,26625,36496,1,35,-10,1350,1,121,-1702,2,0,-1,0,2
EUW1_6879953286',8,50,10,1,0,0,0,6,1,365,84,25522,29768,31492,2,27,8,1,0,1,0,3,374,82,26158,28868,29142,1,-9,2,-636,2,900,2350,0,0,-1,0,3
EUW1_6879910936',2,25,14,0,0,0,0,14,0,299,78,27839,26784,36118,5,28,22,2,0,3,0,1,388,98,33509,32831,45429,0,-89,-20,-5670,-8,-6047,-9311,-2,0,-3,0,13
EUW1_6879725880',9,38,7,0,0,0,0,14,1,333,82,23236,27649,29341,7,80,17,2,0,3,0,0,399,104,31940,31494,36968,0,-66,-22,-8704,-10,-3845,-7627,-2,0,-3,0,14
EUW1_6879692157',4,28,18,2,0,3,0,4,1,383,134,34838,34725,37916,4,23,9,0,0,0,0,13,353,84,25042,28614,25091,1,30,50,9796,9,6111,12825,2,0,3,0,-9
EUW1_6879654794',2,141,15,0,0,1,0,10,1,368,99,29936,30369,29779,5,25,13,2,0,1,0,4,375,95,27736,28956,31785,1,-7,4,2200,2,1413,-2006,-2,0,0,0,6
EUW1_6879620610',3,21,19,2,0,1,0,7,0,344,100,30986,30092,32960,1,28,9,0,0,1,0,8,337,99,27527,28146,26905,1,7,1,3459,10,1946,6055,2,0,0,0,-1
EUW1_6879480969',2,22,8,0,0,0,0,13,0,343,84,24431,28408,24465,6,27,9,1,0,1,0,3,361,95,26937,29062,26108,0,-18,-11,-2506,-1,-654,-1643,-1,0,-1,0,10
EUW1_6879454307',2,30,4,0,0,0,0,8,0,368,87,24068,27963,25489,5,38,15,2,0,1,0,0,371,85,29572,30854,31543,0,-3,2,-5504,-11,-2891,-6054,-2,0,-1,0,8
EUW1_6879430327',1,26,22,0,1,2,0,11,1,344,66,31399,30828,36442,1,64,10,1,0,1,0,5,305,83,25548,27228,30164,1,39,-17,5851,12,3600,6278,-1,1,1,0,6
EUW1_6879123974',0,25,10,0,0,1,0,11,0,360,96,27518,28990,31772,0,31,20,2,0,2,0,6,397,91,32559,32904,42740,0,-37,5,-5041,-10,-3914,-10968,-2,0,-1,0,5
EUW1_6879088928',0,62,6,0,0,1,0,11,0,283,87,23493,26432,29794,5,31,19,1,0,1,0,2,365,100,31226,31918,45131,0,-82,-13,-7733,-13,-5486,-15337,-1,0,0,0,9
EUW1_6879643516',3,31,5,0,0,0,0,4,0,417,87,24862,30452,20929,2,27,4,2,1,0,0,4,357,111,23327,29208,19917,1,60,-24,1535,1,1244,1012,-2,-1,0,0,0
EUW1_6879581899',4,40,8,0,0,1,0,6,1,367,92,26274,29402,29310,6,29,15,2,0,1,0,5,377,80,29330,29181,31277,1,-10,12,-3056,-7,221,-1967,-2,0,0,0,1
EUW1_6879557940',5,24,14,2,1,0,0,6,1,357,88,26966,30206,27993,5,28,7,0,0,0,0,2,395,74,25180,27935,25223,1,-38,14,1786,7,2271,2770,2,1,0,0,4
EUW1_6868375306',2,43,11,1,0,0,0,10,1,359,71,26789,28545,31446,6,32,15,0,0,1,0,4,406,84,29735,30086,31359,1,-47,-13,-2946,-4,-1541,87,1,0,-1,0,6
EUW1_6867850839',1,23,9,2,0,3,0,13,1,335,95,28669,27445,34945,4,24,16,0,0,1,0,10,338,75,28990,27974,36036,1,-3,20,-321,-7,-529,-1091,2,0,2,0,3
EUW1_6867830994',5,28,18,1,1,4,0,5,1,435,121,36384,33474,38984,0,25,5,0,0,0,0,10,328,67,22744,26487,18974,1,107,54,13640,13,6987,20010,1,1,4,0,-5
EUW1_6867731779',4,30,16,0,0,0,0,10,0,345,81,28420,28270,44111,1,21,19,1,0,0,0,2,368,73,30996,32135,41760,0,-23,8,-2576,-3,-3865,2351,-1,0,0,0,8
EUW1_6862806584',4,33,20,0,0,0,0,11,1,358,67,31216,30132,43947,2,40,14,2,0,1,0,5,341,104,30118,29871,31251,0,17,-37,1098,6,261,12696,-2,0,-1,0,6
EUW1_6853781737',7,94,19,1,0,2,0,7,1,307,82,31539,29782,37322,3,27,14,1,0,1,0,5,363,89,28526,29105,34740,1,-56,-7,3013,5,677,2582,0,0,1,0,2
EUW1_6853733682',2,29,9,0,0,0,0,11,0,284,59,24350,24667,28123,6,37,20,1,0,1,0,0,335,121,32160,30227,34770,0,-51,-62,-7810,-11,-5560,-6647,-1,0,-1,0,11
EUW1_6853659526',2,30,14,0,0,2,0,6,1,355,84,31875,28979,37857,5,26,13,1,0,1,0,9,293,111,27176,28001,31352,0,62,-27,4699,1,978,6505,-1,0,1,0,-3
EUW1_6840780834',0,74,19,1,1,2,0,14,0,375,90,31484,32258,35985,5,36,11,1,0,1,0,3,341,89,28152,28977,31505,1,34,1,3332,8,3281,4480,0,1,1,0,11
EUW1_6840713684',3,22,25,1,0,1,0,6,1,330,80,33984,30392,42867,3,28,13,1,0,0,0,9,340,87,29004,28879,42256,1,-10,-7,4980,12,1513,611,0,0,1,0,-3
EUW1_6840683426',5,28,12,0,0,1,0,10,0,385,101,29715,29165,33951,1,41,20,1,0,2,0,8,328,98,31193,30387,30618,1,57,3,-1478,-8,-1222,3333,-1,0,-1,0,2
EUW1_6840663324',9,48,10,0,0,0,0,16,0,265,69,25467,25199,32884,5,29,32,1,0,7,0,1,392,111,41227,34390,52635,0,-127,-42,-15760,-22,-9191,-19751,-1,0,-7,0,15
EUW1_6840411371',5,60,19,1,0,2,0,13,1,385,103,34352,32131,35170,6,33,12,1,0,2,0,8,325,119,28848,30324,25923,1,60,-16,5504,7,1807,9247,0,0,0,0,5
EUW1_6839474589',2,65,9,0,0,1,0,12,0,355,84,27037,29112,30054,4,61,18,1,0,1,0,5,353,100,30556,31345,32226,0,2,-16,-3519,-9,-2233,-2172,-1,0,0,0,7
EUW1_6838505870',2,26,6,2,0,1,0,13,0,345,104,25081,29974,29576,8,100,6,0,1,1,0,0,363,92,26093,29766,31828,1,-18,12,-1012,0,208,-2252,2,-1,0,0,13
EUW1_6838453095',2,26,23,0,0,2,0,15,0,345,87,33681,31180,38747,3,23,11,2,0,1,0,8,348,80,27339,27087,36734,1,-3,7,6342,12,4093,2013,-2,0,1,0,7
EUW1_6838408898',3,36,17,1,0,0,0,4,0,389,86,30862,30073,35535,1,26,17,0,0,0,0,4,361,81,28708,31186,35382,1,28,5,2154,0,-1113,153,1,0,0,0,0
EUW1_6838376046',5,32,23,1,0,2,0,10,0,293,89,32659,29008,48376,5,67,23,1,0,2,0,12,311,94,32422,29174,50275,1,-18,-5,237,0,-166,-1899,0,0,0,0,-2
EUW1_6882551542',1,62,9,0,0,1,0,6,1,402,88,27470,30858,33378,2,26,9,1,0,0,0,6,391,63,24502,30442,29634,1,11,25,2968,0,416,3744,-1,0,1,0,0
EUW1_6883082815',2,24,17,2,0,0,0,16,0,326,79,28740,28197,39372,5,26,15,0,0,2,0,2,350,76,29799,30239,39696,1,-24,3,-1059,2,-2042,-324,2,0,-2,0,14
EUW1_6882920412',5,32,11,0,0,0,0,6,0,377,95,26330,29121,35086,5,43,20,1,0,0,0,1,389,88,30266,32885,40644,0,-12,7,-3936,-9,-3764,-5558,-1,0,0,0,5
EUW1_6882870152',3,21,9,0,0,0,0,8,0,339,76,25005,28241,29893,3,35,10,2,0,1,0,3,378,94,26864,30262,32839,0,-39,-18,-1859,-1,-2021,-2946,-2,0,-1,0,5
EUW1_6881074852',5,35,10,2,0,0,0,9,0,394,84,26413,29289,29559,2,28,4,0,0,1,0,3,369,81,24129,27748,24922,0,25,3,2284,6,1541,4637,2,0,-1,0,6
EUW1_6879823602',3,30,14,2,0,2,0,9,0,376,104,30382,31257,36402,3,30,11,0,0,0,0,8,395,75,27258,30968,26002,1,-19,29,3124,3,289,10400,2,0,2,0,1
EUW1_6879735013',0,23,16,1,0,0,0,8,0,348,73,28053,30462,37310,3,52,11,0,0,0,0,1,357,98,27207,28947,35999,1,-9,-25,846,5,1515,1311,1,0,0,0,7
EUW1_6879676095',0,30,16,2,0,1,0,10,0,355,90,30227,29895,45004,3,29,17,0,0,2,0,2,340,102,30903,29997,35493,1,15,-12,-676,-1,-102,9511,2,0,-1,0,8
EUW1_6879549259',4,24,9,2,0,1,0,7,1,365,100,27101,29950,33925,1,88,6,0,0,0,0,5,379,96,24693,28935,25444,0,-14,4,2408,3,1015,8481,2,0,1,0,2
EUW1_6879499122',1,30,11,1,0,1,0,9,0,345,100,27691,29401,34515,2,34,12,1,0,1,0,5,388,75,28695,30271,33411,0,-43,25,-1004,-1,-870,1104,0,0,0,0,4
EUW1_6878831944',2,60,19,0,0,2,0,10,0,326,58,30833,29813,46576,0,26,19,1,0,2,0,6,328,90,31104,30357,34114,0,-2,-32,-271,0,-544,12462,-1,0,0,0,4
EUW1_6878598687',5,32,11,0,0,0,0,11,1,391,98,27734,29139,27235,2,23,15,2,1,3,0,1,374,74,28616,30209,28595,0,17,24,-882,-4,-1070,-1360,-2,-1,-3,0,10
EUW1_6878445277',4,22,15,1,1,0,0,9,0,340,95,28101,30653,42552,3,27,13,0,0,0,0,4,321,96,26675,29717,30478,1,19,-1,1426,2,936,12074,1,1,0,0,5
EUW1_6882132059',2,28,14,0,0,1,0,2,1,374,100,30367,30403,33755,4,35,14,2,1,1,0,9,300,116,25862,28453,30635,1,74,-16,4505,0,1950,3120,-2,-1,0,0,-7
EUW1_6882089075',5,28,11,1,0,0,0,7,1,336,76,26238,25610,32113,4,32,19,1,0,1,0,3,314,96,29109,28586,38897,1,22,-20,-2871,-8,-2976,-6784,0,0,-1,0,4
EUW1_6882038465',4,20,6,0,0,0,0,15,0,347,94,24974,27197,22813,7,29,20,1,0,2,0,3,377,98,32090,31290,32244,0,-30,-4,-7116,-14,-4093,-9431,-1,0,-2,0,12
EUW1_6881986710',2,24,14,1,0,0,0,5,1,407,100,29607,31133,32875,3,23,9,1,0,1,0,4,371,96,25442,28742,27211,1,36,4,4165,5,2391,5664,0,0,-1,0,1
EUW1_6881928000',4,31,6,0,0,0,0,10,0,386,79,24812,30192,25416,3,32,21,1,0,2,0,3,392,86,32699,34086,40509,0,-6,-7,-7887,-15,-3894,-15093,-1,0,-2,0,7
EUW1_6880255622',2,41,13,0,1,1,0,12,1,330,84,27150,28739,35055,4,25,12,2,0,1,0,0,395,83,28714,30501,33469,0,-65,1,-1564,1,-1762,1586,-2,1,0,0,12
EUW1_6880188485',5,26,14,2,0,0,0,12,1,388,90,29676,30847,33034,3,55,16,0,0,3,0,8,345,94,29951,30487,34735,1,43,-4,-275,-2,360,-1701,2,0,-3,0,4
EUW1_6880126676',3,32,7,0,0,0,0,11,0,368,104,26095,29118,27756,4,47,10,2,0,2,0,2,396,91,28440,30007,31458,0,-28,13,-2345,-3,-889,-3702,-2,0,-2,0,9
EUW1_6880076333',0,143,21,1,0,3,0,3,1,407,84,33391,33957,39227,3,22,9,0,0,0,0,11,300,80,25248,27809,31207,1,107,4,8143,12,6148,8020,1,0,3,0,-8
EUW1_6879559397',3,38,12,0,0,0,0,17,1,381,66,28482,29318,27333,5,140,12,2,0,4,0,4,352,64,27627,27489,33482,0,29,2,855,0,1829,-6149,-2,0,-4,0,13
EUW1_6879486855',4,26,13,1,0,0,0,8,1,368,76,27796,28982,39619,4,44,15,0,0,0,0,2,348,76,28298,29519,38683,1,20,0,-502,-2,-537,936,1,0,0,0,6
EUW1_6878952804',2,23,12,1,0,0,0,16,0,264,87,25210,24636,34899,4,56,26,0,1,5,0,0,371,65,37466,30942,51985,0,-107,22,-12256,-14,-6306,-17086,1,-1,-5,0,16
EUW1_6878880010',5,29,9,0,0,0,0,8,0,351,95,25538,29456,37265,9,34,15,1,0,0,0,1,400,80,28939,31540,35509,0,-49,15,-3401,-6,-2084,1756,-1,0,0,0,7
EUW1_6878834720',3,22,17,1,0,1,0,12,0,369,61,30972,31612,38384,1,25,14,1,0,2,0,4,406,82,29035,31976,32891,1,-37,-21,1937,3,-364,5493,0,0,-1,0,8
EUW1_6877769527',1,26,21,0,0,1,0,5,1,338,77,31215,29849,39124,6,32,21,1,0,0,0,6,319,90,28979,28306,39239,1,19,-13,2236,0,1543,-115,-1,0,1,0,-1
EUW1_6877710453',6,39,16,1,0,1,0,10,0,418,94,29745,31671,36792,4,28,6,1,0,1,0,4,346,98,25456,27572,26810,1,72,-4,4289,10,4099,9982,0,0,0,0,6
EUW1_6877657676',3,24,5,1,0,0,0,11,0,378,98,23919,28733,22807,6,35,7,1,0,1,0,0,380,94,26135,28498,29611,0,-2,4,-2216,-2,235,-6804,0,0,-1,0,11
EUW1_6877615819',4,36,6,0,0,0,0,9,0,379,105,25232,28625,21427,5,25,12,2,1,1,0,6,423,85,28557,33602,29768,0,-44,20,-3325,-6,-4977,-8341,-2,-1,-1,0,3
EUW1_6877565596',7,29,11,2,0,1,0,4,1,379,90,27587,28688,28743,1,56,7,0,0,0,0,5,316,79,24250,26670,21908,1,63,11,3337,4,2018,6835,2,0,1,0,-1
EUW1_6882629603',6,31,11,1,1,0,0,8,1,356,90,27857,30333,28465,5,30,10,1,0,2,0,3,394,98,27516,31102,26076,1,-38,-8,341,1,-769,2389,0,1,-2,0,5
EUW1_6882597743',10,34,11,0,1,0,0,5,1,405,87,28096,30185,26232,6,84,11,2,0,0,0,2,395,78,26534,29435,37230,1,10,9,1562,0,750,-10998,-2,1,0,0,3
EUW1_6882566789',7,28,9,1,0,0,0,4,1,401,94,26999,30615,28413,5,166,9,0,0,0,0,3,366,93,26708,28687,26611,1,35,1,291,0,1928,1802,1,0,0,0,1
EUW1_6879306069',6,29,11,0,0,0,0,9,0,308,94,27138,29316,26752,6,162,20,1,0,1,0,3,343,87,30597,31069,41094,0,-35,7,-3459,-9,-1753,-14342,-1,0,-1,0,6
EUW1_6879199588',8,73,10,1,0,1,0,8,1,347,76,27343,27619,27218,6,159,11,0,0,1,0,5,355,83,27099,30225,34974,0,-8,-7,244,-1,-2606,-7756,1,0,0,0,3
EUW1_6878349893',5,38,19,1,1,3,0,7,1,388,64,31715,30966,40158,7,32,9,0,0,1,0,9,325,104,25321,29824,23017,1,63,-40,6394,10,1142,17141,1,1,2,0,-2
EUW1_6878303829',2,26,11,1,1,0,0,8,0,371,100,26836,31294,35152,4,30,7,1,0,0,0,2,372,107,25574,30632,26721,0,-1,-7,1262,4,662,8431,0,1,0,0,6
EUW1_6878266494',5,34,9,0,0,0,0,9,0,386,112,27411,32201,31623,6,30,11,2,0,0,0,5,376,92,26753,29461,31329,0,10,20,658,-2,2740,294,-2,0,0,0,4
EUW1_6883157430',3,18,23,2,1,3,0,5,1,366,94,35952,32760,42162,4,29,9,0,0,0,0,8,304,71,24704,26540,27609,1,62,23,11248,14,6220,14553,2,1,3,0,-3
EUW1_6883117143',5,47,13,0,0,0,0,14,0,302,83,25769,27061,32469,8,33,23,1,1,3,0,3,343,95,33648,30484,43038,0,-41,-12,-7879,-10,-3423,-10569,-1,-1,-3,0,11
EUW1_6883065797',1,26,10,0,0,1,0,15,1,310,75,25949,27085,29768,2,27,22,2,0,2,0,3,358,68,32055,30707,44808,0,-48,7,-6106,-12,-3622,-15040,-2,0,-1,0,12
EUW1_6883007964',3,28,15,0,0,1,0,9,1,353,80,28079,28765,38180,9,30,6,0,0,0,0,5,330,52,23481,25484,30255,1,23,28,4598,9,3281,7925,0,0,1,0,4
EUW1_6882964566',3,28,10,1,0,1,0,8,1,337,90,26266,29456,26083,2,27,8,1,1,0,0,1,385,112,26325,30276,27827,1,-48,-22,-59,2,-820,-1744,0,-1,1,0,7
EUW1_6882908206',4,39,25,1,1,1,0,6,0,345,102,33043,31848,44070,4,31,15,0,0,0,0,6,322,56,29086,27889,34051,1,23,46,3957,10,3959,10019,1,1,1,0,0
EUW1_6882863218',2,42,19,0,0,2,0,11,1,360,80,31735,31078,40828,1,26,17,1,0,0,0,5,343,79,30033,30349,39016,1,17,1,1702,2,729,1812,-1,0,2,0,6
EUW1_6882462184',4,29,6,1,0,1,0,5,1,405,104,26599,30089,24808,6,34,5,1,0,0,0,6,375,99,23505,29774,23323,0,30,5,3094,1,315,1485,0,0,1,0,-1
EUW1_6881575121',7,29,13,0,0,0,0,9,0,301,58,25833,25863,36331,4,38,13,2,0,2,0,1,376,101,27927,28321,40315,0,-75,-43,-2094,0,-2458,-3984,-2,0,-2,0,8
EUW1_6878676796',7,35,9,2,0,1,0,8,0,409,126,28462,32899,27224,8,80,8,0,1,1,0,4,362,102,25904,29070,22755,1,47,24,2558,1,3829,4469,2,-1,0,0,4
EUW1_6878564407',6,27,7,0,1,0,0,14,0,369,77,26340,29380,25731,5,27,13,1,0,2,0,6,374,94,28829,29785,34288,1,-5,-17,-2489,-6,-405,-8557,-1,1,-2,0,8
EUW1_6878519394',5,37,14,0,0,1,0,12,1,344,85,29573,27201,37233,4,35,22,1,0,1,0,4,341,96,31719,30976,40655,0,3,-11,-2146,-8,-3775,-3422,-1,0,0,0,8
EUW1_6875895373',1,19,7,1,0,1,0,10,0,380,95,25915,30431,27618,3,32,6,1,1,0,0,5,396,82,25354,30320,26172,1,-16,13,561,1,111,1446,0,-1,1,0,5
EUW1_6875847554',11,38,13,1,0,1,0,9,1,358,78,28559,28458,33170,3,31,8,0,0,1,0,6,338,95,26912,26852,36011,1,20,-17,1647,5,1606,-2841,1,0,0,0,3
EUW1_6875186480',4,28,17,1,0,2,0,5,0,383,111,31462,32816,32011,1,25,10,1,0,0,0,4,321,88,24601,27865,25984,1,62,23,6861,7,4951,6027,0,0,2,0,1
EUW1_6875160090',4,325,21,2,0,2,0,8,1,340,73,32048,30480,34253,3,29,16,0,0,1,0,12,348,94,30114,30353,41739,1,-8,-21,1934,5,127,-7486,2,0,1,0,-4
EUW1_6875137982',3,41,21,1,0,1,0,13,1,348,113,31378,32464,35447,3,326,15,1,1,2,0,6,345,82,30202,30497,36031,1,3,31,1176,6,1967,-584,0,-1,-1,0,7
EUW1_6874475055',1,26,9,0,0,1,0,10,0,345,87,26346,28154,26365,1,20,20,2,0,3,0,2,360,103,32020,32425,32696,0,-15,-16,-5674,-11,-4271,-6331,-2,0,-2,0,8
EUW1_6878149808',6,28,9,0,0,0,0,10,0,398,78,25135,29981,28709,6,31,12,2,0,1,0,1,376,90,28068,30213,30234,0,22,-12,-2933,-3,-232,-1525,-2,0,-1,0,9
EUW1_6878101361',8,29,20,1,1,2,0,6,1,348,106,32537,31222,42580,1,24,14,0,0,1,0,10,334,70,27335,29733,32098,1,14,36,5202,6,1489,10482,1,1,1,0,-4
EUW1_6877999566',3,29,10,1,0,1,0,10,0,367,92,27750,28204,21068,4,31,7,1,0,1,0,7,343,88,24378,25904,20380,1,24,4,3372,3,2300,688,0,0,0,0,3
EUW1_6877965141',11,33,12,0,0,2,0,3,1,390,88,29335,30971,33839,5,23,10,2,0,0,0,7,359,89,25726,29866,34590,1,31,-1,3609,2,1105,-751,-2,0,2,0,-4
EUW1_6877421744',5,35,10,1,0,1,0,6,0,337,84,26105,27443,35732,8,30,15,0,0,0,0,5,374,67,28199,28926,37733,1,-37,17,-2094,-5,-1483,-2001,1,0,1,0,1
EUW1_6876655965',6,30,8,0,1,1,0,3,0,356,76,26308,29351,32277,3,38,8,1,0,0,0,5,356,103,24670,29516,31015,1,0,-27,1638,0,-165,1262,-1,1,1,0,-2
EUW1_6875974936',1,34,9,0,0,0,0,13,1,363,77,25640,28770,28261,2,36,17,1,0,1,0,1,373,108,31992,31538,40624,0,-10,-31,-6352,-8,-2768,-12363,-1,0,-1,0,12
EUW1_6875809854',3,26,25,2,0,3,0,4,1,396,96,35161,32443,39531,0,21,8,0,0,1,0,10,295,76,24757,27102,26357,1,101,20,10404,17,5341,13174,2,0,2,0,-6
EUW1_6874500754',4,20,12,2,0,0,0,11,1,356,90,27604,28719,32494,1,34,18,0,0,2,0,1,385,118,32072,31969,41569,0,-29,-28,-4468,-6,-3250,-9075,2,0,-2,0,10
EUW1_6874081489',3,43,7,2,0,0,0,9,0,408,113,27117,30341,19790,9,33,11,0,0,0,0,4,399,82,26766,29416,21538,1,9,31,351,-4,925,-1748,2,0,0,0,5
EUW1_6873845481',4,28,9,0,0,0,0,12,0,389,112,26793,30830,28361,8,31,14,2,0,2,0,4,392,86,30226,32342,26819,0,-3,26,-3433,-5,-1512,1542,-2,0,-2,0,8
EUW1_6873798885',4,19,12,1,0,1,0,10,1,367,82,28133,30169,31720,5,31,12,1,0,1,0,7,369,89,26945,31283,31065,1,-2,-7,1188,0,-1114,655,0,0,0,0,3
EUW1_6873778199',4,24,13,1,1,1,0,7,1,364,90,27769,29720,31330,4,28,9,1,0,0,0,3,345,98,25401,27309,29676,1,19,-8,2368,4,2411,1654,0,1,1,0,4
EUW1_6873280358',4,35,16,2,0,0,0,8,0,368,76,29007,29919,33825,8,36,14,0,0,2,0,5,317,86,27306,26292,32804,1,51,-10,1701,2,3627,1021,2,0,-2,0,3
EUW1_6873089543',4,29,4,1,0,0,0,5,0,417,85,24262,28620,28699,4,25,8,1,0,0,0,3,402,98,26446,29836,26650,1,15,-13,-2184,-4,-1216,2049,0,0,0,0,2
EUW1_6872996758',5,34,12,0,0,1,0,6,0,397,111,29279,32527,32346,7,26,7,1,0,0,0,4,345,88,23538,28670,29020,1,52,23,5741,5,3857,3326,-1,0,1,0,2
EUW1_6871982568',0,26,7,0,0,0,0,9,0,324,86,25227,28276,34655,0,25,20,1,0,1,0,2,370,66,30244,30568,38327,0,-46,20,-5017,-13,-2292,-3672,-1,0,-1,0,7
EUW1_6871500039',5,27,15,0,0,0,0,5,1,372,78,27797,29330,36319,4,34,12,2,0,0,0,3,331,96,25982,30328,36168,1,41,-18,1815,3,-998,151,-2,0,0,0,2
EUW1_6883724592',1,26,11,2,0,1,0,8,1,362,102,27927,31575,28417,5,30,9,0,0,0,0,5,358,94,25971,30895,24890,1,4,8,1956,2,680,3527,2,0,1,0,3
EUW1_6883713703',6,27,11,0,0,0,0,12,0,367,54,26209,28594,28436,3,33,13,1,0,1,0,3,397,67,28021,30367,32310,0,-30,-13,-1812,-2,-1773,-3874,-1,0,-1,0,9
EUW1_6883254500',4,40,18,1,0,1,0,6,1,382,94,31105,32044,31148,0,29,7,1,0,0,0,7,394,86,26286,29025,32306,1,-12,8,4819,11,3019,-1158,0,0,1,0,-1
EUW1_6883079744',2,19,28,2,0,2,0,3,0,378,119,34318,33779,44240,1,18,9,0,0,0,0,9,345,48,25066,27129,29907,1,33,71,9252,19,6650,14333,2,0,2,0,-6
EUW1_6882898721',2,21,18,1,0,0,0,7,1,363,78,29638,29490,37398,2,26,9,0,0,0,0,5,363,97,26735,28857,26264,1,0,-19,2903,9,633,11134,1,0,0,0,2
EUW1_6882708794',4,25,12,1,0,0,0,7,0,349,82,26420,29355,26134,5,20,11,0,0,1,0,0,385,74,27101,28539,32674,1,-36,8,-681,1,816,-6540,1,0,-1,0,7
EUW1_6882616284',4,26,4,0,0,1,0,4,0,342,72,23403,28562,30189,3,26,15,2,0,0,0,4,375,79,27229,31938,37125,0,-33,-7,-3826,-11,-3376,-6936,-2,0,1,0,0
EUW1_6882576167',4,38,7,1,0,0,0,8,0,381,81,25823,28500,31097,5,33,14,0,0,0,0,4,368,84,29364,29803,32990,1,13,-3,-3541,-7,-1303,-1893,1,0,0,0,4
EUW1_6882544323',5,140,16,2,1,1,0,4,0,366,108,30082,31515,35164,4,33,10,0,0,0,0,3,345,69,25499,27786,29889,1,21,39,4583,6,3729,5275,2,1,1,0,1
EUW1_6882507296',1,19,11,0,0,1,0,7,1,347,76,26909,30944,32488,6,48,20,1,0,0,0,7,349,96,30070,32498,31077,1,-2,-20,-3161,-9,-1554,1411,-1,0,1,0,0
EUW1_6882393043',5,25,9,1,0,2,0,9,0,361,80,27340,29543,29416,1,27,11,0,0,0,0,5,355,92,25615,29099,33884,1,6,-12,1725,-2,444,-4468,1,0,2,0,4
EUW1_6882381698',2,20,5,1,0,0,0,9,1,338,77,22976,26570,19117,5,25,13,1,1,1,0,3,408,105,29582,31624,29421,0,-70,-28,-6606,-8,-5054,-10304,0,-1,-1,0,6
EUW1_6881908846',6,30,5,0,1,0,0,10,0,402,114,25678,31228,17581,5,33,8,2,0,1,0,2,406,105,27625,29890,29245,1,-4,9,-1947,-3,1338,-11664,-2,1,-1,0,8
EUW1_6881557616',6,29,10,0,0,0,0,12,1,353,102,26827,28170,26503,4,26,17,1,0,2,0,4,351,114,30691,30542,34958,0,2,-12,-3864,-7,-2372,-8455,-1,0,-2,0,8
EUW1_6881503901',5,32,12,0,0,1,0,7,0,360,108,28770,30273,29958,5,33,14,1,0,1,0,6,379,84,28892,30389,35273,1,-19,24,-122,-2,-116,-5315,-1,0,0,0,1
EUW1_6881252772',1,30,13,1,0,1,0,5,0,371,88,27794,30253,31319,5,43,15,1,0,0,0,3,332,92,27614,29860,27754,0,39,-4,180,-2,393,3565,0,0,1,0,2
EUW1_6881208127',0,24,7,0,0,1,0,13,1,306,77,24291,25809,21920,7,29,20,1,0,3,0,5,389,86,33636,30337,40974,0,-83,-9,-9345,-13,-4528,-19054,-1,0,-2,0,8
EUW1_6881170420',3,26,11,1,0,2,0,7,1,392,119,28448,30896,32044,2,26,6,1,1,1,0,3,386,88,25834,29091,24529,1,6,31,2614,5,1805,7515,0,-1,1,0,4
EUW1_6882501679',4,28,15,1,1,3,0,7,1,347,100,31442,29858,38409,3,40,12,1,0,0,0,7,345,84,26738,28054,29816,1,2,16,4704,3,1804,8593,0,1,3,0,0
EUW1_6882488486',2,25,6,0,0,0,0,11,0,362,89,24275,29393,21616,5,43,15,2,1,2,0,1,413,102,30842,34521,27891,0,-51,-13,-6567,-9,-5128,-6275,-2,-1,-2,0,10
EUW1_6882425818',4,42,11,0,1,0,0,6,1,369,112,27595,32629,33424,2,42,5,2,0,2,0,1,366,92,25245,29990,25627,0,3,20,2350,6,2639,7797,-2,1,-2,0,5
EUW1_6882399151',1,39,7,0,0,0,0,4,1,381,85,24645,29750,20642,10,35,8,1,0,0,0,3,389,86,25332,28384,22720,0,-8,-1,-687,-1,1366,-2078,-1,0,0,0,1
EUW1_6882388120',4,29,15,0,0,0,0,7,1,332,80,27599,28588,26026,1,27,15,2,0,0,0,2,345,84,27881,30197,39823,0,-13,-4,-282,0,-1609,-13797,-2,0,0,0,5
EUW1_6882369747',5,29,8,0,0,0,0,4,1,378,90,25032,29755,26486,3,37,6,1,0,0,0,4,383,90,24580,29471,25815,1,-5,0,452,2,284,671,-1,0,0,0,0
EUW1_6876476091',4,25,6,1,0,0,0,9,1,378,88,24906,28304,25467,6,51,11,0,0,2,0,2,369,107,28288,31558,28718,0,9,-19,-3382,-5,-3254,-3251,1,0,-2,0,7
EUW1_6876466270',1,21,3,0,0,0,0,14,0,329,75,21881,24716,20447,5,31,15,2,0,3,0,0,370,95,30654,29827,35858,0,-41,-20,-8773,-12,-5111,-15411,-2,0,-3,0,14
EUW1_6876455358',4,64,14,1,0,1,0,13,0,372,108,28286,32854,31661,2,197,12,1,0,1,0,6,394,84,29723,29925,32033,0,-22,24,-1437,2,2929,-372,0,0,0,0,7
EUW1_6875152531',3,22,10,0,0,1,0,8,0,353,103,26842,29751,21545,8,56,12,2,0,0,0,3,344,78,26494,28615,33949,1,9,25,348,-2,1136,-12404,-2,0,1,0,5
EUW1_6875136486',3,25,8,0,0,0,0,12,0,328,82,24910,27074,19788,2,25,13,2,0,1,0,3,416,98,29859,30350,23695,0,-88,-16,-4949,-5,-3276,-3907,-2,0,-1,0,9
EUW1_6875106299',0,24,10,1,0,0,0,8,1,411,86,26387,32267,25109,2,24,7,0,0,1,0,3,361,104,26033,29120,25614,1,50,-18,354,3,3147,-505,1,0,-1,0,5
EUW1_6875104677',5,30,23,2,0,0,0,10,1,280,90,30253,28897,44066,4,25,15,0,0,2,0,2,377,74,30047,30211,42359,1,-97,16,206,8,-1314,1707,2,0,-2,0,8
EUW1_6875094468',3,30,20,1,0,3,0,15,1,380,100,33694,31489,40700,4,26,18,0,0,1,0,9,335,96,30851,30233,33235,1,45,4,2843,2,1256,7465,1,0,2,0,6
EUW1_6873777020',2,22,19,2,0,0,0,9,1,312,106,29327,31073,39131,2,22,17,0,0,0,0,4,336,65,28913,28766,35879,1,-24,41,414,2,2307,3252,2,0,0,0,5
EUW1_6873768883',2,32,10,0,0,0,0,8,0,308,75,25942,26553,28157,7,32,12,1,0,1,0,4,377,132,29600,30758,35547,0,-69,-57,-3658,-2,-4205,-7390,-1,0,-1,0,4
EUW1_6873754090',7,33,17,0,0,0,0,12,0,352,96,28849,30605,35402,4,115,20,2,0,3,0,4,347,90,32581,31490,36624,0,5,6,-3732,-3,-885,-1222,-2,0,-3,0,8
EUW1_6873756509',3,39,6,1,0,1,0,9,1,361,84,25458,26357,27733,2,38,10,0,1,1,0,4,380,86,26451,30522,24640,0,-19,-2,-993,-4,-4165,3093,1,-1,0,0,5
EUW1_6873737416',3,25,16,2,0,2,0,7,1,378,114,30711,32284,32536,4,33,7,0,1,0,0,8,309,82,24919,26721,22408,1,69,32,5792,9,5563,10128,2,-1,2,0,-1
EUW1_6873736055',6,137,7,1,0,1,0,10,0,320,80,24877,26216,28410,3,26,17,1,0,1,0,6,393,103,31565,31184,34516,0,-73,-23,-6688,-10,-4968,-6106,0,0,0,0,4
EUW1_6872360568',4,24,20,1,1,0,0,10,0,318,84,30208,30050,39099,3,19,12,1,0,1,0,1,330,88,27668,28304,31752,1,-12,-4,2540,8,1746,7347,0,1,-1,0,9
EUW1_6872347744',5,87,13,0,0,1,0,6,1,323,99,28019,30185,30634,2,49,17,2,0,1,0,5,369,76,29296,30379,36423,1,-46,23,-1277,-4,-194,-5789,-2,0,0,0,1
EUW1_6869504342',7,34,8,0,0,0,0,12,0,375,80,25911,29789,23958,2,23,10,1,0,1,0,1,369,87,26550,29793,21577,1,6,-7,-639,-2,-4,2381,-1,0,-1,0,11
EUW1_6883171391',4,54,22,1,0,2,0,9,0,350,84,33781,31718,42648,3,26,12,1,0,0,0,6,296,72,26031,27617,40660,1,54,12,7750,10,4101,1988,0,0,2,0,3
EUW1_6882940489',5,28,18,1,1,0,0,11,1,357,86,29246,30932,38585,1,29,13,0,0,1,0,2,383,86,29873,30483,37012,0,-26,0,-627,5,449,1573,1,1,-1,0,9
EUW1_6882893658',2,23,18,0,0,2,0,8,0,385,74,32494,32053,33719,6,28,12,2,0,1,0,7,348,94,26879,29778,32999,1,37,-20,5615,6,2275,720,-2,0,1,0,1
EUW1_6882843451',6,58,16,0,0,1,0,10,0,370,74,29549,29487,38203,5,30,14,2,0,1,0,4,358,100,28217,29366,28739,1,12,-26,1332,2,121,9464,-2,0,0,0,6
EUW1_6882793100',2,23,16,0,0,1,0,12,0,321,123,28905,32177,34384,2,53,11,1,1,1,0,4,337,87,28389,29473,30921,1,-16,36,516,5,2704,3463,-1,-1,0,0,8
EUW1_6881422495',3,21,3,0,0,0,0,13,0,319,100,22363,25658,20639,7,52,21,1,0,2,0,3,310,96,30638,30983,34582,0,9,4,-8275,-18,-5325,-13943,-1,0,-2,0,10
EUW1_6880946660',4,23,13,0,0,0,0,10,1,324,100,28425,30092,29862,4,33,11,2,0,2,0,3,382,80,28791,29863,35319,0,-58,20,-366,2,229,-5457,-2,0,-2,0,7
EUW1_6877154269',1,20,16,0,0,0,0,9,0,314,76,28296,28564,36946,3,109,17,2,0,0,0,1,334,76,29791,30286,35509,0,-20,0,-1495,-1,-1722,1437,-2,0,0,0,8
EUW1_6876842045',2,25,10,0,0,2,0,10,1,369,96,28121,30544,33077,1,23,12,2,0,0,0,6,340,115,27210,30576,27607,1,29,-19,911,-2,-32,5470,-2,0,2,0,4
EUW1_6876789022',3,22,14,0,1,0,0,13,1,375,71,28547,31701,38162,3,27,14,1,0,1,0,1,363,98,29572,30428,30705,1,12,-27,-1025,0,1273,7457,-1,1,-1,0,12
EUW1_6876728866',5,23,7,1,0,0,0,14,1,340,72,24426,28086,25359,3,92,20,1,1,3,0,3,402,96,33569,33712,41653,0,-62,-24,-9143,-13,-5626,-16294,0,-1,-3,0,11
EUW1_6876686270',4,23,17,1,1,1,0,9,1,366,100,31336,31861,44887,1,50,10,0,0,1,0,9,326,78,26460,28903,27768,1,40,22,4876,7,2958,17119,1,1,0,0,0
EUW1_6876660662',5,28,17,1,0,2,0,4,1,408,98,31826,30650,29942,2,22,6,1,0,0,0,8,385,98,25119,28681,22820,1,23,0,6707,11,1969,7122,0,0,2,0,-4
EUW1_6870856146',4,27,10,0,0,1,0,11,0,333,70,25758,28244,28298,1,47,8,2,0,2,0,4,357,93,26710,30233,26274,0,-24,-23,-952,2,-1989,2024,-2,0,-1,0,7
EUW1_6870832899',4,32,7,0,0,2,0,12,0,377,84,26208,28020,32200,3,30,15,2,1,0,0,3,307,88,26258,29192,27592,1,70,-4,-50,-8,-1172,4608,-2,-1,2,0,9
EUW1_6870793381',4,27,13,2,0,1,0,6,0,338,84,28233,29029,29823,3,30,14,0,0,1,0,4,338,72,27844,28939,28782,1,0,12,389,-1,90,1041,2,0,0,0,2
EUW1_6870733359',4,34,5,1,0,0,0,10,0,303,81,22804,25586,29171,2,20,13,1,0,2,0,1,401,88,28365,31157,34483,1,-98,-7,-5561,-8,-5571,-5312,0,0,-2,0,9
EUW1_6870429474',5,25,18,0,1,1,0,8,0,358,87,29636,32376,36448,2,25,11,2,0,0,0,7,341,80,25592,27126,34784,1,17,7,4044,7,5250,1664,-2,1,1,0,1
EUW1_6870357932',0,26,15,0,0,0,0,15,0,337,69,29062,29649,35104,4,100,25,2,0,3,0,2,352,92,34939,32305,47247,0,-15,-23,-5877,-10,-2656,-12143,-2,0,-3,0,13
EUW1_6870293928',3,29,19,2,0,2,0,10,0,325,85,30490,28932,39001,2,32,21,0,0,2,0,9,370,78,33074,31991,48266,1,-45,7,-2584,-2,-3059,-9265,2,0,0,0,1
EUW1_6870223180',3,141,4,0,0,0,0,8,0,361,92,24111,28546,23850,3,20,16,2,1,1,0,6,369,84,28662,31277,32538,1,-8,8,-4551,-12,-2731,-8688,-2,-1,-1,0,2
EUW1_6869963770',11,45,21,1,0,1,0,14,1,347,82,29590,29602,44436,4,28,6,0,0,1,0,4,347,67,24673,25316,28705,1,0,15,4917,15,4286,15731,1,0,0,0,10
EUW1_6869892223',5,25,8,0,0,0,0,11,0,338,94,24275,28067,23698,3,27,17,1,0,2,0,0,395,92,31360,32493,27922,0,-57,2,-7085,-9,-4426,-4224,-1,0,-2,0,11
EUW1_6869830286',10,31,11,1,0,0,0,9,1,330,86,26203,27771,26874,2,21,17,0,0,1,0,2,358,81,30247,31231,38586,0,-28,5,-4044,-6,-3460,-11712,1,0,-1,0,7
EUW1_6869746784',3,349,20,1,1,1,0,6,0,346,97,31221,30086,41141,5,35,18,1,0,0,0,2,329,52,29654,28027,36451,1,17,45,1567,2,2059,4690,0,1,1,0,4
EUW1_6883623806',2,38,3,1,0,0,0,10,1,378,98,23234,28659,18119,2,26,7,1,0,2,0,3,386,100,26958,29667,25738,1,-8,-2,-3724,-4,-1008,-7619,0,0,-2,0,7
EUW1_6883596895',2,24,12,1,0,0,0,10,0,381,86,27663,30682,34655,5,34,21,1,0,1,0,5,336,102,31727,31956,39186,0,45,-16,-4064,-9,-1274,-4531,0,0,-1,0,5
EUW1_6883574765',5,26,12,0,1,0,0,12,0,296,88,26446,25539,26615,2,25,14,2,0,2,0,0,372,78,30310,29263,28494,0,-76,10,-3864,-2,-3724,-1879,-2,1,-2,0,12
EUW1_6883546555',3,33,15,2,0,2,0,12,1,332,87,28575,29454,28108,2,37,9,0,1,2,0,3,347,92,27907,28450,23080,1,-15,-5,668,6,1004,5028,2,-1,0,0,9
EUW1_6883497917',5,32,7,0,0,1,0,7,0,361,85,25846,28910,24848,3,43,13,2,0,2,0,5,393,103,29587,30659,29693,0,-32,-18,-3741,-6,-1749,-4845,-2,0,-1,0,2
EUW1_6883450795',6,34,10,0,0,0,0,4,0,366,69,25875,29443,26039,5,26,8,1,1,0,0,2,381,86,25476,29987,28090,0,-15,-17,399,2,-544,-2051,-1,-1,0,0,2
EUW1_6883052345',5,24,11,0,0,0,0,10,1,369,116,27935,31279,31318,3,24,14,2,0,1,0,2,401,93,29973,31309,33234,0,-32,23,-2038,-3,-30,-1916,-2,0,-1,0,8
EUW1_6883006562',4,24,11,1,0,0,0,7,0,385,72,27153,29682,37073,7,65,16,0,0,1,0,4,386,107,30112,31869,36676,0,-1,-35,-2959,-5,-2187,397,1,0,-1,0,3
EUW1_6882839344',2,24,13,1,0,1,0,8,1,356,82,27527,28520,33439,2,47,16,1,1,2,0,5,363,96,30320,32562,36513,1,-7,-14,-2793,-3,-4042,-3074,0,-1,-1,0,3
EUW1_6882282671',3,32,10,0,0,0,0,6,1,326,112,25740,30400,27758,3,42,12,1,1,0,0,6,373,96,27813,31953,26112,0,-47,16,-2073,-2,-1553,1646,-1,-1,0,0,0
EUW1_6882272603',4,29,15,1,1,3,0,13,1,397,105,31999,31231,38340,1,20,15,1,0,2,0,9,317,98,29217,28694,33341,1,80,7,2782,0,2537,4999,0,1,1,0,4
EUW1_6882262473',1,25,20,1,1,3,0,5,1,406,98,35076,31922,40298,2,30,8,0,0,0,0,9,300,74,23151,26187,27616,1,106,24,11925,12,5735,12682,1,1,3,0,-4
EUW1_6882241500',2,23,14,1,0,3,0,7,0,360,130,31036,32947,35431,3,27,12,1,0,0,0,5,317,73,26260,27923,29106,1,43,57,4776,2,5024,6325,0,0,3,0,2
EUW1_6882111258',4,28,14,1,0,0,0,9,1,388,79,29579,30389,29327,2,33,9,0,0,0,0,4,356,96,26041,29404,27267,1,32,-17,3538,5,985,2060,1,0,0,0,5
EUW1_6882008415',2,26,15,2,0,0,0,7,1,318,76,26451,26427,30996,2,28,13,0,0,1,0,2,313,92,27145,27277,40460,0,5,-16,-694,2,-850,-9464,2,0,-1,0,5
EUW1_6881955677',1,20,12,1,0,1,0,8,1,369,82,27783,29722,30587,1,48,9,1,1,1,0,8,362,117,27276,29102,36278,1,7,-35,507,3,620,-5691,0,-1,0,0,0
EUW1_6881472675',1,22,7,0,0,0,0,14,0,327,76,23313,26016,34685,1,23,20,2,0,3,0,0,339,102,32125,31589,34583,0,-12,-26,-8812,-13,-5573,102,-2,0,-3,0,14
EUW1_6881415475',4,26,8,1,0,0,0,10,1,324,74,24069,27011,30603,5,28,12,1,0,1,0,3,341,84,27670,29286,37506,0,-17,-10,-3601,-4,-2275,-6903,0,0,-1,0,7
EUW1_6880819071',2,22,16,1,0,0,0,9,0,304,98,27142,28877,36528,0,20,16,1,0,1,0,2,370,98,30022,32103,39007,0,-66,0,-2880,0,-3226,-2479,0,0,-1,0,7
EUW1_6882163820',4,23,4,0,0,0,0,12,0,302,84,21480,24663,30828,6,151,19,1,1,3,0,1,432,112,32964,35368,42488,0,-130,-28,-11484,-15,-10705,-11660,-1,-1,-3,0,11
EUW1_6882119968',2,60,14,1,1,1,0,7,0,345,90,28351,30935,28956,1,36,8,1,0,1,0,4,372,93,25506,28547,32391,1,-27,-3,2845,6,2388,-3435,0,1,0,0,3
EUW1_6882084805',5,163,16,1,0,2,0,9,1,391,122,31251,32195,34514,2,22,4,1,0,1,0,5,348,70,23348,27312,20287,1,43,52,7903,12,4883,14227,0,0,1,0,4
EUW1_6882021555',4,141,6,1,0,2,0,8,1,390,115,27072,30491,28446,2,43,7,1,0,0,0,5,381,88,25504,29142,23435,1,9,27,1568,-1,1349,5011,0,0,2,0,3
EUW1_6881896645',6,144,8,0,0,0,0,9,1,405,100,26691,30472,24754,0,28,5,1,0,1,0,2,393,112,25501,29399,19022,0,12,-12,1190,3,1073,5732,-1,0,-1,0,7
EUW1_6881836323',4,151,14,0,1,1,0,8,1,372,100,30812,31728,38585,8,101,7,1,0,2,0,8,317,59,22625,26793,25453,1,55,41,8187,7,4935,13132,-1,1,-1,0,0
EUW1_6881774076',2,138,17,0,0,2,0,9,0,345,73,29307,29283,38545,5,31,12,2,0,0,0,4,311,86,26878,27540,33523,1,34,-13,2429,5,1743,5022,-2,0,2,0,5
EUW1_6881721669',5,42,6,0,0,0,0,10,0,315,77,22749,27306,23784,5,198,13,0,0,2,0,1,416,96,29084,31543,35963,0,-101,-19,-6335,-7,-4237,-12179,0,0,-2,0,9
EUW1_6881660248',2,140,19,0,0,2,0,6,1,397,99,32064,33934,42049,2,22,13,1,0,0,0,10,335,78,26189,29217,26738,1,62,21,5875,6,4717,15311,-1,0,2,0,-4
EUW1_6881603585',5,28,13,0,0,0,0,9,1,354,80,27273,28152,25857,4,78,8,2,0,1,0,3,371,115,26281,29601,20313,0,-17,-35,992,5,-1449,5544,-2,0,-1,0,6
EUW1_6880768926',3,142,17,1,0,2,0,7,1,369,83,31078,28706,44356,6,26,15,0,0,1,0,11,322,75,27880,27108,29809,1,47,8,3198,2,1598,14547,1,0,1,0,-4
EUW1_6880750544',0,133,17,0,0,3,0,13,1,313,101,30579,29109,37899,2,23,21,2,0,2,0,6,354,79,32984,31411,36523,1,-41,22,-2405,-4,-2302,1376,-2,0,1,0,7
EUW1_6880722139',11,51,24,2,0,2,0,7,0,373,69,32069,31095,46212,0,157,12,0,0,1,0,9,276,86,25787,27652,34655,1,97,-17,6282,12,3443,11557,2,0,1,0,-2
EUW1_6879317152',4,29,9,0,0,0,0,13,1,312,94,25036,27913,24115,3,149,14,2,0,3,0,3,325,99,29176,28861,33390,0,-13,-5,-4140,-5,-948,-9275,-2,0,-3,0,10
EUW1_6879309731',1,136,11,0,0,0,0,7,1,335,100,26133,29282,32171,9,233,10,2,0,0,0,3,380,72,27005,29770,25839,1,-45,28,-872,1,-488,6332,-2,0,0,0,4
EUW1_6879284333',2,41,8,0,0,0,0,13,0,391,94,26949,30444,23228,3,135,13,2,0,1,0,2,404,91,28702,31807,23819,0,-13,3,-1753,-5,-1363,-591,-2,0,-1,0,11
EUW1_6879273857',4,288,22,2,0,0,0,6,1,326,96,31092,30401,39719,6,146,19,0,0,1,0,4,314,68,28142,26852,43819,1,12,28,2950,3,3549,-4100,2,0,-1,0,2
EUW1_6881235966',1,68,13,2,0,2,0,8,1,391,121,30561,32003,31200,5,29,8,0,0,0,0,7,370,64,24158,28346,25673,1,21,57,6403,5,3657,5527,2,0,2,0,1
EUW1_6881117710',4,29,17,2,0,0,0,12,0,351,114,28348,30272,31256,6,37,11,0,0,2,0,3,382,92,28081,29486,31247,1,-31,22,267,6,786,9,2,0,-2,0,9
EUW1_6881027067',2,20,8,1,0,0,0,11,1,362,92,24404,28811,21941,2,25,9,1,0,1,0,0,425,100,27001,31588,25504,0,-63,-8,-2597,-1,-2777,-3563,0,0,-1,0,11
EUW1_6879420196',3,31,13,2,1,0,0,6,1,368,98,28315,30255,29480,5,24,9,0,0,1,0,3,379,97,25900,28774,23742,0,-11,1,2415,4,1481,5738,2,1,-1,0,3
EUW1_6878133598',3,25,17,1,0,1,0,15,1,323,59,29540,28152,34884,6,145,19,0,1,2,0,2,352,102,32296,30901,37479,0,-29,-43,-2756,-2,-2749,-2595,1,-1,-1,0,13
EUW1_6878102128',1,27,6,2,0,7,2,4,1,409,117,31420,29381,16870,2,25,4,0,0,0,0,13,280,74,21434,22137,13215,1,129,43,9986,2,7244,3655,2,0,7,2,-9
EUW1_6877164149',3,22,15,1,0,1,0,5,1,397,84,28918,30372,33834,5,28,8,0,0,0,0,6,303,92,24972,26792,23119,1,94,-8,3946,7,3580,10715,1,0,1,0,-1
EUW1_6876567093',3,28,14,1,0,0,0,8,0,376,96,28969,33085,31923,3,31,4,1,0,2,0,4,382,86,24622,29464,21483,1,-6,10,4347,10,3621,10440,0,0,-2,0,4
EUW1_6876527182',2,24,8,0,0,1,0,11,0,372,89,26041,29229,34919,2,26,13,2,0,2,0,5,308,104,27334,30427,25526,1,64,-15,-1293,-5,-1198,9393,-2,0,-1,0,6
EUW1_6874345097',1,29,17,0,0,0,0,11,0,345,76,29386,32128,34474,5,38,22,2,0,1,0,2,357,76,31321,31041,35405,1,-12,0,-1935,-5,1087,-931,-2,0,-1,0,9
EUW1_6872906231',1,22,15,0,0,0,0,8,1,317,82,27288,29803,33907,4,29,16,2,0,1,0,0,346,110,28972,30823,40230,1,-29,-28,-1684,-1,-1020,-6323,-2,0,-1,0,8
EUW1_6870109714',4,18,12,0,0,0,0,10,1,340,75,26641,25873,30299,1,31,25,2,0,1,0,6,355,129,35264,34392,38031,0,-15,-54,-8623,-13,-8519,-7732,-2,0,-1,0,4
EUW1_6869646067',4,40,11,1,0,1,0,7,1,408,75,27491,30604,32073,3,33,14,1,0,0,0,5,349,84,27995,29783,34038,0,59,-9,-504,-3,821,-1965,0,0,1,0,2
EUW1_6879030735',3,35,3,0,0,0,0,7,0,393,77,23225,27869,26293,5,23,13,1,1,1,0,1,409,106,29059,32585,30955,0,-16,-29,-5834,-10,-4716,-4662,-1,-1,-1,0,6
EUW1_6877767603',6,30,12,1,0,0,0,8,1,335,93,26118,28166,27603,3,19,8,0,0,1,0,3,349,86,25742,28875,32206,0,-14,7,376,4,-709,-4603,1,0,-1,0,5
EUW1_6877738761',4,29,12,2,1,0,0,8,0,304,116,26192,30864,33196,1,25,5,0,0,0,0,4,353,93,24161,27379,25414,1,-49,23,2031,7,3485,7782,2,1,0,0,4
EUW1_6877720493',3,24,16,1,0,0,0,3,0,330,112,29133,32143,30730,2,22,5,1,0,0,0,6,320,91,22694,27004,21627,1,10,21,6439,11,5139,9103,0,0,0,0,-3
EUW1_6877653965',2,61,10,0,0,0,0,5,0,384,80,25999,30037,33412,3,24,7,0,0,0,0,2,339,77,24139,27881,28283,1,45,3,1860,3,2156,5129,0,0,0,0,3
EUW1_6877605563',3,65,6,0,0,1,0,10,0,394,78,25083,30372,28520,5,52,10,2,0,0,0,4,339,101,26027,31271,34829,1,55,-23,-944,-4,-899,-6309,-2,0,1,0,6
EUW1_6877532001',6,32,10,1,0,1,0,6,0,383,104,27938,30674,33475,11,32,9,1,0,0,0,2,339,88,24452,29042,26485,1,44,16,3486,1,1632,6990,0,0,1,0,4
EUW1_6877402073',2,32,13,0,0,1,0,3,0,380,100,28244,31756,32897,4,43,9,2,0,0,0,5,341,76,23931,28599,30227,0,39,24,4313,4,3157,2670,-2,0,1,0,-2
EUW1_6877337200',6,30,19,0,0,1,0,9,1,397,93,31925,32350,32779,0,26,12,2,0,1,0,4,384,118,28864,32401,30356,0,13,-25,3061,7,-51,2423,-2,0,0,0,5
EUW1_6877285862',6,24,11,0,0,0,0,9,1,300,82,25057,26895,33318,2,21,12,2,1,1,0,4,379,98,27266,31015,31403,0,-79,-16,-2209,-1,-4120,1915,-2,-1,-1,0,5
EUW1_6877128762',8,33,8,0,0,0,0,10,0,315,74,23787,28189,32702,6,30,16,1,1,1,0,1,366,84,28931,29559,39249,0,-51,-10,-5144,-8,-1370,-6547,-1,-1,-1,0,9
EUW1_6877080214',8,34,17,1,0,0,0,9,0,322,120,29105,31501,32024,3,26,16,1,0,0,0,1,392,76,29216,29106,43576,0,-70,44,-111,1,2395,-11552,0,0,0,0,8
EUW1_6876779994',9,36,16,0,0,1,0,10,1,402,68,30180,31552,32668,4,31,13,2,0,1,0,6,325,94,27633,28228,31971,1,77,-26,2547,3,3324,697,-2,0,0,0,4
EUW1_6876284854',4,22,15,1,0,1,0,8,0,381,94,29178,32200,40779,2,26,9,0,0,0,0,6,350,90,25027,29468,33735,0,31,4,4151,6,2732,7044,1,0,1,0,2
EUW1_6876234454',4,48,8,0,0,1,0,10,0,365,84,25863,28109,23327,3,143,12,2,1,1,0,5,379,104,28476,30749,26519,0,-14,-20,-2613,-4,-2640,-3192,-2,-1,0,0,5
EUW1_6876181585',7,29,12,0,0,0,0,8,0,353,95,27103,29507,32111,4,26,13,1,0,1,0,2,351,87,28331,30488,31412,0,2,8,-1228,-1,-981,699,-1,0,-1,0,6
EUW1_6876117507',2,25,8,2,0,0,0,6,0,341,83,25351,28246,30036,5,27,15,0,0,0,0,1,313,112,26878,27776,29736,1,28,-29,-1527,-7,470,300,2,0,0,0,5
EUW1_6876054955',2,26,12,1,1,0,0,3,1,414,104,29419,30672,34761,7,26,13,1,0,3,0,5,372,60,28512,29584,34970,1,42,44,907,-1,1088,-209,0,1,-3,0,-2
EUW1_6875974372',4,36,12,1,1,0,0,10,1,343,76,26396,30101,28272,3,29,8,0,0,2,0,4,359,99,27282,29284,32708,1,-16,-23,-886,4,817,-4436,1,1,-2,0,6
EUW1_6875787503',4,24,11,1,0,1,0,11,0,377,104,28642,32001,31469,6,27,8,0,0,2,0,4,381,84,26261,29133,27618,1,-4,20,2381,3,2868,3851,1,0,-1,0,7
EUW1_6881228406',3,31,16,2,0,1,0,9,0,385,112,30169,33190,36771,5,374,11,0,0,1,0,6,335,80,27346,28552,34065,1,50,32,2823,5,4638,2706,2,0,0,0,3
EUW1_6881118002',3,30,8,0,0,1,0,4,0,347,92,25545,28414,28156,3,33,11,1,1,0,0,4,363,84,26200,29355,28336,1,-16,8,-655,-3,-941,-180,-1,-1,1,0,0
EUW1_6881065362',1,20,14,0,0,2,0,10,1,376,98,30223,31948,29126,2,81,12,2,0,1,0,7,378,97,28201,31561,29892,1,-2,1,2022,2,387,-766,-2,0,1,0,3
EUW1_6880995522',2,24,14,1,0,0,0,8,0,344,87,28122,27774,31840,4,34,19,1,0,1,0,2,419,88,32379,31159,34436,0,-75,-1,-4257,-5,-3385,-2596,0,0,-1,0,6
EUW1_6880893868',4,29,13,0,0,0,0,6,1,348,89,27258,31312,30052,3,67,11,2,0,0,0,2,353,90,25840,30840,31510,1,-5,-1,1418,2,472,-1458,-2,0,0,0,4
EUW1_6879273990',1,41,16,2,0,2,0,8,0,350,92,30104,29554,45107,4,33,11,0,0,1,0,6,297,67,25355,27927,30728,1,53,25,4749,5,1627,14379,2,0,1,0,2
EUW1_6879254873',3,74,6,0,0,0,0,15,0,368,99,24206,28608,28035,5,46,13,2,0,1,0,2,372,74,29085,29384,37760,0,-4,25,-4879,-7,-776,-9725,-2,0,-1,0,13
EUW1_6879224679',4,56,13,1,0,0,0,5,1,375,116,28482,32650,24800,6,74,7,0,0,0,0,3,375,116,25042,30198,22132,1,0,0,3440,6,2452,2668,1,0,0,0,2
EUW1_6879185207',5,26,22,0,0,2,0,10,1,353,77,33161,30681,38432,2,30,16,1,0,0,0,4,294,80,27268,28159,32840,0,59,-3,5893,6,2522,5592,-1,0,2,0,6
EUW1_6879134155',3,24,12,1,0,1,0,7,0,359,84,27007,31308,29051,5,35,11,1,0,0,0,1,392,96,27023,29194,29111,1,-33,-12,-16,1,2114,-60,0,0,1,0,6
EUW1_6877849642',2,48,14,0,0,0,0,8,0,365,78,26866,28634,31976,2,29,9,1,0,0,0,3,346,75,25837,27815,27430,1,19,3,1029,5,819,4546,-1,0,0,0,5
EUW1_6883559882',4,33,23,2,0,2,0,12,1,322,99,32454,31230,44465,3,21,12,0,0,0,0,4,340,88,27030,27041,32754,1,-18,11,5424,11,4189,11711,2,0,2,0,8
EUW1_6882954268',3,25,9,1,0,0,0,7,1,421,80,27010,30213,29439,4,26,9,1,0,1,0,5,369,111,26079,32432,29373,0,52,-31,931,0,-2219,66,0,0,-1,0,2
EUW1_6882887222',3,28,17,1,0,0,0,8,1,346,70,27946,28016,39159,7,39,13,1,0,0,0,1,298,94,26505,28291,37446,1,48,-24,1441,4,-275,1713,0,0,0,0,7
EUW1_6876387155',4,28,12,1,0,0,0,8,0,311,76,26677,29156,29326,4,39,12,0,0,2,0,3,330,72,26511,29482,31522,1,-19,4,166,0,-326,-2196,1,0,-2,0,5
EUW1_6875072562',1,27,8,0,1,0,0,6,0,389,101,25903,29992,27210,4,28,9,1,0,1,0,2,382,82,26860,29496,26125,1,7,19,-957,-1,496,1085,-1,1,-1,0,4
EUW1_6874773368',5,31,13,2,0,0,0,11,0,387,92,29152,31829,33374,5,32,8,0,1,2,0,5,386,88,26972,29753,27391,1,1,4,2180,5,2076,5983,2,-1,-2,0,6
EUW1_6873582607',4,28,19,0,0,1,0,8,1,293,68,30284,29487,38570,4,31,18,2,0,1,0,4,320,88,30354,29809,46743,1,-27,-20,-70,1,-322,-8173,-2,0,0,0,4
EUW1_6871754686',2,55,14,0,0,1,0,9,1,382,87,29272,31607,34162,7,31,10,1,0,0,0,1,364,88,26593,29675,30824,1,18,-1,2679,4,1932,3338,-1,0,1,0,8
EUW1_6871672377',7,27,14,0,0,0,0,9,0,327,83,27619,28573,28584,5,153,18,1,0,1,0,3,367,75,29299,29229,35310,0,-40,8,-1680,-4,-656,-6726,-1,0,-1,0,6
EUW1_6871624990',7,36,13,1,0,1,0,10,0,363,89,28122,31150,33008,3,34,14,1,0,1,0,4,364,86,28027,29789,36645,1,-1,3,95,-1,1361,-3637,0,0,0,0,6
EUW1_6870618870',2,26,5,2,0,0,0,10,0,325,88,22749,27125,27959,5,58,9,0,0,0,0,2,324,96,25603,27221,26039,1,1,-8,-2854,-4,-96,1920,2,0,0,0,8
EUW1_6870446220',6,33,14,1,0,0,0,12,0,336,92,27849,30784,35399,3,24,8,1,0,1,0,5,389,92,26811,29059,27538,1,-53,0,1038,6,1725,7861,0,0,-1,0,7
EUW1_6870371161',5,191,7,1,0,0,0,7,1,376,70,24641,27319,29648,4,31,13,0,0,0,0,0,327,90,27653,29743,36758,0,49,-20,-3012,-6,-2424,-7110,1,0,0,0,7
EUW1_6870287404',1,27,10,2,1,0,0,15,0,317,82,24901,26293,31130,5,28,17,0,0,2,0,3,350,82,31242,30217,34542,0,-33,0,-6341,-7,-3924,-3412,2,1,-2,0,12
EUW1_6878053382',5,28,11,0,0,1,0,5,1,419,82,28194,31037,26084,4,23,10,2,0,0,0,5,377,84,26160,30228,28337,1,42,-2,2034,1,809,-2253,-2,0,1,0,0
EUW1_6876104239',1,28,13,0,0,3,0,7,0,413,80,29597,30758,36965,3,26,15,0,0,0,0,11,353,76,27471,29584,30575,1,60,4,2126,-2,1174,6390,0,0,3,0,-4
EUW1_6874512777',5,37,12,0,0,0,0,13,1,297,80,24272,25257,27290,5,30,20,1,0,2,0,0,337,82,31186,31814,35745,0,-40,-2,-6914,-8,-6557,-8455,-1,0,-2,0,13
EUW1_6873892460',2,50,11,1,1,0,0,12,0,278,92,24861,27524,27431,4,24,16,1,0,1,0,0,347,69,28347,28617,30936,0,-69,23,-3486,-5,-1093,-3505,0,1,-1,0,12
EUW1_6873817730',4,25,21,1,0,0,0,10,0,391,101,31470,32139,34622,5,31,13,1,0,0,0,6,356,74,26788,29041,38625,1,35,27,4682,8,3098,-4003,0,0,0,0,4
EUW1_6873299690',3,31,9,1,0,0,0,9,1,373,80,26994,30487,27973,3,27,5,1,0,1,0,5,369,86,23899,28273,22675,1,4,-6,3095,4,2214,5298,0,0,-1,0,4
EUW1_6870356271',4,38,12,0,0,1,0,10,0,376,83,28456,30193,33935,8,27,13,2,0,0,0,3,359,80,28015,30100,28826,1,17,3,441,-1,93,5109,-2,0,1,0,7
EUW1_6868934504',3,25,5,2,0,0,0,6,1,356,82,23108,28659,23205,5,146,10,0,0,0,0,2,383,81,25801,30618,27451,1,-27,1,-2693,-5,-1959,-4246,2,0,0,0,4
EUW1_6868871268',6,28,20,2,0,2,0,9,0,380,100,33525,31930,43671,1,35,21,0,0,0,0,3,312,79,30059,30155,35857,1,68,21,3466,-1,1775,7814,2,0,2,0,6
EUW1_6868806012',7,26,15,0,0,1,0,5,1,346,104,29508,30987,34020,6,31,11,1,0,0,0,9,364,64,25609,29327,26414,1,-18,40,3899,4,1660,7606,-1,0,1,0,-4
EUW1_6868727160',2,20,15,0,1,1,0,7,1,395,80,31054,31387,34953,5,33,11,1,0,0,0,5,379,79,26554,29126,33062,0,16,1,4500,4,2261,1891,-1,1,1,0,2
EUW1_6868632086',1,51,11,0,0,0,0,8,0,318,71,25207,26936,29427,6,28,12,1,0,1,0,3,359,70,26667,27283,31986,0,-41,1,-1460,-1,-347,-2559,-1,0,-1,0,5
EUW1_6868546089',8,145,9,1,0,0,0,5,0,382,91,26715,29689,23865,5,38,13,0,0,0,0,4,391,80,27746,29578,26340,0,-9,11,-1031,-4,111,-2475,1,0,0,0,1
EUW1_6868370305',6,65,13,0,0,0,0,7,0,355,96,26803,30377,26733,3,65,13,2,0,0,0,1,402,94,27638,30607,31735,1,-47,2,-835,0,-230,-5002,-2,0,0,0,6
EUW1_6868320322',3,30,22,2,0,1,0,9,0,411,102,33241,34653,46983,4,28,4,0,0,2,0,7,354,65,22140,27022,20792,1,57,37,11101,18,7631,26191,2,0,-1,0,2
EUW1_6867658303',4,28,20,1,0,1,0,6,1,363,104,31200,29944,36042,6,206,18,0,0,0,0,4,302,75,29567,27570,39959,1,61,29,1633,2,2374,-3917,1,0,1,0,2
EUW1_6867645325',5,28,16,0,1,0,0,9,0,308,122,28722,32670,31272,3,31,17,2,0,0,0,4,375,86,30366,32747,46941,1,-67,36,-1644,-1,-77,-15669,-2,1,0,0,5
EUW1_6867649539',2,19,18,1,0,0,0,5,1,329,91,27128,30861,40567,0,19,4,0,0,0,0,2,355,96,23171,28649,23118,1,-26,-5,3957,14,2212,17449,1,0,0,0,3
EUW1_6873839118',7,28,16,1,0,0,0,9,1,344,79,28261,30505,36727,2,23,12,0,0,0,0,3,345,79,27822,27492,39378,1,-1,0,439,4,3013,-2651,1,0,0,0,6
EUW1_6873822776',6,29,16,1,0,2,0,13,1,408,90,31417,33094,36694,4,26,8,1,0,1,0,6,320,98,25235,27913,28538,1,88,-8,6182,8,5181,8156,0,0,1,0,7
EUW1_6873800148',1,27,13,1,0,0,0,9,1,281,72,25215,24869,32156,6,28,23,1,0,0,0,3,317,84,29591,28783,42553,0,-36,-12,-4376,-10,-3914,-10397,0,0,0,0,6
EUW1_6873789805',2,29,7,0,0,0,0,10,0,338,84,24443,27950,28182,2,94,20,2,0,2,0,3,390,96,31849,33319,37095,0,-52,-12,-7406,-13,-5369,-8913,-2,0,-2,0,7
EUW1_6873162511',5,33,21,2,0,2,0,10,1,340,96,31104,30566,38842,3,98,7,0,0,0,0,2,334,92,23579,27225,23447,1,6,4,7525,14,3341,15395,2,0,2,0,8
EUW1_6873087865',5,31,22,1,0,1,0,6,1,361,99,32005,31715,42992,4,31,9,0,0,1,0,4,315,76,25208,26886,28585,1,46,23,6797,13,4829,14407,1,0,0,0,2
EUW1_6873001767',0,21,14,2,0,0,0,11,0,349,73,28728,29507,34591,4,28,16,0,0,0,0,2,372,78,29539,30069,38692,1,-23,-5,-811,-2,-562,-4101,2,0,0,0,9
EUW1_6872935124',4,24,12,0,0,0,0,9,0,321,100,26214,27566,29008,3,20,19,1,0,1,0,1,361,91,31057,29609,42531,0,-40,9,-4843,-7,-2043,-13523,-1,0,-1,0,8
EUW1_6872880224',3,26,10,1,0,0,0,5,1,364,96,27126,30285,31277,0,16,8,1,0,1,0,0,354,116,25212,30461,32914,1,10,-20,1914,2,-176,-1637,0,0,-1,0,5
EUW1_6872630005',6,34,11,0,0,1,0,8,1,368,71,26945,29804,31234,3,27,13,2,0,0,0,2,353,76,26262,28923,30547,0,15,-5,683,-2,881,687,-2,0,1,0,6
EUW1_6872592972',4,26,13,0,0,1,0,8,0,401,106,30375,32011,37616,6,27,15,1,0,1,0,9,353,78,28558,30115,37248,1,48,28,1817,-2,1896,368,-1,0,0,0,-1
EUW1_6872570080',3,28,18,2,0,2,0,4,1,410,119,33881,33341,34932,3,39,4,0,0,1,0,11,347,96,22402,27763,22250,1,63,23,11479,14,5578,12682,2,0,1,0,-7
EUW1_6872539989',7,77,15,1,0,1,0,11,0,338,93,29571,29201,39829,7,33,13,1,0,1,0,3,347,75,27448,28706,35778,0,-9,18,2123,2,495,4051,0,0,0,0,8
EUW1_6872503368',2,28,14,0,0,2,0,5,1,377,79,29442,30094,37278,4,40,11,2,0,0,0,9,331,64,25576,27465,38713,0,46,15,3866,3,2629,-1435,-2,0,2,0,-4
EUW1_6872462288',5,29,12,0,0,0,0,12,1,357,72,27113,28279,30186,2,25,12,2,0,1,0,1,388,114,29908,30600,37341,0,-31,-42,-2795,0,-2321,-7155,-2,0,-1,0,11
EUW1_6872440699',2,72,15,2,0,1,0,7,0,393,112,30261,32509,35029,3,25,8,0,0,1,0,6,373,91,26524,29462,34599,0,20,21,3737,7,3047,430,2,0,0,0,1
EUW1_6872425922',1,24,6,0,0,0,0,15,0,349,73,22466,24762,21302,7,37,16,2,1,4,0,0,371,101,31950,32545,34931,0,-22,-28,-9484,-10,-7783,-13629,-2,-1,-4,0,15
EUW1_6872409844',3,57,10,1,0,0,0,16,0,327,84,24851,26993,31333,1,27,20,0,0,3,0,4,339,100,33589,30738,41793,0,-12,-16,-8738,-10,-3745,-10460,1,0,-3,0,12
EUW1_6872379749',3,25,12,0,0,0,0,11,0,333,72,27368,29670,28599,4,34,17,1,0,1,0,3,389,115,30976,32423,34756,0,-56,-43,-3608,-5,-2753,-6157,-1,0,-1,0,8
EUW1_6883496971',5,103,15,1,0,1,0,10,0,324,96,29738,30088,37579,3,72,16,1,1,2,0,4,321,96,29538,29593,30296,1,3,0,200,-1,495,7283,0,-1,-1,0,6
EUW1_6883424112',9,33,9,1,0,0,0,4,1,376,88,26367,30975,27862,5,57,11,1,0,0,0,1,400,96,27640,30578,29201,0,-24,-8,-1273,-2,397,-1339,0,0,0,0,3
EUW1_6874005444',4,45,14,0,0,1,0,8,1,387,83,29175,29874,40274,4,29,11,2,0,0,0,7,338,66,27284,29267,35043,1,49,17,1891,3,607,5231,-2,0,1,0,1
EUW1_6873980143',3,23,4,0,0,0,0,12,0,367,108,23785,28794,25906,5,25,9,2,1,1,0,0,402,96,27778,29663,27926,0,-35,12,-3993,-5,-869,-2020,-2,-1,-1,0,12
EUW1_6873950990',7,26,10,1,0,0,0,9,0,350,98,25612,29351,26943,4,29,11,1,0,1,0,2,342,114,26123,29567,25905,0,8,-16,-511,-1,-216,1038,0,0,-1,0,7
EUW1_6872510867',5,25,9,0,0,0,0,7,0,316,90,25003,27106,25620,4,27,14,2,0,0,0,5,335,102,28609,30434,25728,0,-19,-12,-3606,-5,-3328,-108,-2,0,0,0,2
EUW1_6871024875',3,25,6,0,0,0,0,10,0,346,88,23347,28233,32800,2,34,17,1,1,1,0,1,365,91,31213,30857,33465,0,-19,-3,-7866,-11,-2624,-665,-1,-1,-1,0,9
EUW1_6871018528',5,30,11,0,0,1,0,4,1,419,100,30020,32172,21946,4,26,6,2,0,0,0,5,389,98,24424,29029,24214,1,30,2,5596,5,3143,-2268,-2,0,1,0,-1
EUW1_6869321015',9,89,13,2,0,0,0,15,0,332,98,27352,29355,30092,4,28,14,0,0,1,0,1,333,76,29931,31562,27795,0,-1,22,-2579,-1,-2207,2297,2,0,-1,0,14
EUW1_6869298699',5,29,12,0,0,0,0,15,1,303,89,26177,28460,27019,3,43,16,2,0,2,0,0,399,86,29991,31575,38906,0,-96,3,-3814,-4,-3115,-11887,-2,0,-2,0,15
EUW1_6867893673',4,20,13,0,0,1,0,13,1,343,72,27236,27692,35192,6,33,23,0,0,1,0,5,347,88,33667,32176,43276,0,-4,-16,-6431,-10,-4484,-8084,0,0,0,0,8
EUW1_6867692722',4,27,17,1,0,1,0,6,0,317,90,29304,30434,42100,5,31,12,0,0,0,0,4,299,66,25623,25709,41640,1,18,24,3681,5,4725,460,1,0,1,0,2
EUW1_6867648775',3,31,19,2,1,1,0,7,1,383,100,33778,31139,32255,1,30,7,0,0,2,0,8,331,88,24160,27048,20505,1,52,12,9618,12,4091,11750,2,1,-1,0,-1
EUW1_6867636827',5,40,8,1,0,0,0,8,0,377,100,25227,28004,25325,5,33,13,1,0,1,0,1,381,77,30502,30268,26978,0,-4,23,-5275,-5,-2264,-1653,0,0,-1,0,7
EUW1_6867588049',7,44,11,1,0,0,0,12,0,363,77,25852,27851,32305,6,36,10,1,0,1,0,1,346,92,27377,27576,28035,1,17,-15,-1525,1,275,4270,0,0,-1,0,11
EUW1_6866467942',4,27,12,0,0,0,0,13,1,310,95,26899,28806,27431,0,22,8,2,0,3,0,1,413,99,28369,30296,27819,0,-103,-4,-1470,4,-1490,-388,-2,0,-3,0,12
EUW1_6866434796',4,35,5,0,0,0,0,10,0,327,80,22468,27409,31428,4,28,14,2,1,1,0,0,342,135,28927,32599,31672,0,-15,-55,-6459,-9,-5190,-244,-2,-1,-1,0,10
EUW1_6871845338',3,27,17,0,0,1,0,4,0,364,68,29576,30113,36953,3,26,8,2,0,0,0,6,339,108,25610,28389,29037,1,25,-40,3966,9,1724,7916,-2,0,1,0,-2
EUW1_6871787819',1,23,17,2,0,3,0,10,1,401,101,31068,33847,43578,0,16,0,0,0,0,0,8,349,78,20689,27615,14181,1,52,23,10379,17,6232,29397,2,0,3,0,2
EUW1_6871723160',3,42,16,1,0,1,0,8,1,358,84,29115,30236,38251,3,28,15,1,0,0,0,5,360,85,28068,30542,32954,1,-2,-1,1047,1,-306,5297,0,0,1,0,3
EUW1_6870615797',3,23,4,0,0,0,0,8,0,385,88,23753,28883,19818,4,26,13,1,0,1,0,3,412,106,29132,32866,33475,0,-27,-18,-5379,-9,-3983,-13657,-1,0,-1,0,5
EUW1_6870495720',7,30,15,0,0,0,0,13,1,382,66,28054,29282,37707,3,24,10,1,0,1,0,2,388,90,28314,29646,34048,1,-6,-24,-260,5,-364,3659,-1,0,-1,0,11
EUW1_6869212510',3,15,11,1,0,0,0,8,1,363,72,27768,29087,41074,2,27,11,0,0,1,0,8,340,76,25770,29071,32785,1,23,-4,1998,0,16,8289,1,0,-1,0,0
EUW1_6869179845',4,27,16,2,0,1,0,9,0,331,96,27376,30516,38657,2,27,7,0,1,2,0,4,383,98,27167,29968,28641,1,-52,-2,209,9,548,10016,2,-1,-1,0,5
EUW1_6869144149',6,28,12,0,0,1,0,11,1,336,54,26650,28150,29377,2,24,17,2,0,1,0,3,383,82,29331,30214,38008,0,-47,-28,-2681,-5,-2064,-8631,-2,0,0,0,8
EUW1_6868411478',6,28,10,0,0,0,0,12,1,335,98,26400,29533,33489,6,211,16,1,0,2,0,4,403,88,30122,32722,38610,0,-68,10,-3722,-6,-3189,-5121,-1,0,-2,0,8
EUW1_6868346226',3,39,14,1,0,0,0,9,1,324,87,28290,28654,35535,5,36,18,0,0,0,0,4,326,81,29694,30862,45591,1,-2,6,-1404,-4,-2208,-10056,1,0,0,0,5
EUW1_6868272468',2,58,18,0,0,1,0,11,0,353,94,30927,30009,37808,1,22,14,1,0,2,0,4,375,80,29195,30298,34059,1,-22,14,1732,4,-289,3749,-1,0,-1,0,7
EUW1_6868215819',2,31,26,1,0,3,0,4,1,398,110,36250,33123,48721,4,33,10,1,0,0,0,11,353,74,25203,26463,30516,1,45,36,11047,16,6660,18205,0,0,3,0,-7
EUW1_6867938411',3,30,12,1,0,0,0,12,0,303,96,25132,28803,28616,3,22,18,1,0,2,0,2,391,92,30343,32799,32919,0,-88,4,-5211,-6,-3996,-4303,0,0,-2,0,10
EUW1_6867781464',3,29,10,0,0,1,0,7,0,385,84,27311,29690,31651,5,39,14,2,0,0,0,3,342,84,27435,29708,34352,0,43,0,-124,-4,-18,-2701,-2,0,1,0,4
EUW1_6867747153',2,30,4,0,0,0,0,11,0,307,85,21743,26810,26406,3,33,13,2,0,1,0,1,381,106,28682,31265,33099,0,-74,-21,-6939,-9,-4455,-6693,-2,0,-1,0,10
EUW1_6867727973',1,28,14,1,0,2,0,12,1,367,92,30809,31950,31219,5,28,20,1,1,2,0,7,363,94,31495,29637,35966,1,4,-2,-686,-6,2313,-4747,0,-1,0,0,5
EUW1_6867707017',5,29,13,1,0,0,0,8,0,368,103,27534,30410,38416,3,28,18,1,0,1,0,4,338,107,30521,31970,45674,0,30,-4,-2987,-5,-1560,-7258,0,0,-1,0,4
EUW1_6867662190',5,23,16,2,0,1,0,8,0,319,81,29480,29482,43256,4,33,24,0,0,1,0,0,358,114,33074,32785,54507,0,-39,-33,-3594,-8,-3303,-11251,2,0,0,0,8
EUW1_6883737214',1,21,9,1,0,0,0,10,0,343,90,25993,29020,30667,3,24,18,1,1,2,0,0,399,101,31488,32421,40822,0,-56,-11,-5495,-9,-3401,-10155,0,-1,-2,0,10
EUW1_6883724500',6,28,7,1,0,0,0,10,0,349,74,24941,28148,25760,1,24,16,1,0,2,0,3,382,91,30043,31556,42183,0,-33,-17,-5102,-9,-3408,-16423,0,0,-2,0,7
EUW1_6883714641',7,35,12,0,0,0,0,10,0,408,108,29956,32686,33809,6,39,7,2,0,1,0,5,378,85,23939,28900,21073,1,30,23,6017,5,3786,12736,-2,0,-1,0,5
EUW1_6883698579',3,86,10,1,0,1,0,7,0,371,119,27673,30968,28282,6,29,3,0,0,0,0,4,364,80,22708,28539,25656,1,7,39,4965,7,2429,2626,1,0,1,0,3
EUW1_6883656995',2,30,6,0,0,1,0,11,0,382,87,25647,28575,27691,3,32,11,2,0,0,0,6,370,86,27627,30210,29519,0,12,1,-1980,-5,-1635,-1828,-2,0,1,0,5
EUW1_6883648571',3,22,13,0,0,1,0,8,0,345,83,28817,28492,32164,5,27,20,2,0,2,0,3,351,69,31087,29396,43634,0,-6,14,-2270,-7,-904,-11470,-2,0,-1,0,5
EUW1_6883621372',2,24,12,0,0,1,0,10,1,316,110,26638,29009,29454,4,28,18,1,0,0,0,4,342,88,30247,32076,43302,0,-26,22,-3609,-6,-3067,-13848,-1,0,1,0,6
EUW1_6883591447',1,21,9,1,0,1,0,11,0,384,72,27198,28286,29230,0,28,14,1,0,1,0,3,364,95,28929,31255,31110,1,20,-23,-1731,-5,-2969,-1880,0,0,0,0,8
EUW1_6883572698',0,52,12,0,0,0,0,16,0,313,82,26485,27173,35896,6,87,24,2,0,3,0,1,369,90,33176,33739,47359,1,-56,-8,-6691,-12,-6566,-11463,-2,0,-3,0,15
EUW1_6883501857',12,41,8,2,0,0,0,10,0,381,118,26075,31784,28616,1,57,6,0,0,2,0,2,430,92,27768,31106,31835,0,-49,26,-1693,2,678,-3219,2,0,-2,0,8
EUW1_6883456072',2,28,11,0,1,0,0,8,1,344,103,27078,30776,30239,5,33,14,1,0,1,0,1,374,96,28900,30675,38177,0,-30,7,-1822,-3,101,-7938,-1,1,-1,0,7
EUW1_6883408027',0,25,5,0,0,0,0,14,0,365,88,24329,28530,22242,4,28,20,2,0,2,0,0,382,92,32395,31064,35671,0,-17,-4,-8066,-15,-2534,-13429,-2,0,-2,0,14
EUW1_6883188248',6,29,9,0,0,1,0,12,0,334,88,26375,28902,35222,5,37,14,2,1,1,0,5,396,76,28728,31435,35783,0,-62,12,-2353,-5,-2533,-561,-2,-1,0,0,7
EUW1_6883118361',3,31,14,1,0,2,0,6,1,342,100,29516,29502,35423,2,25,13,1,1,0,0,5,337,78,26991,29886,28028,1,5,22,2525,1,-384,7395,0,-1,2,0,1
EUW1_6883077635',3,30,21,2,0,0,0,9,0,341,95,29994,31110,36694,2,27,9,0,0,0,0,3,368,76,25847,27411,35415,1,-27,19,4147,12,3699,1279,2,0,0,0,6
EUW1_6883021288',4,22,21,2,0,2,0,8,1,359,96,32887,31677,39210,2,24,7,0,0,0,0,11,401,76,26566,29552,29646,1,-42,20,6321,14,2125,9564,2,0,2,0,-3
EUW1_6882925730',6,30,14,0,0,1,0,10,1,375,81,29059,29224,34746,7,106,10,1,0,1,0,3,320,90,25046,28463,36719,1,55,-9,4013,4,761,-1973,-1,0,0,0,7
EUW1_6881883039',5,27,10,0,0,0,0,7,1,384,92,27626,30803,28594,9,35,13,2,0,1,0,5,390,92,28589,31213,29693,0,-6,0,-963,-3,-410,-1099,-2,0,-1,0,2
EUW1_6881765475',4,24,10,1,0,0,0,6,0,420,97,27713,30653,23711,2,57,4,1,0,0,0,3,415,77,24186,28266,20620,1,5,20,3527,6,2387,3091,0,0,0,0,3
EUW1_6881177044',0,140,16,0,0,1,0,6,0,358,116,31022,31124,32739,8,50,13,1,0,1,0,5,361,88,27983,29570,24925,1,-3,28,3039,3,1554,7814,-1,0,0,0,1
EUW1_6881131743',5,29,14,0,0,1,0,15,0,332,111,29945,30217,31841,7,28,24,2,0,4,0,3,349,104,33831,29634,40085,0,-17,7,-3886,-10,583,-8244,-2,0,-3,0,12
EUW1_6881073706',6,25,6,2,0,0,0,6,0,345,80,23274,29570,33074,3,70,5,0,0,1,0,0,406,104,26412,30640,34553,1,-61,-24,-3138,1,-1070,-1479,2,0,-1,0,6
EUW1_6881035626',0,23,6,0,0,0,0,10,0,380,101,25190,29194,20185,4,26,14,2,1,2,0,2,370,75,28677,30001,29748,0,10,26,-3487,-8,-807,-9563,-2,-1,-2,0,8
EUW1_6880381441',1,51,10,0,0,3,0,13,0,397,89,28721,30330,35281,2,26,10,2,0,1,0,7,334,78,26885,26690,25392,1,63,11,1836,0,3640,9889,-2,0,2,0,6
EUW1_6880277732',3,32,10,1,0,0,0,9,1,359,77,26634,30505,25576,2,28,12,1,0,1,0,2,370,91,27641,29845,35678,0,-11,-14,-1007,-2,660,-10102,0,0,-1,0,7
EUW1_6880213170',0,49,12,0,0,0,0,14,0,311,88,25377,27959,27244,5,37,20,1,0,3,0,0,371,124,33436,31211,35293,0,-60,-36,-8059,-8,-3252,-8049,-1,0,-3,0,14
EUW1_6880144130',7,30,16,2,0,0,0,12,1,330,112,29756,30047,37048,0,31,19,0,0,3,0,4,377,92,32236,32596,43747,1,-47,20,-2480,-3,-2549,-6699,2,0,-3,0,8
EUW1_6880087885',5,32,14,2,0,1,0,9,1,392,99,29714,31650,28350,3,26,7,0,0,0,0,5,380,92,25097,27712,26357,1,12,7,4617,7,3938,1993,2,0,1,0,4
EUW1_6880036625',3,44,5,0,0,0,0,6,0,342,87,22569,28374,19001,6,48,11,2,1,0,0,1,402,112,27129,31150,29527,0,-60,-25,-4560,-6,-2776,-10526,-2,-1,0,0,5
EUW1_6879964174',5,34,10,0,1,1,0,10,0,368,89,27742,29183,28443,3,57,12,1,0,1,0,4,375,87,27855,28069,29587,0,-7,2,-113,-2,1114,-1144,-1,1,0,0,6
EUW1_6879834475',2,23,14,2,1,0,0,11,1,356,78,27873,29704,33875,3,30,19,0,0,1,0,2,375,67,32159,31658,43958,0,-19,11,-4286,-5,-1954,-10083,2,1,-1,0,9
EUW1_6879766477',8,33,16,0,0,1,0,9,1,334,56,29146,27443,35822,4,30,15,2,0,1,0,6,337,78,28324,30142,38156,1,-3,-22,822,1,-2699,-2334,-2,0,0,0,3
EUW1_6879395421',5,25,13,1,1,1,0,5,0,391,86,28863,30777,28942,2,28,9,1,0,1,0,4,360,94,25865,29212,26702,1,31,-8,2998,4,1565,2240,0,1,0,0,1
EUW1_6879321264',7,28,8,0,0,0,0,5,0,387,93,26107,31081,25311,2,21,10,2,0,0,0,1,362,106,26265,30061,31442,0,25,-13,-158,-2,1020,-6131,-2,0,0,0,4
EUW1_6879320739',8,35,20,1,0,0,0,7,0,300,97,28880,30325,32216,3,37,6,1,0,0,0,3,375,82,24698,26461,26287,1,-75,15,4182,14,3864,5929,0,0,0,0,4
EUW1_6879303887',2,29,18,1,0,1,0,9,1,370,98,30565,32138,38675,3,34,8,0,0,0,0,5,344,104,26807,29468,27665,1,26,-6,3758,10,2670,11010,1,0,1,0,4
EUW1_6879821866',5,31,5,2,0,0,0,10,1,402,92,24736,28802,24388,3,37,10,0,0,0,0,2,397,107,26762,31304,27161,1,5,-15,-2026,-5,-2502,-2773,2,0,0,0,8
EUW1_6879795654',5,29,20,1,0,2,0,7,1,413,85,32172,33285,38378,1,27,7,0,0,1,0,7,291,86,23051,25721,29746,1,122,-1,9121,13,7564,8632,1,0,1,0,0
EUW1_6879748041',6,290,11,0,0,0,0,12,0,321,90,25279,29184,31897,6,126,19,2,1,2,0,2,347,110,30745,31610,37908,0,-26,-20,-5466,-8,-2426,-6011,-2,-1,-2,0,10
EUW1_6879696288',1,26,4,0,0,0,0,9,1,340,87,22974,27684,26854,4,105,8,2,0,1,0,1,344,88,25837,30082,33223,0,-4,-1,-2863,-4,-2398,-6369,-2,0,-1,0,8
EUW1_6876931636',5,31,14,1,1,1,0,4,0,353,96,28676,29663,38917,3,28,10,1,0,0,0,6,306,98,25744,27924,33647,1,47,-2,2932,4,1739,5270,0,1,1,0,-2
EUW1_6875764867',4,33,12,2,0,1,0,7,1,370,80,26438,30105,26498,5,27,8,0,1,1,0,4,369,92,26033,29043,23795,0,1,-12,405,4,1062,2703,2,-1,0,0,3
EUW1_6872826076',2,25,7,0,0,0,0,5,0,391,93,25498,30799,22181,3,97,9,1,0,0,0,0,395,86,26318,30054,27259,0,-4,7,-820,-2,745,-5078,-1,0,0,0,5
EUW1_6872780345',2,22,8,1,0,0,0,3,1,376,90,26328,29642,35815,8,37,11,1,0,1,0,6,342,96,25709,29253,32857,1,34,-6,619,-3,389,2958,0,0,-1,0,-3
EUW1_6872419674',5,275,7,0,1,2,0,7,1,345,96,26802,30087,33860,4,27,11,2,0,1,0,5,340,92,26492,29599,29291,0,5,4,310,-4,488,4569,-2,1,1,0,2
EUW1_6872392114',3,24,8,1,0,0,0,13,1,392,94,26033,29647,33322,3,35,10,0,0,1,0,3,357,93,26798,29369,24904,1,35,1,-765,-2,278,8418,1,0,-1,0,10
EUW1_6872368410',1,21,19,2,0,0,0,13,1,341,104,30163,30426,36101,4,25,9,0,0,1,0,2,363,80,27042,27937,28884,1,-22,24,3121,10,2489,7217,2,0,-1,0,11
EUW1_6872357103',5,29,13,1,0,0,0,9,1,343,92,27190,28108,33177,6,26,13,1,0,0,0,2,334,98,27951,29083,29245,1,9,-6,-761,0,-975,3932,0,0,0,0,7
EUW1_6869440130',8,28,23,2,1,2,0,12,1,360,130,34495,33669,39655,6,31,10,0,0,2,0,3,300,48,25897,26659,33586,1,60,82,8598,13,7010,6069,2,1,0,0,9
EUW1_6869419468',4,26,13,2,0,2,0,5,1,349,92,29069,30044,31291,4,28,6,0,0,0,0,8,343,116,24489,28126,33114,1,6,-24,4580,7,1918,-1823,2,0,2,0,-3
EUW1_6869387526',3,27,14,1,1,0,0,11,0,348,88,28081,29247,32301,5,102,12,0,0,1,0,2,383,108,28104,30534,32446,0,-35,-20,-23,2,-1287,-145,1,1,-1,0,9
EUW1_6869354445',3,31,9,1,0,1,0,11,0,340,88,26995,27285,24130,4,24,19,1,0,2,0,8,323,79,29695,26834,29968,1,17,9,-2700,-10,451,-5838,0,0,-1,0,3
EUW1_6869335372',5,52,6,2,1,0,0,7,1,289,74,22756,25174,25641,1,26,5,0,0,1,0,2,373,105,25044,29151,29526,0,-84,-31,-2288,1,-3977,-3885,2,1,-1,0,5
EUW1_6869320128',7,34,14,0,0,1,0,10,1,301,100,27393,27700,29393,8,279,12,2,0,0,0,2,315,79,26195,26665,29882,0,-14,21,1198,2,1035,-489,-2,0,1,0,8
EUW1_6867733515',5,27,16,0,0,0,0,11,0,331,68,27351,28953,29866,4,52,16,1,0,1,0,3,339,90,30635,29112,29997,1,-8,-22,-3284,0,-159,-131,-1,0,-1,0,8
EUW1_6867703225',3,33,7,1,0,0,0,5,1,394,76,25636,29358,31536,7,29,5,0,0,1,0,1,366,84,24108,28652,25100,1,28,-8,1528,2,706,6436,1,0,-1,0,4
EUW1_6880108123',4,22,4,0,0,0,0,14,1,351,60,23381,26608,20495,7,38,14,2,1,1,0,1,388,86,28634,29784,29910,0,-37,-26,-5253,-10,-3176,-9415,-2,-1,-1,0,13
EUW1_6880024709',5,27,15,1,0,1,0,12,1,353,88,29778,29170,30774,4,22,14,1,0,3,0,5,341,90,31111,29440,35140,1,12,-2,-1333,1,-270,-4366,0,0,-2,0,7
EUW1_6879939035',6,26,5,1,0,0,0,8,1,398,108,24611,30673,34760,4,24,7,1,0,0,0,2,353,78,24483,30358,34949,0,45,30,128,-2,315,-189,0,0,0,0,6
EUW1_6879879284',7,31,9,1,0,0,0,10,1,369,92,26152,29218,24157,0,41,5,1,0,0,0,3,373,100,24104,28134,25214,1,-4,-8,2048,4,1084,-1057,0,0,0,0,7
EUW1_6879850712',3,62,17,2,0,2,0,5,1,376,103,31659,32608,37063,1,65,8,0,0,1,0,9,321,12,22448,23909,25944,1,55,91,9211,9,8699,11119,2,0,1,0,-4
EUW1_6879307338',7,36,14,1,0,0,0,5,0,365,84,28386,29673,44573,3,28,9,0,0,0,0,1,338,94,25910,27645,35442,1,27,-10,2476,5,2028,9131,1,0,0,0,4
EUW1_6879297951',5,29,17,0,0,0,0,13,0,318,79,28430,30572,37269,1,21,16,0,0,2,0,0,344,100,29153,30145,34835,1,-26,-21,-723,1,427,2434,0,0,-2,0,13
EUW1_6879292578',2,36,8,1,0,1,0,18,0,345,64,25259,27380,33643,5,25,23,1,0,3,0,2,367,111,33032,35043,42090,0,-22,-47,-7773,-15,-7663,-8447,0,0,-2,0,16
EUW1_6879277580',4,25,18,2,0,3,0,10,1,372,98,31434,32755,31786,1,36,7,0,0,0,0,6,350,107,24757,28334,24228,1,22,-9,6677,11,4421,7558,2,0,3,0,4
EUW1_6879259524',5,48,11,0,1,0,0,7,1,321,81,25106,27429,29814,4,153,11,2,0,1,0,2,355,88,26889,28717,23188,0,-34,-7,-1783,0,-1288,6626,-2,1,-1,0,5
EUW1_6879226233',3,24,13,1,1,1,0,6,1,378,112,29448,30301,31749,3,21,12,0,0,0,0,6,322,84,25827,29120,26723,1,56,28,3621,1,1181,5026,1,1,1,0,0
EUW1_6878966127',7,26,18,1,1,0,0,9,0,344,78,28979,31215,38549,6,22,13,0,0,1,0,4,358,105,28553,29729,29102,1,-14,-27,426,5,1486,9447,1,1,-1,0,5
EUW1_6878924852',6,28,13,2,0,2,0,7,1,290,84,29025,29024,37632,4,47,15,0,0,0,0,5,292,92,27082,27444,34543,1,-2,-8,1943,-2,1580,3089,2,0,2,0,2
EUW1_6878854716',3,39,18,0,0,1,0,9,1,323,92,29359,31305,35676,0,23,18,2,1,2,0,5,353,96,30532,32040,41750,1,-30,-4,-1173,0,-735,-6074,-2,-1,-1,0,4
EUW1_6878791235',3,23,9,0,0,0,0,9,1,340,108,25631,30826,29983,3,153,11,1,0,1,0,0,370,94,27771,29844,31494,0,-30,14,-2140,-2,982,-1511,-1,0,-1,0,9
EUW1_6876445185',1,37,16,0,0,2,0,9,1,373,71,29751,29186,32946,11,43,14,1,0,1,0,3,347,75,26980,29169,38281,1,26,-4,2771,2,17,-5335,-1,0,1,0,6
EUW1_6876443682',2,59,25,1,0,1,0,6,1,272,67,30299,29514,46834,3,29,17,0,0,0,0,2,326,78,29113,30114,44310,0,-54,-11,1186,8,-600,2524,1,0,1,0,4
EUW1_6880791975',5,33,11,0,0,0,0,16,1,330,76,26854,28103,32219,2,42,18,2,0,4,0,1,395,95,34398,32398,40926,0,-65,-19,-7544,-7,-4295,-8707,-2,0,-4,0,15
EUW1_6881074456',2,79,10,0,0,1,0,5,1,371,84,28517,28887,30740,4,26,13,0,0,1,0,9,332,91,27363,30068,32288,0,39,-7,1154,-3,-1181,-1548,0,0,0,0,-4
EUW1_6881030313',4,26,17,1,0,1,0,10,1,367,88,31636,30461,43703,2,26,16,0,0,1,0,6,311,84,28609,29068,41192,1,56,4,3027,1,1393,2511,1,0,0,0,4
EUW1_6880901808',0,30,16,1,1,2,0,10,1,383,104,29184,31037,31843,7,39,7,0,0,1,0,8,349,87,25370,28207,29012,1,34,17,3814,9,2830,2831,1,1,1,0,2
EUW1_6879520537',4,30,18,0,0,2,0,9,0,354,96,30764,31692,46232,3,46,12,1,0,1,0,6,361,64,26170,28093,35743,0,-7,32,4594,6,3599,10489,-1,0,1,0,3
EUW1_6879459517',2,30,12,0,1,0,0,8,1,361,90,30117,30004,28204,5,29,10,2,0,1,0,3,358,84,26076,28081,26606,1,3,6,4041,2,1923,1598,-2,1,-1,0,5
EUW1_6879431558',3,39,24,1,0,0,0,7,1,354,88,33113,32012,41851,5,35,14,0,0,1,0,4,371,80,29792,30351,39698,1,-17,8,3321,10,1661,2153,1,0,-1,0,3
EUW1_6879396298',6,33,5,0,0,0,0,6,1,419,104,24924,29998,18046,6,28,9,2,0,1,0,1,437,115,27487,32219,21002,0,-18,-11,-2563,-4,-2221,-2956,-2,0,-1,0,5
EUW1_6869304669',0,24,18,1,0,0,0,6,1,332,102,29110,31460,37968,3,29,8,1,0,1,0,6,344,101,26664,29760,33284,1,-12,1,2446,10,1700,4684,0,0,-1,0,0
EUW1_6867676887',0,24,14,1,0,0,0,10,0,310,87,26397,28001,27391,1,22,14,0,0,1,0,4,304,76,26370,27553,36481,0,6,11,27,0,448,-9090,1,0,-1,0,6
EUW1_6867647327',3,34,10,0,0,0,0,7,1,336,64,24809,26518,25943,1,29,13,2,0,2,0,3,338,100,26825,29541,31318,0,-2,-36,-2016,-3,-3023,-5375,-2,0,-2,0,4
EUW1_6866995385',2,30,10,1,0,1,0,9,1,369,62,27545,28693,23077,6,58,7,0,0,1,0,5,387,97,26225,28421,28675,0,-18,-35,1320,3,272,-5598,1,0,0,0,4
EUW1_6858836231',4,28,17,1,0,2,0,12,0,332,92,31702,29563,39486,4,28,10,0,0,1,0,5,344,96,27402,28214,29516,0,-12,-4,4300,7,1349,9970,1,0,1,0,7
EUW1_6858777290',3,37,14,1,0,1,0,14,1,393,84,30922,29675,35661,4,27,11,0,0,2,0,6,377,78,28047,29718,31923,0,16,6,2875,3,-43,3738,1,0,-1,0,8
EUW1_6858428317',3,31,10,0,0,0,0,10,1,312,98,25490,27715,26704,5,34,16,2,0,1,0,2,365,82,28417,29074,36462,0,-53,16,-2927,-6,-1359,-9758,-2,0,-1,0,8
EUW1_6858368809',5,32,11,1,0,0,0,8,0,387,90,27433,32178,29122,3,31,11,1,0,1,0,3,366,98,27863,30507,28715,1,21,-8,-430,0,1671,407,0,0,-1,0,5
EUW1_6858321638',5,30,16,1,0,0,0,5,0,347,92,29639,29496,30961,4,28,11,1,0,2,0,5,379,92,27595,28265,31518,1,-32,0,2044,5,1231,-557,0,0,-2,0,0
EUW1_6856164626',0,87,10,0,0,0,0,11,0,333,82,26424,26770,26440,5,30,24,2,0,1,0,4,375,95,32361,30744,35230,0,-42,-13,-5937,-14,-3974,-8790,-2,0,-1,0,7
EUW1_6856106995',3,46,19,0,0,2,0,7,1,367,104,31750,32606,41317,7,33,16,2,0,0,0,7,314,64,28161,28472,40831,0,53,40,3589,3,4134,486,-2,0,2,0,0
EUW1_6883363234',7,43,16,2,0,0,0,2,1,324,90,29123,30152,40706,5,67,14,0,0,0,0,2,347,78,26598,27092,45317,1,-23,12,2525,2,3060,-4611,2,0,0,0,0
EUW1_6883314630',8,30,19,0,0,0,0,9,0,329,90,30781,31361,40284,7,54,15,2,1,1,0,0,376,90,30682,30593,40225,0,-47,0,99,4,768,59,-2,-1,-1,0,9
EUW1_6883238834',6,41,9,0,0,2,0,6,1,418,91,28331,29845,30870,5,97,10,2,0,0,0,10,343,92,26235,29968,28178,1,75,-1,2096,-1,-123,2692,-2,0,2,0,-4
EUW1_6883179993',5,28,10,0,1,0,0,7,0,426,104,27533,29807,29592,7,35,17,2,0,1,0,2,389,96,30371,31802,32387,0,37,8,-2838,-7,-1995,-2795,-2,1,-1,0,5
EUW1_6883136485',5,45,4,0,0,0,0,10,0,365,78,23178,26211,30238,4,80,15,2,0,1,0,0,411,115,31044,32682,29645,0,-46,-37,-7866,-11,-6471,593,-2,0,-1,0,10
EUW1_6883073014',3,32,7,0,0,0,0,11,1,375,76,24574,26945,25369,4,38,15,2,0,1,0,1,409,82,29974,30772,39984,0,-34,-6,-5400,-8,-3827,-14615,-2,0,-1,0,10
EUW1_6882025388',2,27,13,0,0,0,0,13,1,341,86,28201,28945,35419,4,34,18,2,0,2,0,0,360,57,30686,28651,34682,0,-19,29,-2485,-5,294,737,-2,0,-2,0,13
EUW1_6881966771',4,28,8,0,0,0,0,11,1,351,102,25141,28259,27843,5,28,11,1,0,1,0,0,396,102,27958,31394,30568,0,-45,0,-2817,-3,-3135,-2725,-1,0,-1,0,11
EUW1_6881893422',4,28,11,0,0,1,0,11,0,389,76,27617,29077,30264,5,34,17,2,0,1,0,4,425,116,30928,33840,41582,0,-36,-40,-3311,-6,-4763,-11318,-2,0,0,0,7
EUW1_6880689392',4,28,9,0,1,0,0,11,1,356,95,26595,29460,36307,1,25,17,2,0,0,0,4,408,112,30019,32547,45294,0,-52,-17,-3424,-8,-3087,-8987,-2,1,0,0,7
EUW1_6880673524',3,26,17,1,1,0,0,6,1,376,71,28344,30453,37058,2,33,11,0,0,0,0,2,374,85,27708,29879,35610,1,2,-14,636,6,574,1448,1,1,0,0,4
EUW1_6880634458',3,259,18,1,0,1,0,11,1,376,89,31881,31346,33329,1,43,16,1,0,1,0,9,366,69,30072,30560,37679,0,10,20,1809,2,786,-4350,0,0,0,0,2
EUW1_6880575446',3,28,13,1,0,1,0,6,0,416,82,28965,31346,26745,3,32,12,1,0,0,0,0,372,94,27242,29943,27516,0,44,-12,1723,1,1403,-771,0,0,1,0,6
EUW1_6880522368',5,27,15,1,1,2,0,8,1,375,111,30344,30756,35560,2,26,10,0,0,1,0,3,369,92,27215,28242,27757,1,6,19,3129,5,2514,7803,1,1,1,0,5
EUW1_6880448042',5,31,14,0,0,0,0,5,0,380,77,28505,29832,38328,8,32,18,1,0,0,0,2,328,87,29217,29703,35474,1,52,-10,-712,-4,129,2854,-1,0,0,0,3
EUW1_6880369406',5,32,16,1,0,1,0,10,0,352,93,28702,30592,31015,2,55,7,1,0,1,0,3,375,90,26610,28447,27512,1,-23,3,2092,9,2145,3503,0,0,0,0,7
EUW1_6880325666',4,26,8,1,0,0,0,4,1,360,82,25415,28113,28406,8,30,14,1,0,0,0,5,364,86,27116,31220,33491,0,-4,-4,-1701,-6,-3107,-5085,0,0,0,0,-1
EUW1_6880237184',1,19,6,0,0,0,0,5,0,375,74,23943,28485,24637,4,29,13,1,0,0,0,1,378,88,27277,30090,37246,1,-3,-14,-3334,-7,-1605,-12609,-1,0,0,0,4
EUW1_6879255857',3,25,16,0,1,1,0,9,0,348,77,29862,30868,39863,5,26,18,0,0,0,0,4,357,82,30087,29970,42689,1,-9,-5,-225,-2,898,-2826,0,1,1,0,5
EUW1_6879216902',4,26,14,0,0,2,0,11,0,376,81,29313,29986,27942,3,26,14,2,0,1,0,6,376,82,28121,28613,32492,1,0,-1,1192,0,1373,-4550,-2,0,1,0,5
EUW1_6883239337',4,34,11,0,1,0,0,9,1,357,98,27371,29061,36756,1,27,10,2,0,1,0,2,325,98,25857,28240,28746,1,32,0,1514,1,821,8010,-2,1,-1,0,7
EUW1_6883180198',0,29,14,2,0,0,0,9,0,351,95,26398,27746,31157,2,25,15,0,1,1,0,1,334,72,28764,28015,30480,0,17,23,-2366,-1,-269,677,2,-1,-1,0,8
EUW1_6883126869',4,23,11,0,1,1,0,8,0,344,80,27325,28307,27911,3,27,13,1,0,1,0,5,342,76,28155,28718,35781,0,2,4,-830,-2,-411,-7870,-1,1,0,0,3
EUW1_6883075565',5,36,16,0,0,0,0,10,0,346,74,28160,28642,35986,5,28,16,2,0,1,0,4,345,92,28657,28328,33715,0,1,-18,-497,0,314,2271,-2,0,-1,0,6
EUW1_6882972834',5,30,12,2,0,1,0,11,0,436,97,29383,32527,28049,5,33,7,0,0,1,0,4,403,80,26430,28233,23607,0,33,17,2953,5,4294,4442,2,0,0,0,7
EUW1_6882049786',7,27,8,2,0,1,0,6,1,385,88,25635,28695,27396,4,29,12,0,0,0,0,5,378,60,25788,30308,31684,1,7,28,-153,-4,-1613,-4288,2,0,1,0,1
EUW1_6881982209',5,40,10,0,0,1,0,5,1,403,85,28660,29784,24116,3,30,12,1,0,0,0,6,398,89,27661,31333,33400,1,5,-4,999,-2,-1549,-9284,-1,0,1,0,-1
EUW1_6881932641',1,26,9,1,0,0,0,15,0,317,52,24191,25880,24348,2,32,25,1,1,4,0,2,390,106,37031,33957,47099,0,-73,-54,-12840,-16,-8077,-22751,0,-1,-4,0,13
EUW1_6881399845',2,27,22,1,0,0,0,11,0,334,104,31497,30915,37720,5,32,16,1,0,2,0,5,379,71,29493,28417,31949,0,-45,33,2004,6,2498,5771,0,0,-2,0,6
EUW1_6881348137',2,29,13,2,0,1,0,10,1,356,110,28991,31009,34827,2,28,13,0,0,1,0,5,376,93,28302,31329,35616,0,-20,17,689,0,-320,-789,2,0,0,0,5
EUW1_6881289780',1,27,7,1,0,0,0,9,0,387,100,26119,31460,30205,3,37,10,0,0,1,0,6,349,96,26257,29935,24760,1,38,4,-138,-3,1525,5445,1,0,-1,0,3
EUW1_6881222355',5,35,11,0,0,0,0,6,1,371,102,27021,30130,29242,3,31,14,1,1,1,0,1,369,81,28628,31354,31911,0,2,21,-1607,-3,-1224,-2669,-1,-1,-1,0,5
EUW1_6881179426',3,41,20,1,0,3,0,11,1,349,76,32604,31477,41141,5,30,17,0,0,1,0,3,358,84,29779,29598,34689,1,-9,-8,2825,3,1879,6452,1,0,2,0,8
EUW1_6881140593',2,156,11,0,0,1,0,11,0,370,84,28370,31069,32422,7,70,16,1,0,2,0,1,363,85,29556,31718,35521,0,7,-1,-1186,-5,-649,-3099,-1,0,-1,0,10
EUW1_6877707275',0,29,12,1,0,0,0,6,0,343,72,27219,27404,28046,1,27,17,1,0,0,0,4,371,86,29607,29842,36157,1,-28,-14,-2388,-5,-2438,-8111,0,0,0,0,2
EUW1_6877678480',6,23,20,1,0,0,0,11,0,336,96,30480,29564,41043,3,25,19,1,0,1,0,4,328,72,31269,28247,39732,0,8,24,-789,1,1317,1311,0,0,-1,0,7
EUW1_6877631265',2,30,5,1,0,0,0,14,0,373,68,24322,28305,25017,5,37,20,1,0,4,0,0,464,103,34204,34377,40389,0,-91,-35,-9882,-15,-6072,-15372,0,0,-4,0,14
EUW1_6877589680',2,421,7,1,0,2,0,8,0,389,95,26776,29204,26940,4,99,12,0,1,1,0,5,345,99,27438,30740,34469,1,44,-4,-662,-5,-1536,-7529,1,-1,1,0,3
EUW1_6877525233',7,26,16,2,1,3,0,6,0,391,96,32019,32613,37897,1,85,7,0,0,0,0,7,406,95,25821,29445,35180,1,-15,1,6198,9,3168,2717,2,1,3,0,-1
EUW1_6877469682',4,32,17,2,0,1,0,6,1,374,74,31748,29833,38209,4,27,15,0,0,2,0,9,341,77,26939,28409,33406,1,33,-3,4809,2,1424,4803,2,0,-1,0,-3
EUW1_6882649661',2,26,10,1,0,0,0,14,0,298,84,24100,26662,27865,3,45,23,1,0,2,0,0,386,96,33297,34102,44201,0,-88,-12,-9197,-13,-7440,-16336,0,0,-2,0,14
EUW1_6882333643',4,23,28,1,1,7,2,9,1,352,92,37731,31824,48037,2,39,4,0,0,0,0,12,323,71,22319,23899,25104,1,29,21,15412,24,7925,22933,1,1,7,2,-3
EUW1_6882313116',4,24,25,1,1,1,0,9,1,376,72,34103,32983,41216,5,32,7,1,0,1,0,7,373,82,25384,27154,38119,1,3,-10,8719,18,5829,3097,0,1,0,0,2
EUW1_6882299207',2,31,16,1,0,1,0,10,1,320,95,28549,29635,38439,2,330,12,1,0,3,0,4,399,68,30437,28855,36196,1,-79,27,-1888,4,780,2243,0,0,-2,0,6
EUW1_6880783131',7,28,19,0,0,0,0,16,0,339,74,30325,29829,36573,1,25,25,2,0,1,0,1,353,78,32988,30101,51778,0,-14,-4,-2663,-6,-272,-15205,-2,0,-1,0,15
EUW1_6878737507',7,25,18,0,1,2,0,5,1,338,94,30570,30362,32130,7,31,14,2,0,0,0,7,349,122,28296,30022,36435,0,-11,-28,2274,4,340,-4305,-2,1,2,0,-2
EUW1_6875081513',3,143,14,1,0,1,0,9,0,348,95,28866,28858,33419,5,30,11,1,0,0,0,4,279,88,24303,26437,26508,1,69,7,4563,3,2421,6911,0,0,1,0,5
EUW1_6871697335',3,25,14,1,0,1,0,11,1,356,97,28885,30435,31509,1,35,8,1,0,1,0,4,359,70,26006,26589,29692,1,-3,27,2879,6,3846,1817,0,0,0,0,7
EUW1_6871625566',1,29,15,1,0,1,0,11,1,329,86,29168,29795,35433,3,24,14,0,0,0,0,4,316,78,26733,26562,38706,1,13,8,2435,1,3233,-3273,1,0,1,0,7
EUW1_6871575761',1,55,8,1,0,0,0,14,0,355,90,25855,28142,27174,4,66,20,1,1,4,0,0,387,113,34574,34487,38466,0,-32,-23,-8719,-12,-6345,-11292,0,-1,-4,0,14
EUW1_6871516652',3,30,9,1,0,1,0,11,0,384,96,26661,31266,31592,6,28,9,0,0,1,0,6,384,88,26507,30104,27431,0,0,8,154,0,1162,4161,1,0,0,0,5
EUW1_6870155776',6,31,11,0,0,1,0,17,1,370,78,28862,30841,29537,2,51,13,2,0,2,0,4,371,83,29458,28642,30118,0,-1,-5,-596,-2,2199,-581,-2,0,-1,0,13
EUW1_6870084496',3,30,14,2,0,1,0,10,1,344,96,28405,29399,27964,8,89,17,0,0,0,0,3,354,75,29270,28892,34621,1,-10,21,-865,-3,507,-6657,2,0,1,0,7
EUW1_6869250576',0,23,11,1,0,2,0,6,1,353,101,28386,30161,29042,6,23,11,0,0,1,0,6,380,106,27444,32056,28958,1,-27,-5,942,0,-1895,84,1,0,1,0,0
EUW1_6869223893',5,68,12,2,0,1,0,11,1,379,68,27723,30635,28586,0,69,9,0,0,0,0,0,361,120,26580,28907,28253,1,18,-52,1143,3,1728,333,2,0,1,0,11
EUW1_6867654500',4,25,9,1,0,0,0,8,0,351,89,24216,28367,28884,1,29,17,0,1,1,0,1,376,92,29749,30942,36072,0,-25,-3,-5533,-8,-2575,-7188,1,-1,-1,0,7
EUW1_6867639102',3,24,8,0,0,0,0,16,0,357,92,25591,29516,28356,4,46,22,2,0,3,0,0,393,108,34425,35505,38663,0,-36,-16,-8834,-14,-5989,-10307,-2,0,-3,0,16
EUW1_6865599665',5,27,8,1,0,1,0,6,1,409,86,27054,28997,27153,4,35,5,1,1,1,0,3,385,78,24158,28290,19864,1,24,8,2896,3,707,7289,0,-1,0,0,3
EUW1_6882591416',5,30,15,0,0,0,0,7,1,380,84,28051,30630,34818,6,34,10,1,0,0,0,3,367,79,26314,29188,32248,1,13,5,1737,5,1442,2570,-1,0,0,0,4
EUW1_6871155679',5,50,7,1,0,0,0,11,0,391,70,25709,30039,26639,2,31,13,0,0,1,0,3,370,109,28722,31633,38537,0,21,-39,-3013,-6,-1594,-11898,1,0,-1,0,8
EUW1_6869954319',2,33,12,1,0,0,0,10,0,367,90,27311,30091,31711,6,88,16,1,0,1,0,4,428,77,31201,31896,41454,0,-61,13,-3890,-4,-1805,-9743,0,0,-1,0,6
EUW1_6867985543',7,37,14,0,0,0,0,12,0,281,80,27411,25542,36860,4,36,23,1,0,3,0,2,363,85,33026,29795,45179,0,-82,-5,-5615,-9,-4253,-8319,-1,0,-3,0,10
EUW1_6867930808',7,92,9,1,1,0,0,10,1,368,106,26754,30548,36804,3,37,7,1,0,1,0,3,385,84,26169,29323,30546,0,-17,22,585,2,1225,6258,0,1,-1,0,7
EUW1_6866842294',10,48,4,0,0,0,0,7,0,372,96,23375,26997,19976,5,35,10,1,0,1,0,0,444,103,28112,31538,28348,0,-72,-7,-4737,-6,-4541,-8372,-1,0,-1,0,7
EUW1_6866765409',1,23,13,0,0,0,0,6,1,328,66,26259,27421,25602,5,31,14,1,0,2,0,3,399,98,29623,31119,37718,0,-71,-32,-3364,-1,-3698,-12116,-1,0,-2,0,3
EUW1_6866724834',9,36,11,1,0,0,0,10,1,369,100,26451,29055,26404,3,37,7,0,0,0,0,2,416,84,26122,30302,32732,1,-47,16,329,4,-1247,-6328,1,0,0,0,8
EUW1_6856624048',4,20,10,1,0,0,0,13,1,315,99,25255,28184,27529,1,22,14,0,0,2,0,2,354,77,28545,31018,36538,1,-39,22,-3290,-4,-2834,-9009,1,0,-2,0,11
EUW1_6851299057',1,26,7,0,0,0,0,10,0,352,113,25902,28989,29375,5,40,17,2,0,1,0,2,402,97,30748,31944,37106,0,-50,16,-4846,-10,-2955,-7731,-2,0,-1,0,8
EUW1_6848509721',5,31,6,1,0,0,0,7,0,338,98,23862,27047,32028,5,36,10,1,0,0,0,0,347,96,25488,29136,32379,0,-9,2,-1626,-4,-2089,-351,0,0,0,0,7
EUW1_6848338613',3,33,11,1,0,1,0,12,1,383,94,28385,31015,29146,3,31,14,1,0,3,0,5,388,87,29883,29654,33332,0,-5,7,-1498,-3,1361,-4186,0,0,-2,0,7
EUW1_6848289177',3,28,16,1,0,2,0,8,1,414,100,31192,32514,40851,7,34,10,0,0,0,0,4,367,80,26379,29867,34631,1,47,20,4813,6,2647,6220,1,0,2,0,4
EUW1_6843588844',6,30,7,0,0,0,0,14,0,342,84,24778,27307,25538,6,31,18,1,0,2,0,0,416,89,31744,32307,40577,0,-74,-5,-6966,-11,-5000,-15039,-1,0,-2,0,14
EUW1_6843568703',3,58,10,0,0,1,0,13,1,344,93,27077,28930,31641,0,31,9,2,0,1,0,2,373,124,27389,31151,28885,0,-29,-31,-312,1,-2221,2756,-2,0,0,0,11
EUW1_6843555713',6,59,18,0,0,1,0,11,0,312,84,30467,27445,36834,3,63,19,1,1,1,0,4,333,80,31331,29208,40960,0,-21,4,-864,-1,-1763,-4126,-1,-1,0,0,7
EUW1_6843532680',4,33,4,0,0,0,0,8,0,400,90,24720,28435,21547,4,43,7,2,0,1,0,0,431,98,27391,30349,24810,1,-31,-8,-2671,-3,-1914,-3263,-2,0,-1,0,8
EUW1_6843450547',8,29,11,0,0,0,0,7,0,375,77,27803,28197,35385,6,30,15,2,0,0,0,4,381,82,28276,30122,37911,0,-6,-5,-473,-4,-1925,-2526,-2,0,0,0,3
EUW1_6883756045',3,45,17,1,0,3,0,11,1,361,138,32367,32977,38824,6,34,14,0,0,1,0,7,369,73,29457,31943,36177,1,-8,65,2910,3,1034,2647,1,0,2,0,4
EUW1_6883192764',3,29,17,0,0,3,0,10,1,340,106,31840,30820,34669,2,24,10,1,0,0,0,8,315,101,25435,27974,29536,1,25,5,6405,7,2846,5133,-1,0,3,0,2
EUW1_6883130824',2,28,11,1,0,0,0,13,1,365,72,27793,30057,32011,6,32,17,1,1,2,0,1,388,108,30894,32502,40372,0,-23,-36,-3101,-6,-2445,-8361,0,-1,-2,0,12
EUW1_6883084080',3,29,13,2,0,0,0,5,1,359,76,27046,29633,24878,2,30,8,0,0,0,0,2,360,107,25578,29253,28824,1,-1,-31,1468,5,380,-3946,2,0,0,0,3
EUW1_6882981141',4,27,7,2,0,0,0,6,1,394,87,24857,29820,26190,0,23,6,0,0,0,0,0,399,100,25476,31102,26385,0,-5,-13,-619,1,-1282,-195,2,0,0,0,6
EUW1_6882752812',1,30,15,0,0,1,0,8,1,401,89,30436,33069,36365,2,23,13,1,0,0,0,4,329,114,26992,29815,31489,1,72,-25,3444,2,3254,4876,-1,0,1,0,4
EUW1_6882706687',2,24,10,0,0,0,0,8,1,396,81,26240,30063,27014,9,36,8,2,0,0,0,4,371,94,26089,28279,20936,0,25,-13,151,2,1784,6078,-2,0,0,0,4
EUW1_6882661260',6,208,17,0,0,1,0,8,0,325,75,29850,29954,34786,6,29,13,2,0,1,0,6,337,88,27865,28628,29777,1,-12,-13,1985,4,1326,5009,-2,0,0,0,2
EUW1_6882628749',4,43,8,1,0,0,0,10,1,390,92,26842,29019,24659,6,28,7,1,1,2,0,3,378,107,26086,29282,26296,1,12,-15,756,1,-263,-1637,0,-1,-2,0,7
EUW1_6882477322',4,26,10,0,0,0,0,11,1,347,89,25955,29521,33109,0,96,14,2,1,1,0,1,355,90,28228,32986,33701,0,-8,-1,-2273,-4,-3465,-592,-2,-1,-1,0,10
EUW1_6882455378',1,64,7,0,0,0,0,10,0,332,106,24795,27488,26757,3,98,18,1,1,2,0,1,392,85,31770,33501,43841,0,-60,21,-6975,-11,-6013,-17084,-1,-1,-2,0,9
EUW1_6882443716',3,28,14,0,0,0,0,11,1,363,89,28780,29987,33993,2,40,14,1,0,1,0,6,391,89,29330,30843,34357,0,-28,0,-550,0,-856,-364,-1,0,-1,0,5
EUW1_6882421861',8,36,9,0,0,0,0,7,0,400,80,27132,29643,29627,4,32,11,2,0,0,0,2,386,72,26895,28334,28317,0,14,8,237,-2,1309,1310,-2,0,0,0,5
EUW1_6882382518',4,79,16,1,0,1,0,10,0,367,76,30609,30203,34184,3,27,17,1,0,1,0,4,399,100,30216,31566,32651,1,-32,-24,393,-1,-1363,1533,0,0,0,0,6
EUW1_6882367577',4,92,12,0,0,0,0,17,0,326,90,27572,27466,30809,11,41,17,2,0,3,0,3,353,85,30877,30182,37021,0,-27,5,-3305,-5,-2716,-6212,-2,0,-3,0,14
EUW1_6882352225',1,57,3,0,0,0,0,15,1,319,91,22755,25504,23623,6,65,19,2,0,4,0,2,394,79,32224,31549,33400,0,-75,12,-9469,-16,-6045,-9777,-2,0,-4,0,13
EUW1_6882339972',4,25,11,1,0,1,0,8,0,358,82,26692,27749,38671,3,38,9,1,0,0,0,5,303,84,24211,27807,29109,1,55,-2,2481,2,-58,9562,0,0,1,0,3
EUW1_6882325299',5,24,11,1,0,0,0,7,0,341,92,27174,31322,30081,6,32,12,1,0,1,0,1,412,91,27643,31474,34833,0,-71,1,-469,-1,-152,-4752,0,0,-1,0,6
EUW1_6881324511',3,29,16,0,0,0,0,7,1,349,77,28073,29824,34738,5,29,16,1,1,0,0,3,347,84,27821,30698,31095,0,2,-7,252,0,-874,3643,-1,-1,0,0,4
EUW1_6881258166',2,38,15,2,0,0,0,8,1,364,90,29736,30051,34389,3,33,12,0,0,1,0,6,354,92,27853,29375,35607,1,10,-2,1883,3,676,-1218,2,0,-1,0,2
EUW1_6883648043',0,21,5,0,0,0,0,11,1,312,86,21964,26921,29074,5,34,12,2,0,3,0,0,390,78,28841,31034,40082,0,-78,8,-6877,-7,-4113,-11008,-2,0,-3,0,11
EUW1_6883635463',1,21,12,0,0,0,0,11,0,373,95,27560,31062,34775,0,23,14,2,0,3,0,0,354,92,30012,31817,37743,0,19,3,-2452,-2,-755,-2968,-2,0,-3,0,11
EUW1_6883606748',1,24,18,1,0,0,0,12,1,355,102,30057,31312,35528,2,31,12,0,0,2,0,5,367,73,28526,30744,33112,1,-12,29,1531,6,568,2416,1,0,-2,0,7
EUW1_6883450937',4,30,10,2,0,1,0,13,0,381,80,28594,30579,29294,4,29,7,0,0,3,0,6,432,88,27608,29804,21859,1,-51,-8,986,3,775,7435,2,0,-2,0,7
EUW1_6869269962',5,26,20,1,0,0,0,6,0,340,82,30096,29903,43514,1,29,15,1,0,0,0,5,350,80,26997,29203,38070,1,-10,2,3099,5,700,5444,0,0,0,0,1
EUW1_6867789182',3,56,14,2,0,1,0,9,0,360,88,28290,29124,33041,3,31,12,0,0,1,0,1,406,60,27394,28066,33427,1,-46,28,896,2,1058,-386,2,0,0,0,8
EUW1_6867762769',1,43,19,1,0,2,0,7,0,393,90,31256,31910,36995,4,35,8,1,0,0,0,6,349,92,25235,26174,27616,1,44,-2,6021,11,5736,9379,0,0,2,0,1
EUW1_6867736765',6,35,7,0,0,0,0,11,0,332,80,25062,25634,29275,3,99,18,0,0,1,0,0,397,94,29041,30438,34038,0,-65,-14,-3979,-11,-4804,-4763,0,0,-1,0,11
EUW1_6882943713',5,26,13,0,0,0,0,8,1,321,78,27347,29291,32457,1,24,18,1,0,0,0,5,354,102,29863,31098,39649,0,-33,-24,-2516,-5,-1807,-7192,-1,0,0,0,3
EUW1_6882887628',4,49,16,2,0,0,0,10,1,367,95,29388,30877,36411,0,26,14,0,0,0,0,0,381,82,28245,29234,29748,1,-14,13,1143,2,1643,6663,2,0,0,0,10
EUW1_6882791132',4,25,11,1,0,1,0,10,0,337,99,27404,30757,36499,1,21,16,1,1,2,0,4,392,111,31947,31928,33996,1,-55,-12,-4543,-5,-1171,2503,0,-1,-1,0,6
EUW1_6882753680',1,21,8,1,0,0,0,12,0,299,101,24943,28692,29015,4,26,18,1,0,3,0,1,379,103,31983,32031,37192,0,-80,-2,-7040,-10,-3339,-8177,0,0,-3,0,11
EUW1_6882694198',2,27,6,0,0,1,0,10,1,374,109,26330,29122,25965,2,19,12,2,1,0,0,4,347,113,27215,30969,25321,0,27,-4,-885,-6,-1847,644,-2,-1,1,0,6
EUW1_6882619278',2,280,6,0,0,1,0,7,0,368,92,24621,28771,28087,2,31,14,2,0,0,0,4,327,96,26601,31519,36283,0,41,-4,-1980,-8,-2748,-8196,-2,0,1,0,3
EUW1_6882583200',7,28,20,1,1,1,0,7,1,376,104,32542,32167,38817,1,18,9,1,0,1,0,6,331,72,24186,27247,23639,1,45,32,8356,11,4920,15178,0,1,0,0,1
EUW1_6882555991',1,26,13,1,0,1,0,11,0,350,76,28761,31064,34454,8,99,15,0,1,1,0,5,375,103,30697,33284,31079,0,-25,-27,-1936,-2,-2220,3375,1,-1,0,0,6
EUW1_6882524474',5,26,10,2,0,2,0,4,1,371,115,28076,31394,33119,1,27,8,0,0,1,0,6,358,80,25931,28936,33347,1,13,35,2145,2,2458,-228,2,0,1,0,-2
EUW1_6882501970',4,45,17,2,0,3,0,7,1,398,75,32790,31583,40537,3,80,6,0,0,0,0,10,343,86,23876,26839,22371,1,55,-11,8914,11,4744,18166,2,0,3,0,-3
EUW1_6881701179',3,27,1,0,0,0,0,10,0,388,95,22503,27597,18611,1,22,8,2,0,1,0,2,405,92,26565,30141,27480,0,-17,3,-4062,-7,-2544,-8869,-2,0,-1,0,8
EUW1_6881074684',2,112,15,0,0,0,0,13,1,302,87,27711,31125,36068,3,30,12,2,0,2,0,1,395,85,28989,30004,33673,0,-93,2,-1278,3,1121,2395,-2,0,-2,0,12
EUW1_6881031118',4,30,9,1,0,0,0,8,0,331,87,25198,28393,25403,1,30,15,0,1,0,0,5,351,84,28836,31154,31881,0,-20,3,-3638,-6,-2761,-6478,1,-1,0,0,3
EUW1_6880994890',5,31,13,1,0,0,0,9,1,352,78,28638,29496,33264,3,89,17,0,0,2,0,3,358,68,30573,31149,37572,0,-6,10,-1935,-4,-1653,-4308,1,0,-2,0,6
EUW1_6880961609',3,23,16,1,0,0,0,11,1,365,97,29492,30138,33825,2,86,13,0,0,1,0,1,389,82,28646,29140,29479,1,-24,15,846,3,998,4346,1,0,-1,0,10
EUW1_6879445555',4,26,5,1,1,2,0,3,1,383,97,25829,29936,21257,4,38,9,1,0,0,0,4,381,88,25503,30186,28572,1,2,9,326,-4,-250,-7315,0,1,2,0,-1
EUW1_6879387391',4,27,22,1,0,2,0,9,1,334,99,31902,31768,44776,3,32,14,0,0,1,0,7,353,63,28457,29050,34966,1,-19,36,3445,8,2718,9810,1,0,1,0,2
EUW1_6879364906',4,35,14,2,0,0,0,11,0,393,90,27778,30966,27839,3,26,16,0,0,1,0,4,361,118,29613,32217,33951,0,32,-28,-1835,-2,-1251,-6112,2,0,-1,0,7
EUW1_6869813408',3,44,10,0,0,0,0,9,0,358,88,26671,29942,40275,3,24,14,2,0,1,0,7,346,92,28604,30370,40322,0,12,-4,-1933,-4,-428,-47,-2,0,-1,0,2
EUW1_6869737868',6,25,18,0,1,0,0,12,1,319,90,29414,30037,38135,2,26,14,1,0,2,0,6,360,97,28141,30745,34315,0,-41,-7,1273,4,-708,3820,-1,1,-2,0,6
EUW1_6869682382',1,27,8,0,1,1,0,11,0,355,97,26293,30057,23175,4,96,14,2,0,1,0,6,359,76,29160,31468,33699,0,-4,21,-2867,-6,-1411,-10524,-2,1,0,0,5
EUW1_6869631066',3,27,12,1,0,0,0,8,1,405,76,27384,29464,29542,4,25,11,1,0,0,0,1,389,74,27337,31123,33442,0,16,2,47,1,-1659,-3900,0,0,0,0,7
EUW1_6883063607',2,25,25,1,0,4,0,7,0,389,94,35826,31518,46014,1,21,13,0,0,0,0,10,280,70,26794,27042,30610,1,109,24,9032,12,4476,15404,1,0,4,0,-3
EUW1_6882997909',4,27,16,1,0,0,0,12,1,300,70,27803,26253,33693,3,25,22,1,0,1,0,3,348,106,33380,30727,40684,0,-48,-36,-5577,-6,-4474,-6991,0,0,-1,0,9
EUW1_6882941778',3,27,19,0,0,0,0,10,1,308,93,31503,32046,40793,5,28,19,2,0,2,0,4,336,98,30946,28902,36872,0,-28,-5,557,0,3144,3921,-2,0,-2,0,6
EUW1_6882895759',0,23,3,0,0,0,0,8,0,385,92,24154,28506,21720,6,43,12,2,0,0,0,4,347,96,27256,29640,28725,0,38,-4,-3102,-9,-1134,-7005,-2,0,0,0,4
EUW1_6882700184',3,136,15,0,0,2,0,10,1,348,98,30549,28888,30823,3,25,10,2,0,0,0,10,352,80,26327,28961,28182,1,-4,18,4222,5,-73,2641,-2,0,2,0,0
EUW1_6882678924',2,28,13,1,0,2,0,5,0,369,103,30060,29809,29554,4,29,10,1,0,0,0,8,341,75,26458,27706,26102,1,28,28,3602,3,2103,3452,0,0,2,0,-3
EUW1_6882645105',2,26,7,0,0,1,0,8,0,359,86,27057,28741,26577,6,26,14,2,0,2,0,6,337,98,27875,29515,32028,1,22,-12,-818,-7,-774,-5451,-2,0,-1,0,2
EUW1_6882621685',4,66,12,0,0,1,0,11,0,395,73,28482,31067,33178,5,62,15,2,0,2,0,2,375,103,30426,30293,36881,0,20,-30,-1944,-3,774,-3703,-2,0,-1,0,9
EUW1_6882584492',1,24,3,2,0,1,0,8,0,406,90,25751,29905,22897,0,19,6,0,0,0,0,7,357,74,23653,28526,18646,1,49,16,2098,-3,1379,4251,2,0,1,0,1
EUW1_6882546089',0,174,11,1,0,3,0,10,1,395,113,29790,31265,34281,1,92,9,0,0,1,0,5,385,90,26038,30229,24148,0,10,23,3752,2,1036,10133,1,0,2,0,5
EUW1_6882519178',4,37,16,0,0,1,0,14,1,337,83,29765,27719,29791,3,40,17,2,0,1,0,4,318,76,29678,27630,29976,1,19,7,87,-1,89,-185,-2,0,0,0,10
EUW1_6882489615',7,30,16,1,0,2,0,11,0,340,70,29678,27837,36971,8,32,17,1,0,2,0,6,296,100,29454,28700,34228,0,44,-30,224,-1,-863,2743,0,0,0,0,5
EUW1_6881954247',2,28,14,1,0,2,0,8,1,327,80,29283,27964,34435,5,22,15,1,0,0,0,7,355,76,28465,29373,38468,0,-28,4,818,-1,-1409,-4033,0,0,2,0,1
EUW1_6881630171',3,27,13,1,0,0,0,9,1,366,86,27461,28959,25822,4,30,9,1,1,1,0,4,371,106,27812,30006,33111,1,-5,-20,-351,4,-1047,-7289,0,-1,-1,0,5
EUW1_6881582467',2,30,20,2,0,0,0,11,1,392,90,31219,32462,40427,2,29,5,0,0,1,0,3,362,86,23606,27067,26596,1,30,4,7613,15,5395,13831,2,0,-1,0,8
EUW1_6881507804',3,31,13,2,0,1,0,9,0,361,102,29231,30643,30219,4,83,12,0,0,1,0,7,338,95,27087,29803,28520,1,23,7,2144,1,840,1699,2,0,0,0,2
EUW1_6881410916',5,28,17,2,0,0,0,4,0,309,102,29433,29269,36493,1,19,8,0,0,1,0,8,321,60,22398,24442,35736,1,-12,42,7035,9,4827,757,2,0,-1,0,-4
EUW1_6881365500',3,27,12,0,1,2,0,4,1,401,110,28809,30711,30780,1,22,6,1,0,0,0,6,349,92,23526,28211,23348,1,52,18,5283,6,2500,7432,-1,1,2,0,-2
EUW1_6883713968',5,33,16,0,0,1,0,10,1,359,72,28359,28906,34277,7,35,18,0,0,2,0,1,331,84,30653,28805,34790,0,28,-12,-2294,-2,101,-513,0,0,-1,0,9
EUW1_6883708335',6,31,15,1,0,2,0,8,0,369,92,30585,32052,49930,6,41,8,0,0,1,0,6,346,91,24783,28699,28893,1,23,1,5802,7,3353,21037,1,0,1,0,2
EUW1_6883704792',1,29,7,0,0,0,0,9,1,322,71,23522,27859,24875,3,25,7,2,0,0,0,0,387,85,24659,29068,29110,0,-65,-14,-1137,0,-1209,-4235,-2,0,0,0,9
EUW1_6883700497',3,29,27,1,0,3,0,3,0,387,82,35663,33240,49425,3,18,10,1,0,0,0,11,274,74,24375,25299,35809,1,113,8,11288,17,7941,13616,0,0,3,0,-8
EUW1_6883681505',6,54,14,0,0,1,0,8,1,396,55,28696,29299,27223,3,27,7,0,0,1,0,5,368,120,25505,30091,25808,1,28,-65,3191,7,-792,1415,0,0,0,0,3
EUW1_6883665674',1,38,9,0,0,1,0,5,0,372,74,26951,30182,26313,3,26,12,2,0,0,0,6,348,104,25913,28417,31298,1,24,-30,1038,-3,1765,-4985,-2,0,1,0,-1
EUW1_6883625139',4,28,16,0,0,1,0,13,0,355,98,30363,29429,34713,3,32,15,1,0,1,0,3,336,90,28842,29252,39431,1,19,8,1521,1,177,-4718,-1,0,0,0,10
EUW1_6883613716',4,42,20,1,0,2,0,10,1,383,85,31889,31563,43537,3,105,10,0,0,1,0,5,352,82,26884,30040,28734,1,31,3,5005,10,1523,14803,1,0,1,0,5
EUW1_6883588645',8,32,15,1,0,2,0,8,1,336,92,29317,27746,30774,3,27,14,0,0,0,0,5,323,76,27951,28688,28345,0,13,16,1366,1,-942,2429,1,0,2,0,3
EUW1_6883560910',3,27,10,0,1,1,0,9,0,412,89,28674,31015,21665,4,37,10,1,0,0,0,7,376,85,27513,29814,32538,1,36,4,1161,0,1201,-10873,-1,1,1,0,2
EUW1_6883518160',3,23,18,0,0,2,0,7,0,373,90,32551,30229,43466,3,317,17,1,0,1,0,9,305,78,28054,28425,31316,0,68,12,4497,1,1804,12150,-1,0,1,0,-2
EUW1_6883483950',4,29,27,1,0,2,0,9,1,343,79,35338,30478,51877,0,19,15,1,0,1,0,7,293,79,27340,26946,33313,1,50,0,7998,12,3532,18564,0,0,1,0,2
EUW1_6883431094',10,34,20,0,0,0,0,16,0,334,55,29293,29463,41130,6,29,15,1,0,1,0,1,338,80,28992,27729,36085,1,-4,-25,301,5,1734,5045,-1,0,-1,0,15
EUW1_6883387842',2,41,16,1,0,1,0,12,1,366,82,28538,28873,35234,4,29,15,1,0,1,0,6,336,98,29060,31868,31907,0,30,-16,-522,1,-2995,3327,0,0,0,0,6
EUW1_6883330107',3,28,11,1,0,0,0,15,1,327,85,26412,28380,28032,5,29,13,1,0,2,0,2,350,120,29553,31111,35693,0,-23,-35,-3141,-2,-2731,-7661,0,0,-2,0,13
EUW1_6883263739',1,33,7,0,0,1,0,11,1,337,81,24326,26718,31721,4,25,9,0,0,1,0,2,382,74,27435,28692,33346,0,-45,7,-3109,-2,-1974,-1625,0,0,0,0,9
EUW1_6883146789',2,36,12,0,0,1,0,8,1,345,95,28656,30118,30919,5,27,16,2,0,0,0,3,385,92,28907,30910,34761,0,-40,3,-251,-4,-792,-3842,-2,0,1,0,5
EUW1_6883096945',4,29,22,2,0,4,0,9,0,394,104,35863,33093,43349,2,21,16,0,0,1,0,10,311,90,29523,30529,32593,1,83,14,6340,6,2564,10756,2,0,3,0,-1
EUW1_6883033239',1,23,15,1,0,4,0,3,1,355,107,31645,31004,33005,4,32,11,1,0,0,0,13,346,84,25623,28791,31514,1,9,23,6022,4,2213,1491,0,0,4,0,-10
EUW1_6873679855',1,25,20,1,0,1,0,5,1,361,106,31443,31635,36308,2,27,12,0,0,0,0,7,334,89,27173,29236,35711,1,27,17,4270,8,2399,597,1,0,1,0,-2
EUW1_6873661826',2,25,11,0,0,1,0,10,1,328,81,26895,28080,26438,4,27,14,2,0,1,0,5,385,113,30066,32510,31090,0,-57,-32,-3171,-3,-4430,-4652,-2,0,0,0,5
EUW1_6873465188',7,72,18,0,0,0,0,10,1,330,83,29030,29275,34264,2,31,18,1,0,1,0,3,355,76,30062,29721,36950,1,-25,7,-1032,0,-446,-2686,-1,0,-1,0,7
EUW1_6873381208',3,28,12,1,0,1,0,12,1,374,105,28933,30475,31679,8,33,9,1,0,1,0,0,406,114,28269,31651,28719,1,-32,-9,664,3,-1176,2960,0,0,0,0,12
EUW1_6872436813',3,25,12,2,0,0,0,9,0,351,92,28192,29951,31777,3,27,21,0,0,2,0,3,336,112,31742,31841,39956,0,15,-20,-3550,-9,-1890,-8179,2,0,-2,0,6
EUW1_6871226206',5,38,6,0,0,1,0,13,0,283,92,23557,26787,21803,4,32,16,2,1,2,0,0,383,114,31379,31716,40297,0,-100,-22,-7822,-10,-4929,-18494,-2,-1,-1,0,13
EUW1_6871205595',4,42,8,1,1,1,0,9,0,361,104,26212,29005,24182,4,30,15,1,0,2,0,1,375,84,30038,31049,37256,0,-14,20,-3826,-7,-2044,-13074,0,1,-1,0,8
EUW1_6871040618',4,27,11,0,0,0,0,10,1,360,94,27785,28719,34484,3,23,20,2,0,3,0,5,323,90,31725,32178,38418,0,37,4,-3940,-9,-3459,-3934,-2,0,-3,0,5
EUW1_6871026591',8,30,21,2,0,2,0,11,0,408,98,33488,32124,39726,4,34,10,0,1,1,0,7,319,85,24938,26961,25447,1,89,13,8550,11,5163,14279,2,-1,1,0,4
EUW1_6870911050',1,23,11,0,0,1,0,8,1,360,80,27899,28352,24433,6,32,9,2,0,1,0,3,338,84,23858,28176,27312,0,22,-4,4041,2,176,-2879,-2,0,0,0,5
EUW1_6870893074',6,29,18,1,0,0,0,4,1,369,78,30921,30588,39854,2,22,11,1,0,0,0,2,338,108,26978,29223,33901,1,31,-30,3943,7,1365,5953,0,0,0,0,2
EUW1_6870810432',1,21,21,2,0,1,0,5,0,380,122,34697,33188,36246,3,22,12,0,0,2,0,7,249,82,24691,23408,25769,1,131,40,10006,9,9780,10477,2,0,-1,0,-2
EUW1_6870779748',8,35,8,2,0,0,0,6,0,383,102,25765,29522,26844,4,24,14,0,0,0,0,4,381,85,29097,30586,35943,0,2,17,-3332,-6,-1064,-9099,2,0,0,0,2
EUW1_6870712310',0,27,6,0,0,0,0,10,0,392,93,25675,28739,22159,5,102,15,2,0,1,0,3,368,126,29300,32974,30873,0,24,-33,-3625,-9,-4235,-8714,-2,0,-1,0,7
EUW1_6870565854',3,60,15,0,0,0,0,12,0,318,68,27876,28562,33786,3,74,26,2,0,1,0,2,386,90,33980,32277,45964,0,-68,-22,-6104,-11,-3715,-12178,-2,0,-1,0,10
EUW1_6869606724',3,23,14,1,1,0,0,4,1,371,80,27104,31576,34780,2,23,5,1,0,0,0,1,358,106,23615,28292,25854,1,13,-26,3489,9,3284,8926,0,1,0,0,3
EUW1_6883641324',7,30,23,1,0,2,0,14,1,284,106,31074,28682,43466,7,25,12,1,1,0,0,4,300,76,27303,28739,32943,1,-16,30,3771,11,-57,10523,0,-1,2,0,10
EUW1_6883625371',4,29,12,0,0,1,0,11,0,301,69,26002,26441,27120,6,30,18,1,1,2,0,3,349,99,30232,28905,42207,0,-48,-30,-4230,-6,-2464,-15087,-1,-1,-1,0,8
EUW1_6883576011',1,24,6,0,0,1,0,14,0,356,76,25088,28565,27018,6,26,22,2,0,1,0,1,388,82,32593,31689,38280,0,-32,-6,-7505,-16,-3124,-11262,-2,0,0,0,13
EUW1_6883551604',1,51,9,0,0,0,0,12,1,337,85,25497,28444,32593,4,28,15,2,0,1,0,3,376,92,28778,31317,29033,0,-39,-7,-3281,-6,-2873,3560,-2,0,-1,0,9
EUW1_6883472221',10,24,16,2,1,0,0,9,1,375,84,27549,30792,31789,2,22,5,0,0,0,0,0,332,90,23760,27389,21917,1,43,-6,3789,11,3403,9872,2,1,0,0,9
EUW1_6882750980',2,24,13,1,0,1,0,6,0,376,100,28686,32471,33375,3,33,11,1,0,0,0,4,369,92,27088,30297,33829,0,7,8,1598,2,2174,-454,0,0,1,0,2
EUW1_6882648048',3,26,18,0,1,2,0,11,1,333,90,30957,30666,32110,5,35,10,2,0,0,0,6,366,67,26143,27794,34581,1,-33,23,4814,8,2872,-2471,-2,1,2,0,5
EUW1_6882188307',3,29,11,1,1,0,0,11,1,331,92,25586,27747,28204,6,23,7,0,0,1,0,1,380,56,26244,28592,26837,1,-49,36,-658,4,-845,1367,1,1,-1,0,10
EUW1_6880698001',5,35,18,1,0,3,0,9,1,370,106,31980,32056,39821,4,30,11,1,0,0,0,11,315,76,24865,27037,35918,1,55,30,7115,7,5019,3903,0,0,3,0,-2
EUW1_6880014264',2,28,15,2,0,0,0,6,1,373,99,28724,31554,32597,2,28,6,0,0,0,0,2,352,108,25130,30277,29271,1,21,-9,3594,9,1277,3326,2,0,0,0,4
EUW1_6879948297',2,26,15,1,0,1,0,2,1,353,88,28802,30988,41977,2,23,9,1,0,0,0,5,322,78,24315,27941,40401,1,31,10,4487,6,3047,1576,0,0,1,0,-3
EUW1_6879816924',5,28,19,1,0,3,0,5,1,372,112,32630,32094,38244,1,27,11,1,0,0,0,13,328,100,25612,28151,25858,1,44,12,7018,8,3943,12386,0,0,3,0,-8
EUW1_6879557227',2,31,13,0,1,0,0,8,0,334,79,26804,28046,27198,6,40,14,2,0,1,0,4,374,82,28122,29670,32787,0,-40,-3,-1318,-1,-1624,-5589,-2,1,-1,0,4
EUW1_6879517452',2,28,12,1,0,0,0,7,0,318,94,26934,28002,32865,5,31,17,0,0,1,0,1,381,82,29600,31013,37026,0,-63,12,-2666,-5,-3011,-4161,1,0,-1,0,6
EUW1_6882503049',4,25,12,0,0,0,0,13,0,328,63,26114,29458,40614,3,25,16,2,0,2,0,0,408,88,29869,34702,38396,0,-80,-25,-3755,-4,-5244,2218,-2,0,-2,0,13
EUW1_6882465055',3,26,12,0,0,0,0,10,0,336,63,26922,29256,30245,3,23,13,2,0,1,0,5,344,84,27593,29660,33855,0,-8,-21,-671,-1,-404,-3610,-2,0,-1,0,5
EUW1_6879458590',3,35,21,2,1,3,0,4,1,365,122,32234,32836,34684,2,136,7,0,0,1,0,6,327,45,23022,24108,22801,1,38,77,9212,14,8728,11883,2,1,2,0,-2
EUW1_6879434535',2,57,13,2,0,0,0,7,1,368,93,28193,30462,24211,4,30,4,0,0,1,0,2,387,86,24576,27771,19681,1,-19,7,3617,9,2691,4530,2,0,-1,0,5
EUW1_6878443882',1,156,11,2,1,1,0,7,1,355,77,27062,28924,33946,3,25,10,0,0,1,0,4,347,71,27325,27937,43921,1,8,6,-263,1,987,-9975,2,1,0,0,3
EUW1_6878140651',4,23,10,1,0,0,0,12,0,374,87,25146,30013,27082,7,137,17,1,1,2,0,0,370,92,30380,32545,39747,0,4,-5,-5234,-7,-2532,-12665,0,-1,-2,0,12
EUW1_6877959748',2,60,19,1,0,1,0,10,0,320,116,30529,32456,37114,1,57,5,0,0,1,0,5,317,88,23427,25470,30982,1,3,28,7102,14,6986,6132,1,0,0,0,5
EUW1_6877932928',3,29,22,1,0,2,0,6,1,304,113,31888,30101,39170,1,36,16,0,0,0,0,7,323,66,27459,28617,38224,1,-19,47,4429,6,1484,946,1,0,2,0,-1
EUW1_6877920027',0,26,16,2,0,2,0,4,1,363,92,28751,30204,28489,1,19,7,0,0,0,0,3,301,75,22614,24835,28196,1,62,17,6137,9,5369,293,2,0,2,0,1
EUW1_6877899133',3,261,5,0,0,0,0,12,0,328,75,22047,27115,25632,6,44,19,2,0,2,0,1,403,84,32529,33141,34091,0,-75,-9,-10482,-14,-6026,-8459,-2,0,-2,0,11
EUW1_6877131806',0,64,13,1,0,1,0,7,0,321,112,27940,31519,35174,3,61,10,1,0,1,0,3,345,79,25895,27447,35832,1,-24,33,2045,3,4072,-658,0,0,0,0,4
EUW1_6877046729',2,20,20,1,1,1,0,8,1,387,70,32201,30373,36588,6,29,13,0,0,1,0,6,337,88,27571,29104,28272,0,50,-18,4630,7,1269,8316,1,1,0,0,2
EUW1_6876996593',4,26,27,1,0,2,0,9,0,403,90,36236,34445,45084,3,26,13,0,0,0,0,7,352,93,28661,30011,31184,1,51,-3,7575,14,4434,13900,1,0,2,0,2
EUW1_6869417320',1,56,8,0,0,1,0,6,1,353,96,26630,28543,26872,6,29,19,1,0,1,0,8,320,72,28800,29393,40188,0,33,24,-2170,-11,-850,-13316,-1,0,0,0,-2
EUW1_6869379571',0,23,19,1,1,1,0,12,0,412,102,31772,34782,35811,3,24,13,0,0,0,0,4,409,82,29694,31327,30977,0,3,20,2078,6,3455,4834,1,1,1,0,8
EUW1_6869330179',5,31,10,0,0,2,0,9,1,353,94,28399,28737,28346,4,32,9,2,0,1,0,10,375,108,27166,30262,28988,0,-22,-14,1233,1,-1525,-642,-2,0,1,0,-1
EUW1_6868156838',2,149,16,0,0,2,0,11,1,347,115,31647,32226,39552,1,34,11,2,0,2,0,9,355,71,25717,27885,31215,1,-8,44,5930,5,4341,8337,-2,0,0,0,2
EUW1_6867706115',4,30,14,2,1,1,0,6,1,378,104,29497,33421,38112,1,30,3,0,0,1,0,6,345,103,22967,29039,24536,1,33,1,6530,11,4382,13576,2,1,0,0,0
EUW1_6867665325',4,26,16,0,0,2,0,6,0,333,86,30476,29708,38229,4,24,18,2,1,0,0,9,304,70,28574,28929,37591,1,29,16,1902,-2,779,638,-2,-1,2,0,-3
EUW1_6880348733',0,48,17,1,0,3,0,8,1,408,122,34608,34560,31512,1,18,7,0,0,1,0,9,315,64,23069,27171,19465,1,93,58,11539,10,7389,12047,1,0,2,0,-1
EUW1_6880285652',3,43,9,0,0,1,0,9,1,382,90,27189,30418,31946,4,27,12,2,0,0,0,6,354,78,26913,29174,28228,0,28,12,276,-3,1244,3718,-2,0,1,0,3
EUW1_6880211135',4,29,11,0,0,3,0,7,1,406,115,30303,31865,27326,2,88,5,2,0,0,0,9,303,119,23029,27102,18322,0,103,-4,7274,6,4763,9004,-2,0,3,0,-2
EUW1_6879466805',5,24,9,0,0,1,0,9,1,374,87,26043,30168,18772,3,27,8,1,0,0,0,4,395,100,25739,29935,19558,0,-21,-13,304,1,233,-786,-1,0,1,0,5
EUW1_6879444897',7,30,15,2,0,2,0,7,1,408,96,32270,31689,36462,1,26,9,0,0,1,0,11,357,87,25272,28936,20838,1,51,9,6998,6,2753,15624,2,0,1,0,-4
EUW1_6879425889',4,24,14,2,0,2,0,11,1,377,98,29777,32259,31729,0,21,4,0,0,0,0,3,382,122,24551,29819,23660,1,-5,-24,5226,10,2440,8069,2,0,2,0,8
EUW1_6879408824',1,18,4,0,0,0,0,10,1,376,95,23503,28837,24807,7,25,8,2,0,1,0,0,410,108,26634,31758,25034,0,-34,-13,-3131,-4,-2921,-227,-2,0,-1,0,10
EUW1_6879389312',0,51,3,0,0,0,0,11,0,357,76,22165,26802,32701,4,117,22,2,0,3,0,1,398,96,32444,35226,44609,0,-41,-20,-10279,-19,-8424,-11908,-2,0,-3,0,10
EUW1_6879380971',1,29,26,1,0,3,0,6,1,413,107,36760,34581,42059,0,24,7,0,0,1,0,9,272,58,22477,24398,30020,1,141,49,14283,19,10183,12039,1,0,2,0,-3
EUW1_6879372702',3,28,20,1,1,1,0,8,1,382,94,31335,30720,31182,1,21,8,1,0,0,0,6,396,80,26046,29329,34628,1,-14,14,5289,12,1391,-3446,0,1,1,0,2
EUW1_6878983048',0,22,10,0,0,0,0,14,0,391,91,26767,29201,32369,2,26,21,2,0,2,0,1,343,75,31623,29306,39496,0,48,16,-4856,-11,-105,-7127,-2,0,-2,0,13
EUW1_6878933355',5,27,10,0,0,0,0,13,0,313,70,24540,26981,34029,6,27,15,2,0,2,0,3,348,113,29119,31023,35786,0,-35,-43,-4579,-5,-4042,-1757,-2,0,-2,0,10
EUW1_6878890846',4,31,20,1,0,0,0,8,1,370,80,30499,29309,34815,0,18,13,0,0,1,0,3,317,112,27833,30234,29690,1,53,-32,2666,7,-925,5125,1,0,-1,0,5
EUW1_6878819483',3,24,7,1,0,0,0,11,1,373,92,24926,28647,26068,6,27,15,1,1,0,0,3,366,91,28334,31036,32364,0,7,1,-3408,-8,-2389,-6296,0,-1,0,0,8
EUW1_6878764160',0,22,9,0,0,0,0,15,0,325,79,25141,27242,31664,4,345,20,1,0,4,0,4,342,84,32738,31134,39520,0,-17,-5,-7597,-11,-3892,-7856,-1,0,-4,0,11
EUW1_6878724763',1,23,12,0,0,0,0,15,0,365,48,28554,27373,28535,4,30,28,2,0,3,0,3,376,120,35953,32212,50425,0,-11,-72,-7399,-16,-4839,-21890,-2,0,-3,0,12
EUW1_6878677875',4,49,6,0,0,0,0,9,0,322,114,23786,28596,25475,4,23,12,2,1,1,0,2,404,88,28226,30148,34415,0,-82,26,-4440,-6,-1552,-8940,-2,-1,-1,0,7
EUW1_6878646476',4,30,13,0,0,0,0,10,1,387,84,28421,31660,30327,4,23,5,0,1,1,0,4,380,98,24508,29236,30687,1,7,-14,3913,8,2424,-360,0,-1,-1,0,6
EUW1_6878581094',5,32,10,0,0,1,0,4,1,418,86,27947,30631,32835,6,37,6,2,0,0,0,1,348,82,23949,27841,25129,1,70,4,3998,4,2790,7706,-2,0,1,0,3
EUW1_6878004989',0,20,2,2,0,0,0,18,0,354,84,22529,26760,19656,7,96,8,0,0,3,0,1,368,90,28693,28049,31765,0,-14,-6,-6164,-6,-1289,-12109,2,0,-3,0,17
EUW1_6874008949',2,23,14,1,0,0,0,13,0,308,84,27625,28433,39224,3,63,22,1,0,3,0,2,368,85,32858,32663,45319,0,-60,-1,-5233,-8,-4230,-6095,0,0,-3,0,11
EUW1_6873684212',3,24,19,1,1,1,0,12,0,318,96,31426,30626,33843,2,24,20,1,0,1,0,8,352,73,30894,28882,34285,1,-34,23,532,-1,1744,-442,0,1,0,0,4
EUW1_6873673700',1,28,13,1,0,1,0,10,1,384,92,29111,31076,33113,6,23,12,1,1,1,0,7,366,95,27596,31262,30196,1,18,-3,1515,1,-186,2917,0,-1,0,0,3
EUW1_6873588912',5,30,10,0,0,1,0,8,0,374,101,26901,30923,29252,4,28,9,1,0,0,0,1,359,88,26518,28637,26687,0,15,13,383,1,2286,2565,-1,0,1,0,7
EUW1_6872678014',6,42,24,1,1,4,0,6,0,322,106,35390,31287,38722,1,21,13,0,0,0,0,11,270,76,25390,24613,29935,1,52,30,10000,11,6674,8787,1,1,4,0,-5
EUW1_6872646219',1,20,8,1,0,0,0,13,0,324,90,25884,27780,36858,5,102,13,0,0,2,0,4,363,80,30391,29437,28999,0,-39,10,-4507,-5,-1657,7859,1,0,-2,0,9
EUW1_6871414258',3,21,15,0,0,1,0,12,1,341,74,29480,29187,32581,4,29,19,1,0,2,0,8,347,88,31639,30342,34764,0,-6,-14,-2159,-4,-1155,-2183,-1,0,-1,0,4
EUW1_6871369677',9,71,18,0,0,1,0,15,0,324,95,31528,31315,37255,4,154,30,1,0,2,0,4,319,89,33716,32946,44499,0,5,6,-2188,-12,-1631,-7244,-1,0,-1,0,11
EUW1_6871323388',3,25,17,1,0,1,0,7,1,368,97,30415,32761,33135,0,36,6,0,0,0,0,5,359,69,24043,28585,21942,1,9,28,6372,11,4176,11193,1,0,1,0,2
EUW1_6871284159',2,18,10,0,0,0,0,5,0,306,65,23869,26433,30967,4,32,17,2,0,2,0,0,388,102,31369,32293,40444,0,-82,-37,-7500,-7,-5860,-9477,-2,0,-2,0,5
EUW1_6871261086',6,32,17,0,1,1,0,9,0,392,89,31536,31720,29110,4,23,10,2,0,2,0,6,343,83,27316,27195,28513,1,49,6,4220,7,4525,597,-2,1,-1,0,3
EUW1_6870745442',5,35,22,2,1,4,0,6,1,405,122,35828,34819,38243,3,26,4,0,0,0,0,10,318,82,22141,25034,22322,1,87,40,13687,18,9785,15921,2,1,4,0,-4
EUW1_6869866176',2,26,12,2,0,1,0,12,1,354,92,28243,28196,34831,4,28,13,0,0,1,0,6,400,89,28755,30145,31337,0,-46,3,-512,-1,-1949,3494,2,0,0,0,6
EUW1_6869798913',6,34,10,1,0,2,0,6,0,373,108,28466,29603,27593,5,135,5,1,0,0,0,6,338,96,23515,27276,23961,1,35,12,4951,5,2327,3632,0,0,2,0,0
EUW1_6869747656',4,26,7,0,0,0,0,11,0,367,91,25476,30523,30704,3,26,7,2,1,2,0,2,360,106,26199,30466,23247,0,7,-15,-723,0,57,7457,-2,-1,-2,0,9
EUW1_6868082030',4,29,6,0,0,1,0,10,0,363,81,26093,28072,25194,6,33,15,2,0,1,0,2,378,93,28791,30588,39331,0,-15,-12,-2698,-9,-2516,-14137,-2,0,0,0,8
EUW1_6866531302',3,27,6,0,0,0,0,13,0,352,90,24592,29461,23534,5,29,8,2,0,2,0,3,385,118,29210,31063,36307,0,-33,-28,-4618,-2,-1602,-12773,-2,0,-2,0,10
EUW1_6866494433',3,55,20,1,0,2,0,11,1,394,108,31428,32319,34976,5,25,4,0,0,1,0,6,309,60,22009,23046,22903,1,85,48,9419,16,9273,12073,1,0,1,0,5
EUW1_6865093463',3,25,11,1,0,1,0,12,0,367,115,27822,32671,31480,3,39,10,0,0,2,0,4,391,75,28413,29913,34509,1,-24,40,-591,1,2758,-3029,1,0,-1,0,8
EUW1_6865001345',4,26,9,1,1,1,0,15,0,343,74,26363,28961,30778,1,25,18,1,0,1,0,5,339,114,30758,31306,36693,1,4,-40,-4395,-9,-2345,-5915,0,1,0,0,10
EUW1_6864959578',3,38,14,2,1,1,0,8,1,382,108,30275,30630,33828,4,50,13,0,0,1,0,7,353,75,29046,30632,29591,1,29,33,1229,1,-2,4237,2,1,0,0,1
EUW1_6863517255',3,30,7,1,0,1,0,11,0,389,91,27216,28923,29377,4,23,14,1,0,2,0,7,310,91,27299,29730,31994,1,79,0,-83,-7,-807,-2617,0,0,-1,0,4
EUW1_6863483114',2,56,16,0,0,1,0,13,0,282,85,29260,29559,30637,4,73,16,2,0,1,0,4,373,98,30510,31210,37436,0,-91,-13,-1250,0,-1651,-6799,-2,0,0,0,9
EUW1_6863293445',2,27,10,0,0,1,0,11,0,336,83,26413,28172,25187,5,80,8,2,0,1,0,3,390,83,25715,28878,29092,0,-54,0,698,2,-706,-3905,-2,0,0,0,8
EUW1_6863279285',7,95,16,1,0,0,0,14,1,346,100,29639,28856,31665,3,32,14,1,0,1,0,2,327,96,29452,28695,33341,1,19,4,187,2,161,-1676,0,0,-1,0,12
EUW1_6863275593',2,102,19,1,0,1,0,10,1,335,88,30014,30660,35772,6,36,10,1,0,1,0,4,327,79,26836,28513,31278,1,8,9,3178,9,2147,4494,0,0,0,0,6
EUW1_6856924379',3,66,10,0,1,0,0,8,0,386,99,28806,28691,36190,4,30,13,2,0,1,0,1,300,98,26272,29512,27921,0,86,1,2534,-3,-821,8269,-2,1,-1,0,7
EUW1_6854597971',1,21,7,0,0,0,0,10,1,371,67,25828,29076,26028,6,27,13,2,0,1,0,2,409,80,29084,30884,32694,0,-38,-13,-3256,-6,-1808,-6666,-2,0,-1,0,8
EUW1_6822695840',3,19,19,1,1,0,0,8,0,359,84,29934,32647,38688,3,24,9,0,0,1,0,2,269,91,24420,29299,31148,1,90,-7,5514,10,3348,7540,1,1,-1,0,6
EUW1_6817878624',3,20,18,2,0,1,0,13,0,316,97,30557,29831,37010,5,45,22,0,0,1,0,1,370,101,32938,31022,40303,1,-54,-4,-2381,-4,-1191,-3293,2,0,0,0,12
EUW1_6816559770',5,41,19,1,1,2,0,6,1,358,79,30369,30863,34332,6,33,9,0,0,0,0,0,355,97,27728,30639,31255,1,3,-18,2641,10,224,3077,1,1,2,0,6
EUW1_6802513716',2,70,13,1,1,0,0,6,0,266,151,25475,30418,30186,8,34,10,0,0,0,0,2,345,44,25659,28195,33412,1,-79,107,-184,3,2223,-3226,1,1,0,0,4
EUW1_6802477793',8,90,7,0,0,0,0,12,0,315,94,26368,28380,27704,6,108,18,1,0,3,0,5,363,89,30880,30667,32402,0,-48,5,-4512,-11,-2287,-4698,-1,0,-3,0,7
EUW1_6802437123',5,29,15,1,0,2,0,11,1,361,103,30799,30755,35404,8,37,13,1,0,0,0,8,349,86,27967,29178,36972,1,12,17,2832,2,1577,-1568,0,0,2,0,3
EUW1_6883016942',5,71,20,1,0,0,0,11,0,355,92,31298,31292,37819,4,32,15,1,0,2,0,3,349,95,29739,29226,36514,1,6,-3,1559,5,2066,1305,0,0,-2,0,8
EUW1_6882961091',2,23,6,1,0,0,0,5,0,383,74,24699,29661,22950,5,27,5,1,0,0,0,0,368,109,23546,29507,21265,0,15,-35,1153,1,154,1685,0,0,0,0,5
EUW1_6882915992',3,28,14,2,1,2,0,6,1,370,80,29803,29772,36221,5,31,25,0,0,0,0,4,297,100,31978,30209,43801,1,73,-20,-2175,-11,-437,-7580,2,1,2,0,2
EUW1_6874972702',5,41,15,1,0,1,0,17,1,381,108,31778,32148,36219,5,27,19,0,0,3,0,6,381,64,32475,31235,36363,0,0,44,-697,-4,913,-144,1,0,-2,0,11
EUW1_6874945914',2,57,13,1,0,1,0,11,0,364,85,27689,31581,35488,2,53,10,1,0,1,0,2,381,82,27227,28394,28675,1,-17,3,462,3,3187,6813,0,0,0,0,9
EUW1_6874915829',4,213,19,0,1,2,0,9,0,382,97,33483,32005,35142,4,39,14,1,0,1,0,6,330,73,28432,27869,33411,1,52,24,5051,5,4136,1731,-1,1,1,0,3
EUW1_6874875937',4,49,18,1,0,0,0,9,1,293,69,28972,25818,38694,3,23,17,1,0,0,0,3,296,106,28894,28898,41293,0,-3,-37,78,1,-3080,-2599,0,0,0,0,6
EUW1_6874316605',3,48,17,2,1,2,0,7,1,396,116,32470,33476,32810,4,29,6,0,0,1,0,10,338,88,24685,27504,24930,1,58,28,7785,11,5972,7880,2,1,1,0,-3
EUW1_6874260174',1,74,14,2,1,2,0,7,0,404,96,30144,32348,37767,5,38,12,0,0,0,0,6,351,80,26876,29228,30479,1,53,16,3268,2,3120,7288,2,1,2,0,1
EUW1_6874218621',3,28,14,0,1,0,0,15,0,325,97,28193,30211,33762,1,30,17,2,0,3,0,3,396,110,32663,32678,39671,0,-71,-13,-4470,-3,-2467,-5909,-2,1,-3,0,12
EUW1_6874155215',4,29,10,1,0,0,0,6,0,325,104,25146,29220,27486,0,74,9,0,0,1,0,3,403,92,26294,30081,30156,1,-78,12,-1148,1,-861,-2670,1,0,-1,0,3
EUW1_6874093268',4,31,14,2,0,0,0,10,0,332,90,26860,29281,35577,3,40,10,0,0,0,0,1,338,77,27116,28054,29764,1,-6,13,-256,4,1227,5813,2,0,0,0,9
EUW1_6874038338',3,27,12,1,0,0,0,9,1,301,82,25150,26301,25460,4,36,10,1,0,1,0,0,354,96,26904,28344,31326,0,-53,-14,-1754,2,-2043,-5866,0,0,-1,0,9
EUW1_6874007807',8,28,15,1,0,1,0,9,1,364,92,29639,29676,27298,9,33,12,1,1,0,0,5,401,107,29498,31987,30337,0,-37,-15,141,3,-2311,-3039,0,-1,1,0,4
EUW1_6873972888',1,25,14,0,0,1,0,10,1,341,78,27625,27681,30684,4,34,10,2,0,0,0,6,353,72,25078,26458,35034,0,-12,6,2547,4,1223,-4350,-2,0,1,0,4
EUW1_6873931295',3,37,8,1,0,0,0,5,0,386,100,26107,29508,24775,1,25,6,1,0,0,0,2,335,112,23372,27854,18512,1,51,-12,2735,2,1654,6263,0,0,0,0,3
EUW1_6873907754',2,26,10,0,0,0,0,7,0,398,96,27891,31099,39137,3,103,18,1,0,1,0,4,371,84,29121,32253,34307,1,27,12,-1230,-8,-1154,4830,-1,0,-1,0,3
EUW1_6873863031',3,149,16,1,0,2,0,7,1,368,84,31293,30944,36167,3,22,7,1,0,0,0,10,374,104,25810,30042,26697,1,-6,-20,5483,9,902,9470,0,0,2,0,-3
EUW1_6873841599',11,35,4,1,0,1,0,8,0,398,95,25363,30069,23871,2,24,7,1,0,1,0,2,413,92,26382,29955,23437,0,-15,3,-1019,-3,114,434,0,0,0,0,6
EUW1_6873815896',2,23,7,0,0,0,0,14,0,350,60,22660,26607,21394,0,24,19,1,0,2,0,0,383,120,32183,33827,32667,0,-33,-60,-9523,-12,-7220,-11273,-1,0,-2,0,14
EUW1_6882665881',1,27,6,1,0,0,0,13,0,319,61,23787,27159,24640,2,23,16,1,0,3,0,1,355,100,31563,30032,34291,0,-36,-39,-7776,-10,-2873,-9651,0,0,-3,0,12
EUW1_6882615005',2,28,7,0,0,0,0,8,1,327,92,24007,29124,25478,2,26,6,2,0,1,0,2,385,92,24655,29031,26941,0,-58,0,-648,1,93,-1463,-2,0,-1,0,6
EUW1_6872761553',2,19,12,0,0,1,0,4,1,335,99,27959,29385,34988,4,95,19,1,0,1,0,4,368,68,29968,33053,41873,0,-33,31,-2009,-7,-3668,-6885,-1,0,0,0,0
EUW1_6872729491',5,35,9,0,0,0,0,11,0,367,90,27119,30372,25944,4,32,11,2,0,1,0,5,383,66,26856,29749,30826,0,-16,24,263,-2,623,-4882,-2,0,-1,0,6
EUW1_6882967401',4,31,20,0,0,0,0,10,1,383,120,30463,35088,38937,4,31,11,2,0,1,0,4,351,84,26828,28598,33401,1,32,36,3635,9,6490,5536,-2,0,-1,0,6
EUW1_6882915848',5,42,17,0,0,0,0,12,1,331,92,28371,29608,36600,7,30,16,2,0,1,0,2,375,91,29697,29262,39151,0,-44,1,-1326,1,346,-2551,-2,0,-1,0,10
EUW1_6882873730',1,26,10,2,0,1,0,10,1,374,76,27024,29356,28269,2,24,6,0,0,0,0,4,390,120,25313,31495,25139,1,-16,-44,1711,4,-2139,3130,2,0,1,0,6
EUW1_6882755601',2,94,9,0,1,0,0,8,0,372,104,26520,31042,25123,6,34,11,2,0,2,0,2,384,109,28210,30574,28011,0,-12,-5,-1690,-2,468,-2888,-2,1,-2,0,6
EUW1_6882717561',9,162,13,0,0,1,0,10,0,402,82,29504,31379,36843,4,26,5,2,1,0,0,4,342,114,23846,29048,17443,1,60,-32,5658,8,2331,19400,-2,-1,1,0,6
EUW1_6882675854',5,31,13,2,0,2,0,11,1,395,122,30742,32687,31641,4,31,4,0,0,1,0,5,352,84,22611,26797,28758,1,43,38,8131,9,5890,2883,2,0,1,0,6
EUW1_6882648992',4,31,9,1,0,0,0,13,1,364,87,25123,27646,32530,2,27,18,1,0,2,0,1,408,107,32340,32926,36409,0,-44,-20,-7217,-9,-5280,-3879,0,0,-2,0,12
EUW1_6882617910',3,31,8,0,0,0,0,10,0,362,92,27180,29322,27854,5,32,16,2,0,2,0,2,394,130,31487,33493,30870,0,-32,-38,-4307,-8,-4171,-3016,-2,0,-2,0,8
EUW1_6882567323',0,29,13,0,0,0,0,3,0,382,59,26756,29632,31168,5,39,15,2,0,0,0,3,371,96,29355,32189,35160,0,11,-37,-2599,-2,-2557,-3992,-2,0,0,0,0
EUW1_6882554765',6,31,14,1,0,1,0,4,0,393,121,29988,31310,36610,4,28,13,1,0,0,0,7,325,83,26961,28145,32646,1,68,38,3027,1,3165,3964,0,0,1,0,-3
EUW1_6882038122',5,25,11,1,0,2,0,8,1,393,66,27903,30140,30389,1,27,7,0,0,1,0,6,351,98,25580,28960,28181,0,42,-32,2323,4,1180,2208,1,0,1,0,2
EUW1_6881661549',4,24,12,0,0,0,0,6,0,345,124,28077,30624,32941,3,31,16,2,0,0,0,0,389,76,29197,30026,36970,0,-44,48,-1120,-4,598,-4029,-2,0,0,0,6
EUW1_6880081637',3,25,9,0,0,0,0,3,0,400,91,25941,30402,26542,6,84,14,2,0,0,0,1,352,100,27976,31059,30671,0,48,-9,-2035,-5,-657,-4129,-2,0,0,0,2
EUW1_6879964641',2,33,9,0,0,0,0,10,1,378,78,26215,28770,36127,4,33,13,1,0,2,0,1,335,74,27933,28519,34680,0,43,4,-1718,-4,251,1447,-1,0,-2,0,9
EUW1_6879905493',1,23,11,0,0,1,0,11,1,332,115,29434,30093,36575,7,32,18,2,0,1,0,6,355,68,28686,30100,39873,0,-23,47,748,-7,-7,-3298,-2,0,0,0,5
EUW1_6879858632',2,32,16,1,0,0,0,9,0,355,76,27700,29863,41784,1,20,22,1,0,0,0,1,377,116,32785,32604,39475,0,-22,-40,-5085,-6,-2741,2309,0,0,0,0,8
EUW1_6878279248',7,21,14,0,0,0,0,13,0,298,76,27217,27075,37173,5,34,22,1,1,3,0,3,338,91,33384,30145,44153,0,-40,-15,-6167,-8,-3070,-6980,-1,-1,-3,0,10
EUW1_6878260554',5,32,21,1,0,4,0,9,1,370,97,32932,32218,35848,1,19,7,0,0,0,0,4,326,77,23575,26728,29860,1,44,20,9357,14,5490,5988,1,0,4,0,5
EUW1_6876813693',4,40,12,2,0,0,0,4,1,363,90,26499,30007,30425,3,31,9,0,0,0,0,1,340,108,25187,29871,25525,1,23,-18,1312,3,136,4900,2,0,0,0,3
EUW1_6876764778',7,32,14,1,0,0,0,6,1,355,82,26849,31660,35414,6,27,6,1,0,0,0,3,350,78,23750,28107,28409,1,5,4,3099,8,3553,7005,0,0,0,0,3
EUW1_6876384977',4,24,15,1,0,1,0,8,0,367,96,29463,30233,37751,0,26,14,0,0,1,0,7,341,64,27896,29069,34898,1,26,32,1567,1,1164,2853,1,0,0,0,1
EUW1_6876357838',4,25,14,0,0,1,0,10,1,375,94,29704,29651,39243,4,28,13,1,0,0,0,2,287,89,26469,28632,30653,0,88,5,3235,1,1019,8590,-1,0,1,0,8
EUW1_6876301708',4,24,9,0,0,1,0,11,0,393,71,27943,27883,26510,5,47,11,1,0,0,0,3,349,84,26535,28178,27612,1,44,-13,1408,-2,-295,-1102,-1,0,1,0,8
EUW1_6876229167',6,48,15,0,0,0,0,10,1,342,80,28274,28895,35201,2,29,21,2,0,2,0,4,353,78,32137,30985,41073,0,-11,2,-3863,-6,-2090,-5872,-2,0,-2,0,6
EUW1_6873690462',1,27,17,1,0,0,0,11,1,355,92,27993,29664,35404,2,22,11,0,0,0,0,2,374,91,26542,30151,26336,1,-19,1,1451,6,-487,9068,1,0,0,0,9
EUW1_6873575998',2,29,15,0,0,2,0,5,0,395,98,29904,32123,34847,5,29,16,1,0,0,0,2,348,86,28130,29503,33785,1,47,12,1774,-1,2620,1062,-1,0,2,0,3
EUW1_6873520441',6,30,7,0,0,0,0,11,0,375,86,26639,31562,22213,3,25,13,2,1,2,0,3,418,105,29339,33330,24848,1,-43,-19,-2700,-6,-1768,-2635,-2,-1,-2,0,8
EUW1_6873422807',2,165,8,2,0,2,0,7,1,411,102,27367,31827,33623,5,29,6,0,0,1,0,6,384,86,25639,30458,29445,1,27,16,1728,2,1369,4178,2,0,1,0,1
EUW1_6872267651',2,23,6,0,0,0,0,12,0,312,90,23242,27604,21690,3,47,14,0,0,1,0,2,376,98,29533,32723,33953,0,-64,-8,-6291,-8,-5119,-12263,0,0,-1,0,10
EUW1_6872240848',8,30,14,0,0,0,0,9,1,313,100,26657,27791,29411,4,37,16,1,0,3,0,2,379,73,31146,30575,41462,1,-66,27,-4489,-2,-2784,-12051,-1,0,-3,0,7
EUW1_6872214169',1,24,5,1,0,0,0,12,0,292,90,22931,24991,26127,2,28,27,1,0,3,0,4,360,93,33847,31604,49417,0,-68,-3,-10916,-22,-6613,-23290,0,0,-3,0,8
EUW1_6872194507',4,38,9,0,1,0,0,11,0,348,90,26264,29724,30055,6,31,9,2,0,1,0,2,381,98,26565,30854,27513,0,-33,-8,-301,0,-1130,2542,-2,1,-1,0,9
EUW1_6870933815',4,23,25,2,0,3,0,4,0,347,114,34590,31963,42449,0,17,6,0,0,0,0,13,223,62,21843,20552,23255,1,124,52,12747,19,11411,19194,2,0,3,0,-9
EUW1_6870904890',3,24,18,1,1,0,0,4,0,362,96,29242,32082,43305,5,29,10,1,0,0,0,4,315,88,24490,27187,24947,1,47,8,4752,8,4895,18358,0,1,0,0,0
EUW1_6870858010',1,29,12,1,0,0,0,15,0,270,44,25243,23565,29970,8,31,26,0,0,4,0,3,330,69,34989,27772,38370,0,-60,-25,-9746,-14,-4207,-8400,1,0,-4,0,12
EUW1_6882561860',1,27,9,2,0,2,0,13,1,378,81,27783,29400,26762,2,30,12,0,0,1,0,7,369,98,27896,30857,30110,0,9,-17,-113,-3,-1457,-3348,2,0,1,0,6
EUW1_6869269495',7,27,13,1,0,1,0,10,0,297,64,26171,26922,28831,3,25,15,1,1,1,0,2,363,100,28577,28619,33834,0,-66,-36,-2406,-2,-1697,-5003,0,-1,0,0,8
EUW1_6868291458',4,30,25,1,0,4,0,4,1,379,84,36938,32616,43418,8,31,14,0,0,0,0,11,317,67,26585,27162,31374,1,62,17,10353,11,5454,12044,1,0,4,0,-7
EUW1_6880218828',2,23,7,1,0,0,0,8,0,329,83,24184,27707,33109,2,27,15,1,0,1,0,2,356,88,29334,31736,28073,0,-27,-5,-5150,-8,-4029,5036,0,0,-1,0,6
EUW1_6872088161',3,42,27,1,1,1,0,13,1,338,98,35238,34957,48160,3,25,14,0,0,1,0,6,317,86,28491,27951,41976,1,21,12,6747,13,7006,6184,1,1,0,0,7
EUW1_6872039630',1,54,14,0,0,1,0,9,1,358,87,29441,30630,44018,4,31,17,1,0,1,0,4,327,81,30421,31445,39559,0,31,6,-980,-3,-815,4459,-1,0,0,0,5
EUW1_6858599413',0,46,12,0,0,2,0,6,0,315,87,27512,28166,35596,4,90,17,1,0,1,0,4,352,70,28735,28862,35903,0,-37,17,-1223,-5,-696,-307,-1,0,1,0,2
EUW1_6858557076',3,30,17,1,0,4,0,7,1,372,86,31687,30027,38405,5,39,9,1,0,2,0,14,367,121,29140,31603,28385,1,5,-35,2547,8,-1576,10020,0,0,2,0,-7
EUW1_6839694623',3,29,28,0,0,0,0,13,0,307,96,34117,31978,44031,2,35,21,2,0,2,0,5,324,80,33107,28376,42380,0,-17,16,1010,7,3602,1651,-2,0,-2,0,8
EUW1_6839654583',3,30,14,2,0,2,0,8,1,372,86,31197,29244,34078,5,35,10,0,0,0,0,7,348,84,27008,27165,26702,1,24,2,4189,4,2079,7376,2,0,2,0,1
EUW1_6839589975',6,47,12,1,0,0,0,4,0,386,75,27577,29371,31275,2,33,8,1,0,0,0,3,369,105,25804,29991,25020,0,17,-30,1773,4,-620,6255,0,0,0,0,1
EUW1_6839526948',5,32,9,2,0,0,0,10,0,338,102,25766,27767,24983,3,93,13,0,0,1,0,0,396,98,29830,29720,29699,1,-58,4,-4064,-4,-1953,-4716,2,0,-1,0,10
EUW1_6839477947',3,29,6,0,0,0,0,4,1,358,79,23579,27005,19207,2,22,7,1,0,1,0,0,367,123,26604,30400,24483,0,-9,-44,-3025,-1,-3395,-5276,-1,0,-1,0,4
EUW1_6839442872',3,41,11,0,0,0,0,13,1,288,74,25741,27196,31487,2,29,23,1,0,2,0,1,368,102,35865,32024,44960,0,-80,-28,-10124,-12,-4828,-13473,-1,0,-2,0,12
EUW1_6838888970',3,57,19,1,0,0,0,11,0,359,104,31064,33688,41612,6,61,5,1,1,3,0,5,325,63,24555,26590,29553,1,34,41,6509,14,7098,12059,0,-1,-3,0,6
EUW1_6838825719',3,30,13,2,0,0,0,8,1,378,82,26176,29997,32208,5,96,9,0,0,0,0,2,348,99,26742,28434,29877,0,30,-17,-566,4,1563,2331,2,0,0,0,6
EUW1_6837229658',5,28,12,1,0,1,0,14,1,313,103,29570,30708,33625,6,30,21,1,1,2,0,3,356,92,32757,31376,36815,0,-43,11,-3187,-9,-668,-3190,0,-1,-1,0,11
EUW1_6836147155',1,24,16,0,0,1,0,7,0,377,78,29291,30347,33814,2,24,10,2,0,0,0,4,364,74,26094,28632,31127,0,13,4,3197,6,1715,2687,-2,0,1,0,3
EUW1_6836081119',2,24,7,0,0,0,0,18,0,313,62,22829,24534,28825,4,31,28,2,0,6,1,0,362,105,38143,33549,50515,0,-49,-43,-15314,-21,-9015,-21690,-2,0,-6,-1,18
EUW1_6870259237',4,29,13,0,0,2,0,6,1,355,86,28255,30145,30393,6,22,7,0,0,0,0,4,331,94,23817,28506,26301,1,24,-8,4438,6,1639,4092,0,0,2,0,2
EUW1_6870204486',7,43,15,2,0,1,0,9,0,375,91,29059,32301,32431,4,30,9,0,0,0,0,2,324,104,24735,28455,28135,1,51,-13,4324,6,3846,4296,2,0,1,0,7
EUW1_6869763004',3,28,8,2,0,1,0,10,1,373,92,26653,29742,30677,1,50,10,0,0,1,0,6,354,99,25546,28206,31252,1,19,-7,1107,-2,1536,-575,2,0,0,0,4
EUW1_6869711794',6,42,15,0,0,0,0,10,1,287,71,28989,27600,33481,5,24,24,2,0,2,0,4,371,88,32773,32438,43671,0,-84,-17,-3784,-9,-4838,-10190,-2,0,-2,0,6
EUW1_6866592131',1,34,20,0,1,2,0,6,1,345,128,33006,32567,33499,2,27,9,2,0,1,0,10,294,76,24056,26597,29653,1,51,52,8950,11,5970,3846,-2,1,1,0,-4
EUW1_6863335520',6,38,9,1,0,1,0,7,1,389,93,27534,30090,18069,8,53,7,0,0,1,0,4,420,77,25610,28485,21625,1,-31,16,1924,2,1605,-3556,1,0,0,0,3
EUW1_6858733831',1,30,6,0,0,0,0,13,0,361,95,24725,26790,25515,2,25,15,2,1,1,0,2,400,104,31512,30719,26572,0,-39,-9,-6787,-9,-3929,-1057,-2,-1,-1,0,11
EUW1_6858682782',4,227,11,1,0,0,0,8,0,398,106,28165,30639,25061,4,30,4,1,0,1,0,3,398,84,25271,27926,27000,0,0,22,2894,7,2713,-1939,0,0,-1,0,5
EUW1_6874059595',7,29,22,1,1,1,0,11,0,404,96,33485,33588,38653,3,24,11,0,0,1,0,2,310,94,26955,27156,25269,1,94,2,6530,11,6432,13384,1,1,0,0,9
EUW1_6874021471',8,40,18,2,0,0,0,7,0,353,91,28308,29790,33074,3,45,12,0,0,0,0,0,380,84,28304,29191,31236,1,-27,7,4,6,599,1838,2,0,0,0,7
EUW1_6873985812',3,26,14,2,0,1,0,8,1,333,100,29407,30062,30555,3,29,19,0,1,1,0,8,327,68,29659,29258,36262,1,6,32,-252,-5,804,-5707,2,-1,0,0,0
EUW1_6873958950',2,22,3,1,0,0,0,6,0,353,71,22668,26724,21557,2,26,18,1,0,3,0,1,390,104,31257,32181,34500,0,-37,-33,-8589,-15,-5457,-12943,0,0,-3,0,5
EUW1_6872211575',4,38,12,0,0,1,0,8,1,358,80,28399,29127,35329,4,60,20,2,0,1,0,7,339,112,31365,31195,35577,0,19,-32,-2966,-8,-2068,-248,-2,0,0,0,1
EUW1_6872175606',5,24,9,0,0,0,0,9,0,368,80,25855,30596,18887,1,146,10,2,0,2,0,2,388,131,28370,31790,33513,0,-20,-51,-2515,-1,-1194,-14626,-2,0,-2,0,7
EUW1_6871983099',3,60,14,0,0,0,0,14,0,277,71,26377,29185,31182,3,57,21,2,0,3,0,0,361,124,34168,32142,43722,0,-84,-53,-7791,-7,-2957,-12540,-2,0,-3,0,14
EUW1_6871908287',3,37,17,1,0,1,0,12,0,295,86,29382,28882,34665,2,30,17,1,0,2,0,5,296,100,29392,27645,36679,1,-1,-14,-10,0,1237,-2014,0,0,-1,0,7
EUW1_6883385496',4,42,12,1,0,0,0,5,1,382,92,28284,31191,31818,6,47,8,0,0,1,0,7,368,86,25024,27914,29082,1,14,6,3260,4,3277,2736,1,0,-1,0,-2
EUW1_6883303060',1,25,20,1,0,2,0,3,1,327,89,30755,30316,39162,0,25,12,0,0,0,0,8,348,74,26053,26982,30974,1,-21,15,4702,8,3334,8188,1,0,2,0,-5
EUW1_6883013604',3,44,14,1,0,0,0,11,0,334,82,27113,30983,39398,5,24,16,1,0,1,0,2,408,89,31189,32686,39529,0,-74,-7,-4076,-2,-1703,-131,0,0,-1,0,9
EUW1_6882885499',3,119,6,0,0,0,0,7,0,342,76,23330,27244,23106,3,112,11,2,0,2,0,2,382,87,28085,30500,32304,0,-40,-11,-4755,-5,-3256,-9198,-2,0,-2,0,5
EUW1_6882824536',7,27,12,1,0,0,0,12,1,345,82,26917,27954,34690,4,104,17,1,0,2,0,3,382,84,31218,31511,35285,0,-37,-2,-4301,-5,-3557,-595,0,0,-2,0,9
EUW1_6882789500',10,30,9,1,0,0,0,13,0,371,94,26832,30048,28580,5,29,12,1,0,2,0,2,422,96,31063,32119,30694,0,-51,-2,-4231,-3,-2071,-2114,0,0,-2,0,11
EUW1_6882706426',4,45,13,2,0,1,0,6,1,358,88,27551,29964,32412,1,27,8,0,0,0,0,7,380,79,25610,28258,24108,1,-22,9,1941,5,1706,8304,2,0,1,0,-1
EUW1_6882694604',1,34,8,0,0,0,0,8,0,319,78,23913,26323,30205,7,37,24,1,0,1,0,1,347,94,32918,31810,44239,0,-28,-16,-9005,-16,-5487,-14034,-1,0,-1,0,7
EUW1_6882649957',5,26,2,1,0,1,0,6,0,378,102,24838,28422,26517,7,29,16,1,0,1,0,7,351,98,28963,33235,32770,0,27,4,-4125,-14,-4813,-6253,0,0,0,0,-1
EUW1_6882491575',2,32,17,1,1,2,0,3,1,424,112,32512,32572,32228,2,29,3,0,0,0,0,9,344,84,22052,26142,22965,1,80,28,10460,14,6430,9263,1,1,2,0,-6
EUW1_6879678799',3,23,6,1,0,0,0,11,0,336,103,23058,28300,24502,7,25,13,1,0,1,0,0,372,96,28138,30517,33729,0,-36,7,-5080,-7,-2217,-9227,0,0,-1,0,11
EUW1_6879630563',1,27,22,2,0,3,0,3,1,393,90,35408,33000,39820,4,28,11,0,0,0,0,10,257,90,24969,26304,25397,0,136,0,10439,11,6696,14423,2,0,3,0,-7
EUW1_6878895860',7,32,24,0,0,1,0,9,0,334,72,31903,30116,49160,0,23,18,1,0,2,0,10,319,83,31348,31176,39269,1,15,-11,555,6,-1060,9891,-1,0,-1,0,-1
EUW1_6878824565',4,44,10,2,0,0,0,10,0,367,70,27767,29807,32570,6,161,11,0,0,1,0,8,350,128,26801,31157,25122,1,17,-58,966,-1,-1350,7448,2,0,-1,0,2
EUW1_6878743114',6,32,8,0,1,0,0,10,0,387,89,27278,30164,26414,4,231,9,2,0,1,0,3,369,108,24906,30774,28461,1,18,-19,2372,-1,-610,-2047,-2,1,-1,0,7
EUW1_6878408040',3,33,6,0,0,0,0,10,0,317,89,23533,26333,28564,5,31,25,2,1,3,0,2,401,102,34314,34734,39799,0,-84,-13,-10781,-19,-8401,-11235,-2,-1,-3,0,8
EUW1_6878359852',6,32,12,1,0,1,0,12,0,339,92,26616,28989,29118,2,34,14,1,1,1,0,3,352,80,28639,29040,32735,0,-13,12,-2023,-2,-51,-3617,0,-1,0,0,9
EUW1_6878306917',4,60,12,1,0,1,0,10,0,388,84,28697,30736,29103,6,63,10,1,0,1,0,2,357,96,26956,29335,25696,1,31,-12,1741,2,1401,3407,0,0,0,0,8
EUW1_6882097096',7,29,15,0,0,1,0,10,1,386,81,29920,31603,30417,5,31,14,1,0,0,0,4,334,95,27921,29904,34305,0,52,-14,1999,1,1699,-3888,-1,0,1,0,6
EUW1_6881694612',0,28,7,1,0,0,0,7,1,362,94,25064,28431,35213,5,30,14,1,0,1,0,4,391,97,28940,32850,31334,0,-29,-3,-3876,-7,-4419,3879,0,0,-1,0,3
EUW1_6881642042',5,23,9,0,0,1,0,10,0,372,102,27205,29501,26714,3,20,15,2,0,2,0,4,363,77,29277,30486,37680,0,9,25,-2072,-6,-985,-10966,-2,0,-1,0,6
EUW1_6881602407',4,22,5,1,0,0,0,15,1,320,76,22461,25405,25828,2,29,25,1,0,4,0,0,386,104,34804,35147,53173,0,-66,-28,-12343,-20,-9742,-27345,0,0,-4,0,15
EUW1_6881519279',3,33,12,0,1,0,0,12,0,319,112,27366,28520,34046,5,41,21,1,0,2,0,3,350,67,32048,30006,40898,0,-31,45,-4682,-9,-1486,-6852,-1,1,-2,0,9
EUW1_6877708995',3,110,10,1,1,2,0,4,1,360,96,28701,29209,31773,2,26,8,0,0,0,0,9,340,80,24039,28273,26802,0,20,16,4662,2,936,4971,1,1,2,0,-5
EUW1_6877655583',4,27,10,0,1,0,0,9,1,330,100,26107,28214,32013,7,104,14,1,0,1,0,0,379,76,29115,30483,41771,0,-49,24,-3008,-4,-2269,-9758,-1,1,-1,0,9
EUW1_6877585319',2,22,20,0,1,1,0,8,0,386,80,31113,32659,42727,0,23,8,2,0,1,0,6,344,100,25589,28750,29049,1,42,-20,5524,12,3909,13678,-2,1,0,0,2
EUW1_6877542511',1,29,10,0,0,0,0,11,1,341,110,25914,27579,29554,4,33,14,1,0,1,0,1,343,94,29332,30437,41044,0,-2,16,-3418,-4,-2858,-11490,-1,0,-1,0,10
EUW1_6877286941',4,26,10,1,0,0,0,9,0,381,89,26697,30957,34121,4,23,11,1,0,0,0,2,358,92,26588,29074,34206,1,23,-3,109,-1,1883,-85,0,0,0,0,7
EUW1_6877231065',1,20,11,0,0,0,0,2,1,387,98,26849,30318,33734,4,32,6,1,1,0,0,4,358,94,23804,28489,28638,1,29,4,3045,5,1829,5096,-1,-1,0,0,-2
EUW1_6882921825',8,38,12,1,0,1,0,2,1,407,93,27982,32877,38155,4,32,5,0,0,0,0,0,371,93,24242,28292,21458,1,36,0,3740,7,4585,16697,1,0,1,0,2
EUW1_6882809206',4,33,9,1,0,1,0,13,1,383,99,28725,28927,21777,7,38,13,1,0,2,0,7,368,84,28452,30061,32878,0,15,15,273,-4,-1134,-11101,0,0,-1,0,6
EUW1_6882758714',5,55,11,0,0,0,0,11,1,364,98,26703,30294,25106,5,39,14,2,0,1,0,0,404,78,29539,30818,35478,0,-40,20,-2836,-3,-524,-10372,-2,0,-1,0,11
EUW1_6882678813',3,21,11,0,0,1,0,10,1,354,77,25991,28929,34735,2,24,11,2,0,1,0,2,350,94,28214,30588,32599,1,4,-17,-2223,0,-1659,2136,-2,0,0,0,8
EUW1_6882614956',4,35,15,1,0,0,0,10,1,348,80,29094,30156,43195,6,40,19,0,0,1,0,2,341,73,29374,30028,31523,0,7,7,-280,-4,128,11672,1,0,-1,0,8
EUW1_6880075100',2,37,12,0,0,0,0,8,0,339,105,26853,30624,27136,4,31,7,2,0,1,0,5,392,70,24726,28367,30300,1,-53,35,2127,5,2257,-3164,-2,0,-1,0,3
EUW1_6879964848',6,39,13,2,0,1,0,5,0,375,103,28425,31560,33230,2,22,9,0,0,0,0,5,396,74,26035,30893,30049,1,-21,29,2390,4,667,3181,2,0,1,0,0
EUW1_6879924950',4,30,20,0,0,1,0,8,1,402,84,33451,33646,41750,5,27,8,2,0,2,0,3,358,92,25300,28459,32966,1,44,-8,8151,12,5187,8784,-2,0,-1,0,5
EUW1_6879869343',11,37,15,0,0,0,0,6,1,357,108,30434,29520,31771,4,42,11,1,0,2,0,6,323,92,26606,29524,30605,0,34,16,3828,4,-4,1166,-1,0,-2,0,0
EUW1_6879819156',3,25,21,2,0,0,0,8,1,313,136,31229,31126,39121,4,22,16,0,0,1,0,3,358,88,30303,31062,35925,1,-45,48,926,5,64,3196,2,0,-1,0,5
EUW1_6882988198',5,30,13,0,0,0,0,10,0,319,73,28205,27521,28885,3,40,24,2,0,2,0,4,350,110,32770,33009,48887,0,-31,-37,-4565,-11,-5488,-20002,-2,0,-2,0,6
EUW1_6882947568',9,74,17,0,0,1,0,16,1,366,69,29763,28383,34604,4,100,15,1,0,1,0,3,355,74,30796,29342,32422,1,11,-5,-1033,2,-959,2182,-1,0,0,0,13
EUW1_6882883055',6,35,8,1,0,0,0,10,0,331,79,24502,26877,26628,4,38,12,0,0,1,0,1,368,92,26919,30331,30574,0,-37,-13,-2417,-4,-3454,-3946,1,0,-1,0,9
EUW1_6881771825',6,33,10,0,0,0,0,9,0,317,73,25179,26948,32527,5,27,19,2,0,1,0,3,385,78,31202,31393,43227,0,-68,-5,-6023,-9,-4445,-10700,-2,0,-1,0,6
EUW1_6881646581',6,31,8,0,0,0,0,9,1,376,56,25234,28393,22455,4,30,19,2,0,0,0,2,434,128,30907,34575,31881,0,-58,-72,-5673,-11,-6182,-9426,-2,0,0,0,7
EUW1_6879845032',5,24,13,0,0,0,0,13,1,339,92,28009,28397,29164,5,159,12,1,0,2,0,0,375,88,29015,29713,28166,1,-36,4,-1006,1,-1316,998,-1,0,-2,0,13
EUW1_6879802564',4,31,15,0,0,1,0,11,1,346,97,30058,31435,34987,6,76,15,2,0,1,0,4,356,95,28305,28731,32603,1,-10,2,1753,0,2704,2384,-2,0,0,0,7
EUW1_6879700928',1,29,17,0,0,1,0,11,0,389,86,31314,31833,39584,5,23,15,1,0,2,0,4,314,98,29248,29237,33372,0,75,-12,2066,2,2596,6212,-1,0,-1,0,7
EUW1_6879666170',5,33,11,1,0,1,0,14,0,354,104,27814,30413,25840,3,203,13,1,0,1,0,3,350,68,26731,28507,30008,0,4,36,1083,-2,1906,-4168,0,0,0,0,11
EUW1_6878864922',2,60,7,1,0,1,0,9,0,356,90,25875,28684,23907,6,63,10,1,1,1,0,2,371,97,27928,29721,25333,0,-15,-7,-2053,-3,-1037,-1426,0,-1,0,0,7
EUW1_6878719172',3,37,13,0,1,2,0,7,1,350,80,29942,29267,36287,7,28,15,1,0,2,0,8,351,84,28535,28834,32145,1,-1,-4,1407,-2,433,4142,-1,1,0,0,-1
EUW1_6878665360',3,24,10,2,0,0,0,12,1,306,84,25151,28106,21296,4,28,16,0,0,2,0,1,364,111,31423,31314,33727,1,-58,-27,-6272,-6,-3208,-12431,2,0,-2,0,11
EUW1_6877052539',3,26,14,2,0,2,0,8,1,412,116,31404,32853,36146,5,33,7,0,0,0,0,6,325,71,24199,28929,32609,1,87,45,7205,7,3924,3537,2,0,2,0,2
EUW1_6876845515',3,22,19,1,0,1,0,11,0,320,76,30004,28586,48654,3,53,21,0,0,1,0,8,331,64,30816,29194,47068,1,-11,12,-812,-2,-608,1586,1,0,0,0,3
EUW1_6870304471',5,67,16,1,0,0,0,7,1,359,77,29008,30266,36231,5,74,11,0,0,1,0,4,365,70,27623,28528,34216,0,-6,7,1385,5,1738,2015,1,0,-1,0,3
EUW1_6870240144',5,27,13,1,0,1,0,11,0,315,79,28358,27915,35212,5,28,12,1,0,2,0,7,354,94,27791,27532,28751,0,-39,-15,567,1,383,6461,0,0,-1,0,4
EUW1_6870183741',7,32,15,1,0,0,0,6,0,377,86,28971,31654,40747,2,24,12,1,0,0,0,1,357,97,28503,29940,35077,0,20,-11,468,3,1714,5670,0,0,0,0,5
EUW1_6883713441',3,29,5,0,0,0,0,16,0,329,87,24152,26841,28640,5,37,23,2,0,2,0,2,383,71,33298,33417,36052,0,-54,16,-9146,-18,-6576,-7412,-2,0,-2,0,14
EUW1_6880922741',4,29,16,1,0,0,0,3,1,354,82,28416,28416,38000,4,35,18,0,0,0,0,4,344,74,28776,27674,42526,1,10,8,-360,-2,742,-4526,1,0,0,0,-1
EUW1_6880890385',1,17,10,0,0,0,0,18,0,272,95,25378,28598,29016,7,35,20,2,0,3,0,4,399,84,33523,31655,43528,0,-127,11,-8145,-10,-3057,-14512,-2,0,-3,0,14
EUW1_6878353086',6,134,10,2,0,1,0,5,0,377,96,26809,30287,29759,6,35,9,0,0,0,0,5,344,72,25416,27448,29002,1,33,24,1393,1,2839,757,2,0,1,0,0
EUW1_6874980691',9,35,13,1,0,0,0,10,1,366,94,27548,30971,31007,1,30,7,1,0,1,0,2,333,94,25193,30847,33488,0,33,0,2355,6,124,-2481,0,0,-1,0,8
EUW1_6872907969',6,30,19,0,0,2,0,5,1,401,107,33169,32167,32724,2,29,6,2,0,0,0,11,341,99,25042,28816,28289,1,60,8,8127,13,3351,4435,-2,0,2,0,-6
EUW1_6869843688',5,62,16,1,0,0,0,8,0,352,111,29360,31083,39838,6,26,21,0,0,0,0,3,336,79,31295,31923,40232,0,16,32,-1935,-5,-840,-394,1,0,0,0,5
EUW1_6866598823',9,27,19,2,0,3,0,6,1,343,100,31997,31420,33406,2,24,12,0,0,0,0,9,326,87,26854,27483,32781,1,17,13,5143,7,3937,625,2,0,3,0,-3
EUW1_6882760814',2,22,12,0,0,0,0,7,1,418,81,27304,30928,28930,3,29,9,1,0,0,0,2,378,102,25709,29081,28778,0,40,-21,1595,3,1847,152,-1,0,0,0,5
EUW1_6882719904',2,23,19,2,0,0,0,10,1,322,114,31168,30563,34567,0,23,8,0,0,2,0,9,354,78,24929,27045,27238,1,-32,36,6239,11,3518,7329,2,0,-2,0,1
EUW1_6882666188',3,140,9,0,0,0,0,3,0,362,90,25826,29436,23607,4,22,13,1,0,1,0,4,366,94,27452,29023,32077,0,-4,-4,-1626,-4,413,-8470,-1,0,-1,0,-1
EUW1_6882613168',4,22,11,1,0,1,0,16,0,415,76,28924,30662,26027,3,51,11,1,0,2,0,4,349,100,27216,29536,25555,0,66,-24,1708,0,1126,472,0,0,-1,0,12
EUW1_6882566525',4,32,15,1,0,0,0,13,1,308,92,27205,28213,34161,2,28,15,0,0,3,0,3,354,72,29138,28318,34647,1,-46,20,-1933,0,-105,-486,1,0,-3,0,10
EUW1_6882536920',6,37,8,0,0,0,0,14,0,337,64,23726,26114,33051,5,98,22,1,0,2,0,0,344,114,32698,34228,43856,0,-7,-50,-8972,-14,-8114,-10805,-1,0,-2,0,14
EUW1_6881806176',5,35,11,1,0,1,0,14,1,393,88,28133,30479,28112,4,37,6,1,0,0,0,3,395,113,25915,31038,23891,0,-2,-25,2218,5,-559,4221,0,0,1,0,11
EUW1_6881700106',3,27,12,0,0,0,0,8,1,353,68,26607,28977,30894,4,41,6,2,0,1,0,2,317,104,23985,26889,26876,1,36,-36,2622,6,2088,4018,-2,0,-1,0,6
EUW1_6881611336',3,25,23,1,0,2,0,7,1,349,82,31889,32230,45927,3,29,10,0,0,0,0,7,316,84,25037,28118,28268,1,33,-2,6852,13,4112,17659,1,0,2,0,0
EUW1_6881335735',7,29,18,0,0,4,0,8,0,387,74,33589,30180,35540,6,31,6,2,0,2,0,8,309,95,22980,25988,18310,1,78,-21,10609,12,4192,17230,-2,0,2,0,0
EUW1_6881279721',3,23,18,1,1,1,0,6,1,384,98,31238,31221,33824,5,30,10,1,0,1,0,5,325,98,26503,29339,32888,1,59,0,4735,8,1882,936,0,1,0,0,1
EUW1_6881232058',2,22,9,2,0,0,0,11,1,328,86,25110,27782,26208,4,26,16,0,0,2,0,1,387,82,30231,31496,36512,0,-59,4,-5121,-7,-3714,-10304,2,0,-2,0,10
EUW1_6881179015',3,37,13,0,0,0,0,15,0,322,86,26361,28853,36361,3,30,20,1,0,2,0,0,364,96,31742,32182,49439,0,-42,-10,-5381,-7,-3329,-13078,-1,0,-2,0,15
EUW1_6881130774',5,25,8,1,0,0,0,13,0,337,90,24595,28203,20092,6,30,17,1,0,2,0,0,357,81,30143,29215,37012,0,-20,9,-5548,-9,-1012,-16920,0,0,-2,0,13
EUW1_6881072748',5,28,15,0,1,0,0,4,0,381,90,28342,31195,30918,5,52,13,1,0,0,0,4,370,97,27727,31905,34349,1,11,-7,615,2,-710,-3431,-1,1,0,0,0
EUW1_6872626828',3,25,4,0,0,0,0,12,1,340,83,22808,26600,26113,4,72,12,2,0,3,0,1,412,96,30283,31902,41882,0,-72,-13,-7475,-8,-5302,-15769,-2,0,-3,0,11
EUW1_6872580127',4,24,13,0,1,0,0,9,0,351,90,26987,28020,27426,3,32,14,2,0,1,0,1,383,80,28765,30557,26685,0,-32,10,-1778,-1,-2537,741,-2,1,-1,0,8
EUW1_6871387020',7,33,17,1,1,2,0,11,1,386,68,31535,31108,35498,2,33,12,0,0,1,0,5,352,84,28583,28821,29747,1,34,-16,2952,5,2287,5751,1,1,1,0,6
EUW1_6871306162',1,23,17,1,0,1,0,8,1,401,101,30464,32603,35762,3,149,8,1,0,0,0,1,363,93,24716,28730,29200,1,38,8,5748,9,3873,6562,0,0,1,0,7
EUW1_6871262189',1,30,12,0,0,0,0,13,0,325,95,27798,27346,33208,5,28,17,2,0,2,0,3,373,99,31062,30424,44913,0,-48,-4,-3264,-5,-3078,-11705,-2,0,-2,0,10
EUW1_6871128098',4,34,10,0,0,0,0,9,0,387,68,25959,28529,29686,9,46,17,1,1,1,0,5,400,84,31032,31257,32118,1,-13,-16,-5073,-7,-2728,-2432,-1,-1,-1,0,4
EUW1_6870857774',4,27,19,2,0,2,0,11,1,390,89,31472,31131,37752,2,21,7,0,0,0,0,7,361,90,25233,26965,23979,1,29,-1,6239,12,4166,13773,2,0,2,0,4
EUW1_6870837868',1,23,4,0,0,0,0,13,0,280,114,23328,26738,26843,3,107,22,1,0,1,0,0,370,85,30999,32319,40781,0,-90,29,-7671,-18,-5581,-13938,-1,0,-1,0,13
EUW1_6870807335',5,24,3,0,0,0,0,12,0,369,110,24674,30166,24131,1,23,17,2,0,3,0,4,402,81,30325,32513,37891,0,-33,29,-5651,-14,-2347,-13760,-2,0,-3,0,8
EUW1_6870780031',4,30,20,2,0,2,0,7,0,316,90,29729,30853,40793,4,28,9,0,1,1,0,7,330,85,26325,27624,35831,1,-14,5,3404,11,3229,4962,2,-1,1,0,0
EUW1_6870682502',4,66,25,1,1,1,0,9,0,312,111,32534,32718,36117,1,92,13,1,0,0,0,8,358,40,28197,27883,37551,1,-46,71,4337,12,4835,-1434,0,1,1,0,1
EUW1_6870612302',2,24,21,2,1,0,0,9,1,274,112,28823,28325,39752,1,25,8,0,0,1,0,3,344,76,26463,27122,34593,0,-70,36,2360,13,1203,5159,2,1,-1,0,6
EUW1_6883078700',2,19,16,0,0,1,0,10,1,336,88,29973,31660,38749,1,23,14,2,0,1,0,5,338,92,27696,29719,34165,0,-2,-4,2277,2,1941,4584,-2,0,0,0,5
EUW1_6882518566',5,26,19,1,0,1,0,10,1,360,77,30667,31985,38055,3,140,13,1,0,0,0,2,376,74,27454,29601,39435,1,-16,3,3213,6,2384,-1380,0,0,1,0,8
EUW1_6881669363',5,171,11,2,0,1,0,6,0,370,76,27486,28410,30883,8,46,14,0,0,1,0,3,388,76,28272,30537,34208,1,-18,0,-786,-3,-2127,-3325,2,0,0,0,3
EUW1_6881555391',4,73,15,1,1,0,0,5,0,382,103,30088,30110,33039,6,33,10,0,0,1,0,7,356,67,26482,28918,26513,1,26,36,3606,5,1192,6526,1,1,-1,0,-2
EUW1_6879645493',6,31,11,1,0,1,0,11,0,322,70,27110,27320,34409,4,28,21,1,1,1,0,2,381,88,30727,31353,35323,0,-59,-18,-3617,-10,-4033,-914,0,-1,0,0,9
EUW1_6878402664',2,24,9,0,0,0,0,12,1,345,90,25458,27922,21967,6,35,15,2,0,2,0,2,372,94,30036,30475,27669,0,-27,-4,-4578,-6,-2553,-5702,-2,0,-2,0,10
EUW1_6878351002',4,23,10,1,0,1,0,11,0,390,115,29049,31059,28472,5,27,14,0,0,0,0,6,382,108,28834,31952,32832,1,8,7,215,-4,-893,-4360,1,0,1,0,5
EUW1_6878071252',3,15,19,2,1,0,0,14,1,301,94,31009,29537,33538,1,22,9,0,0,1,0,5,348,98,26976,28390,31531,1,-47,-4,4033,10,1147,2007,2,1,-1,0,9
EUW1_6876889213',3,25,16,1,0,1,0,14,1,350,72,29384,29362,31713,4,30,23,1,0,1,0,4,349,107,32678,33259,37646,0,1,-35,-3294,-7,-3897,-5933,0,0,0,0,10
EUW1_6876831351',1,26,12,0,0,1,0,7,0,383,83,28603,30389,33366,4,28,14,2,0,0,0,3,379,84,27511,29424,27883,1,4,-1,1092,-2,965,5483,-2,0,1,0,4
EUW1_6875450995',4,35,17,0,0,0,0,13,0,330,89,28820,30791,32317,3,29,19,1,1,3,0,3,420,90,33432,33017,35553,1,-90,-1,-4612,-2,-2226,-3236,-1,-1,-3,0,10
EUW1_6875397260',5,24,8,0,1,1,0,9,0,362,92,26234,29791,28098,7,36,12,2,0,1,0,4,345,80,26426,28259,28894,0,17,12,-192,-4,1532,-796,-2,1,0,0,5
EUW1_6875371122',5,24,11,1,0,0,0,10,0,334,76,25810,28369,29245,7,32,28,0,1,2,0,3,378,116,36358,34868,47597,0,-44,-40,-10548,-17,-6499,-18352,1,-1,-2,0,7
EUW1_6875198959',4,30,22,1,0,2,0,9,1,408,84,33339,33655,47344,3,36,12,0,0,1,0,8,342,83,26915,30352,33095,1,66,1,6424,10,3303,14249,1,0,1,0,1
EUW1_6874502458',3,20,15,0,0,0,0,11,0,297,78,26111,26443,33050,1,22,9,1,0,1,0,2,368,85,27197,28549,25906,0,-71,-7,-1086,6,-2106,7144,-1,0,-1,0,9
EUW1_6882343838',7,30,18,1,0,1,0,5,1,336,108,30658,30164,45967,4,27,18,1,0,0,0,5,321,90,29170,29969,39915,0,15,18,1488,0,195,6052,0,0,1,0,0
EUW1_6882337725',8,35,20,2,0,1,0,9,1,380,88,33187,30419,37470,6,32,7,0,0,0,0,4,322,64,23404,25334,31772,1,58,24,9783,13,5085,5698,2,0,1,0,5
EUW1_6882325758',1,30,9,0,0,0,0,9,1,322,98,26104,27938,27998,4,104,21,2,0,1,0,3,346,135,31946,33105,36797,0,-24,-37,-5842,-12,-5167,-8799,-2,0,-1,0,6
EUW1_6882309878',9,50,16,0,0,0,0,12,0,282,65,27815,28275,40066,6,31,16,2,0,2,0,2,328,78,28401,28208,41883,0,-46,-13,-586,0,67,-1817,-2,0,-2,0,10
EUW1_6882288435',7,28,16,1,0,1,0,3,1,384,112,30423,31656,30853,6,34,6,1,0,0,0,8,359,99,24580,28565,24027,1,25,13,5843,10,3091,6826,0,0,1,0,-5
EUW1_6882274361',9,34,12,0,0,0,0,10,1,354,70,27904,30822,31018,3,24,15,1,0,1,0,3,404,114,29928,32635,34775,0,-50,-44,-2024,-3,-1813,-3757,-1,0,-1,0,7
EUW1_6882259054',2,25,16,0,0,2,0,10,0,315,78,29054,29203,29001,4,27,13,1,1,0,0,4,354,82,26409,28474,32823,0,-39,-4,2645,3,729,-3822,-1,-1,2,0,6
EUW1_6882235039',5,28,21,0,0,1,0,13,1,309,73,31172,29644,40584,4,35,28,1,0,2,0,4,354,61,34879,31651,54484,1,-45,12,-3707,-7,-2007,-13900,-1,0,-1,0,9
EUW1_6881800892',3,24,26,1,0,1,0,4,0,379,85,34004,33845,46865,3,42,8,0,0,1,0,7,275,53,24255,25550,32183,1,104,32,9749,18,8295,14682,1,0,0,0,-3
EUW1_6881742618',7,33,9,0,0,0,0,11,0,349,94,25410,27043,29095,2,20,14,2,0,2,0,0,370,90,29701,29702,34976,0,-21,4,-4291,-5,-2659,-5881,-2,0,-2,0,11
EUW1_6883538429',3,32,17,1,0,2,0,9,1,368,94,30544,30644,33881,3,26,7,0,0,0,0,6,376,76,24561,27552,28222,1,-8,18,5983,10,3092,5659,1,0,2,0,3
EUW1_6883509961',6,67,14,1,0,1,0,8,0,373,82,28684,29925,30788,2,25,7,1,0,0,0,5,370,109,25800,29372,23700,0,3,-27,2884,7,553,7088,0,0,1,0,3
EUW1_6883459996',7,34,17,1,0,1,0,10,0,318,90,29918,27898,36363,2,27,12,1,0,0,0,5,366,79,27015,27929,33180,0,-48,11,2903,5,-31,3183,0,0,1,0,5
EUW1_6883409840',0,27,19,1,0,1,0,12,0,309,89,30478,29408,37347,6,34,13,1,0,1,0,3,378,79,29689,30123,36686,1,-69,10,789,6,-715,661,0,0,0,0,9
EUW1_6883100340',4,28,12,1,0,0,0,12,0,332,79,26670,27899,27066,2,32,9,1,1,2,0,2,389,83,27686,28626,27715,0,-57,-4,-1016,3,-727,-649,0,-1,-2,0,10
EUW1_6883027147',8,32,13,1,0,0,0,11,0,388,84,28913,30927,40005,3,23,9,0,0,1,0,4,333,63,23953,27132,33833,1,55,21,4960,4,3795,6172,1,0,-1,0,7
EUW1_6882986316',4,25,24,2,0,2,0,10,0,410,77,34849,31964,43879,2,29,10,0,0,2,0,12,337,62,27531,27451,34142,1,73,15,7318,14,4513,9737,2,0,0,0,-2
EUW1_6882941739',3,31,11,1,1,0,0,7,1,386,93,27774,31318,33000,4,242,9,1,0,2,0,4,343,86,25108,28617,27285,1,43,7,2666,2,2701,5715,0,1,-2,0,3
EUW1_6882888803',1,62,15,2,1,1,0,9,1,327,83,29250,30110,37580,8,63,12,0,0,0,0,6,329,68,26177,26618,37940,1,-2,15,3073,3,3492,-360,2,1,1,0,3
EUW1_6882833395',3,51,12,0,0,2,0,9,1,364,107,29355,29274,28438,5,31,12,1,0,1,0,8,376,60,27641,28603,36028,1,-12,47,1714,0,671,-7590,-1,0,1,0,1
EUW1_6881402177',3,30,9,1,0,0,0,10,0,372,74,26815,29339,26530,5,30,13,1,0,3,0,2,403,75,28988,29733,33345,0,-31,-1,-2173,-4,-394,-6815,0,0,-3,0,8
EUW1_6880309133',5,28,14,1,0,0,0,5,1,348,79,27574,28114,33895,3,34,12,0,0,2,0,7,319,62,25953,28290,33557,0,29,17,1621,2,-176,338,1,0,-2,0,-2
EUW1_6879047313',5,49,19,0,0,2,0,6,0,403,68,31983,32007,40554,3,30,10,2,0,0,0,4,369,95,26514,30082,31966,1,34,-27,5469,9,1925,8588,-2,0,2,0,2
EUW1_6878689716',7,28,14,0,0,1,0,5,1,335,72,28452,28421,31514,6,32,10,2,0,1,0,6,376,98,27271,30339,31258,1,-41,-26,1181,4,-1918,256,-2,0,0,0,-1
EUW1_6878615945',2,36,14,0,0,0,0,11,0,367,95,28467,29588,37228,3,34,18,2,0,1,0,2,353,68,30266,29921,39015,0,14,27,-1799,-4,-333,-1787,-2,0,-1,0,9
EUW1_6878281434',4,28,23,1,0,0,0,16,0,306,68,31157,29541,41627,5,28,27,0,0,3,0,1,357,84,35872,31151,49583,0,-51,-16,-4715,-4,-1610,-7956,1,0,-3,0,15
EUW1_6877557859',3,25,19,1,0,1,0,9,0,387,72,30809,29077,41829,4,38,16,1,0,1,0,2,352,78,30393,28410,37528,0,35,-6,416,3,667,4301,0,0,0,0,7
EUW1_6877453308',1,19,10,1,0,1,0,6,1,345,78,27318,28674,27329,7,37,19,1,0,0,0,3,359,108,28913,32076,32376,0,-14,-30,-1595,-9,-3402,-5047,0,0,1,0,3
EUW1_6877345682',4,39,10,2,0,1,0,12,0,328,96,27132,27314,33780,2,21,14,0,0,2,0,6,334,92,28784,27972,34500,0,-6,4,-1652,-4,-658,-720,2,0,-1,0,6
EUW1_6883063772',3,25,11,1,0,0,0,2,0,417,104,28091,32060,31143,2,23,9,0,0,0,0,3,415,83,26713,32241,26497,1,2,21,1378,2,-181,4646,1,0,0,0,-1
EUW1_6883013696',5,28,12,0,0,1,0,7,1,364,108,29167,30766,27282,8,35,11,2,0,1,0,5,368,80,27736,30754,24768,0,-4,28,1431,1,12,2514,-2,0,0,0,2
EUW1_6882812474',2,27,15,1,0,1,0,13,1,344,78,29665,28876,32791,3,21,24,1,0,2,0,6,418,82,34258,34537,46321,0,-74,-4,-4593,-9,-5661,-13530,0,0,-1,0,7
EUW1_6882764688',4,23,7,0,0,0,0,10,1,395,100,25304,29186,26181,2,26,10,1,0,2,0,2,382,83,26838,30294,23052,0,13,17,-1534,-3,-1108,3129,-1,0,-2,0,8
EUW1_6882716027',4,24,15,0,0,0,0,9,1,362,71,28151,29776,27532,3,21,6,2,0,1,0,5,350,98,25369,29098,25242,1,12,-27,2782,9,678,2290,-2,0,-1,0,4
EUW1_6882118986',7,28,20,1,0,1,0,7,0,359,98,32021,31554,44127,4,33,13,0,0,1,0,5,340,74,27628,28365,31218,0,19,24,4393,7,3189,12909,1,0,0,0,2
EUW1_6881330910',10,92,7,0,0,0,0,9,0,334,91,24422,28679,27016,2,30,12,1,0,1,0,1,373,104,28721,30171,30076,0,-39,-13,-4299,-5,-1492,-3060,-1,0,-1,0,8
EUW1_6879717309',9,32,13,0,0,1,0,12,0,310,87,26486,27133,30029,7,29,12,2,0,1,0,4,335,92,27762,28414,28615,0,-25,-5,-1276,1,-1281,1414,-2,0,0,0,8
EUW1_6879680915',1,33,7,1,0,0,0,5,0,380,98,24442,29080,31996,4,47,11,1,0,0,0,2,379,101,26835,30812,31880,0,1,-3,-2393,-4,-1732,116,0,0,0,0,3
EUW1_6878808458',4,237,15,0,1,0,0,7,1,369,84,29128,31838,33283,3,27,12,2,0,1,0,5,327,108,26665,29881,30189,1,42,-24,2463,3,1957,3094,-2,1,-1,0,2
EUW1_6878746077',2,26,10,0,0,1,0,3,1,398,100,28719,31702,27839,3,28,12,1,0,0,0,7,395,101,29522,31554,36015,0,3,-1,-803,-2,148,-8176,-1,0,1,0,-4
EUW1_6878627679',5,29,10,1,0,0,0,8,0,387,88,26956,30886,31499,2,23,10,1,0,2,0,4,368,90,26339,29804,30231,1,19,-2,617,0,1082,1268,0,0,-2,0,4
EUW1_6878579886',5,35,8,1,0,0,0,11,1,397,84,26429,29594,30193,4,98,9,1,0,1,0,3,428,116,28863,33185,26411,0,-31,-32,-2434,-1,-3591,3782,0,0,-1,0,8
EUW1_6878455004',4,24,8,0,0,0,0,9,0,368,80,25367,26586,38603,5,36,20,1,0,1,0,5,348,80,31689,31790,44934,0,20,0,-6322,-12,-5204,-6331,-1,0,-1,0,4
EUW1_6878416535',2,29,13,1,0,2,0,9,1,362,92,28235,30813,34706,3,32,11,1,0,0,0,1,345,67,26232,28254,33730,0,17,25,2003,2,2559,976,0,0,2,0,8
EUW1_6876864859',5,29,15,0,0,1,0,6,1,362,69,28510,27231,37017,2,23,7,2,0,0,0,5,362,82,24021,27218,27113,1,0,-13,4489,8,13,9904,-2,0,1,0,1
EUW1_6876746922',2,30,13,0,0,1,0,8,1,302,90,26914,27336,38375,0,20,17,1,0,0,0,4,344,96,29446,31773,37581,0,-42,-6,-2532,-4,-4437,794,-1,0,1,0,4
EUW1_6876711497',6,26,9,1,0,0,0,8,0,390,96,28081,29867,27636,9,60,10,1,0,1,0,2,393,88,27326,30446,27641,0,-3,8,755,-1,-579,-5,0,0,-1,0,6
EUW1_6883421526',3,48,14,1,0,0,0,3,1,376,99,29127,30886,34381,1,21,7,0,0,0,0,5,341,68,23250,27144,26047,1,35,31,5877,7,3742,8334,1,0,0,0,-2
EUW1_6883343790',0,24,10,0,0,0,0,6,0,367,83,25946,29632,24116,9,36,14,2,0,1,0,2,395,96,28095,29582,34226,0,-28,-13,-2149,-4,50,-10110,-2,0,-1,0,4
EUW1_6883271997',4,24,17,0,0,2,0,8,1,351,74,30299,28209,33338,1,205,9,1,0,1,0,4,326,84,26852,27890,25070,1,25,-10,3447,8,319,8268,-1,0,1,0,4
EUW1_6883196707',4,133,11,1,0,0,0,15,0,328,116,28289,29660,32725,4,25,20,1,0,2,0,7,358,68,30226,30500,36608,0,-30,48,-1937,-9,-840,-3883,0,0,-2,0,8
EUW1_6882260309',2,34,12,0,0,0,0,13,1,296,88,25116,29280,28139,0,28,12,1,0,3,0,1,375,81,28537,31154,32295,1,-79,7,-3421,0,-1874,-4156,-1,0,-3,0,12
EUW1_6882243474',6,45,14,1,0,1,0,7,1,362,104,28660,31138,34594,2,85,11,0,1,1,0,1,352,80,27112,30853,31027,1,10,24,1548,3,285,3567,1,-1,0,0,6
EUW1_6882200399',5,32,6,0,0,0,0,10,0,362,83,24442,28233,29547,4,32,13,2,0,1,0,5,342,106,29070,29761,29927,0,20,-23,-4628,-7,-1528,-380,-2,0,-1,0,5
EUW1_6882178585',2,25,8,0,0,0,0,8,0,343,112,25279,30006,27250,6,41,16,1,0,1,0,5,376,84,29173,32741,36034,0,-33,28,-3894,-8,-2735,-8784,-1,0,-1,0,3
EUW1_6882136606',7,39,9,0,0,0,0,7,0,375,90,27248,28081,28377,5,33,11,1,0,1,0,4,339,89,26977,30454,28724,0,36,1,271,-2,-2373,-347,-1,0,-1,0,3
EUW1_6882078999',5,25,8,1,0,0,0,7,1,395,82,25121,29881,32729,1,21,2,1,0,1,0,3,366,94,23835,28007,23532,1,29,-12,1286,6,1874,9197,0,0,-1,0,4
EUW1_6880182055',5,24,11,0,1,1,0,12,1,350,88,29434,29583,31714,4,28,19,2,0,1,0,5,335,76,29506,29988,29892,0,15,12,-72,-8,-405,1822,-2,1,0,0,7
EUW1_6880129512',8,36,11,0,0,1,0,8,0,368,75,26838,30056,34387,9,40,14,1,1,0,0,0,386,120,29212,30284,31549,0,-18,-45,-2374,-3,-228,2838,-1,-1,1,0,8
EUW1_6880076569',4,35,12,1,0,1,0,2,0,377,79,26723,28761,27815,3,60,10,0,0,0,0,5,333,88,25342,28931,25977,1,44,-9,1381,2,-170,1838,1,0,1,0,-3
EUW1_6879966303',3,25,9,1,0,1,0,3,1,410,96,26997,30571,26894,4,34,8,1,0,0,0,5,341,91,25033,28272,27991,0,69,5,1964,1,2299,-1097,0,0,1,0,-2
EUW1_6879919196',4,86,24,1,0,1,0,8,0,376,92,33639,33578,44577,2,54,9,0,0,1,0,5,378,99,26037,30341,37971,1,-2,-7,7602,15,3237,6606,1,0,0,0,3
EUW1_6879881422',2,24,19,1,0,2,0,10,0,321,94,28906,29781,39241,1,24,6,0,0,1,0,4,338,78,26369,25581,26354,1,-17,16,2537,13,4200,12887,1,0,1,0,6
EUW1_6879811385',2,31,11,1,0,0,0,13,0,390,101,28399,30952,27538,5,28,16,1,0,3,0,5,373,94,30443,30642,33023,0,17,7,-2044,-5,310,-5485,0,0,-3,0,8
EUW1_6879613346',6,223,6,1,0,0,0,8,0,366,92,24904,28894,22168,3,51,14,1,0,0,0,2,369,94,28408,31052,28271,0,-3,-2,-3504,-8,-2158,-6103,0,0,0,0,6
EUW1_6883413814',5,32,10,0,0,1,0,5,0,335,114,27091,30778,32331,4,75,7,1,0,0,0,5,305,89,23572,27287,25982,1,30,25,3519,3,3491,6349,-1,0,1,0,0
EUW1_6883342783',6,25,10,2,0,0,0,7,0,395,88,27046,29866,27513,1,23,11,0,0,1,0,2,369,132,27494,30810,27407,1,26,-44,-448,-1,-944,106,2,0,-1,0,5
EUW1_6883286731',4,264,12,1,0,0,0,12,1,363,80,26362,30173,23878,3,27,10,1,0,2,0,3,423,95,29334,30760,33594,0,-60,-15,-2972,2,-587,-9716,0,0,-2,0,9
EUW1_6882727003',3,44,11,0,0,1,0,19,1,332,47,27232,25837,29963,3,28,11,1,0,5,0,7,279,116,28316,28675,32851,0,53,-69,-1084,0,-2838,-2888,-1,0,-4,0,12
EUW1_6882695647',5,261,7,1,0,0,0,14,0,346,106,25880,29810,31560,3,39,14,0,0,1,0,5,433,94,28939,32418,35025,0,-87,12,-3059,-7,-2608,-3465,1,0,-1,0,9
EUW1_6882610484',6,32,20,2,0,1,0,5,1,343,92,31259,31915,42416,5,48,13,0,0,0,0,6,361,100,27674,30111,33049,1,-18,-8,3585,7,1804,9367,2,0,1,0,-1
EUW1_6882052286',3,63,14,0,0,0,0,9,0,334,91,27714,29421,38940,8,35,16,1,1,1,0,4,336,75,28881,30458,36485,1,-2,16,-1167,-2,-1037,2455,-1,-1,-1,0,5
EUW1_6882009746',7,39,15,1,0,0,0,11,1,383,91,28463,31501,26557,1,18,12,0,0,1,0,0,439,76,27763,30994,24789,1,-56,15,700,3,507,1768,1,0,-1,0,11
EUW1_6881850023',6,25,11,1,0,0,0,7,1,356,82,26598,30285,34914,8,29,12,1,0,0,0,1,362,98,26965,29237,34182,1,-6,-16,-367,-1,1048,732,0,0,0,0,6
EUW1_6881802490',1,134,20,1,0,1,0,11,1,384,92,32781,31838,42763,7,25,15,1,1,2,0,6,331,95,28409,30469,33760,0,53,-3,4372,5,1369,9003,0,-1,-1,0,5
EUW1_6881412382',8,31,17,0,0,1,0,14,1,297,90,28878,26707,29073,2,47,18,1,0,2,0,4,356,90,30655,29042,38050,0,-59,0,-1777,-1,-2335,-8977,-1,0,-1,0,10
EUW1_6881337327',4,34,9,0,0,1,0,11,1,385,94,26725,31414,23304,8,46,7,1,0,0,0,3,388,102,26053,30445,25203,0,-3,-8,672,2,969,-1899,-1,0,1,0,8
EUW1_6881280965',9,31,13,0,0,0,0,10,1,332,84,26924,28965,33535,5,35,8,2,0,0,0,1,357,96,24979,28687,36466,1,-25,-12,1945,5,278,-2931,-2,0,0,0,9
EUW1_6881216492',3,27,6,0,0,0,0,12,0,357,107,25377,29079,24500,5,28,15,2,0,1,0,4,347,92,27836,30298,32752,0,10,15,-2459,-9,-1219,-8252,-2,0,-1,0,8
EUW1_6881169781',5,29,17,2,1,1,0,10,0,368,109,30501,30543,34723,2,25,7,0,0,0,0,3,342,80,24388,28075,25127,1,26,29,6113,10,2468,9596,2,1,1,0,7
EUW1_6881125154',1,26,16,0,0,1,0,4,1,359,88,30784,31929,34517,3,105,12,1,0,1,0,8,331,87,26656,29522,33711,1,28,1,4128,4,2407,806,-1,0,0,0,-4
EUW1_6881073082',2,27,15,1,0,2,0,8,1,347,82,29698,29639,38838,8,31,16,1,0,0,0,6,367,66,27319,28674,40678,0,-20,16,2379,-1,965,-1840,0,0,2,0,2
EUW1_6881036636',3,37,4,0,0,0,0,10,1,302,86,22265,27059,21740,6,150,13,0,0,2,0,0,418,93,29039,31004,29197,0,-116,-7,-6774,-9,-3945,-7457,0,0,-2,0,10
EUW1_6880999963',4,30,10,1,0,0,0,8,0,369,81,26220,29205,34592,6,35,10,1,0,1,0,0,340,106,27417,29618,35529,0,29,-25,-1197,0,-413,-937,0,0,-1,0,8
EUW1_6882712514',6,28,12,0,0,0,0,7,0,388,106,26308,32117,32350,5,29,11,2,0,0,0,2,363,102,26562,29856,23675,0,25,4,-254,1,2261,8675,-2,0,0,0,5
EUW1_6882657260',2,22,6,2,0,1,0,8,1,346,93,24984,28299,29323,1,26,10,0,0,1,0,7,376,110,27936,31508,32671,0,-30,-17,-2952,-4,-3209,-3348,2,0,0,0,1
EUW1_6882052337',2,159,18,0,0,1,0,10,1,302,72,27818,28221,34358,3,26,10,1,0,0,0,4,296,79,25255,27671,35213,1,6,-7,2563,8,550,-855,-1,0,1,0,6
EUW1_6881989975',5,28,12,0,0,1,0,7,0,401,81,28095,31070,36329,3,32,14,2,0,0,0,3,333,79,26808,31408,30646,0,68,2,1287,-2,-338,5683,-2,0,1,0,4
EUW1_6881906274',3,22,15,0,0,0,0,11,0,293,84,26831,32614,30647,1,23,13,1,0,2,0,1,392,88,29174,30042,38603,0,-99,-4,-2343,2,2572,-7956,-1,0,-2,0,10
EUW1_6881068471',3,37,12,1,0,2,0,5,0,394,84,28660,30848,29610,4,27,9,1,0,0,0,9,288,66,23487,25391,25549,1,106,18,5173,3,5457,4061,0,0,2,0,-4
EUW1_6881023287',3,141,6,0,1,0,0,4,0,356,98,24613,29922,22176,1,19,9,2,0,0,0,2,380,102,26963,31891,22651,0,-24,-4,-2350,-3,-1969,-475,-2,1,0,0,2
EUW1_6880204363',9,35,13,2,0,0,0,8,1,346,86,26890,29697,21208,0,28,10,0,0,0,0,4,385,86,26552,29930,26408,1,-39,0,338,3,-233,-5200,2,0,0,0,4
EUW1_6880142987',4,65,17,1,0,0,0,13,1,321,84,28758,29532,35624,2,65,14,1,0,2,0,4,361,91,30878,31061,35190,0,-40,-7,-2120,3,-1529,434,0,0,-2,0,9
EUW1_6880066455',4,44,27,0,0,2,0,12,1,331,104,33776,32261,46719,2,76,16,1,0,1,0,6,301,83,28984,29753,38953,0,30,21,4792,11,2508,7766,-1,0,1,0,6
EUW1_6879931151',5,38,14,1,0,1,0,6,1,365,113,29888,30673,27896,2,39,8,1,0,0,0,6,363,85,24776,29594,21486,1,2,28,5112,6,1079,6410,0,0,1,0,0
EUW1_6879847193',2,64,13,0,0,1,0,12,1,338,95,27904,30810,24945,3,29,13,2,0,2,0,4,387,80,28730,28802,30362,0,-49,15,-826,0,2008,-5417,-2,0,-1,0,8
EUW1_6879817503',4,43,22,1,0,3,0,2,1,349,67,34208,30494,35387,1,26,9,0,0,1,0,10,319,87,26706,27741,22121,1,30,-20,7502,13,2753,13266,1,0,2,0,-8
EUW1_6878826173',5,33,13,1,0,0,0,10,1,346,95,26823,31247,32716,7,26,13,1,0,0,0,0,312,100,26905,28463,26890,0,34,-5,-82,0,2784,5826,0,0,0,0,10
EUW1_6878772064',3,62,11,0,0,2,0,8,0,383,95,27850,29664,30900,1,37,10,1,0,0,0,8,270,104,25948,29022,32939,1,113,-9,1902,1,642,-2039,-1,0,2,0,0
EUW1_6878538620',4,24,19,2,0,2,0,6,1,412,96,32322,32872,36508,6,27,6,0,0,0,0,7,309,92,23709,26402,26051,1,103,4,8613,13,6470,10457,2,0,2,0,-1
EUW1_6878483649',3,24,12,1,0,0,0,11,0,375,86,27918,30524,27308,2,21,17,1,0,1,0,4,381,92,29736,31379,32680,0,-6,-6,-1818,-5,-855,-5372,0,0,-1,0,7
EUW1_6878174441',4,27,4,0,0,0,0,12,1,378,83,23929,29132,21661,2,22,2,2,0,1,0,1,396,72,23729,28354,21747,1,-18,11,200,2,778,-86,-2,0,-1,0,11
EUW1_6877770455',1,21,8,1,0,1,0,6,0,401,93,27284,32033,30689,2,89,15,1,0,0,0,8,359,90,27437,32064,30977,1,42,3,-153,-7,-31,-288,0,0,1,0,-2
EUW1_6883555960',4,38,11,0,0,1,0,13,1,352,100,27998,29278,30315,6,95,14,1,0,1,0,8,320,92,28537,29876,36601,1,32,8,-539,-3,-598,-6286,-1,0,0,0,5
EUW1_6883515067',5,62,13,1,0,1,0,7,1,372,88,28830,31590,29040,2,67,5,1,0,0,0,6,347,90,22382,27974,18293,1,25,-2,6448,8,3616,10747,0,0,1,0,1
EUW1_6881150595',6,27,17,1,1,2,0,5,1,372,102,31865,32781,37363,2,156,10,0,0,0,0,6,355,86,26669,29534,24349,1,17,16,5196,7,3247,13014,1,1,2,0,-1
EUW1_6880666125',4,28,12,0,0,0,0,10,0,367,84,27090,33051,34548,5,34,10,2,0,0,0,1,373,95,25846,31303,31061,0,-6,-11,1244,2,1748,3487,-2,0,0,0,9
EUW1_6880610093',3,30,18,0,0,1,0,11,0,334,102,30778,31302,31249,3,29,19,1,0,2,0,5,387,100,32654,32324,33959,1,-53,2,-1876,-1,-1022,-2710,-1,0,-1,0,6
EUW1_6876621472',2,27,9,2,0,0,0,5,0,387,91,25873,30254,24644,3,143,8,0,0,0,0,3,368,80,25505,28467,24589,1,19,11,368,1,1787,55,2,0,0,0,2
EUW1_6876585165',4,24,15,0,0,0,0,13,1,330,80,29873,31176,46612,3,30,28,2,0,2,0,7,336,99,33782,33089,52742,0,-6,-19,-3909,-13,-1913,-6130,-2,0,-2,0,6
EUW1_6875825406',1,19,12,0,0,0,0,6,0,387,97,27367,31959,32093,1,26,9,2,0,0,0,5,341,102,25515,28512,26502,1,46,-5,1852,3,3447,5591,-2,0,0,0,1
EUW1_6875445830',3,24,11,0,0,0,0,10,0,310,88,26140,27930,31364,2,31,17,2,0,1,0,1,381,100,30176,32147,38926,0,-71,-12,-4036,-6,-4217,-7562,-2,0,-1,0,9
EUW1_6875328967',5,22,24,2,0,4,0,6,1,344,120,34147,32421,43475,3,35,9,0,0,0,0,8,311,83,24610,26386,31321,1,33,37,9537,15,6035,12154,2,0,4,0,-2
EUW1_6875273391',6,28,12,1,0,0,0,15,1,340,94,27712,27429,30926,4,27,15,1,0,2,0,3,353,93,30712,30118,33393,0,-13,1,-3000,-3,-2689,-2467,0,0,-2,0,12
EUW1_6874815680',4,37,12,0,0,1,0,6,1,366,72,28123,29523,36512,3,97,13,1,0,0,0,6,346,71,25438,30588,31424,1,20,1,2685,-1,-1065,5088,-1,0,1,0,0
EUW1_6874743040',2,30,6,0,0,0,0,6,1,338,74,23209,27796,28507,7,30,14,2,1,0,0,2,356,96,27382,30436,32497,0,-18,-22,-4173,-8,-2640,-3990,-2,-1,0,0,4
EUW1_6874135599',6,33,4,1,0,1,0,7,1,412,100,25315,29662,21163,4,32,5,1,0,0,0,4,407,96,24485,30019,17389,0,5,4,830,-1,-357,3774,0,0,1,0,3
EUW1_6873935676',1,22,9,0,0,0,0,11,1,340,76,24827,26547,27860,2,46,14,2,0,2,0,0,365,100,30559,29923,33513,0,-25,-24,-5732,-5,-3376,-5653,-2,0,-2,0,11
EUW1_6873149150',3,20,16,0,0,0,0,9,1,361,82,28616,31012,37485,6,34,10,0,0,1,0,2,328,72,25919,26286,31488,1,33,10,2697,6,4726,5997,0,0,-1,0,7
EUW1_6872180835',4,31,10,1,0,0,0,7,0,394,78,25802,30011,26687,3,23,9,0,0,0,0,4,373,88,25500,30298,20771,1,21,-10,302,1,-287,5916,1,0,0,0,3
EUW1_6878417909',5,27,12,2,0,1,0,10,0,375,102,28148,31180,38673,2,25,9,0,0,1,0,2,376,112,26566,30974,30912,1,-1,-10,1582,3,206,7761,2,0,0,0,8
EUW1_6878361443',6,33,10,0,0,1,0,14,0,337,92,28042,27841,28248,5,27,16,1,0,4,0,5,384,83,32222,30112,34264,0,-47,9,-4180,-6,-2271,-6016,-1,0,-3,0,9
EUW1_6878186339',7,25,11,1,0,0,0,8,1,389,91,28775,32798,31908,3,27,7,1,0,3,0,5,390,99,25816,30177,31351,1,-1,-8,2959,4,2621,557,0,0,-3,0,3
EUW1_6878119229',5,23,17,0,0,1,0,16,0,324,83,29697,29652,34934,4,202,17,1,0,2,0,3,331,95,31061,31010,39789,0,-7,-12,-1364,0,-1358,-4855,-1,0,-1,0,13
EUW1_6877237934',4,31,12,1,1,0,0,2,0,352,96,28345,29885,33051,6,28,10,0,0,0,0,6,332,93,24896,28474,26718,1,20,3,3449,2,1411,6333,1,1,0,0,-4
EUW1_6877178763',3,25,16,0,1,1,0,6,1,364,88,29577,30721,34985,1,27,9,2,0,0,0,5,344,86,25434,27542,30760,1,20,2,4143,7,3179,4225,-2,1,1,0,1
EUW1_6877010660',1,40,9,0,0,0,0,11,0,321,87,25479,28889,30715,5,32,15,1,0,2,0,2,355,104,29904,30516,37014,0,-34,-17,-4425,-6,-1627,-6299,-1,0,-2,0,9
EUW1_6876956631',3,34,20,1,0,0,0,5,0,334,106,30859,30878,34386,3,27,20,0,0,0,0,3,374,74,31571,31734,40587,0,-40,32,-712,0,-856,-6201,1,0,0,0,2
EUW1_6876726818',4,23,18,2,0,3,0,10,1,317,84,32208,30718,41559,2,25,15,0,1,2,0,10,329,76,29452,28960,36701,1,-12,8,2756,3,1758,4858,2,-1,1,0,0
EUW1_6876689345',7,23,6,2,0,0,0,14,0,347,96,25145,27526,23581,4,61,16,0,1,1,0,3,357,91,28611,31707,28330,0,-10,5,-3466,-10,-4181,-4749,2,-1,-1,0,11
EUW1_6875298537',3,31,11,2,0,0,0,5,1,340,78,25616,29540,30428,3,22,10,0,0,0,0,3,365,86,26206,28585,37730,1,-25,-8,-590,1,955,-7302,2,0,0,0,2
EUW1_6875264501',5,28,13,1,0,0,0,6,1,345,90,26906,28730,39301,1,78,14,0,0,1,0,5,333,76,28681,28944,38882,1,12,14,-1775,-1,-214,419,1,0,-1,0,1
EUW1_6875210033',5,27,12,2,0,1,0,14,0,336,96,27044,29327,31344,3,44,7,0,0,0,0,1,343,70,24471,27370,34811,1,-7,26,2573,5,1957,-3467,2,0,1,0,13
EUW1_6874718999',6,33,18,0,1,1,0,9,0,390,106,30917,31944,30814,2,25,10,2,0,1,0,8,354,88,27482,28462,25257,0,36,18,3435,8,3482,5557,-2,1,0,0,1
EUW1_6874641243',2,37,9,0,0,1,0,4,0,344,88,27134,30577,29495,6,66,15,2,0,0,0,5,305,88,24728,27709,31887,1,39,0,2406,-6,2868,-2392,-2,0,1,0,-1
EUW1_6874571425',2,64,15,2,0,2,0,13,0,383,85,30555,31427,32623,3,62,15,0,0,3,0,6,316,93,29638,28715,27534,1,67,-8,917,0,2712,5089,2,0,-1,0,7
EUW1_6871722746',8,29,10,0,0,0,0,13,1,356,74,26558,28527,28395,1,95,11,2,1,1,0,4,347,106,28184,29847,31057,0,9,-32,-1626,-1,-1320,-2662,-2,-1,-1,0,9
EUW1_6871662508',5,24,11,1,0,1,0,9,1,329,108,27697,29210,28226,4,25,5,1,0,1,0,2,366,80,24297,28149,25408,1,-37,28,3400,6,1061,2818,0,0,0,0,7
EUW1_6870158840',3,27,11,1,0,0,0,12,0,357,93,26700,27730,33136,6,27,16,1,1,2,0,3,384,96,32188,32224,33977,0,-27,-3,-5488,-5,-4494,-841,0,-1,-2,0,9
EUW1_6882776043',2,26,5,1,0,1,0,9,1,330,90,24153,26448,26109,7,31,16,1,0,1,0,4,384,82,29224,31923,33348,0,-54,8,-5071,-11,-5475,-7239,0,0,0,0,5
EUW1_6882714371',4,34,16,1,0,2,0,8,0,406,82,31016,30787,29114,3,39,14,1,0,0,0,6,367,75,27739,30947,26273,0,39,7,3277,2,-160,2841,0,0,2,0,2
EUW1_6881323405',3,26,12,2,0,0,0,7,1,369,95,26988,30956,29948,5,27,8,0,0,1,0,3,353,96,25379,29182,25462,1,16,-1,1609,4,1774,4486,2,0,-1,0,4
EUW1_6881249531',6,25,7,1,0,1,0,8,0,384,76,24816,28216,25834,3,21,11,1,1,2,0,2,388,98,27562,31439,28843,0,-4,-22,-2746,-4,-3223,-3009,0,-1,-1,0,6
EUW1_6880995216',2,27,11,1,0,1,0,12,0,384,96,28212,29502,23421,3,91,10,1,0,1,0,5,304,74,26288,26082,25246,0,80,22,1924,1,3420,-1825,0,0,0,0,7
EUW1_6880960900',6,33,18,1,0,1,0,17,1,326,115,31177,30160,36527,8,38,19,1,1,2,0,4,398,71,31936,31127,34195,0,-72,44,-759,-1,-967,2332,0,-1,-1,0,13
EUW1_6880935700',5,27,23,1,1,3,0,8,1,385,89,34483,31512,40973,2,27,12,0,0,1,0,10,350,85,27074,28633,27659,1,35,4,7409,11,2879,13314,1,1,2,0,-2
EUW1_6878412775',3,41,22,0,0,0,0,5,1,354,67,32949,28257,43975,4,32,20,2,0,2,0,4,321,64,30479,27398,39164,0,33,3,2470,2,859,4811,-2,0,-2,0,1
EUW1_6878327575',1,25,20,1,1,0,0,10,1,353,76,30377,30681,38551,2,66,18,1,0,1,0,2,361,96,29411,30259,35522,1,-8,-20,966,2,422,3029,0,1,-1,0,8
EUW1_6876959687',6,34,13,0,0,1,0,9,1,355,93,27043,28251,27342,3,39,10,2,0,1,0,5,358,75,27500,28246,27343,0,-3,18,-457,3,5,-1,-2,0,0,0,4
EUW1_6876873299',5,27,12,1,0,0,0,10,1,349,70,26529,27256,33803,3,32,12,1,0,2,0,2,388,89,30337,31079,34069,0,-39,-19,-3808,0,-3823,-266,0,0,-2,0,8
EUW1_6875543558',3,36,7,2,0,0,0,7,0,402,104,26163,30922,24623,7,40,8,0,0,0,0,2,418,86,25942,29755,24064,1,-16,18,221,-1,1167,559,2,0,0,0,5
EUW1_6875470011',4,25,15,1,0,0,0,9,1,403,68,28112,31305,36503,3,25,12,1,0,1,0,1,361,96,27117,31833,29526,0,42,-28,995,3,-528,6977,0,0,-1,0,8
EUW1_6874393860',1,28,9,0,0,0,0,9,0,392,106,27049,30434,34773,7,30,10,1,0,0,0,5,395,93,26982,30246,41419,1,-3,13,67,-1,188,-6646,-1,0,0,0,4
EUW1_6874293874',4,25,8,0,0,0,0,6,0,382,112,26242,31870,25736,1,22,11,2,1,1,0,6,396,108,28908,30528,24587,1,-14,4,-2666,-3,1342,1149,-2,-1,-1,0,0
EUW1_6874205021',0,18,6,0,0,0,0,9,1,303,82,23577,26400,19652,5,28,22,2,1,2,0,1,414,106,33541,33315,36285,0,-111,-24,-9964,-16,-6915,-16633,-2,-1,-2,0,8
EUW1_6874150325',4,37,16,0,0,1,0,16,1,268,68,28726,27396,41764,1,23,29,2,0,2,0,2,341,115,35778,32890,49794,0,-73,-47,-7052,-13,-5494,-8030,-2,0,-1,0,14
EUW1_6872979355',4,153,13,1,0,0,0,5,1,358,102,27441,29801,32219,5,32,6,1,0,1,0,3,365,94,25095,29037,25281,0,-7,8,2346,7,764,6938,0,0,-1,0,2
EUW1_6872837476',5,38,11,2,1,1,0,5,1,420,108,29176,33483,20862,6,36,7,0,0,0,0,6,416,100,26741,30830,22001,1,4,8,2435,4,2653,-1139,2,1,1,0,-1
EUW1_6872774568',5,32,13,0,0,0,0,9,0,341,80,28325,28581,32591,7,29,16,1,0,1,0,6,377,114,29951,32322,42349,1,-36,-34,-1626,-3,-3741,-9758,-1,0,-1,0,3
EUW1_6881669244',2,23,8,1,0,0,0,13,1,364,77,25752,26713,31947,6,36,18,0,1,2,0,0,333,118,30695,29407,29962,0,31,-41,-4943,-10,-2694,1985,1,-1,-2,0,13
EUW1_6871683846',2,28,16,0,0,0,0,15,0,322,118,29535,31932,34123,1,29,22,1,0,1,0,3,360,90,32550,30986,40221,0,-38,28,-3015,-6,946,-6098,-1,0,-1,0,12
EUW1_6871573541',0,31,16,0,1,1,0,3,1,375,76,28994,29696,42639,5,140,13,2,0,0,0,7,318,87,26945,28040,24964,0,57,-11,2049,3,1656,17675,-2,1,1,0,-4
EUW1_6871510997',2,22,14,1,0,0,0,7,1,341,72,27779,28724,33100,5,28,14,1,0,2,0,4,339,96,28825,30159,33376,1,2,-24,-1046,0,-1435,-276,0,0,-2,0,3
EUW1_6882001627',4,26,7,0,0,0,0,14,0,308,65,22723,27289,24522,7,26,8,2,0,2,0,1,386,121,28561,29771,28739,0,-78,-56,-5838,-1,-2482,-4217,-2,0,-2,0,13
EUW1_6881273335',1,36,17,1,0,0,0,8,0,355,96,29076,31080,42925,4,344,13,1,0,0,0,4,361,72,26129,30112,30253,1,-6,24,2947,4,968,12672,0,0,0,0,4
EUW1_6881224768',3,27,12,1,0,0,0,12,1,336,82,27464,29720,36237,2,425,7,0,0,2,0,5,392,78,26660,29239,39848,1,-56,4,804,5,481,-3611,1,0,-2,0,7
EUW1_6881171165',4,32,15,1,0,1,0,7,0,373,96,29771,31563,40481,5,230,9,1,0,0,0,5,366,95,26008,29097,25952,1,7,1,3763,6,2466,14529,0,0,1,0,2
EUW1_6881134124',3,223,18,0,0,2,0,8,1,356,88,30551,31484,35173,4,22,12,2,0,0,0,4,338,64,26154,26637,33263,1,18,24,4397,6,4847,1910,-2,0,2,0,4
EUW1_6880762373',3,278,6,0,0,1,0,5,1,367,78,27491,27014,30173,4,68,16,1,0,0,0,8,342,86,26707,30304,31840,1,25,-8,784,-10,-3290,-1667,-1,0,1,0,-3
EUW1_6880727250',3,192,28,1,0,3,0,4,1,382,69,37243,31984,51708,3,30,8,0,0,0,0,10,267,83,24272,25301,29059,1,115,-14,12971,20,6683,22649,1,0,3,0,-6
EUW1_6880688802',5,248,11,1,1,2,0,10,0,367,92,28694,30068,34686,3,24,10,1,0,1,0,6,357,72,25417,29282,30616,1,10,20,3277,1,786,4070,0,1,1,0,4
EUW1_6880658101',1,215,21,1,1,2,0,14,1,323,66,33519,27131,40618,1,25,20,1,0,1,0,2,325,79,29324,28644,30466,1,-2,-13,4195,1,-1513,10152,0,1,1,0,12
EUW1_6880606067',5,37,27,1,1,2,0,9,1,370,96,34250,31683,44817,3,191,12,0,0,1,0,5,329,76,27764,26682,32216,1,41,20,6486,15,5001,12601,1,1,1,0,4
EUW1_6874572922',3,313,10,0,0,0,0,16,0,296,82,24470,25329,34696,0,21,18,2,0,3,0,1,349,105,31207,31468,40549,0,-53,-23,-6737,-8,-6139,-5853,-2,0,-3,0,15
EUW1_6874507540',4,25,18,2,1,2,0,8,0,373,87,32344,31520,42314,7,222,14,0,0,1,0,8,388,109,30467,31682,33273,0,-15,-22,1877,4,-162,9041,2,1,1,0,0
EUW1_6874449089',4,161,3,0,0,0,0,14,1,302,71,21291,24301,19088,3,40,16,2,0,1,0,2,375,117,30394,33689,35256,0,-73,-46,-9103,-13,-9388,-16168,-2,0,-1,0,12
EUW1_6874318574',5,25,6,0,0,0,0,16,0,321,84,22744,25789,27051,3,304,20,1,1,3,0,0,387,104,33085,32046,34265,0,-66,-20,-10341,-14,-6257,-7214,-1,-1,-3,0,16
EUW1_6874219989',8,275,21,0,0,0,0,6,1,333,70,30305,29115,46092,6,30,11,1,1,1,0,7,322,70,25627,29010,34523,0,11,0,4678,10,105,11569,-1,-1,-1,0,-1
EUW1_6871423708',5,30,10,2,0,0,0,10,0,381,90,26068,28582,30336,1,26,15,0,0,0,0,2,346,98,28697,31658,28782,0,35,-8,-2629,-5,-3076,1554,2,0,0,0,8
EUW1_6871377019',4,30,15,2,1,1,0,11,1,385,104,31051,31962,36391,2,295,12,0,0,2,0,3,350,104,27550,29338,27012,0,35,0,3501,3,2624,9379,2,1,-1,0,8
EUW1_6871356480',5,25,18,1,0,2,0,10,1,373,90,31351,31040,35802,4,321,8,1,0,2,0,7,314,89,26328,27642,30990,1,59,1,5023,10,3398,4812,0,0,0,0,3
EUW1_6869550715',6,31,16,0,0,0,0,6,1,385,90,30756,31521,39718,7,33,10,1,0,1,0,8,360,85,25838,28794,29227,1,25,5,4918,6,2727,10491,-1,0,-1,0,-2
EUW1_6867870359',9,20,8,0,0,0,0,13,0,353,90,24065,28390,30438,4,45,19,2,0,1,0,0,351,100,30705,31714,41433,0,2,-10,-6640,-11,-3324,-10995,-2,0,-1,0,13
EUW1_6881549813',2,46,14,1,0,0,0,5,0,330,65,27236,27634,34053,3,32,21,0,0,0,0,5,293,95,30436,28814,38618,1,37,-30,-3200,-7,-1180,-4565,1,0,0,0,0
EUW1_6881500040',6,44,10,0,0,0,0,13,1,284,80,24545,26955,36853,4,38,16,1,0,2,0,1,367,96,30531,29528,40450,0,-83,-16,-5986,-6,-2573,-3597,-1,0,-2,0,12
EUW1_6881431442',7,32,22,2,0,1,0,9,0,355,74,31412,30318,45310,1,29,9,0,0,0,0,4,329,101,25814,26363,36907,1,26,-27,5598,13,3955,8403,2,0,1,0,5
EUW1_6881383637',8,32,12,0,0,1,0,11,1,345,84,26587,27850,32788,7,36,12,1,0,1,0,2,384,73,27964,29353,33355,0,-39,11,-1377,0,-1503,-567,-1,0,0,0,9
EUW1_6881324108',3,33,11,1,0,1,0,11,0,341,90,27127,29017,27922,3,26,16,0,0,2,0,5,367,86,31128,29155,33186,0,-26,4,-4001,-5,-138,-5264,1,0,-1,0,6
EUW1_6881251602',4,43,7,0,0,0,0,8,0,364,116,27366,29889,26431,4,114,9,2,0,2,0,7,356,86,25689,29655,27260,1,8,30,1677,-2,234,-829,-2,0,-2,0,1
EUW1_6878281689',4,26,12,0,0,1,0,5,1,328,104,28454,28392,34318,1,27,7,1,0,0,0,6,312,64,23256,26777,27411,1,16,40,5198,5,1615,6907,-1,0,1,0,-1
EUW1_6878217448',4,25,9,1,1,0,0,8,1,334,79,27036,29415,22219,4,27,12,0,0,2,0,6,333,100,26465,28069,29432,1,1,-21,571,-3,1346,-7213,1,1,-2,0,2
EUW1_6878189422',2,28,14,0,0,0,0,14,0,348,77,27209,29828,33841,7,29,20,1,0,2,0,2,365,109,32956,32561,41428,0,-17,-32,-5747,-6,-2733,-7587,-1,0,-2,0,12
EUW1_6881532948',0,28,4,0,0,0,0,8,0,388,91,23140,28827,21526,7,31,11,2,0,1,0,3,367,112,27121,30816,33722,0,21,-21,-3981,-7,-1989,-12196,-2,0,-1,0,5
EUW1_6871087228',3,66,16,2,0,1,0,8,1,366,55,29918,28079,36009,1,35,15,0,1,0,0,5,378,105,29419,30736,30374,1,-12,-50,499,1,-2657,5635,2,-1,1,0,3
EUW1_6871064242',6,30,10,0,0,1,0,9,1,369,100,27294,29194,27208,3,28,9,1,0,0,0,2,409,80,26394,30431,26423,1,-40,20,900,1,-1237,785,-1,0,1,0,7
EUW1_6866455066',4,30,10,0,0,0,0,8,1,375,108,27370,32022,25853,4,32,6,2,0,1,0,4,392,91,24992,29339,27625,0,-17,17,2378,4,2683,-1772,-2,0,-1,0,4
EUW1_6866414865',4,31,8,0,0,1,0,10,1,399,100,28664,30284,33583,3,29,8,1,1,1,0,5,339,119,26283,31081,26779,1,60,-19,2381,0,-797,6804,-1,-1,0,0,5
EUW1_6866363030',2,28,7,1,0,1,0,6,1,426,81,26234,30289,23483,3,34,5,0,1,0,0,3,364,84,23940,29830,27060,1,62,-3,2294,2,459,-3577,1,-1,1,0,3
EUW1_6865015949',4,34,18,1,0,1,0,6,0,375,86,30160,32173,31934,5,52,8,0,0,2,0,4,386,110,26172,29855,29160,1,-11,-24,3988,10,2318,2774,1,0,-1,0,2
EUW1_6864973639',2,25,7,0,0,0,0,12,0,373,96,25915,30678,18985,3,23,11,2,1,2,0,2,413,120,30167,31517,28416,0,-40,-24,-4252,-4,-839,-9431,-2,-1,-2,0,10
EUW1_6864932265',5,25,4,0,0,0,0,7,0,389,87,23356,29677,20795,2,34,16,1,0,1,0,0,421,116,30177,35431,35862,0,-32,-29,-6821,-12,-5754,-15067,-1,0,-1,0,7
EUW1_6864883753',4,30,7,0,0,0,0,11,1,342,104,24592,29053,22744,5,28,12,1,0,2,0,2,395,84,30100,29577,31535,0,-53,20,-5508,-5,-524,-8791,-1,0,-2,0,9
EUW1_6864825342',3,24,9,2,1,0,0,15,0,355,68,25428,27579,23146,3,27,14,0,0,1,0,1,366,127,29602,31734,28956,0,-11,-59,-4174,-5,-4155,-5810,2,1,-1,0,14
EUW1_6864790187',3,24,15,1,1,0,0,12,0,323,106,28678,30052,34475,7,29,21,1,0,1,0,1,348,106,31787,32334,38033,0,-25,0,-3109,-6,-2282,-3558,0,1,-1,0,11
EUW1_6864758678',6,28,13,1,0,1,0,9,0,321,153,29367,30002,37047,8,28,14,1,1,1,0,4,305,70,26560,27721,26284,1,16,83,2807,-1,2281,10763,0,-1,0,0,5
EUW1_6864718792',4,30,15,2,0,2,0,6,1,378,96,30959,31528,32520,2,26,15,0,0,1,0,6,315,100,27912,28866,28151,1,63,-4,3047,0,2662,4369,2,0,1,0,0
EUW1_6863746985',7,65,5,0,0,0,0,8,1,388,80,24707,29302,21378,4,64,9,1,0,0,0,1,375,102,25709,30187,27792,0,13,-22,-1002,-4,-885,-6414,-1,0,0,0,7
EUW1_6863685375',3,31,12,0,0,1,0,10,0,319,77,26041,27677,35677,2,35,24,1,0,1,0,2,364,86,31504,31191,46920,0,-45,-9,-5463,-12,-3514,-11243,-1,0,0,0,8
EUW1_6863590120',5,46,7,1,0,1,0,7,0,347,102,25230,30198,30458,4,25,8,0,0,0,0,2,337,90,23925,29197,24581,1,10,12,1305,-1,1001,5877,1,0,1,0,5
EUW1_6863548556',2,27,15,0,0,1,0,7,1,377,100,28731,30691,35896,2,24,22,1,0,1,0,3,355,96,29736,30082,43029,0,22,4,-1005,-7,609,-7133,-1,0,0,0,4
EUW1_6863517016',2,24,20,0,0,2,0,7,1,356,92,30234,29711,38370,7,28,6,0,0,0,0,8,321,84,23930,25144,25754,1,35,8,6304,14,4567,12616,0,0,2,0,-1
EUW1_6863479566',5,27,17,0,0,2,0,6,1,361,114,31180,32570,34978,5,30,5,1,0,0,0,10,328,76,23095,27077,19128,1,33,38,8085,12,5493,15850,-1,0,2,0,-4
EUW1_6863454566',2,25,15,1,0,0,0,9,1,352,134,28751,30799,35250,8,80,14,1,0,1,0,4,333,73,27845,29956,33029,1,19,61,906,1,843,2221,0,0,-1,0,5
EUW1_6863386438',5,304,12,1,0,1,0,8,1,337,86,27754,28159,30473,5,29,15,0,0,0,0,2,322,110,26798,30995,32484,0,15,-24,956,-3,-2836,-2011,1,0,1,0,6
EUW1_6863371959',3,28,18,0,0,1,0,11,0,369,123,31274,33141,39716,5,32,5,1,0,1,0,8,307,78,23149,25033,28243,1,62,45,8125,13,8108,11473,-1,0,0,0,3
EUW1_6880944013',7,32,8,0,0,0,0,9,0,330,104,24192,27160,21286,1,27,10,1,0,1,0,1,358,96,26186,28917,24071,0,-28,8,-1994,-2,-1757,-2785,-1,0,-1,0,8
EUW1_6880918778',1,32,15,0,0,0,0,8,0,365,88,29462,30416,35774,6,101,19,2,0,2,0,5,333,80,30010,30941,42471,0,32,8,-548,-4,-525,-6697,-2,0,-2,0,3
EUW1_6875149879',2,30,13,2,0,0,0,10,0,367,113,27981,30397,35191,1,25,17,0,0,0,0,2,338,81,28881,29902,33790,1,29,32,-900,-4,495,1401,2,0,0,0,8
EUW1_6875115407',3,30,13,0,0,0,0,7,0,325,97,27023,28485,28186,3,53,17,1,0,0,0,3,384,81,29473,29647,35057,0,-59,16,-2450,-4,-1162,-6871,-1,0,0,0,4
EUW1_6857753667',4,35,12,1,0,0,0,11,1,312,106,27022,28236,29863,2,29,17,1,0,1,0,1,376,90,31302,30975,37151,0,-64,16,-4280,-5,-2739,-7288,0,0,-1,0,10
EUW1_6857697245',2,70,10,0,0,0,0,7,0,370,92,26127,29274,31117,5,28,14,1,0,1,0,3,351,88,29674,29712,34498,0,19,4,-3547,-4,-438,-3381,-1,0,-1,0,4
EUW1_6854722214',3,24,19,1,0,2,0,7,1,414,97,34522,33192,39742,4,19,5,1,0,1,0,10,324,74,22418,25935,29220,1,90,23,12104,14,7257,10522,0,0,1,0,-3
EUW1_6841102023',4,145,11,1,0,0,0,10,0,373,92,27768,30343,30718,5,25,17,1,0,0,0,3,339,74,28785,29065,32165,0,34,18,-1017,-6,1278,-1447,0,0,0,0,7
EUW1_6837071328',3,97,13,1,0,1,0,8,1,341,106,28636,29130,34705,4,202,8,1,0,1,0,6,313,74,25192,26348,26691,1,28,32,3444,5,2782,8014,0,0,0,0,2
EUW1_6836627434',4,27,15,0,0,0,0,7,0,354,94,29281,30313,33381,6,30,15,1,0,0,0,3,325,78,27913,30003,32601,1,29,16,1368,0,310,780,-1,0,0,0,4
EUW1_6798312961',7,27,13,0,0,0,0,11,0,348,83,27194,28616,31093,4,41,18,2,0,1,0,3,360,91,30951,29206,36390,0,-12,-8,-3757,-5,-590,-5297,-2,0,-1,0,8
EUW1_6796573642',9,40,22,2,0,2,0,7,1,351,97,33121,30876,43490,2,24,7,0,0,0,0,7,313,64,23905,26562,21660,1,38,33,9216,15,4314,21830,2,0,2,0,0
EUW1_6883197758',5,24,6,0,0,1,0,9,0,357,93,25118,28294,22404,3,30,16,2,0,2,0,5,372,105,30075,31203,35441,1,-15,-12,-4957,-10,-2909,-13037,-2,0,-1,0,4
EUW1_6883128894',3,23,8,2,0,0,0,12,1,390,100,27483,30572,29448,2,29,7,0,1,1,0,3,331,96,24659,29247,24886,1,59,4,2824,1,1325,4562,2,-1,-1,0,9
EUW1_6883084570',5,148,9,1,0,1,0,15,1,360,110,28570,29407,29755,4,24,20,1,1,2,0,4,391,113,33314,33683,38478,0,-31,-3,-4744,-11,-4276,-8723,0,-1,-1,0,11
EUW1_6882999017',3,26,18,1,0,0,0,7,1,402,92,31198,32673,40952,3,29,13,1,0,2,0,6,322,84,27357,29817,32972,1,80,8,3841,5,2856,7980,0,0,-2,0,1
EUW1_6882938361',5,27,11,1,0,1,0,11,0,394,96,27074,30710,28444,3,28,11,0,0,1,0,4,383,96,26820,30720,23693,1,11,0,254,0,-10,4751,1,0,0,0,7
EUW1_6882801964',4,32,13,0,1,1,0,4,1,382,88,28607,31458,29895,4,32,6,1,0,0,0,6,362,100,24666,29891,25663,1,20,-12,3941,7,1567,4232,-1,1,1,0,-2
EUW1_6881109742',2,29,19,1,0,2,0,14,1,399,119,34746,34475,33421,3,135,6,0,0,2,0,4,356,60,23943,26843,19323,1,43,59,10803,13,7632,14098,1,0,0,0,10
EUW1_6881062249',4,39,18,1,0,2,0,8,1,372,94,30569,32111,39132,3,31,18,0,0,0,0,8,313,70,28578,29957,38568,1,59,24,1991,0,2154,564,1,0,2,0,0
EUW1_6881041559',4,29,7,0,0,1,0,10,1,411,89,26084,30629,28742,5,24,18,2,0,1,0,3,356,90,28798,31171,32839,0,55,-1,-2714,-11,-542,-4097,-2,0,0,0,7
EUW1_6880995723',1,61,10,1,0,1,0,15,1,340,89,26273,29214,25524,7,180,10,1,1,2,0,5,351,85,27982,29503,30569,1,-11,4,-1709,0,-289,-5045,0,-1,-1,0,10
EUW1_6880963785',2,25,12,2,0,0,0,10,0,339,64,26547,29739,26388,3,32,13,0,0,2,0,2,380,108,29619,30525,28789,0,-41,-44,-3072,-1,-786,-2401,2,0,-2,0,8
EUW1_6880901834',3,25,11,1,0,0,0,17,0,328,87,26436,27920,32075,2,23,27,1,1,2,0,0,372,97,36924,33977,44752,0,-44,-10,-10488,-16,-6057,-12677,0,-1,-2,0,17
EUW1_6880888460',4,27,9,2,0,1,0,12,0,385,92,27158,29756,32802,3,31,19,0,1,2,0,2,367,88,31386,32129,37345,0,18,4,-4228,-10,-2373,-4543,2,-1,-1,0,10
EUW1_6880860337',6,29,10,0,0,0,0,11,1,322,107,26435,28717,27963,6,25,15,2,0,1,0,2,384,104,29887,30742,28732,0,-62,3,-3452,-5,-2025,-769,-2,0,-1,0,9
EUW1_6880845305',5,26,15,0,0,1,0,10,1,293,98,28838,29721,33400,3,39,19,2,0,1,0,0,385,66,29863,31124,39671,1,-92,32,-1025,-4,-1403,-6271,-2,0,0,0,10
EUW1_6880845488',2,39,15,1,0,3,0,6,1,350,117,30864,33044,35100,5,90,13,0,0,1,0,7,331,48,25626,27777,27157,1,19,69,5238,2,5267,7943,1,0,2,0,-1
EUW1_6880816938',3,30,17,1,0,0,0,11,1,348,92,29105,31185,37292,1,22,12,1,0,2,0,4,331,100,28502,30177,31569,1,17,-8,603,5,1008,5723,0,0,-2,0,7
EUW1_6880802987',1,26,7,0,0,0,0,6,0,371,81,24652,29958,24941,5,24,12,2,0,0,0,2,400,104,28875,31778,27375,0,-29,-23,-4223,-5,-1820,-2434,-2,0,0,0,4
EUW1_6880791949',3,23,18,1,0,1,0,5,1,395,93,30772,32797,40204,3,29,6,0,0,1,0,10,337,62,23118,25330,25093,1,58,31,7654,12,7467,15111,1,0,0,0,-5
EUW1_6883515318',5,32,9,1,0,1,0,8,1,419,90,28078,30976,30682,4,31,9,1,0,0,0,9,386,84,25999,29674,28818,1,33,6,2079,0,1302,1864,0,0,1,0,-1
EUW1_6883487458',2,22,13,0,0,0,0,10,1,371,76,27580,29275,31097,3,30,8,2,0,1,0,2,373,91,26410,29445,29921,1,-2,-15,1170,5,-170,1176,-2,0,-1,0,8
EUW1_6883453527',2,24,5,0,0,0,0,6,0,399,92,24203,30540,21979,1,52,2,2,0,0,0,0,398,136,23490,31954,27233,0,1,-44,713,3,-1414,-5254,-2,0,0,0,6
EUW1_6883400793',7,44,18,1,0,1,0,6,1,377,78,31045,31488,41276,3,92,16,0,0,1,0,8,370,92,29048,31772,34692,0,7,-14,1997,2,-284,6584,1,0,0,0,-2
EUW1_6883339932',1,41,17,0,1,0,0,9,0,342,90,28895,31042,42180,3,28,17,1,0,1,0,2,378,86,30336,31233,38188,0,-36,4,-1441,0,-191,3992,-1,1,-1,0,7
EUW1_6883281750',3,28,11,1,0,0,0,6,0,389,84,27589,30552,27910,5,28,15,1,1,0,0,5,353,104,28227,31268,32801,0,36,-20,-638,-4,-716,-4891,0,-1,0,0,1
EUW1_6882177459',4,27,5,0,0,0,0,8,0,399,102,25218,29616,24694,4,32,7,2,0,0,0,2,411,74,24914,29384,22520,1,-12,28,304,-2,232,2174,-2,0,0,0,6
EUW1_6882136730',5,28,13,1,0,2,0,8,0,369,88,29741,29640,31947,4,49,11,1,0,0,0,10,336,108,27076,28878,27875,1,33,-20,2665,2,762,4072,0,0,2,0,-2
EUW1_6882091895',3,25,20,0,0,1,0,6,0,390,80,32440,31649,43595,2,27,19,2,0,0,0,4,313,86,29568,30339,29708,1,77,-6,2872,1,1310,13887,-2,0,1,0,2
EUW1_6882044918',5,69,6,0,0,0,0,12,0,341,89,24978,27839,26293,1,66,15,2,1,2,0,7,387,93,29809,31492,34177,0,-46,-4,-4831,-9,-3653,-7884,-2,-1,-2,0,5
EUW1_6876890155',2,27,20,2,0,1,0,6,1,366,89,30673,31404,39297,6,34,9,0,0,0,0,5,345,97,25149,29788,32915,1,21,-8,5524,11,1616,6382,2,0,1,0,1
EUW1_6876848096',4,50,8,0,0,0,0,11,1,382,80,26483,28846,28305,4,57,15,2,1,1,0,3,362,138,29758,31585,35031,1,20,-58,-3275,-7,-2739,-6726,-2,-1,-1,0,8
EUW1_6876799614',5,25,11,2,0,0,0,4,0,391,96,26747,29612,28779,3,34,6,0,0,0,0,0,367,84,25352,27196,28002,0,24,12,1395,5,2416,777,2,0,0,0,4
EUW1_6876756995',5,23,8,2,1,0,0,7,1,381,122,27057,30402,25262,3,32,8,0,0,0,0,4,377,88,25856,29225,21721,0,4,34,1201,0,1177,3541,2,1,0,0,3
EUW1_6876723283',2,19,5,0,0,0,0,6,0,353,95,24139,26805,29992,3,29,15,2,0,0,0,3,354,88,28293,30290,39561,0,-1,7,-4154,-10,-3485,-9569,-2,0,0,0,3
EUW1_6876704577',1,29,3,0,0,0,0,5,0,364,104,23343,28965,19062,6,125,11,1,1,0,0,1,402,73,26948,31702,31466,0,-38,31,-3605,-8,-2737,-12404,-1,-1,0,0,4
EUW1_6876243375',4,32,11,1,0,1,0,4,1,413,90,28805,30780,32351,4,42,10,0,0,1,0,4,363,72,25721,28561,28570,0,50,18,3084,1,2219,3781,1,0,0,0,0
EUW1_6876195409',3,29,16,1,1,2,0,7,1,407,115,32122,32553,33950,0,21,8,1,0,1,0,6,350,79,25562,29594,21795,1,57,36,6560,8,2959,12155,0,1,1,0,1
EUW1_6875688093',4,26,12,1,0,1,0,8,0,393,65,27918,29287,32564,3,34,10,0,0,1,0,2,346,106,27697,29606,24797,0,47,-41,221,2,-319,7767,1,0,0,0,6
EUW1_6875650322',4,50,8,0,0,0,0,6,0,356,82,24569,28168,27165,3,22,12,1,0,1,0,3,393,90,28022,30531,30343,0,-37,-8,-3453,-4,-2363,-3178,-1,0,-1,0,3
EUW1_6881584284',1,28,16,0,0,1,0,13,0,353,84,29297,30649,43219,3,27,18,1,1,1,0,2,356,100,31239,30469,40723,0,-3,-16,-1942,-2,180,2496,-1,-1,0,0,11
EUW1_6881541905',1,38,10,0,0,0,0,9,0,366,76,26128,30425,29424,6,148,14,2,0,2,0,0,371,94,28159,29659,35493,0,-5,-18,-2031,-4,766,-6069,-2,0,-2,0,9
EUW1_6881506560',4,25,1,0,0,0,0,17,0,381,60,21799,25978,16079,7,36,23,1,0,3,0,1,387,106,33672,34005,38227,0,-6,-46,-11873,-22,-8027,-22148,-1,0,-3,0,16
EUW1_6881456533',3,71,15,2,0,0,0,8,0,394,76,29194,31922,35323,6,200,10,0,0,0,0,4,384,72,25534,29027,34538,1,10,4,3660,5,2895,785,2,0,0,0,4
EUW1_6881393197',0,49,9,0,0,0,0,11,0,326,76,25181,26489,29204,2,25,20,1,0,2,0,2,375,74,31834,30963,40514,0,-49,2,-6653,-11,-4474,-11310,-1,0,-2,0,9
EUW1_6881353487',3,25,21,1,0,0,0,8,1,340,64,31840,29575,36028,1,56,6,1,0,2,0,6,285,85,22876,24896,26211,1,55,-21,8964,15,4679,9817,0,0,-2,0,2
EUW1_6881164194',2,27,16,2,0,1,0,7,1,357,98,28452,32371,28496,2,26,2,0,0,0,0,2,373,78,21963,27031,22182,1,-16,20,6489,14,5340,6314,2,0,1,0,5
EUW1_6880926351',5,130,7,1,0,1,0,6,0,360,99,26583,30663,34215,3,98,10,1,0,0,0,5,370,104,26608,32666,28523,1,-10,-5,-25,-3,-2003,5692,0,0,1,0,1
EUW1_6880912691',3,21,23,2,0,3,0,3,1,435,114,35625,34814,48426,2,28,9,0,0,0,0,13,264,72,23709,26589,28065,1,171,42,11916,14,8225,20361,2,0,3,0,-10
EUW1_6880886059',3,79,12,0,0,0,0,16,0,288,58,25251,25254,25077,5,25,17,2,0,3,0,1,356,112,31538,29219,39937,0,-68,-54,-6287,-5,-3965,-14860,-2,0,-3,0,15
EUW1_6880341637',4,37,17,0,0,1,0,15,1,369,82,29156,29395,31709,5,25,17,1,1,2,0,5,348,88,30974,30872,30695,0,21,-6,-1818,0,-1477,1014,-1,-1,-1,0,10
EUW1_6880267913',1,33,15,1,0,1,0,11,0,367,90,29238,31580,34162,2,28,8,1,0,1,0,1,359,75,25657,27003,31769,1,8,15,3581,7,4577,2393,0,0,0,0,10
EUW1_6880212535',5,33,13,1,0,0,0,4,1,353,101,27470,30547,31849,1,27,12,1,0,0,0,2,376,65,27108,30822,32622,0,-23,36,362,1,-275,-773,0,0,0,0,2
EUW1_6880146627',2,28,9,2,0,0,0,8,0,341,92,25717,29134,26611,6,32,9,0,0,0,0,3,371,84,26886,29551,32442,1,-30,8,-1169,0,-417,-5831,2,0,0,0,5
EUW1_6882906834',5,144,17,1,0,0,0,3,1,358,88,29108,31420,33469,4,28,9,1,1,0,0,5,330,90,25440,28976,37411,0,28,-2,3668,8,2444,-3942,0,-1,0,0,-2
EUW1_6882841647',5,29,12,1,0,0,0,9,1,400,70,27812,30210,31729,2,34,14,0,1,0,0,4,405,89,29545,33242,32097,0,-5,-19,-1733,-2,-3032,-368,1,-1,0,0,5
EUW1_6882707417',5,93,15,1,0,0,0,9,0,344,83,28677,28371,30988,4,69,10,1,0,1,0,3,381,104,28998,29731,36115,1,-37,-21,-321,5,-1360,-5127,0,0,-1,0,6
EUW1_6882654440',6,29,16,1,0,0,0,8,1,377,80,28065,31130,40772,3,30,8,1,0,1,0,4,346,100,26612,26332,28845,0,31,-20,1453,8,4798,11927,0,0,-1,0,4
EUW1_6882632671',1,27,8,1,0,0,0,16,0,298,94,24992,25147,24101,6,36,11,1,1,2,0,2,377,101,28338,28784,23682,0,-79,-7,-3346,-3,-3637,419,0,-1,-2,0,14
EUW1_6880948684',4,130,16,1,0,2,0,6,1,438,90,32461,32009,39939,1,22,10,1,0,1,0,7,328,98,25188,27957,25738,1,110,-8,7273,6,4052,14201,0,0,1,0,-1
EUW1_6879691493',4,24,9,0,0,0,0,11,0,368,116,26560,31496,23733,7,34,9,2,0,2,0,2,404,96,28149,30070,24961,0,-36,20,-1589,0,1426,-1228,-2,0,-2,0,9
EUW1_6877261914',2,24,26,2,0,0,0,13,0,324,82,33242,31954,46232,3,33,22,0,0,1,0,2,357,106,32986,29561,47413,1,-33,-24,256,4,2393,-1181,2,0,-1,0,11
EUW1_6877189026',4,57,11,0,0,0,0,9,0,299,76,25913,25470,31584,3,30,10,1,0,0,0,2,376,79,25992,28513,34812,0,-77,-3,-79,1,-3043,-3228,-1,0,0,0,7
EUW1_6877089078',3,48,11,0,0,1,0,12,0,329,88,26662,28413,33585,2,27,12,1,0,1,0,5,358,96,28306,29103,32177,0,-29,-8,-1644,-1,-690,1408,-1,0,0,0,7
EUW1_6877026685',5,29,10,0,0,1,0,7,0,343,92,26339,27177,30792,2,38,11,1,0,0,0,1,376,76,26557,29053,32016,0,-33,16,-218,-1,-1876,-1224,-1,0,1,0,6
EUW1_6876856686',3,36,7,0,0,1,0,10,0,384,84,25581,28835,23992,4,30,13,1,1,1,0,6,339,100,28154,29203,26607,1,45,-16,-2573,-6,-368,-2615,-1,-1,0,0,4
EUW1_6883622942',1,28,17,1,0,1,0,8,1,343,73,29038,27978,34652,6,30,18,1,0,2,0,9,303,91,30970,29309,35500,1,40,-18,-1932,-1,-1331,-848,0,0,-1,0,-1
EUW1_6883599703',2,27,16,1,0,1,0,6,1,385,94,29335,30123,26968,2,36,12,1,0,0,0,7,350,88,26429,28685,29041,1,35,6,2906,4,1438,-2073,0,0,1,0,-1
EUW1_6883567276',5,32,10,0,0,1,0,7,0,369,72,28503,30219,30843,1,45,11,1,0,0,0,6,350,86,26019,28846,35104,1,19,-14,2484,-1,1373,-4261,-1,0,1,0,1
EUW1_6883534911',5,29,17,1,0,1,0,9,1,327,84,29026,27504,32990,4,31,5,1,0,2,0,6,350,78,25380,26468,29334,0,-23,6,3646,12,1036,3656,0,0,-1,0,3
EUW1_6883451365',7,27,9,0,0,0,0,7,0,339,85,24530,28818,27812,4,32,13,2,0,2,0,1,377,108,29674,31307,29508,0,-38,-23,-5144,-4,-2489,-1696,-2,0,-2,0,6
EUW1_6883412757',6,29,14,1,0,0,0,7,0,376,84,28607,30229,37646,4,24,17,1,0,0,0,2,358,92,29569,30816,42369,0,18,-8,-962,-3,-587,-4723,0,0,0,0,5
EUW1_6883354912',4,21,13,1,0,1,0,9,1,401,120,30046,32037,30492,1,19,11,1,0,3,0,5,362,103,27760,30502,25044,1,39,17,2286,2,1535,5448,0,0,-2,0,4
EUW1_6883142049',4,28,11,2,0,2,0,12,1,342,84,27581,27925,28060,3,25,17,0,0,0,0,4,321,84,28435,30293,29739,0,21,0,-854,-6,-2368,-1679,2,0,2,0,8
EUW1_6883073921',2,29,9,0,0,0,0,7,0,407,76,25508,30290,27864,5,23,13,2,0,1,0,3,384,108,29041,32680,32330,0,23,-32,-3533,-4,-2390,-4466,-2,0,-1,0,4
EUW1_6882889004',4,52,19,1,0,3,0,10,1,393,71,32321,32087,44318,5,27,9,0,0,1,0,11,327,86,24719,27540,31533,1,66,-15,7602,10,4547,12785,1,0,2,0,-1
EUW1_6882826346',5,31,9,0,0,1,0,10,0,363,93,26823,30442,33788,5,33,9,2,0,0,0,6,336,86,25074,29878,28865,1,27,7,1749,0,564,4923,-2,0,1,0,4
EUW1_6882714299',4,36,5,1,0,0,0,7,1,395,74,24508,28080,24457,3,52,8,0,0,0,0,4,395,127,26739,31507,28181,0,0,-53,-2231,-3,-3427,-3724,1,0,0,0,3
EUW1_6882291315',0,33,9,0,1,1,0,12,0,383,89,27496,28714,25324,2,31,16,1,0,0,0,4,284,78,26455,25142,31952,1,99,11,1041,-7,3572,-6628,-1,1,1,0,8
EUW1_6882239530',3,31,10,0,0,1,0,13,1,328,70,27163,25273,28808,1,55,14,1,0,2,0,5,364,112,29687,30434,28536,0,-36,-42,-2524,-4,-5161,272,-1,0,-1,0,8
EUW1_6882208821',6,33,23,0,0,0,0,10,0,391,74,32244,30985,43306,4,32,9,1,0,0,0,5,384,82,26499,28966,30364,1,7,-8,5745,14,2019,12942,-1,0,0,0,5
EUW1_6882179444',2,33,11,0,0,1,0,11,0,344,70,27941,27869,24433,4,26,21,0,1,1,0,2,383,96,32085,32538,38910,0,-39,-26,-4144,-10,-4669,-14477,0,-1,0,0,9
EUW1_6882843333',6,71,11,0,0,0,0,7,0,301,83,25598,27876,24795,4,64,19,2,0,0,0,2,344,84,27036,30340,38934,0,-43,-1,-1438,-8,-2464,-14139,-2,0,0,0,5
EUW1_6882761482',7,34,20,1,0,1,0,13,0,316,94,30320,30009,44013,6,29,17,0,0,3,0,4,342,70,31386,29234,39014,1,-26,24,-1066,3,775,4999,1,0,-2,0,9
EUW1_6882716606',4,27,11,0,1,1,0,7,1,384,95,28665,30673,28073,0,39,9,2,0,0,0,8,390,81,25999,31299,30081,1,-6,14,2666,2,-626,-2008,-2,1,1,0,-1
EUW1_6882658358',2,130,6,0,0,1,0,13,1,374,90,26227,28200,28919,3,28,21,2,0,2,0,4,381,112,32291,32164,39819,0,-7,-22,-6064,-15,-3964,-10900,-2,0,-1,0,9
EUW1_6882639499',2,130,7,1,0,0,0,5,1,378,112,25171,28900,26589,5,67,15,0,0,0,0,1,337,96,27378,29924,34245,0,41,16,-2207,-8,-1024,-7656,1,0,0,0,4
EUW1_6882029214',7,34,18,1,0,1,0,6,1,371,75,31045,31174,38608,2,30,12,0,0,0,0,3,354,80,26439,28619,34887,1,17,-5,4606,6,2555,3721,1,0,1,0,3
EUW1_6881465512',2,24,9,1,0,1,0,8,0,374,83,27085,29608,32336,4,90,17,1,0,1,0,6,358,91,29769,32658,35680,1,16,-8,-2684,-8,-3050,-3344,0,0,0,0,2
EUW1_6881410478',4,26,10,0,0,1,0,11,1,355,104,27385,28816,34521,2,37,16,2,0,1,0,2,358,83,28898,30683,35352,0,-3,21,-1513,-6,-1867,-831,-2,0,0,0,9
EUW1_6879888990',4,25,11,0,0,0,0,6,0,379,86,26237,31162,33098,5,34,16,2,0,0,0,2,353,100,28833,31502,36576,0,26,-14,-2596,-5,-340,-3478,-2,0,0,0,4
EUW1_6879845570',7,45,14,2,0,0,0,8,1,367,90,27734,30139,29806,3,37,8,0,0,1,0,4,356,82,26154,27602,31011,1,11,8,1580,6,2537,-1205,2,0,-1,0,4
EUW1_6878120075',1,23,8,0,0,0,0,6,0,389,122,25385,32120,23381,2,29,10,2,0,0,0,4,353,109,26469,31448,25934,0,36,13,-1084,-2,672,-2553,-2,0,0,0,2
EUW1_6878102565',1,37,7,0,0,0,0,14,1,326,76,24639,28852,22955,3,30,17,2,1,3,0,2,403,134,32740,34123,34972,0,-77,-58,-8101,-10,-5271,-12017,-2,-1,-3,0,12
EUW1_6878066876',9,32,14,1,0,2,0,4,1,378,99,30519,30181,35075,3,42,6,0,1,0,0,8,384,88,25837,28552,27682,0,-6,11,4682,8,1629,7393,1,-1,2,0,-4
EUW1_6878026413',3,42,21,0,0,1,0,6,1,334,90,32746,30568,39146,3,36,14,2,0,0,0,10,324,108,28664,30125,28923,0,10,-18,4082,7,443,10223,-2,0,1,0,-4
EUW1_6877503463',7,35,16,0,0,0,0,7,1,353,93,29758,31049,40326,1,24,12,2,0,0,0,0,367,72,27355,28633,33841,0,-14,21,2403,4,2416,6485,-2,0,0,0,7
EUW1_6877422268',5,30,9,1,0,0,0,7,1,350,82,25680,28831,30474,4,36,11,0,0,0,0,1,353,100,26819,29137,28819,1,-3,-18,-1139,-2,-306,1655,1,0,0,0,6
EUW1_6877382293',11,32,25,2,0,1,0,4,1,405,100,34656,33637,42450,3,41,10,0,0,3,0,7,338,78,25881,28189,30574,1,67,22,8775,15,5448,11876,2,0,-2,0,-3
EUW1_6877333767',1,25,12,0,0,0,0,14,0,334,74,27175,27161,36095,8,33,17,1,0,1,0,1,344,105,29967,31037,42186,0,-10,-31,-2792,-5,-3876,-6091,-1,0,-1,0,13
EUW1_6876998723',4,21,18,1,0,3,0,8,1,419,104,34222,32153,37214,5,142,3,0,0,0,0,8,321,68,21374,24953,24252,1,98,36,12848,15,7200,12962,1,0,3,0,0
EUW1_6876936115',3,26,4,0,0,0,0,15,0,373,98,23521,29341,23258,4,34,15,2,0,3,0,2,405,128,32432,33865,36200,0,-32,-30,-8911,-11,-4524,-12942,-2,0,-3,0,13
EUW1_6876900458',4,24,23,0,0,1,0,6,1,367,85,32856,31949,41354,3,30,16,2,0,0,0,5,297,95,27489,28440,32454,1,70,-10,5367,7,3509,8900,-2,0,1,0,1
EUW1_6876859563',5,25,11,0,0,0,0,13,0,358,86,27039,28798,31707,3,23,24,2,1,3,0,2,356,85,33187,31738,42703,0,2,1,-6148,-13,-2940,-10996,-2,-1,-3,0,11
EUW1_6876743494',2,21,14,0,0,1,0,11,0,369,84,28199,30575,33569,3,37,13,1,0,2,0,4,408,99,30700,31447,33641,1,-39,-15,-2501,1,-872,-72,-1,0,-1,0,7
EUW1_6876637420',6,67,18,0,0,1,0,14,0,359,79,31614,30702,34857,5,63,13,2,0,2,0,5,364,92,29190,29740,37449,0,-5,-13,2424,5,962,-2592,-2,0,-1,0,9
EUW1_6876610044',2,22,14,0,1,3,0,8,1,395,96,30278,32454,34898,1,21,14,2,0,1,0,9,329,107,26836,31224,31781,1,66,-11,3442,0,1230,3117,-2,1,2,0,-1
EUW1_6876576798',2,28,14,1,0,0,0,9,0,345,132,27848,31943,31093,2,73,8,1,0,2,0,4,378,52,27177,27819,30370,1,-33,80,671,6,4124,723,0,0,-2,0,5
EUW1_6875590609',7,50,9,1,0,0,0,14,0,349,93,25653,28393,30006,4,29,9,0,0,4,0,3,411,68,28933,31453,34038,1,-62,25,-3280,0,-3060,-4032,1,0,-4,0,11
EUW1_6875525756',2,17,13,0,1,0,0,11,1,387,115,29757,30459,36272,6,29,13,2,0,2,0,3,381,96,28981,30775,29238,1,6,19,776,0,-316,7034,-2,1,-2,0,8
EUW1_6875433504',3,24,20,1,0,1,0,8,1,346,82,31238,30575,45387,5,30,19,0,0,2,0,4,366,85,32054,31143,42524,1,-20,-3,-816,1,-568,2863,1,0,-1,0,4
EUW1_6883756723',3,28,3,0,0,0,0,12,0,333,80,21518,26898,17786,4,35,10,2,0,2,0,0,458,143,30555,34484,30503,0,-125,-63,-9037,-7,-7586,-12717,-2,0,-2,0,12
EUW1_6883730209',8,27,7,0,1,0,0,3,1,378,99,25665,29041,30201,4,33,11,2,0,0,0,2,358,92,25324,29655,27446,1,20,7,341,-4,-614,2755,-2,1,0,0,1
EUW1_6883697267',2,27,12,1,0,0,0,4,1,385,115,28833,32359,32515,1,35,8,0,0,1,0,4,353,100,25049,29981,28352,0,32,15,3784,4,2378,4163,1,0,-1,0,0
EUW1_6883698689',4,35,12,1,0,0,0,9,1,353,85,27456,29621,34776,2,23,12,0,0,1,0,0,404,74,29065,30031,41440,0,-51,11,-1609,0,-410,-6664,1,0,-1,0,9
EUW1_6882645972',2,21,7,0,0,1,0,11,0,333,66,25995,27860,30095,3,38,18,1,1,1,0,3,364,108,29495,32336,39083,0,-31,-42,-3500,-11,-4476,-8988,-1,-1,0,0,8
EUW1_6882606117',5,51,15,0,0,0,0,4,1,389,112,29696,31729,32260,3,20,9,2,0,0,0,6,381,91,26316,27648,28552,1,8,21,3380,6,4081,3708,-2,0,0,0,-2
EUW1_6881282023',3,25,10,1,0,0,0,9,0,308,90,24876,28103,29813,4,27,12,1,0,1,0,0,405,91,28093,30161,29490,0,-97,-1,-3217,-2,-2058,323,0,0,-1,0,9
EUW1_6881229436',3,27,8,2,1,0,0,8,1,389,130,26735,31334,26485,2,23,7,0,0,0,0,2,357,86,25797,28969,32896,0,32,44,938,1,2365,-6411,2,1,0,0,6
EUW1_6881184807',1,23,8,0,0,1,0,11,1,348,98,26113,28782,32398,3,28,12,2,0,2,0,7,360,106,28505,30824,26826,0,-12,-8,-2392,-4,-2042,5572,-2,0,-1,0,4
EUW1_6880978392',4,19,5,0,0,0,0,13,0,371,67,22537,27822,18154,4,138,16,2,0,4,0,1,437,106,32544,33309,33382,0,-66,-39,-10007,-11,-5487,-15228,-2,0,-4,0,12
EUW1_6880953066',1,18,11,0,0,1,0,8,0,317,89,27487,28005,26566,4,33,17,2,1,1,0,7,363,108,29738,29421,31348,1,-46,-19,-2251,-6,-1416,-4782,-2,-1,0,0,1
EUW1_6880921209',1,45,21,0,0,0,0,1,0,300,73,29166,27529,41920,6,26,20,1,0,0,0,2,272,78,29019,27613,35931,1,28,-5,147,1,-84,5989,-1,0,0,0,-1
EUW1_6880902756',0,53,15,0,0,0,0,4,0,359,102,29658,31259,34205,2,60,9,2,0,1,0,1,325,88,25047,27351,29059,1,34,14,4611,6,3908,5146,-2,0,-1,0,3
EUW1_6878859448',7,32,15,1,0,1,0,10,1,393,80,30294,29608,33653,5,29,12,1,0,0,0,6,364,94,27624,29846,30875,0,29,-14,2670,3,-238,2778,0,0,1,0,4
EUW1_6878787313',3,26,19,1,0,6,0,12,1,396,104,34402,31367,35177,0,25,5,1,0,1,0,7,283,84,21510,24694,21061,1,113,20,12892,14,6673,14116,0,0,5,0,5
EUW1_6874965027',2,23,8,1,0,0,0,9,1,342,88,25223,27668,35972,6,29,20,1,1,2,0,3,376,99,31763,32476,42260,0,-34,-11,-6540,-12,-4808,-6288,0,-1,-2,0,6
EUW1_6874927782',2,31,17,1,0,0,0,12,0,321,80,27862,29844,36618,5,34,14,1,0,2,0,1,379,86,29376,31066,36724,1,-58,-6,-1514,3,-1222,-106,0,0,-2,0,11
EUW1_6874882718',3,30,16,0,0,0,0,12,1,344,64,28397,27161,39125,4,31,14,1,0,1,0,1,331,80,28477,28035,42175,0,13,-16,-80,2,-874,-3050,-1,0,-1,0,11
EUW1_6874760926',6,31,13,2,0,2,0,6,1,405,88,29850,30806,34286,0,51,10,0,0,1,0,8,352,75,26429,28052,28380,1,53,13,3421,3,2754,5906,2,0,1,0,-2
EUW1_6883629500',5,38,15,2,0,0,0,11,1,337,90,29195,28986,35391,2,30,19,0,1,2,0,3,393,86,32378,30956,35535,0,-56,4,-3183,-4,-1970,-144,2,-1,-2,0,8
EUW1_6883605840',7,30,27,2,0,2,0,11,1,387,94,35606,34381,48882,4,27,17,0,0,1,0,9,333,85,30583,29364,38832,1,54,9,5023,10,5017,10050,2,0,1,0,2
EUW1_6883567426',3,28,6,1,0,0,0,8,1,394,122,25508,30204,34175,2,31,11,1,0,1,0,1,375,74,26397,29175,27346,1,19,48,-889,-5,1029,6829,0,0,-1,0,7
EUW1_6883541791',3,25,16,1,0,0,0,11,0,381,94,30076,29950,42889,3,118,16,1,0,1,0,7,330,90,29507,30107,36836,0,51,4,569,0,-157,6053,0,0,-1,0,4
EUW1_6883498244',3,23,9,0,0,0,0,8,0,374,77,25629,27575,29381,3,27,14,1,1,1,0,1,381,94,28990,32163,31332,0,-7,-17,-3361,-5,-4588,-1951,-1,-1,-1,0,7
EUW1_6883411879',5,39,14,0,0,0,0,12,1,356,59,28776,27922,36871,7,34,21,1,0,2,0,3,360,111,33612,31977,35346,0,-4,-52,-4836,-7,-4055,1525,-1,0,-2,0,9
EUW1_6883348065',2,28,14,1,0,0,0,8,0,354,95,28428,30281,33087,2,27,12,1,1,0,0,4,394,57,27725,31105,31659,1,-40,38,703,2,-824,1428,0,-1,0,0,4
EUW1_6882914107',6,139,13,1,0,0,0,6,1,393,79,28658,30749,35875,1,21,12,1,0,1,0,3,379,96,27274,31495,34698,0,14,-17,1384,1,-746,1177,0,0,-1,0,3
EUW1_6882880757',6,31,13,1,1,3,0,7,1,339,122,29785,30710,23152,1,29,10,1,0,0,0,10,324,98,25339,27520,22031,1,15,24,4446,3,3190,1121,0,1,3,0,-3
EUW1_6882831994',2,25,20,2,0,2,0,11,1,357,90,31420,32088,40770,1,21,8,0,0,1,0,9,334,94,25389,27199,31623,1,23,-4,6031,12,4889,9147,2,0,1,0,2
EUW1_6882792159',0,17,4,0,0,0,0,14,0,333,64,21705,24583,20977,5,30,20,2,1,3,0,2,392,107,34009,32061,43816,0,-59,-43,-12304,-16,-7478,-22839,-2,-1,-3,0,12
EUW1_6882715346',3,26,13,1,0,1,0,10,0,352,90,28014,28789,30009,0,26,15,0,0,0,0,4,353,90,29276,29831,31605,0,-1,0,-1262,-2,-1042,-1596,1,0,1,0,6
EUW1_6882674396',2,24,21,0,0,0,0,10,0,333,76,31206,30511,46546,6,57,21,1,0,1,0,3,320,64,30271,28560,39974,1,13,12,935,0,1951,6572,-1,0,-1,0,7
EUW1_6882227588',5,65,14,2,0,1,0,7,0,394,88,29175,30548,32011,0,25,15,0,0,1,0,6,374,110,28818,32725,32659,0,20,-22,357,-1,-2177,-648,2,0,0,0,1
EUW1_6882188408',3,28,12,0,0,0,0,6,0,384,100,29440,30193,32083,2,25,11,2,1,1,0,4,368,82,27499,29661,26692,1,16,18,1941,1,532,5391,-2,-1,-1,0,2
EUW1_6882165890',2,42,16,0,0,0,0,16,1,336,72,28156,28342,43249,3,25,17,1,0,3,0,3,331,81,30395,27671,38577,0,5,-9,-2239,-1,671,4672,-1,0,-3,0,13
EUW1_6882123266',3,20,7,1,0,1,0,11,0,350,76,24504,28853,31914,6,32,15,1,0,1,0,3,361,96,28700,29780,38715,0,-11,-20,-4196,-8,-927,-6801,0,0,0,0,8
EUW1_6882073635',1,23,20,2,0,1,0,5,1,365,70,32168,30502,40528,7,28,20,0,0,0,0,3,320,118,29624,28661,39052,0,45,-48,2544,0,1841,1476,2,0,1,0,2
EUW1_6883392410',3,26,24,1,0,1,0,5,0,311,84,32005,30427,44352,4,28,17,1,0,2,0,6,336,84,30306,29664,39334,0,-25,0,1699,7,763,5018,0,0,-1,0,-1
EUW1_6883335420',4,300,20,1,0,1,0,9,1,363,70,31749,31553,43671,2,18,9,0,0,1,0,7,312,78,23978,26347,20999,1,51,-8,7771,11,5206,22672,1,0,0,0,2
EUW1_6882841688',6,30,18,2,0,0,0,9,1,318,90,28844,30492,31715,4,25,13,0,0,0,0,3,329,72,25731,27741,38570,1,-11,18,3113,5,2751,-6855,2,0,0,0,6
EUW1_6882779472',4,23,12,0,1,0,0,7,0,380,86,27558,30447,27720,7,66,15,1,0,0,0,1,342,92,28147,31625,31676,0,38,-6,-589,-3,-1178,-3956,-1,1,0,0,6
EUW1_6882714645',2,284,12,0,0,1,0,11,0,299,81,27011,28121,37726,1,22,17,2,0,2,0,2,340,86,30210,30530,37580,0,-41,-5,-3199,-5,-2409,146,-2,0,-1,0,9
EUW1_6882675818',3,28,18,2,0,1,0,11,0,356,96,30693,30432,42741,1,22,15,0,0,2,0,7,301,83,28618,27392,36448,1,55,13,2075,3,3040,6293,2,0,-1,0,4
EUW1_6882616634',3,46,10,1,1,0,0,7,1,385,89,27411,30266,26712,6,192,9,0,0,1,0,2,375,85,25398,28886,27784,1,10,4,2013,1,1380,-1072,1,1,-1,0,5
EUW1_6882579671',3,62,9,0,0,0,0,9,0,361,92,24970,30682,33726,3,59,8,1,0,1,0,0,418,71,26431,30803,37423,1,-57,21,-1461,1,-121,-3697,-1,0,-1,0,9
EUW1_6882548322',3,239,7,1,0,0,0,13,0,353,60,23709,26595,33808,8,31,19,0,0,2,0,5,364,95,32130,31837,40470,0,-11,-35,-8421,-12,-5242,-6662,1,0,-2,0,8
EUW1_6880671499',2,59,11,0,0,2,0,9,0,342,88,27927,32155,32976,2,57,12,2,0,0,0,3,354,80,26358,29564,34367,0,-12,8,1569,-1,2591,-1391,-2,0,2,0,6
EUW1_6880601504',4,178,11,1,0,2,0,12,1,373,94,28706,29616,27429,1,94,15,1,0,2,0,6,340,102,30058,31774,31118,0,33,-8,-1352,-4,-2158,-3689,0,0,0,0,6
EUW1_6880548150',7,26,11,1,0,0,0,10,1,369,84,29033,28413,31707,3,97,15,0,0,2,0,6,288,108,28106,29881,33352,0,81,-24,927,-4,-1468,-1645,1,0,-2,0,4
EUW1_6880035837',3,26,14,2,0,1,0,12,0,389,88,28447,31363,31627,1,26,11,0,1,1,0,2,315,104,27004,27386,27410,1,74,-16,1443,3,3977,4217,2,-1,0,0,10
EUW1_6879985767',0,137,7,0,0,1,0,10,1,348,84,27162,28117,25199,6,98,12,2,0,2,0,9,369,83,26420,29469,24575,1,-21,1,742,-5,-1352,624,-2,0,-1,0,1
EUW1_6879911234',1,66,7,0,0,0,0,8,0,339,96,24000,28940,28513,5,72,14,2,0,1,0,1,379,110,28684,32578,33772,0,-40,-14,-4684,-7,-3638,-5259,-2,0,-1,0,7
EUW1_6879887601',3,23,12,0,0,0,0,18,0,345,71,26680,27343,29995,4,28,20,2,0,3,0,2,378,100,31504,32454,39873,0,-33,-29,-4824,-8,-5111,-9878,-2,0,-3,0,16
EUW1_6879821534',4,25,7,0,0,0,0,7,1,347,106,24477,30654,19323,3,30,12,2,0,1,0,4,378,113,28332,33674,29797,0,-31,-7,-3855,-5,-3020,-10474,-2,0,-1,0,3
EUW1_6879786805',2,24,4,0,1,0,0,10,0,314,90,22933,25148,21881,2,19,16,2,0,1,0,0,386,74,29773,30883,37600,0,-72,16,-6840,-12,-5735,-15719,-2,1,-1,0,10
EUW1_6883176746',3,34,7,1,0,2,0,7,0,393,79,26310,29589,25459,2,80,3,0,0,0,0,8,321,102,22033,25964,25830,1,72,-23,4277,4,3625,-371,1,0,2,0,-1
EUW1_6883048768',4,29,11,1,0,0,0,9,0,362,84,26314,29400,30294,1,29,17,0,0,2,0,3,352,88,29517,30311,33791,0,10,-4,-3203,-6,-911,-3497,1,0,-2,0,6
EUW1_6882991462',3,61,15,1,0,1,0,12,1,306,100,28814,28468,32755,4,147,11,1,0,1,0,4,362,103,27597,29119,30346,1,-56,-3,1217,4,-651,2409,0,0,0,0,8
EUW1_6882922022',4,22,14,1,0,0,0,5,0,372,94,28329,30331,29575,6,26,10,1,0,0,0,4,339,70,25053,27653,31294,1,33,24,3276,4,2678,-1719,0,0,0,0,1
EUW1_6882817214',3,27,20,0,0,1,0,13,0,346,84,31030,31354,36148,4,33,17,2,0,2,0,7,345,96,31263,29179,44411,0,1,-12,-233,3,2175,-8263,-2,0,-1,0,6
EUW1_6882733772',3,24,14,0,0,2,0,7,1,407,84,30120,30913,37329,3,24,13,1,0,0,0,6,319,86,26864,29125,34003,0,88,-2,3256,1,1788,3326,-1,0,2,0,1
EUW1_6882218228',5,66,12,0,0,2,0,10,0,370,82,27275,30540,31763,1,51,12,1,0,1,0,6,336,92,28080,30232,34502,0,34,-10,-805,0,308,-2739,-1,0,1,0,4
EUW1_6882158821',2,23,11,0,0,1,0,6,1,366,75,27263,28342,33137,1,73,22,2,0,1,0,5,284,103,30223,31910,31214,0,82,-28,-2960,-11,-3568,1923,-2,0,0,0,1
EUW1_6882090901',1,24,12,2,1,1,0,8,1,386,110,28898,31585,33067,1,26,5,0,0,0,0,4,320,86,22797,26428,32242,0,66,24,6101,7,5157,825,2,1,1,0,4
EUW1_6882045751',0,27,10,1,0,0,0,8,0,396,98,25852,30069,23895,6,37,15,0,0,0,0,0,368,80,29001,30189,27680,0,28,18,-3149,-5,-120,-3785,1,0,0,0,8
EUW1_6881956653',3,30,8,0,0,0,0,9,0,351,94,25102,29590,26297,3,49,13,2,0,0,0,1,367,99,26843,30716,31577,1,-16,-5,-1741,-5,-1126,-5280,-2,0,0,0,8
EUW1_6881802268',6,26,9,1,0,0,0,16,0,334,92,25165,28001,26852,2,43,10,0,1,1,0,0,370,91,27740,28566,28269,0,-36,1,-2575,-1,-565,-1417,1,-1,-1,0,16
EUW1_6881639276',4,22,7,1,0,2,0,6,0,361,80,26156,29790,26090,1,22,5,1,0,0,0,7,337,115,23865,28873,22015,1,24,-35,2291,2,917,4075,0,0,2,0,-1
EUW1_6881608906',4,35,6,1,0,0,0,14,0,355,86,23533,27831,22721,5,23,14,1,0,2,0,1,394,82,30919,32886,41147,0,-39,4,-7386,-8,-5055,-18426,0,0,-2,0,13
EUW1_6881553078',3,135,16,2,0,2,0,8,1,365,99,30630,31306,32419,1,30,17,0,0,1,0,6,339,96,29816,30515,42074,1,26,3,814,-1,791,-9655,2,0,1,0,2
EUW1_6881502029',6,32,12,1,0,1,0,5,1,392,107,28858,31799,29077,4,35,7,1,0,0,0,6,322,100,24158,29016,26315,1,70,7,4700,5,2783,2762,0,0,1,0,-1
EUW1_6881466196',0,49,19,0,1,2,0,8,0,380,84,31794,33904,35532,1,17,8,2,0,1,0,7,314,86,23346,26352,23215,1,66,-2,8448,11,7552,12317,-2,1,1,0,1
EUW1_6881344944',3,27,10,1,0,1,0,11,1,357,96,26826,27446,27163,1,30,14,1,1,1,0,4,362,107,28618,31640,33213,0,-5,-11,-1792,-4,-4194,-6050,0,-1,0,0,7
EUW1_6880306440',4,20,3,1,1,0,0,10,0,372,100,23478,29344,22794,1,29,9,1,0,0,0,2,378,111,25756,29939,21743,0,-6,-11,-2278,-6,-595,1051,0,1,0,0,8
EUW1_6883749060',6,25,17,0,0,0,0,15,1,387,103,30647,31502,40007,4,19,9,2,0,3,0,1,389,94,29015,31851,24773,1,-2,9,1632,8,-349,15234,-2,0,-3,0,14
EUW1_6883727727',6,27,11,1,0,0,0,14,0,333,84,25650,27772,24015,4,42,19,1,0,3,0,0,390,118,34318,33344,44782,0,-57,-34,-8668,-8,-5572,-20767,0,0,-3,0,14
EUW1_6883710877',2,52,15,1,0,1,0,7,0,383,88,29955,30287,40151,2,30,8,0,0,0,0,3,356,96,24974,30173,47249,1,27,-8,4981,7,114,-7098,1,0,1,0,4
EUW1_6882095616',2,27,6,2,0,1,0,16,1,340,100,24599,28498,27616,3,81,9,0,0,3,0,1,382,104,28861,30325,29133,0,-42,-4,-4262,-3,-1827,-1517,2,0,-2,0,15
EUW1_6882042356',9,36,20,2,0,0,0,9,1,373,106,31852,33890,48637,1,23,5,0,0,1,0,5,331,58,22716,26418,25403,1,42,48,9136,15,7472,23234,2,0,-1,0,4
EUW1_6881976556',4,27,12,0,1,0,0,6,0,378,97,29151,30740,34633,4,33,20,2,0,0,0,7,345,106,29666,30812,43477,0,33,-9,-515,-8,-72,-8844,-2,1,0,0,-1
EUW1_6881896348',2,38,8,0,0,0,0,10,1,331,110,26056,29359,27727,1,145,9,2,1,0,0,3,428,97,26659,31472,26090,0,-97,13,-603,-1,-2113,1637,-2,-1,0,0,7
EUW1_6869778659',1,21,7,0,1,0,0,11,0,366,115,26553,29752,25811,5,27,16,2,0,1,0,5,356,80,29110,30814,34803,0,10,35,-2557,-9,-1062,-8992,-2,1,-1,0,6
EUW1_6869724777',2,69,8,0,0,0,0,13,0,338,89,24540,28216,24675,2,37,19,1,0,4,0,2,380,90,34152,31316,47786,0,-42,-1,-9612,-11,-3100,-23111,-1,0,-4,0,11
EUW1_6869498069',3,65,4,0,0,0,0,11,1,313,76,22483,26945,18911,8,29,22,2,0,3,0,4,368,79,32052,32572,41075,0,-55,-3,-9569,-18,-5627,-22164,-2,0,-3,0,7
EUW1_6867837785',5,77,10,1,1,0,0,8,0,363,64,25384,28084,26793,3,28,14,0,0,0,0,2,367,68,28439,29656,32139,0,-4,-4,-3055,-4,-1572,-5346,1,1,0,0,6
EUW1_6867794937',2,30,15,0,0,0,0,9,1,369,82,29120,28769,35509,2,35,8,2,0,1,0,1,355,78,26039,27974,32738,0,14,4,3081,7,795,2771,-2,0,-1,0,8
EUW1_6866411153',2,18,14,1,0,0,0,9,0,364,120,28518,32167,34426,4,26,9,1,0,0,0,5,381,96,26598,30548,30964,1,-17,24,1920,5,1619,3462,0,0,0,0,4
EUW1_6861384483',5,33,11,0,0,0,0,12,1,352,100,28235,29712,27542,6,27,14,1,0,2,0,2,326,90,28398,29874,33848,1,26,10,-163,-3,-162,-6306,-1,0,-2,0,10
EUW1_6861262674',6,146,18,2,0,1,0,8,1,366,108,31113,31374,42359,7,29,15,0,0,0,0,9,337,80,28032,30955,32856,1,29,28,3081,3,419,9503,2,0,1,0,-1
EUW1_6852158714',5,30,17,1,0,0,0,9,1,408,92,31445,31092,36766,2,29,10,0,0,2,0,4,356,89,27281,28733,24880,0,52,3,4164,7,2359,11886,1,0,-2,0,5
EUW1_6878704225',5,195,21,1,0,2,0,9,0,349,79,32555,30512,41916,4,35,11,0,0,1,0,6,312,43,23848,23919,29929,1,37,36,8707,10,6593,11987,1,0,1,0,3
EUW1_6877183760',1,30,9,0,1,0,0,8,0,394,83,27367,29023,24932,5,28,19,1,0,1,0,4,364,111,31421,31877,36426,0,30,-28,-4054,-10,-2854,-11494,-1,1,-1,0,4
EUW1_6876977942',2,30,15,1,1,1,0,3,0,369,119,30281,31780,32343,2,20,8,1,0,0,0,7,378,84,24886,29423,26215,1,-9,35,5395,7,2357,6128,0,1,1,0,-4
EUW1_6876895337',3,42,14,2,0,1,0,7,1,360,85,28666,30675,29672,6,29,9,0,0,0,0,4,339,76,24784,27367,22057,1,21,9,3882,5,3308,7615,2,0,1,0,3
EUW1_6875866828',4,29,9,1,0,0,0,8,1,360,78,24910,29138,27566,3,30,11,1,0,2,0,1,378,97,28663,29807,26091,0,-18,-19,-3753,-2,-669,1475,0,0,-2,0,7
EUW1_6883293473',3,44,13,2,0,0,0,10,1,328,96,27353,29020,30385,2,30,14,0,0,0,0,0,365,76,27887,28557,32751,1,-37,20,-534,-1,463,-2366,2,0,0,0,10
EUW1_6883176277',4,27,8,1,0,0,0,10,0,399,82,25699,29586,31808,8,57,15,0,0,0,0,1,373,98,28745,32089,32884,0,26,-16,-3046,-7,-2503,-1076,1,0,0,0,9
EUW1_6882848897',3,176,12,1,0,0,0,7,1,396,85,26671,29428,25404,1,38,8,0,0,0,0,1,369,84,25893,29493,27230,0,27,1,778,4,-65,-1826,1,0,0,0,6
EUW1_6882788149',5,33,14,2,0,0,0,12,1,381,92,29330,32250,24791,5,55,8,0,0,2,0,2,350,77,25239,26903,28716,1,31,15,4091,6,5347,-3925,2,0,-2,0,10
EUW1_6882763641',4,26,8,1,0,0,0,10,1,328,88,26185,26924,34733,5,28,18,1,0,2,0,0,404,108,31156,33054,38093,0,-76,-20,-4971,-10,-6130,-3360,0,0,-2,0,10
EUW1_6882271597',5,29,8,0,0,0,0,16,0,332,68,24707,28327,21992,5,43,13,2,1,2,0,0,350,115,29348,30860,28562,0,-18,-47,-4641,-5,-2533,-6570,-2,-1,-2,0,16
EUW1_6882253815',5,109,30,0,1,0,0,18,1,289,69,33289,29806,48222,4,37,16,1,0,2,0,2,295,73,28861,26285,32955,1,-6,-4,4428,14,3521,15267,-1,1,-2,0,16
EUW1_6882231163',2,26,21,1,1,0,0,6,1,367,101,30823,35046,36342,4,23,11,0,0,0,0,1,364,98,26621,30624,34779,1,3,3,4202,10,4422,1563,1,1,0,0,5
EUW1_6882154061',4,48,20,0,0,0,0,9,1,356,67,30980,29431,39680,2,54,16,1,0,2,0,5,383,74,29930,30506,34433,0,-27,-7,1050,4,-1075,5247,-1,0,-2,0,4
EUW1_6882128049',5,29,10,0,0,0,0,7,0,315,70,24832,27562,26799,4,28,25,1,0,1,0,0,386,91,33142,34084,45633,0,-71,-21,-8310,-15,-6522,-18834,-1,0,-1,0,7
EUW1_6882095596',3,26,16,2,0,1,0,15,1,316,86,29372,27666,37253,7,31,22,0,1,2,0,3,331,77,32420,28609,46204,0,-15,9,-3048,-6,-943,-8951,2,-1,-1,0,12
EUW1_6881583288',5,50,22,2,1,1,0,6,1,386,71,32504,33691,45543,1,25,7,0,0,1,0,6,325,128,25479,29265,32531,1,61,-57,7025,15,4426,13012,2,1,0,0,0
EUW1_6881497437',3,27,16,0,0,0,0,6,1,324,112,28022,31712,31893,5,28,12,2,0,0,0,2,397,72,27476,29395,43324,1,-73,40,546,4,2317,-11431,-2,0,0,0,4
EUW1_6881348413',6,62,7,0,0,0,0,11,0,319,78,24364,27059,29478,3,167,12,1,0,2,0,0,428,118,30075,31802,32827,0,-109,-40,-5711,-5,-4743,-3349,-1,0,-2,0,11
EUW1_6881290896',11,41,8,1,0,0,0,5,1,380,65,26341,27561,29040,1,26,17,0,0,0,0,4,405,119,29680,32967,37301,0,-25,-54,-3339,-9,-5406,-8261,1,0,0,0,1
EUW1_6881249635',5,36,9,0,0,0,0,4,0,416,88,25588,29554,29557,7,38,11,2,0,0,0,3,385,82,26948,30096,34698,0,31,6,-1360,-2,-542,-5141,-2,0,0,0,1
EUW1_6880542973',5,28,13,2,0,1,0,11,1,396,83,28680,30166,34353,5,26,15,0,0,0,0,4,368,79,29104,29262,40196,0,28,4,-424,-2,904,-5843,2,0,1,0,7
EUW1_6879550682',1,24,5,0,0,0,0,9,0,354,88,23565,28458,21653,6,28,16,1,0,1,0,3,366,112,29762,33202,29443,0,-12,-24,-6197,-11,-4744,-7790,-1,0,-1,0,6
EUW1_6878367759',4,27,28,0,0,1,0,14,0,344,68,32189,30278,50231,4,28,11,2,0,1,0,5,300,84,28159,26188,35283,1,44,-16,4030,17,4090,14948,-2,0,0,0,9
EUW1_6878241151',6,26,13,1,0,0,0,9,0,388,100,28308,30339,31373,2,28,12,0,0,0,0,1,368,96,27693,29490,29470,1,20,4,615,1,849,1903,1,0,0,0,8
EUW1_6875470283',5,32,9,0,0,0,0,11,0,321,102,25156,28351,31899,7,32,20,1,0,1,0,1,393,78,30190,31815,37725,0,-72,24,-5034,-11,-3464,-5826,-1,0,-1,0,10
EUW1_6871315535',4,62,13,0,0,2,0,9,0,335,104,28927,30248,41005,6,67,19,2,0,1,0,4,367,95,30177,30623,40613,0,-32,9,-1250,-6,-375,392,-2,0,1,0,5
EUW1_6871122811',8,37,14,0,0,0,0,5,1,381,72,28230,29846,38496,4,32,7,1,0,0,0,5,354,104,24582,28385,29189,1,27,-32,3648,7,1461,9307,-1,0,0,0,0
EUW1_6870606118',5,21,9,0,0,0,0,7,1,338,111,26780,29220,22788,3,23,6,2,0,2,0,7,381,90,25142,28172,27680,0,-43,21,1638,3,1048,-4892,-2,0,-2,0,0
EUW1_6870554682',6,27,13,0,0,0,0,7,1,369,83,27670,28697,25818,5,52,17,1,0,1,0,4,376,80,29531,30755,36438,0,-7,3,-1861,-4,-2058,-10620,-1,0,-1,0,3
EUW1_6870489120',5,28,17,1,0,0,0,6,1,381,104,29827,30500,32959,7,41,7,0,0,0,0,8,384,92,25471,28365,23296,1,-3,12,4356,10,2135,9663,1,0,0,0,-2
EUW1_6870408490',5,58,10,0,1,2,0,12,0,325,92,28602,27145,30464,5,31,19,2,0,1,0,5,273,88,27627,27316,30355,0,52,4,975,-9,-171,109,-2,1,1,0,7
EUW1_6870117566',1,135,8,0,0,1,0,16,0,374,78,26817,27646,29139,8,30,17,1,1,3,0,5,378,115,32807,31578,36380,0,-4,-37,-5990,-9,-3932,-7241,-1,-1,-2,0,11
EUW1_6866376013',8,37,9,0,0,0,0,15,1,385,74,25819,29944,27357,3,24,11,2,1,3,0,0,416,114,30379,33828,30296,0,-31,-40,-4560,-2,-3884,-2939,-2,-1,-3,0,15
EUW1_6866340241',3,34,9,0,0,0,0,10,1,362,92,26676,28687,30526,6,24,18,2,1,1,0,5,356,112,30206,32260,31221,0,6,-20,-3530,-9,-3573,-695,-2,-1,-1,0,5
EUW1_6866316841',3,27,11,1,0,0,0,14,1,349,98,26904,27796,26413,4,45,14,1,0,4,0,3,380,87,30611,30348,31923,0,-31,11,-3707,-3,-2552,-5510,0,0,-4,0,11
EUW1_6883538478',6,33,22,1,0,1,0,8,1,374,78,32536,29389,34909,2,32,23,1,0,0,0,4,321,86,31549,30098,34963,1,53,-8,987,-1,-709,-54,0,0,1,0,4
EUW1_6883444253',2,25,11,1,0,0,0,10,0,358,82,27112,28800,32152,5,22,12,1,0,3,0,4,305,91,26995,29123,29006,1,53,-9,117,-1,-323,3146,0,0,-3,0,6
EUW1_6883262120',2,50,12,1,0,0,0,11,0,348,104,27651,30030,36309,3,24,20,0,0,2,0,1,404,68,32071,32568,37908,1,-56,36,-4420,-8,-2538,-1599,1,0,-2,0,10
EUW1_6883196994',3,55,7,0,0,0,0,5,0,338,74,23953,28479,23899,1,23,9,2,0,0,0,0,365,82,25629,29926,31304,0,-27,-8,-1676,-2,-1447,-7405,-2,0,0,0,5
EUW1_6883079673',4,25,12,1,0,0,0,10,1,342,85,26274,28774,37096,6,29,5,0,0,0,0,5,328,74,23300,26381,36199,0,14,11,2974,7,2393,897,1,0,0,0,5
EUW1_6883017466',4,27,20,2,1,3,0,6,1,435,124,33789,34048,34467,4,26,3,0,0,0,0,10,319,96,22380,26749,22897,1,116,28,11409,17,7299,11570,2,1,3,0,-4
EUW1_6882956887',3,28,15,1,0,2,0,8,1,339,79,29165,28518,39920,2,27,9,0,0,1,0,6,337,95,26802,27838,31293,1,2,-16,2363,6,680,8627,1,0,1,0,2
EUW1_6882880387',2,29,15,1,0,0,0,7,1,364,72,28721,31739,36077,5,35,19,1,0,0,0,6,298,84,29653,29528,35345,0,66,-12,-932,-4,2211,732,0,0,0,0,1
EUW1_6882786508',2,22,15,1,1,0,0,5,1,383,111,29285,31485,42590,7,25,14,1,0,1,0,5,383,76,28313,29756,28966,1,0,35,972,1,1729,13624,0,1,-1,0,0
EUW1_6882730123',1,18,13,0,0,0,0,3,1,384,68,27234,29343,32129,2,28,11,1,0,0,0,4,344,92,25624,28742,20986,0,40,-24,1610,2,601,11143,-1,0,0,0,-1
EUW1_6882222196',2,28,10,2,0,0,0,6,1,386,111,26986,33102,24971,5,25,3,0,0,0,0,0,392,80,23776,28973,17983,1,-6,31,3210,7,4129,6988,2,0,0,0,6
EUW1_6882202834',4,37,14,1,0,2,0,12,1,350,112,29540,29130,34834,0,23,16,1,0,1,0,6,337,68,28159,30837,31460,1,13,44,1381,-2,-1707,3374,0,0,1,0,6
EUW1_6882126071',0,24,11,1,0,0,0,10,1,372,52,25473,29424,30440,2,25,16,1,0,1,0,3,351,104,29569,31919,29208,0,21,-52,-4096,-5,-2495,1232,0,0,-1,0,7
EUW1_6882037275',3,30,13,0,0,0,0,11,0,316,84,26684,28724,35102,1,19,16,2,0,1,0,0,325,79,28489,30110,36074,0,-9,5,-1805,-3,-1386,-972,-2,0,-1,0,11
EUW1_6881993946',0,79,7,0,0,1,0,12,0,351,78,25650,29791,28452,4,27,20,2,0,1,0,3,380,101,30476,33120,37563,0,-29,-23,-4826,-13,-3329,-9111,-2,0,0,0,9
EUW1_6881764642',4,26,12,1,0,0,0,12,0,287,106,27770,27995,30039,1,22,21,1,0,1,0,7,310,101,30605,30095,46841,0,-23,5,-2835,-9,-2100,-16802,0,0,-1,0,5
EUW1_6881680720',7,41,17,0,0,0,0,14,0,305,62,28484,29342,39025,2,25,18,2,0,2,0,3,358,104,31980,31402,40635,0,-53,-42,-3496,-1,-2060,-1610,-2,0,-2,0,11
EUW1_6881608354',6,28,12,1,1,0,0,10,1,315,90,26700,29219,39431,6,26,17,1,0,1,0,1,371,81,29713,31173,33410,0,-56,9,-3013,-5,-1954,6021,0,1,-1,0,9
EUW1_6881499738',1,22,7,1,0,0,0,11,0,355,90,24938,29383,33378,7,35,18,1,1,2,0,0,384,113,31456,32945,38349,0,-29,-23,-6518,-11,-3562,-4971,0,-1,-2,0,11
EUW1_6882720880',5,29,17,1,0,2,0,9,0,318,88,28504,30275,35154,1,23,13,0,0,0,0,2,357,86,26484,28749,30553,1,-39,2,2020,4,1526,4601,1,0,2,0,7
EUW1_6882546515',7,21,21,0,0,0,0,15,0,222,59,28401,26117,43734,7,29,34,2,0,4,0,2,381,71,37576,31786,62452,0,-159,-12,-9175,-13,-5669,-18718,-2,0,-4,0,13
EUW1_6882512557',2,26,11,0,0,0,0,13,0,300,84,25194,27887,35136,4,26,23,2,1,2,0,1,338,123,32146,33972,39107,0,-38,-39,-6952,-12,-6085,-3971,-2,-1,-2,0,12
EUW1_6882492836',2,30,15,1,0,1,0,6,0,420,94,29930,32280,37967,4,39,10,0,0,0,0,6,322,98,24765,27065,30649,1,98,-4,5165,5,5215,7318,1,0,1,0,0
EUW1_6882467589',6,29,8,2,1,2,0,8,0,387,116,27723,30539,30499,1,103,8,0,0,0,0,4,365,71,24329,28691,23828,1,22,45,3394,0,1848,6671,2,1,2,0,4
EUW1_6882411031',4,36,15,0,0,0,0,11,1,346,98,28057,30387,31215,2,27,5,1,1,1,0,6,338,74,24294,26926,29260,0,8,24,3763,10,3461,1955,-1,-1,-1,0,5
EUW1_6882286117',4,29,9,0,0,0,0,11,0,360,96,27735,27954,26905,4,70,20,2,0,1,0,3,315,85,29495,30244,34872,0,45,11,-1760,-11,-2290,-7967,-2,0,-1,0,8
EUW1_6881105402',0,124,10,0,0,0,0,13,0,348,96,25807,29857,33364,3,27,18,1,1,3,0,0,391,92,31260,33148,35700,0,-43,4,-5453,-8,-3291,-2336,-1,-1,-3,0,13
EUW1_6879685714',1,21,14,1,0,0,0,11,1,354,106,28594,30979,34043,3,28,14,0,0,2,0,2,345,76,29813,31348,33177,1,9,30,-1219,0,-369,866,1,0,-2,0,9
EUW1_6879456221',3,34,14,0,0,0,0,11,0,324,67,26412,26617,27633,2,27,14,2,0,1,0,3,337,100,28576,26886,35304,0,-13,-33,-2164,0,-269,-7671,-2,0,-1,0,8
EUW1_6879302498',5,32,23,1,0,1,0,9,1,340,92,33290,30986,44573,5,32,14,1,0,1,0,10,339,82,28740,28003,34992,1,1,10,4550,9,2983,9581,0,0,0,0,-1
EUW1_6878535421',4,29,17,0,0,0,0,12,1,347,76,29222,31020,30964,4,21,11,2,0,1,0,5,351,64,26316,27881,39809,1,-4,12,2906,6,3139,-8845,-2,0,-1,0,7
EUW1_6883597793',2,21,8,1,0,1,0,12,1,343,128,26520,30385,30581,5,28,15,0,0,2,0,2,367,68,29405,30734,29813,0,-24,60,-2885,-7,-349,768,1,0,-1,0,10
EUW1_6883573015',5,31,15,0,0,1,0,8,1,398,84,29873,30601,30511,4,29,13,2,0,0,0,6,396,102,29206,31308,26608,0,2,-18,667,2,-707,3903,-2,0,1,0,2
EUW1_6883415832',2,32,9,2,0,0,0,11,1,373,99,25479,30536,28952,7,30,10,0,0,1,0,2,399,104,27495,31999,27450,1,-26,-5,-2016,-1,-1463,1502,2,0,-1,0,9
EUW1_6883356625',3,23,14,1,0,1,0,6,0,378,106,28809,32618,31108,2,23,7,0,0,1,0,7,396,105,27095,30844,27615,1,-18,1,1714,7,1774,3493,1,0,0,0,-1
EUW1_6882990330',2,21,13,2,1,1,0,9,1,326,112,27525,29352,27504,4,23,7,0,0,0,0,6,297,88,23749,25982,29393,1,29,24,3776,6,3370,-1889,2,1,1,0,3
EUW1_6882071080',3,25,6,1,0,0,0,14,0,368,126,25423,31640,23276,3,22,10,1,1,3,0,5,390,106,28632,31760,27696,1,-22,20,-3209,-4,-120,-4420,0,-1,-3,0,9
EUW1_6881911094',3,111,15,0,0,0,0,9,1,361,64,28552,30952,35372,3,22,20,1,0,3,0,4,359,110,31831,34018,43373,1,2,-46,-3279,-5,-3066,-8001,-1,0,-3,0,5
EUW1_6881846989',3,61,13,1,1,2,0,6,1,383,83,30271,30955,34804,2,29,5,0,0,1,0,7,331,116,24690,29029,21810,0,52,-33,5581,8,1926,12994,1,1,1,0,-1
EUW1_6881784220',3,27,5,0,0,0,0,10,1,392,116,25854,31160,29070,4,30,13,2,0,1,0,5,354,92,27783,30777,34122,1,38,24,-1929,-8,383,-5052,-2,0,-1,0,5
EUW1_6881417022',4,95,10,1,0,0,0,12,1,381,108,27090,32849,18391,3,30,10,1,1,1,0,2,350,84,26834,29005,27406,0,31,24,256,0,3844,-9015,0,-1,-1,0,10
EUW1_6881374572',0,228,7,0,0,0,0,16,1,343,112,24512,29790,29707,5,30,18,2,0,3,0,2,413,84,32559,33583,36857,0,-70,28,-8047,-11,-3793,-7150,-2,0,-3,0,14
EUW1_6880674707',6,28,3,0,0,0,0,12,0,340,72,21861,26344,17612,3,25,17,1,0,3,0,4,350,113,31308,29368,40743,0,-10,-41,-9447,-14,-3024,-23131,-1,0,-3,0,8
EUW1_6880645798',4,26,13,1,0,1,0,16,0,305,104,26556,28991,32161,1,17,19,1,0,2,0,3,371,74,31471,29891,41853,0,-66,30,-4915,-6,-900,-9692,0,0,-1,0,13
EUW1_6880601853',4,28,8,1,0,1,0,5,1,405,108,26979,31326,44184,3,28,11,1,1,1,0,4,311,99,26152,31033,29681,1,94,9,827,-3,293,14503,0,-1,0,0,1
EUW1_6880230600',6,24,9,0,0,0,0,8,1,322,92,24557,28228,19835,8,32,13,1,0,1,0,2,404,88,27808,32701,31965,0,-82,4,-3251,-4,-4473,-12130,-1,0,-1,0,6
EUW1_6880091736',4,31,19,2,0,1,0,12,1,351,96,29677,31696,39448,7,30,10,0,0,1,0,3,349,92,26520,30221,33229,1,2,4,3157,9,1475,6219,2,0,0,0,9
EUW1_6868403140',0,22,8,0,0,1,0,10,0,307,89,25088,26676,25252,6,27,15,2,0,5,0,5,410,116,32380,32883,36046,0,-103,-27,-7292,-7,-6207,-10794,-2,0,-4,0,5
EUW1_6868237639',2,24,24,2,0,2,0,7,1,322,106,33410,30638,45229,5,93,16,0,0,0,0,6,282,70,27841,26997,37365,1,40,36,5569,8,3641,7864,2,0,2,0,1
EUW1_6868149573',4,22,8,0,0,0,0,8,1,337,78,24865,28433,30262,0,27,13,1,0,1,0,2,357,85,27175,29946,37462,1,-20,-7,-2310,-5,-1513,-7200,-1,0,-1,0,6
EUW1_6868079341',4,31,12,0,0,0,0,8,1,371,78,29069,30756,31694,2,80,14,1,0,0,0,5,400,93,28966,30918,34039,0,-29,-15,103,-2,-162,-2345,-1,0,0,0,3
EUW1_6868010399',4,37,7,0,0,0,0,11,1,381,70,25192,28541,26133,1,26,16,1,0,3,0,1,394,88,31007,33108,35608,0,-13,-18,-5815,-9,-4567,-9475,-1,0,-3,0,10
EUW1_6867281675',0,21,11,0,0,0,0,17,0,299,74,24787,27689,33656,0,24,23,2,0,3,0,2,344,105,34116,32579,48467,0,-45,-31,-9329,-12,-4890,-14811,-2,0,-3,0,15
EUW1_6867208285',1,29,14,2,0,1,0,8,1,333,96,28367,29046,41279,2,237,11,0,1,0,0,5,304,94,25398,27504,30810,0,29,2,2969,3,1542,10469,2,-1,1,0,3
EUW1_6867096994',1,25,18,2,1,1,0,6,1,355,132,29490,33443,40408,2,29,7,0,0,1,0,6,324,56,24177,26371,31971,1,31,76,5313,11,7072,8437,2,1,0,0,0
EUW1_6867016194',1,22,16,0,0,1,0,13,0,362,74,29527,30867,45835,1,24,14,1,0,1,0,4,345,101,28807,29324,32242,0,17,-27,720,2,1543,13593,-1,0,0,0,9
EUW1_6866972583',2,54,5,1,0,0,0,7,0,384,108,24928,31027,25455,2,23,13,1,0,1,0,4,416,104,28458,33301,30098,0,-32,4,-3530,-8,-2274,-4643,0,0,-1,0,3
EUW1_6866900693',2,25,11,1,0,2,0,9,0,380,92,29256,31258,33391,6,26,21,1,0,1,0,6,361,88,32177,31529,43557,1,19,4,-2921,-10,-271,-10166,0,0,1,0,3
EUW1_6866839235',2,24,11,0,0,0,0,13,0,311,91,26450,26825,32185,4,30,27,1,0,2,0,2,357,91,35157,32483,39177,0,-46,0,-8707,-16,-5658,-6992,-1,0,-2,0,11
EUW1_6866784397',4,68,14,1,0,0,0,8,0,338,95,29875,30425,28868,3,348,13,0,0,1,0,5,354,91,27958,28514,34878,1,-16,4,1917,1,1911,-6010,1,0,-1,0,3
EUW1_6866577089',3,22,15,0,0,0,0,10,0,334,106,28709,31382,27311,5,29,11,1,0,1,0,3,376,76,27006,28895,35050,1,-42,30,1703,4,2487,-7739,-1,0,-1,0,7
EUW1_6866526318',2,24,12,2,0,2,0,3,1,399,100,29316,31795,34926,2,25,6,0,0,0,0,11,340,84,24083,28357,20877,1,59,16,5233,6,3438,14049,2,0,2,0,-8
EUW1_6866445093',4,25,8,0,0,0,0,9,0,308,78,23595,27638,30169,4,21,16,2,1,3,0,0,345,92,30587,30784,45416,0,-37,-14,-6992,-8,-3146,-15247,-2,-1,-3,0,9
EUW1_6866401435',1,25,11,0,0,1,0,8,1,359,108,28395,31029,28754,4,40,14,2,0,2,0,4,384,63,26972,29761,30738,0,-25,45,1423,-3,1268,-1984,-2,0,-1,0,4
EUW1_6866353785',3,20,7,0,0,0,0,11,1,360,88,24660,29681,25296,4,21,21,2,0,2,0,3,362,115,32054,34049,38058,0,-2,-27,-7394,-14,-4368,-12762,-2,0,-2,0,8
EUW1_6883546431',0,27,4,0,1,0,0,8,0,386,116,24592,30507,22978,3,42,9,2,0,1,0,0,431,107,28285,32279,27390,0,-45,9,-3693,-5,-1772,-4412,-2,1,-1,0,8
EUW1_6883485530',4,31,17,2,0,0,0,7,1,368,84,28944,30130,29418,2,28,9,0,0,0,0,4,340,92,25713,27153,31180,1,28,-8,3231,8,2977,-1762,2,0,0,0,3
EUW1_6883327440',4,87,19,1,0,0,0,10,0,336,84,28572,29575,35011,4,42,14,1,0,0,0,3,343,112,29120,30230,33325,1,-7,-28,-548,5,-655,1686,0,0,0,0,7
EUW1_6883256315',2,27,3,0,0,0,0,9,0,380,84,23402,30446,18887,3,28,10,2,0,0,0,0,433,116,27095,32768,26207,0,-53,-32,-3693,-7,-2322,-7320,-2,0,0,0,9
EUW1_6882956564',5,33,14,0,0,0,0,15,1,336,73,28041,28341,32321,4,28,15,1,0,2,0,3,404,102,31600,33015,33829,0,-68,-29,-3559,-1,-4674,-1508,-1,0,-2,0,12
EUW1_6882880407',3,30,18,0,0,1,0,11,0,344,77,29048,28450,36294,4,25,13,2,0,1,0,4,347,74,28734,29148,33171,1,-3,3,314,5,-698,3123,-2,0,0,0,7
EUW1_6882548118',7,34,15,0,1,1,0,7,1,366,91,29993,32557,32104,5,27,12,1,0,0,0,5,381,99,26724,30837,30472,0,-15,-8,3269,3,1720,1632,-1,1,1,0,2
EUW1_6882095707',3,47,12,2,0,0,0,12,1,382,110,27814,30918,30011,3,29,7,0,0,1,0,2,357,100,25369,28643,24799,1,25,10,2445,5,2275,5212,2,0,-1,0,10
EUW1_6882031358',7,34,6,0,0,0,0,11,1,348,82,24554,28311,26770,3,27,12,2,0,2,0,2,384,78,28765,29717,34011,0,-36,4,-4211,-6,-1406,-7241,-2,0,-2,0,9
EUW1_6881981477',0,22,11,1,0,1,0,13,1,338,70,25889,29771,30315,1,93,17,0,1,2,0,1,355,102,31538,32092,38197,1,-17,-32,-5649,-6,-2321,-7882,1,-1,-1,0,12
EUW1_6881929831',0,22,11,0,0,0,0,9,1,366,81,26565,30673,32363,2,97,13,1,0,0,0,3,356,102,27958,33769,40527,0,10,-21,-1393,-2,-3096,-8164,-1,0,0,0,6
EUW1_6881738788',4,28,12,2,0,1,0,13,0,368,88,27350,29040,30074,3,30,13,0,1,1,0,3,345,90,28369,29603,34404,0,23,-2,-1019,-1,-563,-4330,2,-1,0,0,10
EUW1_6881678380',4,27,10,0,0,1,0,6,1,424,92,28214,32368,29658,7,26,4,2,0,0,0,3,414,111,24556,30935,25280,0,10,-19,3658,6,1433,4378,-2,0,1,0,3
EUW1_6881632929',2,32,17,1,1,1,0,9,1,341,101,29208,29386,33066,3,24,12,0,0,1,0,6,364,90,28753,31653,27823,1,-23,11,455,5,-2267,5243,1,1,0,0,3
EUW1_6881566227',1,21,8,0,0,1,0,8,0,385,101,26142,32499,23396,6,57,8,1,0,1,0,3,401,91,26651,30379,32758,1,-16,10,-509,0,2120,-9362,-1,0,0,0,5
EUW1_6881497596',5,36,9,0,0,1,0,14,0,359,81,26314,31631,28808,2,29,14,1,0,1,0,0,407,111,29246,32490,29720,1,-48,-30,-2932,-5,-859,-912,-1,0,0,0,14
EUW1_6881424358',4,29,14,1,0,0,0,8,1,387,74,27308,30269,32129,6,34,6,1,0,1,0,1,402,97,26444,30326,28263,1,-15,-23,864,8,-57,3866,0,0,-1,0,7
EUW1_6879279742',3,29,10,0,0,0,0,9,1,376,100,27887,29787,31357,0,30,10,2,0,2,0,6,352,89,26002,30384,25671,0,24,11,1885,0,-597,5686,-2,0,-2,0,3
EUW1_6879253050',4,41,19,0,0,3,0,11,0,372,92,32163,30734,41932,1,23,13,1,0,1,0,9,335,96,28277,30157,31057,0,37,-4,3886,6,577,10875,-1,0,2,0,2
EUW1_6883574315',3,27,16,2,0,1,0,7,1,354,93,29723,29910,36603,1,43,16,0,0,0,0,7,336,74,29570,30942,32893,1,18,19,153,0,-1032,3710,2,0,1,0,0
EUW1_6883554074',4,26,16,2,0,0,0,10,0,367,78,27924,28974,35677,3,27,17,0,0,1,0,5,367,78,30393,31187,34129,0,0,0,-2469,-1,-2213,1548,2,0,-1,0,5
EUW1_6883534500',2,33,15,0,0,0,0,16,0,269,65,26795,24235,31893,5,33,18,2,0,3,0,3,385,84,32159,30221,44931,0,-116,-19,-5364,-3,-5986,-13038,-2,0,-3,0,13
EUW1_6883485406',2,27,19,2,1,2,0,8,1,331,76,30242,29496,33600,2,40,11,0,0,1,0,10,350,108,29813,29401,32795,1,-19,-32,429,8,95,805,2,1,1,0,-2
EUW1_6883443995',4,32,17,0,0,1,0,5,1,362,78,30088,30867,39320,5,33,8,2,0,0,0,3,377,102,25742,29368,35818,1,-15,-24,4346,9,1499,3502,-2,0,1,0,2
EUW1_6883116401',3,31,7,1,0,0,0,8,0,373,88,23940,28540,21314,4,20,13,1,1,1,0,2,402,103,29009,32804,39222,0,-29,-15,-5069,-6,-4264,-17908,0,-1,-1,0,6
EUW1_6883065584',5,39,10,0,0,0,0,10,1,360,94,27082,31473,32362,4,77,15,1,0,3,0,4,383,82,28561,32513,35026,1,-23,12,-1479,-5,-1040,-2664,-1,0,-3,0,6
EUW1_6881859280',3,32,12,0,0,0,0,10,0,378,72,26489,30764,36386,2,24,16,1,0,1,0,1,409,111,31097,31618,42978,0,-31,-39,-4608,-4,-854,-6592,-1,0,-1,0,9
EUW1_6881814517',3,43,16,2,0,2,0,4,1,376,72,29182,30770,34273,4,29,7,0,0,0,0,5,340,80,23161,26459,30267,1,36,-8,6021,9,4311,4006,2,0,2,0,-1
EUW1_6881734597',4,29,13,0,0,1,0,13,1,402,74,29884,31540,31370,4,26,13,1,0,2,0,3,367,82,27974,28214,29664,0,35,-8,1910,0,3326,1706,-1,0,-1,0,10
EUW1_6880594715',8,39,7,0,0,1,0,9,0,352,78,25385,29458,21790,6,65,13,2,0,1,0,4,369,104,27929,31739,35748,1,-17,-26,-2544,-6,-2281,-13958,-2,0,0,0,5
EUW1_6880560554',1,28,6,0,0,0,0,15,1,291,103,22817,25645,22614,3,23,11,2,1,4,0,2,400,86,30090,31561,25631,0,-109,17,-7273,-5,-5916,-3017,-2,-1,-4,0,13
EUW1_6880500305',3,33,8,0,0,0,0,12,1,333,87,25201,28091,27578,6,122,16,1,0,3,0,3,399,97,31768,33724,41018,0,-66,-10,-6567,-8,-5633,-13440,-1,0,-3,0,9
EUW1_6880458863',2,21,21,1,0,3,0,6,1,394,110,34321,32487,34024,4,30,9,0,0,0,0,11,361,68,25512,26389,22029,1,33,42,8809,12,6098,11995,1,0,3,0,-5
EUW1_6880410691',5,31,12,2,0,1,0,10,1,347,96,27643,28019,30241,6,79,16,0,0,1,0,2,327,108,28729,31491,33204,0,20,-12,-1086,-4,-3472,-2963,2,0,0,0,8
EUW1_6880358328',5,55,23,2,1,2,0,7,1,378,104,33661,31363,42188,2,29,12,0,0,0,0,7,360,80,27364,28072,32335,1,18,24,6297,11,3291,9853,2,1,2,0,0
EUW1_6880181625',4,30,18,0,0,1,0,6,1,333,71,30183,29890,40496,4,22,16,2,0,1,0,7,304,86,27988,29118,38552,0,29,-15,2195,2,772,1944,-2,0,0,0,-1
EUW1_6881452800',7,29,18,0,0,0,0,5,1,384,106,30780,32437,38007,4,34,15,1,0,0,0,5,343,94,29077,29469,35238,1,41,12,1703,3,2968,2769,-1,0,0,0,0
EUW1_6881244578',4,221,16,1,0,2,0,11,1,383,100,31294,31602,35830,4,23,18,1,0,1,0,8,356,76,30598,31958,34266,1,27,24,696,-2,-356,1564,0,0,1,0,3
EUW1_6881147758',2,25,9,0,0,0,0,11,1,338,84,23953,27275,29932,3,43,20,2,0,3,0,0,344,111,31565,32346,40830,0,-6,-27,-7612,-11,-5071,-10898,-2,0,-3,0,11
EUW1_6879925247',4,26,20,2,0,2,0,7,0,363,74,31827,31240,36731,4,23,11,0,0,1,0,3,299,75,26031,26105,29438,1,64,-1,5796,9,5135,7293,2,0,1,0,4
EUW1_6879719934',5,27,4,0,1,1,0,11,0,382,97,25880,29845,31709,2,58,13,1,0,1,0,5,405,97,28601,33148,36492,0,-23,0,-2721,-9,-3303,-4783,-1,1,0,0,6
EUW1_6879672275',5,25,14,0,0,0,0,16,0,321,80,27371,27365,32673,4,29,21,1,1,1,0,1,351,84,32069,30512,42486,0,-30,-4,-4698,-7,-3147,-9813,-1,-1,-1,0,15
EUW1_6878701662',4,27,8,1,1,0,0,7,0,346,66,25335,27879,31581,3,33,13,1,0,1,0,4,360,86,27024,29047,34066,0,-14,-20,-1689,-5,-1168,-2485,0,1,-1,0,3
EUW1_6878663604',1,26,2,0,0,0,0,9,0,332,92,21265,26060,26883,3,26,18,2,0,1,0,1,394,96,30204,33526,38400,0,-62,-4,-8939,-16,-7466,-11517,-2,0,-1,0,8
EUW1_6878434965',5,31,7,1,1,0,0,11,0,386,102,25510,29013,20837,3,30,13,1,0,2,0,4,380,70,28924,30227,33213,1,6,32,-3414,-6,-1214,-12376,0,1,-2,0,7
EUW1_6878373243',6,23,7,1,0,0,0,6,1,378,80,24983,29839,23065,3,42,9,0,0,1,0,3,432,92,27011,31622,28654,0,-54,-12,-2028,-2,-1783,-5589,1,0,-1,0,3
EUW1_6878321352',3,29,13,0,0,1,0,9,1,401,79,28379,29937,30054,4,36,9,2,0,0,0,5,347,87,25831,28768,28686,0,54,-8,2548,4,1169,1368,-2,0,1,0,4
EUW1_6877324852',2,29,11,0,0,1,0,12,0,334,63,26654,28348,25287,7,30,12,2,0,2,0,3,419,120,29935,32120,33562,0,-85,-57,-3281,-1,-3772,-8275,-2,0,-1,0,9
EUW1_6877238900',4,143,24,0,0,1,0,7,1,355,66,32918,30800,41611,4,18,12,0,0,1,0,5,316,90,26938,28181,31660,1,39,-24,5980,12,2619,9951,0,0,0,0,2
EUW1_6883582164',2,28,16,2,0,3,0,12,0,352,72,32070,29752,36308,6,29,13,0,0,0,0,10,301,76,27284,26991,35470,1,51,-4,4786,3,2761,838,2,0,3,0,2
EUW1_6883562769',12,37,22,1,1,1,0,7,1,357,77,31852,29448,34760,2,22,3,0,0,0,0,5,314,70,21362,23158,24159,1,43,7,10490,19,6290,10601,1,1,1,0,2
EUW1_6883522631',6,25,9,0,0,2,0,7,0,370,82,26864,29409,25839,3,83,14,1,0,0,0,3,405,94,27982,31469,35731,0,-35,-12,-1118,-5,-2060,-9892,-1,0,2,0,4
EUW1_6883289476',1,23,7,0,0,0,0,8,0,357,92,24252,29241,22229,3,30,12,2,0,1,0,1,396,100,28355,31736,36815,0,-39,-8,-4103,-5,-2495,-14586,-2,0,-1,0,7
EUW1_6883065870',6,34,12,2,0,2,0,11,0,373,95,28131,29367,38250,5,35,13,0,0,1,0,5,372,96,28695,30593,31608,1,1,-1,-564,-1,-1226,6642,2,0,1,0,6
EUW1_6883008149',8,73,8,0,0,0,0,12,0,346,90,25740,28786,27079,2,60,19,2,0,1,0,5,371,73,29754,31966,38869,0,-25,17,-4014,-11,-3180,-11790,-2,0,-1,0,7
EUW1_6882713053',3,35,13,0,0,0,0,15,0,335,61,26163,26699,29098,7,32,21,1,0,2,0,2,378,86,32068,31232,27561,0,-43,-25,-5905,-8,-4533,1537,-1,0,-2,0,13
EUW1_6882642876',7,27,18,1,0,1,0,5,0,338,87,29645,29802,35476,4,22,11,1,0,1,0,7,333,81,26362,28150,30240,0,5,6,3283,7,1652,5236,0,0,0,0,-2
EUW1_6882618943',7,61,17,1,0,2,0,5,1,409,87,31852,32577,35359,3,27,9,1,0,1,0,6,365,76,25361,27532,27712,1,44,11,6491,8,5045,7647,0,0,1,0,-1
EUW1_6882275008',3,25,14,0,0,0,0,11,1,349,88,28205,28576,30949,4,31,21,1,0,2,0,2,390,75,31382,30185,46869,0,-41,13,-3177,-7,-1609,-15920,-1,0,-2,0,9
EUW1_6881277732',4,27,12,1,0,0,0,4,0,357,95,26494,28846,25041,6,31,8,1,0,0,0,0,345,84,25494,26560,28479,0,12,11,1000,4,2286,-3438,0,0,0,0,4
EUW1_6880718499',7,36,5,0,0,0,0,4,1,383,81,24507,28631,27559,6,32,12,1,0,0,0,2,376,101,28173,30437,30141,0,7,-20,-3666,-7,-1806,-2582,-1,0,0,0,2
EUW1_6879687804',3,24,13,0,0,0,0,8,0,294,73,27767,25544,40427,4,30,25,2,0,2,0,3,316,85,32445,30038,47675,0,-22,-12,-4678,-12,-4494,-7248,-2,0,-2,0,5
EUW1_6879636929',5,28,8,0,0,0,0,12,0,344,98,25090,28800,24675,11,49,17,2,0,2,0,1,371,102,30417,32606,30104,0,-27,-4,-5327,-9,-3806,-5429,-2,0,-2,0,11
EUW1_6879258458',4,61,27,1,1,3,0,10,1,369,87,35891,31613,46069,4,32,13,1,0,0,0,7,337,84,28442,30051,33462,1,32,3,7449,14,1562,12607,0,1,3,0,3
EUW1_6878279132',8,28,12,0,0,1,0,11,1,360,94,28137,28858,31093,1,29,17,2,1,2,0,3,351,97,31223,29687,32724,1,9,-3,-3086,-5,-829,-1631,-2,-1,-1,0,8
EUW1_6878228539',5,29,14,1,0,1,0,6,1,363,82,28725,27615,26273,5,30,7,0,0,0,0,4,331,72,24406,25299,23163,1,32,10,4319,7,2316,3110,1,0,1,0,2
EUW1_6877200147',5,71,18,0,0,1,0,9,1,387,86,30733,30967,43026,2,25,16,2,0,0,0,7,319,82,27193,29864,40943,0,68,4,3540,2,1103,2083,-2,0,1,0,2
EUW1_6883494528',6,33,17,0,0,2,0,15,0,376,69,31089,30722,34712,7,28,14,2,0,2,0,4,367,94,29994,30075,31636,0,9,-25,1095,3,647,3076,-2,0,0,0,11
EUW1_6883318275',2,37,4,0,0,0,0,12,1,378,108,24156,28956,17264,5,31,12,2,1,2,0,1,428,96,30439,31760,25650,0,-50,12,-6283,-8,-2804,-8386,-2,-1,-2,0,11
EUW1_6883232771',2,37,9,0,1,1,0,9,0,353,78,26518,29494,32888,7,31,11,2,0,0,0,4,384,93,27062,29374,33472,0,-31,-15,-544,-2,120,-584,-2,1,1,0,5
EUW1_6882869424',0,123,19,0,0,0,0,9,0,337,67,30771,29841,38916,3,28,24,2,0,3,0,10,380,104,33909,33118,41736,0,-43,-37,-3138,-5,-3277,-2820,-2,0,-3,0,-1
EUW1_6882202226',0,20,3,0,0,0,0,16,0,264,74,21246,22726,20769,7,31,30,2,0,7,0,2,382,92,37403,33675,42539,0,-118,-18,-16157,-27,-10949,-21770,-2,0,-7,0,14
EUW1_6882175793',6,48,13,0,0,1,0,18,0,330,74,27046,28669,30341,5,64,11,2,0,2,0,2,380,76,28570,29025,32953,0,-50,-2,-1524,2,-356,-2612,-2,0,-1,0,16
EUW1_6881822355',8,61,16,0,0,1,0,9,0,372,72,31384,29469,35896,7,103,23,1,0,1,0,8,374,87,32464,32150,45211,1,-2,-15,-1080,-7,-2681,-9315,-1,0,0,0,1
EUW1_6881737169',3,50,8,1,0,0,0,5,1,362,95,25236,30135,25262,3,47,10,0,0,0,0,1,392,86,26364,31164,27943,1,-30,9,-1128,-2,-1029,-2681,1,0,0,0,4
EUW1_6881601333',5,29,8,2,0,0,0,7,1,375,64,25345,28395,30583,4,37,10,0,0,0,0,4,388,103,27160,31343,25081,0,-13,-39,-1815,-2,-2948,5502,2,0,0,0,3
EUW1_6880671241',5,28,13,1,0,0,0,11,0,353,99,27670,30003,30850,6,43,12,1,0,2,0,4,377,108,29207,31093,34863,0,-24,-9,-1537,1,-1090,-4013,0,0,-2,0,7
EUW1_6880642364',5,26,14,0,0,0,0,13,0,354,92,25934,29760,30419,3,32,14,2,1,2,0,1,395,96,30679,31775,37452,0,-41,-4,-4745,0,-2015,-7033,-2,-1,-2,0,12
EUW1_6880609857',4,24,9,1,0,0,0,12,1,383,79,26513,29384,29007,3,24,15,1,0,1,0,4,355,100,29248,30619,32635,0,28,-21,-2735,-6,-1235,-3628,0,0,-1,0,8
EUW1_6880546757',6,38,16,1,0,0,0,6,1,354,102,30526,29276,34840,6,27,14,1,0,1,0,3,327,54,27725,26115,30595,1,27,48,2801,2,3161,4245,0,0,-1,0,3
EUW1_6879063566',4,28,12,0,0,1,0,9,0,407,110,28553,31340,30043,4,42,13,2,0,0,0,4,384,64,27985,29870,28115,0,23,46,568,-1,1470,1928,-2,0,1,0,5
EUW1_6878989656',7,29,12,1,0,0,0,13,1,330,73,26498,26966,32105,5,27,16,1,0,1,0,2,372,100,30450,31423,39583,1,-42,-27,-3952,-4,-4457,-7478,0,0,-1,0,11
EUW1_6882576965',3,30,14,1,0,0,0,8,1,358,94,27912,31382,26011,3,27,7,1,0,1,0,1,441,94,27152,30236,32746,1,-83,0,760,7,1146,-6735,0,0,-1,0,7
EUW1_6880908543',3,31,15,1,0,0,0,3,1,388,107,29202,32385,35748,3,32,9,1,0,1,0,4,372,84,27358,28839,30909,0,16,23,1844,6,3546,4839,0,0,-1,0,-1
EUW1_6880041266',4,34,5,0,0,0,0,5,1,400,115,26405,30882,22674,6,33,5,1,0,0,0,4,370,78,22957,28676,14898,1,30,37,3448,0,2206,7776,-1,0,0,0,1
EUW1_6876801207',4,27,6,0,0,0,0,13,0,291,73,22782,24496,24008,6,21,23,1,0,3,0,0,401,82,36391,30322,46604,0,-110,-9,-13609,-17,-5826,-22596,-1,0,-3,0,13
EUW1_6876750419',13,34,10,2,0,0,0,4,1,378,85,25624,30051,31723,1,179,6,0,0,0,0,2,362,107,25015,29900,28167,1,16,-22,609,4,151,3556,2,0,0,0,2
EUW1_6875613663',2,63,8,0,0,0,0,9,0,389,82,25907,30732,28884,3,59,9,2,0,1,0,5,389,93,26463,29395,29862,1,0,-11,-556,-1,1337,-978,-2,0,-1,0,4
EUW1_6875562204',7,32,29,1,0,0,0,9,0,363,107,35713,33998,47503,2,30,9,0,0,2,0,4,312,70,26359,25928,30051,1,51,37,9354,20,8070,17452,1,0,-2,0,5
EUW1_6875534121',4,25,26,2,1,3,0,7,1,383,108,35841,33345,41713,4,32,8,0,0,0,0,12,337,87,26219,27809,26150,1,46,21,9622,18,5536,15563,2,1,3,0,-5
EUW1_6871849558',2,27,16,1,0,1,0,7,1,392,78,30731,31488,37121,5,29,13,0,0,1,0,7,308,88,26712,28228,33898,1,84,-10,4019,3,3260,3223,1,0,0,0,0
EUW1_6871779392',4,31,10,0,0,1,0,14,0,358,81,27189,29004,26909,4,27,15,1,1,1,0,3,383,92,29756,30684,31269,0,-25,-11,-2567,-5,-1680,-4360,-1,-1,0,0,11
EUW1_6871708638',1,29,10,1,0,0,0,9,0,355,92,25908,28935,27582,4,53,14,1,0,1,0,3,373,88,28583,29812,35687,0,-18,4,-2675,-4,-877,-8105,0,0,-1,0,6
EUW1_6871645978',3,60,16,0,0,0,0,15,0,312,73,27011,28378,38927,3,65,17,1,0,2,0,1,372,84,31044,29374,34123,0,-60,-11,-4033,-1,-996,4804,-1,0,-2,0,14
EUW1_6871596329',5,25,15,0,0,0,0,10,1,361,92,29641,30648,33757,5,24,15,2,0,1,0,5,355,107,30488,32468,32532,1,6,-15,-847,0,-1820,1225,-2,0,-1,0,5
EUW1_6871448997',2,21,10,0,0,0,0,11,1,320,106,26155,29553,26191,3,23,15,2,0,2,0,2,387,108,30601,30960,40119,0,-67,-2,-4446,-5,-1407,-13928,-2,0,-2,0,9
EUW1_6868126113',3,26,20,1,0,0,0,9,1,342,74,29834,30050,40530,5,32,20,1,0,1,0,3,343,104,31424,30068,41367,0,-1,-30,-1590,0,-18,-837,0,0,-1,0,6
EUW1_6882255808',8,29,12,0,1,0,0,9,0,318,80,26379,29612,33554,1,370,9,2,0,1,0,5,357,70,26216,27385,31497,1,-39,10,163,3,2227,2057,-2,1,-1,0,4
EUW1_6882241467',3,34,10,0,0,0,0,9,0,298,76,23954,26325,36923,2,23,15,1,0,2,0,0,368,89,30058,31464,41073,0,-70,-13,-6104,-5,-5139,-4150,-1,0,-2,0,9
EUW1_6882215983',1,42,14,0,0,0,0,8,0,326,75,27330,27918,31086,2,25,11,2,0,0,0,1,386,84,27008,28858,30077,0,-60,-9,322,3,-940,1009,-2,0,0,0,7
EUW1_6882116786',4,37,7,1,0,0,0,8,1,398,85,25534,27788,26408,4,30,8,1,1,1,0,6,396,96,27370,31999,21864,0,2,-11,-1836,-1,-4211,4544,0,-1,-1,0,2
EUW1_6880726422',6,38,13,0,0,1,0,9,0,337,96,28423,27453,29124,4,142,19,2,1,2,0,2,400,83,32115,31184,35414,0,-63,13,-3692,-6,-3731,-6290,-2,-1,-1,0,7
EUW1_6880665372',5,29,8,1,0,1,0,5,1,407,102,28325,30615,27000,6,43,8,1,0,1,0,8,341,102,25536,29171,28342,0,66,0,2789,0,1444,-1342,0,0,0,0,-3
EUW1_6880631349',3,24,13,0,0,0,0,11,1,337,100,28007,31803,33837,6,31,13,1,0,1,0,5,401,88,28458,30062,30877,0,-64,12,-451,0,1741,2960,-1,0,-1,0,6
EUW1_6880602957',2,66,4,0,0,0,0,12,1,336,93,23535,27406,24277,5,31,13,2,0,2,0,1,412,101,29700,31941,31648,0,-76,-8,-6165,-9,-4535,-7371,-2,0,-2,0,11
EUW1_6880551056',2,24,15,1,0,2,0,6,0,328,98,29724,29773,30768,6,29,8,0,0,0,0,4,361,82,24306,29083,27639,1,-33,16,5418,7,690,3129,1,0,2,0,2
EUW1_6880503475',3,25,14,2,0,2,0,4,0,373,94,28747,30905,33955,3,29,9,0,0,0,0,7,331,98,25355,27727,27440,1,42,-4,3392,5,3178,6515,2,0,2,0,-3
EUW1_6879279827',4,37,14,0,0,0,0,12,1,367,76,27345,29498,27435,3,21,8,1,0,0,0,1,378,88,26178,28695,26665,1,-11,-12,1167,6,803,770,-1,0,0,0,11
EUW1_6880131430',2,22,11,0,0,0,0,9,1,376,86,26918,30375,32462,3,26,10,2,0,1,0,2,377,104,27235,30634,36128,0,-1,-18,-317,1,-259,-3666,-2,0,-1,0,7
EUW1_6878479838',3,35,11,2,0,0,0,11,1,373,96,28267,30959,29112,4,30,10,0,0,2,0,3,382,91,27208,29567,33601,1,-9,5,1059,1,1392,-4489,2,0,-2,0,8
EUW1_6877399756',2,21,6,0,0,1,0,7,0,368,76,25863,28975,35653,5,31,10,2,0,0,0,4,362,92,26673,28950,33041,0,6,-16,-810,-4,25,2612,-2,0,1,0,3
EUW1_6877322393',2,22,9,0,0,1,0,11,0,351,99,28864,29236,32761,3,24,14,1,0,0,0,5,339,100,28183,30047,35838,1,12,-1,681,-5,-811,-3077,-1,0,1,0,6
EUW1_6877270001',3,30,18,1,0,1,0,9,0,342,84,32322,29894,37047,4,26,15,1,0,0,0,8,356,76,27108,27115,29176,1,-14,8,5214,3,2779,7871,0,0,1,0,1
EUW1_6877048201',4,25,9,2,0,0,0,7,0,365,88,25262,28245,29558,2,33,8,0,0,1,0,3,382,94,26305,29778,27710,1,-17,-6,-1043,1,-1533,1848,2,0,-1,0,4
EUW1_6876713242',6,19,13,0,0,0,0,8,0,336,72,26985,28803,31606,3,59,15,1,0,0,0,0,386,80,27818,30861,32140,0,-50,-8,-833,-2,-2058,-534,-1,0,0,0,8
EUW1_6876634659',3,31,8,0,0,2,0,9,1,381,108,27664,30923,26454,0,23,12,2,1,1,0,4,409,87,28471,30912,30985,1,-28,21,-807,-4,11,-4531,-2,-1,1,0,5
EUW1_6876587314',4,23,10,1,1,0,0,9,0,370,109,26931,31245,28394,6,29,11,1,0,1,0,3,391,93,27912,29397,29397,1,-21,16,-981,-1,1848,-1003,0,1,-1,0,6
EUW1_6876056432',6,33,23,0,1,3,0,8,1,376,96,34940,34188,41350,4,33,12,1,0,0,0,9,343,95,27984,30039,33332,1,33,1,6956,11,4149,8018,-1,1,3,0,-1
EUW1_6875999850',3,30,13,0,0,0,0,6,0,337,93,27498,27581,31378,2,43,14,1,0,1,0,1,357,66,27419,27905,30154,0,-20,27,79,-1,-324,1224,-1,0,-1,0,5
EUW1_6875957535',2,23,10,1,0,0,0,19,0,356,88,26068,27461,33235,6,28,25,1,1,4,0,2,382,86,36469,34822,44915,0,-26,2,-10401,-15,-7361,-11680,0,-1,-4,0,17
EUW1_6874506087',7,30,13,0,0,0,0,9,1,332,73,27678,28142,40507,5,25,17,1,0,2,0,8,372,86,31384,30996,43066,0,-40,-13,-3706,-4,-2854,-2559,-1,0,-2,0,1
EUW1_6874461258',4,33,14,2,0,1,0,12,1,355,111,30142,31880,50629,3,27,9,0,0,1,0,6,330,81,24403,28215,24513,1,25,30,5739,5,3665,26116,2,0,0,0,6
EUW1_6874311348',5,29,9,0,0,1,0,9,0,404,114,27925,29984,26854,5,48,19,1,0,0,0,7,339,82,29388,30423,41284,1,65,32,-1463,-10,-439,-14430,-1,0,1,0,2
EUW1_6882965115',2,37,5,0,0,1,0,9,0,330,84,24043,26908,28626,2,66,21,1,0,0,0,4,389,88,30181,31873,37874,0,-59,-4,-6138,-16,-4965,-9248,-1,0,1,0,5
EUW1_6882919536',2,76,11,0,0,1,0,6,0,307,74,25734,25671,31866,3,23,11,2,0,0,0,5,312,82,25300,26112,28316,0,-5,-8,434,0,-441,3550,-2,0,1,0,1
EUW1_6882745848',0,25,8,0,0,0,0,9,0,369,75,25683,28612,30816,6,32,19,1,0,1,0,3,348,84,29778,30121,32418,0,21,-9,-4095,-11,-1509,-1602,-1,0,-1,0,6
EUW1_6882687505',2,82,9,0,0,0,0,7,1,342,91,26384,29659,33221,0,64,13,2,0,1,0,5,362,92,28565,31239,35786,1,-20,-1,-2181,-4,-1580,-2565,-2,0,-1,0,2
EUW1_6882487603',3,65,6,1,0,0,0,13,0,323,100,23864,27487,25102,5,59,18,1,0,1,0,1,392,107,30844,33214,34677,0,-69,-7,-6980,-12,-5727,-9575,0,0,-1,0,12
EUW1_6881860394',3,23,16,1,0,0,0,11,0,339,80,28477,29548,39003,3,78,16,1,0,1,0,6,375,92,30293,30486,31207,1,-36,-12,-1816,0,-938,7796,0,0,-1,0,5
EUW1_6881606691',5,28,13,0,0,1,0,6,0,369,83,28107,31182,32063,5,50,10,1,0,0,0,6,354,79,26409,28800,30529,0,15,4,1698,3,2382,1534,-1,0,1,0,0
EUW1_6881564495',5,72,10,1,0,0,0,10,0,349,77,25486,29022,27664,5,60,17,1,1,1,0,0,367,82,29488,32322,37330,0,-18,-5,-4002,-7,-3300,-9666,0,-1,-1,0,10
EUW1_6881493053',7,35,18,0,0,2,0,9,1,363,89,30890,30265,33180,2,23,10,1,0,0,0,4,346,88,26614,28972,27408,1,17,1,4276,8,1293,5772,-1,0,2,0,5
EUW1_6881301037',2,23,12,1,0,0,0,10,0,372,94,27353,29723,28805,10,31,14,0,0,2,0,5,366,94,29581,28610,33493,0,6,0,-2228,-2,1113,-4688,1,0,-2,0,5
EUW1_6881246812',4,44,8,2,1,0,0,10,0,327,105,25672,28637,29063,6,30,16,0,0,1,0,2,412,72,29495,30963,37810,0,-85,33,-3823,-8,-2326,-8747,2,1,-1,0,8
EUW1_6881182425',6,25,11,1,1,0,0,9,1,353,79,26275,29245,30528,1,60,4,0,0,0,0,5,391,92,25983,29795,22541,1,-38,-13,292,7,-550,7987,1,1,0,0,4
EUW1_6881148638',1,26,16,0,0,2,0,8,0,297,77,29536,27231,35599,2,70,24,1,0,1,0,7,297,58,28757,26842,31834,0,0,19,779,-8,389,3765,-1,0,1,0,1
EUW1_6878394112',2,26,13,0,0,1,0,12,1,308,62,27125,25813,26181,2,34,21,2,0,2,0,7,315,106,31701,28500,39355,0,-7,-44,-4576,-8,-2687,-13174,-2,0,-1,0,5
EUW1_6878366466',2,27,14,2,0,1,0,7,1,387,112,29592,33442,38185,5,22,6,0,0,1,0,4,297,86,22828,26368,26293,1,90,26,6764,8,7074,11892,2,0,0,0,3
EUW1_6883527178',6,27,10,0,0,0,0,7,0,419,105,28825,32772,29431,3,36,4,1,0,1,0,5,339,97,22566,29174,17561,1,80,8,6259,6,3598,11870,-1,0,-1,0,2
EUW1_6883454764',3,19,4,0,0,1,0,8,0,394,98,25914,28522,18629,3,26,5,1,0,1,0,7,384,92,24093,28267,28540,1,10,6,1821,-1,255,-9911,-1,0,0,0,1
EUW1_6883275779',5,37,21,1,0,1,0,14,1,315,99,30754,30407,36544,7,60,9,1,0,1,0,5,318,88,27300,27082,33430,1,-3,11,3454,12,3325,3114,0,0,0,0,9
EUW1_6883195602',3,67,9,0,0,0,0,7,1,368,104,26277,29138,22696,5,67,10,2,0,1,0,4,391,115,28190,30966,33657,1,-23,-11,-1913,-1,-1828,-10961,-2,0,-1,0,3
EUW1_6883149164',0,26,11,0,0,0,0,18,0,301,86,26246,25442,25422,2,28,17,1,0,3,0,0,377,105,32236,32002,32934,0,-76,-19,-5990,-6,-6560,-7512,-1,0,-3,0,18
EUW1_6882911754',5,145,14,2,0,1,0,9,1,385,122,30272,30479,30914,3,28,17,0,0,1,0,3,348,77,30557,29712,30669,1,37,45,-285,-3,767,245,2,0,0,0,6
EUW1_6882805563',10,36,13,0,0,0,0,10,0,299,71,26972,28051,31405,3,38,16,1,0,1,0,3,308,77,28578,27665,33486,1,-9,-6,-1606,-3,386,-2081,-1,0,-1,0,7
EUW1_6882702846',2,31,5,0,0,0,0,9,1,332,88,23562,26566,22975,3,37,18,1,0,2,0,2,375,74,29631,30428,44463,0,-43,14,-6069,-13,-3862,-21488,-1,0,-2,0,7
EUW1_6882649385',7,26,12,2,0,1,0,11,0,378,90,27971,29775,29436,5,25,14,0,1,1,0,3,393,70,30256,30760,34943,1,-15,20,-2285,-2,-985,-5507,2,-1,0,0,8
EUW1_6882046416',2,127,10,1,0,0,0,8,0,365,79,26562,29016,35113,3,27,15,0,0,0,0,1,320,76,27670,28069,38425,1,45,3,-1108,-5,947,-3312,1,0,0,0,7
EUW1_6881915039',5,53,18,1,1,0,0,6,0,363,84,29158,32128,31031,4,27,7,0,0,1,0,3,382,100,25423,27197,26112,1,-19,-16,3735,11,4931,4919,1,1,-1,0,3
EUW1_6881691150',6,31,4,0,0,0,0,6,0,388,86,23496,27127,20565,3,27,6,2,0,0,0,1,430,94,26333,30473,25132,1,-42,-8,-2837,-2,-3346,-4567,-2,0,0,0,5
EUW1_6881574324',4,23,14,1,0,0,0,10,0,369,78,28206,29533,32336,6,29,14,0,0,2,0,4,384,90,28675,29841,34211,1,-15,-12,-469,0,-308,-1875,1,0,-2,0,6
EUW1_6881471732',3,49,11,0,0,1,0,10,0,327,71,27168,25809,35688,4,33,16,1,0,1,0,3,313,78,28484,29164,34044,0,14,-7,-1316,-5,-3355,1644,-1,0,0,0,7
EUW1_6881170880',2,25,6,0,0,0,0,15,0,349,64,24048,28169,26452,2,23,23,2,1,2,0,1,406,148,34232,36379,40928,0,-57,-84,-10184,-17,-8210,-14476,-2,-1,-2,0,14
EUW1_6881108829',5,36,5,0,0,0,0,13,1,319,84,23290,24691,24754,10,39,18,2,0,2,0,3,296,87,28270,28327,33952,0,23,-3,-4980,-13,-3636,-9198,-2,0,-2,0,10
EUW1_6881023489',5,27,2,1,0,0,0,13,1,351,102,22025,27914,19948,3,26,13,1,1,2,0,0,428,94,30173,34184,28493,0,-77,8,-8148,-11,-6270,-8545,0,-1,-2,0,13
EUW1_6880586956',4,27,5,1,0,0,0,8,0,402,95,24437,28345,22910,2,38,10,0,0,0,0,1,374,76,26436,29164,27328,0,28,19,-1999,-5,-819,-4418,1,0,0,0,7
EUW1_6873366888',4,28,20,1,0,1,0,12,0,385,98,32576,31564,39889,0,37,13,0,0,0,0,2,326,83,26363,27083,32710,1,59,15,6213,7,4481,7179,1,0,1,0,10
EUW1_6873074593',2,25,19,1,0,1,0,7,0,343,107,31448,30451,35661,4,39,14,1,0,1,0,8,322,100,27107,28446,32926,1,21,7,4341,5,2005,2735,0,0,0,0,-1
EUW1_6872556291',1,24,13,0,0,0,0,12,0,318,84,26765,28225,29969,5,32,13,2,1,2,0,1,389,111,32039,31734,36287,0,-71,-27,-5274,0,-3509,-6318,-2,-1,-2,0,11
EUW1_6872532289',7,30,14,1,1,1,0,5,1,390,102,30763,32481,38286,4,22,5,0,0,0,0,6,340,90,22399,27629,25390,1,50,12,8364,9,4852,12896,1,1,1,0,-1
EUW1_6868223103',6,28,12,1,1,1,0,7,1,395,106,29330,32964,27621,0,23,3,1,0,0,0,4,377,111,23769,29802,25597,1,18,-5,5561,9,3162,2024,0,1,1,0,3
EUW1_6868163300',6,32,26,1,0,5,0,8,1,390,56,35714,32447,48632,3,54,15,1,0,1,0,8,295,92,26896,28295,39837,1,95,-36,8818,11,4152,8795,0,0,4,0,0
EUW1_6868106104',7,30,20,1,0,2,0,8,0,370,107,33952,32516,44149,3,24,14,1,0,0,0,9,318,104,27218,31165,34463,1,52,3,6734,6,1351,9686,0,0,2,0,-1
EUW1_6868056281',3,33,11,1,1,2,0,5,1,396,93,28717,31269,33625,4,32,7,1,0,0,0,6,355,97,24158,28041,32550,1,41,-4,4559,4,3228,1075,0,1,2,0,-1
EUW1_6882710566',3,32,16,2,0,0,0,8,0,366,84,29548,29178,35786,5,30,16,0,0,0,0,4,344,104,28430,29482,39650,0,22,-20,1118,0,-304,-3864,2,0,0,0,4
EUW1_6882671601',4,33,17,2,0,2,0,7,1,371,100,31789,32407,43646,5,141,10,0,0,2,0,9,342,92,26280,27980,34600,1,29,8,5509,7,4427,9046,2,0,0,0,-2
EUW1_6882631926',6,32,7,0,0,0,0,7,1,409,119,26443,30357,19786,4,105,9,1,0,1,0,4,423,92,27703,31045,24536,0,-14,27,-1260,-2,-688,-4750,-1,0,-1,0,3
EUW1_6882614584',5,215,3,0,1,0,0,10,0,333,83,22900,26612,19960,10,30,18,2,0,2,0,0,388,83,29993,32759,35996,0,-55,0,-7093,-15,-6147,-16036,-2,1,-2,0,10
EUW1_6878274224',2,30,9,1,0,1,0,6,0,339,70,24932,27790,28356,2,29,10,1,0,0,0,4,350,100,25439,28900,24208,0,-11,-30,-507,-1,-1110,4148,0,0,1,0,2
EUW1_6878243709',4,24,12,0,0,1,0,10,0,358,78,28052,28229,28811,3,23,18,2,1,0,0,5,344,118,30705,32355,36023,0,14,-40,-2653,-6,-4126,-7212,-2,-1,1,0,5
EUW1_6878838544',5,28,12,2,0,1,0,10,0,344,86,27841,27946,31844,2,30,12,0,0,0,0,5,331,81,27288,28249,35113,1,13,5,553,0,-303,-3269,2,0,1,0,5
EUW1_6878767612',4,28,13,1,0,0,0,11,0,400,94,28615,31044,34598,3,29,21,1,0,1,0,2,385,75,31309,33280,44918,0,15,19,-2694,-8,-2236,-10320,0,0,-1,0,9
EUW1_6878499917',7,27,23,0,0,1,0,11,0,330,82,31396,31995,44183,3,98,15,1,0,1,0,2,351,105,29789,30789,41226,1,-21,-23,1607,8,1206,2957,-1,0,0,0,9
EUW1_6878458856',3,39,17,0,0,2,0,8,1,335,86,30212,31166,38245,5,28,8,1,0,1,0,5,390,109,27435,30301,38482,1,-55,-23,2777,9,865,-237,-1,0,1,0,3
EUW1_6878241161',7,26,7,0,0,1,0,13,0,305,74,23673,25382,22126,8,40,16,2,1,1,0,2,393,112,31293,31410,32266,0,-88,-38,-7620,-9,-6028,-10140,-2,-1,0,0,11
EUW1_6878188723',4,29,10,0,0,0,0,7,0,373,86,27256,29176,27910,3,30,11,2,0,1,0,2,312,76,25146,28309,26854,0,61,10,2110,-1,867,1056,-2,0,-1,0,5
EUW1_6874994931',9,29,20,2,1,0,0,11,1,348,99,31196,32908,42134,3,27,10,0,0,1,0,5,328,84,25856,27350,30525,1,20,15,5340,10,5558,11609,2,1,-1,0,6
EUW1_6874970201',4,25,20,1,1,3,0,6,0,396,115,34743,34626,33902,3,26,11,1,0,2,0,7,328,79,27614,29293,26536,1,68,36,7129,9,5333,7366,0,1,1,0,-1
EUW1_6874943436',6,33,7,0,0,0,0,6,1,399,92,25376,29949,26725,2,25,21,1,0,1,0,4,384,98,31092,33779,41145,0,15,-6,-5716,-14,-3830,-14420,-1,0,-1,0,2
EUW1_6874915667',2,28,11,1,0,1,0,12,0,353,82,27442,28208,29691,4,31,16,0,0,1,0,6,360,86,29124,30354,37928,0,-7,-4,-1682,-5,-2146,-8237,1,0,0,0,6
EUW1_6873898512',6,29,10,2,0,0,0,9,1,353,72,25133,28426,34605,7,100,17,0,0,1,0,1,303,96,29182,30182,37987,1,50,-24,-4049,-7,-1756,-3382,2,0,-1,0,8
EUW1_6873869759',4,38,11,1,0,0,0,14,0,339,78,25533,28772,24771,7,29,18,1,1,2,0,2,372,130,31716,32340,27963,0,-33,-52,-6183,-7,-3568,-3192,0,-1,-2,0,12
EUW1_6865516012',3,24,12,1,0,0,0,12,1,343,72,25766,30287,34641,2,26,10,1,0,2,0,4,353,91,27969,29129,34465,0,-10,-19,-2203,2,1158,176,0,0,-2,0,8
EUW1_6865399509',3,72,7,2,0,0,0,15,1,324,116,25081,28085,19678,0,25,9,0,0,5,0,1,418,88,30820,30584,28066,0,-94,28,-5739,-2,-2499,-8388,2,0,-5,0,14
EUW1_6861351418',1,26,9,0,0,0,0,4,0,413,91,27535,30194,25678,8,100,16,2,0,0,0,0,382,88,29012,30728,34733,0,31,3,-1477,-7,-534,-9055,-2,0,0,0,4
EUW1_6878602417',3,27,10,2,0,1,0,11,1,347,88,26327,28991,27796,2,31,10,0,0,0,0,4,337,106,25942,29303,34564,1,10,-18,385,0,-312,-6768,2,0,1,0,7
EUW1_6878553769',2,27,17,0,0,1,0,13,0,330,84,29358,30113,36683,2,66,12,1,0,1,0,2,351,85,26658,28490,27839,1,-21,-1,2700,5,1623,8844,-1,0,0,0,11
EUW1_6878519236',3,27,21,1,0,2,0,8,1,372,78,32287,31089,38709,0,44,9,0,0,1,0,5,287,78,23080,25075,26679,1,85,0,9207,12,6014,12030,1,0,1,0,3
EUW1_6878482332',4,26,20,1,1,6,1,13,1,390,99,34046,32606,41227,2,28,5,0,0,1,0,10,355,73,25680,26409,22527,1,35,26,8366,15,6197,18700,1,1,5,1,3
EUW1_6878452644',4,56,14,1,1,1,0,5,0,386,92,29776,30803,37759,6,35,10,0,0,1,0,6,369,72,25562,30248,36050,1,17,20,4214,4,555,1709,1,1,0,0,-1
EUW1_6873146129',2,31,7,0,0,1,0,13,0,384,74,26462,29742,26147,6,29,16,2,0,2,0,7,369,74,29351,31781,31470,0,15,0,-2889,-9,-2039,-5323,-2,0,-1,0,6
EUW1_6873081545',4,82,9,2,0,1,0,9,0,326,109,26525,29477,32027,7,64,17,0,0,1,0,2,387,101,29603,32897,34569,0,-61,8,-3078,-8,-3420,-2542,2,0,0,0,7
EUW1_6873021755',8,37,13,0,0,1,0,10,1,362,80,27807,29406,33499,2,137,24,1,1,2,0,6,351,68,31975,31288,44769,0,11,12,-4168,-11,-1882,-11270,-1,-1,-1,0,4
EUW1_6872972697',3,90,21,1,1,2,0,10,1,328,90,32510,30396,41739,7,32,6,0,0,1,0,3,335,75,24061,25560,26667,1,-7,15,8449,15,4836,15072,1,1,1,0,7
EUW1_6870426051',2,147,15,1,0,1,0,15,0,349,110,29015,30404,39635,1,22,14,0,0,2,0,6,390,90,31536,31359,36625,1,-41,20,-2521,1,-955,3010,1,0,-1,0,9
EUW1_6870377544',5,61,18,1,0,0,0,10,0,291,101,28619,30664,39360,5,62,19,1,1,1,0,2,356,118,30399,31881,41519,0,-65,-17,-1780,-1,-1217,-2159,0,-1,-1,0,8
EUW1_6870316558',4,29,6,0,1,0,0,10,0,311,102,24761,27362,28753,4,29,15,2,0,2,0,3,397,87,29588,31467,38908,0,-86,15,-4827,-9,-4105,-10155,-2,1,-2,0,7
EUW1_6870249616',2,58,8,1,0,1,0,10,0,352,86,25823,27520,33750,6,39,10,1,0,0,0,7,347,88,25695,29260,34114,1,5,-2,128,-2,-1740,-364,0,0,1,0,3
EUW1_6870185280',4,61,20,2,0,1,0,10,1,362,102,32743,32723,38208,5,69,11,0,0,1,0,2,383,74,26337,27420,36824,1,-21,28,6406,9,5303,1384,2,0,0,0,8
EUW1_6865779668',5,45,17,0,0,1,0,11,0,332,81,29641,30285,34560,4,30,14,2,0,1,0,6,353,99,28848,29225,39279,1,-21,-18,793,3,1060,-4719,-2,0,0,0,5
EUW1_6865341161',5,31,8,1,0,0,0,7,1,360,104,25969,28731,26906,3,37,15,0,0,1,0,1,392,96,29152,32706,33087,0,-32,8,-3183,-7,-3975,-6181,1,0,-1,0,6
EUW1_6865299291',1,32,6,0,0,0,0,11,0,348,84,24623,28620,19368,6,37,21,2,0,4,0,2,429,95,35958,35056,38398,0,-81,-11,-11335,-15,-6436,-19030,-2,0,-4,0,9
EUW1_6865242354',6,26,10,0,0,1,0,6,1,360,88,26560,29517,29718,3,30,12,2,0,0,0,4,384,100,27782,30790,38856,0,-24,-12,-1222,-2,-1273,-9138,-2,0,1,0,2
EUW1_6865022457',3,28,11,0,0,2,0,5,0,398,108,29633,32438,24155,1,23,8,2,0,0,0,6,375,87,25362,30315,25554,1,23,21,4271,3,2123,-1399,-2,0,2,0,-1
EUW1_6883548026',3,27,24,2,0,3,0,5,0,406,91,35354,33127,47394,1,42,14,0,0,0,0,5,300,77,27310,25301,31766,1,106,14,8044,10,7826,15628,2,0,3,0,0
EUW1_6883509318',2,28,16,1,1,1,0,7,1,400,104,30986,32976,36300,1,97,13,1,0,0,0,4,347,92,27891,31104,30159,0,53,12,3095,3,1872,6141,0,1,1,0,3
EUW1_6883474243',2,31,9,0,0,0,0,5,1,382,88,25949,29126,24269,2,26,11,2,0,0,0,2,356,100,26437,30418,28600,0,26,-12,-488,-2,-1292,-4331,-2,0,0,0,3
EUW1_6883434037',3,28,6,0,0,0,0,8,0,326,79,23675,27081,26523,6,31,15,1,1,1,0,1,401,94,30865,30204,38917,0,-75,-15,-7190,-9,-3123,-12394,-1,-1,-1,0,7
EUW1_6883377771',4,34,21,1,0,2,0,8,1,395,107,33914,32391,42521,5,104,8,1,0,1,0,7,334,96,25088,28776,27919,1,61,11,8826,13,3615,14602,0,0,1,0,1
EUW1_6883027005',3,30,25,2,0,2,0,4,1,376,112,34542,32553,43032,0,20,12,0,0,1,0,8,323,64,25846,27978,32467,1,53,48,8696,13,4575,10565,2,0,1,0,-4
EUW1_6882981881',4,26,14,1,0,1,0,9,1,408,95,28963,31589,34428,7,31,6,0,0,0,0,3,359,100,25113,30583,26017,1,49,-5,3850,8,1006,8411,1,0,1,0,6
EUW1_6882931131',6,25,7,0,0,2,0,8,0,330,100,25798,28502,27383,6,32,10,1,0,0,0,6,359,92,26443,29598,31074,0,-29,8,-645,-3,-1096,-3691,-1,0,2,0,2
EUW1_6882885740',4,29,18,0,0,1,0,11,0,306,91,30597,28588,44451,5,27,22,0,0,1,0,4,327,88,31062,29396,40030,0,-21,3,-465,-4,-808,4421,0,0,0,0,7
EUW1_6882839358',1,21,15,0,0,0,0,9,1,320,88,28941,26160,34073,9,58,22,2,0,3,0,6,342,104,31483,30527,42887,0,-22,-16,-2542,-7,-4367,-8814,-2,0,-3,0,3
EUW1_6882804561',0,36,17,1,1,0,0,11,0,345,112,29298,30392,35366,5,29,19,1,0,2,0,3,371,94,33063,31931,42812,1,-26,18,-3765,-2,-1539,-7446,0,1,-2,0,8
EUW1_6882729135',4,27,17,1,0,0,0,5,1,414,98,30053,33404,37657,4,28,10,0,0,1,0,6,345,82,26727,29620,34734,0,69,16,3326,7,3784,2923,1,0,-1,0,-1
EUW1_6881378042',3,24,12,2,0,1,0,4,1,366,76,27053,28328,30844,4,23,7,0,0,0,0,5,357,96,25205,29094,23424,1,9,-20,1848,5,-766,7420,2,0,1,0,-1
EUW1_6881328737',6,31,25,1,0,1,0,11,1,362,92,34366,30916,41117,5,36,16,1,0,1,0,3,295,96,28487,26573,38250,1,67,-4,5879,9,4343,2867,0,0,0,0,8
EUW1_6881149422',7,34,10,1,1,2,0,14,0,372,78,27739,31371,27650,8,37,14,1,0,1,0,2,373,110,28453,29383,32726,0,-1,-32,-714,-4,1988,-5076,0,1,1,0,12
EUW1_6881128725',7,30,7,0,0,0,0,12,0,338,88,24478,26133,24849,6,26,17,1,0,1,0,0,420,80,30703,31514,27937,0,-82,8,-6225,-10,-5381,-3088,-1,0,-1,0,12
EUW1_6881039271',6,29,4,1,1,0,0,13,0,386,107,23844,29743,16766,4,26,10,1,0,1,0,1,410,88,27764,31765,27478,0,-24,19,-3920,-6,-2022,-10712,0,1,-1,0,12
EUW1_6880436414',1,57,22,1,0,0,0,15,1,316,105,31174,33790,41856,3,54,16,1,0,1,0,3,368,82,27909,29423,42565,0,-52,23,3265,6,4367,-709,0,0,-1,0,12
EUW1_6880379263',5,75,17,1,0,1,0,8,0,392,92,30451,32864,36524,1,57,10,0,0,1,0,4,341,120,26821,29782,27285,1,51,-28,3630,7,3082,9239,1,0,0,0,4
EUW1_6882638370',1,29,7,1,0,0,0,13,0,395,78,25736,29265,30060,7,110,15,1,1,1,0,0,365,91,29114,31408,33023,0,30,-13,-3378,-8,-2143,-2963,0,-1,-1,0,13
EUW1_6881931133',5,24,10,0,0,0,0,10,1,346,81,25900,28823,29067,7,28,9,2,0,2,0,0,386,106,28659,30334,29314,0,-40,-25,-2759,1,-1511,-247,-2,0,-2,0,10
EUW1_6881876443',3,40,5,0,0,0,0,14,0,339,62,23161,26317,28891,7,35,19,1,0,3,0,1,399,54,31441,32334,39267,0,-60,8,-8280,-14,-6017,-10376,-1,0,-3,0,13
EUW1_6880213467',4,27,8,0,0,0,0,8,0,374,97,25291,30091,29178,3,102,5,2,1,1,0,3,358,106,24381,29637,23360,1,16,-9,910,3,454,5818,-2,-1,-1,0,5
EUW1_6879890279',3,29,12,0,0,1,0,8,0,357,92,27642,31426,34421,3,21,14,0,0,0,0,4,388,106,28275,31584,37295,0,-31,-14,-633,-2,-158,-2874,0,0,1,0,4
EUW1_6879561445',6,29,10,1,1,2,0,12,1,365,96,27891,29865,28522,4,99,11,1,0,1,0,6,342,99,27951,30134,26958,1,23,-3,-60,-1,-269,1564,0,1,1,0,6
EUW1_6879535094',4,31,15,1,1,2,0,12,0,360,94,29625,30164,34610,1,24,14,1,0,1,0,8,337,69,28281,28384,31567,1,23,25,1344,1,1780,3043,0,1,1,0,4
EUW1_6879102150',5,25,25,0,0,4,0,8,1,372,82,35826,32747,42926,2,21,9,1,0,1,0,10,332,69,23852,26955,29512,1,40,13,11974,16,5792,13414,-1,0,3,0,-2
EUW1_6883136393',1,29,9,0,0,0,0,10,0,379,90,27222,31144,23029,3,31,15,1,0,0,0,1,375,96,28297,32582,34416,0,4,-6,-1075,-6,-1438,-11387,-1,0,0,0,9
EUW1_6881759362',3,27,12,2,0,0,0,11,1,368,74,27023,31190,30314,1,175,9,0,0,1,0,0,370,110,27387,31670,25401,1,-2,-36,-364,3,-480,4913,2,0,-1,0,11
EUW1_6881561406',3,25,6,0,0,0,0,7,0,346,107,23808,27932,27043,3,29,15,2,0,1,0,2,382,80,29009,29325,30433,0,-36,27,-5201,-9,-1393,-3390,-2,0,-1,0,5
EUW1_6881407151',3,24,9,0,0,0,0,9,0,337,104,26867,29388,31805,5,27,19,2,0,1,0,4,405,85,31456,33315,38809,0,-68,19,-4589,-10,-3927,-7004,-2,0,-1,0,5
EUW1_6881275609',4,31,12,2,0,0,0,8,1,400,75,27529,30275,31276,5,59,6,0,0,0,0,4,372,109,25639,30188,29883,1,28,-34,1890,6,87,1393,2,0,0,0,4
EUW1_6881159189',5,22,20,1,0,1,0,5,0,367,64,31919,32157,43471,1,22,14,1,0,1,0,9,299,84,28239,28173,41806,1,68,-20,3680,6,3984,1665,0,0,0,0,-4
EUW1_6881073024',8,44,11,1,0,0,0,6,0,384,61,26813,28821,23564,1,32,11,0,0,2,0,6,407,110,29375,32281,26818,1,-23,-49,-2562,0,-3460,-3254,1,0,-2,0,0
EUW1_6880955432',3,21,10,0,0,0,0,13,0,247,84,24366,25746,23286,1,23,16,1,0,2,0,4,405,72,29509,29931,33327,0,-158,12,-5143,-6,-4185,-10041,-1,0,-2,0,9
EUW1_6879616124',4,27,15,0,0,2,0,6,1,406,114,32139,32199,40328,5,28,8,1,0,1,0,7,333,94,24809,29175,23647,1,73,20,7330,7,3024,16681,-1,0,1,0,-1
EUW1_6879587316',2,65,13,1,1,1,0,7,0,406,73,29585,31068,27709,5,31,6,0,0,0,0,4,379,84,24584,28207,23326,1,27,-11,5001,7,2861,4383,1,1,1,0,3
EUW1_6879563424',4,33,22,1,1,1,0,10,1,322,96,31209,30378,36432,5,26,13,0,0,0,0,3,355,76,27211,27694,31009,1,-33,20,3998,9,2684,5423,1,1,1,0,7
EUW1_6879481081',4,24,8,1,0,0,0,14,0,360,112,25630,28890,31887,2,25,20,0,0,2,0,4,318,95,30598,31759,37371,0,42,17,-4968,-12,-2869,-5484,1,0,-2,0,10
EUW1_6879460012',5,30,9,1,0,0,0,10,0,331,79,25739,28519,30286,4,31,18,1,0,1,0,1,356,110,30246,31987,32026,0,-25,-31,-4507,-9,-3468,-1740,0,0,-1,0,9
EUW1_6878848591',6,32,16,1,0,0,0,8,0,365,83,30145,29147,33792,6,54,16,1,0,1,0,4,346,76,28451,29142,37882,0,19,7,1694,0,5,-4090,0,0,-1,0,4
EUW1_6878785153',4,25,9,0,0,0,0,9,0,337,80,25732,29601,27062,2,30,21,2,0,1,0,1,398,84,31708,32026,38551,0,-61,-4,-5976,-12,-2425,-11489,-2,0,-1,0,8
EUW1_6878737566',2,155,16,0,0,1,0,7,0,337,91,29093,29292,37633,3,59,19,1,0,0,0,5,333,71,29399,30263,39240,0,4,20,-306,-3,-971,-1607,-1,0,1,0,2
EUW1_6878564586',1,25,15,1,0,0,0,6,1,374,102,28046,30855,33368,2,23,8,1,0,0,0,3,344,66,23192,27183,23792,1,30,36,4854,7,3672,9576,0,0,0,0,3
EUW1_6878364493',2,28,12,1,0,0,0,11,1,308,79,27250,27251,31583,1,27,19,1,0,2,0,3,359,88,31118,30284,39866,1,-51,-9,-3868,-7,-3033,-8283,0,0,-2,0,8
EUW1_6878216261',6,181,5,0,0,0,0,7,0,344,70,23468,28128,25148,1,58,15,2,0,1,0,1,412,117,30291,32573,27709,0,-68,-47,-6823,-10,-4445,-2561,-2,0,-1,0,6
EUW1_6881055389',1,30,16,1,0,0,0,12,0,375,118,30410,33121,40334,1,28,15,1,0,1,0,1,344,80,29082,31011,36906,0,31,38,1328,1,2110,3428,0,0,-1,0,11
EUW1_6881023577',3,28,15,1,0,1,0,4,0,355,96,30644,29945,34045,4,32,13,1,0,1,0,7,279,75,27417,24737,33828,0,76,21,3227,2,5208,217,0,0,0,0,-3
EUW1_6879435933',4,27,14,0,0,0,0,7,0,368,76,29783,29878,34853,2,27,15,2,0,2,0,4,427,78,30726,31300,39588,0,-59,-2,-943,-1,-1422,-4735,-2,0,-2,0,3
EUW1_6878459978',0,29,10,1,0,0,0,6,0,411,106,27340,29979,22842,7,30,8,0,1,0,0,1,364,82,25256,28681,22769,0,47,24,2084,2,1298,73,1,-1,0,0,5
EUW1_6876610675',3,33,13,0,0,1,0,10,1,327,100,27741,29180,33044,2,25,13,2,0,2,0,3,369,78,29295,28823,33134,1,-42,22,-1554,0,357,-90,-2,0,-1,0,7
EUW1_6876564221',2,28,10,2,0,0,0,6,0,415,106,27402,32187,27294,4,30,6,0,0,0,0,3,382,114,24958,30197,24111,1,33,-8,2444,4,1990,3183,2,0,0,0,3
EUW1_6874018237',4,33,9,1,0,3,0,12,0,374,98,28559,28869,26661,8,33,14,1,0,1,0,6,353,84,28679,28802,30690,1,21,14,-120,-5,67,-4029,0,0,2,0,6
EUW1_6873994852',3,26,14,1,0,1,0,8,0,368,88,30205,30123,38042,1,21,20,0,0,0,0,4,344,74,29928,28892,38300,0,24,14,277,-6,1231,-258,1,0,1,0,4
EUW1_6873956980',6,85,21,0,0,1,0,3,1,341,100,31772,30833,38123,2,26,6,1,0,2,0,8,337,54,23717,25498,22868,1,4,46,8055,15,5335,15255,-1,0,-1,0,-5
EUW1_6873924257',3,42,2,1,0,1,0,7,1,382,89,23675,28695,19282,2,25,6,1,0,0,0,0,406,86,24796,31675,20406,0,-24,3,-1121,-4,-2980,-1124,0,0,1,0,7
EUW1_6873909964',5,29,25,2,0,4,0,10,1,388,126,37139,34252,52582,5,35,7,0,0,0,0,7,385,90,26147,29604,28985,1,3,36,10992,18,4648,23597,2,0,4,0,3
EUW1_6873832369',7,29,12,1,0,1,0,5,0,373,82,28870,31559,33956,2,68,14,1,0,1,0,5,372,98,29664,30754,36314,0,1,-16,-794,-2,805,-2358,0,0,0,0,0
EUW1_6883392520',6,42,13,2,0,2,0,6,1,390,92,29086,30547,29482,8,45,3,0,0,0,0,5,393,81,23151,27751,30731,1,-3,11,5935,10,2796,-1249,2,0,2,0,1
EUW1_6882399546',4,27,9,0,0,0,0,11,1,341,59,25319,27549,30740,2,26,13,1,0,2,0,3,324,119,29073,28892,28941,0,17,-60,-3754,-4,-1343,1799,-1,0,-2,0,8
EUW1_6882376098',3,27,12,0,0,0,0,10,0,288,68,25249,25515,43653,4,30,26,0,0,1,0,3,347,104,33481,33009,50617,0,-59,-36,-8232,-14,-7494,-6964,0,0,-1,0,7
EUW1_6880192981',10,108,6,0,0,0,0,8,1,353,88,24186,27231,25197,6,43,8,1,1,2,0,3,369,86,26805,30454,28535,0,-16,2,-2619,-2,-3223,-3338,-1,-1,-2,0,5
EUW1_6879407281',5,39,11,2,1,1,0,7,1,342,116,27732,30662,29765,0,19,9,0,0,0,0,4,352,86,24996,29671,26110,1,-10,30,2736,2,991,3655,2,1,1,0,3
EUW1_6878144939',3,59,9,1,0,1,0,5,1,365,94,26842,29490,29525,3,26,8,0,0,0,0,5,347,90,24572,28496,28444,1,18,4,2270,1,994,1081,1,0,1,0,0
EUW1_6878089274',3,24,6,0,0,0,0,9,0,322,68,22865,27200,29164,7,108,18,2,0,2,0,3,357,90,31154,31298,36891,0,-35,-22,-8289,-12,-4098,-7727,-2,0,-2,0,6
EUW1_6878060135',2,21,15,2,1,1,0,10,1,344,98,29428,31476,34962,4,26,9,0,0,1,0,5,360,94,25959,27965,34868,0,-16,4,3469,6,3511,94,2,1,0,0,5
EUW1_6878045529',3,32,17,2,1,4,0,4,1,409,92,32647,30316,35855,7,31,5,0,0,0,0,8,357,88,23291,26093,20739,1,52,4,9356,12,4223,15116,2,1,4,0,-4
EUW1_6878008353',3,25,17,1,0,0,0,14,0,332,72,27641,28407,40286,5,29,14,1,0,1,0,2,310,70,28015,26174,32060,1,22,2,-374,3,2233,8226,0,0,-1,0,12
EUW1_6877973314',5,68,10,0,0,1,0,8,1,405,80,26630,30039,24704,3,45,8,2,0,0,0,2,399,108,26188,30807,28010,0,6,-28,442,2,-768,-3306,-2,0,1,0,6
EUW1_6877954312',5,30,18,2,0,1,0,8,1,338,100,29839,29806,33304,5,31,14,0,0,0,0,5,333,100,27325,28820,32413,1,5,0,2514,4,986,891,2,0,1,0,3
EUW1_6877944915',2,26,10,1,0,1,0,4,0,331,110,27434,28285,35060,9,35,19,1,0,1,0,6,325,81,28784,28756,38125,0,6,29,-1350,-9,-471,-3065,0,0,0,0,-2
EUW1_6877923259',4,31,11,0,0,0,0,15,0,315,60,25796,26759,33470,4,27,16,2,0,2,0,2,366,112,30522,30121,37853,1,-51,-52,-4726,-5,-3362,-4383,-2,0,-2,0,13
EUW1_6872610152',3,24,9,2,0,1,0,7,0,370,90,28138,29946,28852,4,27,10,0,0,1,0,9,305,90,24944,27247,25017,1,65,0,3194,-1,2699,3835,2,0,0,0,-2
EUW1_6871530104',2,27,17,1,0,1,0,7,1,413,72,30621,31010,35164,2,25,10,1,0,1,0,5,346,100,26670,28912,33113,1,67,-28,3951,7,2098,2051,0,0,0,0,2
EUW1_6870499237',5,26,10,0,0,0,0,11,0,329,88,25551,29639,33591,5,26,15,1,0,3,0,2,417,96,31257,31703,33568,0,-88,-8,-5706,-5,-2064,23,-1,0,-3,0,9
EUW1_6870372837',2,41,14,0,0,0,0,16,0,296,79,26240,26698,33584,7,28,21,2,0,2,0,3,383,78,33176,32143,41590,0,-87,1,-6936,-7,-5445,-8006,-2,0,-2,0,13
EUW1_6869870336',3,31,20,1,0,1,0,6,1,313,78,29283,30526,38539,3,28,14,1,0,0,0,3,318,72,25283,27063,37678,0,-5,6,4000,6,3463,861,0,0,1,0,3
EUW1_6869556106',1,23,14,1,0,0,0,12,0,314,98,26670,28830,31659,3,23,13,1,1,0,0,4,350,82,28042,30152,33365,0,-36,16,-1372,1,-1322,-1706,0,-1,0,0,8
EUW1_6869516110',4,25,12,1,1,0,0,10,0,357,84,26753,29246,30018,2,57,11,1,0,1,0,4,365,110,27985,29225,31198,0,-8,-26,-1232,1,21,-1180,0,1,-1,0,6
EUW1_6869459850',5,30,25,2,0,2,0,12,0,315,108,33674,32710,49369,1,24,18,0,0,2,0,6,308,76,30910,28068,45743,1,7,32,2764,7,4642,3626,2,0,0,0,6
EUW1_6869429515',5,27,23,1,1,2,0,10,1,272,71,32116,25941,34345,4,28,13,0,0,1,0,4,315,94,27744,25833,20634,1,-43,-23,4372,10,108,13711,1,1,1,0,6
EUW1_6868550301',9,36,14,2,0,1,0,8,1,338,74,28140,29786,32591,2,46,9,0,0,1,0,6,334,105,26063,27808,22964,0,4,-31,2077,5,1978,9627,2,0,0,0,2
EUW1_6866858350',4,59,16,2,0,1,0,11,1,364,107,29160,33210,40563,0,59,7,0,0,0,0,2,366,80,25986,31084,28165,1,-2,27,3174,9,2126,12398,2,0,1,0,9
EUW1_6866791066',5,42,15,2,0,1,0,4,1,388,82,29608,30301,33430,3,34,8,0,0,0,0,8,369,89,25089,28746,32517,1,19,-7,4519,7,1555,913,2,0,1,0,-4
EUW1_6866745122',3,27,6,0,0,0,0,10,0,358,100,25359,28649,30800,2,26,14,2,0,1,0,2,335,82,26851,28902,29746,0,23,18,-1492,-8,-253,1054,-2,0,-1,0,8
EUW1_6866571692',4,25,18,0,0,2,0,8,0,376,54,31287,30361,36160,7,29,10,1,0,0,0,8,332,88,26266,27287,30549,1,44,-34,5021,8,3074,5611,-1,0,2,0,0
EUW1_6866526591',1,23,12,2,0,1,0,7,1,319,82,25876,28872,39108,2,26,17,0,0,1,0,4,344,97,29120,30811,34005,1,-25,-15,-3244,-5,-1939,5103,2,0,0,0,3
EUW1_6882519634',4,29,11,0,1,1,0,12,1,394,114,29041,31199,28068,3,27,14,2,0,2,0,3,356,93,29005,31543,32579,0,38,21,36,-3,-344,-4511,-2,1,-1,0,9
EUW1_6881970991',4,23,13,0,0,1,0,6,1,389,113,29712,31223,42001,1,29,11,1,0,0,0,4,353,82,25899,29229,32714,0,36,31,3813,2,1994,9287,-1,0,1,0,2
EUW1_6881610387',4,30,15,0,0,2,0,11,0,396,100,30497,31380,32694,8,33,11,2,0,0,0,3,348,92,25683,28017,28375,0,48,8,4814,4,3363,4319,-2,0,2,0,8
EUW1_6881522081',3,24,12,0,0,1,0,15,1,304,77,26908,25335,28896,5,22,18,1,1,3,0,5,346,118,31487,32654,38744,0,-42,-41,-4579,-6,-7319,-9848,-1,-1,-2,0,10
EUW1_6880037232',3,45,20,0,0,1,0,10,0,360,69,30890,31021,39174,3,28,9,1,0,2,0,3,321,82,27734,28247,33648,1,39,-13,3156,11,2774,5526,-1,0,-1,0,7
EUW1_6879992343',1,19,11,1,0,0,0,12,1,364,92,27402,29553,27847,2,27,13,0,0,2,0,5,373,92,29298,31706,29019,1,-9,0,-1896,-2,-2153,-1172,1,0,-2,0,7
EUW1_6879824839',6,26,11,0,0,0,0,10,0,353,89,26872,29282,29635,7,26,21,2,0,1,0,3,371,84,31507,31375,40837,0,-18,5,-4635,-10,-2093,-11202,-2,0,-1,0,7
EUW1_6878950533',5,67,19,1,1,1,0,14,1,341,87,30444,30784,43011,5,61,11,0,0,0,0,4,332,80,26573,28766,35169,1,9,7,3871,8,2018,7842,1,1,1,0,10
EUW1_6878881379',1,29,18,1,0,3,0,6,0,421,77,34205,32438,36353,3,25,10,0,0,1,0,10,311,90,25818,27304,25866,0,110,-13,8387,8,5134,10487,1,0,2,0,-4
EUW1_6878089574',3,28,15,0,0,0,0,11,1,324,74,28409,29117,34338,4,61,20,1,0,1,0,3,372,85,30712,31209,36623,0,-48,-11,-2303,-5,-2092,-2285,-1,0,-1,0,8
EUW1_6878052044',7,29,15,0,1,1,0,8,1,369,104,29998,31215,34043,7,30,9,1,0,0,0,5,399,88,26627,30780,24456,1,-30,16,3371,6,435,9587,-1,1,1,0,3
EUW1_6877347878',6,28,14,0,1,1,0,8,0,309,112,28185,28938,30410,5,31,14,1,0,1,0,2,376,68,28515,29119,36172,0,-67,44,-330,0,-181,-5762,-1,1,0,0,6
EUW1_6882113628',5,28,13,1,0,0,0,12,0,343,90,27912,29063,31951,7,30,18,1,0,1,0,2,344,76,30184,27963,42967,1,-1,14,-2272,-5,1100,-11016,0,0,-1,0,10
EUW1_6881995697',2,38,22,1,0,2,0,11,0,346,78,32927,31061,36998,2,29,26,0,0,1,0,10,294,86,32778,29832,41415,1,52,-8,149,-4,1229,-4417,1,0,1,0,1
EUW1_6879705839',7,30,11,1,0,0,0,5,0,385,78,26678,30175,28117,3,30,12,1,1,0,0,3,387,102,27761,30593,25003,1,-2,-24,-1083,-1,-418,3114,0,-1,0,0,2
EUW1_6879670058',4,46,15,2,0,1,0,12,1,412,99,30706,33501,29089,5,26,4,0,0,1,0,4,355,91,22836,27754,29039,1,57,8,7870,11,5747,50,2,0,0,0,8
EUW1_6879623125',6,27,7,0,1,1,0,11,0,380,90,27190,30677,26819,4,28,17,2,0,1,0,6,358,102,29130,31076,37473,0,22,-12,-1940,-10,-399,-10654,-2,1,0,0,5
EUW1_6878768493',1,195,10,0,0,0,0,11,0,339,68,25711,28577,28125,0,33,15,1,1,1,0,1,333,80,28608,30581,41108,0,6,-12,-2897,-5,-2004,-12983,-1,-1,-1,0,10
EUW1_6878695066',4,27,12,0,0,0,0,12,0,362,82,27315,30128,32287,1,43,14,1,0,1,0,4,360,98,29169,32031,26551,0,2,-16,-1854,-2,-1903,5736,-1,0,-1,0,8
EUW1_6877168773',2,31,16,1,0,0,0,12,1,364,73,28305,29270,40549,3,63,14,0,0,1,0,3,334,93,28260,30336,36899,1,30,-20,45,2,-1066,3650,1,0,-1,0,9
EUW1_6876917110',10,34,15,1,1,2,0,7,1,409,116,31794,32756,33610,4,31,8,1,0,0,0,6,335,88,24175,29200,25717,1,74,28,7619,7,3556,7893,0,1,2,0,1
EUW1_6876870783',5,24,4,1,0,0,0,7,0,395,85,23942,29777,24298,5,61,17,0,0,0,0,0,397,102,28495,34660,34684,0,-2,-17,-4553,-13,-4883,-10386,1,0,0,0,7
EUW1_6876835268',2,23,7,0,1,0,0,17,0,319,84,25709,25646,30651,3,27,25,2,0,4,0,3,413,88,35923,33087,40852,0,-94,-4,-10214,-18,-7441,-10201,-2,1,-4,0,14
EUW1_6876791738',4,21,14,1,1,1,0,4,1,400,97,29396,34108,35252,2,25,9,1,0,0,0,6,350,73,24030,26656,30166,1,50,24,5366,5,7452,5086,0,1,1,0,-2
EUW1_6876727808',3,27,18,1,0,1,0,5,1,335,74,29677,30495,35920,3,16,8,1,0,0,0,6,360,85,24930,29486,25042,0,-25,-11,4747,10,1009,10878,0,0,1,0,-1
EUW1_6876622878',2,43,14,0,0,0,0,15,1,332,104,28117,29225,39285,5,28,12,2,0,1,0,3,349,75,27762,28283,34092,1,-17,29,355,2,942,5193,-2,0,-1,0,12
EUW1_6876591288',1,31,6,0,0,0,0,12,0,375,90,24580,30966,23296,5,22,9,2,0,1,0,0,415,121,27917,32585,30205,0,-40,-31,-3337,-3,-1619,-6909,-2,0,-1,0,12
EUW1_6876292281',8,36,21,2,1,1,0,11,0,323,59,31799,28280,39669,3,30,16,0,0,2,0,6,307,108,29589,28291,40545,1,16,-49,2210,5,-11,-876,2,1,-1,0,5
EUW1_6876244906',5,58,6,0,0,0,0,12,0,336,77,23687,27620,24238,2,28,3,1,0,1,0,1,383,94,24741,28207,23578,0,-47,-17,-1054,3,-587,660,-1,0,-1,0,11
EUW1_6874469816',8,34,8,1,0,1,0,7,1,376,64,26083,26821,21899,4,28,12,1,0,0,0,6,370,92,28250,29768,26235,1,6,-28,-2167,-4,-2947,-4336,0,0,1,0,1
EUW1_6882988455',10,41,16,2,0,0,0,10,1,395,88,29614,30595,33529,4,36,15,0,0,1,0,4,364,92,30238,31983,27187,0,31,-4,-624,1,-1388,6342,2,0,-1,0,6
EUW1_6881585920',3,25,11,1,0,0,0,12,0,330,88,25981,29079,25125,3,30,9,1,0,2,0,0,398,106,29394,29511,29306,0,-68,-18,-3413,2,-432,-4181,0,0,-2,0,12
EUW1_6874393556',3,26,16,2,0,0,0,11,1,399,86,28352,30756,29410,3,18,10,0,0,1,0,2,398,76,27589,28934,33544,1,1,10,763,6,1822,-4134,2,0,-1,0,9
EUW1_6873422413',3,27,17,1,0,1,0,9,1,393,94,29967,32232,39463,2,23,10,0,0,1,0,6,366,82,27416,30332,29009,1,27,12,2551,7,1900,10454,1,0,0,0,3
EUW1_6883656991',6,43,23,0,0,1,0,9,1,318,70,30773,29546,39745,4,30,19,0,0,2,0,7,297,68,31498,28697,39719,1,21,2,-725,4,849,26,0,0,-1,0,2
EUW1_6883616040',3,28,11,0,0,0,0,15,1,317,97,26747,29368,30528,6,30,12,2,0,2,0,3,366,92,27749,29120,32086,0,-49,5,-1002,-1,248,-1558,-2,0,-2,0,12
EUW1_6883594987',2,27,15,1,0,2,0,12,0,359,91,30580,30570,36380,2,41,17,0,0,3,0,5,342,80,31530,29082,34326,1,17,11,-950,-2,1488,2054,1,0,-1,0,7
EUW1_6883541723',4,31,14,0,0,0,0,5,0,373,74,27364,30780,38109,9,30,13,1,0,0,0,0,334,92,25176,28323,34418,0,39,-18,2188,1,2457,3691,-1,0,0,0,5
EUW1_6883512606',4,28,11,0,0,0,0,8,0,332,96,26031,28011,28718,2,41,14,2,0,2,0,2,386,80,30043,30950,35137,0,-54,16,-4012,-3,-2939,-6419,-2,0,-2,0,6
EUW1_6883458368',1,28,7,1,0,0,0,11,0,294,102,24750,26425,27634,2,25,23,0,0,2,0,1,379,78,34206,32442,44553,0,-85,24,-9456,-16,-6017,-16919,1,0,-2,0,10
EUW1_6883420489',6,64,19,1,0,0,0,11,0,305,79,28837,30027,34820,4,64,15,0,0,1,0,4,369,101,30146,30718,37249,0,-64,-22,-1309,4,-691,-2429,1,0,-1,0,7
EUW1_6882360179',4,26,10,2,1,0,0,11,0,386,88,27107,30595,38661,5,27,15,0,0,1,0,0,368,96,28567,29966,31686,0,18,-8,-1460,-5,629,6975,2,1,-1,0,11
EUW1_6882362456',1,23,29,2,0,4,0,11,1,377,89,36496,33456,43854,1,25,9,0,0,1,0,8,289,70,23799,24862,27412,1,88,19,12697,20,8594,16442,2,0,3,0,3
EUW1_6882335216',3,33,15,1,1,2,0,10,1,373,78,28362,30290,28318,5,29,11,0,0,2,0,5,345,90,27438,28170,21703,1,28,-12,924,4,2120,6615,1,1,0,0,5
EUW1_6882328715',4,32,13,0,0,1,0,9,1,327,72,26691,27148,29893,5,27,12,1,1,0,0,3,317,116,27927,29605,36584,1,10,-44,-1236,1,-2457,-6691,-1,-1,1,0,6
EUW1_6882313888',2,34,22,1,0,1,0,13,1,318,68,31217,28338,44259,1,67,22,1,0,1,0,4,328,64,31691,29586,46282,1,-10,4,-474,0,-1248,-2023,0,0,0,0,9
EUW1_6882297018',1,30,8,1,0,0,0,15,0,346,88,26189,28439,24189,8,33,15,1,0,3,0,2,402,88,32136,31593,33817,0,-56,0,-5947,-7,-3154,-9628,0,0,-3,0,13
EUW1_6882279237',4,30,17,0,0,0,0,8,1,341,74,28783,29898,33672,1,28,7,1,1,2,0,5,325,94,25668,27890,29746,1,16,-20,3115,10,2008,3926,-1,-1,-2,0,3
EUW1_6882268582',3,28,14,1,0,1,0,12,0,365,72,29341,30718,40869,5,26,17,0,0,1,0,4,326,84,28544,29616,33829,1,39,-12,797,-3,1102,7040,1,0,0,0,8
EUW1_6882245875',2,26,12,1,0,1,0,8,0,320,87,27418,28143,32947,3,33,17,1,0,0,0,4,318,75,28830,30159,36683,1,2,12,-1412,-5,-2016,-3736,0,0,1,0,4
EUW1_6882217215',2,33,8,0,0,1,0,10,1,393,81,26161,30060,36208,3,23,10,2,0,1,0,4,361,96,26207,31467,25352,0,32,-15,-46,-2,-1407,10856,-2,0,0,0,6
EUW1_6882205603',3,28,7,0,0,0,0,9,0,367,84,26048,29595,30603,3,25,13,1,0,1,0,5,386,87,28538,31695,31617,0,-19,-3,-2490,-6,-2100,-1014,-1,0,-1,0,4
EUW1_6882171368',1,24,21,1,0,1,0,10,1,345,92,30883,31647,43784,1,27,12,0,0,1,0,7,335,101,27318,29373,28111,1,10,-9,3565,9,2274,15673,1,0,0,0,3
EUW1_6883041141',4,20,11,1,0,1,0,8,0,365,82,27351,29264,35368,1,24,10,0,0,0,0,4,344,89,25184,29245,38208,1,21,-7,2167,1,19,-2840,1,0,1,0,4
EUW1_6882966159',3,25,10,2,0,0,0,10,1,375,100,25735,31218,24889,5,188,8,0,0,1,0,1,399,116,27339,30501,32486,0,-24,-16,-1604,2,717,-7597,2,0,-1,0,9
EUW1_6882715924',5,37,4,1,0,0,0,11,1,363,80,22732,27180,26429,5,40,8,0,1,2,0,3,431,85,28025,30131,29168,1,-68,-5,-5293,-4,-2951,-2739,1,-1,-2,0,8
EUW1_6882679404',7,35,22,1,0,2,0,5,1,441,88,33872,34050,40941,3,26,4,0,0,0,0,9,367,90,23302,28030,17193,1,74,-2,10570,18,6020,23748,1,0,2,0,-4
EUW1_6882642641',8,47,13,1,0,0,0,9,1,358,72,27727,30306,27580,0,31,11,0,0,1,0,3,373,91,27517,29647,33417,1,-15,-19,210,2,659,-5837,1,0,-1,0,6
EUW1_6882604739',3,32,13,1,0,1,0,8,1,357,77,28587,30586,26539,2,134,9,0,0,2,0,4,383,98,28078,29475,26599,1,-26,-21,509,4,1111,-60,1,0,-1,0,4
EUW1_6878766239',2,25,10,0,0,1,0,8,1,328,104,26723,28222,33812,6,49,15,1,0,0,0,7,322,82,28038,29460,32273,1,6,22,-1315,-5,-1238,1539,-1,0,1,0,1
EUW1_6878694479',2,23,14,1,0,0,0,8,1,398,89,29349,30451,37108,6,34,8,0,0,2,0,3,377,66,26363,29504,27339,1,21,23,2986,6,947,9769,1,0,-2,0,5
EUW1_6878630982',7,37,7,1,0,0,0,9,1,362,94,24407,28041,23052,8,36,12,1,0,1,0,2,374,91,28638,30673,28332,0,-12,3,-4231,-5,-2632,-5280,0,0,-1,0,7
EUW1_6878576923',4,38,15,1,0,2,0,9,1,375,91,30233,31849,36878,5,36,4,0,0,0,0,6,356,91,23726,28099,24560,1,19,0,6507,11,3750,12318,1,0,2,0,3
EUW1_6878491460',5,40,7,1,0,1,0,6,0,338,100,25055,27217,29684,7,34,13,0,0,0,0,3,343,102,27387,29849,29565,0,-5,-2,-2332,-6,-2632,119,1,0,1,0,3
EUW1_6877471369',5,26,13,2,0,1,0,6,1,401,92,28888,31101,39061,4,39,6,0,0,0,0,6,370,85,24458,28544,23876,1,31,7,4430,7,2557,15185,2,0,1,0,0
EUW1_6877409597',4,34,10,2,0,2,0,4,1,403,120,30168,31963,30102,9,27,7,0,0,0,0,11,366,80,24302,28225,25589,1,37,40,5866,3,3738,4513,2,0,2,0,-7
EUW1_6877327880',5,34,13,1,0,0,0,12,1,381,97,28737,30864,39113,5,30,10,1,0,2,0,2,379,82,28333,30042,36330,0,2,15,404,3,822,2783,0,0,-2,0,10
EUW1_6877285519',5,26,16,1,0,1,0,6,1,328,120,31406,30079,35715,3,36,8,1,0,1,0,7,354,84,24886,28408,28915,1,-26,36,6520,8,1671,6800,0,0,0,0,-1
EUW1_6877196252',4,38,10,1,0,0,0,7,0,373,81,26602,29812,30982,6,29,6,1,0,0,0,4,358,92,24152,27642,23758,0,15,-11,2450,4,2170,7224,0,0,0,0,3
EUW1_6877154738',6,39,13,1,0,0,0,12,0,368,74,28494,29836,30726,3,79,13,1,0,2,0,3,394,118,31486,31788,33101,0,-26,-44,-2992,0,-1952,-2375,0,0,-2,0,9
EUW1_6877071441',4,41,6,0,0,0,0,11,1,357,85,24737,26656,33661,3,29,7,1,0,1,0,2,378,80,25341,29426,32705,0,-21,5,-604,-1,-2770,956,-1,0,-1,0,9
EUW1_6876888381',4,34,8,1,0,0,0,6,1,414,98,27476,32012,25756,8,32,6,1,1,1,0,6,411,90,26140,30659,27819,1,3,8,1336,2,1353,-2063,0,-1,-1,0,0
EUW1_6876852474',6,40,29,2,0,1,0,10,1,365,92,35678,31948,47309,8,33,15,0,0,0,0,5,306,78,29141,26797,33093,1,59,14,6537,14,5151,14216,2,0,1,0,5
EUW1_6876792463',5,40,6,0,0,0,0,10,0,321,85,22526,26209,25467,4,38,14,2,1,1,0,1,358,101,29149,29174,32446,1,-37,-16,-6623,-8,-2965,-6979,-2,-1,-1,0,9
EUW1_6882849481',2,23,17,1,0,1,0,14,0,312,80,26892,27323,40780,2,29,18,0,0,2,0,4,317,88,28118,28467,37600,0,-5,-8,-1226,-1,-1144,3180,1,0,-1,0,10
EUW1_6882671710',6,29,13,2,0,1,0,9,0,375,98,28629,29171,37681,6,29,13,0,1,0,0,6,334,78,27102,30223,26773,1,41,20,1527,0,-1052,10908,2,-1,1,0,3
EUW1_6882645847',0,53,11,0,0,0,0,16,0,313,79,27097,28441,40243,7,112,23,2,0,3,0,4,372,106,34609,33970,40234,0,-59,-27,-7512,-12,-5529,9,-2,0,-3,0,12
EUW1_6881647361',5,33,6,0,0,1,0,2,1,402,84,25774,29397,31708,1,99,10,0,0,0,0,4,343,99,26013,30809,23353,0,59,-15,-239,-4,-1412,8355,0,0,1,0,-2
EUW1_6881591912',2,25,17,0,0,1,0,10,0,335,97,29582,28893,35152,2,25,14,2,0,1,0,4,333,98,28974,28822,31691,1,2,-1,608,3,71,3461,-2,0,0,0,6
EUW1_6881170346',4,55,8,1,1,1,0,8,0,380,82,26285,29427,24878,3,131,11,1,0,0,0,7,352,106,26884,30902,23609,0,28,-24,-599,-3,-1475,1269,0,1,1,0,1
EUW1_6880401797',1,41,14,1,0,0,0,9,0,275,78,25564,27038,26123,4,26,12,0,0,1,0,3,370,70,27498,28776,31236,0,-95,8,-1934,2,-1738,-5113,1,0,-1,0,6
EUW1_6878098242',6,26,13,0,0,0,0,2,0,370,76,26592,29400,35253,0,30,20,1,0,0,0,1,363,104,31723,32587,35621,0,7,-28,-5131,-7,-3187,-368,-1,0,0,0,1
EUW1_6877508697',6,263,9,1,0,0,0,7,0,353,96,25036,28790,21255,6,30,9,0,0,1,0,3,372,76,27179,29642,27753,1,-19,20,-2143,0,-852,-6498,1,0,-1,0,4
EUW1_6874973754',3,72,6,0,0,0,0,7,0,256,95,22717,26233,21303,3,31,12,2,0,3,0,2,397,94,27840,31439,26998,0,-141,1,-5123,-6,-5206,-5695,-2,0,-3,0,5
EUW1_6873687391',8,34,13,1,1,0,0,13,1,333,88,27779,27711,32329,5,28,14,1,0,2,0,4,326,72,28730,28329,32837,1,7,16,-951,-1,-618,-508,0,1,-2,0,9
EUW1_6873687520',3,23,11,1,0,1,0,8,1,318,75,25348,25921,25526,3,29,15,1,1,2,0,5,357,88,29471,29969,32539,0,-39,-13,-4123,-4,-4048,-7013,0,-1,-1,0,3
EUW1_6873431908',5,33,11,0,0,0,0,14,0,318,84,25308,27716,30000,3,27,18,2,1,2,0,1,344,84,31657,29971,39187,0,-26,0,-6349,-7,-2255,-9187,-2,-1,-2,0,13
EUW1_6873334313',3,23,16,0,0,2,0,7,0,384,128,31555,33141,35912,1,35,7,2,0,1,0,5,354,72,24077,27988,29236,1,30,56,7478,9,5153,6676,-2,0,1,0,2
EUW1_6873285541',3,56,8,0,0,0,0,9,0,356,98,24862,28509,24446,4,70,15,2,0,2,0,1,414,96,30533,31910,33889,0,-58,2,-5671,-7,-3401,-9443,-2,0,-2,0,8
EUW1_6873179414',3,29,14,1,0,0,0,7,0,301,105,26759,28318,38326,4,34,20,1,0,1,0,2,327,94,31523,30657,46623,0,-26,11,-4764,-6,-2339,-8297,0,0,-1,0,5
EUW1_6873130506',1,22,5,0,0,1,0,10,0,416,108,25463,30822,24259,1,20,10,2,0,0,0,2,372,104,26557,30963,27084,0,44,4,-1094,-5,-141,-2825,-2,0,1,0,8
EUW1_6873021992',3,36,14,0,1,1,0,11,0,312,76,28975,27264,35562,5,294,21,2,0,1,0,5,309,96,31266,30188,40807,1,3,-20,-2291,-7,-2924,-5245,-2,1,0,0,6
EUW1_6876838438',2,30,15,1,0,2,0,10,1,368,131,29888,32625,35316,4,28,10,1,0,0,0,5,379,96,26713,31813,39060,0,-11,35,3175,5,812,-3744,0,0,2,0,5
EUW1_6876206424',0,38,14,1,0,1,0,8,0,381,93,29576,31799,34510,4,43,16,1,0,1,0,3,335,114,29293,31232,31438,1,46,-21,283,-2,567,3072,0,0,0,0,5
EUW1_6876181719',0,37,9,1,0,0,0,11,0,285,90,24790,26893,27007,7,31,23,1,0,2,0,3,340,90,32800,31233,39907,0,-55,0,-8010,-14,-4340,-12900,0,0,-2,0,8
EUW1_6875660369',4,62,10,1,1,0,0,7,1,381,99,26805,30604,27962,5,39,7,1,0,1,0,4,398,88,26733,29794,25883,1,-17,11,72,3,810,2079,0,1,-1,0,3
EUW1_6875621700',6,38,12,1,1,0,0,5,0,326,111,26628,28386,30210,4,32,15,0,0,0,0,5,364,70,27289,28703,27709,0,-38,41,-661,-3,-317,2501,1,1,0,0,0
EUW1_6875573200',1,22,9,0,0,1,0,12,1,370,88,26979,28312,28745,5,34,16,1,0,1,0,5,348,120,29722,33376,34065,0,22,-32,-2743,-7,-5064,-5320,-1,0,0,0,7
EUW1_6875323541',7,33,8,0,0,1,0,7,0,402,111,27160,30359,23743,8,34,12,2,0,0,0,0,446,81,28646,31553,31536,0,-44,30,-1486,-4,-1194,-7793,-2,0,1,0,7
EUW1_6873928438',5,41,4,0,0,0,0,12,0,358,96,24102,29454,23119,4,30,8,1,0,2,0,3,396,56,26587,28011,38521,1,-38,40,-2485,-4,1443,-15402,-1,0,-2,0,9
EUW1_6873896002',2,42,9,0,0,0,0,9,0,395,94,27035,30879,38174,6,23,12,2,0,0,0,5,312,81,26024,30273,38382,1,83,13,1011,-3,606,-208,-2,0,0,0,4
EUW1_6873878764',0,43,19,2,0,0,0,10,1,366,103,31265,32180,45113,2,23,2,0,0,3,0,8,313,81,21317,26701,21586,1,53,22,9948,17,5479,23527,2,0,-3,0,2
EUW1_6872496009',3,29,15,1,0,0,0,8,1,335,86,29564,30361,43690,5,27,19,1,0,2,0,4,347,98,30058,30682,35402,1,-12,-12,-494,-4,-321,8288,0,0,-2,0,4
EUW1_6871622525',1,25,8,0,0,0,0,14,1,296,92,25230,27700,39856,2,32,18,2,0,3,0,0,346,90,29737,31779,40756,0,-50,2,-4507,-10,-4079,-900,-2,0,-3,0,14
EUW1_6871567162',4,30,10,0,0,1,0,4,0,407,116,29265,32231,30171,6,87,10,1,0,0,0,6,368,109,25967,29824,22534,1,39,7,3298,0,2407,7637,-1,0,1,0,-2
EUW1_6871157193',2,28,17,1,0,1,0,10,1,357,74,30009,30925,34589,2,23,8,1,0,3,0,7,350,108,27065,29252,32622,1,7,-34,2944,9,1673,1967,0,0,-2,0,3
EUW1_6871117861',1,25,5,0,0,1,0,15,0,325,102,24791,28709,33915,8,68,19,2,0,2,0,3,395,92,32181,33314,35884,0,-70,10,-7390,-14,-4605,-1969,-2,0,-1,0,12
EUW1_6871059654',3,39,11,1,0,0,0,7,0,329,88,25656,29781,34900,3,36,10,1,1,1,0,0,366,118,28199,31206,29836,1,-37,-30,-2543,1,-1425,5064,0,-1,-1,0,7
EUW1_6871037256',5,27,8,0,0,1,0,6,0,387,79,25776,29645,29620,0,26,9,2,0,1,0,3,367,86,26231,30415,31272,1,20,-7,-455,-1,-770,-1652,-2,0,0,0,3
EUW1_6871077111',1,27,9,0,0,0,0,13,0,323,108,25766,29659,25291,4,38,10,2,1,1,0,2,359,95,27147,30897,32379,1,-36,13,-1381,-1,-1238,-7088,-2,-1,-1,0,11
EUW1_6871056839',3,24,16,1,0,1,0,7,0,405,123,31535,33088,48408,1,26,13,0,0,0,0,4,349,68,27595,29882,33847,1,56,55,3940,3,3206,14561,1,0,1,0,3
EUW1_6871040763',3,47,22,0,0,0,0,7,1,331,88,29531,30308,40255,1,33,12,2,0,3,0,7,320,123,28679,31455,35166,0,11,-35,852,10,-1147,5089,-2,0,-3,0,0
EUW1_6871021984',3,25,21,2,0,0,0,9,0,324,80,29300,30236,31971,4,23,14,0,0,1,0,5,334,68,27914,27671,35525,0,-10,12,1386,7,2565,-3554,2,0,-1,0,4
EUW1_6869615681',1,24,10,0,0,0,0,7,0,348,91,25988,29537,31356,1,23,12,2,0,0,0,1,370,98,26986,29838,27648,0,-22,-7,-998,-2,-301,3708,-2,0,0,0,6
EUW1_6869568263',2,34,9,0,0,0,0,8,0,319,86,24847,27118,27444,3,27,15,1,0,1,0,0,386,80,29403,29547,31046,0,-67,6,-4556,-6,-2429,-3602,-1,0,-1,0,8
EUW1_6869353713',2,24,21,2,1,3,0,9,0,350,97,35233,30643,44184,2,23,17,0,0,1,0,10,312,82,28959,28497,34274,1,38,15,6274,4,2146,9910,2,1,2,0,-1
EUW1_6869337964',2,30,6,0,0,0,0,15,0,329,92,23987,27790,25700,3,27,37,1,0,3,0,3,376,89,37627,36388,55464,0,-47,3,-13640,-31,-8598,-29764,-1,0,-3,0,12
EUW1_6868029104',4,23,14,1,1,1,0,9,1,375,108,30723,31479,29986,4,28,8,1,0,1,0,3,315,82,24370,28001,25735,1,60,26,6353,6,3478,4251,0,1,0,0,6
EUW1_6867979275',2,26,13,0,0,0,0,14,0,314,95,26411,29356,28816,6,29,11,2,0,2,0,1,323,99,28157,28046,33086,1,-9,-4,-1746,2,1310,-4270,-2,0,-2,0,13
EUW1_6866367618',3,30,9,2,0,1,0,10,1,416,72,26765,30822,26150,5,37,7,0,0,1,0,2,402,112,26869,30169,24339,1,14,-40,-104,2,653,1811,2,0,0,0,8
EUW1_6866339105',4,42,8,1,0,0,0,9,0,356,84,24912,27039,28395,1,28,15,1,0,2,0,2,373,96,29827,31701,39618,0,-17,-12,-4915,-7,-4662,-11223,0,0,-2,0,7
EUW1_6865645681',2,26,17,0,1,2,0,8,1,338,101,30259,29824,34806,4,37,10,2,0,1,0,6,341,83,26223,28239,31520,1,-3,18,4036,7,1585,3286,-2,1,1,0,2
EUW1_6864684882',1,28,15,0,1,1,0,11,0,360,82,29805,30069,33272,8,44,17,2,0,1,0,2,339,73,30959,30402,35405,1,21,9,-1154,-2,-333,-2133,-2,1,0,0,9
EUW1_6864655172',3,29,15,1,0,1,0,10,0,334,93,27767,28897,41477,4,23,9,1,0,0,0,3,342,67,25384,26239,29873,1,-8,26,2383,6,2658,11604,0,0,1,0,7
EUW1_6864646887',4,44,11,0,1,1,0,7,1,384,100,28773,32491,32928,2,24,3,1,0,0,0,4,351,92,22898,27336,25915,1,33,8,5875,8,5155,7013,-1,1,1,0,3
EUW1_6864588159',5,26,12,1,0,1,0,7,1,376,67,27846,28522,25357,5,26,14,1,0,0,0,3,345,133,28468,31934,24422,0,31,-66,-622,-2,-3412,935,0,0,1,0,4
EUW1_6861125075',0,52,8,0,0,2,0,11,0,358,78,26042,29715,21960,4,188,10,1,0,0,0,3,336,98,26141,29594,37210,1,22,-20,-99,-2,121,-15250,-1,0,2,0,8
EUW1_6881016328',5,32,9,2,0,0,0,11,0,412,88,26313,31592,29477,5,29,14,0,0,0,0,2,343,124,27974,31305,29167,1,69,-36,-1661,-5,287,310,2,0,0,0,9
EUW1_6880992493',4,27,18,2,0,0,0,10,1,330,110,28882,29100,34176,1,20,17,0,0,0,0,2,301,75,29055,29404,40369,0,29,35,-173,1,-304,-6193,2,0,0,0,8
EUW1_6883185063',4,33,13,2,1,1,0,10,1,364,116,29081,31771,26049,3,22,7,0,0,0,0,6,362,84,25991,29882,27348,1,2,32,3090,6,1889,-1299,2,1,1,0,4
EUW1_6883063305',3,139,13,0,0,1,0,11,0,376,83,28616,29714,32320,3,97,11,2,0,0,0,5,325,72,25561,27899,32831,1,51,11,3055,2,1815,-511,-2,0,1,0,6
EUW1_6882913392',3,142,10,1,0,0,0,9,1,406,82,27894,29619,38258,9,36,21,0,0,2,0,6,370,82,33055,33077,33394,0,36,0,-5161,-11,-3458,4864,1,0,-2,0,3
EUW1_6882806864',5,20,8,2,0,0,0,13,0,383,86,25996,29074,30629,3,42,16,0,0,2,0,3,380,89,29704,32747,34388,0,3,-3,-3708,-8,-3673,-3759,2,0,-2,0,10
EUW1_6882569585',4,25,12,0,0,1,0,14,1,324,84,27233,25859,33273,6,32,19,2,0,3,0,4,324,69,32395,30317,38065,0,0,15,-5162,-7,-4458,-4792,-2,0,-2,0,10
EUW1_6882548560',6,34,19,1,0,3,0,9,0,369,96,32053,30135,34045,2,26,8,0,0,0,0,10,295,80,23908,25763,32252,1,74,16,8145,11,4372,1793,1,0,3,0,-1
EUW1_6882516131',0,21,12,1,0,1,0,17,0,367,90,27816,29561,36141,1,21,10,1,0,1,0,4,371,94,28603,29833,33438,0,-4,-4,-787,2,-272,2703,0,0,0,0,13
EUW1_6876971260',3,29,4,0,0,0,0,13,0,380,87,23948,27345,25874,6,34,19,2,0,2,0,2,408,100,31450,33838,35622,0,-28,-13,-7502,-15,-6493,-9748,-2,0,-2,0,11
EUW1_6876931450',1,25,10,0,0,0,0,10,0,292,78,23953,25617,30451,4,23,21,2,0,2,0,0,374,91,32051,31944,42990,0,-82,-13,-8098,-11,-6327,-12539,-2,0,-2,0,10
EUW1_6876900341',3,93,26,1,0,3,0,10,0,348,86,34040,30710,40638,3,42,10,0,0,1,0,9,323,89,26577,26733,24285,1,25,-3,7463,16,3977,16353,1,0,2,0,1
EUW1_6875062735',3,41,25,1,0,2,0,9,1,360,99,33753,30568,41219,0,26,14,1,0,0,0,7,294,89,26925,27951,39321,1,66,10,6828,11,2617,1898,0,0,2,0,2
EUW1_6875050645',5,24,13,1,0,2,0,10,0,360,96,29533,29059,39075,3,39,14,1,0,1,0,4,310,83,27956,29174,33007,1,50,13,1577,-1,-115,6068,0,0,1,0,6
EUW1_6882827113',7,32,12,1,0,0,0,8,1,326,79,26002,27830,26202,3,24,12,1,0,0,0,2,352,101,27084,29844,32620,0,-26,-22,-1082,0,-2014,-6418,0,0,0,0,6
EUW1_6882742085',4,29,10,1,0,0,0,8,0,357,100,27535,28699,33209,5,29,13,1,0,2,0,0,399,99,28149,30678,24772,0,-42,1,-614,-3,-1979,8437,0,0,-2,0,8
EUW1_6880931434',3,48,7,0,0,0,0,7,0,415,80,26578,30395,24569,2,34,7,1,0,0,0,2,392,108,25414,29496,27967,0,23,-28,1164,0,899,-3398,-1,0,0,0,5
EUW1_6880887938',4,41,20,0,0,1,0,7,0,338,70,30612,29681,41780,4,86,18,1,0,1,0,5,338,84,30088,30098,35288,0,0,-14,524,2,-417,6492,-1,0,0,0,2
EUW1_6879610245',3,24,4,0,0,1,0,6,1,364,84,24027,28716,24936,4,39,9,1,0,0,0,3,390,98,26078,31660,27623,0,-26,-14,-2051,-5,-2944,-2687,-1,0,1,0,3
EUW1_6879585346',5,23,21,1,0,2,0,9,1,381,89,34085,31716,41161,10,35,6,1,0,1,0,9,291,82,23002,25563,20034,1,90,7,11083,15,6153,21127,0,0,1,0,0
EUW1_6868271873',2,31,24,1,0,2,0,12,0,318,97,32858,31265,52781,5,57,15,1,0,1,0,8,313,66,28431,26653,35468,1,5,31,4427,9,4612,17313,0,0,1,0,4
EUW1_6868163787',2,58,3,0,1,0,0,7,0,392,96,23322,29111,13581,4,25,6,1,0,1,0,0,401,86,25235,29819,20013,0,-9,10,-1913,-3,-708,-6432,-1,1,-1,0,7
EUW1_6866307449',3,27,9,2,1,0,0,3,0,366,92,25311,30111,18298,5,28,7,0,0,0,0,2,406,96,26239,30080,22863,1,-40,-4,-928,2,31,-4565,2,1,0,0,1
EUW1_6875352366',4,34,9,0,0,1,0,8,0,306,120,26393,30024,32302,4,25,9,2,0,1,0,3,396,87,27038,29185,31752,0,-90,33,-645,0,839,550,-2,0,0,0,5
EUW1_6875289245',2,134,11,0,0,2,0,4,1,360,126,28740,32421,34652,1,27,8,1,0,0,0,6,383,77,25495,30072,25118,1,-23,49,3245,3,2349,9534,-1,0,2,0,-2
EUW1_6873787890',6,31,14,0,0,2,0,9,0,355,92,30586,29983,30681,2,28,12,2,0,0,0,4,336,80,27308,26677,29770,0,19,12,3278,2,3306,911,-2,0,2,0,5
EUW1_6873768186',6,32,13,1,0,1,0,15,0,365,90,28742,30470,31811,5,58,14,1,1,1,0,4,344,75,28241,28243,29073,0,21,15,501,-1,2227,2738,0,-1,0,0,11
EUW1_6873760097',4,167,18,1,0,1,0,6,1,334,84,31125,30780,37298,1,22,15,0,0,0,0,7,349,102,27941,29655,29951,1,-15,-18,3184,3,1125,7347,1,0,1,0,-1
EUW1_6872941702',4,34,12,1,0,1,0,8,0,385,100,28929,30701,35745,5,27,10,1,0,0,0,9,328,87,26481,29161,32459,0,57,13,2448,2,1540,3286,0,0,1,0,-1
EUW1_6872894521',0,28,10,1,0,0,0,7,1,361,92,27129,28527,28336,4,30,20,0,0,0,0,4,349,96,30607,29670,36270,0,12,-4,-3478,-10,-1143,-7934,1,0,0,0,3
EUW1_6872389063',3,29,15,0,0,1,0,8,1,364,81,27752,29548,35046,1,40,12,1,0,0,0,2,352,74,27742,27601,34639,1,12,7,10,3,1947,407,-1,0,1,0,6
EUW1_6872367223',1,22,17,0,0,0,0,12,0,345,97,29497,30505,39839,3,28,14,1,0,0,0,4,394,77,29799,32025,32948,0,-49,20,-302,3,-1520,6891,-1,0,0,0,8
EUW1_6872334494',6,32,15,1,0,1,0,1,1,329,100,29696,29863,30051,5,35,15,0,1,0,0,3,377,98,29331,29523,29208,0,-48,2,365,0,340,843,1,-1,1,0,-2
EUW1_6872316855',6,25,20,1,0,1,0,5,1,347,72,30173,28539,40008,2,30,12,1,0,0,0,1,304,92,27526,27412,32460,1,43,-20,2647,8,1127,7548,0,0,1,0,4
EUW1_6872292451',4,28,15,0,0,0,0,10,0,312,80,27956,27551,41345,3,90,11,1,0,0,0,2,315,94,26000,28503,31517,0,-3,-14,1956,4,-952,9828,-1,0,0,0,8
EUW1_6872279637',3,87,19,1,0,1,0,13,1,314,76,30153,28501,31293,5,32,16,1,0,2,0,5,371,91,30631,29182,30770,0,-57,-15,-478,3,-681,523,0,0,-1,0,8
EUW1_6872258496',0,34,11,0,0,0,0,9,1,291,108,25447,30310,26343,1,34,10,2,0,3,0,1,395,101,27577,29923,29667,0,-104,7,-2130,1,387,-3324,-2,0,-3,0,8
EUW1_6872227865',7,34,13,0,1,2,0,9,1,376,66,28348,28000,31454,5,33,11,1,0,0,0,8,350,95,27574,28794,26243,0,26,-29,774,2,-794,5211,-1,1,2,0,1
EUW1_6872208492',6,56,13,1,0,0,0,9,0,346,76,27542,28731,31133,2,29,15,0,0,2,0,3,340,92,29219,30560,34597,0,6,-16,-1677,-2,-1829,-3464,1,0,-2,0,6
EUW1_6871147950',1,79,12,2,0,0,0,10,1,330,100,25908,30133,26887,5,62,9,0,0,0,0,4,384,95,25915,29810,26977,1,-54,5,-7,3,323,-90,2,0,0,0,6
EUW1_6871120597',3,32,5,1,0,0,0,8,0,339,84,23623,28668,31622,2,24,11,1,0,0,0,4,363,93,25784,30556,33335,1,-24,-9,-2161,-6,-1888,-1713,0,0,0,0,4
EUW1_6883641315',3,34,8,2,1,2,0,7,0,394,105,28070,29675,28520,3,31,12,0,0,1,0,7,381,84,28064,30064,24858,1,13,21,6,-4,-389,3662,2,1,1,0,0
EUW1_6883434148',4,45,11,1,1,0,0,12,1,333,92,26296,29724,29210,4,27,18,1,0,2,0,0,382,84,31063,29905,39664,0,-49,8,-4767,-7,-181,-10454,0,1,-2,0,12
EUW1_6883395553',7,82,8,2,0,0,0,16,0,350,69,25687,28081,25543,4,38,10,0,0,2,0,3,363,74,27116,28779,28007,1,-13,-5,-1429,-2,-698,-2464,2,0,-2,0,13
EUW1_6882952958',9,73,12,0,0,1,0,8,1,369,77,28078,28283,25497,2,27,10,2,0,0,0,2,380,59,25697,26703,27723,1,-11,18,2381,2,1580,-2226,-2,0,1,0,6
EUW1_6882886412',3,94,15,1,0,2,0,9,1,424,70,31089,31800,34744,5,28,9,1,1,1,0,4,339,107,26172,29607,22358,1,85,-37,4917,6,2193,12386,0,-1,1,0,5
EUW1_6882838090',6,32,12,0,1,1,0,11,1,376,102,29051,31512,35464,1,25,11,1,0,1,0,4,372,78,28013,30490,38644,1,4,24,1038,1,1022,-3180,-1,1,0,0,7
EUW1_6882800213',4,161,5,0,0,0,0,5,1,402,87,24770,30123,30582,4,55,10,1,0,1,0,4,393,96,27927,32584,32254,0,9,-9,-3157,-5,-2461,-1672,-1,0,-1,0,1
EUW1_6882278278',2,33,11,0,0,0,0,9,1,353,78,26717,29298,31326,3,36,11,1,0,1,0,2,373,94,27447,29158,27362,0,-20,-16,-730,0,140,3964,-1,0,-1,0,7
EUW1_6882265193',5,23,7,0,0,0,0,12,0,325,84,23603,25473,29701,3,30,20,2,0,1,0,2,370,102,30225,31101,37692,0,-45,-18,-6622,-13,-5628,-7991,-2,0,-1,0,10
EUW1_6882197134',6,147,10,1,1,0,0,8,0,371,85,28125,30305,42403,5,28,8,0,0,1,0,4,354,92,25172,28307,27787,1,17,-7,2953,2,1998,14616,1,1,-1,0,4
EUW1_6881844130',4,25,14,0,0,0,0,10,0,304,75,26038,27196,32469,1,26,11,2,0,3,0,2,401,116,30393,31884,34893,0,-97,-41,-4355,3,-4688,-2424,-2,0,-3,0,8
EUW1_6881773403',5,34,13,2,0,0,0,5,1,423,94,29870,34316,30743,4,68,3,0,0,1,0,5,398,101,24767,30665,24197,1,25,-7,5103,10,3651,6546,2,0,-1,0,0
EUW1_6880718909',1,25,11,0,0,0,0,9,0,388,102,29497,32370,31220,3,21,9,2,0,1,0,4,418,82,26517,30753,29922,1,-30,20,2980,2,1617,1298,-2,0,-1,0,5
EUW1_6880676692',2,24,20,1,0,3,0,8,1,365,104,32943,32441,37105,6,28,12,1,0,1,0,9,354,79,27343,29091,31388,0,11,25,5600,8,3350,5717,0,0,2,0,-1
EUW1_6880630703',5,31,14,1,0,0,0,10,0,338,76,28056,28698,35524,4,23,15,1,0,0,0,4,365,90,28207,29544,38241,0,-27,-14,-151,-1,-846,-2717,0,0,0,0,6
EUW1_6882139842',3,22,6,0,0,0,0,11,1,349,54,23558,25348,26528,2,36,18,1,0,2,0,2,343,102,30122,32019,48581,0,6,-48,-6564,-12,-6671,-22053,-1,0,-2,0,9
EUW1_6882093107',2,24,9,0,0,0,0,12,0,319,74,25844,29447,32531,6,29,18,2,0,2,0,2,365,114,30488,32562,40344,0,-46,-40,-4644,-9,-3115,-7813,-2,0,-2,0,10
EUW1_6882039779',3,17,22,1,0,3,0,8,1,339,102,33668,31126,48906,3,24,18,0,0,1,0,11,298,70,28851,27892,39809,0,41,32,4817,4,3234,9097,1,0,2,0,-3
EUW1_6881984031',7,25,20,2,0,1,0,13,1,349,83,30536,30643,35532,3,24,16,0,0,2,0,2,332,75,29788,29485,38544,0,17,8,748,4,1158,-3012,2,0,-1,0,11
EUW1_6881925581',6,23,16,1,0,1,0,5,1,351,120,29834,30586,39488,2,21,8,0,0,0,0,7,297,64,22930,25292,28060,1,54,56,6904,8,5294,11428,1,0,1,0,-2
EUW1_6881232559',6,22,17,2,0,1,0,7,1,384,111,31074,33260,37164,3,25,6,0,0,0,0,6,298,88,23327,29344,27631,1,86,23,7747,11,3916,9533,2,0,1,0,1
EUW1_6881173448',5,28,5,1,1,1,0,8,1,366,84,24482,27915,25500,3,67,10,0,0,1,0,4,373,87,26921,29907,31442,0,-7,-3,-2439,-5,-1992,-5942,1,1,0,0,4
EUW1_6881125049',3,28,11,2,1,1,0,9,0,332,117,27276,29461,30285,5,30,10,0,0,0,0,6,346,84,26506,28707,28982,1,-14,33,770,1,754,1303,2,1,1,0,3
EUW1_6881097221',5,29,18,1,1,7,1,8,1,418,114,35532,33155,31545,2,13,3,0,0,0,0,9,266,70,19512,21585,18619,1,152,44,16020,15,11570,12926,1,1,7,1,-1
EUW1_6881067958',5,137,3,1,0,0,0,7,1,372,80,23799,28880,27106,2,31,14,1,0,1,0,5,380,112,28754,32918,31173,0,-8,-32,-4955,-11,-4038,-4067,0,0,-1,0,2
EUW1_6880481902',4,54,12,1,0,0,0,15,0,310,60,25477,26460,33066,2,138,20,0,0,4,0,3,343,103,32731,32392,38063,0,-33,-43,-7254,-8,-5932,-4997,1,0,-4,0,12
EUW1_6880424065',2,30,11,2,0,0,0,6,1,353,108,26758,33231,28399,3,36,7,0,0,0,0,5,370,87,25040,29431,29392,1,-17,21,1718,4,3800,-993,2,0,0,0,1
EUW1_6880375494',3,23,5,1,0,0,0,11,0,392,94,24252,29961,21985,5,137,11,1,1,1,0,2,406,114,28327,33118,28991,0,-14,-20,-4075,-6,-3157,-7006,0,-1,-1,0,9
EUW1_6880308340',3,24,15,1,0,1,0,7,1,333,95,29898,29946,33006,4,28,11,1,0,1,0,8,327,70,24846,27215,28915,1,6,25,5052,4,2731,4091,0,0,0,0,-1
EUW1_6879688231',4,130,11,1,0,1,0,8,1,355,82,26791,28874,34064,7,43,14,1,0,1,0,4,344,116,28722,30674,34004,0,11,-34,-1931,-3,-1800,60,0,0,0,0,4
EUW1_6879635205',4,42,17,0,0,1,0,11,0,378,85,29998,29833,37485,1,24,14,2,0,0,0,3,329,78,27517,27313,31623,1,49,7,2481,3,2520,5862,-2,0,1,0,8
EUW1_6879590344',3,48,13,0,0,1,0,8,0,357,73,28552,29983,30561,6,26,14,1,0,1,0,5,330,102,27997,28621,26348,0,27,-29,555,-1,1362,4213,-1,0,0,0,3
EUW1_6879563676',8,38,12,2,0,0,0,2,0,401,106,28844,33300,35085,8,32,11,0,0,0,0,5,335,86,26368,29411,33881,1,66,20,2476,1,3889,1204,2,0,0,0,-3
EUW1_6882869840',3,30,8,0,0,0,0,11,1,328,93,24645,27325,25461,1,27,15,2,1,1,0,1,384,110,30147,32576,28738,0,-56,-17,-5502,-7,-5251,-3277,-2,-1,-1,0,10
EUW1_6875284884',4,28,14,0,0,3,0,3,0,357,75,29657,29871,38947,2,27,11,1,0,0,0,6,296,91,25395,28852,30649,1,61,-16,4262,3,1019,8298,-1,0,3,0,-3
EUW1_6875257852',3,27,11,2,0,0,0,11,0,314,82,25485,27547,32898,3,27,20,0,0,1,0,0,354,98,31696,30423,41917,0,-40,-16,-6211,-9,-2876,-9019,2,0,-1,0,11
EUW1_6873930058',5,28,11,0,0,0,0,12,0,350,96,27567,28668,32920,0,25,16,1,0,2,0,3,390,83,29938,30716,34852,0,-40,13,-2371,-5,-2048,-1932,-1,0,-2,0,9
EUW1_6873892113',2,29,15,0,0,1,0,9,0,342,82,29841,28922,38321,3,32,29,1,0,0,0,4,329,58,32747,30910,48122,0,13,24,-2906,-14,-1988,-9801,-1,0,1,0,5
EUW1_6872944788',4,36,8,0,0,0,0,10,1,365,100,27312,28484,23372,6,25,11,2,0,1,0,4,384,104,28487,31317,24061,0,-19,-4,-1175,-3,-2833,-689,-2,0,-1,0,6
EUW1_6866558360',1,28,10,0,0,1,0,6,0,395,80,27268,31606,34890,3,27,16,2,0,1,0,4,355,104,28827,30745,36088,0,40,-24,-1559,-6,861,-1198,-2,0,0,0,2
EUW1_6866535837',4,24,13,2,1,2,0,9,0,397,120,30117,32003,30516,6,40,7,0,0,0,0,6,367,64,23844,28912,25617,1,30,56,6273,6,3091,4899,2,1,2,0,3
EUW1_6866384539',1,28,13,1,0,0,0,7,0,370,90,27295,28969,33958,6,54,11,1,0,1,0,1,342,79,27733,27745,28770,0,28,11,-438,2,1224,5188,0,0,-1,0,6
EUW1_6866350203',3,25,9,0,0,0,0,11,1,340,94,24994,29405,27103,3,29,16,1,1,2,0,2,381,93,30666,32107,34334,0,-41,1,-5672,-7,-2702,-7231,-1,-1,-2,0,9
EUW1_6864680560',6,27,12,1,0,1,0,6,1,405,99,29678,32477,29146,7,161,9,0,0,0,0,6,358,76,25168,28223,30550,1,47,23,4510,3,4254,-1404,1,0,1,0,0
EUW1_6864664484',8,30,18,2,0,1,0,9,1,366,102,31213,32529,45005,4,28,11,0,0,0,0,4,367,81,27563,29462,27031,1,-1,21,3650,7,3067,17974,2,0,1,0,5
EUW1_6864638821',0,20,14,0,0,1,0,10,1,339,74,29814,29694,39091,4,31,15,2,0,0,0,4,331,122,28760,31305,38407,1,8,-48,1054,-1,-1611,684,-2,0,1,0,6
EUW1_6864207438',5,29,19,1,0,3,0,8,1,393,102,32361,31349,40935,2,28,15,1,0,0,0,6,359,87,28783,31979,36077,0,34,15,3578,4,-630,4858,0,0,3,0,2
EUW1_6864151863',1,29,18,0,0,1,0,10,1,350,90,29813,29192,34040,0,25,14,1,0,0,0,4,334,82,28262,29680,32929,1,16,8,1551,4,-488,1111,-1,0,1,0,6
EUW1_6863749527',3,24,7,0,0,0,0,17,0,310,72,22972,25470,25595,2,24,22,2,1,3,0,1,370,119,33633,32432,37771,0,-60,-47,-10661,-15,-6962,-12176,-2,-1,-3,0,16
EUW1_6863679262',4,35,8,0,0,1,0,14,0,346,83,25645,27307,29171,5,24,16,2,0,2,0,3,366,104,29544,31222,35685,1,-20,-21,-3899,-8,-3915,-6514,-2,0,-1,0,11
EUW1_6863602654',4,242,13,1,0,1,0,10,0,389,106,29304,30950,38172,5,22,16,1,0,2,0,4,349,100,30745,30221,40254,0,40,6,-1441,-3,729,-2082,0,0,-1,0,6
EUW1_6863556792',3,25,16,0,1,0,0,12,0,324,64,28464,27949,40267,4,30,22,1,0,1,0,3,335,96,32651,28428,43195,0,-11,-32,-4187,-6,-479,-2928,-1,1,-1,0,9
EUW1_6883700215',1,99,4,0,1,0,0,6,1,392,108,24751,30414,28564,1,291,10,2,0,2,0,2,374,92,27707,30524,27230,0,18,16,-2956,-6,-110,1334,-2,1,-2,0,4
EUW1_6882414143',4,49,6,0,0,0,0,11,0,341,92,25599,27938,38638,3,91,13,2,0,2,0,4,348,99,28772,31096,30559,0,-7,-7,-3173,-7,-3158,8079,-2,0,-2,0,7
EUW1_6880928702',7,34,9,0,0,0,0,7,1,337,84,24733,29134,27168,8,32,7,0,0,0,0,0,351,90,24203,28341,32019,1,-14,-6,530,2,793,-4851,0,0,0,0,7
EUW1_6879733532',2,25,7,1,0,0,0,12,0,351,82,24558,28789,26023,2,26,10,1,1,2,0,3,421,114,29700,31335,28103,0,-70,-32,-5142,-3,-2546,-2080,0,-1,-2,0,9
EUW1_6879487925',5,26,9,0,0,0,0,10,0,368,78,25692,27424,24933,2,26,14,2,0,1,0,3,390,121,30301,32610,34469,0,-22,-43,-4609,-5,-5186,-9536,-2,0,-1,0,7
EUW1_6879409045',2,183,19,2,0,1,0,5,0,379,96,30345,32686,36596,4,48,10,0,0,0,0,7,367,66,25981,27129,31064,1,12,30,4364,9,5557,5532,2,0,1,0,-2
EUW1_6875115446',2,60,9,1,0,1,0,12,0,325,73,25561,27795,25513,3,65,21,1,0,3,0,4,369,102,31786,32920,39578,0,-44,-29,-6225,-12,-5125,-14065,0,0,-2,0,8
EUW1_6873788804',5,71,15,1,0,0,0,11,0,367,94,28357,33179,33567,4,32,8,0,0,2,0,5,372,98,27241,30843,36154,1,-5,-4,1116,7,2336,-2587,1,0,-2,0,6
EUW1_6873767408',5,29,13,1,0,0,0,7,1,388,98,27870,30821,28273,4,38,5,1,1,0,0,0,394,105,24780,29724,23230,1,-6,-7,3090,8,1097,5043,0,-1,0,0,7
EUW1_6882950489',2,26,9,0,0,0,0,13,0,352,83,24487,29426,31708,4,41,11,2,0,2,0,1,419,73,28815,29838,31615,0,-67,10,-4328,-2,-412,93,-2,0,-2,0,12
EUW1_6881713219',4,29,6,0,0,0,0,12,0,348,142,24971,32219,22707,1,26,6,1,0,1,0,4,357,66,24485,27499,28110,1,-9,76,486,0,4720,-5403,-1,0,-1,0,8
EUW1_6881656535',2,30,16,1,0,2,0,10,0,404,77,31010,32418,34391,3,30,9,0,0,0,0,7,331,94,26046,27279,33927,1,73,-17,4964,7,5139,464,1,0,2,0,3
EUW1_6880329652',5,27,23,0,0,2,0,4,1,350,95,33871,32721,49037,1,24,16,1,0,0,0,11,338,82,29125,30356,31794,1,12,13,4746,7,2365,17243,-1,0,2,0,-7
EUW1_6880153686',7,36,20,0,0,1,0,11,1,374,103,32096,32443,34953,3,30,15,2,0,1,0,1,390,80,29529,30962,36740,1,-16,23,2567,5,1481,-1787,-2,0,0,0,10
EUW1_6879419871',2,37,13,0,0,1,0,9,0,354,101,28963,30016,30383,4,31,8,1,0,0,0,4,354,69,24674,27243,24528,0,0,32,4289,5,2773,5855,-1,0,1,0,5
EUW1_6878775949',4,45,22,1,0,1,0,8,1,365,78,33028,32193,38833,3,24,14,0,1,0,0,6,343,99,29147,30368,37657,0,22,-21,3881,8,1825,1176,1,-1,1,0,2
EUW1_6878653097',3,28,19,2,1,2,0,11,1,362,70,31064,31201,27693,4,42,10,0,0,0,0,6,328,96,26970,28299,30619,1,34,-26,4094,9,2902,-2926,2,1,2,0,5
EUW1_6878529280',6,35,17,1,0,1,0,8,1,342,85,30094,27870,36907,5,37,17,1,0,1,0,4,329,106,28956,29477,30600,0,13,-21,1138,0,-1607,6307,0,0,0,0,4
EUW1_6878470136',4,27,8,0,0,1,0,7,1,360,104,26330,30273,25312,4,22,10,2,0,0,0,1,369,107,25988,29798,28144,0,-9,-3,342,-2,475,-2832,-2,0,1,0,6
EUW1_6878423112',2,24,23,1,1,1,0,13,1,305,94,32007,30429,42391,5,28,17,1,0,1,0,3,297,104,29697,29049,44456,1,8,-10,2310,6,1380,-2065,0,1,0,0,10
EUW1_6878039817',3,98,10,0,0,0,0,8,0,338,100,25694,29591,27521,2,24,10,2,0,0,0,3,369,86,25989,30382,34841,0,-31,14,-295,0,-791,-7320,-2,0,0,0,5
EUW1_6877616223',6,30,15,1,1,3,0,14,0,352,108,31325,32054,36810,4,29,18,1,0,1,0,7,341,76,29434,29401,31433,0,11,32,1891,-3,2653,5377,0,1,2,0,7
EUW1_6876501232',2,43,10,2,0,1,0,4,1,360,108,26769,28421,24194,4,37,6,0,0,0,0,5,351,80,23659,28145,26070,1,9,28,3110,4,276,-1876,2,0,1,0,-1
EUW1_6875931256',4,27,22,0,1,1,0,10,0,338,70,30982,31070,38051,1,22,15,1,0,0,0,4,312,92,28729,28690,36428,0,26,-22,2253,7,2380,1623,-1,1,1,0,6
EUW1_6875139975',2,32,14,0,0,0,0,16,1,343,89,27805,28770,34000,5,62,11,2,0,2,0,3,410,69,28518,31019,29300,0,-67,20,-713,3,-2249,4700,-2,0,-2,0,13
EUW1_6873779910',4,65,16,2,1,1,0,8,0,317,114,29840,29974,33479,3,67,12,0,0,1,0,4,351,74,27078,28167,37138,1,-34,40,2762,4,1807,-3659,2,1,0,0,4
EUW1_6872402038',1,19,11,1,0,0,0,12,1,278,62,24027,26631,41260,6,30,8,0,0,2,0,1,385,91,27689,30311,35083,0,-107,-29,-3662,3,-3680,6177,1,0,-2,0,11
EUW1_6872370282',3,60,8,1,0,1,0,10,0,318,76,25762,26358,24398,6,31,11,0,0,1,0,8,341,98,27515,26914,24638,1,-23,-22,-1753,-3,-556,-240,1,0,0,0,2
EUW1_6883536491',9,39,11,1,0,1,0,5,1,389,93,28988,30242,30768,2,27,11,0,0,2,0,11,384,82,27673,30365,30386,0,5,11,1315,0,-123,382,1,0,-1,0,-6
EUW1_6883492416',5,31,24,2,1,1,0,6,1,340,50,32072,28481,47552,4,49,18,0,0,0,0,7,297,67,27875,26070,38718,1,43,-17,4197,6,2411,8834,2,1,1,0,-1
EUW1_6883447015',6,40,10,0,0,2,0,10,1,388,100,28360,30664,31141,5,93,11,2,0,0,0,7,368,102,28475,30602,38142,1,20,-2,-115,-1,62,-7001,-2,0,2,0,3
EUW1_6883035678',4,29,10,0,0,1,0,9,0,364,84,27975,28846,35636,6,323,13,2,0,0,0,7,408,80,27642,29555,35550,1,-44,4,333,-3,-709,86,-2,0,1,0,2
EUW1_6882968975',4,31,12,1,0,0,0,9,1,373,101,29242,30840,27167,2,34,14,1,0,1,0,2,395,73,28853,30607,30357,1,-22,28,389,-2,233,-3190,0,0,-1,0,7
EUW1_6882919868',8,34,8,1,0,0,0,8,0,392,80,25167,29533,27895,5,28,11,1,0,1,0,3,419,102,28912,31640,28094,0,-27,-22,-3745,-3,-2107,-199,0,0,-1,0,5
EUW1_6882815127',8,35,10,0,0,1,0,11,0,350,92,27944,27238,32793,6,36,14,1,0,1,0,4,316,71,27680,26169,24697,1,34,21,264,-4,1069,8096,-1,0,0,0,7
EUW1_6882762360',1,24,15,0,0,1,0,10,0,365,114,30550,31328,35323,5,30,17,1,0,2,0,4,391,96,31181,32238,33456,1,-26,18,-631,-2,-910,1867,-1,0,-1,0,6
EUW1_6882727566',5,33,17,0,1,1,0,11,1,356,79,30220,31723,39679,6,99,10,1,0,1,0,6,328,108,25572,27927,28335,1,28,-29,4648,7,3796,11344,-1,1,0,0,5
EUW1_6876365244',2,27,18,1,0,1,0,7,0,353,92,31319,32691,40886,4,28,15,1,0,0,0,2,351,91,28827,30761,35628,1,2,1,2492,3,1930,5258,0,0,1,0,5
EUW1_6876324387',6,31,28,2,0,2,0,11,1,314,111,35751,31540,45726,3,29,12,0,0,1,0,7,299,82,26567,26262,31903,1,15,29,9184,16,5278,13823,2,0,1,0,4
EUW1_6876289418',5,42,10,0,0,1,0,11,0,355,74,27240,29466,29639,2,26,15,1,0,1,0,5,374,112,30290,30852,35364,1,-19,-38,-3050,-5,-1386,-5725,-1,0,0,0,6
EUW1_6876253454',2,23,13,1,0,0,0,12,0,356,94,26328,31463,31302,3,32,14,1,0,1,0,3,376,72,28602,29245,30657,0,-20,22,-2274,-1,2218,645,0,0,-1,0,9
EUW1_6876220996',3,21,15,2,0,0,0,12,1,339,98,28739,29548,32723,2,31,19,0,0,1,0,3,396,81,31506,31685,40792,0,-57,17,-2767,-4,-2137,-8069,2,0,-1,0,9
EUW1_6876175994',1,30,12,0,0,0,0,6,0,356,88,26465,28277,25983,3,41,12,2,1,2,0,1,395,74,28909,29963,33044,0,-39,14,-2444,0,-1686,-7061,-2,-1,-2,0,5
EUW1_6876113457',5,31,8,0,0,0,0,6,0,375,84,25787,28641,36251,8,35,16,2,1,2,0,4,340,100,29836,30151,33934,1,35,-16,-4049,-8,-1510,2317,-2,-1,-2,0,2
EUW1_6876052055',3,71,16,2,0,2,0,11,0,365,106,30750,30785,40686,3,27,19,0,1,2,0,7,353,76,32371,31998,40053,0,12,30,-1621,-3,-1213,633,2,-1,0,0,4
EUW1_6875965175',1,24,12,1,0,0,0,12,1,359,76,26813,28141,32078,4,30,13,0,0,2,0,2,369,100,29837,31144,32948,0,-10,-24,-3024,-1,-3003,-870,1,0,-2,0,10
EUW1_6875893390',4,29,13,0,0,0,0,11,0,326,76,26695,25875,36375,2,30,21,1,0,3,0,3,300,92,32446,30751,41363,0,26,-16,-5751,-8,-4876,-4988,-1,0,-3,0,8
EUW1_6883742822',6,33,19,1,0,1,0,6,1,343,83,30858,28448,41437,3,31,13,1,0,0,0,7,363,88,28824,30194,39529,1,-20,-5,2034,6,-1746,1908,0,0,1,0,-1
EUW1_6883497524',2,27,9,0,0,1,0,13,0,364,90,27884,28211,30115,4,29,19,2,0,2,0,5,345,117,31033,32184,37597,1,19,-27,-3149,-10,-3973,-7482,-2,0,-1,0,8
EUW1_6877537896',7,34,8,0,0,0,0,5,1,373,88,25180,30449,30134,6,28,6,2,0,0,0,3,370,104,24232,30466,30804,0,3,-16,948,2,-17,-670,-2,0,0,0,2
EUW1_6877473091',6,33,21,2,1,2,0,5,1,352,108,32460,30719,34903,2,38,10,0,0,0,0,9,340,68,24629,26152,24146,1,12,40,7831,11,4567,10757,2,1,2,0,-4
EUW1_6877232886',4,27,19,2,0,1,0,5,1,338,88,30773,31500,47472,6,69,14,0,1,1,0,6,367,88,28466,30118,37786,1,-29,0,2307,5,1382,9686,2,-1,0,0,-1
EUW1_6877153997',2,41,12,0,0,1,0,9,1,359,100,28837,29635,36353,5,25,13,2,0,2,0,6,329,69,27091,28576,35087,0,30,31,1746,-1,1059,1266,-2,0,-1,0,3
EUW1_6874628056',4,26,11,0,0,2,0,14,0,375,105,30212,31969,31970,2,21,14,2,0,2,0,11,411,104,31612,32674,30748,0,-36,1,-1400,-3,-705,1222,-2,0,0,0,3
EUW1_6873948523',5,52,12,1,0,1,0,4,1,361,98,28571,30778,35719,7,27,7,1,0,0,0,5,374,86,24949,29435,23567,1,-13,12,3622,5,1343,12152,0,0,1,0,-1
EUW1_6873899346',6,34,8,1,1,1,0,10,1,345,94,25887,27980,25264,3,34,8,1,0,1,0,3,339,106,25780,28470,27254,1,6,-12,107,0,-490,-1990,0,1,0,0,7
EUW1_6873844810',5,28,15,0,0,1,0,13,1,343,83,30286,28697,36329,4,31,11,1,0,2,0,7,368,67,27592,28509,30271,0,-25,16,2694,4,188,6058,-1,0,-1,0,6
EUW1_6873818805',6,26,10,1,1,0,0,8,1,442,110,29999,31814,24883,1,112,4,1,0,2,0,6,419,80,25050,30291,20139,1,23,30,4949,6,1523,4744,0,1,-2,0,2
EUW1_6873549713',3,26,9,1,0,0,0,8,0,400,118,27604,32050,28764,2,30,7,0,0,1,0,4,332,82,24174,28015,26883,1,68,36,3430,2,4035,1881,1,0,-1,0,4
EUW1_6873499625',4,30,13,0,0,1,0,13,1,382,41,28002,29051,30049,5,30,9,1,0,1,0,3,368,74,26441,27704,27246,0,14,-33,1561,4,1347,2803,-1,0,0,0,10
EUW1_6871120030',2,66,10,1,0,0,0,9,0,372,106,27390,31526,29722,4,29,10,1,0,2,0,3,376,98,27723,30146,40450,0,-4,8,-333,0,1380,-10728,0,0,-2,0,6
EUW1_6871083953',5,32,6,1,0,0,0,8,0,411,96,24903,30626,24391,1,22,7,1,0,0,0,0,368,112,24957,31028,28806,1,43,-16,-54,-1,-402,-4415,0,0,0,0,8
EUW1_6869531327',6,22,17,2,0,1,0,9,1,399,90,31444,34111,41800,1,24,9,0,0,0,0,6,379,106,26491,29743,31321,1,20,-16,4953,8,4368,10479,2,0,1,0,3
EUW1_6882539467',5,27,9,0,0,0,0,11,0,321,76,24683,28349,25760,3,24,10,2,0,1,0,0,384,112,26924,31020,24745,0,-63,-36,-2241,-1,-2671,1015,-2,0,-1,0,11
EUW1_6882505470',4,36,9,1,0,0,0,14,0,313,82,26180,27437,30332,7,26,11,0,1,2,0,2,376,94,27587,28499,27670,0,-63,-12,-1407,-2,-1062,2662,1,-1,-2,0,12
EUW1_6880773024',3,43,29,1,0,5,0,4,1,405,71,34851,34268,47923,2,128,10,0,0,0,0,9,280,84,22889,24270,36525,1,125,-13,11962,19,9998,11398,1,0,5,0,-5
EUW1_6880744938',0,17,6,0,0,0,0,10,0,351,94,24378,28260,27442,2,44,14,1,0,1,0,1,392,70,29037,31491,38309,0,-41,24,-4659,-8,-3231,-10867,-1,0,-1,0,9
EUW1_6880730060',4,47,16,2,0,1,0,9,0,389,69,29061,31561,33407,1,56,2,0,0,0,0,3,323,100,21627,25229,18769,1,66,-31,7434,14,6332,14638,2,0,1,0,6
EUW1_6867723544',2,27,9,0,0,0,0,10,0,367,80,25675,28877,28465,4,35,8,2,0,2,0,3,398,132,28019,31798,22821,1,-31,-52,-2344,1,-2921,5644,-2,0,-2,0,7
EUW1_6867309449',2,139,16,0,0,0,0,9,0,370,85,28132,32281,40028,3,261,14,2,0,2,0,4,336,124,30654,32537,34017,0,34,-39,-2522,2,-256,6011,-2,0,-2,0,5
EUW1_6867267904',3,30,17,1,0,3,0,9,1,383,117,30998,31149,43784,2,21,12,1,0,0,0,7,310,63,26566,28176,29996,1,73,54,4432,5,2973,13788,0,0,3,0,2
EUW1_6867208477',5,35,15,1,0,1,0,8,1,377,78,30120,32626,29091,4,39,3,1,0,1,0,4,285,126,21410,25775,17188,1,92,-48,8710,12,6851,11903,0,0,0,0,4
EUW1_6867025957',5,48,5,1,0,0,0,9,1,340,78,23344,27305,24666,3,44,10,1,0,0,0,1,381,110,25933,30953,28060,0,-41,-32,-2589,-5,-3648,-3394,0,0,0,0,8
EUW1_6866769976',2,22,4,0,0,0,0,15,0,337,94,22328,27129,24467,3,66,18,2,1,3,0,1,360,93,31996,32252,37847,0,-23,1,-9668,-14,-5123,-13380,-2,-1,-3,0,14
EUW1_6866728517',9,37,11,0,0,1,0,4,0,378,78,27625,30326,34211,3,35,12,2,0,0,0,6,377,130,27367,32272,31863,1,1,-52,258,-1,-1946,2348,-2,0,1,0,-2
EUW1_6866673071',3,87,15,1,0,1,0,7,1,334,103,28176,29579,28650,5,32,13,1,1,1,0,4,383,119,30099,32331,32857,0,-49,-16,-1923,2,-2752,-4207,0,-1,0,0,3
EUW1_6866298381',4,42,9,0,0,0,0,14,0,316,100,25097,28273,25337,4,30,8,2,1,3,0,3,366,92,26503,27801,25988,1,-50,8,-1406,1,472,-651,-2,-1,-3,0,11
EUW1_6866254979',1,26,8,1,0,2,0,3,0,436,90,28681,30518,26994,4,36,6,1,0,1,0,10,345,126,24726,31063,19630,1,91,-36,3955,2,-545,7364,0,0,1,0,-7
EUW1_6865769688',7,32,14,2,0,0,0,9,1,384,90,27791,30406,28155,4,29,5,0,0,0,0,2,374,130,26134,31595,20049,0,10,-40,1657,9,-1189,8106,2,0,0,0,7
EUW1_6864676504',4,26,6,1,0,0,0,4,1,388,88,25627,28238,24715,6,36,5,1,0,0,0,2,348,124,23642,30620,21276,0,40,-36,1985,1,-2382,3439,0,0,0,0,2
EUW1_6863663898',2,49,11,0,0,0,0,16,0,324,71,25723,27482,32657,7,33,27,2,0,4,0,0,369,116,37705,32419,42539,0,-45,-45,-11982,-16,-4937,-9882,-2,0,-4,0,16
EUW1_6881208344',6,33,10,1,0,0,0,11,1,376,78,25284,28563,24084,6,31,11,1,0,3,0,2,437,98,30192,32954,37292,1,-61,-20,-4908,-1,-4391,-13208,0,0,-3,0,9
EUW1_6881159380',2,22,9,0,0,0,0,12,1,388,75,26336,29416,23184,4,29,16,2,1,3,0,1,401,112,31865,31902,33464,0,-13,-37,-5529,-7,-2486,-10280,-2,-1,-3,0,11
EUW1_6880956667',4,29,22,1,0,3,0,5,1,392,139,35066,36801,44429,4,26,5,1,0,0,0,8,339,80,22627,28507,26293,1,53,59,12439,17,8294,18136,0,0,3,0,-3
EUW1_6869253692',3,28,10,0,0,0,0,14,0,307,77,25995,27404,27409,2,225,19,1,1,3,0,1,372,100,31654,31657,42594,1,-65,-23,-5659,-9,-4253,-15185,-1,-1,-3,0,13
EUW1_6869242633',2,41,24,1,0,1,0,11,1,331,87,33688,29856,46475,1,181,16,0,0,2,0,7,281,95,28535,26832,33959,1,50,-8,5153,8,3024,12516,1,0,-1,0,4
EUW1_6869208387',8,44,15,1,0,0,0,12,0,373,84,29146,32489,37307,6,33,13,1,0,0,0,2,363,78,27296,29378,32015,1,10,6,1850,2,3111,5292,0,0,0,0,10
EUW1_6868954257',2,32,19,1,0,1,0,11,1,343,85,32028,30573,42123,0,221,17,0,0,1,0,6,313,76,30399,29024,45273,0,30,9,1629,2,1549,-3150,1,0,0,0,5
EUW1_6868903771',8,29,17,0,0,1,0,8,1,382,100,32656,30992,38959,2,27,7,1,0,1,0,7,320,88,23569,27340,23717,1,62,12,9087,10,3652,15242,-1,0,0,0,1
EUW1_6868767669',2,24,2,0,0,0,0,11,0,362,78,22184,28244,19793,4,22,10,1,0,1,0,1,415,98,27657,31140,27600,0,-53,-20,-5473,-8,-2896,-7807,-1,0,-1,0,10
EUW1_6868612357',4,30,13,1,1,2,0,10,1,360,100,30026,30791,31682,0,18,11,1,0,0,0,6,329,96,26362,28074,29331,0,31,4,3664,2,2717,2351,0,1,2,0,4
EUW1_6867815174',5,29,15,1,0,1,0,10,0,288,70,28430,25637,36148,1,34,20,0,0,0,0,6,299,68,28480,26651,40369,0,-11,2,-50,-5,-1014,-4221,1,0,1,0,4
EUW1_6867763558',5,36,10,2,0,1,0,5,1,355,80,26664,28464,31259,6,40,12,0,0,1,0,5,340,91,26289,28534,33294,1,15,-11,375,-2,-70,-2035,2,0,0,0,0
EUW1_6867641353',5,32,11,0,0,0,0,6,0,374,95,27343,31817,30947,3,42,11,2,0,0,0,5,367,103,26430,30096,31319,0,7,-8,913,0,1721,-372,-2,0,0,0,1
EUW1_6867454053',6,34,10,1,0,0,0,8,0,352,75,25420,28814,35104,5,28,17,1,0,0,0,1,339,96,28534,30052,33505,1,13,-21,-3114,-7,-1238,1599,0,0,0,0,7
EUW1_6867282924',6,89,18,2,0,3,0,9,1,352,90,32168,30909,31131,4,35,8,0,0,2,0,3,330,81,25252,26587,30833,1,22,9,6916,10,4322,298,2,0,1,0,6
EUW1_6867187354',5,42,16,1,0,0,0,8,1,307,78,27885,27122,35811,1,25,20,1,0,0,0,2,316,94,29034,27879,35222,0,-9,-16,-1149,-4,-757,589,0,0,0,0,6
EUW1_6866352299',6,83,13,1,0,0,0,10,1,329,88,25907,29793,26198,0,23,3,1,0,0,0,3,373,108,23735,28578,18903,1,-44,-20,2172,10,1215,7295,0,0,0,0,7
EUW1_6866325919',3,29,11,0,0,1,0,5,0,384,104,28429,30374,35589,6,29,14,1,0,0,0,12,369,70,28415,31253,30670,0,15,34,14,-3,-879,4919,-1,0,1,0,-7
EUW1_6866250528',2,24,10,2,0,1,0,11,0,371,60,25777,30031,30831,7,172,15,0,0,1,0,0,344,92,28076,28658,32546,1,27,-32,-2299,-5,1373,-1715,2,0,0,0,11
EUW1_6866220047',4,24,5,2,0,0,0,8,1,364,74,23104,27963,27318,5,32,5,0,0,1,0,2,384,112,25396,30309,24081,1,-20,-38,-2292,0,-2346,3237,2,0,-1,0,6
EUW1_6866196314',2,191,11,1,0,0,0,10,1,383,99,28297,30624,34667,0,24,10,0,0,0,0,5,350,96,27637,29841,30636,1,33,3,660,1,783,4031,1,0,0,0,5
EUW1_6866108681',4,38,20,1,0,2,0,3,1,358,102,31432,31471,40600,2,33,15,1,0,0,0,11,322,76,27128,27744,31016,1,36,26,4304,5,3727,9584,0,0,2,0,-8
EUW1_6883726640',3,25,17,0,0,1,0,8,1,394,72,30948,30910,38578,1,24,9,1,0,1,0,6,314,72,23669,26022,27076,1,80,0,7279,8,4888,11502,-1,0,0,0,2
EUW1_6883720644',5,33,8,1,0,0,0,9,1,356,94,24469,27843,21487,3,27,10,1,0,1,0,3,403,92,27146,29992,22945,0,-47,2,-2677,-2,-2149,-1458,0,0,-1,0,6
EUW1_6883702979',6,33,5,0,1,1,0,5,0,426,81,26264,29893,22713,5,62,6,2,0,0,0,5,405,105,24752,30344,15313,1,21,-24,1512,-1,-451,7400,-2,1,1,0,0
EUW1_6882894422',3,31,16,1,1,2,0,9,1,353,103,28674,28455,32073,3,29,12,1,0,0,0,7,274,80,25384,23647,27292,1,79,23,3290,4,4808,4781,0,1,2,0,2
EUW1_6882855518',7,42,11,0,0,1,0,6,1,348,86,27432,27907,34841,3,25,19,2,0,1,0,5,370,104,30788,31754,36436,0,-22,-18,-3356,-8,-3847,-1595,-2,0,0,0,1
EUW1_6881956097',2,22,10,0,0,0,0,11,0,317,84,25094,28451,30604,7,28,15,2,0,2,0,2,345,92,30503,29913,37786,0,-28,-8,-5409,-5,-1462,-7182,-2,0,-2,0,9
EUW1_6881513287',2,34,9,0,0,0,0,9,1,310,79,25124,26390,25380,3,99,13,0,0,2,0,0,347,95,28383,29588,34434,0,-37,-16,-3259,-4,-3198,-9054,0,0,-2,0,9
EUW1_6881448397',4,46,15,2,0,0,0,8,0,353,76,29140,29108,36937,6,28,16,0,0,2,0,3,368,74,28773,29240,32490,1,-15,2,367,-1,-132,4447,2,0,-2,0,5
EUW1_6881406964',3,28,5,0,0,0,0,10,0,353,78,22904,27455,20249,4,31,14,1,1,3,0,0,399,92,31633,32890,26978,0,-46,-14,-8729,-9,-5435,-6729,-1,-1,-3,0,10
EUW1_6865151576',4,17,6,0,0,0,0,8,1,356,84,24585,27549,21147,3,25,8,1,0,0,0,6,400,99,26748,30992,25664,0,-44,-15,-2163,-2,-3443,-4517,-1,0,0,0,2
EUW1_6865075006',3,32,7,1,0,0,0,3,0,354,84,23681,27526,19114,3,30,7,0,0,0,0,2,332,88,24042,27068,22799,1,22,-4,-361,0,458,-3685,1,0,0,0,1
EUW1_6865036302',1,25,23,1,1,3,0,14,0,376,93,34076,32929,38215,3,23,9,1,0,1,0,7,347,91,26285,26716,31687,1,29,2,7791,14,6213,6528,0,1,2,0,7
EUW1_6864999413',3,26,15,2,1,1,0,7,1,329,104,28686,31911,30897,4,22,3,0,0,0,0,6,317,80,21916,27247,21341,1,12,24,6770,12,4664,9556,2,1,1,0,1
EUW1_6864949328',2,23,16,0,0,0,0,16,1,363,84,29293,30281,34830,1,27,12,1,0,3,0,2,328,90,28852,27919,33354,0,35,-6,441,4,2362,1476,-1,0,-3,0,14
EUW1_6864901609',2,20,12,1,0,1,0,11,1,390,82,27321,29591,25469,5,28,13,0,0,0,0,5,344,82,28176,29437,26903,1,46,0,-855,-1,154,-1434,1,0,1,0,6
EUW1_6864614297',2,110,10,0,0,0,0,10,0,308,93,25315,28496,26295,8,34,12,1,1,0,0,0,393,94,28290,29740,31149,0,-85,-1,-2975,-2,-1244,-4854,-1,-1,0,0,10
EUW1_6864599448',2,39,6,2,0,0,0,8,0,316,83,22759,29411,19756,1,30,11,0,1,1,0,0,413,93,27909,30231,30693,1,-97,-10,-5150,-5,-820,-10937,2,-1,-1,0,8
EUW1_6864094216',1,28,13,0,0,1,0,10,1,379,72,29000,28990,22783,5,36,5,2,0,1,0,6,332,88,23855,28235,21574,1,47,-16,5145,8,755,1209,-2,0,0,0,4
EUW1_6864005320',8,32,7,1,0,0,0,12,1,324,57,23479,26085,28427,6,30,21,0,1,2,0,0,360,106,32737,31170,35260,0,-36,-49,-9258,-14,-5085,-6833,1,-1,-2,0,12
EUW1_6863783116',4,28,15,0,0,0,0,8,0,340,76,27667,29181,31264,5,24,20,2,0,1,0,1,357,91,30853,31955,40771,0,-17,-15,-3186,-5,-2774,-9507,-2,0,-1,0,7
EUW1_6863722083',3,30,7,1,0,0,0,7,1,370,82,25187,27138,30584,5,51,14,0,0,1,0,2,346,98,28907,30103,26514,0,24,-16,-3720,-7,-2965,4070,1,0,-1,0,5
EUW1_6863671427',5,28,7,2,1,0,0,5,0,394,108,25678,31674,26753,2,31,3,0,0,0,0,4,353,119,23844,28868,19425,1,41,-11,1834,4,2806,7328,2,1,0,0,1
EUW1_6863626832',6,34,19,0,1,2,0,8,0,407,88,34385,33094,45250,2,19,14,1,0,1,0,9,339,88,26477,27725,34921,1,68,0,7908,5,5369,10329,-1,1,1,0,-1
EUW1_6863560248',3,22,11,1,0,1,0,9,0,367,104,28346,31330,40407,3,23,11,0,0,1,0,5,324,83,27590,29623,33319,1,43,21,756,0,1707,7088,1,0,0,0,4
EUW1_6863387082',3,25,14,1,0,1,0,9,1,321,98,29522,29850,37992,5,24,16,0,0,2,0,4,333,70,27714,29165,32735,1,-12,28,1808,-2,685,5257,1,0,-1,0,5
EUW1_6863368486',3,27,16,1,0,1,0,5,1,368,76,29887,27726,30456,1,31,10,1,0,0,0,4,333,88,25760,28745,26942,1,35,-12,4127,6,-1019,3514,0,0,1,0,1
EUW1_6863341874',5,29,14,1,0,1,0,7,0,414,100,30367,32988,29992,3,31,10,1,0,0,0,5,362,80,26352,28051,26192,1,52,20,4015,4,4937,3800,0,0,1,0,2
EUW1_6863308449',4,35,11,1,1,0,0,8,1,379,99,27702,29785,28760,5,30,11,0,0,0,0,3,364,110,26864,30281,29304,1,15,-11,838,0,-496,-544,1,1,0,0,5
EUW1_6877038503',2,41,14,1,0,2,0,5,1,366,96,30142,31216,36487,2,21,15,0,0,0,0,7,349,106,28523,30027,43294,1,17,-10,1619,-1,1189,-6807,1,0,2,0,-2
EUW1_6876995777',1,30,16,1,0,2,0,10,1,379,120,29931,32651,34181,0,19,4,1,0,0,0,4,333,80,23135,27300,21259,1,46,40,6796,12,5351,12922,0,0,2,0,6
EUW1_6873010219',5,29,13,1,1,3,0,7,1,390,98,31500,32304,33740,1,27,3,0,0,0,0,9,349,98,22422,27486,27306,1,41,0,9078,10,4818,6434,1,1,3,0,-2
EUW1_6871633834',6,32,18,0,0,0,0,7,1,311,96,28809,29065,28388,4,39,13,1,0,1,0,5,337,68,28308,28674,35760,0,-26,28,501,5,391,-7372,-1,0,-1,0,2
EUW1_6870353842',2,27,11,0,0,2,0,7,1,336,78,27768,28252,30453,4,20,10,2,0,1,0,10,346,106,26817,29295,29626,0,-10,-28,951,1,-1043,827,-2,0,1,0,-3
EUW1_6868921780',1,26,11,1,0,0,0,12,1,344,96,27495,27971,26373,1,28,15,0,0,1,0,1,370,93,28390,29944,28148,1,-26,3,-895,-4,-1973,-1775,1,0,-1,0,11
EUW1_6868865584',0,22,12,1,0,0,0,8,0,324,64,25405,27134,31174,6,104,24,0,1,2,0,1,343,84,32382,32188,42836,0,-19,-20,-6977,-12,-5054,-11662,1,-1,-2,0,7
EUW1_6868672237',6,27,12,2,0,0,0,5,0,350,100,27253,28329,29919,3,28,13,0,0,0,0,3,371,78,26838,29942,30734,0,-21,22,415,-1,-1613,-815,2,0,0,0,2
EUW1_6868602351',7,31,16,0,0,1,0,12,1,348,66,28742,29367,33218,2,32,15,2,0,0,0,6,342,78,27766,28939,36918,1,6,-12,976,1,428,-3700,-2,0,1,0,6
EUW1_6868312008',1,24,21,1,0,1,0,6,0,339,76,31456,29480,37308,6,29,18,0,0,1,0,5,285,72,28433,27564,39980,0,54,4,3023,3,1916,-2672,1,0,0,0,1
EUW1_6868275493',3,33,10,0,0,0,0,15,0,296,56,24441,25628,32188,6,188,21,1,0,3,0,5,391,103,33638,33531,39794,0,-95,-47,-9197,-11,-7903,-7606,-1,0,-3,0,10
EUW1_6868077086',1,59,7,0,0,0,0,10,0,334,112,25512,28468,24008,5,65,16,1,1,2,0,1,382,100,30833,31628,32656,1,-48,12,-5321,-9,-3160,-8648,-1,-1,-2,0,9
EUW1_6864845096',2,25,6,0,0,0,0,9,0,387,109,24819,30131,23743,7,25,15,1,1,1,0,0,387,86,29216,33311,30774,0,0,23,-4397,-9,-3180,-7031,-1,-1,-1,0,9
EUW1_6864810923',5,29,16,0,0,1,0,4,1,351,100,29312,30776,38858,5,35,6,1,0,1,0,2,358,80,25057,28326,27433,1,-7,20,4255,10,2450,11425,-1,0,0,0,2
EUW1_6864767631',5,22,10,0,0,0,0,15,0,371,94,27150,30384,29023,5,30,18,2,0,1,0,4,399,85,30441,32648,40953,1,-28,9,-3291,-8,-2264,-11930,-2,0,-1,0,11
EUW1_6864734644',5,26,9,0,0,0,0,9,1,357,70,25514,27058,24048,3,26,17,2,0,1,0,2,383,110,30428,32594,32612,0,-26,-40,-4914,-8,-5536,-8564,-2,0,-1,0,7
EUW1_6864699620',2,24,10,1,0,0,0,6,1,369,96,27101,30382,40173,7,37,15,0,0,1,0,2,321,91,28657,28376,31028,1,48,5,-1556,-5,2006,9145,1,0,-1,0,4
EUW1_6864672851',7,30,12,2,0,0,0,9,0,290,84,25143,27038,26702,1,38,13,0,0,1,0,0,343,94,28109,29120,34798,0,-53,-10,-2966,-1,-2082,-8096,2,0,-1,0,9
EUW1_6864652802',5,38,13,0,0,0,0,13,0,323,78,26261,28105,30243,4,26,14,1,0,2,0,2,348,105,29956,30431,35981,0,-25,-27,-3695,-1,-2326,-5738,-1,0,-2,0,11
EUW1_6864638720',2,138,16,1,1,0,0,7,1,330,74,27373,30054,42689,4,24,4,0,0,1,0,1,359,93,23821,27766,26152,1,-29,-19,3552,12,2288,16537,1,1,-1,0,6
EUW1_6864596471',2,20,10,1,0,1,0,10,1,316,93,26518,27904,37725,2,26,22,0,0,2,0,2,367,73,32823,30255,39425,0,-51,20,-6305,-12,-2351,-1700,1,0,-1,0,8
EUW1_6864586527',3,28,14,0,1,1,0,9,1,373,90,28610,30944,31819,5,28,12,2,0,1,0,5,348,93,28283,30397,30037,1,25,-3,327,2,547,1782,-2,1,0,0,4
EUW1_6864579499',3,20,6,0,0,0,0,8,0,332,104,24090,28015,26574,5,96,17,1,1,2,0,3,397,103,30989,32414,33732,0,-65,1,-6899,-11,-4399,-7158,-1,-1,-2,0,5
EUW1_6864570607',5,30,22,1,0,1,0,6,1,377,113,31415,32230,41192,4,39,7,1,0,1,0,4,313,66,24085,24847,27179,1,64,47,7330,15,7383,14013,0,0,0,0,2
EUW1_6864561541',5,47,30,1,0,1,0,10,1,349,99,35569,32534,50667,5,32,13,1,0,1,0,4,314,76,27466,27393,36890,1,35,23,8103,17,5141,13777,0,0,0,0,6
EUW1_6864546762',0,26,12,1,0,0,0,15,0,305,68,26800,28860,26639,5,30,13,1,0,3,0,4,352,116,30074,29212,33073,0,-47,-48,-3274,-1,-352,-6434,0,0,-3,0,11
EUW1_6864536624',5,32,16,0,1,0,0,7,1,372,86,31298,31240,37509,2,24,9,1,0,1,0,3,330,94,25889,27674,23748,1,42,-8,5409,7,3566,13761,-1,1,-1,0,4
EUW1_6864518154',5,35,14,0,1,3,0,5,0,382,103,30297,33460,33651,2,27,11,2,0,0,0,10,359,81,25809,29272,35172,1,23,22,4488,3,4188,-1521,-2,1,3,0,-5
EUW1_6864503429',9,33,9,2,0,0,0,10,1,382,74,25487,29028,33417,2,29,12,0,0,1,0,1,421,91,29570,30402,29454,0,-39,-17,-4083,-3,-1374,3963,2,0,-1,0,9
EUW1_6875432840',2,26,5,1,1,1,0,5,0,431,84,26470,30470,24063,4,39,11,1,0,1,0,2,396,80,27354,29959,25240,0,35,4,-884,-6,511,-1177,0,1,0,0,3
EUW1_6875402782',3,35,23,2,1,5,0,8,1,397,126,35700,33424,42388,0,19,7,0,0,0,0,10,285,70,24107,26258,24764,1,112,56,11593,16,7166,17624,2,1,5,0,-2
EUW1_6875356039',2,29,13,2,0,0,0,4,0,367,82,28282,30974,38686,4,27,13,0,0,1,0,4,303,85,26096,28676,28410,1,64,-3,2186,0,2298,10276,2,0,-1,0,0
EUW1_6882547477',3,30,16,0,0,0,0,14,1,330,91,28932,31109,40026,2,42,12,2,0,3,0,3,313,107,28256,29313,43495,1,17,-16,676,4,1796,-3469,-2,0,-3,0,11
EUW1_6882514111',4,27,15,1,0,0,0,8,1,374,78,28111,29906,38446,6,30,8,1,0,0,0,2,324,94,24757,27916,32388,1,50,-16,3354,7,1990,6058,0,0,0,0,6
EUW1_6882495946',7,31,12,0,0,0,0,14,0,331,80,26303,26327,27832,7,31,17,1,0,3,0,1,431,82,33151,31867,34819,0,-100,-2,-6848,-5,-5540,-6987,-1,0,-3,0,13
EUW1_6881197004',3,64,6,0,1,0,0,6,1,355,84,24910,30093,22557,5,77,7,2,0,0,0,0,367,111,25073,30746,25432,0,-12,-27,-163,-1,-653,-2875,-2,1,0,0,6
EUW1_6880952682',8,52,15,2,0,1,0,8,1,374,65,30365,28794,28810,6,52,8,0,0,1,0,9,325,131,25218,27795,19139,1,49,-66,5147,7,999,9671,2,0,0,0,-1
EUW1_6880658297',2,265,15,2,0,0,0,10,0,360,98,28694,31337,35652,5,30,12,0,0,2,0,4,358,85,28898,30765,38081,0,2,13,-204,3,572,-2429,2,0,-2,0,6
EUW1_6876849000',0,44,4,0,0,0,0,10,0,351,65,23088,27310,32232,3,28,14,2,0,1,0,1,406,99,29348,31624,29184,0,-55,-34,-6260,-10,-4314,3048,-2,0,-1,0,9
EUW1_6876570312',1,25,14,1,1,0,0,15,1,375,97,30389,30679,43380,5,25,10,1,0,2,0,2,355,89,27495,29999,24719,0,20,8,2894,4,680,18661,0,1,-2,0,13
EUW1_6875454713',5,82,18,2,0,0,0,8,1,387,84,30232,32295,42809,4,77,5,0,0,2,0,2,307,82,22816,25792,27981,1,80,2,7416,13,6503,14828,2,0,-2,0,6
EUW1_6875372169',3,26,12,1,0,1,0,6,0,398,82,28216,31989,34740,3,22,12,1,0,0,0,3,383,97,27656,31624,31186,1,15,-15,560,0,365,3554,0,0,1,0,3
EUW1_6875338034',3,34,10,0,0,0,0,13,1,368,67,25662,30123,26493,0,34,8,1,0,1,0,1,409,94,27285,30935,29261,1,-41,-27,-1623,2,-812,-2768,-1,0,-1,0,12
EUW1_6875297661',4,35,19,1,0,1,0,4,0,361,101,31008,32232,39858,3,26,13,1,0,0,0,3,320,78,27482,28660,34104,1,41,23,3526,6,3572,5754,0,0,1,0,1
EUW1_6875266516',3,39,10,1,0,1,0,8,0,384,99,27281,31082,28473,10,34,10,1,1,0,0,7,372,97,26448,29159,28233,1,12,2,833,0,1923,240,0,-1,1,0,1
EUW1_6883722866',3,34,10,0,0,0,0,16,1,385,88,27074,29258,25183,5,30,10,2,0,2,0,2,329,108,26199,28659,29653,1,56,-20,875,0,599,-4470,-2,0,-2,0,14
EUW1_6883700956',3,29,15,0,0,1,0,9,0,351,94,29808,28582,37364,7,41,22,2,0,2,0,8,375,74,31700,30881,49884,0,-24,20,-1892,-7,-2299,-12520,-2,0,-1,0,1
EUW1_6883704538',5,26,15,1,0,0,0,9,1,351,74,28332,30044,33586,2,29,11,0,0,1,0,3,419,71,28742,31178,35091,1,-68,3,-410,4,-1134,-1505,1,0,-1,0,6
EUW1_6882507097',2,36,14,1,0,0,0,12,1,347,88,28486,28902,39549,3,26,8,0,0,2,0,6,307,95,25496,27365,28252,1,40,-7,2990,6,1537,11297,1,0,-2,0,6
EUW1_6882485897',3,30,11,1,0,0,0,9,0,350,94,25702,30187,21211,6,34,15,1,0,1,0,3,406,100,30581,32168,40629,0,-56,-6,-4879,-4,-1981,-19418,0,0,-1,0,6
EUW1_6882458377',2,29,5,0,0,0,0,12,1,379,94,24537,27410,31233,6,34,10,2,0,1,0,0,391,85,27291,29472,26053,0,-12,9,-2754,-5,-2062,5180,-2,0,-1,0,12
EUW1_6882438454',3,25,9,0,0,1,0,17,1,337,81,26824,27237,27553,4,31,19,1,0,5,0,3,393,82,34394,30682,42522,0,-56,-1,-7570,-10,-3445,-14969,-1,0,-4,0,14
EUW1_6882425995',4,42,10,0,0,0,0,9,0,384,99,27621,28820,31513,6,32,17,1,1,3,0,5,369,108,30735,33099,33157,0,15,-9,-3114,-7,-4279,-1644,-1,-1,-3,0,4
EUW1_6882400980',5,33,16,2,1,0,0,6,1,359,85,28034,29573,31425,6,31,12,0,0,1,0,4,364,94,28520,30217,38572,0,-5,-9,-486,4,-644,-7147,2,1,-1,0,2
EUW1_6882385675',6,29,16,2,0,2,0,11,1,331,94,29619,30518,38014,0,31,10,0,0,1,0,3,356,71,27122,29190,27750,1,-25,23,2497,6,1328,10264,2,0,1,0,8
EUW1_6880894696',0,32,5,0,0,0,0,12,0,364,83,23535,28723,18955,3,35,10,2,0,2,0,1,435,124,30135,33045,30528,0,-71,-41,-6600,-5,-4322,-11573,-2,0,-2,0,11
EUW1_6880873708',3,35,9,1,0,0,0,5,1,361,90,26222,28283,31684,2,106,8,0,0,0,0,6,349,98,24810,30828,30004,0,12,-8,1412,1,-2545,1680,1,0,0,0,-1
EUW1_6880855179',6,51,15,1,0,1,0,5,1,388,90,30091,31205,44955,4,24,13,1,0,0,0,2,350,84,27383,28961,33282,1,38,6,2708,2,2244,11673,0,0,1,0,3
EUW1_6880847678',3,24,7,0,0,0,0,13,0,293,76,24020,27647,25198,4,36,15,2,1,2,0,2,434,95,32147,33546,36249,0,-141,-19,-8127,-8,-5899,-11051,-2,-1,-2,0,11
EUW1_6879660480',1,42,20,1,1,0,0,12,1,335,74,29734,27803,34719,4,292,17,1,0,2,0,2,363,78,32179,29319,34559,0,-28,-4,-2445,3,-1516,160,0,1,-2,0,10
EUW1_6879390495',2,42,10,0,0,0,0,6,0,387,94,26324,31136,33547,3,28,9,2,1,1,0,1,400,118,27113,31798,35893,0,-13,-24,-789,1,-662,-2346,-2,-1,-1,0,5
EUW1_6878036412',8,35,9,0,0,0,0,7,0,393,75,26082,31212,23652,5,50,13,2,0,0,0,2,411,89,27213,31470,32249,0,-18,-14,-1131,-4,-258,-8597,-2,0,0,0,5
EUW1_6878021675',1,28,9,0,0,1,0,9,1,431,100,27630,32128,25758,4,27,12,2,0,1,0,5,369,103,28454,31798,25493,0,62,-3,-824,-3,330,265,-2,0,0,0,4
EUW1_6878004510',8,198,5,1,0,0,0,8,0,386,106,24679,29279,38242,5,25,15,1,0,1,0,2,384,92,29214,31109,27742,0,2,14,-4535,-10,-1830,10500,0,0,-1,0,6
EUW1_6883121794',5,27,15,1,0,0,0,11,1,316,104,28653,29674,33883,2,30,15,0,0,0,0,1,363,70,28045,30897,34781,0,-47,34,608,0,-1223,-898,1,0,0,0,10
EUW1_6882407219',2,28,18,1,0,1,0,11,1,369,97,30713,31498,39496,2,18,6,0,0,1,0,5,329,81,24462,26996,24667,0,40,16,6251,12,4502,14829,1,0,0,0,6
EUW1_6882391269',4,39,16,1,1,0,0,13,1,312,104,28618,28857,35308,3,28,17,1,0,2,0,2,345,92,29653,32228,41223,0,-33,12,-1035,-1,-3371,-5915,0,1,-2,0,11
EUW1_6882384467',1,56,7,1,0,0,0,8,0,308,78,23166,24062,28129,9,64,18,1,0,1,0,3,362,94,30473,31012,35305,0,-54,-16,-7307,-11,-6950,-7176,0,0,-1,0,5
EUW1_6881755766',5,34,9,0,0,0,0,14,0,350,85,26330,27865,21319,7,27,12,2,0,2,0,2,366,96,26939,28166,26313,0,-16,-11,-609,-3,-301,-4994,-2,0,-2,0,12
EUW1_6881318728',3,27,24,1,0,1,0,9,1,383,104,32956,34835,46141,2,22,8,1,0,1,0,4,308,65,22484,25142,25432,1,75,39,10472,16,9693,20709,0,0,0,0,5
EUW1_6880924883',4,208,20,1,0,1,0,7,1,351,63,29536,29639,34808,1,29,9,0,0,0,0,5,309,80,25206,27552,33353,1,42,-17,4330,11,2087,1455,1,0,1,0,2
EUW1_6880736533',3,23,21,1,0,1,0,8,0,378,84,30371,31396,40146,2,46,12,1,0,1,0,6,321,92,27346,28508,39759,1,57,-8,3025,9,2888,387,0,0,0,0,2
EUW1_6880064349',2,19,13,2,0,1,0,10,0,326,100,26729,29470,33752,4,256,10,0,0,2,0,4,359,75,27021,29097,28096,0,-33,25,-292,3,373,5656,2,0,-1,0,6
EUW1_6879202898',7,27,10,1,0,1,0,14,1,342,83,26168,28921,28106,7,33,19,0,1,2,0,3,339,92,31659,31051,33259,1,3,-9,-5491,-9,-2130,-5153,1,-1,-1,0,11
EUW1_6879166949',4,31,7,0,0,0,0,14,0,316,68,24412,26872,28660,1,89,20,1,1,2,0,1,374,112,32877,31830,38203,0,-58,-44,-8465,-13,-4958,-9543,-1,-1,-2,0,13
EUW1_6878450790',6,28,9,0,1,0,0,12,1,360,92,26877,29853,33176,6,24,14,2,0,1,0,3,375,104,30809,31411,34265,1,-15,-12,-3932,-5,-1558,-1089,-2,1,-1,0,9
EUW1_6877843750',3,23,15,1,1,1,0,9,0,375,104,31089,30917,36818,3,135,15,1,0,1,0,8,353,96,28942,28845,31975,1,22,8,2147,0,2072,4843,0,1,0,0,1
EUW1_6877825557',4,32,8,0,0,0,0,13,1,351,94,24175,27753,22828,5,31,8,2,1,2,0,0,387,85,28422,29279,29651,0,-36,9,-4247,0,-1526,-6823,-2,-1,-2,0,13
EUW1_6876469353',0,37,4,0,0,0,0,15,0,236,72,19974,21696,21734,5,31,17,0,1,6,1,1,373,92,32477,30280,33964,0,-137,-20,-12503,-13,-8584,-12230,0,-1,-6,-1,14
EUW1_6876461907',1,29,12,1,0,0,0,8,1,382,79,27400,28701,30412,3,30,12,1,0,0,0,3,364,101,28068,30258,28809,1,18,-22,-668,0,-1557,1603,0,0,0,0,5
EUW1_6876449254',4,23,5,0,0,0,0,11,0,318,92,22248,26742,24408,2,21,11,2,1,0,0,0,399,107,28220,31852,33007,0,-81,-15,-5972,-6,-5110,-8599,-2,-1,0,0,11
EUW1_6876439754',3,20,15,1,0,2,0,6,1,386,106,30730,33234,35293,1,24,12,0,0,0,0,7,360,82,27459,29222,37472,1,26,24,3271,3,4012,-2179,1,0,2,0,-1
EUW1_6875092626',3,32,6,1,0,0,0,15,0,328,84,23008,29796,24708,5,26,11,0,1,3,0,2,408,100,31166,31252,39849,0,-80,-16,-8158,-5,-1456,-15141,1,-1,-3,0,13
EUW1_6875076258',6,34,15,1,1,0,0,11,0,371,96,29506,32519,42803,2,26,11,0,0,0,0,2,397,124,27985,31598,39489,1,-26,-28,1521,4,921,3314,1,1,0,0,9
EUW1_6875063447',3,24,15,2,0,1,0,5,0,312,104,27896,27908,35209,0,27,15,0,0,1,0,6,370,84,29199,31970,36159,0,-58,20,-1303,0,-4062,-950,2,0,0,0,-1
EUW1_6875057387',2,26,15,0,0,0,0,13,0,298,66,28094,27417,35469,5,78,26,1,0,1,0,5,344,121,33746,31770,48073,0,-46,-55,-5652,-11,-4353,-12604,-1,0,-1,0,8
EUW1_6875057597',5,21,19,2,1,1,0,7,1,336,91,29564,32283,42051,3,75,6,0,0,0,0,7,355,94,25180,28808,38428,0,-19,-3,4384,13,3475,3623,2,1,1,0,0
EUW1_6875028046',0,30,13,0,0,2,0,6,0,366,88,30092,31416,30377,5,45,8,2,0,0,0,8,321,95,24240,27352,32915,1,45,-7,5852,5,4064,-2538,-2,0,2,0,-2
EUW1_6875008309',0,46,12,0,0,1,0,12,1,367,90,29657,31415,30146,3,141,14,1,0,2,0,5,393,113,29903,32736,34050,0,-26,-23,-246,-2,-1321,-3904,-1,0,-1,0,7
EUW1_6874991776',3,24,6,0,0,0,0,8,0,330,98,23572,28207,19623,6,29,11,2,0,1,0,2,378,73,27778,29373,29241,0,-48,25,-4206,-5,-1166,-9618,-2,0,-1,0,6
EUW1_6874948405',3,28,13,0,0,0,0,8,1,337,82,28591,29699,34686,3,62,19,1,0,0,0,2,344,84,29831,28338,39712,0,-7,-2,-1240,-6,1361,-5026,-1,0,0,0,6
EUW1_6874915832',2,35,16,2,0,0,0,13,1,331,94,28820,29588,39021,0,25,19,0,0,2,0,3,352,92,30986,31282,32872,0,-21,2,-2166,-3,-1694,6149,2,0,-2,0,10
EUW1_6874845103',5,33,15,2,0,2,0,6,0,338,128,29188,31343,36149,2,24,7,0,1,0,0,6,331,72,24529,26904,31452,1,7,56,4659,8,4439,4697,2,-1,2,0,0
EUW1_6873774694',3,25,6,0,0,0,0,10,0,322,106,23929,30103,20450,12,37,15,2,0,1,0,1,404,104,30403,32015,41086,0,-82,2,-6474,-9,-1912,-20636,-2,0,-1,0,9
EUW1_6873872250',3,34,2,0,0,0,0,9,0,380,96,22396,27733,15874,8,33,15,2,1,1,0,1,427,92,29888,31280,33173,0,-47,4,-7492,-13,-3547,-17299,-2,-1,-1,0,8
EUW1_6873862712',5,30,20,2,1,3,0,7,0,412,90,33636,35137,43646,2,38,7,0,0,0,0,9,322,81,23327,27268,27212,1,90,9,10309,13,7869,16434,2,1,3,0,-2
EUW1_6873833203',4,27,9,0,0,1,0,9,1,346,84,26442,26835,27682,4,27,9,1,0,1,0,4,399,80,26497,28695,26602,1,-53,4,-55,0,-1860,1080,-1,0,0,0,5
EUW1_6873807443',1,32,8,1,0,0,0,14,0,316,96,26337,29053,39240,5,27,21,1,0,2,0,1,380,80,31675,32502,51836,0,-64,16,-5338,-13,-3449,-12596,0,0,-2,0,13
EUW1_6873803503',2,24,12,1,0,3,0,10,1,357,88,30089,31233,35471,1,21,11,1,0,1,0,5,344,118,26451,31022,37295,1,13,-30,3638,1,211,-1824,0,0,2,0,5
EUW1_6873783166',2,32,8,0,0,2,0,8,0,368,92,27560,29921,21883,2,28,12,2,0,2,0,6,366,82,27491,29156,29468,0,2,10,69,-4,765,-7585,-2,0,0,0,2
EUW1_6870969486',2,64,27,0,0,2,0,9,1,338,91,33883,32299,46157,4,54,13,2,0,1,0,5,354,68,27709,29066,39390,1,-16,23,6174,14,3233,6767,-2,0,1,0,4
EUW1_6869410253',6,36,16,1,0,1,0,9,0,332,98,30069,30801,31233,4,39,11,1,0,0,0,7,339,90,26713,29575,33185,1,-7,8,3356,5,1226,-1952,0,0,1,0,2
EUW1_6869390782',3,23,6,1,0,0,0,10,0,307,116,23455,27330,21849,2,24,15,1,0,2,0,2,384,80,29629,30529,33759,0,-77,36,-6174,-9,-3199,-11910,0,0,-2,0,8
EUW1_6869368896',0,25,15,1,1,3,0,8,0,383,100,30994,31972,33632,4,24,10,0,0,0,0,1,335,96,25992,29710,29124,1,48,4,5002,5,2262,4508,1,1,3,0,7
EUW1_6867860004',6,29,19,1,0,1,0,8,0,387,102,32860,33520,35585,3,209,9,1,0,1,0,6,368,72,26025,27910,28959,1,19,30,6835,10,5610,6626,0,0,0,0,2
EUW1_6867821831',2,25,5,0,0,1,0,10,1,392,104,25486,30918,26848,3,28,5,1,0,2,0,1,421,92,26471,30096,27077,0,-29,12,-985,0,822,-229,-1,0,-1,0,9
EUW1_6866612004',2,20,12,1,0,0,0,7,1,388,66,26836,29169,36290,1,20,14,0,0,1,0,1,418,94,29456,32122,35763,1,-30,-28,-2620,-2,-2953,527,1,0,-1,0,6
EUW1_6866534961',3,36,9,0,0,0,0,10,0,365,86,26345,28838,30648,4,25,14,2,0,1,0,2,379,94,27292,32722,43876,0,-14,-8,-947,-5,-3884,-13228,-2,0,-1,0,8
EUW1_6866500443',2,24,15,1,0,1,0,6,1,342,107,28105,29354,30837,0,17,4,1,0,0,0,6,317,84,21805,24860,25680,1,25,23,6300,11,4494,5157,0,0,1,0,0
EUW1_6864661855',6,30,16,0,0,0,0,11,1,376,82,29124,29652,37570,3,25,15,2,0,1,0,5,374,86,29279,31925,38627,0,2,-4,-155,1,-2273,-1057,-2,0,-1,0,6
EUW1_6864641803',4,31,10,0,0,1,0,8,0,397,92,27718,31030,30914,5,30,6,2,0,1,0,3,394,87,25529,30658,28252,0,3,5,2189,4,372,2662,-2,0,0,0,5
EUW1_6864628731',10,35,6,1,0,0,0,10,0,368,84,24181,28160,27048,5,26,12,1,0,1,0,0,418,96,29373,30486,24902,0,-50,-12,-5192,-6,-2326,2146,0,0,-1,0,10
EUW1_6865022437',3,24,5,0,0,0,0,6,0,371,90,24244,28996,25598,5,26,13,2,0,1,0,4,382,108,28409,32892,29021,0,-11,-18,-4165,-8,-3896,-3423,-2,0,-1,0,2
EUW1_6864977678',4,22,17,1,0,1,0,13,0,326,54,28832,28984,33582,1,22,21,0,1,1,0,3,361,98,32528,31381,44371,1,-35,-44,-3696,-4,-2397,-10789,1,-1,0,0,10
EUW1_6864911062',5,26,9,1,0,0,0,8,1,370,69,26475,29453,31307,5,28,11,1,0,1,0,2,355,81,26332,28845,34105,0,15,-12,143,-2,608,-2798,0,0,-1,0,6
EUW1_6864875135',2,18,6,0,0,0,0,16,1,276,83,21789,23415,23587,5,28,23,1,1,3,0,1,379,86,32419,32488,34556,0,-103,-3,-10630,-17,-9073,-10969,-1,-1,-3,0,15
EUW1_6864844252',3,27,9,0,0,0,0,6,1,386,101,25731,30629,22141,4,32,8,1,0,0,0,2,417,114,27012,31171,24886,0,-31,-13,-1281,1,-542,-2745,-1,0,0,0,4
EUW1_6864826937',0,25,4,0,0,0,0,8,0,390,93,23713,28249,21037,5,28,16,2,0,1,0,2,398,100,29656,32898,27903,0,-8,-7,-5943,-12,-4649,-6866,-2,0,-1,0,6
EUW1_6864764585',1,22,9,0,0,0,0,6,0,337,71,24851,27453,26896,6,31,15,2,0,0,0,1,294,84,26060,29310,33474,1,43,-13,-1209,-6,-1857,-6578,-2,0,0,0,5
EUW1_6864726944',4,27,9,0,0,1,0,10,0,348,108,26939,28993,22632,6,25,11,1,0,1,0,2,322,94,26466,26248,23742,1,26,14,473,-2,2745,-1110,-1,0,0,0,8
EUW1_6864691388',6,29,11,2,0,0,0,13,0,369,98,28558,28881,28370,5,35,13,0,0,1,0,3,366,74,27630,27955,29818,1,3,24,928,-2,926,-1448,2,0,-1,0,10
EUW1_6864642643',4,26,7,1,0,0,0,8,0,372,80,25266,28390,33362,4,94,18,0,0,1,0,1,383,122,30602,36431,32093,0,-11,-42,-5336,-11,-8041,1269,1,0,-1,0,7
EUW1_6864619862',4,30,12,2,0,1,0,7,1,362,100,29028,29955,34461,3,35,7,0,0,1,0,6,352,75,24631,27026,29347,1,10,25,4397,5,2929,5114,2,0,0,0,1
EUW1_6866544623',3,29,11,1,0,1,0,6,0,373,68,28043,29887,38283,5,34,9,1,0,0,0,4,376,70,26170,30240,32806,0,-3,-2,1873,2,-353,5477,0,0,1,0,2
EUW1_6866494059',3,29,9,1,0,0,0,9,1,388,106,26303,29617,29711,2,28,5,0,0,0,0,4,372,83,24390,27754,25401,0,16,23,1913,4,1863,4310,1,0,0,0,5
EUW1_6866460668',1,21,4,1,0,0,0,11,0,342,89,22861,27909,25928,5,31,13,0,0,2,0,0,392,102,28870,30036,34223,0,-50,-13,-6009,-9,-2127,-8295,1,0,-2,0,11
EUW1_6866425539',5,27,19,0,0,2,0,9,1,366,91,31416,31128,37972,2,45,14,2,1,0,0,8,330,104,27711,30495,31228,1,36,-13,3705,5,633,6744,-2,-1,2,0,1
EUW1_6866258954',2,25,14,1,1,2,0,6,1,357,76,30884,29285,28477,2,190,14,0,0,0,0,5,377,103,29188,29630,30184,1,-20,-27,1696,0,-345,-1707,1,1,2,0,1
EUW1_6865597867',4,98,13,0,0,0,0,7,1,369,88,28702,30605,29363,5,33,5,1,0,0,0,4,351,83,24537,26697,22697,1,18,5,4165,8,3908,6666,-1,0,0,0,3
EUW1_6864952961',5,46,13,2,1,0,0,15,0,305,78,25570,27269,31932,5,21,11,0,0,2,0,1,348,114,28128,28335,29024,0,-43,-36,-2558,2,-1066,2908,2,1,-2,0,14
EUW1_6882416950',6,37,11,0,0,0,0,6,0,389,74,26256,30115,27768,6,32,6,2,0,0,0,1,403,80,24815,28914,24074,1,-14,-6,1441,5,1201,3694,-2,0,0,0,5
EUW1_6880402615',4,30,18,1,0,1,0,8,1,343,68,29520,30970,34364,4,40,15,0,0,0,0,7,342,87,28440,29018,35025,1,1,-19,1080,3,1952,-661,1,0,1,0,1
EUW1_6879036954',2,21,19,1,0,2,0,9,1,395,86,33697,33357,40483,3,31,9,0,0,0,0,5,276,78,23726,25879,28305,1,119,8,9971,10,7478,12178,1,0,2,0,4
EUW1_6878989156',6,30,8,1,0,0,0,15,0,315,77,23588,25659,27531,3,42,16,0,0,3,0,0,402,84,31598,31855,37480,0,-87,-7,-8010,-8,-6196,-9949,1,0,-3,0,15
EUW1_6878708982',5,30,24,2,0,2,0,6,1,366,94,33462,30624,36845,0,26,14,0,0,0,0,9,246,78,26663,23778,34434,1,120,16,6799,10,6846,2411,2,0,2,0,-3
EUW1_6878643915',5,43,13,0,1,0,0,10,1,343,95,26868,30218,26408,2,25,10,1,0,1,0,3,385,72,26678,30088,30348,0,-42,23,190,3,130,-3940,-1,1,-1,0,7
EUW1_6878319227',3,32,16,0,1,1,0,7,0,315,99,28591,29114,30723,2,34,12,0,0,1,0,5,337,68,26617,28066,36866,1,-22,31,1974,4,1048,-6143,0,1,0,0,2
EUW1_6877500873',3,23,11,0,0,0,0,12,0,250,85,23725,26701,21751,2,20,18,2,0,4,0,1,358,78,32039,29692,35169,0,-108,7,-8314,-7,-2991,-13418,-2,0,-4,0,11
EUW1_6877056224',4,26,13,0,0,0,0,9,1,307,80,26694,30014,34084,4,23,20,2,0,1,0,2,303,96,29911,30863,37237,0,4,-16,-3217,-7,-849,-3153,-2,0,-1,0,7
EUW1_6876747590',1,194,12,0,0,2,0,9,0,375,107,29953,29982,31688,5,29,10,2,0,0,0,10,367,74,26619,29913,28723,1,8,33,3334,2,69,2965,-2,0,2,0,-1
EUW1_6876705528',2,43,19,0,1,0,0,8,1,350,88,30332,30796,37099,6,153,11,0,0,1,0,6,319,76,26484,26699,31241,1,31,12,3848,8,4097,5858,0,1,-1,0,2
EUW1_6875732343',6,55,14,1,0,0,0,12,0,312,69,26540,27780,33763,1,59,21,0,0,2,0,1,368,94,32368,30999,42398,0,-56,-25,-5828,-7,-3219,-8635,1,0,-2,0,11
EUW1_6875574638',3,28,8,0,1,1,0,6,0,382,83,25150,29122,27300,1,27,7,1,0,1,0,2,348,80,24309,28185,25903,0,34,3,841,1,937,1397,-1,1,0,0,4
EUW1_6875530297',3,34,8,0,0,0,0,13,0,273,62,23362,24249,24232,3,33,17,0,0,2,0,0,348,94,28957,29118,38058,0,-75,-32,-5595,-9,-4869,-13826,0,0,-2,0,13
EUW1_6875484293',4,29,7,0,0,0,0,10,0,345,84,23872,27418,26736,5,27,13,2,0,1,0,2,387,78,27793,29235,26598,0,-42,6,-3921,-6,-1817,138,-2,0,-1,0,8
EUW1_6874977945',4,27,27,1,0,2,0,7,1,347,86,33725,30542,44972,0,25,7,0,0,1,0,10,274,78,24353,24609,28660,1,73,8,9372,20,5933,16312,1,0,1,0,-3
EUW1_6874585074',2,29,8,0,0,0,0,6,1,369,91,25352,30151,32252,4,33,11,0,0,1,0,2,390,87,27328,29485,37974,0,-21,4,-1976,-3,666,-5722,0,0,-1,0,4
EUW1_6874354624',5,45,8,0,0,0,0,9,1,313,96,24060,29059,28892,2,32,5,1,0,0,0,1,398,103,25589,31029,24059,0,-85,-7,-1529,3,-1970,4833,-1,0,0,0,8
EUW1_6874241563',6,30,4,2,0,0,0,5,1,364,106,24106,31924,18168,5,36,3,0,0,0,0,5,407,90,23152,29862,14156,1,-43,16,954,1,2062,4012,2,0,0,0,0
EUW1_6874035455',5,31,19,0,0,2,0,7,1,352,58,30793,28390,33069,6,33,13,1,0,0,0,5,320,80,27827,27132,31772,0,32,-22,2966,6,1258,1297,-1,0,2,0,2
TR1_1507562624',5,34,13,0,0,0,0,8,0,384,76,28171,29748,35668,4,22,14,2,0,1,0,7,300,88,26524,28130,36103,1,84,-12,1647,-1,1618,-435,-2,0,-1,0,1
TR1_1507563448',2,102,18,0,0,0,0,8,0,342,94,30505,30708,36453,4,26,13,2,0,1,0,5,346,84,28306,29861,36140,1,-4,10,2199,5,847,313,-2,0,-1,0,3
TR1_1507564108',3,26,21,1,0,0,0,10,1,323,75,29322,30088,38163,0,28,18,1,0,2,0,1,389,72,31309,30262,41095,1,-66,3,-1987,3,-174,-2932,0,0,-2,0,9
TR1_1507565031',1,24,8,0,0,1,0,7,1,296,103,25312,27007,34728,2,29,25,2,0,1,0,2,329,86,31502,30678,41903,0,-33,17,-6190,-17,-3671,-7175,-2,0,0,0,5
TR1_1507514988',10,33,9,0,0,0,0,11,1,320,94,25871,28236,27622,5,38,7,1,0,1,0,2,433,92,27475,29809,26918,1,-113,2,-1604,2,-1573,704,-1,0,-1,0,9
TR1_1507502026',5,28,22,1,1,2,0,7,0,366,98,33138,32013,39961,3,34,14,0,0,0,0,9,287,84,27086,27235,27607,1,79,14,6052,8,4778,12354,1,1,2,0,-2
TR1_1507481902',3,24,14,1,0,1,0,11,0,348,90,27423,29618,33547,2,39,10,1,0,0,0,3,321,111,25312,28763,27953,0,27,-21,2111,4,855,5594,0,0,1,0,8
TR1_1507474229',2,30,16,2,0,2,0,8,0,376,88,32112,31575,31946,2,32,10,0,0,2,0,5,331,72,25391,28030,26700,0,45,16,6721,6,3545,5246,2,0,0,0,3
TR1_1507463648',2,21,30,1,0,1,0,7,0,338,86,35587,32086,50942,0,20,15,0,0,1,0,6,312,79,28241,29358,36768,1,26,7,7346,15,2728,14174,1,0,0,0,1
TR1_1507460044',4,44,17,0,0,1,0,13,1,353,88,30392,29997,37408,0,28,10,2,0,0,0,4,277,96,25421,28595,29338,1,76,-8,4971,7,1402,8070,-2,0,1,0,9
TR1_1507445660',6,30,5,1,0,0,0,6,0,365,92,23923,27689,20837,5,42,12,1,0,0,0,2,341,111,26868,30500,30608,0,24,-19,-2945,-7,-2811,-9771,0,0,0,0,4
TR1_1507442249',5,30,18,2,0,0,0,10,1,371,94,29286,30937,39253,3,184,11,0,0,0,0,3,324,89,25670,26318,34009,1,47,5,3616,7,4619,5244,2,0,0,0,7
TR1_1507434149',6,23,22,1,0,2,0,8,1,343,102,32780,32239,44727,4,52,18,0,0,0,0,5,319,84,29801,29355,33960,1,24,18,2979,4,2884,10767,1,0,2,0,3
TR1_1507416834',4,24,9,0,0,0,0,6,0,371,100,25837,28570,29190,2,23,17,2,0,0,0,1,364,102,29813,30342,31482,0,7,-2,-3976,-8,-1772,-2292,-2,0,0,0,5
TR1_1507356052',3,26,23,2,0,2,0,12,1,351,94,33736,31748,38508,1,18,8,0,0,2,0,7,260,85,24182,25603,22034,1,91,9,9554,15,6145,16474,2,0,0,0,5
TR1_1507348997',2,26,25,2,0,7,1,5,0,403,83,34883,33765,44899,3,27,7,0,0,0,0,11,273,72,23587,27905,29652,1,130,11,11296,18,5860,15247,2,0,7,1,-6
TR1_1507347752',2,28,5,0,0,0,0,12,0,366,107,24438,29974,24560,7,52,14,2,0,0,0,0,389,96,28788,32185,33027,0,-23,11,-4350,-9,-2211,-8467,-2,0,0,0,12
TR1_1507335060',4,33,7,2,0,0,0,5,1,391,84,26388,29261,26076,6,42,8,0,0,1,0,4,398,94,26779,30787,25317,1,-7,-10,-391,-1,-1526,759,2,0,-1,0,1
EUW1_6878269427',2,42,22,1,1,4,0,8,0,398,81,34006,30286,33006,2,41,4,0,0,0,0,8,358,85,23485,27476,21968,1,40,-4,10521,18,2810,11038,1,1,4,0,0
EUW1_6878232643',4,35,11,0,0,0,0,5,1,349,80,26308,29611,28653,5,34,16,2,0,1,0,2,369,99,29766,30921,36884,0,-20,-19,-3458,-5,-1310,-8231,-2,0,-1,0,3
EUW1_6877989856',4,26,10,1,0,1,0,10,0,345,82,26733,27436,25831,3,27,9,1,1,1,0,5,355,101,27550,29024,26385,1,-10,-19,-817,1,-1588,-554,0,-1,0,0,5
EUW1_6877711180',6,32,14,0,0,0,0,8,0,375,93,28326,33237,33005,4,29,15,1,0,1,0,1,410,74,29628,30661,40070,0,-35,19,-1302,-1,2576,-7065,-1,0,-1,0,7
EUW1_6877681884',2,31,10,1,0,0,0,13,0,286,66,24930,26430,25813,2,59,27,0,0,4,0,2,398,94,35489,32687,45834,0,-112,-28,-10559,-17,-6257,-20021,1,0,-4,0,11
EUW1_6877622082',4,30,11,1,0,0,0,7,0,352,107,27071,28497,32234,1,31,13,1,0,1,0,2,363,86,27712,29708,36525,0,-11,21,-641,-2,-1211,-4291,0,0,-1,0,5
EUW1_6877564538',1,25,7,0,0,0,0,12,1,333,89,25015,27193,29252,2,255,21,1,0,3,0,5,369,118,33213,33456,37477,0,-36,-29,-8198,-14,-6263,-8225,-1,0,-3,0,7
EUW1_6877501585',5,34,12,1,0,0,0,12,0,313,84,26646,27170,29790,6,38,14,1,0,1,0,2,384,92,29307,29904,28740,0,-71,-8,-2661,-2,-2734,1050,0,0,-1,0,10
EUW1_6876628698',6,31,14,2,0,0,0,10,1,352,102,29035,30649,33129,8,36,11,0,0,0,0,5,367,85,26905,30348,28026,1,-15,17,2130,3,301,5103,2,0,0,0,5
EUW1_6876605529',4,31,10,2,1,1,0,10,1,422,113,28685,32669,21193,3,85,4,0,0,1,0,5,387,114,25316,30528,19786,1,35,-1,3369,6,2141,1407,2,1,0,0,5
EUW1_6876485815',2,42,19,1,0,0,0,7,0,318,113,30055,32399,34114,2,36,10,1,0,1,0,3,340,54,25892,27753,30421,1,-22,59,4163,9,4646,3693,0,0,-1,0,4
EUW1_6876469307',1,50,12,0,1,1,0,10,0,359,92,29142,29909,33892,2,34,15,2,0,0,0,3,330,60,28411,27677,34558,1,29,32,731,-3,2232,-666,-2,1,1,0,7
EUW1_6876460064',7,34,6,1,0,1,0,7,1,385,81,27230,31585,25625,3,43,7,1,0,0,0,8,366,110,24958,30686,20599,1,19,-29,2272,-1,899,5026,0,0,1,0,-1
EUW1_6876458560',3,28,13,1,1,0,0,7,1,364,94,28700,29099,35339,6,36,14,0,0,2,0,4,334,81,28791,29445,30961,1,30,13,-91,-1,-346,4378,1,1,-2,0,3
EUW1_6876447570',4,27,28,1,0,0,0,8,1,312,91,34796,28204,43731,6,226,14,0,0,2,0,5,288,36,26903,23649,35025,1,24,55,7893,14,4555,8706,1,0,-2,0,3
EUW1_6876433569',6,30,15,0,0,0,0,3,1,376,83,28788,30231,27841,4,38,10,1,0,1,0,3,334,80,25764,28849,32990,1,42,3,3024,5,1382,-5149,-1,0,-1,0,0
EUW1_6876419865',2,28,11,0,0,0,0,13,0,293,89,26526,26464,27230,6,33,18,1,0,1,0,2,399,83,31623,31668,33675,0,-106,6,-5097,-7,-5204,-6445,-1,0,-1,0,11
EUW1_6876395424',1,23,12,0,0,0,0,7,0,322,94,26557,28758,35736,4,19,18,2,0,0,0,1,328,89,28320,30572,35396,0,-6,5,-1763,-6,-1814,340,-2,0,0,0,6
EUW1_6876393519',9,45,16,1,0,1,0,10,1,387,76,29473,31814,35141,2,24,5,1,0,1,0,2,404,80,24905,30103,22554,1,-17,-4,4568,11,1711,12587,0,0,0,0,8
EUW1_6876365335',3,27,20,0,0,1,0,10,0,301,81,30313,28857,39701,1,21,17,2,0,0,0,5,327,90,29537,28781,40531,1,-26,-9,776,3,76,-830,-2,0,1,0,5
EUW1_6873776961',2,32,19,0,1,2,0,9,1,403,94,33922,32134,35013,2,23,16,0,0,1,0,4,312,90,28058,28491,27710,1,91,4,5864,3,3643,7303,0,1,1,0,5
EUW1_6866268085',3,28,14,1,0,0,0,10,0,362,113,28653,30267,31268,1,27,7,1,0,1,0,1,383,55,25980,27816,29108,1,-21,58,2673,7,2451,2160,0,0,-1,0,9
EUW1_6866253659',6,149,10,0,0,0,0,12,0,320,89,25800,30071,23156,2,24,13,2,1,2,0,0,418,119,30442,32732,28715,0,-98,-30,-4642,-3,-2661,-5559,-2,-1,-2,0,12
EUW1_6864596665',2,31,8,0,0,1,0,10,1,360,84,27464,29590,22438,2,31,12,2,0,2,0,6,369,92,26903,31138,29434,0,-9,-8,561,-4,-1548,-6996,-2,0,-1,0,4
EUW1_6864577210',2,120,17,1,1,0,0,10,0,367,69,30830,30947,40352,6,33,16,0,0,0,0,4,366,91,29662,30416,31611,1,1,-22,1168,1,531,8741,1,1,0,0,6
EUW1_6864569001',2,44,16,1,0,4,0,15,0,350,69,32054,29759,39465,5,46,20,0,0,0,0,9,350,95,31522,31214,41118,0,0,-26,532,-4,-1455,-1653,1,0,4,0,6
EUW1_6863360295',6,31,14,0,0,1,0,12,0,408,96,30572,31289,26443,4,63,7,1,0,1,0,5,386,96,26866,28832,21275,0,22,0,3706,7,2457,5168,-1,0,0,0,7
EUW1_6863329075',5,52,14,1,0,1,0,12,1,348,88,28092,28321,31111,3,33,12,1,0,1,0,4,336,66,26825,26532,31566,1,12,22,1267,2,1789,-455,0,0,0,0,8
EUW1_6863313759',7,39,11,1,0,0,0,14,1,388,110,27431,31196,27598,3,22,6,0,0,1,0,0,421,84,27123,30874,23204,1,-33,26,308,5,322,4394,1,0,-1,0,14
EUW1_6863282086',2,24,12,0,0,0,0,12,0,307,104,26589,28263,36476,1,67,27,1,0,1,0,4,340,96,33822,33178,47242,0,-33,8,-7233,-15,-4915,-10766,-1,0,-1,0,8
EUW1_6863278120',4,38,9,0,0,0,0,11,0,335,94,24824,29905,25956,3,47,15,2,1,2,0,2,398,94,30427,31938,35546,0,-63,0,-5603,-6,-2033,-9590,-2,-1,-2,0,9
EUW1_6863240927',2,152,14,0,0,0,0,10,0,354,104,29136,30851,32557,3,31,17,2,0,3,0,3,398,98,32242,31722,36824,0,-44,6,-3106,-3,-871,-4267,-2,0,-3,0,7
EUW1_6863244556',2,139,11,0,0,0,0,12,1,376,80,27260,27560,28795,4,28,19,1,0,5,0,6,386,92,32446,32469,34763,0,-10,-12,-5186,-8,-4909,-5968,-1,0,-5,0,6
EUW1_6862097539',9,36,18,0,0,0,0,8,1,324,80,27653,28431,27328,3,30,14,2,0,1,0,1,343,88,29751,29430,37591,0,-19,-8,-2098,4,-999,-10263,-2,0,-1,0,7
EUW1_6883744957',6,26,9,1,0,0,0,5,0,419,94,27540,31601,33793,5,33,9,1,0,2,0,4,368,89,24547,30541,27923,1,51,5,2993,0,1060,5870,0,0,-2,0,1
EUW1_6883213605',2,21,7,1,0,0,0,8,0,310,84,23407,26442,34276,5,27,20,1,0,1,0,4,332,76,28852,31715,40008,0,-22,8,-5445,-13,-5273,-5732,0,0,-1,0,4
EUW1_6883038606',5,28,7,1,0,0,0,6,0,356,88,25085,27380,22968,6,35,11,1,0,0,0,1,388,103,27752,30750,29971,0,-32,-15,-2667,-4,-3370,-7003,0,0,0,0,5
EUW1_6882662131',5,26,8,0,0,0,0,6,1,353,70,25322,27988,29246,4,21,8,0,0,0,0,3,341,86,24602,28475,29861,0,12,-16,720,0,-487,-615,0,0,0,0,3
EUW1_6882621323',4,31,9,0,0,0,0,16,0,248,51,22676,24046,32689,7,23,25,0,1,3,0,0,380,116,36345,32208,43344,0,-132,-65,-13669,-16,-8162,-10655,0,-1,-3,0,16
EUW1_6882608475',7,26,24,1,1,0,0,7,1,378,106,31903,32429,37245,2,22,5,0,0,2,0,5,302,68,21532,26280,20574,1,76,38,10371,19,6149,16671,1,1,-2,0,2
EUW1_6882574711',3,23,15,1,0,0,0,11,1,300,70,26883,28172,33033,1,134,20,0,0,0,0,1,341,93,30316,31166,40925,0,-41,-23,-3433,-5,-2994,-7892,1,0,0,0,10
EUW1_6882546602',5,25,14,0,0,0,0,10,0,315,92,27753,28134,36076,4,31,21,2,1,1,0,3,352,99,31365,30873,37356,0,-37,-7,-3612,-7,-2739,-1280,-2,-1,-1,0,7
EUW1_6882097198',5,29,9,2,0,0,0,4,1,379,101,24949,29655,27305,5,32,5,0,1,0,0,3,389,76,23827,28425,23054,1,-10,25,1122,4,1230,4251,2,-1,0,0,1
EUW1_6882032938',4,31,15,0,1,0,0,10,1,394,84,28961,30652,33315,2,23,10,1,0,1,0,4,356,103,26966,31745,26628,0,38,-19,1995,5,-1093,6687,-1,1,-1,0,6
EUW1_6881980665',5,33,16,0,0,0,0,15,1,369,94,30109,28650,36139,7,23,18,1,0,0,0,2,320,78,29772,29558,31804,0,49,16,337,-2,-908,4335,-1,0,0,0,13
EUW1_6881909442',4,20,10,0,0,1,0,10,0,313,73,27527,26719,35576,6,25,18,1,0,1,0,6,343,94,29973,31760,33128,1,-30,-21,-2446,-8,-5041,2448,-1,0,0,0,4
EUW1_6871123851',3,46,10,0,1,0,0,7,1,344,92,25904,28518,26254,3,25,8,1,0,0,0,0,368,82,24406,27394,32042,0,-24,10,1498,2,1124,-5788,-1,1,0,0,7
EUW1_6865108757',1,24,10,0,0,0,0,9,0,288,87,23736,26996,38528,4,28,19,2,0,2,0,2,327,111,32017,31499,42598,0,-39,-24,-8281,-9,-4503,-4070,-2,0,-2,0,7
EUW1_6864427905',2,22,6,0,0,1,0,14,1,326,91,24755,26177,32001,1,18,16,2,0,2,0,8,352,88,29740,30132,27526,0,-26,3,-4985,-10,-3955,4475,-2,0,-1,0,6
EUW1_6863739879',4,28,29,0,0,10,2,5,1,358,100,38896,30765,38424,2,21,5,0,0,0,0,13,216,59,18614,18965,18944,1,142,41,20282,24,11800,19480,0,0,10,2,-8
EUW1_6861936845',5,32,11,1,1,1,0,13,1,354,104,28819,29359,32472,4,34,14,0,0,0,0,5,318,79,26337,29310,31123,1,36,25,2482,-3,49,1349,1,1,1,0,8
EUW1_6860057845',2,78,11,1,1,0,0,7,1,402,101,27579,33566,34528,4,56,6,1,0,0,0,3,335,102,23657,27604,23676,1,67,-1,3922,5,5962,10852,0,1,0,0,4
EUW1_6859992082',7,41,9,0,0,1,0,10,0,323,80,26057,26678,29189,4,34,10,1,0,0,0,2,380,75,25486,28638,27704,0,-57,5,571,-1,-1960,1485,-1,0,1,0,8
EUW1_6859915573',1,29,8,0,0,0,0,8,0,356,82,25119,29931,26519,5,32,15,2,0,2,0,1,356,92,29124,30222,28126,0,0,-10,-4005,-7,-291,-1607,-2,0,-2,0,7
EUW1_6858484914',2,49,13,1,0,2,0,8,1,391,80,30264,30611,32760,0,30,6,0,0,0,0,7,315,80,23521,26057,27869,1,76,0,6743,7,4554,4891,1,0,2,0,1
EUW1_6824885849',4,33,12,1,1,0,0,3,1,393,74,28780,31309,31222,3,42,13,1,0,0,0,6,343,105,28124,30591,29216,0,50,-31,656,-1,718,2006,0,1,0,0,-3
EUW1_6824799518',1,17,14,1,0,0,0,12,0,374,90,28945,31643,38391,3,23,19,1,0,2,0,3,365,98,31099,31334,39844,0,9,-8,-2154,-5,309,-1453,0,0,-2,0,9
EUW1_6824694164',4,66,9,1,0,0,0,11,0,343,76,25367,27645,27286,1,78,11,0,1,0,0,1,342,94,26741,29949,28606,0,1,-18,-1374,-2,-2304,-1320,1,-1,0,0,10
EUW1_6824590058',3,352,15,1,0,1,0,3,1,341,78,28585,28375,35687,0,57,10,1,0,0,0,5,320,78,24382,26929,36656,0,21,0,4203,5,1446,-969,0,0,1,0,-2
EUW1_6824325431',5,30,10,1,1,1,0,6,1,334,118,27287,29559,29607,1,23,10,1,0,0,0,5,358,94,26522,29223,27884,1,-24,24,765,0,336,1723,0,1,1,0,1
EUW1_6824112419',4,24,15,1,0,1,0,10,0,319,92,28940,27778,38740,2,22,13,0,1,1,0,3,365,108,29420,32162,34087,1,-46,-16,-480,2,-4384,4653,1,-1,0,0,7
EUW1_6823525820',6,26,13,1,0,1,0,9,1,391,78,29190,30147,29176,2,25,8,1,0,1,0,7,330,88,24506,27513,28755,1,61,-10,4684,5,2634,421,0,0,0,0,2
EUW1_6823475749',1,30,5,0,0,0,0,10,0,352,96,24272,28361,28288,3,39,16,2,0,0,0,0,362,100,28074,30514,35374,0,-10,-4,-3802,-11,-2153,-7086,-2,0,0,0,10
EUW1_6823075243',7,32,12,2,0,0,0,5,1,399,85,27784,30227,34637,3,27,6,0,0,0,0,5,379,100,25755,30561,22999,0,20,-15,2029,6,-334,11638,2,0,0,0,0
EUW1_6823017694',4,21,9,2,0,0,0,5,0,381,80,26446,29727,30586,0,22,8,0,0,0,0,1,349,104,25079,29355,20927,1,32,-24,1367,1,372,9659,2,0,0,0,4
EUW1_6875232717',4,67,8,0,0,0,0,8,1,336,61,23526,25675,24597,4,26,12,0,0,0,0,0,374,89,26781,29304,28153,0,-38,-28,-3255,-4,-3629,-3556,0,0,0,0,8
EUW1_6875213706',8,41,21,1,1,1,0,4,1,381,88,33313,32075,34623,4,27,8,1,0,0,0,8,348,96,24769,27972,27132,1,33,-8,8544,13,4103,7491,0,1,1,0,-4
EUW1_6875185894',5,69,12,2,0,0,0,7,0,346,109,27099,30361,33399,3,86,6,0,0,0,0,2,336,102,24473,29600,22434,1,10,7,2626,6,761,10965,2,0,0,0,5
EUW1_6875090494',1,18,7,0,0,0,0,14,1,303,90,23813,27715,21370,2,25,20,1,1,2,0,0,362,107,31273,33989,41419,0,-59,-17,-7460,-13,-6274,-20049,-1,-1,-2,0,14
EUW1_6875072994',3,26,17,1,0,0,0,5,1,361,98,30044,32425,33488,0,27,8,1,1,4,0,6,325,122,25697,29004,28693,1,36,-24,4347,9,3421,4795,0,-1,-4,0,-1
EUW1_6874395702',1,47,15,2,0,0,0,5,1,375,88,28675,30790,36494,2,23,8,0,0,1,0,8,294,104,23415,28564,18190,1,81,-16,5260,7,2226,18304,2,0,-1,0,-3
EUW1_6874321445',5,23,13,0,0,1,0,5,1,355,75,27489,29353,35480,3,362,11,2,0,0,0,6,331,68,25825,29358,32200,0,24,7,1664,2,-5,3280,-2,0,1,0,-1
EUW1_6874286608',3,23,12,0,0,0,0,12,0,320,94,28295,30679,45656,2,19,17,2,0,2,0,3,349,112,30554,32027,36271,1,-29,-18,-2259,-5,-1348,9385,-2,0,-2,0,9
EUW1_6874145936',7,28,23,1,1,1,0,8,1,392,110,33592,34024,38618,1,22,9,1,0,2,0,7,332,74,25409,25662,28252,1,60,36,8183,14,8362,10366,0,1,-1,0,1
EUW1_6873774079',6,27,5,0,0,2,0,6,1,388,92,25923,28555,27607,2,28,7,2,0,1,0,4,414,88,26110,30071,31208,1,-26,4,-187,-2,-1516,-3601,-2,0,1,0,2
EUW1_6872578956',4,30,12,0,0,1,0,11,1,369,86,28440,30316,30890,3,34,6,1,0,0,0,7,363,102,25290,30664,23827,1,6,-16,3150,6,-348,7063,-1,0,1,0,4
EUW1_6872538277',6,27,6,2,1,0,0,7,0,314,139,24647,30742,22942,3,70,7,0,0,2,0,3,396,75,26223,29568,25409,1,-82,64,-1576,-1,1174,-2467,2,1,-2,0,4
EUW1_6871097698',4,69,14,0,0,1,0,9,1,360,91,28989,30318,28870,3,68,9,1,0,0,0,6,312,81,24730,27364,25390,0,48,10,4259,5,2954,3480,-1,0,1,0,3
EUW1_6871068748',4,62,10,0,0,1,0,8,0,374,74,27500,29021,27915,5,30,15,2,0,1,0,6,361,97,28677,30145,32888,0,13,-23,-1177,-5,-1124,-4973,-2,0,0,0,2
EUW1_6870293020',3,27,12,0,0,0,0,13,0,323,89,26947,28192,28734,3,55,17,1,1,3,0,5,370,94,32225,31854,35037,0,-47,-5,-5278,-5,-3662,-6303,-1,-1,-3,0,8
EUW1_6870216936',2,35,10,2,0,0,0,9,1,303,86,25304,28269,22802,4,21,13,0,0,1,0,4,352,86,27261,29677,36244,1,-49,0,-1957,-3,-1408,-13442,2,0,-1,0,5
EUW1_6869858455',4,24,12,1,0,1,0,7,1,365,88,27072,30955,26810,3,24,7,1,0,0,0,2,377,98,25549,30533,31897,0,-12,-10,1523,5,422,-5087,0,0,1,0,5
EUW1_6869391044',6,55,12,1,0,1,0,4,1,356,87,28258,27780,25079,2,29,12,1,0,0,0,6,339,84,26520,29899,26051,0,17,3,1738,0,-2119,-972,0,0,1,0,-2
EUW1_6869372772',2,24,12,0,0,0,0,10,0,335,90,27517,28853,33439,2,20,19,1,0,2,0,4,343,78,30081,30135,33597,0,-8,12,-2564,-7,-1282,-158,-1,0,-2,0,6
EUW1_6868650443',3,30,11,0,0,1,0,9,1,338,85,27186,27460,35018,5,25,17,1,1,3,0,1,353,73,29934,29910,38865,0,-15,12,-2748,-6,-2450,-3847,-1,-1,-2,0,8
EUW1_6882259170',3,37,9,2,0,1,0,8,1,380,86,27314,30596,36164,5,45,9,0,0,0,0,6,339,71,25050,28276,31321,1,41,15,2264,0,2320,4843,2,0,1,0,2
EUW1_6882165765',4,43,12,1,0,0,0,7,1,357,82,27040,29271,29132,0,60,3,0,1,0,0,8,390,94,24232,27212,23088,1,-33,-12,2808,9,2059,6044,1,-1,0,0,-1
EUW1_6874754431',3,26,11,1,1,1,0,8,0,365,90,27947,29846,34082,7,29,7,1,0,0,0,3,349,73,24262,25647,22332,1,16,17,3685,4,4199,11750,0,1,1,0,5
EUW1_6874572396',5,136,11,1,0,0,0,11,0,324,82,26364,27796,30388,4,31,15,1,0,0,0,1,392,89,29207,31083,35693,0,-68,-7,-2843,-4,-3287,-5305,0,0,0,0,10
EUW1_6874515492',5,32,4,0,0,0,0,7,0,383,86,23181,28643,19746,3,32,8,2,1,1,0,0,436,98,26854,30990,24842,0,-53,-12,-3673,-4,-2347,-5096,-2,-1,-1,0,7
EUW1_6883647825',1,23,12,0,0,2,0,5,0,350,88,28620,28475,32898,4,26,16,2,0,1,0,9,330,112,28211,29689,28639,1,20,-24,409,-4,-1214,4259,-2,0,1,0,-4
EUW1_6883633826',2,228,22,2,0,4,0,8,1,408,88,34335,33975,37880,1,24,6,0,0,1,0,7,329,96,23652,27176,23018,1,79,-8,10683,16,6799,14862,2,0,3,0,1
EUW1_6882940780',5,154,14,1,1,2,0,5,1,376,112,29873,32243,32073,7,41,6,1,0,0,0,9,311,84,22893,26246,21695,1,65,28,6980,8,5997,10378,0,1,2,0,-4
EUW1_6882872451',5,65,8,2,1,1,0,5,1,355,106,25910,31455,26579,7,71,7,0,0,0,0,4,348,90,23927,29093,22410,1,7,16,1983,1,2362,4169,2,1,1,0,1
EUW1_6880514328',4,22,9,0,1,1,0,10,1,336,68,26542,27264,26116,4,37,16,2,0,0,0,3,323,82,28366,28407,31752,1,13,-14,-1824,-7,-1143,-5636,-2,1,1,0,7
EUW1_6880455453',4,31,4,0,0,0,0,10,0,405,75,25669,27989,24092,6,32,13,2,0,1,0,3,392,131,29333,32992,30296,0,13,-56,-3664,-9,-5003,-6204,-2,0,-1,0,7
EUW1_6880404810',3,203,13,1,0,2,0,7,0,332,108,28743,29662,36325,3,30,14,0,0,2,0,6,362,82,29637,29913,30984,0,-30,26,-894,-1,-251,5341,1,0,0,0,1
EUW1_6880337421',3,24,12,1,0,2,0,6,1,414,102,30293,32431,34087,4,29,7,0,0,0,0,6,358,91,24436,27216,26832,1,56,11,5857,5,5215,7255,1,0,2,0,0
EUW1_6880281943',7,30,11,2,0,0,0,8,0,368,90,26148,30361,27619,1,25,4,0,0,0,0,5,388,94,24522,28259,21727,1,-20,-4,1626,7,2102,5892,2,0,0,0,3
EUW1_6880217164',5,28,9,1,0,0,0,13,0,364,92,25608,30821,22412,5,32,7,1,0,2,0,2,432,112,28433,31567,26439,1,-68,-20,-2825,2,-746,-4027,0,0,-2,0,11
EUW1_6880185712',7,28,8,1,0,0,0,13,1,327,77,24670,27381,31895,3,26,22,1,0,3,0,1,410,119,34912,35043,38908,0,-83,-42,-10242,-14,-7662,-7013,0,0,-3,0,12
EUW1_6880121048',2,53,5,0,1,0,0,4,0,358,92,23071,30147,25285,5,27,4,2,0,1,0,0,412,119,24832,29621,20986,0,-54,-27,-1761,1,526,4299,-2,1,-1,0,4
EUW1_6879295332',4,27,19,1,0,2,0,13,1,375,123,32327,32563,43422,5,32,17,1,0,2,0,5,313,84,28889,28614,30320,1,62,39,3438,2,3949,13102,0,0,0,0,8
EUW1_6879286641',2,28,15,1,0,0,0,8,1,341,87,28671,29961,34874,4,29,14,0,0,2,0,3,335,108,29171,30064,31701,0,6,-21,-500,1,-103,3173,1,0,-2,0,5
EUW1_6877839581',6,41,13,0,0,1,0,12,0,319,102,29796,26984,33276,2,77,27,2,0,2,0,5,283,68,32726,26932,44219,0,36,34,-2930,-14,52,-10943,-2,0,-1,0,7
EUW1_6883601341',4,26,17,1,0,0,0,10,1,368,93,29901,31337,36558,7,37,14,0,0,0,0,4,320,72,26928,27827,31772,0,48,21,2973,3,3510,4786,1,0,0,0,6
EUW1_6883587524',3,30,10,0,0,0,0,9,1,371,70,24699,31296,27427,3,27,8,2,0,0,0,0,368,114,25643,29868,27692,1,3,-44,-944,2,1428,-265,-2,0,0,0,9
EUW1_6883545992',6,28,10,0,1,0,0,13,0,333,88,26118,28435,30533,5,30,10,2,0,1,0,2,390,84,27621,29908,33081,1,-57,4,-1503,0,-1473,-2548,-2,1,-1,0,11
EUW1_6883469499',2,23,12,2,0,0,0,2,1,390,79,26481,29712,30706,2,22,5,0,0,0,0,4,349,75,22603,26033,21767,1,41,4,3878,7,3679,8939,2,0,0,0,-2
EUW1_6883412468',5,183,18,2,0,2,0,10,0,326,76,30237,29669,34785,4,22,16,0,0,2,0,5,366,87,31647,30020,32454,1,-40,-11,-1410,2,-351,2331,2,0,0,0,5
EUW1_6883323425',4,29,15,0,0,0,0,14,1,336,86,28477,28188,37222,3,20,19,2,0,3,0,1,319,82,31404,29545,37827,0,17,4,-2927,-4,-1357,-605,-2,0,-3,0,13
EUW1_6883273660',5,26,18,2,0,0,0,5,0,345,107,30642,32551,36085,3,41,9,0,0,1,0,2,306,92,23735,24826,26915,1,39,15,6907,9,7725,9170,2,0,-1,0,3
EUW1_6883189226',1,140,11,1,0,1,0,5,0,388,85,27953,29978,28779,1,28,12,1,0,0,0,5,350,86,25739,29122,27113,0,38,-1,2214,-1,856,1666,0,0,1,0,0
EUW1_6883142591',6,30,14,1,0,0,0,7,1,391,106,28261,30507,42258,8,29,12,1,0,0,0,3,334,77,27019,30521,29234,0,57,29,1242,2,-14,13024,0,0,0,0,4
EUW1_6882959354',2,29,15,1,0,1,0,11,0,373,94,30178,30404,40000,3,28,9,0,0,2,0,5,349,78,26072,28537,27873,0,24,16,4106,6,1867,12127,1,0,-1,0,6
EUW1_6882920180',6,34,9,0,0,0,0,10,0,375,78,26429,30122,35004,7,28,14,2,0,2,0,3,368,89,29132,32497,31168,0,7,-11,-2703,-5,-2375,3836,-2,0,-2,0,7
EUW1_6882858930',3,28,6,1,0,1,0,7,1,387,81,26037,29672,30227,5,33,4,1,0,0,0,6,382,84,24120,29447,25134,0,5,-3,1917,2,225,5093,0,0,1,0,1
EUW1_6882803438',6,27,12,2,0,0,0,7,0,371,104,27724,29890,25076,2,53,11,0,0,2,0,4,361,80,27638,27729,28758,1,10,24,86,1,2161,-3682,2,0,-2,0,3
EUW1_6882753303',5,29,15,0,0,0,0,9,1,344,84,27751,29818,33800,2,29,13,1,0,1,0,1,329,78,27546,28318,32044,0,15,6,205,2,1500,1756,-1,0,-1,0,8
EUW1_6882719585',1,25,8,1,0,1,0,7,0,367,86,26632,30271,28258,3,23,7,1,0,0,0,5,367,94,24661,28521,31222,1,0,-8,1971,1,1750,-2964,0,0,1,0,2
EUW1_6882683989',5,37,8,1,0,1,0,9,0,353,76,24712,26858,27822,5,30,23,1,0,2,0,1,371,96,33388,33531,40104,0,-18,-20,-8676,-15,-6673,-12282,0,0,-1,0,8
EUW1_6882643171',5,29,14,2,0,1,0,7,1,362,78,27272,29583,27838,2,32,8,0,0,0,0,2,371,90,25543,28824,30416,1,-9,-12,1729,6,759,-2578,2,0,1,0,5
EUW1_6882155265',1,133,23,1,0,2,0,5,1,279,106,32071,30772,42819,0,25,12,0,0,0,0,8,287,69,25631,26858,38485,1,-8,37,6440,11,3914,4334,1,0,2,0,-3
EUW1_6881908322',5,30,14,1,1,0,0,7,1,338,80,29242,28006,40208,5,32,20,1,0,2,0,3,307,84,29326,28994,41268,0,31,-4,-84,-6,-988,-1060,0,1,-2,0,4
EUW1_6883455492',4,27,22,2,0,1,0,4,1,406,99,33306,34130,44281,1,27,6,0,0,0,0,7,325,94,23675,27912,25678,1,81,5,9631,16,6218,18603,2,0,1,0,-3
EUW1_6883399607',2,23,20,1,0,1,0,11,1,383,84,31380,31107,35184,3,22,16,1,0,0,0,3,359,91,29655,31324,37243,0,24,-7,1725,4,-217,-2059,0,0,1,0,8
EUW1_6881525453',2,23,13,1,0,2,0,10,1,384,96,29017,30570,30829,9,34,5,0,0,1,0,7,352,62,23775,25706,21922,1,32,34,5242,8,4864,8907,1,0,1,0,3
EUW1_6881411505',5,27,17,1,1,1,0,8,1,381,128,30259,32942,38854,4,30,10,1,0,1,0,7,338,64,25689,28325,29734,1,43,64,4570,7,4617,9120,0,1,0,0,1
EUW1_6881261002',3,29,13,0,0,0,0,11,0,319,101,26623,30460,32839,2,29,17,1,1,2,0,3,352,82,29874,30072,41803,0,-33,19,-3251,-4,388,-8964,-1,-1,-2,0,8
EUW1_6879580907',2,23,5,0,0,0,0,11,1,392,72,23429,29217,20415,5,30,8,1,0,1,0,1,402,112,28088,31102,27257,0,-10,-40,-4659,-3,-1885,-6842,-1,0,-1,0,10
EUW1_6879366386',3,41,17,0,0,0,0,12,0,351,78,28285,28514,38038,7,34,21,2,1,2,0,3,335,82,31596,29543,33466,0,16,-4,-3311,-4,-1029,4572,-2,-1,-2,0,9
EUW1_6879362862',3,28,11,1,0,0,0,8,0,350,78,26597,28438,33307,2,24,16,1,0,1,0,4,373,94,28410,29797,37788,0,-23,-16,-1813,-5,-1359,-4481,0,0,-1,0,4
EUW1_6879272195',4,225,16,2,0,0,0,7,1,376,90,28437,30234,33373,7,155,8,0,0,1,0,7,363,78,25177,27812,37440,1,13,12,3260,8,2422,-4067,2,0,-1,0,0
EUW1_6879257636',4,215,18,2,1,0,0,11,1,355,122,30801,32653,32758,5,40,9,0,0,1,0,2,397,85,27670,29020,29896,1,-42,37,3131,9,3633,2862,2,1,-1,0,9
EUW1_6877895945',2,24,12,1,1,2,0,6,1,331,110,28633,29799,35419,2,30,11,1,0,0,0,3,337,77,24612,27305,32346,1,-6,33,4021,1,2494,3073,0,1,2,0,3
EUW1_6877884322',1,14,8,0,0,0,0,11,0,364,75,25345,29087,43048,3,34,18,2,0,3,0,4,372,84,30450,32421,40354,0,-8,-9,-5105,-10,-3334,2694,-2,0,-3,0,7
EUW1_6877876140',2,29,13,0,1,2,0,6,0,355,87,28923,28215,34055,1,30,17,2,0,1,0,7,364,72,29839,30730,40109,0,-9,15,-916,-4,-2515,-6054,-2,1,1,0,-1
EUW1_6877850421',2,29,11,0,0,1,0,9,0,366,78,27241,29837,25610,1,25,14,1,0,1,0,8,331,90,28532,30589,32553,0,35,-12,-1291,-3,-752,-6943,-1,0,0,0,1
EUW1_6877071925',2,28,14,0,0,0,0,8,0,321,118,28940,30579,41666,3,26,21,2,1,2,0,3,371,77,32799,32078,40837,0,-50,41,-3859,-7,-1499,829,-2,-1,-2,0,5
EUW1_6877012638',2,31,19,0,0,0,0,6,1,395,98,30451,32715,39230,1,25,11,2,0,1,0,2,360,92,27219,29468,29108,1,35,6,3232,8,3247,10122,-2,0,-1,0,4
EUW1_6876946342',4,26,14,0,0,1,0,10,0,340,86,31181,29140,37230,4,26,22,2,0,1,0,8,331,85,31395,30212,36768,0,9,1,-214,-8,-1072,462,-2,0,0,0,2
EUW1_6876274409',3,25,9,0,0,0,0,11,0,303,92,25068,26573,31162,2,21,20,2,0,2,0,0,364,86,31205,32319,45347,0,-61,6,-6137,-11,-5746,-14185,-2,0,-2,0,11
EUW1_6871365772',2,25,14,0,0,2,0,9,0,363,116,31324,33255,37090,2,23,13,2,0,0,0,7,330,84,26235,28749,28657,1,33,32,5089,1,4506,8433,-2,0,2,0,2
EUW1_6869702107',4,31,17,1,0,2,0,8,0,374,100,30644,32509,38416,5,40,10,0,0,1,0,7,367,72,26264,30363,34655,1,7,28,4380,7,2146,3761,1,0,1,0,1
EUW1_6868056658',8,23,14,0,1,2,0,10,1,348,88,29360,29074,30571,0,21,10,1,0,1,0,9,371,100,26858,29646,27494,1,-23,-12,2502,4,-572,3077,-1,1,1,0,1
EUW1_6867999353',1,28,25,1,0,0,0,6,0,311,74,32382,31883,43834,7,30,26,1,0,0,0,6,317,76,31913,31177,50910,0,-6,-2,469,-1,706,-7076,0,0,0,0,0
EUW1_6867702703',4,39,16,1,0,2,0,11,0,364,75,31092,30148,37110,4,24,11,1,1,1,0,2,345,96,27482,28741,30370,1,19,-21,3610,5,1407,6740,0,-1,1,0,9
EUW1_6866509852',2,32,21,1,0,0,0,11,0,314,66,31243,28049,40975,8,32,20,1,0,1,0,5,298,68,29224,27083,42378,1,16,-2,2019,1,966,-1403,0,0,-1,0,6
EUW1_6866469022',6,30,13,1,0,0,0,11,1,318,90,25871,26501,27067,4,56,14,0,0,2,0,1,376,81,28785,29546,34158,1,-58,9,-2914,-1,-3045,-7091,1,0,-2,0,10
EUW1_6866388620',0,26,7,0,0,1,0,11,1,331,90,25436,27002,25792,2,25,18,2,0,1,0,4,248,77,26875,24690,33931,0,83,13,-1439,-11,2312,-8139,-2,0,0,0,7
EUW1_6866350752',3,35,15,2,0,0,0,15,1,348,78,27841,28947,34317,7,28,15,0,0,1,0,0,329,102,28836,29382,34234,0,19,-24,-995,0,-435,83,2,0,-1,0,15
EUW1_6866240690',3,50,16,1,0,0,0,12,0,313,88,27515,28378,39374,0,32,21,0,0,1,0,2,300,80,30639,27402,39037,0,13,8,-3124,-5,976,337,1,0,-1,0,10
EUW1_6866217207',3,34,8,0,0,0,0,4,1,387,95,26129,29317,27420,3,29,9,2,0,1,0,2,363,76,26432,29686,23651,0,24,19,-303,-1,-369,3769,-2,0,-1,0,2
EUW1_6866136499',2,23,9,0,0,0,0,8,0,365,126,27262,29941,30586,6,46,12,1,0,1,0,3,360,80,28511,29502,32508,1,5,46,-1249,-3,439,-1922,-1,0,-1,0,5
EUW1_6864701671',7,26,10,0,0,1,0,14,1,333,87,26617,28791,26628,5,26,14,2,0,3,0,4,375,88,30382,30054,34505,0,-42,-1,-3765,-4,-1263,-7877,-2,0,-2,0,10
EUW1_6882344394',2,25,9,1,0,0,0,7,0,388,85,25921,28846,29248,5,26,11,1,0,1,0,3,334,80,26463,30448,30010,0,54,5,-542,-2,-1602,-762,0,0,-1,0,4
EUW1_6882346687',3,27,5,0,0,0,0,12,0,352,73,22831,26880,18230,4,27,14,1,1,4,0,2,407,114,32829,32774,33916,0,-55,-41,-9998,-9,-5894,-15686,-1,-1,-4,0,10
EUW1_6882286635',4,27,16,1,0,1,0,11,0,365,96,29617,31405,35583,1,29,18,1,0,1,0,6,356,84,29533,29980,41012,0,9,12,84,-2,1425,-5429,0,0,0,0,5
EUW1_6882251203',2,53,2,0,0,0,0,12,0,329,96,22501,26579,19742,5,28,14,2,0,5,0,1,399,75,31567,31415,26119,0,-70,21,-9066,-12,-4836,-6377,-2,0,-5,0,11
EUW1_6881872137',3,36,12,0,0,0,0,11,1,384,95,27117,30786,33097,3,36,11,1,1,1,0,2,373,97,27936,29668,34570,0,11,-2,-819,1,1118,-1473,-1,-1,-1,0,9
EUW1_6876745274',10,26,17,1,0,0,0,11,1,315,92,28617,28890,37345,3,25,21,1,0,1,0,4,374,84,32633,32081,38926,0,-59,8,-4016,-4,-3191,-1581,0,0,-1,0,7
EUW1_6876710720',3,23,14,1,0,0,0,6,1,360,90,28555,29241,31990,1,25,12,1,0,1,0,2,380,91,29404,31218,40831,1,-20,-1,-849,2,-1977,-8841,0,0,-1,0,4
EUW1_6876618033',5,34,12,1,0,1,0,6,0,390,99,28985,30422,28856,4,25,14,1,1,0,0,3,385,76,27313,30133,26574,1,5,23,1672,-2,289,2282,0,-1,1,0,3
EUW1_6876433727',7,31,13,0,1,0,0,5,1,300,74,26365,25927,33583,6,34,23,2,0,1,0,1,364,89,32156,32773,40001,0,-64,-15,-5791,-10,-6846,-6418,-2,1,-1,0,4
EUW1_6875246913',5,33,6,0,0,0,0,4,1,386,97,24491,29224,26243,4,52,13,1,0,1,0,1,354,118,28252,31652,28415,0,32,-21,-3761,-7,-2428,-2172,-1,0,-1,0,3
EUW1_6875213101',3,23,12,1,0,0,0,10,1,421,110,27356,32727,34587,3,30,9,1,0,1,0,1,396,112,27775,33333,31929,1,25,-2,-419,3,-606,2658,0,0,-1,0,9
EUW1_6875188427',4,45,21,2,0,2,0,2,1,369,120,32845,33589,41292,2,20,9,0,0,0,0,9,341,76,24110,27361,24357,1,28,44,8735,12,6228,16935,2,0,2,0,-7
EUW1_6875170063',7,27,6,1,1,2,0,4,0,397,117,27119,30984,26778,4,22,4,1,0,0,0,7,379,102,23218,29475,23001,0,18,15,3901,2,1509,3777,0,1,2,0,-3
EUW1_6883757978',2,21,13,0,0,2,0,7,1,389,87,29923,28521,32303,4,26,16,1,0,1,0,6,357,79,28677,29464,25509,1,32,8,1246,-3,-943,6794,-1,0,1,0,1
EUW1_6883395241',0,23,7,0,0,1,0,9,0,336,64,24393,27508,22736,3,144,18,1,1,2,0,3,362,96,31745,31243,38409,0,-26,-32,-7352,-11,-3735,-15673,-1,-1,-1,0,6
EUW1_6881333242',0,20,3,0,0,2,0,13,0,376,72,24474,26830,20866,1,72,16,2,1,2,0,6,385,128,30835,33540,34375,0,-9,-56,-6361,-13,-6710,-13509,-2,-1,0,0,7
EUW1_6881274327',1,23,13,1,0,1,0,11,0,353,86,28517,29566,31064,0,24,16,1,0,1,0,3,353,92,29539,30001,33521,1,0,-6,-1022,-3,-435,-2457,0,0,0,0,8
EUW1_6881205091',4,27,12,0,0,0,0,9,1,362,112,27483,30084,31683,4,31,9,2,0,2,0,2,361,84,26808,28568,28358,1,1,28,675,3,1516,3325,-2,0,-2,0,7
EUW1_6881162508',1,21,10,0,0,1,0,7,1,404,111,28152,31387,30455,2,90,7,1,0,0,0,3,350,104,24747,29947,27688,1,54,7,3405,3,1440,2767,-1,0,1,0,4
EUW1_6881120606',2,27,9,0,0,0,0,12,0,297,81,24372,27066,27316,7,31,17,2,0,2,0,1,394,86,31135,31612,35274,0,-97,-5,-6763,-8,-4546,-7958,-2,0,-2,0,11
EUW1_6881062626',1,37,8,1,0,0,0,14,0,351,84,24910,29237,29037,4,34,19,1,0,2,0,2,377,108,31305,32642,36741,0,-26,-24,-6395,-11,-3405,-7704,0,0,-2,0,12
EUW1_6881016107',4,25,10,2,0,1,0,7,1,384,96,26480,30921,31568,2,30,7,0,0,1,0,5,370,75,24906,29838,29522,1,14,21,1574,3,1083,2046,2,0,0,0,2
EUW1_6880985334',5,26,10,0,0,0,0,9,0,356,66,24229,26625,22563,0,29,21,2,1,3,0,1,395,108,33116,34644,34972,0,-39,-42,-8887,-11,-8019,-12409,-2,-1,-3,0,8
EUW1_6880886213',5,27,14,1,0,0,0,7,1,382,90,28900,30647,34807,2,24,15,0,0,0,0,3,325,86,27966,29730,28164,0,57,4,934,-1,917,6643,1,0,0,0,4
EUW1_6880852449',0,20,14,1,0,2,0,10,0,390,90,30391,30754,35410,3,22,15,0,0,0,0,6,339,92,29238,30299,32760,1,51,-2,1153,-1,455,2650,1,0,2,0,4
EUW1_6880848512',1,63,8,0,0,0,0,9,1,351,78,24415,29246,27623,2,25,13,1,0,1,0,0,327,94,28330,28436,31428,0,24,-16,-3915,-5,810,-3805,-1,0,-1,0,9
EUW1_6880820949',6,23,22,2,0,2,0,8,1,329,78,31575,29595,38262,1,30,19,0,0,1,0,5,366,69,31727,30394,40519,1,-37,9,-152,3,-799,-2257,2,0,1,0,3
EUW1_6877864064',1,36,2,1,0,0,0,9,0,342,94,22036,26158,21355,3,30,15,0,1,0,0,2,370,102,27953,33012,32795,0,-28,-8,-5917,-13,-6854,-11440,1,-1,0,0,7
EUW1_6877743088',4,29,21,2,0,1,0,9,1,334,75,32215,31417,42994,4,26,13,0,0,0,0,2,336,68,26477,26435,35988,0,-2,7,5738,8,4982,7006,2,0,1,0,7
EUW1_6877710750',3,32,23,1,0,1,0,19,1,332,98,32809,31945,49024,1,21,26,0,0,3,0,4,330,68,34934,30734,46772,0,2,30,-2125,-3,1211,2252,1,0,-2,0,15
EUW1_6877674559',3,40,16,2,0,1,0,8,0,349,115,28915,30747,30144,2,29,9,0,0,0,0,8,335,92,25206,27973,26632,1,14,23,3709,7,2774,3512,2,0,1,0,0
EUW1_6883670271',2,93,24,0,0,2,0,10,1,319,96,32684,31426,44634,3,44,9,0,0,0,0,4,294,63,23485,24640,31472,1,25,33,9199,15,6786,13162,0,0,2,0,6
EUW1_6880815613',4,23,17,1,1,0,0,11,0,329,69,29466,30966,39487,5,27,21,0,0,1,0,2,369,97,31657,32683,35170,0,-40,-28,-2191,-4,-1717,4317,1,1,-1,0,9
EUW1_6880653505',2,33,8,0,0,0,0,17,0,347,92,25131,28034,33704,2,23,18,2,0,4,0,0,366,103,33488,32130,38014,0,-19,-11,-8357,-10,-4096,-4310,-2,0,-4,0,17
EUW1_6880560121',1,22,11,0,0,0,0,7,1,371,92,26994,28934,25774,7,34,11,0,0,0,0,4,363,64,25609,29358,29709,1,8,28,1385,0,-424,-3935,0,0,0,0,3
EUW1_6879344517',2,106,17,1,1,0,0,8,1,334,98,28908,30196,42106,4,97,14,0,0,2,0,4,337,74,28762,29052,33050,1,-3,24,146,3,1144,9056,1,1,-2,0,4
EUW1_6879320979',2,35,11,2,1,1,0,17,1,349,88,26792,28869,27668,4,291,15,0,0,1,0,2,352,77,29768,30192,30156,1,-3,11,-2976,-4,-1323,-2488,2,1,0,0,15
EUW1_6882406941',1,24,13,1,0,0,0,13,1,340,83,28236,29397,33308,3,26,21,1,1,2,0,4,340,112,32150,34143,46889,1,0,-29,-3914,-8,-4746,-13581,0,-1,-2,0,9
EUW1_6882384576',4,59,8,0,0,1,0,6,0,407,90,26766,30755,22137,1,65,9,2,0,0,0,6,406,97,26987,30433,23227,1,1,-7,-221,-1,322,-1090,-2,0,1,0,0
EUW1_6881562907',0,32,11,0,0,0,0,13,0,365,72,27468,30010,41474,2,22,21,1,0,2,0,3,315,96,31545,31051,37015,1,50,-24,-4077,-10,-1041,4459,-1,0,-2,0,10
EUW1_6880274806',5,33,22,1,0,3,0,8,1,363,96,33250,31168,40627,8,28,8,1,0,0,0,7,294,94,23836,24794,30348,1,69,2,9414,14,6374,10279,0,0,3,0,1
EUW1_6880211692',5,22,18,2,0,1,0,8,1,380,97,30072,30933,43278,3,26,6,0,0,0,0,5,277,110,22828,25582,24011,1,103,-13,7244,12,5351,19267,2,0,1,0,3
EUW1_6880153885',5,86,4,1,0,0,0,6,0,365,104,23621,28144,26810,1,31,9,1,0,0,0,2,365,88,25875,30421,22918,0,0,16,-2254,-5,-2277,3892,0,0,0,0,4
EUW1_6873739030',6,45,12,2,1,1,0,7,0,405,107,28850,32586,29073,3,26,5,0,0,0,0,4,372,94,23885,29117,20710,1,33,13,4965,7,3469,8363,2,1,1,0,3
EUW1_6870969953',3,67,16,2,0,0,0,7,1,369,78,28482,29705,35169,1,24,11,0,0,0,0,4,311,98,26072,29152,32221,1,58,-20,2410,5,553,2948,2,0,0,0,3
EUW1_6864585746',1,29,18,1,0,1,0,5,0,393,99,30651,31585,34059,2,100,10,0,0,0,0,4,306,78,26126,27498,26949,1,87,21,4525,8,4087,7110,1,0,1,0,1
EUW1_6862023299',1,25,7,1,0,1,0,9,0,346,112,26103,30602,30789,1,26,12,0,0,2,0,0,364,66,27184,28574,37041,0,-18,46,-1081,-5,2028,-6252,1,0,-1,0,9
EUW1_6862017865',3,26,6,0,0,0,0,11,1,343,86,24186,26758,21198,4,22,16,1,0,2,0,2,374,94,30907,31357,34095,0,-31,-8,-6721,-10,-4599,-12897,-1,0,-2,0,9
EUW1_6860793217',0,38,23,1,0,2,0,9,1,312,117,33495,32777,47308,3,47,15,1,0,1,0,8,332,79,29686,30064,39205,0,-20,38,3809,8,2713,8103,0,0,1,0,1
EUW1_6860792475',2,32,11,1,0,1,0,5,0,375,110,27899,30371,24748,4,25,6,1,1,0,0,3,381,86,24545,29363,22504,1,-6,24,3354,5,1008,2244,0,-1,1,0,2
EUW1_6856685511',1,30,22,0,0,3,0,6,1,379,92,35857,31680,40997,3,31,9,1,0,0,0,12,340,84,25989,28021,32590,1,39,8,9868,13,3659,8407,-1,0,3,0,-6
EUW1_6855485456',5,77,14,2,0,0,0,10,0,312,104,28264,30223,35673,2,63,16,0,0,2,0,3,372,84,30969,32451,41688,1,-60,20,-2705,-2,-2228,-6015,2,0,-2,0,7
EUW1_6854352675',6,30,14,2,0,1,0,11,0,385,102,28678,30558,34955,5,24,14,0,0,0,0,3,369,74,28150,30197,27398,1,16,28,528,0,361,7557,2,0,1,0,8
EUW1_6854220260',5,29,11,0,0,0,0,11,1,356,61,27592,27184,28234,6,29,21,2,0,3,0,5,351,92,30737,31037,32331,0,5,-31,-3145,-10,-3853,-4097,-2,0,-3,0,6
EUW1_6853074128',3,25,6,1,0,0,0,11,0,377,56,25445,28005,17231,1,51,6,0,0,3,0,4,368,85,25501,29095,21154,1,9,-29,-56,0,-1090,-3923,1,0,-3,0,7
EUW1_6853004784',0,26,15,0,0,0,0,13,1,304,94,29081,28101,40020,6,28,27,2,1,3,0,3,362,97,35225,31787,49216,0,-58,-3,-6144,-12,-3686,-9196,-2,-1,-3,0,10
EUW1_6851660631',0,26,7,0,0,0,0,11,0,366,94,24956,28666,23617,6,30,9,2,1,1,0,1,405,120,28811,31713,32378,0,-39,-26,-3855,-2,-3047,-8761,-2,-1,-1,0,10
EUW1_6882629781',5,25,9,1,0,1,0,12,0,394,82,27808,31271,33079,2,23,15,0,0,1,0,5,330,92,28841,29848,26437,0,64,-10,-1033,-6,1423,6642,1,0,0,0,7
EUW1_6882428887',4,28,16,0,0,1,0,9,1,349,112,30311,31689,36184,3,24,16,1,0,1,0,3,358,62,29310,29351,39569,0,-9,50,1001,0,2338,-3385,-1,0,0,0,6
EUW1_6882399310',1,21,16,1,0,2,0,9,1,335,78,29693,29051,37097,1,120,11,1,0,0,0,3,309,80,25753,27986,34401,1,26,-2,3940,5,1065,2696,0,0,2,0,6
EUW1_6882331588',4,161,15,2,0,2,0,10,1,365,95,30976,29433,30432,3,23,18,0,0,1,0,6,288,76,29591,28640,36806,1,77,19,1385,-3,793,-6374,2,0,1,0,4
EUW1_6882309321',7,33,22,1,0,1,0,13,1,345,66,31976,30554,37121,6,36,16,1,0,0,0,3,325,98,28529,29091,35030,0,20,-32,3447,6,1463,2091,0,0,1,0,10
EUW1_6882299518',3,23,15,0,0,1,0,11,0,328,92,28996,30478,40780,2,21,10,2,0,1,0,5,342,84,27189,29451,33613,1,-14,8,1807,5,1027,7167,-2,0,0,0,6
EUW1_6881049710',4,23,10,2,0,1,0,10,0,331,86,25895,28548,26087,2,33,12,0,0,2,0,2,394,98,28569,32435,29176,0,-63,-12,-2674,-2,-3887,-3089,2,0,-1,0,8
EUW1_6881004325',6,31,16,0,0,3,0,5,1,338,88,30376,30518,33912,7,44,10,1,0,0,0,9,320,68,25434,28172,26229,1,18,20,4942,6,2346,7683,-1,0,3,0,-4
EUW1_6880975624',2,24,22,2,0,1,0,11,1,301,52,29505,29495,45849,0,20,21,0,0,2,0,6,327,90,30457,28743,47927,1,-26,-38,-952,1,752,-2078,2,0,-1,0,5
EUW1_6879130882',4,31,19,2,0,0,0,12,0,318,103,29629,30002,33600,4,33,22,0,0,2,0,6,342,71,31993,30097,44951,0,-24,32,-2364,-3,-95,-11351,2,0,-2,0,6
EUW1_6877698312',10,36,20,0,0,2,0,11,1,378,86,33154,31712,41945,8,40,20,2,0,1,0,8,308,82,28364,26611,35812,1,70,4,4790,0,5101,6133,-2,0,1,0,3
EUW1_6877653279',6,29,11,0,0,1,0,6,0,382,85,27729,30034,26710,7,26,15,2,0,0,0,6,360,86,27674,28733,31442,0,22,-1,55,-4,1301,-4732,-2,0,1,0,0
EUW1_6877335787',6,25,6,0,0,1,0,12,0,355,98,24264,28809,26862,4,23,17,2,0,2,0,1,370,71,29075,30955,34934,0,-15,27,-4811,-11,-2146,-8072,-2,0,-1,0,11
EUW1_6876488144',9,37,12,0,0,0,0,8,1,372,96,27816,31593,39721,4,27,8,1,0,0,0,4,344,81,24953,28217,26994,0,28,15,2863,4,3376,12727,-1,0,0,0,4
EUW1_6876474251',4,24,11,1,0,0,0,8,1,362,77,25168,29436,24774,4,29,11,1,0,2,0,5,381,112,29139,31686,31640,0,-19,-35,-3971,0,-2250,-6866,0,0,-2,0,3
EUW1_6876172989',8,33,17,1,0,1,0,7,1,380,102,31244,31697,37283,3,25,15,1,0,1,0,7,331,84,27559,28725,36589,1,49,18,3685,2,2972,694,0,0,0,0,0
EUW1_6876135613',3,28,15,0,0,1,0,4,1,387,90,29850,32485,29364,4,23,9,2,0,0,0,4,375,89,24702,28182,25668,1,12,1,5148,6,4303,3696,-2,0,1,0,0
EUW1_6875997280',3,142,18,0,0,1,0,5,1,377,82,31300,31408,35448,6,29,11,1,0,0,0,5,371,64,26990,28999,34294,1,6,18,4310,7,2409,1154,-1,0,1,0,0
EUW1_6875907213',1,24,19,1,0,1,0,7,1,349,94,30783,32681,36019,1,21,11,0,0,0,0,5,343,85,25830,28848,29448,1,6,9,4953,8,3833,6571,1,0,1,0,2
EUW1_6875223986',5,31,20,2,0,2,0,10,1,414,118,30587,34930,35655,4,24,3,0,0,1,0,7,351,113,23131,28138,22256,0,63,5,7456,17,6792,13399,2,0,1,0,3
EUW1_6866478822',4,31,15,1,0,1,0,10,1,338,94,29700,30323,34528,9,42,13,1,0,0,0,4,323,86,26386,28150,28137,1,15,8,3314,2,2173,6391,0,0,1,0,6
EUW1_6866437709',3,22,7,1,0,0,0,7,0,384,110,26531,30453,26609,9,39,12,1,0,0,0,5,362,65,27047,29532,33424,0,22,45,-516,-5,921,-6815,0,0,0,0,2
EUW1_6866399564',1,23,10,1,0,0,0,9,1,402,93,27141,30211,32024,8,29,13,0,0,0,0,2,393,66,27033,30772,36010,0,9,27,108,-3,-561,-3986,1,0,0,0,7
EUW1_6866363110',1,27,18,0,1,2,0,7,0,388,76,30746,31603,33002,2,22,9,2,0,0,0,8,360,108,25273,28999,30184,1,28,-32,5473,9,2604,2818,-2,1,2,0,-1
EUW1_6866350493',5,29,8,0,0,0,0,11,1,337,68,24283,27268,26116,4,27,18,2,0,4,0,3,367,128,33260,32386,32110,0,-30,-60,-8977,-10,-5118,-5994,-2,0,-4,0,8
EUW1_6866169509',3,31,16,1,0,0,0,5,1,357,100,28934,29338,38017,10,31,14,1,0,0,0,5,327,68,27061,26937,36674,1,30,32,1873,2,2401,1343,0,0,0,0,0
EUW1_6866157717',3,30,7,2,0,0,0,9,1,360,128,25918,29665,17761,2,23,7,0,0,1,0,2,387,84,24872,28961,20080,1,-27,44,1046,0,704,-2319,2,0,-1,0,7
EUW1_6866144066',1,28,15,1,0,0,0,13,0,289,92,27156,26726,37286,8,38,25,0,0,1,0,3,358,84,33745,32519,47557,0,-69,8,-6589,-10,-5793,-10271,1,0,-1,0,10
EUW1_6866129291',3,32,10,1,0,0,0,14,0,361,84,26509,28725,31662,4,38,18,1,0,2,0,1,376,95,31278,32121,41525,0,-15,-11,-4769,-8,-3396,-9863,0,0,-2,0,13
EUW1_6866115394',8,42,23,1,0,2,0,5,1,326,89,32552,30921,40284,1,28,11,0,0,0,0,7,330,76,26543,27064,34574,1,-4,13,6009,12,3857,5710,1,0,2,0,-2
EUW1_6866061010',2,23,16,2,1,2,0,11,0,343,60,29288,29327,40638,6,38,14,0,0,0,0,6,325,115,27536,29560,26695,1,18,-55,1752,2,-233,13943,2,1,2,0,5
EUW1_6865342817',7,31,7,0,0,0,0,9,1,369,86,24442,27308,28133,6,34,18,2,0,1,0,1,384,93,30437,32010,33153,0,-15,-7,-5995,-11,-4702,-5020,-2,0,-1,0,8
EUW1_6865273264',2,28,8,1,0,0,0,8,0,319,88,24672,27623,35409,7,34,10,1,0,1,0,1,359,102,26738,28525,29998,0,-40,-14,-2066,-2,-902,5411,0,0,-1,0,7
EUW1_6864623479',8,30,13,1,0,1,0,3,1,419,109,29117,32328,33143,1,24,5,0,0,0,0,5,355,70,23927,27354,22402,1,64,39,5190,8,4974,10741,1,0,1,0,-2
EUW1_6864609457',6,33,13,2,0,1,0,8,1,394,83,27729,30640,28168,6,29,9,0,0,1,0,5,366,80,27085,30836,28045,1,28,3,644,4,-196,123,2,0,0,0,3
EUW1_6864594716',2,34,18,1,0,2,0,7,1,319,120,32750,31793,41779,4,187,7,0,0,1,0,9,345,70,24294,27717,31729,1,-26,50,8456,11,4076,10050,1,0,1,0,-2
EUW1_6864566181',2,26,16,0,1,0,0,11,0,333,72,29297,29277,39657,4,29,18,2,0,1,0,2,373,99,29666,29571,35090,0,-40,-27,-369,-2,-294,4567,-2,1,-1,0,9
EUW1_6864559477',4,30,17,1,0,0,0,13,0,340,86,28219,30436,34721,2,28,15,0,0,2,0,1,373,102,30508,31446,35146,1,-33,-16,-2289,2,-1010,-425,1,0,-2,0,12
EUW1_6864537284',3,28,15,0,0,2,0,10,1,364,108,31370,30524,29714,4,27,12,2,0,1,0,10,353,80,28923,28758,25031,1,11,28,2447,3,1766,4683,-2,0,1,0,0
EUW1_6881822100',7,194,13,2,1,0,0,10,1,339,76,27561,29453,30806,3,40,13,0,0,1,0,4,390,120,29625,31573,31975,1,-51,-44,-2064,0,-2120,-1169,2,1,-1,0,6
EUW1_6881560170',5,64,17,1,1,0,0,9,1,367,90,30014,30736,37418,4,170,10,1,0,0,0,4,346,78,25732,28244,25934,1,21,12,4282,7,2492,11484,0,1,0,0,5
EUW1_6881048703',3,28,7,0,0,1,0,5,1,406,76,25864,29443,23819,3,253,10,1,0,0,0,5,341,128,25850,30094,25486,0,65,-52,14,-3,-651,-1667,-1,0,1,0,0
EUW1_6881001200',4,264,17,1,0,0,0,10,0,338,84,28803,31160,38042,4,34,8,1,0,0,0,2,355,100,25174,29234,30823,0,-17,-16,3629,9,1926,7219,0,0,0,0,8
EUW1_6880983734',2,15,17,0,0,0,0,9,1,329,79,28907,31624,37193,1,172,12,2,0,2,0,4,314,113,27457,29404,27201,1,15,-34,1450,5,2220,9992,-2,0,-2,0,5
EUW1_6880047748',4,34,8,1,0,1,0,8,1,415,80,27375,28848,29812,5,338,13,1,1,0,0,3,378,123,28516,32346,41766,0,37,-43,-1141,-5,-3498,-11954,0,-1,1,0,5
EUW1_6879014025',4,34,11,0,0,1,0,17,0,348,55,27133,27231,32403,3,190,20,2,0,3,0,0,360,116,33801,30893,40416,0,-12,-61,-6668,-9,-3662,-8013,-2,0,-2,0,17
EUW1_6878959178',5,223,8,0,0,0,0,16,0,345,96,25114,28879,33106,7,32,20,1,0,2,0,2,386,90,32111,32489,38226,0,-41,6,-6997,-12,-3610,-5120,-1,0,-2,0,14
EUW1_6878643530',5,172,3,0,0,0,0,5,0,371,90,22939,28705,24300,7,79,10,0,0,0,0,2,343,72,24909,29768,21750,0,28,18,-1970,-7,-1063,2550,0,0,0,0,3
EUW1_6878559051',6,142,12,0,0,0,0,12,0,362,91,27513,30065,33142,3,54,17,2,0,1,0,1,397,116,31357,33077,36345,0,-35,-25,-3844,-5,-3012,-3203,-2,0,-1,0,11
EUW1_6878522125',0,418,10,0,0,1,0,13,0,320,76,27528,27064,32411,1,59,26,1,1,2,0,7,346,100,33991,32625,43171,0,-26,-24,-6463,-16,-5561,-10760,-1,-1,-1,0,6
EUW1_6878213573',5,24,16,0,0,1,0,12,0,340,85,29600,31095,38600,4,125,19,2,0,1,0,3,337,70,30610,29641,34849,0,3,15,-1010,-3,1454,3751,-2,0,0,0,9
EUW1_6878163226',5,208,14,0,0,2,0,6,0,360,104,30200,31865,37006,4,29,15,2,0,1,0,9,363,99,28889,30889,28768,0,-3,5,1311,-1,976,8238,-2,0,1,0,-3
EUW1_6878116268',8,31,14,0,0,1,0,16,1,339,70,28251,28693,32838,5,282,18,1,0,1,0,5,351,89,30667,28752,37220,0,-12,-19,-2416,-4,-59,-4382,-1,0,0,0,11
EUW1_6878070877',2,206,13,1,0,2,0,7,1,360,82,28969,32689,34636,2,22,13,0,0,0,0,6,376,96,27317,29569,35354,1,-16,-14,1652,0,3120,-718,1,0,2,0,1
EUW1_6878030091',2,147,9,1,0,0,0,13,0,317,81,25352,25985,30035,1,27,19,0,0,3,0,2,360,78,32834,32309,47127,0,-43,3,-7482,-10,-6324,-17092,1,0,-3,0,11
EUW1_6877983958',3,189,17,2,0,0,0,6,1,372,100,28719,31440,39107,4,32,14,0,0,0,0,6,328,86,27109,29255,33202,1,44,14,1610,3,2185,5905,2,0,0,0,0
EUW1_6877949333',5,33,18,0,0,2,0,8,1,381,75,31533,31356,36126,2,28,17,2,0,1,0,6,380,94,30916,32223,37724,1,1,-19,617,1,-867,-1598,-2,0,1,0,2
EUW1_6877932096',2,26,20,1,0,1,0,19,0,374,110,32654,32162,39753,1,149,13,0,0,3,0,3,358,88,31669,29211,36269,1,16,22,985,7,2951,3484,1,0,-2,0,16
EUW1_6877330538',6,245,14,1,0,1,0,10,0,343,84,27405,30263,33096,4,42,9,1,0,0,0,2,371,69,25706,28296,32518,1,-28,15,1699,5,1967,578,0,0,1,0,8
EUW1_6883665635',1,27,9,0,0,0,0,12,1,329,112,25131,28429,22073,5,32,12,2,0,1,0,1,355,98,28238,30332,35003,0,-26,14,-3107,-3,-1903,-12930,-2,0,-1,0,11
EUW1_6882532221',7,33,16,1,0,0,0,6,0,357,88,29940,29920,37625,5,23,19,1,0,0,0,4,359,81,28841,31552,37997,1,-2,7,1099,-3,-1632,-372,0,0,0,0,2
EUW1_6877320745',4,24,10,0,0,2,0,11,0,405,87,29907,30060,39232,6,33,21,2,0,1,0,6,341,85,30115,33593,32723,1,64,2,-208,-11,-3533,6509,-2,0,1,0,5
EUW1_6877276129',6,142,14,1,0,1,0,6,0,357,86,29357,30894,34173,3,36,8,1,0,0,0,5,375,95,24961,29034,21772,1,-18,-9,4396,6,1860,12401,0,0,1,0,1
EUW1_6877228715',4,28,6,0,0,1,0,13,1,373,122,26232,29637,29917,6,23,15,1,0,1,0,5,349,85,28828,33067,31717,0,24,37,-2596,-9,-3430,-1800,-1,0,0,0,8
EUW1_6877172121',2,26,10,0,0,0,0,9,0,362,88,27044,29803,26896,2,23,12,1,0,0,0,3,401,88,27961,31806,29968,0,-39,0,-917,-2,-2003,-3072,-1,0,0,0,6
EUW1_6876982572',4,34,11,2,1,0,0,8,1,420,112,28413,33572,26196,7,28,5,0,0,0,0,1,412,88,25112,29858,25332,1,8,24,3301,6,3714,864,2,1,0,0,7
EUW1_6876923315',4,31,17,1,1,0,0,13,0,360,115,30805,30991,38129,0,24,15,0,0,2,0,3,347,75,29967,27990,32542,1,13,40,838,2,3001,5587,1,1,-2,0,10
EUW1_6875858943',2,25,17,2,1,2,0,5,1,396,108,31497,32963,40468,3,27,8,0,0,1,0,9,340,96,24490,29029,23907,1,56,12,7007,9,3934,16561,2,1,1,0,-4
EUW1_6875700706',1,21,24,2,0,1,0,14,0,364,103,33191,31940,46458,5,46,16,0,0,1,0,2,370,88,30526,29728,38607,1,-6,15,2665,8,2212,7851,2,0,0,0,12
EUW1_6875583175',1,23,12,2,1,0,0,8,1,391,94,27540,31201,30845,5,44,9,0,0,0,0,0,348,78,24400,27432,28255,1,43,16,3140,3,3769,2590,2,1,0,0,8
EUW1_6874414990',5,27,21,2,0,3,0,6,0,332,94,32705,31540,44685,2,24,18,0,0,0,0,12,347,85,29362,30893,39841,1,-15,9,3343,3,647,4844,2,0,3,0,-6
EUW1_6874240044',6,27,12,1,0,1,0,10,1,342,98,26641,28176,36195,4,27,16,0,1,1,0,4,351,73,28832,30603,35554,0,-9,25,-2191,-4,-2427,641,1,-1,0,0,6
EUW1_6874195186',3,30,6,0,0,0,0,14,0,369,98,25966,31405,27137,5,25,13,2,0,3,0,3,397,78,29365,31898,30293,0,-28,20,-3399,-7,-493,-3156,-2,0,-3,0,11
EUW1_6874145753',2,15,8,1,0,1,0,9,1,381,86,26367,32921,22361,1,29,8,1,0,1,0,3,414,114,26839,31744,28369,1,-33,-28,-472,0,1177,-6008,0,0,0,0,6
EUW1_6874101254',4,26,5,0,0,0,0,11,0,371,64,22866,26005,26607,7,50,14,2,1,0,0,2,387,96,28849,31169,30443,0,-16,-32,-5983,-9,-5164,-3836,-2,-1,0,0,9
EUW1_6874067215',0,40,5,0,0,0,0,12,0,297,71,22715,23673,24277,4,60,26,1,0,2,0,0,379,100,34596,31485,33910,0,-82,-29,-11881,-21,-7812,-9633,-1,0,-2,0,12
EUW1_6881546781',2,32,22,0,0,1,0,6,1,360,89,33192,31902,47952,2,24,18,1,0,1,0,5,327,64,28801,28199,37002,1,33,25,4391,4,3703,10950,-1,0,0,0,1
EUW1_6881477823',4,42,7,0,0,1,0,8,0,356,79,24770,27589,18783,4,29,11,2,0,2,0,2,367,104,28396,28367,21556,0,-11,-25,-3626,-4,-778,-2773,-2,0,-1,0,6
EUW1_6877252933',5,26,26,2,0,2,0,9,1,359,102,34086,32263,42130,2,30,11,0,0,1,0,5,277,94,26618,26082,29133,1,82,8,7468,15,6181,12997,2,0,1,0,4
EUW1_6877215787',3,21,9,0,0,0,0,12,1,348,104,26048,30040,26370,4,33,15,2,0,3,0,2,389,92,30614,31869,29821,0,-41,12,-4566,-6,-1829,-3451,-2,0,-3,0,10
EUW1_6875078059',3,52,19,0,1,0,0,9,1,348,66,30555,29478,36056,4,136,16,1,0,0,0,5,312,79,26458,28039,40737,1,36,-13,4097,3,1439,-4681,-1,1,0,0,4
EUW1_6869422457',5,27,9,1,0,0,0,16,0,342,80,25575,28428,31948,11,32,14,1,0,2,0,0,365,88,29856,30676,32065,1,-23,-8,-4281,-5,-2248,-117,0,0,-2,0,16
EUW1_6869396173',6,38,10,1,0,4,0,2,1,386,98,30229,29839,22714,0,138,3,0,0,0,0,14,297,76,20350,23267,17644,1,89,22,9879,7,6572,5070,1,0,4,0,-12
EUW1_6869368009',3,33,11,0,0,1,0,9,1,366,102,28477,30062,30024,4,339,12,2,0,0,0,7,391,67,26024,28850,26790,0,-25,35,2453,-1,1212,3234,-2,0,1,0,2
EUW1_6868760169',1,24,18,2,0,1,0,9,1,384,98,31279,30511,34833,4,94,13,0,0,1,0,1,353,68,27715,28555,26782,1,31,30,3564,5,1956,8051,2,0,0,0,8
EUW1_6867600473',3,24,11,0,0,1,0,4,0,330,117,27840,28879,22722,2,27,8,2,0,0,0,8,323,82,23970,25618,26770,1,7,35,3870,3,3261,-4048,-2,0,1,0,-4
EUW1_6867575769',2,17,11,0,0,0,0,12,0,332,92,26637,28359,28709,8,26,18,1,0,1,0,0,351,70,29706,28808,39129,0,-19,22,-3069,-7,-449,-10420,-1,0,-1,0,12
EUW1_6867542055',4,25,11,0,0,0,0,7,0,352,91,26922,28002,34126,4,26,23,2,0,0,0,1,372,91,31255,33272,36920,0,-20,0,-4333,-12,-5270,-2794,-2,0,0,0,6
EUW1_6867505097',3,30,13,0,0,1,0,6,1,335,76,27370,28201,28684,3,24,17,2,0,0,0,4,331,84,27309,28416,35794,0,4,-8,61,-4,-215,-7110,-2,0,1,0,2
EUW1_6867360448',3,23,12,0,0,0,0,10,1,371,76,27365,28330,33794,1,37,12,2,0,0,0,3,318,88,25775,27139,33318,0,53,-12,1590,0,1191,476,-2,0,0,0,7
EUW1_6867311744',0,24,13,0,0,1,0,3,1,382,82,28336,29715,32350,9,58,10,2,0,0,0,5,346,114,25893,28472,27496,0,36,-32,2443,3,1243,4854,-2,0,1,0,-2
EUW1_6867241155',2,19,15,1,0,0,0,13,0,307,79,27484,28402,35741,1,23,16,0,0,1,0,4,346,71,28413,29240,41701,0,-39,8,-929,-1,-838,-5960,1,0,-1,0,9
EUW1_6883442859',5,24,18,0,0,1,0,4,1,365,54,28668,28954,30529,1,41,9,0,0,0,0,3,356,72,24751,28081,33263,1,9,-18,3917,9,873,-2734,0,0,1,0,1
EUW1_6883394654',1,29,11,0,0,0,0,15,0,323,92,25791,27938,28686,6,57,18,2,0,1,0,2,387,72,30977,30493,33447,0,-64,20,-5186,-7,-2555,-4761,-2,0,-1,0,13
EUW1_6883322055',6,49,11,0,1,1,0,12,0,328,105,27980,30101,30165,5,20,22,2,0,1,0,3,381,81,32699,31965,48098,0,-53,24,-4719,-11,-1864,-17933,-2,1,0,0,9
EUW1_6883271891',5,170,18,1,0,3,0,7,0,392,94,33090,32732,39938,6,27,13,0,0,1,0,8,343,76,27280,28000,36095,1,49,18,5810,5,4732,3843,1,0,2,0,-1
EUW1_6883218573',3,29,8,0,0,0,0,13,1,318,62,23766,27744,33355,2,25,22,2,0,3,0,1,383,103,33381,32733,34084,0,-65,-41,-9615,-14,-4989,-729,-2,0,-3,0,12
EUW1_6883159918',5,29,17,1,1,2,0,6,1,369,93,33481,30386,35001,0,89,15,0,0,1,0,10,338,35,27472,27270,27209,1,31,58,6009,2,3116,7792,1,1,1,0,-4
EUW1_6882858756',6,38,14,1,0,1,0,10,0,370,86,29478,29761,31476,1,24,17,1,0,1,0,7,353,91,30379,29550,33085,1,17,-5,-901,-3,211,-1609,0,0,0,0,3
EUW1_6882818007',1,23,9,1,0,1,0,12,1,375,98,26969,30223,25627,3,23,11,0,1,1,0,5,367,108,29192,30803,22906,1,8,-10,-2223,-2,-580,2721,1,-1,0,0,7
EUW1_6882791696',2,29,9,0,0,1,0,13,0,315,83,24907,27093,32322,2,20,15,2,0,1,0,0,321,120,29258,29302,32505,0,-6,-37,-4351,-6,-2209,-183,-2,0,0,0,13
EUW1_6882737154',5,29,16,0,0,1,0,5,0,326,74,28512,29943,33045,2,86,12,2,0,1,0,8,351,71,27288,31026,28288,0,-25,3,1224,4,-1083,4757,-2,0,0,0,-3
EUW1_6882715627',4,164,4,0,0,0,0,16,1,336,88,22117,26372,22288,4,44,21,2,1,4,0,3,395,92,33694,32351,40865,0,-59,-4,-11577,-17,-5979,-18577,-2,-1,-4,0,13
EUW1_6882674315',5,26,15,0,0,0,0,11,0,301,84,27020,27802,31165,3,29,14,2,0,1,0,1,374,96,29617,29831,34922,1,-73,-12,-2597,1,-2029,-3757,-2,0,-1,0,10
EUW1_6882622359',1,23,16,2,0,2,0,10,1,363,116,31366,32097,35760,3,33,9,0,0,1,0,9,340,80,25832,29181,23603,1,23,36,5534,7,2916,12157,2,0,1,0,1
EUW1_6882589619',3,69,9,1,0,0,0,6,0,349,84,25072,28481,29637,7,31,13,1,0,0,0,3,374,79,28795,28855,33718,0,-25,5,-3723,-4,-374,-4081,0,0,0,0,3
EUW1_6882539191',4,31,13,0,1,1,0,2,0,381,107,29647,32736,37276,3,29,12,2,0,0,0,9,373,91,26417,30235,33155,0,8,16,3230,1,2501,4121,-2,1,1,0,-7
EUW1_6882510171',4,21,10,1,0,0,0,10,0,308,92,25112,30083,27182,3,31,14,1,0,2,0,4,447,82,30629,33385,33317,0,-139,10,-5517,-4,-3302,-6135,0,0,-2,0,6
EUW1_6882487497',9,53,13,1,1,0,0,11,0,367,92,27204,30217,32442,6,30,11,1,0,2,0,2,421,103,30520,31951,37168,0,-54,-11,-3316,2,-1734,-4726,0,1,-2,0,9
EUW1_6882448108',2,23,7,0,0,0,0,11,1,321,88,24331,25519,26269,5,271,19,2,0,1,0,0,356,91,30776,31404,36167,0,-35,-3,-6445,-12,-5885,-9898,-2,0,-1,0,11
EUW1_6878846489',5,140,7,1,1,0,0,9,0,313,87,23677,27614,19302,1,33,7,0,0,2,0,4,365,88,26058,28956,24027,0,-52,-1,-2381,0,-1342,-4725,1,1,-2,0,5
EUW1_6877475961',1,27,22,1,0,3,0,6,0,384,82,34137,32078,47689,2,28,18,0,0,0,0,9,301,85,28598,28269,37657,1,83,-3,5539,4,3809,10032,1,0,3,0,-3
EUW1_6877414494',2,24,13,0,0,0,0,13,0,325,70,26726,27708,32192,1,22,19,2,1,2,0,3,318,110,31248,30058,35718,0,7,-40,-4522,-6,-2350,-3526,-2,-1,-2,0,10
EUW1_6877171059',1,47,3,0,0,0,0,10,0,318,84,22532,25600,20708,3,25,18,1,0,3,0,2,370,86,31148,30213,36140,0,-52,-2,-8616,-15,-4613,-15432,-1,0,-3,0,8
EUW1_6876408895',4,27,7,0,0,0,0,15,0,289,67,22924,25719,25065,4,146,16,0,0,3,0,0,392,58,31429,29254,35983,0,-103,9,-8505,-9,-3535,-10918,0,0,-3,0,15
EUW1_6876396778',4,25,9,1,1,0,0,6,1,389,104,26043,33212,28475,3,28,5,1,0,1,0,3,365,108,24472,30936,24993,1,24,-4,1571,4,2276,3482,0,1,-1,0,3
EUW1_6872934593',3,68,7,1,0,0,0,12,1,386,65,26621,30358,34270,5,64,11,1,0,2,0,7,352,96,27841,30014,34737,1,34,-31,-1220,-4,344,-467,0,0,-2,0,5
EUW1_6872886832',4,24,13,1,0,1,0,10,0,313,84,29175,29360,27565,4,25,10,1,0,1,0,7,337,99,25886,28255,27623,1,-24,-15,3289,3,1105,-58,0,0,0,0,3
EUW1_6872839684',2,25,9,0,0,1,0,11,0,329,84,25361,29468,29971,2,99,17,2,0,1,0,2,356,83,30418,31476,40464,0,-27,1,-5057,-8,-2008,-10493,-2,0,0,0,9
EUW1_6872262019',3,25,6,0,0,0,0,6,1,381,90,24814,29125,29221,5,37,14,1,0,0,0,2,393,83,26874,30254,27620,0,-12,7,-2060,-8,-1129,1601,-1,0,0,0,4
EUW1_6872246801',3,28,15,1,0,1,0,11,1,378,98,29671,31618,34217,3,22,11,0,0,2,0,5,329,94,27337,31012,29773,1,49,4,2334,4,606,4444,1,0,-1,0,6
EUW1_6883673716',2,45,21,0,0,2,0,3,0,391,90,33359,31741,40695,5,36,14,1,0,0,0,9,271,70,26388,26434,32365,1,120,20,6971,7,5307,8330,-1,0,2,0,-6
EUW1_6883656182',3,25,13,1,0,1,0,7,0,344,111,28213,31561,33903,2,25,11,1,0,0,0,2,325,60,23915,27929,32342,1,19,51,4298,2,3632,1561,0,0,1,0,5
EUW1_6883637454',4,56,11,0,0,0,0,13,0,252,76,24788,26548,24212,1,67,15,2,0,2,0,0,373,84,31018,28786,33261,0,-121,-8,-6230,-4,-2238,-9049,-2,0,-2,0,13
EUW1_6883587579',2,15,12,0,0,0,0,12,0,276,111,26015,30301,30089,4,27,16,2,0,3,0,0,349,87,32295,31423,38903,0,-73,24,-6280,-4,-1122,-8814,-2,0,-3,0,12
EUW1_6883543240',0,26,19,0,0,4,0,10,1,377,75,34528,33020,38644,4,28,12,1,0,0,0,11,363,100,27799,29288,25474,0,14,-25,6729,7,3732,13170,-1,0,4,0,-1
EUW1_6883520525',3,31,7,0,0,1,0,8,0,352,84,26651,27999,27139,1,21,21,1,0,1,0,3,355,83,30970,31114,37387,0,-3,1,-4319,-14,-3115,-10248,-1,0,0,0,5
EUW1_6883472492',3,28,14,1,0,0,0,8,0,310,98,27174,25827,35203,3,29,17,1,0,0,0,4,357,85,29574,28650,32332,0,-47,13,-2400,-3,-2823,2871,0,0,0,0,4
EUW1_6883411215',5,33,10,0,0,0,0,11,1,348,97,25891,29945,27933,2,28,8,2,0,0,0,4,363,111,26488,29965,26272,0,-15,-14,-597,2,-20,1661,-2,0,0,0,7
EUW1_6883360580',5,34,16,0,1,1,0,7,0,324,72,29356,29166,38502,5,25,8,2,0,0,0,4,365,68,25591,28846,31575,1,-41,4,3765,8,320,6927,-2,1,1,0,3
EUW1_6883257870',3,25,12,1,0,0,0,14,1,342,58,26250,27041,26368,3,29,10,1,1,2,0,2,393,132,29798,32650,37028,0,-51,-74,-3548,2,-5609,-10660,0,-1,-2,0,12
EUW1_6883200586',5,23,18,2,0,1,0,6,1,351,90,28919,30745,34447,0,20,6,0,0,0,0,7,338,77,23909,26576,24415,1,13,13,5010,12,4169,10032,2,0,1,0,-1
EUW1_6883141296',3,43,22,1,0,1,0,9,0,413,82,32392,31847,36744,2,28,8,0,0,1,0,6,343,72,25986,27850,29784,1,70,10,6406,14,3997,6960,1,0,0,0,3
EUW1_6872318960',4,48,20,1,0,0,0,8,1,359,83,30424,30176,44014,4,23,9,1,0,1,0,4,331,90,25081,28950,31850,1,28,-7,5343,11,1226,12164,0,0,-1,0,4
EUW1_6872303040',3,24,11,0,0,1,0,9,1,389,86,28022,29183,33909,3,24,11,1,0,0,0,1,341,84,26061,29555,33508,1,48,2,1961,0,-372,401,-1,0,1,0,8
EUW1_6872289927',2,61,14,1,0,1,0,5,0,378,88,29837,31549,39527,2,94,14,0,0,1,0,9,349,78,28185,29325,37266,1,29,10,1652,0,2224,2261,1,0,0,0,-4
EUW1_6872277143',4,31,20,1,0,3,0,5,1,366,134,34114,34691,39068,2,24,6,1,0,0,0,15,330,86,22880,26182,26762,1,36,48,11234,14,8509,12306,0,0,3,0,-10
EUW1_6867568397',2,29,13,2,0,1,0,14,0,337,91,29171,29216,35060,4,42,22,0,0,1,0,1,347,102,31737,31911,39915,0,-10,-11,-2566,-9,-2695,-4855,2,0,0,0,13
EUW1_6864530823',3,25,8,0,0,0,0,9,0,312,69,23464,24804,21761,6,27,17,1,0,1,0,1,388,100,31277,30276,35223,0,-76,-31,-7813,-9,-5472,-13462,-1,0,-1,0,8
EUW1_6856662819',3,19,12,2,1,1,0,8,0,355,104,27854,29651,30493,4,27,7,0,0,0,0,5,337,92,25519,27744,31154,1,18,12,2335,5,1907,-661,2,1,1,0,3
EUW1_6856640204',2,19,12,0,0,2,0,8,0,372,96,29691,29819,28933,3,25,13,1,0,0,0,9,371,62,27320,28513,30063,1,1,34,2371,-1,1306,-1130,-1,0,2,0,-1
EUW1_6855399154',6,22,10,1,0,1,0,9,0,351,84,27547,30589,31133,6,104,14,1,0,0,0,2,351,103,27671,30951,31439,1,0,-19,-124,-4,-362,-306,0,0,1,0,7
EUW1_6844039904',4,24,7,0,0,0,0,14,1,341,106,26127,28266,21215,4,26,16,2,1,3,0,1,377,98,31019,31127,29414,0,-36,8,-4892,-9,-2861,-8199,-2,-1,-3,0,13
EUW1_6842217600',3,28,6,2,0,0,0,8,0,399,98,26178,30031,18097,3,87,9,0,0,0,0,1,362,118,25956,29115,26632,1,37,-20,222,-3,916,-8535,2,0,0,0,7
EUW1_6842083343',1,29,9,1,1,0,0,5,1,428,77,25831,29815,20739,5,30,0,1,0,0,0,0,377,120,22633,28995,10829,1,51,-43,3198,9,820,9910,0,1,0,0,5
EUW1_6840417166',0,131,11,0,0,1,0,6,1,429,84,28744,32354,28765,1,19,8,2,1,0,0,2,386,100,25802,30188,30452,1,43,-16,2942,3,2166,-1687,-2,-1,1,0,4
EUW1_6840237046',6,27,17,1,0,1,0,5,0,376,74,30831,27281,37975,4,27,22,1,0,0,0,4,329,74,31811,29936,40991,1,47,0,-980,-5,-2655,-3016,0,0,1,0,1
EUW1_6880165619',0,23,14,0,1,0,0,12,0,362,106,29468,29667,28621,3,28,11,2,0,1,0,3,360,92,27025,29058,28996,1,2,14,2443,3,609,-375,-2,1,-1,0,9
EUW1_6880094180',5,28,8,1,0,0,0,12,1,412,92,25992,31090,23040,5,28,10,1,0,1,0,2,369,100,27777,29136,22370,0,43,-8,-1785,-2,1954,670,0,0,-1,0,10
EUW1_6880048353',2,22,5,0,0,0,0,10,0,377,48,23077,28351,24964,4,57,11,2,1,1,0,0,387,156,28574,33560,28145,0,-10,-108,-5497,-6,-5209,-3181,-2,-1,-1,0,10
EUW1_6883581418',3,43,13,0,0,0,0,8,1,355,95,27359,28856,34056,7,33,18,2,0,2,0,3,411,82,32052,32406,39014,0,-56,13,-4693,-5,-3550,-4958,-2,0,-2,0,5
EUW1_6883540421',3,26,9,0,0,0,0,5,1,302,92,24893,26959,21991,4,33,12,2,0,1,0,0,364,92,27311,28377,24119,0,-62,0,-2418,-3,-1418,-2128,-2,0,-1,0,5
EUW1_6883468134',2,18,10,1,0,0,0,6,1,380,90,26960,29970,24830,4,28,9,0,1,0,0,5,346,86,25102,28966,24527,0,34,4,1858,1,1004,303,1,-1,0,0,1
EUW1_6880375303',3,24,9,1,1,0,0,7,0,371,86,25836,29899,32177,5,31,12,1,0,0,0,4,364,80,26489,30619,28264,0,7,6,-653,-3,-720,3913,0,1,0,0,3
EUW1_6880195356',4,24,12,0,0,1,0,13,0,314,86,27603,28421,34305,1,29,15,2,0,2,0,4,377,78,31234,30605,36147,1,-63,8,-3631,-3,-2184,-1842,-2,0,-1,0,9
EUW1_6880063854',9,72,9,2,0,1,0,9,1,370,104,26657,30555,25304,1,22,6,0,0,1,0,6,384,79,25989,29709,25469,0,-14,25,668,3,846,-165,2,0,0,0,3
EUW1_6880020179',5,218,14,2,0,1,0,6,1,380,114,28543,31864,32717,2,25,5,0,0,0,0,6,401,58,23505,28891,31059,1,-21,56,5038,9,2973,1658,2,0,1,0,0
EUW1_6879080627',3,29,23,0,1,1,0,9,1,362,123,33464,35497,50813,2,22,21,1,0,1,0,4,345,86,30863,29182,46083,0,17,37,2601,2,6315,4730,-1,1,0,0,5
EUW1_6878946297',1,28,5,0,0,0,0,15,1,287,71,21947,23229,29140,3,28,23,2,0,5,0,1,400,103,35625,32596,40464,0,-113,-32,-13678,-18,-9367,-11324,-2,0,-5,0,14
EUW1_6878904824',5,28,12,0,1,0,0,10,1,355,93,27822,29587,27329,3,38,9,2,0,3,0,5,336,105,26989,28195,28677,0,19,-12,833,3,1392,-1348,-2,1,-3,0,5
EUW1_6878863077',3,34,3,1,0,0,0,9,0,343,78,21750,27332,21540,5,42,13,1,0,1,0,0,359,94,27880,30790,29250,0,-16,-16,-6130,-10,-3458,-7710,0,0,-1,0,9
EUW1_6878828838',2,28,12,1,0,0,0,4,0,378,101,27876,30884,29962,6,27,9,1,0,0,0,1,343,90,24664,28276,28578,1,35,11,3212,3,2608,1384,0,0,0,0,3
EUW1_6878326898',5,30,11,1,0,0,0,12,0,312,80,25684,27186,30107,4,30,16,1,1,2,0,1,368,95,30337,29893,38894,1,-56,-15,-4653,-5,-2707,-8787,0,-1,-2,0,11
EUW1_6878269338',3,31,14,2,0,1,0,8,1,401,90,29585,32102,28184,3,24,12,0,0,1,0,5,371,95,28770,30633,33645,1,30,-5,815,2,1469,-5461,2,0,0,0,3
EUW1_6878239786',3,32,8,1,0,0,0,9,1,362,86,24875,27804,30677,3,26,14,1,0,1,0,3,361,92,28759,30829,30537,0,1,-6,-3884,-6,-3025,140,0,0,-1,0,6
EUW1_6882666129',4,32,11,2,1,1,0,4,1,393,117,29148,31048,32936,4,33,5,0,0,0,0,10,356,58,22793,27200,18184,1,37,59,6355,6,3848,14752,2,1,1,0,-6
EUW1_6882630720',5,103,8,1,0,0,0,13,0,359,76,24403,27100,21049,4,30,8,1,0,2,0,3,371,82,27353,27515,26268,0,-12,-6,-2950,0,-415,-5219,0,0,-2,0,10
EUW1_6882180034',2,83,12,1,0,1,0,13,1,365,84,27926,29777,38148,4,31,10,0,0,1,0,4,320,74,26472,28250,26395,1,45,10,1454,2,1527,11753,1,0,0,0,9
EUW1_6882135131',5,30,13,0,0,1,0,9,0,363,69,27387,29365,35163,6,33,18,1,0,0,0,4,319,117,30207,31711,33983,0,44,-48,-2820,-5,-2346,1180,-1,0,1,0,5
EUW1_6882094966',5,28,10,0,1,0,0,10,0,383,100,27843,31170,28920,8,45,9,1,0,1,0,3,403,88,27472,29465,33115,0,-20,12,371,1,1705,-4195,-1,1,-1,0,7
EUW1_6882047590',5,28,4,0,0,0,0,9,1,403,106,24835,29306,25332,5,150,11,2,0,1,0,1,428,86,27659,32079,25774,0,-25,20,-2824,-7,-2773,-442,-2,0,-1,0,8
EUW1_6881979648',6,48,20,2,0,2,0,5,1,375,82,31175,31011,31628,3,28,6,0,0,0,0,6,326,78,22796,26567,30283,1,49,4,8379,14,4444,1345,2,0,2,0,-1
EUW1_6881906106',4,25,12,0,0,0,0,14,1,328,84,26866,27636,31649,3,28,18,1,0,3,0,2,356,96,31891,30735,39208,0,-28,-12,-5025,-6,-3099,-7559,-1,0,-3,0,12
EUW1_6881836762',7,35,20,2,1,1,0,10,1,396,95,34331,33748,42007,3,28,14,0,0,1,0,6,360,82,27888,29100,33510,1,36,13,6443,6,4648,8497,2,1,0,0,4
EUW1_6875297026',3,27,17,1,1,1,0,10,0,297,77,29689,29231,36547,3,27,15,0,0,1,0,4,298,87,27336,26023,29839,0,-1,-10,2353,2,3208,6708,1,1,0,0,6
EUW1_6875245255',2,33,19,1,1,1,0,6,1,332,114,30270,30794,37188,4,30,6,0,0,0,0,5,310,66,21901,25507,25279,1,22,48,8369,13,5287,11909,1,1,1,0,1
EUW1_6873896326',2,36,14,1,0,0,0,2,0,398,94,29690,32158,32063,1,27,8,0,0,1,0,4,357,93,24764,29730,25736,0,41,1,4926,6,2428,6327,1,0,-1,0,-2
EUW1_6876243408',2,47,13,2,0,0,0,7,0,375,79,26941,29872,36923,0,29,12,0,0,0,0,4,299,86,26257,27521,26559,1,76,-7,684,1,2351,10364,2,0,0,0,3
EUW1_6876219102',2,21,8,0,0,0,0,11,0,339,86,25683,29246,25189,4,48,19,2,0,2,0,2,369,97,31563,32212,32170,0,-30,-11,-5880,-11,-2966,-6981,-2,0,-2,0,9
EUW1_6872873292',2,31,13,0,0,0,0,16,1,312,50,27252,27812,40089,5,20,25,1,0,4,0,3,338,98,35203,31503,44460,0,-26,-48,-7951,-12,-3691,-4371,-1,0,-4,0,13
EUW1_6869915091',2,29,13,2,0,1,0,7,1,380,110,28538,32339,31379,1,19,1,0,0,0,0,3,334,102,20781,25977,19837,1,46,8,7757,12,6362,11542,2,0,1,0,4
EUW1_6869853287',4,32,9,0,0,0,0,10,0,347,84,25816,29746,26015,3,33,10,1,0,1,0,1,381,83,26602,29665,27148,1,-34,1,-786,-1,81,-1133,-1,0,-1,0,9
EUW1_6869763906',1,25,12,0,0,0,0,12,0,334,92,27874,27433,30989,4,28,26,2,0,2,0,3,393,92,35334,33921,49393,0,-59,0,-7460,-14,-6488,-18404,-2,0,-2,0,9
EUW1_6869706274',2,106,22,2,1,0,0,8,0,315,86,29611,32215,38478,1,33,8,0,0,0,0,2,336,90,25799,26329,31301,1,-21,-4,3812,14,5886,7177,2,1,0,0,6
EUW1_6869654772',2,26,11,0,0,1,0,6,1,360,130,28581,31658,27071,4,30,6,2,1,0,0,5,401,90,24446,29596,22817,1,-41,40,4135,5,2062,4254,-2,-1,1,0,1
EUW1_6866383493',4,47,13,0,0,2,0,12,1,373,66,28884,30060,35414,2,36,10,2,0,1,0,4,344,82,25874,28306,27764,0,29,-16,3010,3,1754,7650,-2,0,1,0,8
EUW1_6864546108',3,168,9,0,0,0,0,15,1,323,78,24909,25861,32635,2,24,22,1,0,4,0,4,345,101,33128,31952,40110,0,-22,-23,-8219,-13,-6091,-7475,-1,0,-4,0,11
EUW1_6862879989',3,26,8,0,0,2,0,8,1,421,107,27543,31226,27275,6,240,9,1,0,1,0,4,354,92,27669,29464,21898,0,67,15,-126,-1,1762,5377,-1,0,1,0,4
EUW1_6871286382',2,28,10,0,0,1,0,8,0,377,104,27797,30295,28242,4,36,12,2,1,1,0,2,371,100,28172,30322,34730,1,6,4,-375,-2,-27,-6488,-2,-1,0,0,6
EUW1_6869651683',2,30,14,2,0,1,0,7,1,348,77,28530,30112,36531,1,52,9,0,0,0,0,5,320,78,25526,27756,43876,0,28,-1,3004,5,2356,-7345,2,0,1,0,2
EUW1_6869611783',4,33,12,0,0,2,0,10,0,403,124,30493,32109,26821,2,16,11,2,0,0,0,5,355,78,26504,29523,31897,1,48,46,3989,1,2586,-5076,-2,0,2,0,5
EUW1_6869576478',4,37,1,1,0,0,0,9,0,338,103,21442,27952,18927,8,28,12,1,1,2,0,4,411,96,29319,32061,31790,0,-73,7,-7877,-11,-4109,-12863,0,-1,-2,0,5
EUW1_6869362912',2,29,18,2,0,1,0,11,1,328,91,30076,30069,35905,1,25,15,0,0,1,0,5,349,92,29253,30834,34267,0,-21,-1,823,3,-765,1638,2,0,0,0,6
EUW1_6866578158',7,37,13,0,0,1,0,6,1,325,87,28538,28461,34200,3,25,18,2,0,1,0,6,324,99,29135,30384,37080,0,1,-12,-597,-5,-1923,-2880,-2,0,0,0,0
EUW1_6866511247',7,31,8,1,0,0,0,10,1,362,76,25470,28501,23917,5,26,10,1,0,0,0,2,357,83,26165,28789,25218,0,5,-7,-695,-2,-288,-1301,0,0,0,0,8
EUW1_6866444204',4,33,21,1,0,0,0,12,1,356,89,31298,31998,40408,5,43,18,0,0,1,0,4,353,89,30129,28264,37574,1,3,0,1169,3,3734,2834,1,0,-1,0,8
EUW1_6866407893',3,35,10,1,0,1,0,7,1,339,82,25980,29244,28273,3,24,6,0,0,0,0,4,358,85,23188,28519,29104,0,-19,-3,2792,4,725,-831,1,0,1,0,3
EUW1_6866379811',3,24,9,2,0,0,0,17,0,330,91,25131,28161,30898,5,31,21,0,0,5,0,3,403,87,35503,33631,41526,0,-73,4,-10372,-12,-5470,-10628,2,0,-5,0,14
EUW1_6864653552',6,32,9,0,0,0,0,13,0,331,66,24388,28740,33245,4,27,20,1,0,2,0,1,357,113,32279,34475,38790,0,-26,-47,-7891,-11,-5735,-5545,-1,0,-2,0,12
EUW1_6864632988',3,24,21,0,1,1,0,8,1,382,118,33225,34115,38567,1,29,8,0,0,1,0,6,308,68,26053,27901,27290,1,74,50,7172,13,6214,11277,0,1,0,0,2
EUW1_6864610879',5,29,13,0,0,1,0,11,0,350,104,27776,30950,31713,5,28,8,2,0,2,0,3,376,72,26483,27974,33015,0,-26,32,1293,5,2976,-1302,-2,0,-1,0,8
EUW1_6864593406',4,28,9,0,0,0,0,10,0,347,86,25045,27600,35422,4,26,15,1,0,0,0,0,392,98,29120,32786,43977,0,-45,-12,-4075,-6,-5186,-8555,-1,0,0,0,10
EUW1_6864592789',7,30,18,0,1,1,0,6,1,357,94,30976,29100,41562,4,25,17,2,0,0,0,6,325,76,29081,27577,34203,1,32,18,1895,1,1523,7359,-2,1,1,0,0
EUW1_6864582531',2,25,22,1,1,1,0,11,0,332,72,32175,30995,37761,2,33,16,0,0,2,0,9,314,107,30096,29728,41065,1,18,-35,2079,6,1267,-3304,1,1,-1,0,2
EUW1_6864573885',1,24,24,1,0,0,0,4,0,358,84,34300,33262,46222,5,28,10,1,0,2,0,5,315,68,24847,26422,29359,1,43,16,9453,14,6840,16863,0,0,-2,0,-1
EUW1_6864546407',1,25,11,1,0,1,0,10,0,325,80,26030,28762,25300,2,28,9,0,0,0,0,3,384,98,26375,30242,31983,0,-59,-18,-345,2,-1480,-6683,1,0,1,0,7
EUW1_6864538066',0,21,13,0,0,0,0,9,0,313,76,26228,26109,32028,4,28,18,1,1,2,0,0,356,96,31205,29947,34335,0,-43,-20,-4977,-5,-3838,-2307,-1,-1,-2,0,9
EUW1_6864525172',5,25,13,2,0,0,0,7,0,328,97,27354,30346,32235,1,22,14,0,0,1,0,4,340,66,27096,28248,35889,1,-12,31,258,-1,2098,-3654,2,0,-1,0,3
EUW1_6877955136',3,25,9,0,0,0,0,12,0,383,82,25219,29918,24477,7,29,10,1,0,1,0,4,367,82,26758,28272,28445,0,16,0,-1539,-1,1646,-3968,-1,0,-1,0,8
EUW1_6877935219',2,48,11,0,0,0,0,6,1,361,95,27634,29383,26428,6,31,10,2,1,1,0,1,357,100,26240,29644,27056,0,4,-5,1394,1,-261,-628,-2,-1,-1,0,5
EUW1_6877922248',3,23,9,0,0,0,0,12,0,399,96,27219,29576,30871,1,28,17,2,0,2,0,5,374,88,29383,31481,32197,0,25,8,-2164,-8,-1905,-1326,-2,0,-2,0,7
EUW1_6877919722',1,28,6,0,0,0,0,7,0,403,108,26149,29953,18283,4,24,7,2,0,2,0,2,372,100,25333,29617,17626,0,31,8,816,-1,336,657,-2,0,-2,0,5
EUW1_6877904610',4,58,15,0,0,0,0,9,0,372,90,28602,31749,30538,3,25,13,1,0,1,0,1,389,92,29562,31072,35273,1,-17,-2,-960,2,677,-4735,-1,0,-1,0,8
EUW1_6877887789',5,51,12,1,0,1,0,4,0,388,100,27323,30524,31573,1,22,8,1,0,0,0,5,400,78,25507,30376,25040,1,-12,22,1816,4,148,6533,0,0,1,0,-1
EUW1_6877815807',2,38,16,0,0,1,0,7,0,372,98,29792,30103,39131,0,23,11,2,0,1,0,6,346,77,27086,27630,30393,1,26,21,2706,5,2473,8738,-2,0,0,0,1
EUW1_6877131731',4,32,14,1,1,0,0,11,0,360,98,29989,30972,35364,3,27,10,1,0,2,0,6,359,72,26568,31126,26616,1,1,26,3421,4,-154,8748,0,1,-2,0,5
EUW1_6876426235',2,26,7,1,0,0,0,13,0,318,76,23890,27401,36891,2,26,19,1,0,2,0,2,349,112,30592,33241,36408,0,-31,-36,-6702,-12,-5840,483,0,0,-2,0,11
EUW1_6876408377',2,36,14,0,0,0,0,5,1,352,78,26314,29792,32415,2,24,13,1,0,0,0,0,381,96,26868,30955,36658,1,-29,-18,-554,1,-1163,-4243,-1,0,0,0,5
EUW1_6874846866',0,43,16,2,0,0,0,11,1,364,116,29171,32090,30262,5,27,9,0,0,1,0,2,381,88,26392,29737,30292,0,-17,28,2779,7,2353,-30,2,0,-1,0,9
EUW1_6874788101',4,30,18,1,0,1,0,7,1,335,88,29258,30199,37462,1,44,11,1,0,0,0,4,350,98,25832,29569,28601,0,-15,-10,3426,7,630,8861,0,0,1,0,3
EUW1_6874304343',0,26,11,0,0,0,0,8,1,377,80,27232,29307,31558,6,31,15,2,0,0,0,5,328,99,27708,30338,30338,1,49,-19,-476,-4,-1031,1220,-2,0,0,0,3
EUW1_6873975234',4,28,8,2,1,0,0,2,0,406,109,26209,30930,26802,0,93,3,0,0,0,0,2,386,86,23167,29433,15308,1,20,23,3042,5,1497,11494,2,1,0,0,0
EUW1_6873905310',3,73,5,0,1,0,0,10,1,374,96,25249,29346,27787,9,69,16,1,0,2,0,1,376,96,29964,31056,37017,0,-2,0,-4715,-11,-1710,-9230,-1,1,-2,0,9
EUW1_6870738251',2,36,7,2,0,0,0,14,0,369,100,25288,29010,20590,2,27,10,0,0,2,0,0,429,106,29823,31311,19629,1,-60,-6,-4535,-3,-2301,961,2,0,-2,0,14
EUW1_6868740633',1,29,13,2,0,1,0,12,1,294,93,26800,28911,28788,2,33,6,0,0,3,0,6,431,90,28614,29889,23971,0,-137,3,-1814,7,-978,4817,2,0,-2,0,6
EUW1_6868606217',2,29,8,0,1,0,0,7,1,383,89,25568,30392,29882,3,28,7,2,0,1,0,5,359,102,24814,28209,26133,1,24,-13,754,1,2183,3749,-2,1,-1,0,2
EUW1_6872323406',1,25,14,0,0,0,0,14,0,328,61,25389,29761,30425,3,25,18,2,0,2,0,0,388,110,32105,31345,43021,0,-60,-49,-6716,-4,-1584,-12596,-2,0,-2,0,14
EUW1_6872304736',3,62,11,0,0,0,0,8,1,319,115,26618,29993,31906,1,59,9,1,0,2,0,2,353,76,26023,29419,30410,0,-34,39,595,2,574,1496,-1,0,-2,0,6
EUW1_6872280412',2,89,16,0,0,1,0,13,1,305,74,27310,26814,32929,4,26,5,2,0,2,0,5,361,70,25688,27604,29215,0,-56,4,1622,11,-790,3714,-2,0,-1,0,8
EUW1_6872261048',2,38,10,1,0,0,0,8,0,303,62,25036,27008,25604,1,31,17,0,0,0,0,4,398,98,30252,31055,36399,1,-95,-36,-5216,-7,-4047,-10795,1,0,0,0,4
EUW1_6872230303',5,26,22,2,0,3,0,5,1,328,75,31828,34417,40255,3,24,7,0,0,0,0,6,352,100,25748,29580,41279,1,-24,-25,6080,15,4837,-1024,2,0,3,0,-1
EUW1_6871494508',8,169,17,1,0,1,0,8,1,354,84,29348,29833,45540,1,94,16,1,0,1,0,6,356,88,29588,32066,38203,1,-2,-4,-240,1,-2233,7337,0,0,0,0,2
EUW1_6871442089',2,29,19,1,0,0,0,8,0,305,76,28675,30220,43647,1,28,20,1,0,1,0,1,368,91,31934,31063,41878,0,-63,-15,-3259,-1,-843,1769,0,0,-1,0,7
EUW1_6871373391',2,30,7,1,0,1,0,7,0,355,68,24434,28875,24578,3,32,12,0,0,0,0,3,352,84,26617,28590,32360,1,3,-16,-2183,-5,285,-7782,1,0,1,0,4
EUW1_6871333352',3,46,10,0,0,0,0,17,0,314,76,25399,26653,37159,1,27,21,1,1,4,0,1,311,106,34121,32114,46107,0,3,-30,-8722,-11,-5461,-8948,-1,-1,-4,0,16
EUW1_6871304046',4,18,12,0,0,0,0,11,1,366,64,27111,29549,32037,2,26,10,2,0,1,0,3,344,111,26463,29303,33276,0,22,-47,648,2,246,-1239,-2,0,-1,0,8
EUW1_6871193762',1,27,13,1,0,0,0,9,1,367,76,29284,29635,34151,5,26,13,0,0,1,0,3,359,92,28509,30094,32612,0,8,-16,775,0,-459,1539,1,0,-1,0,6
EUW1_6871160544',4,24,8,0,1,1,0,8,0,379,77,27159,29346,34723,5,28,9,2,0,1,0,4,372,90,26527,30146,26121,1,7,-13,632,-1,-800,8602,-2,1,0,0,4
EUW1_6871132848',5,30,26,2,1,0,0,8,1,314,85,34359,31033,45316,1,25,13,0,0,3,0,8,326,76,26584,27664,34365,1,-12,9,7775,13,3369,10951,2,1,-3,0,0
EUW1_6871099122',2,23,17,1,0,0,0,9,1,329,72,28505,30052,34533,4,28,12,0,0,1,0,2,340,79,27536,28529,38815,1,-11,-7,969,5,1523,-4282,1,0,-1,0,7
EUW1_6870934954',4,30,14,0,0,2,0,11,1,325,88,30508,31160,39019,2,24,16,2,0,1,0,5,319,95,28023,28276,37850,1,6,-7,2485,-2,2884,1169,-2,0,1,0,6
EUW1_6870916684',3,23,18,0,0,1,0,11,0,354,104,30714,30229,30827,4,32,14,1,0,1,0,4,324,76,29365,27288,37113,0,30,28,1349,4,2941,-6286,-1,0,0,0,7
EUW1_6870888443',3,24,8,0,0,0,0,15,0,305,82,23923,26538,36332,3,27,24,2,0,2,0,1,342,104,32644,32430,37503,0,-37,-22,-8721,-16,-5892,-1171,-2,0,-2,0,14
EUW1_6870848191',0,24,6,0,0,0,0,13,0,339,78,24384,28406,25075,3,22,15,2,0,2,0,2,350,92,29266,30225,32331,0,-11,-14,-4882,-9,-1819,-7256,-2,0,-2,0,11
EUW1_6864519553',3,140,8,1,0,0,0,12,1,314,97,25310,28450,31838,4,24,14,1,1,1,0,0,384,90,29264,30298,29193,0,-70,7,-3954,-6,-1848,2645,0,-1,-1,0,12
EUW1_6864473858',3,35,11,0,0,0,0,9,0,319,82,26238,27940,26540,2,139,17,1,0,1,0,2,383,78,29951,31091,36658,0,-64,4,-3713,-6,-3151,-10118,-1,0,-1,0,7
EUW1_6883597525',4,21,6,0,0,0,0,17,0,280,90,22935,24030,28440,1,48,19,1,0,5,0,0,396,86,33114,31489,33656,0,-116,4,-10179,-13,-7459,-5216,-1,0,-5,0,17
EUW1_6883574329',5,64,22,1,0,2,0,8,0,405,109,35602,31932,41677,8,40,10,0,0,1,0,9,317,74,25120,26657,39666,1,88,35,10482,12,5275,2011,1,0,1,0,-1
EUW1_6883518511',5,190,5,0,0,1,0,8,1,368,108,26236,28477,23212,5,33,15,2,0,1,0,5,421,102,28951,34059,37441,0,-53,6,-2715,-10,-5582,-14229,-2,0,0,0,3
EUW1_6882826033',5,73,12,0,0,2,0,10,1,397,92,29285,29487,35639,2,42,15,1,0,1,0,1,372,93,28457,31024,37616,1,25,-1,828,-3,-1537,-1977,-1,0,1,0,9
EUW1_6882731076',2,24,7,0,0,0,0,5,1,386,98,25268,27324,25065,7,32,13,2,0,1,0,1,405,92,28279,31704,32407,1,-19,6,-3011,-6,-4380,-7342,-2,0,-1,0,4
EUW1_6882685136',3,27,23,1,0,1,0,11,1,370,84,33429,30241,40643,2,28,9,0,0,1,0,5,347,72,25741,27728,26935,1,23,12,7688,14,2513,13708,1,0,0,0,6
EUW1_6882292158',2,26,10,0,0,1,0,7,0,365,112,28312,30203,27428,6,29,12,1,0,0,0,2,361,88,27233,29340,25875,1,4,24,1079,-2,863,1553,-1,0,1,0,5
EUW1_6882276238',6,35,9,0,0,0,0,9,0,375,70,26244,28573,26806,9,30,12,2,0,1,0,5,375,86,28690,29542,33787,0,0,-16,-2446,-3,-969,-6981,-2,0,-1,0,4
EUW1_6882189237',1,30,12,0,0,1,0,6,0,404,100,29937,31557,34354,5,35,18,1,0,1,0,2,385,97,31054,31375,38774,0,19,3,-1117,-6,182,-4420,-1,0,0,0,4
EUW1_6882015954',4,31,15,1,0,0,0,12,0,277,104,27915,27602,37710,6,34,19,0,0,1,0,4,339,71,30223,30355,37018,0,-62,33,-2308,-4,-2753,692,1,0,-1,0,8
EUW1_6881238950',3,27,14,1,0,0,0,4,1,360,85,29242,28915,26526,2,26,9,0,0,1,0,9,313,71,24903,26204,26621,1,47,14,4339,5,2711,-95,1,0,-1,0,-5
EUW1_6881202626',4,95,12,0,0,0,0,12,1,333,106,27567,26555,30921,8,44,17,2,0,2,0,3,357,85,29702,28199,43306,0,-24,21,-2135,-5,-1644,-12385,-2,0,-2,0,9
EUW1_6881144557',6,28,8,0,0,0,0,7,0,355,89,24845,28448,23415,7,29,12,1,1,0,0,1,408,92,28641,30562,26175,0,-53,-3,-3796,-4,-2114,-2760,-1,-1,0,0,6
EUW1_6882929940',8,33,12,1,0,1,0,7,1,371,88,28124,29935,27856,3,366,9,1,0,0,0,5,393,104,26399,29785,25853,1,-22,-16,1725,3,150,2003,0,0,1,0,2
EUW1_6882867170',1,32,6,0,0,1,0,5,0,328,92,24078,26540,31342,2,92,11,2,0,0,0,2,333,78,24785,26980,30139,0,-5,14,-707,-5,-440,1203,-2,0,1,0,3
EUW1_6882818234',4,24,17,1,0,1,0,10,1,339,62,29132,29290,34757,7,32,12,1,0,1,0,9,322,85,27816,28676,39743,1,17,-23,1316,5,614,-4986,0,0,0,0,1
EUW1_6882776520',3,43,13,1,0,1,0,6,1,393,116,31044,31698,36075,4,21,10,1,0,2,0,6,363,84,25821,29703,23162,0,30,32,5223,3,1995,12913,0,0,-1,0,0
EUW1_6882732506',2,60,16,0,0,1,0,12,0,303,102,29248,29820,36667,0,206,22,1,0,2,0,4,333,108,33663,32849,45888,0,-30,-6,-4415,-6,-3029,-9221,-1,0,-1,0,8
EUW1_6882684392',1,18,10,0,0,0,0,11,0,325,91,25852,29087,27240,1,136,23,2,0,3,0,2,367,76,34122,31852,41664,0,-42,15,-8270,-13,-2765,-14424,-2,0,-3,0,9
EUW1_6882597643',5,232,14,1,0,0,0,7,1,351,66,27501,28771,30043,1,99,11,1,0,0,0,3,348,68,26063,28145,33493,0,3,-2,1438,3,626,-3450,0,0,0,0,4
EUW1_6881701400',3,27,13,0,0,5,0,7,1,405,130,32546,32908,34033,3,26,5,1,0,0,0,10,315,62,22242,26532,31677,1,90,68,10304,8,6376,2356,-1,0,5,0,-3
EUW1_6881634142',5,32,3,1,0,0,0,9,0,348,90,22935,29369,21080,7,40,11,1,0,1,0,2,379,94,27446,31946,29766,1,-31,-4,-4511,-8,-2577,-8686,0,0,-1,0,7
EUW1_6881576325',5,65,16,0,0,1,0,9,1,348,90,29656,30477,37082,1,65,15,2,0,0,0,4,360,97,29770,31112,33829,0,-12,-7,-114,1,-635,3253,-2,0,1,0,5
EUW1_6881522569',3,37,7,1,0,0,0,12,1,338,88,25843,27911,31475,6,43,11,1,0,2,0,2,353,76,27722,28030,31584,0,-15,12,-1879,-4,-119,-109,0,0,-2,0,10
EUW1_6881480939',4,28,3,1,0,0,0,9,1,366,82,22438,28483,19750,5,23,11,1,1,1,0,1,392,90,27598,31084,22493,0,-26,-8,-5160,-8,-2601,-2743,0,-1,-1,0,8
EUW1_6881434910',1,23,5,0,0,1,0,11,0,344,76,24126,27224,25030,4,28,17,2,1,2,0,3,314,86,28901,27960,35831,0,30,-10,-4775,-12,-736,-10801,-2,-1,-1,0,8
EUW1_6881397185',6,35,14,1,0,3,0,4,1,401,104,32687,33186,28599,6,27,4,1,0,1,0,9,329,96,21823,27069,22068,1,72,8,10864,10,6117,6531,0,0,2,0,-5
EUW1_6881332880',2,29,12,1,0,2,0,5,1,395,106,30117,32055,28420,7,29,8,1,0,1,0,6,370,90,24882,28637,27483,1,25,16,5235,4,3418,937,0,0,1,0,-1
EUW1_6881244522',3,26,9,1,0,1,0,5,0,375,89,26192,29066,27370,4,96,8,1,0,0,0,4,394,112,25826,30925,25666,0,-19,-23,366,1,-1859,1704,0,0,1,0,1
EUW1_6880761814',8,36,14,2,1,0,0,12,1,336,90,28073,29896,28815,4,30,9,0,0,1,0,4,356,94,26943,29756,26301,0,-20,-4,1130,5,140,2514,2,1,-1,0,8
EUW1_6883609493',4,32,13,0,0,0,0,15,0,338,87,28221,29645,33249,5,29,16,2,0,3,0,1,401,111,31407,31337,33450,0,-63,-24,-3186,-3,-1692,-201,-2,0,-3,0,14
EUW1_6883570198',3,29,7,0,0,0,0,10,1,324,90,23675,27516,26410,3,22,14,2,0,1,0,4,379,114,28224,31614,34153,0,-55,-24,-4549,-7,-4098,-7743,-2,0,-1,0,6
EUW1_6883519256',3,60,13,0,0,1,0,9,1,325,67,28819,29745,36117,4,33,16,1,1,0,0,5,369,88,29231,30215,33622,0,-44,-21,-412,-3,-470,2495,-1,-1,1,0,4
EUW1_6882270332',6,31,11,0,0,1,0,12,0,365,80,27808,28460,25530,3,24,14,2,0,3,0,6,378,88,31370,29362,36897,0,-13,-8,-3562,-3,-902,-11367,-2,0,-2,0,6
EUW1_6880810413',4,31,16,1,0,1,0,9,1,391,109,31507,32513,42509,3,21,6,1,0,2,0,5,369,101,25005,29426,24718,1,22,8,6502,10,3087,17791,0,0,-1,0,4
EUW1_6880813686',7,27,25,1,0,4,0,11,1,351,96,33992,31109,40051,4,41,7,1,0,1,0,9,335,104,25396,28271,26654,1,16,-8,8596,18,2838,13397,0,0,3,0,2
EUW1_6880795602',3,50,13,1,0,1,0,14,0,308,82,26536,27276,23919,2,41,11,0,1,2,0,4,370,105,28734,29925,33456,0,-62,-23,-2198,2,-2649,-9537,1,-1,-1,0,10
EUW1_6880776334',5,73,10,0,0,0,0,13,0,303,87,24541,28128,22457,7,31,19,2,0,2,0,0,370,68,32479,29508,44037,0,-67,19,-7938,-9,-1380,-21580,-2,0,-2,0,13
EUW1_6878385448',2,29,5,1,0,1,0,10,0,355,87,24152,27812,24220,3,55,15,1,0,1,0,4,373,81,27964,29340,28725,1,-18,6,-3812,-10,-1528,-4505,0,0,0,0,6
EUW1_6878327755',3,76,11,0,0,0,0,10,1,362,80,27940,30472,28073,3,202,16,2,1,2,0,1,356,120,29099,30566,36146,0,6,-40,-1159,-5,-94,-8073,-2,-1,-2,0,9
EUW1_6878266849',3,30,14,1,0,0,0,18,0,340,73,28568,28135,35967,6,38,19,1,1,3,0,1,329,73,30985,29153,44495,0,11,0,-2417,-5,-1018,-8528,0,-1,-3,0,17
EUW1_6877888430',1,33,10,0,0,0,0,12,1,322,102,26468,28077,32070,6,104,13,0,0,3,0,3,356,89,28330,30252,28919,1,-34,13,-1862,-3,-2175,3151,0,0,-3,0,9
EUW1_6877701559',1,28,11,1,0,1,0,7,0,377,90,27503,31752,32300,4,30,8,0,0,0,0,5,340,92,24990,28224,25462,1,37,-2,2513,3,3528,6838,1,0,1,0,2
EUW1_6877663798',1,45,29,1,0,2,0,9,0,360,94,36510,31757,43684,2,27,16,0,0,0,0,8,344,58,28174,25847,40625,1,16,36,8336,13,5910,3059,1,0,2,0,1
EUW1_6877555523',6,31,4,1,0,0,0,6,0,411,105,24268,30541,23666,4,57,7,1,0,0,0,3,393,100,25324,32373,24873,0,18,5,-1056,-3,-1832,-1207,0,0,0,0,3
EUW1_6877489440',3,23,5,0,0,0,0,13,0,402,97,25817,31029,23949,6,28,12,2,0,2,0,2,405,73,28622,31483,34796,0,-3,24,-2805,-7,-454,-10847,-2,0,-2,0,11
EUW1_6877298637',4,34,5,0,0,0,0,11,1,368,71,22952,26554,22941,9,51,15,1,0,3,0,1,381,88,29379,30872,32101,0,-13,-17,-6427,-10,-4318,-9160,-1,0,-3,0,10
EUW1_6877024964',7,29,13,1,1,1,0,6,1,371,93,27948,29079,31523,2,50,11,0,0,0,0,6,337,74,25513,27825,26011,0,34,19,2435,2,1254,5512,1,1,1,0,0
EUW1_6876972704',2,31,9,1,0,1,0,4,1,362,98,26793,29240,39448,4,28,16,1,0,0,0,4,323,82,27312,29606,38146,0,39,16,-519,-7,-366,1302,0,0,1,0,0
EUW1_6876934317',3,24,15,1,0,6,1,4,1,400,114,33284,32747,30802,0,18,3,0,0,1,0,10,344,28,19695,24086,18468,1,56,86,13589,12,8661,12334,1,0,5,1,-6
EUW1_6876701265',1,24,7,1,0,0,0,4,1,350,102,24854,29781,25277,5,37,4,1,0,0,0,4,410,93,23944,28608,20027,1,-60,9,910,3,1173,5250,0,0,0,0,0
EUW1_6876688501',0,61,7,0,0,0,0,12,0,339,80,24786,28771,24056,2,67,15,2,0,2,0,4,405,80,30424,33220,48801,0,-66,0,-5638,-8,-4449,-24745,-2,0,-2,0,8
EUW1_6876400304',3,29,12,0,0,1,0,8,0,348,95,27361,29115,30805,4,39,15,1,0,1,0,5,332,54,26803,27725,35471,0,16,41,558,-3,1390,-4666,-1,0,0,0,3
EUW1_6876371944',6,53,11,1,1,1,0,4,0,401,69,27560,29217,29049,6,27,10,0,0,0,0,3,332,101,25961,27318,22654,1,69,-32,1599,1,1899,6395,1,1,1,0,1
EUW1_6883770803',1,30,5,0,0,1,0,13,0,349,69,24392,26969,26854,3,25,21,2,1,2,0,3,351,111,32486,32796,38392,0,-2,-42,-8094,-16,-5827,-11538,-2,-1,-1,0,10
EUW1_6883753605',2,24,14,0,0,0,0,12,0,334,88,28912,30898,44087,1,25,17,1,0,1,0,3,318,76,29221,28838,32853,1,16,12,-309,-3,2060,11234,-1,0,-1,0,9
EUW1_6883726062',4,42,13,0,0,0,0,4,1,397,83,28733,29675,35667,7,37,15,1,0,1,0,4,371,90,28032,30737,33012,1,26,-7,701,-2,-1062,2655,-1,0,-1,0,0
EUW1_6883721701',9,31,17,0,0,0,0,12,1,316,89,29084,29908,34463,3,42,9,1,0,2,0,3,376,66,27506,26924,29312,1,-60,23,1578,8,2984,5151,-1,0,-2,0,9
EUW1_6883708052',6,92,16,1,0,0,0,11,0,315,69,28767,26505,28423,1,30,16,0,0,0,0,0,362,78,28506,29221,36211,0,-47,-9,261,0,-2716,-7788,1,0,0,0,11
EUW1_6883561688',5,28,11,1,0,1,0,5,0,375,82,27671,28491,27943,3,58,9,0,0,0,0,4,353,83,25564,28730,26902,1,22,-1,2107,2,-239,1041,1,0,1,0,1
EUW1_6883497674',5,28,9,1,0,0,0,9,1,313,81,25441,27903,28669,5,338,14,1,0,1,0,0,389,74,28259,29675,31695,1,-76,7,-2818,-5,-1772,-3026,0,0,-1,0,9
EUW1_6883460152',3,58,15,1,0,0,0,14,0,322,91,27296,26932,38507,3,37,23,1,1,3,0,3,381,100,35396,33230,40410,0,-59,-9,-8100,-8,-6298,-1903,0,-1,-3,0,11
EUW1_6883431821',3,36,16,1,0,0,0,7,1,383,71,28697,30716,30498,3,28,6,0,1,0,0,4,377,84,25725,29185,29509,1,6,-13,2972,10,1531,989,1,-1,0,0,3
EUW1_6883379746',5,33,14,0,0,0,0,5,1,373,87,28134,30511,29549,5,27,10,2,0,1,0,4,350,87,25916,28675,30973,1,23,0,2218,4,1836,-1424,-2,0,-1,0,1
EUW1_6882564752',5,33,18,0,0,1,0,13,1,394,84,31678,32035,40832,3,41,14,2,0,1,0,5,343,92,27710,29498,29119,1,51,-8,3968,4,2537,11713,-2,0,0,0,8
EUW1_6882539140',1,61,7,0,0,0,0,10,0,344,84,23801,27248,23131,6,36,15,2,0,1,0,2,366,128,30390,33442,38248,0,-22,-44,-6589,-8,-6194,-15117,-2,0,-1,0,8
EUW1_6882508365',2,37,6,0,0,0,0,10,1,329,78,23666,27251,25581,4,32,12,2,1,2,0,2,368,102,28836,30035,29351,0,-39,-24,-5170,-6,-2784,-3770,-2,-1,-2,0,8
EUW1_6882421996',3,42,13,0,0,1,0,3,1,397,83,28309,30954,28718,3,91,11,2,0,0,0,3,348,105,26297,28762,28446,1,49,-22,2012,2,2192,272,-2,0,1,0,0
EUW1_6882400198',3,190,13,1,1,3,0,5,0,385,111,29381,32290,36132,2,24,9,1,0,0,0,4,352,76,25033,27397,28766,1,33,35,4348,4,4893,7366,0,1,3,0,1
EUW1_6882386309',2,28,11,0,0,0,0,11,0,325,102,26372,29396,33112,4,147,17,2,0,1,0,3,354,82,30092,31720,36472,0,-29,20,-3720,-6,-2324,-3360,-2,0,-1,0,8
EUW1_6882367321',4,41,8,2,0,0,0,7,0,391,108,25870,30183,27054,9,38,6,0,0,1,0,1,368,90,25010,27881,24720,1,23,18,860,2,2302,2334,2,0,-1,0,6
EUW1_6882851442',8,34,25,2,0,2,0,10,1,400,96,35348,32886,48374,3,30,8,0,0,0,0,5,334,82,25004,27849,35456,1,66,14,10344,17,5037,12918,2,0,2,0,5
EUW1_6882817668',5,53,14,0,0,0,0,13,0,349,64,28263,28862,35925,7,32,18,1,0,1,0,6,341,97,30780,29327,39801,0,8,-33,-2517,-4,-465,-3876,-1,0,-1,0,7
EUW1_6882780504',2,24,22,2,0,4,0,3,0,452,99,34874,34078,42506,1,133,5,0,0,0,0,12,327,84,22530,26036,27550,1,125,15,12344,17,8042,14956,2,0,4,0,-9
EUW1_6882684362',7,71,6,0,0,0,0,5,0,360,68,23873,27240,22920,1,48,9,1,0,1,0,4,386,104,26738,29834,25615,1,-26,-36,-2865,-3,-2594,-2695,-1,0,-1,0,1
EUW1_6882162921',7,29,17,1,1,2,0,9,0,383,82,31734,31304,42062,1,35,14,0,0,0,0,8,343,83,28393,29143,29980,1,40,-1,3341,3,2161,12082,1,1,2,0,1
EUW1_6879265055',4,24,10,1,0,1,0,8,1,312,91,26627,26155,33228,1,21,17,1,1,1,0,6,361,72,28715,28382,35312,0,-49,19,-2088,-7,-2227,-2084,0,-1,0,0,2
EUW1_6879243051',5,25,11,0,0,1,0,12,0,351,104,27311,29806,27617,2,25,16,1,0,0,0,7,337,104,29539,31510,35318,1,14,0,-2228,-5,-1704,-7701,-1,0,1,0,5
EUW1_6877645434',5,41,16,0,0,0,0,15,1,370,78,29018,29935,35323,0,42,21,1,0,2,0,4,376,86,34755,33583,41110,0,-6,-8,-5737,-5,-3648,-5787,-1,0,-2,0,11
EUW1_6883029707',2,262,11,0,0,0,0,4,1,363,86,26686,29834,32968,1,33,14,1,0,0,0,3,370,74,27620,28977,34083,0,-7,12,-934,-3,857,-1115,-1,0,0,0,1
EUW1_6882610697',1,35,13,1,1,0,0,11,1,341,99,27615,30833,36193,3,43,10,1,0,1,0,5,361,84,26800,28952,32073,1,-20,15,815,3,1881,4120,0,1,-1,0,6
EUW1_6882265134',6,58,10,2,0,0,0,10,1,401,95,26957,30685,31869,2,34,9,0,1,0,0,2,386,108,26547,31676,25353,1,15,-13,410,1,-991,6516,2,-1,0,0,8
EUW1_6882262484',3,33,8,1,0,0,0,8,0,393,71,25633,29379,30218,5,27,19,1,0,2,0,1,398,92,31025,31787,35146,0,-5,-21,-5392,-11,-2408,-4928,0,0,-2,0,7
EUW1_6881220527',5,176,9,0,0,1,0,5,1,404,98,27296,32065,22063,6,35,7,2,0,0,0,5,403,103,24819,30696,29856,1,1,-5,2477,2,1369,-7793,-2,0,1,0,0
EUW1_6883307114',8,33,20,1,1,1,0,8,1,348,88,31361,30414,43466,0,23,13,1,0,1,0,6,305,60,26356,27320,29330,0,43,28,5005,7,3094,14136,0,1,0,0,2
EUW1_6883204322',2,24,14,0,0,0,0,16,0,330,77,27289,29585,33005,3,27,24,2,0,2,0,0,403,82,33914,32027,38404,0,-73,-5,-6625,-10,-2442,-5399,-2,0,-2,0,16
EUW1_6881338940',7,62,15,1,0,0,0,14,0,344,82,28033,29242,30787,6,30,16,1,0,1,0,3,374,78,30479,29631,38342,0,-30,4,-2446,-1,-389,-7555,0,0,-1,0,11
EUW1_6881138412',5,89,12,0,0,0,0,9,1,354,80,26932,29056,33722,4,92,12,2,0,1,0,1,297,72,26966,28039,28658,1,57,8,-34,0,1017,5064,-2,0,-1,0,8
EUW1_6879777836',6,32,10,0,0,0,0,8,0,357,90,25922,29930,23688,5,28,9,2,0,0,0,2,401,100,26238,29733,26569,0,-44,-10,-316,1,197,-2881,-2,0,0,0,6
EUW1_6879087657',2,31,8,0,0,0,0,12,1,393,110,26099,29870,23666,5,30,11,1,0,2,0,2,351,70,27723,30813,30028,0,42,40,-1624,-3,-943,-6362,-1,0,-2,0,10
EUW1_6879035613',2,34,14,0,1,2,0,9,1,348,79,30069,29430,33525,5,28,14,1,0,1,0,9,363,76,27997,29394,32965,0,-15,3,2072,0,36,560,-1,1,1,0,0
EUW1_6878919273',4,27,17,2,0,0,0,6,1,335,88,29126,29139,37148,6,20,13,0,0,0,0,2,332,100,27330,28397,32298,1,3,-12,1796,4,742,4850,2,0,0,0,4
EUW1_6880210010',4,24,12,1,1,0,0,5,1,407,98,27946,32140,32116,3,29,5,1,0,1,0,2,389,91,24653,29381,23387,0,18,7,3293,7,2759,8729,0,1,-1,0,3
EUW1_6870611436',3,31,13,2,0,1,0,8,0,387,64,28046,28809,32896,5,51,14,0,0,1,0,3,375,90,28293,29873,29124,1,12,-26,-247,-1,-1064,3772,2,0,0,0,5
EUW1_6870557972',4,32,7,0,0,0,0,12,0,332,90,24317,29335,27933,2,21,17,2,0,2,0,1,362,114,31068,33425,35842,0,-30,-24,-6751,-10,-4090,-7909,-2,0,-2,0,11
EUW1_6869022183',1,23,7,0,0,0,0,11,0,382,88,26346,29544,28180,8,33,16,2,0,1,0,5,387,113,29282,31737,29917,0,-5,-25,-2936,-9,-2193,-1737,-2,0,-1,0,6
EUW1_6868971849',1,31,12,2,0,1,0,8,0,410,80,27834,32565,33750,9,26,11,0,0,0,0,5,383,90,26909,31958,23297,1,27,-10,925,1,607,10453,2,0,1,0,3
EUW1_6868905956',5,268,28,2,0,4,0,7,1,391,106,37276,34429,52427,0,25,15,0,0,0,0,11,292,86,27708,27840,37048,0,99,20,9568,13,6589,15379,2,0,4,0,-4
EUW1_6864338514',3,70,8,0,0,1,0,6,1,401,96,27414,29798,26644,5,32,10,1,0,0,0,4,365,103,26473,30629,30599,0,36,-7,941,-2,-831,-3955,-1,0,1,0,2
EUW1_6864286242',3,22,9,0,0,0,0,10,0,347,84,24618,27542,27928,1,27,15,2,1,3,0,0,359,96,30837,32051,32628,0,-12,-12,-6219,-6,-4509,-4700,-2,-1,-3,0,10
EUW1_6864226259',3,59,11,0,0,0,0,15,0,358,74,25728,28063,30730,4,46,16,2,0,3,0,1,396,92,31775,32245,38157,0,-38,-18,-6047,-5,-4182,-7427,-2,0,-3,0,14
EUW1_6864156719',2,25,14,2,1,0,0,7,1,349,107,28147,29457,31315,2,101,12,0,0,1,0,0,350,97,29244,30355,29008,0,-1,10,-1097,2,-898,2307,2,1,-1,0,7
EUW1_6864082062',5,27,17,1,0,1,0,8,0,378,99,29299,33661,34067,1,35,12,1,0,0,0,5,387,100,26946,29315,27291,1,-9,-1,2353,5,4346,6776,0,0,1,0,3
EUW1_6863125963',5,26,7,1,0,0,0,6,0,386,100,25754,30296,24803,3,40,4,1,0,0,0,1,385,68,23041,28905,27307,1,1,32,2713,3,1391,-2504,0,0,0,0,5
EUW1_6863087230',4,25,7,0,0,0,0,11,1,368,83,24532,28675,27434,6,31,13,1,0,1,0,1,347,64,27640,27561,31777,1,21,19,-3108,-6,1114,-4343,-1,0,-1,0,10
EUW1_6863056319',4,64,10,0,0,1,0,14,0,357,69,27247,27620,28677,2,28,18,1,1,3,0,3,367,95,32101,31241,39216,0,-10,-26,-4854,-8,-3621,-10539,-1,-1,-2,0,11
EUW1_6863018720',2,25,20,1,0,2,0,9,0,336,110,32753,31546,42214,4,26,17,0,0,1,0,8,311,76,27632,28523,36207,1,25,34,5121,3,3023,6007,1,0,1,0,1
EUW1_6862968067',4,29,17,1,0,0,0,8,0,317,99,28401,29046,33130,7,26,14,1,0,0,0,3,334,78,28002,27280,32318,1,-17,21,399,3,1766,812,0,0,0,0,5
EUW1_6862890716',3,24,15,0,0,0,0,6,1,391,87,28987,31861,37422,2,25,15,1,0,0,0,2,379,88,28921,30861,38168,0,12,-1,66,0,1000,-746,-1,0,0,0,4
EUW1_6861762389',2,23,13,0,0,1,0,10,0,368,86,28851,29747,41912,4,28,17,2,0,0,0,6,346,81,29662,29651,34641,0,22,5,-811,-4,96,7271,-2,0,1,0,4
EUW1_6883753809',3,37,13,0,1,1,0,6,0,398,106,29337,33835,26978,5,25,5,2,0,0,0,2,361,119,24660,29643,18499,1,37,-13,4677,8,4192,8479,-2,1,1,0,4
EUW1_6883748608',1,23,10,0,0,0,0,7,1,401,90,26728,31424,27120,1,26,6,0,0,0,0,1,386,74,25187,29433,30359,1,15,16,1541,4,1991,-3239,0,0,0,0,6
EUW1_6883717492',5,39,10,1,0,1,0,10,1,378,90,27772,29172,25762,3,33,13,1,0,1,0,6,368,86,29162,31115,28882,0,10,4,-1390,-3,-1943,-3120,0,0,0,0,4
EUW1_6883583081',6,44,10,1,0,0,0,14,0,325,69,25387,26140,30240,3,25,19,1,0,3,0,3,374,94,32469,30519,36887,0,-49,-25,-7082,-9,-4379,-6647,0,0,-3,0,11
EUW1_6883559900',9,43,10,1,0,0,0,7,1,386,73,25857,28071,26709,7,33,7,1,0,1,0,1,355,76,25887,26461,26504,0,31,-3,-30,3,1610,205,0,0,-1,0,6
EUW1_6883485980',6,48,9,0,0,0,0,10,0,362,91,26333,29883,25952,4,51,11,1,0,1,0,3,368,92,27441,30020,25330,1,-6,-1,-1108,-2,-137,622,-1,0,-1,0,7
EUW1_6883439963',1,29,10,0,0,0,0,9,1,337,80,26692,27242,31669,8,47,12,1,0,1,0,6,371,78,27555,30059,32489,0,-34,2,-863,-2,-2817,-820,-1,0,-1,0,3
EUW1_6883382682',6,42,9,2,0,1,0,6,1,402,102,27593,31058,27349,6,101,8,0,0,0,0,5,392,90,25325,29725,20858,1,10,12,2268,1,1333,6491,2,0,1,0,1
EUW1_6883006467',3,23,9,0,1,0,0,9,0,376,90,26102,29230,25291,4,26,13,2,0,1,0,0,372,109,28359,31169,28245,1,4,-19,-2257,-4,-1939,-2954,-2,1,-1,0,9
EUW1_6882653818',3,27,11,1,0,1,0,7,1,371,66,27983,30190,32658,8,29,11,0,0,0,0,6,335,62,25919,29369,30655,1,36,4,2064,0,821,2003,1,0,1,0,1
EUW1_6882600348',5,32,18,1,0,1,0,10,0,337,91,30391,29214,43762,1,27,17,0,0,0,0,6,321,99,29764,30316,44930,0,16,-8,627,1,-1102,-1168,1,0,1,0,4
EUW1_6882579156',6,30,26,2,1,2,0,10,1,383,100,31709,33311,40895,2,22,7,0,0,1,0,3,313,87,24017,25958,24867,1,70,13,7692,19,7353,16028,2,1,1,0,7
EUW1_6882215275',2,24,3,1,0,0,0,8,0,339,84,21353,25168,20787,7,30,17,1,0,0,0,1,372,88,29159,31237,37978,0,-33,-4,-7806,-14,-6069,-17191,0,0,0,0,7
EUW1_6882188470',4,29,3,0,1,1,0,6,0,382,101,24522,30018,20793,8,32,10,2,0,1,0,4,393,76,26194,30101,31049,0,-11,25,-1672,-7,-83,-10256,-2,1,0,0,2
EUW1_6882466600',3,189,15,1,0,0,0,11,0,366,97,29220,30987,31160,4,33,18,1,0,0,0,1,322,81,28500,28261,36492,1,44,16,720,-3,2726,-5332,0,0,0,0,10
EUW1_6882437839',2,22,14,0,1,0,0,5,1,368,108,29112,31016,35403,5,29,13,2,0,0,0,0,419,92,28505,30415,28090,0,-51,16,607,1,601,7313,-2,1,0,0,5
EUW1_6882416819',6,35,16,0,0,1,0,14,0,336,87,29584,28987,32589,1,20,20,2,1,1,0,3,360,92,32405,31689,36414,0,-24,-5,-2821,-4,-2702,-3825,-2,-1,0,0,11
EUW1_6882368395',5,26,18,2,0,1,0,5,0,367,102,30690,31260,35855,3,49,8,0,0,0,0,7,356,86,25090,28561,24949,1,11,16,5600,10,2699,10906,2,0,1,0,-2
EUW1_6882367808',7,349,19,2,0,3,0,5,0,347,84,34276,30194,43764,3,19,12,0,0,2,0,9,270,62,24977,26134,26680,1,77,22,9299,7,4060,17084,2,0,1,0,-4
EUW1_6882300356',4,28,9,0,0,0,0,14,1,354,88,26415,29121,20995,4,23,17,1,1,3,0,2,371,116,31755,31112,29412,0,-17,-28,-5340,-8,-1991,-8417,-1,-1,-3,0,12
EUW1_6882271137',3,23,11,0,0,0,0,17,0,278,109,26740,26487,29134,2,415,15,2,1,3,0,2,360,105,32118,31828,32791,0,-82,4,-5378,-4,-5341,-3657,-2,-1,-3,0,15
EUW1_6881783169',4,27,14,1,0,1,0,8,1,325,74,28086,29566,33481,3,21,16,1,0,0,0,3,340,96,28149,31758,44523,0,-15,-22,-63,-2,-2192,-11042,0,0,1,0,5
EUW1_6881661857',3,31,18,1,0,2,0,6,1,353,109,30389,31084,35055,2,21,6,0,0,0,0,7,351,84,24294,27120,29753,1,2,25,6095,12,3964,5302,1,0,2,0,-1
EUW1_6881590675',0,22,6,0,0,0,0,10,0,377,126,25903,30401,20010,4,30,11,2,1,2,0,3,379,90,27591,29627,25358,1,-2,36,-1688,-5,774,-5348,-2,-1,-2,0,7
EUW1_6879963574',5,93,16,2,0,2,0,3,1,377,132,32259,33390,38344,5,27,12,0,0,0,0,9,345,84,26605,29406,25144,1,32,48,5654,4,3984,13200,2,0,2,0,-6
EUW1_6879910873',3,31,13,1,0,0,0,9,0,367,95,27214,28800,29189,5,28,18,1,0,3,0,1,372,110,33129,31672,38105,0,-5,-15,-5915,-5,-2872,-8916,0,0,-3,0,8
EUW1_6879847071',2,25,14,1,0,1,0,8,0,361,91,29692,31060,39806,9,41,14,1,0,1,0,5,393,96,30264,31467,39099,0,-32,-5,-572,0,-407,707,0,0,0,0,3
EUW1_6879785911',3,25,8,0,0,0,0,7,0,409,102,25895,30637,24232,4,30,7,2,1,0,0,3,391,102,25591,30286,22342,1,18,0,304,1,351,1890,-2,-1,0,0,4
EUW1_6879742654',5,29,15,1,1,3,0,6,1,361,124,32572,33027,40698,4,27,10,1,0,0,0,11,330,79,26279,29053,29717,1,31,45,6293,5,3974,10981,0,1,3,0,-5
EUW1_6879695814',4,34,8,1,0,2,0,6,0,421,96,27686,31239,20705,7,31,6,1,0,0,0,7,351,112,24052,29224,22424,1,70,-16,3634,2,2015,-1719,0,0,2,0,-1
EUW1_6878858723',6,29,7,0,1,1,0,8,0,382,96,25774,29706,24611,6,31,12,1,0,1,0,3,380,84,26367,31518,25163,0,2,12,-593,-5,-1812,-552,-1,1,0,0,5
EUW1_6878803877',5,38,21,2,0,3,0,10,1,431,103,34713,34280,40061,0,46,3,0,0,1,0,7,357,84,22400,27655,26320,1,74,19,12313,18,6625,13741,2,0,2,0,3
EUW1_6878747247',4,22,11,1,0,0,0,12,1,348,92,26900,30324,30779,1,34,13,1,0,1,0,3,382,78,29031,32701,30436,0,-34,14,-2131,-2,-2377,343,0,0,-1,0,9
EUW1_6875288270',5,33,12,1,0,0,0,5,1,352,112,28127,30746,34289,1,26,13,1,1,2,0,4,354,84,27456,29283,35557,0,-2,28,671,-1,1463,-1268,0,-1,-2,0,1
EUW1_6875254019',2,45,17,1,0,2,0,8,0,368,79,30386,29654,35384,4,29,11,1,0,0,0,5,367,77,25929,29208,25626,1,1,2,4457,6,446,9758,0,0,2,0,3
EUW1_6875226473',2,33,11,0,0,0,0,10,0,338,78,26173,28604,30865,2,53,14,2,0,1,0,3,370,98,28450,30702,27888,0,-32,-20,-2277,-3,-2098,2977,-2,0,-1,0,7
EUW1_6875186300',3,26,10,1,0,0,0,15,0,306,88,26695,25955,29175,1,54,17,1,0,4,0,6,348,124,31297,30707,34176,0,-42,-36,-4602,-7,-4752,-5001,0,0,-4,0,9
EUW1_6875165160',2,26,11,1,0,0,0,10,0,344,78,26231,27889,40384,5,21,19,1,0,1,0,0,378,86,30772,30086,37257,0,-34,-8,-4541,-8,-2197,3127,0,0,-1,0,10
EUW1_6875136434',0,22,11,2,1,1,0,5,1,364,109,27870,31860,29282,2,45,8,0,0,0,0,4,373,98,25327,29712,32280,1,-9,11,2543,3,2148,-2998,2,1,1,0,1
EUW1_6874802682',2,30,8,1,0,0,0,7,0,340,103,24915,29738,34869,4,26,13,0,0,0,0,3,359,81,27089,30559,33338,1,-19,22,-2174,-5,-821,1531,1,0,0,0,4
EUW1_6874745008',3,37,9,0,0,0,0,10,0,354,84,25311,27388,34610,3,34,22,1,0,2,0,1,370,84,32984,31648,40268,0,-16,0,-7673,-13,-4260,-5658,-1,0,-2,0,9
EUW1_6874676409',4,23,9,0,0,1,0,12,0,367,102,27914,29545,24855,8,30,14,1,1,2,0,10,379,78,29053,30775,28712,1,-12,24,-1139,-5,-1230,-3857,-1,-1,-1,0,2
EUW1_6874616873',2,26,9,1,0,0,0,9,1,356,85,25837,28776,30953,0,25,12,1,1,1,0,2,339,96,26986,29667,31188,1,17,-11,-1149,-3,-891,-235,0,-1,-1,0,7
EUW1_6874549531',6,34,11,1,0,0,0,2,1,358,84,26756,29684,31931,5,24,15,1,0,0,0,3,374,94,27895,30447,29383,1,-16,-10,-1139,-4,-763,2548,0,0,0,0,-1
EUW1_6870520417',4,70,10,0,0,0,0,9,1,351,94,26290,29453,31906,5,48,14,2,1,1,0,1,356,114,28601,30688,34117,1,-5,-20,-2311,-4,-1235,-2211,-2,-1,-1,0,8
EUW1_6870438362',2,350,11,0,0,3,0,12,0,354,86,29196,28991,31418,0,72,14,2,0,1,0,8,324,86,28557,30672,30935,0,30,0,639,-3,-1681,483,-2,0,2,0,4
EUW1_6882667580',6,24,14,0,0,1,0,12,1,351,92,32088,29855,26248,4,43,23,2,0,2,0,10,372,96,33293,33182,39331,0,-21,-4,-1205,-9,-3327,-13083,-2,0,-1,0,2
EUW1_6882625184',2,24,12,1,0,1,0,7,1,368,92,29437,30364,33088,8,24,18,0,0,0,0,7,362,75,30069,31380,35650,0,6,17,-632,-6,-1016,-2562,1,0,1,0,0
EUW1_6882594826',7,52,18,0,0,1,0,9,1,356,93,31967,32184,37635,2,103,10,1,0,1,0,5,367,105,27397,29366,32793,0,-11,-12,4570,8,2818,4842,-1,0,0,0,4
EUW1_6882263601',3,27,11,1,0,0,0,5,0,378,85,26439,29686,29145,2,24,12,1,0,0,0,1,370,114,28470,29920,30361,1,8,-29,-2031,-1,-234,-1216,0,0,0,0,4
EUW1_6882246469',2,26,17,1,0,1,0,10,1,378,80,32677,28861,34840,2,38,11,0,0,2,0,4,321,66,25084,25611,23746,1,57,14,7593,6,3250,11094,1,0,-1,0,6
EUW1_6882182561',6,29,21,2,0,2,0,8,1,372,75,33282,31098,44410,3,26,12,0,0,1,0,6,311,84,27823,27904,33075,1,61,-9,5459,9,3194,11335,2,0,1,0,2
EUW1_6882131393',2,31,8,1,0,1,0,6,0,370,108,26695,30884,30261,7,30,7,1,1,0,0,2,400,104,27179,30318,24164,0,-30,4,-484,1,566,6097,0,-1,1,0,4
EUW1_6882104033',4,41,10,0,0,0,0,5,1,387,75,26538,29917,30243,1,20,15,2,1,0,0,2,419,106,29327,32753,33098,0,-32,-31,-2789,-5,-2836,-2855,-2,-1,0,0,3
EUW1_6883622139',7,150,13,1,0,1,0,9,1,345,106,28826,31130,39232,2,38,10,0,0,1,0,6,368,86,26654,29242,37510,0,-23,20,2172,3,1888,1722,1,0,0,0,3
EUW1_6883591085',4,25,12,0,0,0,0,16,0,370,76,27378,29864,34134,3,29,13,2,0,2,0,2,410,68,30232,30968,35957,0,-40,8,-2854,-1,-1104,-1823,-2,0,-2,0,14
EUW1_6883569664',2,61,11,0,0,0,0,14,1,312,78,26972,24931,30471,6,78,26,1,0,3,0,2,347,101,33066,30965,48094,0,-35,-23,-6094,-15,-6034,-17623,-1,0,-3,0,12
EUW1_6883544669',3,42,24,1,1,3,0,15,1,378,93,34996,32811,45425,1,20,15,0,0,1,0,7,345,56,30330,28591,36805,1,33,37,4666,9,4220,8620,1,1,2,0,8
EUW1_6883495351',7,34,13,0,0,0,0,12,1,311,65,25981,24678,34651,4,26,24,2,0,2,0,3,348,81,32322,30008,40664,0,-37,-16,-6341,-11,-5330,-6013,-2,0,-2,0,9
EUW1_6883425622',2,24,13,1,0,1,0,5,0,416,112,30007,33348,29567,5,34,11,0,0,1,0,8,382,95,28205,32423,34852,1,34,17,1802,2,925,-5285,1,0,0,0,-3
EUW1_6883359295',5,30,12,0,0,1,0,11,0,371,83,29016,29860,33868,6,32,13,1,0,1,0,1,377,115,28995,29489,32387,0,-6,-32,21,-1,371,1481,-1,0,0,0,10
EUW1_6883311886',4,26,4,0,1,0,0,8,0,374,102,25063,28150,28988,6,30,16,2,0,1,0,3,364,80,29765,29821,33871,0,10,22,-4702,-12,-1671,-4883,-2,1,-1,0,5
EUW1_6882184483',5,44,6,0,0,1,0,15,0,345,74,25116,28080,21505,4,25,16,2,1,2,0,2,396,122,30963,32783,29248,0,-51,-48,-5847,-10,-4703,-7743,-2,-1,-1,0,13
EUW1_6882136361',4,48,4,2,0,0,0,8,0,376,95,23724,27881,20085,6,35,14,0,0,1,0,1,402,96,28549,33300,28968,1,-26,-1,-4825,-10,-5419,-8883,2,0,-1,0,7
EUW1_6882100773',5,28,18,0,0,1,0,8,0,330,76,30656,29560,42504,2,231,18,2,0,0,0,4,367,87,30536,30620,39079,1,-37,-11,120,0,-1060,3425,-2,0,1,0,4
EUW1_6873992682',4,47,8,2,1,0,0,8,0,368,97,25735,30098,22463,3,27,4,0,0,0,0,2,428,106,26228,30675,24063,1,-60,-9,-493,4,-577,-1600,2,1,0,0,6
EUW1_6882681595',2,28,13,1,1,2,0,8,1,364,100,29414,32999,28957,2,26,5,0,0,0,0,4,373,108,24912,29453,30646,1,-9,-8,4502,8,3546,-1689,1,1,2,0,4
EUW1_6881217275',4,27,16,1,0,0,0,7,1,381,85,30538,31238,33531,3,22,4,0,0,2,0,3,341,74,22681,26338,25566,1,40,11,7857,12,4900,7965,1,0,-2,0,4
EUW1_6881183886',8,39,4,1,0,0,0,13,1,354,80,23363,27528,26093,6,35,12,1,0,1,0,0,427,74,29377,31089,31417,0,-73,6,-6014,-8,-3561,-5324,0,0,-1,0,13
EUW1_6881141413',1,25,2,0,0,0,0,8,0,356,81,21347,27723,27400,6,32,12,2,0,2,0,1,402,98,28972,31839,32039,0,-46,-17,-7625,-10,-4116,-4639,-2,0,-2,0,7
EUW1_6881064997',5,37,2,0,0,0,0,9,0,350,54,20970,25078,22199,5,64,18,1,0,1,0,2,400,100,28806,31434,35432,0,-50,-46,-7836,-16,-6356,-13233,-1,0,-1,0,7
EUW1_6879761914',2,50,13,1,0,0,0,7,0,367,109,27369,31590,38394,1,15,15,0,0,1,0,1,357,85,29623,30754,30977,1,10,24,-2254,-2,836,7417,1,0,-1,0,6
EUW1_6879711683',7,29,9,1,1,1,0,6,1,389,92,28456,29675,17737,2,23,8,1,0,2,0,6,371,104,26230,31046,21543,0,18,-12,2226,1,-1371,-3806,0,1,-1,0,0
EUW1_6878202553',6,27,17,1,0,2,0,6,0,387,106,31717,31868,34566,1,19,10,0,0,0,0,9,345,82,25612,28593,27187,1,42,24,6105,7,3275,7379,1,0,2,0,-3
EUW1_6878171828',2,22,24,1,0,1,0,7,1,361,72,34057,34099,41928,6,34,8,1,0,1,0,4,353,69,24744,27259,35237,1,8,3,9313,16,6840,6691,0,0,0,0,3
EUW1_6878134602',6,40,19,2,0,1,0,8,1,378,82,30165,30397,39079,4,23,11,0,1,1,0,4,360,94,27396,29482,28292,1,18,-12,2769,8,915,10787,2,-1,0,0,4
EUW1_6877112066',6,29,18,1,0,0,0,12,0,316,93,28914,31607,40547,3,62,18,1,0,1,0,3,388,92,32646,30888,39175,0,-72,1,-3732,0,719,1372,0,0,-1,0,9
EUW1_6876639973',5,30,19,1,1,1,0,6,1,381,74,31913,31498,37631,6,26,6,0,0,0,0,5,329,68,23068,26222,32060,1,52,6,8845,13,5276,5571,1,1,1,0,1
EUW1_6876122624',5,54,3,0,0,0,0,11,0,327,110,23114,27555,25843,7,101,20,1,1,2,0,3,384,118,32425,33022,35046,0,-57,-8,-9311,-17,-5467,-9203,-1,-1,-2,0,8
EUW1_6877470959',5,31,10,1,1,1,0,7,1,387,89,27476,30558,34417,3,30,9,1,0,1,0,3,379,76,26560,29082,22837,1,8,13,916,1,1476,11580,0,1,0,0,4
EUW1_6870786455',3,28,11,2,0,3,0,4,1,398,100,29139,30825,30965,2,22,12,0,0,1,0,6,339,75,26061,30100,30761,1,59,25,3078,-1,725,204,2,0,2,0,-2
EUW1_6870746458',4,28,15,1,0,1,0,10,1,341,74,29459,29988,38031,2,25,12,1,0,2,0,9,356,70,27383,28638,33342,0,-15,4,2076,3,1350,4689,0,0,-1,0,1
EUW1_6870697661',4,31,11,0,0,1,0,11,0,358,63,28159,29603,34114,3,29,20,1,0,1,0,4,384,101,33820,32143,45094,0,-26,-38,-5661,-9,-2540,-10980,-1,0,0,0,7
EUW1_6870645974',2,28,16,1,1,3,0,7,0,404,99,31307,31791,37991,2,33,6,1,0,1,0,10,347,88,25202,29530,23889,1,57,11,6105,10,2261,14102,0,1,2,0,-3
EUW1_6870080938',5,78,9,1,0,0,0,9,1,302,62,24065,24019,30927,5,27,15,0,0,1,0,3,373,72,29371,30956,34800,0,-71,-10,-5306,-6,-6937,-3873,1,0,-1,0,6
EUW1_6868954542',2,25,12,1,0,0,0,12,0,318,62,25816,26164,31430,3,35,24,1,0,3,0,2,369,82,34214,31272,44044,0,-51,-20,-8398,-12,-5108,-12614,0,0,-3,0,10
EUW1_6868697255',3,29,16,1,1,3,0,5,1,373,103,31006,31882,29143,2,31,6,1,0,0,0,8,351,85,25233,28271,23522,1,22,18,5773,10,3611,5621,0,1,3,0,-3
EUW1_6868570598',5,31,13,2,0,1,0,3,1,363,102,29298,30633,30126,1,20,5,0,0,1,0,2,388,82,24431,27728,20820,1,-25,20,4867,8,2905,9306,2,0,0,0,1
EUW1_6868481549',3,28,14,0,1,0,0,6,0,357,95,28511,29190,37432,2,42,17,2,0,0,0,0,300,90,28079,28234,29773,1,57,5,432,-3,956,7659,-2,1,0,0,6
EUW1_6868434842',3,24,17,1,0,6,0,7,1,407,90,34881,30936,37004,6,24,13,0,0,1,0,12,262,56,25424,23636,33158,1,145,34,9457,4,7300,3846,1,0,5,0,-5
EUW1_6882026463',13,152,9,0,0,2,0,10,1,343,74,26668,27056,33927,6,56,16,1,0,1,0,7,336,69,27891,29576,31800,1,7,5,-1223,-7,-2520,2127,-1,0,1,0,3
EUW1_6880738520',5,24,13,1,0,1,0,9,0,332,102,28620,28747,35659,5,95,21,1,0,0,0,4,315,74,28727,29535,33752,1,17,28,-107,-8,-788,1907,0,0,1,0,5
EUW1_6877735814',6,40,12,2,0,1,0,7,1,378,138,29133,34169,34771,5,27,11,0,1,0,0,3,375,85,26840,30606,27661,1,3,53,2293,1,3563,7110,2,-1,1,0,4
EUW1_6875368188',5,29,8,0,0,0,0,10,0,315,89,25071,24798,26873,7,113,17,2,0,1,0,2,351,98,30395,30146,33119,0,-36,-9,-5324,-9,-5348,-6246,-2,0,-1,0,8
EUW1_6875335959',6,43,21,2,1,1,0,5,1,368,100,32233,33984,40145,0,31,8,0,0,1,0,6,319,82,24205,28465,28546,1,49,18,8028,13,5519,11599,2,1,0,0,-1
EUW1_6875255162',5,27,25,1,0,1,0,10,1,347,91,33339,33354,42569,3,106,13,1,0,1,0,6,322,80,25697,26093,28033,1,25,11,7642,12,7261,14536,0,0,0,0,4
EUW1_6872183290',3,39,5,1,0,0,0,6,0,379,98,23337,29405,28547,6,37,13,1,0,0,0,3,383,69,26656,30574,32204,1,-4,29,-3319,-8,-1169,-3657,0,0,0,0,3
EUW1_6869752940',4,30,12,1,0,2,0,16,1,333,63,27750,28371,29493,1,23,11,1,0,2,0,6,325,103,28017,29495,30405,0,8,-40,-267,1,-1124,-912,0,0,0,0,10
EUW1_6869244378',2,30,9,0,0,0,0,12,1,340,86,25830,28031,32946,3,36,19,2,1,2,0,5,376,98,31194,31895,35204,0,-36,-12,-5364,-10,-3864,-2258,-2,-1,-2,0,7
EUW1_6869229602',1,34,13,0,0,0,0,9,1,313,81,26623,27816,29732,0,55,12,1,0,0,0,4,315,61,25936,28119,31126,0,-2,20,687,1,-303,-1394,-1,0,0,0,5
EUW1_6869193433',2,31,17,0,0,1,0,6,1,359,66,30146,29398,45483,0,23,11,2,0,1,0,8,262,86,22890,26053,25961,1,97,-20,7256,6,3345,19522,-2,0,0,0,-2
EUW1_6869126289',3,28,12,1,0,2,0,14,1,329,82,28617,28795,33671,6,28,16,0,0,2,0,3,364,67,30119,29521,38809,0,-35,15,-1502,-4,-726,-5138,1,0,0,0,11
EUW1_6869072522',3,25,10,0,0,0,0,9,0,329,87,25875,27849,33864,1,24,17,2,0,0,0,1,340,79,28623,30946,32841,0,-11,8,-2748,-7,-3097,1023,-2,0,0,0,8
EUW1_6882871421',3,25,6,1,0,1,0,8,0,395,94,25698,30095,20703,3,29,7,1,0,1,0,3,405,86,25696,29411,26278,0,-10,8,2,-1,684,-5575,0,0,0,0,5
EUW1_6882831509',2,29,15,0,0,0,0,8,0,360,67,27083,28827,40813,7,29,11,1,1,1,0,3,397,91,28479,30475,33881,1,-37,-24,-1396,4,-1648,6932,-1,-1,-1,0,5
EUW1_6882789961',8,38,20,1,0,0,0,5,1,357,93,31497,31449,42286,3,91,8,0,0,1,0,5,358,78,25235,27574,32156,1,-1,15,6262,12,3875,10130,1,0,-1,0,0
EUW1_6882730267',4,29,10,0,0,0,0,8,0,359,64,25767,29024,22606,2,23,14,2,0,1,0,0,358,111,29001,30580,36720,1,1,-47,-3234,-4,-1556,-14114,-2,0,-1,0,8
EUW1_6882696143',4,31,9,1,1,0,0,5,0,401,112,25932,31768,27997,2,29,6,1,0,0,0,1,368,92,23598,28025,21162,1,33,20,2334,3,3743,6835,0,1,0,0,4
EUW1_6881962973',1,64,5,1,0,0,0,4,0,378,108,24887,30495,19404,4,70,2,0,0,0,0,3,393,111,23262,31386,23855,0,-15,-3,1625,3,-891,-4451,1,0,0,0,1
EUW1_6881895913',4,30,15,2,1,0,0,6,1,385,101,29132,32977,38166,6,32,7,0,0,0,0,2,311,92,23864,28456,36923,1,74,9,5268,8,4521,1243,2,1,0,0,4
EUW1_6881764967',6,33,10,1,0,0,0,6,1,402,100,26584,30490,28479,7,33,8,1,1,0,0,3,363,90,25220,28372,23152,1,39,10,1364,2,2118,5327,0,-1,0,0,3
EUW1_6881699004',1,51,12,1,0,1,0,9,0,337,77,28014,29271,32208,5,91,20,0,0,1,0,6,362,73,30408,30693,39112,0,-25,4,-2394,-8,-1422,-6904,1,0,0,0,3
EUW1_6881642880',1,28,6,0,0,0,0,12,1,345,72,23598,27414,15314,5,88,12,1,0,1,0,4,366,108,26685,31926,26916,0,-21,-36,-3087,-6,-4512,-11602,-1,0,-1,0,8
EUW1_6881594679',5,28,10,1,0,0,0,13,0,312,70,24921,27343,20369,5,42,13,1,0,3,0,0,401,126,30381,32812,35253,0,-89,-56,-5460,-3,-5469,-14884,0,0,-3,0,13
EUW1_6879219401',5,20,12,1,0,0,0,9,1,294,72,25048,27396,26752,3,29,11,0,1,2,0,1,354,92,28802,30088,33512,0,-60,-20,-3754,1,-2692,-6760,1,-1,-2,0,8
EUW1_6878448490',5,46,11,0,0,0,0,14,0,371,84,26355,29102,31266,2,27,19,1,0,2,0,0,385,103,31917,33696,33837,0,-14,-19,-5562,-8,-4594,-2571,-1,0,-2,0,14
EUW1_6878389098',2,23,18,0,0,1,0,10,0,306,81,28373,28304,39334,1,26,13,2,0,1,0,4,301,112,27618,28410,27002,1,5,-31,755,5,-106,12332,-2,0,0,0,6
EUW1_6878350588',6,92,9,0,0,1,0,10,0,388,78,27671,29301,27670,5,37,12,2,0,1,0,5,383,82,27041,30886,29436,0,5,-4,630,-3,-1585,-1766,-2,0,0,0,5
EUW1_6877115739',3,22,17,1,0,1,0,4,0,420,98,31485,33040,29068,4,29,4,1,0,0,0,6,368,83,22884,26779,23579,1,52,15,8601,13,6261,5489,0,0,1,0,-2
EUW1_6877055307',6,71,20,0,0,0,0,10,1,372,80,29770,31218,36892,3,29,12,2,0,0,0,2,298,100,26252,29566,29378,0,74,-20,3518,8,1652,7514,-2,0,0,0,8
EUW1_6877020571',9,32,14,2,0,0,0,7,0,356,82,27302,30277,28072,4,25,9,0,0,1,0,3,378,106,27040,29597,28093,1,-22,-24,262,5,680,-21,2,0,-1,0,4
EUW1_6881637458',6,27,18,2,0,2,0,5,0,362,80,31246,31186,36165,4,21,11,0,0,0,0,6,343,84,26666,28190,30693,1,19,-4,4580,7,2996,5472,2,0,2,0,-1
EUW1_6881544747',3,26,9,0,0,2,0,7,0,356,88,26807,29441,24903,5,28,10,2,1,1,0,6,378,99,27206,31191,28851,0,-22,-11,-399,-1,-1750,-3948,-2,-1,1,0,1
EUW1_6881501300',4,31,8,0,0,0,0,8,0,325,85,24548,28960,23832,5,31,17,2,1,2,0,4,384,90,30753,31001,39383,0,-59,-5,-6205,-9,-2041,-15551,-2,-1,-2,0,4
EUW1_6881441849',8,34,10,1,0,0,0,11,1,395,100,28314,29259,30341,5,28,14,1,0,1,0,5,355,84,29003,32123,34150,0,40,16,-689,-4,-2864,-3809,0,0,-1,0,6
EUW1_6878520150',4,31,11,0,0,0,0,9,0,348,78,27016,29914,39132,2,24,14,2,0,1,0,4,342,104,27844,31166,29637,1,6,-26,-828,-3,-1252,9495,-2,0,-1,0,5
EUW1_6878477066',3,25,25,2,0,3,0,7,0,392,108,34767,31135,40568,2,31,11,0,0,1,0,13,351,59,27534,28548,34122,1,41,49,7233,14,2587,6446,2,0,2,0,-6
EUW1_6878446978',2,21,11,0,0,0,0,16,0,333,86,25982,28452,32563,4,32,23,1,0,2,0,0,376,106,35361,32139,41244,0,-43,-20,-9379,-12,-3687,-8681,-1,0,-2,0,16
EUW1_6878395041',2,28,12,1,1,1,0,8,1,361,98,27164,29983,33090,4,31,7,0,0,0,0,5,334,84,23996,26780,24718,1,27,14,3168,5,3203,8372,1,1,1,0,3
EUW1_6876967235',3,25,3,1,1,0,0,11,0,370,104,23467,29001,17682,4,43,9,1,0,1,0,0,403,95,26861,30600,28212,0,-33,9,-3394,-6,-1599,-10530,0,1,-1,0,11
EUW1_6876934551',2,23,16,2,0,2,0,9,0,359,94,30080,32661,39664,3,27,9,0,0,0,0,6,325,102,24886,29050,25533,1,34,-8,5194,7,3611,14131,2,0,2,0,3
EUW1_6876880117',5,37,11,0,0,0,0,15,0,326,93,26338,29445,27589,5,21,16,2,0,3,0,2,381,94,31217,31280,42148,1,-55,-1,-4879,-5,-1835,-14559,-2,0,-3,0,13
EUW1_6876828424',0,20,13,1,0,0,0,17,1,301,82,26588,26646,28304,3,29,16,1,1,4,0,3,427,109,34960,33524,29399,0,-126,-27,-8372,-3,-6878,-1095,0,-1,-4,0,14
EUW1_6876787274',3,21,9,1,0,0,0,12,1,393,112,26943,30403,32016,4,31,23,1,0,2,0,2,354,64,32610,33663,36860,0,39,48,-5667,-14,-3260,-4844,0,0,-2,0,10
EUW1_6876663376',3,26,5,1,1,0,0,10,0,393,91,25912,28515,25499,7,29,14,1,0,2,0,5,348,92,28124,28966,26835,0,45,-1,-2212,-9,-451,-1336,0,1,-2,0,5
EUW1_6882897066',5,26,14,1,0,2,0,16,1,352,96,29791,31180,31558,7,22,9,1,0,4,0,7,382,80,29147,29591,21792,0,-30,16,644,5,1589,9766,0,0,-2,0,9
EUW1_6882481506',2,23,16,1,0,1,0,8,1,359,97,30660,30308,35974,6,30,15,1,1,0,0,6,338,95,28592,29125,24531,0,21,2,2068,1,1183,11443,0,-1,1,0,2
EUW1_6882458852',5,30,20,2,1,3,0,8,0,364,92,33746,30224,46772,5,23,7,0,0,1,0,9,298,80,24104,26577,29832,1,66,12,9642,13,3647,16940,2,1,2,0,-1
EUW1_6882437080',4,26,6,1,0,0,0,12,0,326,100,24086,27933,26213,7,24,16,1,0,1,0,0,357,94,29539,31474,28642,0,-31,6,-5453,-10,-3541,-2429,0,0,-1,0,12
EUW1_6882417853',2,21,11,1,0,1,0,7,1,386,96,28255,31636,27282,3,23,8,0,0,0,0,5,378,96,26031,29578,23973,0,8,0,2224,3,2058,3309,1,0,1,0,2
EUW1_6881806647',3,23,28,2,0,2,0,10,1,344,82,33636,30947,39302,1,18,9,0,0,1,0,9,340,104,28536,28974,26073,1,4,-22,5100,19,1973,13229,2,0,1,0,1
EUW1_6881717891',1,22,9,0,0,1,0,8,0,334,85,26851,27290,25468,2,34,23,1,0,1,0,4,368,98,31713,33336,42407,0,-34,-13,-4862,-14,-6046,-16939,-1,0,0,0,4
EUW1_6879618865',4,31,8,2,0,1,0,8,1,340,107,26453,28987,28800,2,26,15,0,0,1,0,7,417,100,29973,34768,35621,0,-77,7,-3520,-7,-5781,-6821,2,0,0,0,1
EUW1_6879589887',4,29,25,2,0,3,0,5,0,388,122,35586,34113,44592,3,32,14,0,0,0,0,13,349,50,27736,30004,41378,1,39,72,7850,11,4109,3214,2,0,3,0,-8
EUW1_6879552695',1,24,15,2,0,0,0,9,0,352,88,28969,30022,28509,5,31,15,0,0,0,0,6,343,92,28029,29048,33818,1,9,-4,940,0,974,-5309,2,0,0,0,3
EUW1_6879506320',2,22,11,1,0,0,0,7,1,347,104,27854,28462,40128,3,28,16,1,0,1,0,4,365,72,28334,30218,32518,1,-18,32,-480,-5,-1756,7610,0,0,-1,0,3
EUW1_6879302131',6,26,11,1,0,1,0,16,0,277,90,25787,26886,31758,3,31,15,1,0,3,0,4,315,85,29280,26810,35743,0,-38,5,-3493,-4,76,-3985,0,0,-2,0,12
EUW1_6879233550',3,30,18,0,1,1,0,11,1,298,86,28646,30972,38170,5,82,12,1,0,2,0,2,346,77,27082,27922,33940,0,-48,9,1564,6,3050,4230,-1,1,-1,0,9
EUW1_6879203481',2,23,15,2,0,0,0,8,1,398,109,28393,30858,29081,2,48,4,0,0,0,0,3,346,74,22898,27300,27699,1,52,35,5495,11,3558,1382,2,0,0,0,5
EUW1_6879158769',1,21,18,2,0,1,0,13,0,347,83,29296,29552,28090,3,32,7,0,0,2,0,3,379,127,28393,30263,25329,1,-32,-44,903,11,-711,2761,2,0,-1,0,10
EUW1_6879104075',7,297,6,0,0,0,0,11,0,362,88,23904,28110,18769,3,32,11,2,0,1,0,0,381,104,27739,31000,27665,0,-19,-16,-3835,-5,-2890,-8896,-2,0,-1,0,11
EUW1_6879054118',6,20,10,2,0,0,0,10,1,339,74,25443,27295,22316,5,38,5,0,0,1,0,3,398,85,25134,28146,20459,1,-59,-11,309,5,-851,1857,2,0,-1,0,7
EUW1_6878400086',3,40,8,0,0,0,0,8,1,347,105,25453,28024,26881,3,26,11,1,0,1,0,2,398,82,28438,30682,34741,0,-51,23,-2985,-3,-2658,-7860,-1,0,-1,0,6
EUW1_6878158629',5,29,14,1,0,1,0,11,1,346,96,29207,30097,31927,3,25,13,1,0,1,0,2,377,82,28974,29731,27807,0,-31,14,233,1,366,4120,0,0,0,0,9
EUW1_6878103816',4,27,9,0,0,1,0,9,0,375,85,27060,28306,28322,3,32,14,1,1,1,0,5,367,106,28826,31096,30774,0,8,-21,-1766,-5,-2790,-2452,-1,-1,0,0,4
EUW1_6882819585',12,35,14,0,0,0,0,7,0,395,96,29801,30889,30365,7,37,14,2,0,1,0,4,370,76,27858,29288,29508,1,25,20,1943,0,1601,857,-2,0,-1,0,3
EUW1_6882522370',4,30,14,2,0,2,0,11,0,351,74,28160,30149,37288,5,26,7,0,0,0,0,6,328,89,24278,28184,27404,1,23,-15,3882,7,1965,9884,2,0,2,0,5
EUW1_6882501851',8,44,6,0,0,1,0,6,0,387,93,25382,28884,34050,5,29,7,2,0,0,0,2,352,84,23691,29415,28272,0,35,9,1691,-1,-531,5778,-2,0,1,0,4
EUW1_6882158268',4,26,12,0,0,1,0,5,0,327,84,27702,28207,37264,8,110,15,1,0,0,0,5,335,92,29072,29461,34982,0,-8,-8,-1370,-3,-1254,2282,-1,0,1,0,0
EUW1_6882138862',2,62,15,2,0,2,0,10,1,363,84,30685,31687,39093,5,61,10,0,0,0,0,7,328,80,25330,28908,33369,1,35,4,5355,5,2779,5724,2,0,2,0,3
EUW1_6881797379',4,26,8,0,0,0,0,9,0,346,82,24863,28718,19794,3,21,13,2,0,1,0,3,399,104,29240,30918,31883,0,-53,-22,-4377,-5,-2200,-12089,-2,0,-1,0,6
EUW1_6881621028',5,27,16,2,0,0,0,12,0,350,72,30006,29040,34924,6,26,17,0,0,2,0,2,340,103,31820,31065,33397,0,10,-31,-1814,-1,-2025,1527,2,0,-2,0,10
EUW1_6881545962',2,29,11,0,0,0,0,14,1,335,92,27497,27312,35996,2,27,19,2,0,2,0,1,344,86,30051,29733,33299,0,-9,6,-2554,-8,-2421,2697,-2,0,-2,0,13
EUW1_6881191839',3,26,17,0,0,1,0,13,1,383,80,29952,30555,38126,2,26,11,2,0,1,0,4,348,96,28413,28941,33224,1,35,-16,1539,6,1614,4902,-2,0,0,0,9
EUW1_6880752655',0,26,5,0,0,0,0,9,0,306,86,22503,24861,29638,4,23,28,2,0,3,0,1,331,78,33916,31195,48488,0,-25,8,-11413,-23,-6334,-18850,-2,0,-3,0,8
EUW1_6880730205',2,26,13,0,0,1,0,12,0,318,85,28042,28506,27119,1,32,19,1,0,3,0,7,397,86,33268,32750,36695,0,-79,-1,-5226,-6,-4244,-9576,-1,0,-2,0,5
EUW1_6880647110',4,34,7,1,0,0,0,8,0,340,91,24407,26450,26747,9,32,19,1,0,2,0,3,407,95,32324,31955,32035,0,-67,-4,-7917,-12,-5505,-5288,0,0,-2,0,5
EUW1_6880613009',6,45,10,1,0,1,0,5,0,406,104,28379,31734,28442,3,27,8,1,0,1,0,4,357,80,25447,29271,24513,1,49,24,2932,2,2463,3929,0,0,0,0,1
EUW1_6879244695',4,23,25,2,1,5,0,8,1,379,128,36499,34136,38626,1,15,6,0,0,0,0,11,381,60,24013,26683,26843,1,-2,68,12486,19,7453,11783,2,1,5,0,-3
EUW1_6879212762',5,31,13,0,0,1,0,6,0,404,95,28061,32256,33487,3,24,5,1,0,0,0,2,411,100,24053,29877,22338,1,-7,-5,4008,8,2379,11149,-1,0,1,0,4
EUW1_6883275942',3,30,6,1,0,0,0,11,1,311,84,23347,26099,29908,4,32,21,0,0,1,0,2,379,88,31536,32835,41536,0,-68,-4,-8189,-15,-6736,-11628,1,0,-1,0,9
EUW1_6883218745',3,21,20,2,0,1,0,8,1,367,95,32274,31286,38468,3,54,10,0,0,2,0,10,349,80,26711,29121,34223,1,18,15,5563,10,2165,4245,2,0,-1,0,-2
EUW1_6883152273',4,28,10,0,0,0,0,9,0,315,76,24513,25583,28574,3,35,21,2,0,2,0,1,360,80,30997,30379,36787,0,-45,-4,-6484,-11,-4796,-8213,-2,0,-2,0,8
EUW1_6882887367',2,25,13,1,0,0,0,8,1,316,96,27385,27987,36302,5,55,16,0,0,0,0,1,364,69,27400,29026,36547,0,-48,27,-15,-3,-1039,-245,1,0,0,0,7
EUW1_6879921152',5,204,13,1,0,0,0,10,1,349,95,26645,29330,33566,2,40,12,0,0,0,0,3,341,85,27702,30191,28615,1,8,10,-1057,1,-861,4951,1,0,0,0,7
EUW1_6877812923',3,26,14,2,0,0,0,12,1,334,96,28053,29042,33560,1,26,13,0,0,2,0,3,349,76,28171,29709,34739,1,-15,20,-118,1,-667,-1179,2,0,-2,0,9
EUW1_6877560559',2,28,10,0,0,0,0,4,0,368,91,27095,29700,26904,0,44,12,1,0,0,0,0,367,76,27637,29289,28233,1,1,15,-542,-2,411,-1329,-1,0,0,0,4
EUW1_6876928716',9,34,16,0,0,0,0,6,1,350,78,28420,29969,36429,4,30,8,2,0,0,0,6,330,92,24868,26170,31102,1,20,-14,3552,8,3799,5327,-2,0,0,0,0
EUW1_6875679546',5,27,14,1,0,1,0,8,1,346,99,31576,29914,48592,2,24,15,1,0,0,0,7,353,95,29062,30184,36499,0,-7,4,2514,-1,-270,12093,0,0,1,0,1
EUW1_6875629415',2,22,9,0,0,0,0,10,0,323,86,24604,27030,23671,6,31,17,2,0,3,0,3,402,85,32023,32471,38800,0,-79,1,-7419,-8,-5441,-15129,-2,0,-3,0,7
EUW1_6883601243',5,34,22,1,0,1,0,9,1,315,92,29991,29465,39454,2,29,9,1,0,1,0,4,322,88,24946,26445,29007,1,-7,4,5045,13,3020,10447,0,0,0,0,5
EUW1_6883554401',2,47,23,1,0,3,0,14,1,351,79,31792,29838,40113,4,26,11,1,0,1,0,6,327,96,27433,28221,28292,1,24,-17,4359,12,1617,11821,0,0,2,0,8
EUW1_6883527126',3,27,17,0,0,2,0,10,1,363,77,30168,33212,34856,4,31,10,1,0,0,0,6,319,101,25739,28437,32511,1,44,-24,4429,7,4775,2345,-1,0,2,0,4
EUW1_6883486399',4,33,23,1,0,0,0,13,1,303,78,30255,29653,36771,2,23,15,0,0,0,0,1,329,80,28503,28380,37823,1,-26,-2,1752,8,1273,-1052,1,0,0,0,12
EUW1_6883409075',2,27,4,1,0,0,0,8,0,371,77,24665,29091,23667,3,23,8,1,0,1,0,6,310,94,24251,28570,25196,1,61,-17,414,-4,521,-1529,0,0,-1,0,2
EUW1_6883368165',5,31,15,1,0,1,0,11,0,372,108,30138,31635,34401,5,32,7,1,0,1,0,4,394,94,26491,29409,27619,1,-22,14,3647,8,2226,6782,0,0,0,0,7
EUW1_6883319791',6,190,15,1,1,1,0,3,1,383,103,31229,31869,29751,1,23,5,1,0,2,0,10,356,91,23144,26926,17745,1,27,12,8085,10,4943,12006,0,1,-1,0,-7
EUW1_6883236288',4,30,12,1,0,0,0,12,0,367,90,26827,29265,32183,3,21,14,1,0,1,0,1,331,82,27980,28762,37231,1,36,8,-1153,-2,503,-5048,0,0,-1,0,11
EUW1_6883178046',1,24,6,0,0,0,0,7,0,348,83,24536,28880,23766,1,23,10,1,0,1,0,2,356,104,26832,29302,31006,0,-8,-21,-2296,-4,-422,-7240,-1,0,-1,0,5
EUW1_6883132798',2,61,17,1,0,2,0,4,1,397,114,31829,33068,38269,5,29,8,1,0,0,0,10,335,62,23514,27077,25745,1,62,52,8315,9,5991,12524,0,0,2,0,-6
EUW1_6883069038',1,17,15,2,1,0,0,6,0,334,98,27832,29278,28864,4,21,12,0,0,0,0,1,340,80,26583,28180,35509,1,-6,18,1249,3,1098,-6645,2,1,0,0,5
EUW1_6883022662',0,26,11,1,0,0,0,7,1,380,106,28467,30357,35947,2,32,12,1,0,2,0,6,365,82,27363,29491,28975,1,15,24,1104,-1,866,6972,0,0,-2,0,1
EUW1_6882947972',3,33,13,1,0,0,0,7,0,347,78,26778,29298,34993,2,58,13,0,0,0,0,0,349,80,26345,29088,32289,1,-2,-2,433,0,210,2704,1,0,0,0,7
EUW1_6882853307',1,27,19,1,0,1,0,8,0,333,112,30911,34378,42407,2,18,14,0,0,0,0,5,352,71,26769,28489,29549,1,-19,41,4142,5,5889,12858,1,0,1,0,3
EUW1_6882309190',5,89,16,1,0,0,0,10,1,325,68,27040,28395,31562,1,25,5,1,0,1,0,2,372,92,25117,27470,28312,0,-47,-24,1923,11,925,3250,0,0,-1,0,8
EUW1_6882619737',3,29,10,2,0,0,0,9,0,351,104,25847,28607,27004,1,35,14,0,0,1,0,1,394,84,28911,30568,35713,1,-43,20,-3064,-4,-1961,-8709,2,0,-1,0,8
EUW1_6881300808',6,45,20,1,0,0,0,11,1,382,88,29633,32171,40326,7,38,11,1,0,0,0,4,376,107,28650,30315,28331,1,6,-19,983,9,1856,11995,0,0,0,0,7
EUW1_6881268781',3,65,5,1,0,0,0,12,1,377,90,23084,28279,22871,6,34,13,1,0,1,0,1,400,98,29317,32372,32349,0,-23,-8,-6233,-8,-4093,-9478,0,0,-1,0,11
EUW1_6879937663',3,28,11,0,1,0,0,13,0,347,70,26417,29567,27658,4,30,14,1,0,1,0,1,358,74,28359,29213,36442,0,-11,-4,-1942,-3,354,-8784,-1,1,-1,0,12
EUW1_6878367991',5,27,7,1,0,0,0,10,0,337,94,24324,28663,20753,1,224,13,1,0,1,0,0,332,102,27183,29706,34024,0,5,-8,-2859,-6,-1043,-13271,0,0,-1,0,10
EUW1_6878315355',3,61,17,2,0,3,0,7,0,352,128,31242,32227,34956,6,69,6,0,1,0,0,10,315,73,24287,27266,23714,1,37,55,6955,11,4961,11242,2,-1,3,0,-3
EUW1_6878282983',8,32,18,2,0,1,0,5,1,402,103,31564,32549,34230,4,68,10,0,0,0,0,9,356,87,26728,28239,26545,1,46,16,4836,8,4310,7685,2,0,1,0,-4
EUW1_6878228150',4,75,13,1,0,1,0,11,0,351,109,28133,31805,27527,4,30,11,1,1,1,0,0,382,93,28447,29723,30248,0,-31,16,-314,2,2082,-2721,0,-1,0,0,11
EUW1_6875820970',3,144,18,1,0,1,0,12,1,370,115,30970,32708,43586,6,32,10,1,0,0,0,4,323,53,24015,26473,28270,1,47,62,6955,8,6235,15316,0,0,1,0,8
EUW1_6875695278',6,31,9,1,0,0,0,8,0,363,70,24793,27717,27664,2,22,12,0,0,0,0,2,393,59,27217,30870,33738,1,-30,11,-2424,-3,-3153,-6074,1,0,0,0,6
EUW1_6875631396',2,24,20,0,0,0,0,8,0,340,78,30691,28442,36030,4,35,14,2,0,1,0,5,323,100,28346,29127,32692,0,17,-22,2345,6,-685,3338,-2,0,-1,0,3
EUW1_6873964497',5,33,11,0,0,1,0,5,0,360,92,27233,29250,32379,3,89,11,1,0,0,0,5,328,78,24796,27804,29755,0,32,14,2437,0,1446,2624,-1,0,1,0,0
EUW1_6883457366',6,34,13,1,0,0,0,7,1,362,85,27806,30635,34313,1,26,5,0,0,1,0,2,389,78,23783,30424,24188,1,-27,7,4023,8,211,10125,1,0,-1,0,5
EUW1_6883416002',3,24,14,1,0,3,0,17,0,341,68,28909,30038,33345,4,78,11,1,0,3,0,4,328,84,28261,29174,34937,0,13,-16,648,3,864,-1592,0,0,0,0,13
EUW1_6883159860',3,24,9,1,0,0,0,7,0,338,102,25998,29097,38032,5,24,18,1,0,0,0,0,329,94,27895,31136,35822,1,9,8,-1897,-9,-2039,2210,0,0,0,0,7
EUW1_6883101167',7,26,25,2,0,3,0,7,1,380,109,35252,33668,45448,4,24,11,0,0,0,0,10,311,74,25300,27098,30103,1,69,35,9952,14,6570,15345,2,0,3,0,-3
EUW1_6882829694',3,30,11,0,1,0,0,5,0,405,104,27482,30945,26395,6,28,8,1,0,0,0,5,409,84,26173,30328,21308,1,-4,20,1309,3,617,5087,-1,1,0,0,0
EUW1_6882507048',2,46,10,0,0,0,0,10,0,373,69,25068,28316,28085,6,29,16,1,0,1,0,2,364,107,29902,30560,39126,0,9,-38,-4834,-6,-2244,-11041,-1,0,-1,0,8
EUW1_6883393185',3,37,9,0,0,0,0,13,0,325,88,25549,27663,21510,7,33,16,1,1,2,0,2,345,88,29584,29950,29745,0,-20,0,-4035,-7,-2287,-8235,-1,-1,-2,0,11
EUW1_6883282728',7,60,20,2,1,2,0,6,1,369,104,33105,33001,33030,4,62,10,0,0,0,0,10,340,96,25745,29008,27118,1,29,8,7360,10,3993,5912,2,1,2,0,-4
EUW1_6883211397',2,21,19,1,0,1,0,8,1,358,92,29671,30456,33644,1,28,10,0,0,0,0,2,366,87,26204,28887,29513,1,-8,5,3467,9,1569,4131,1,0,1,0,6
EUW1_6883012107',3,69,9,1,0,1,0,8,0,382,119,27713,31288,31464,4,24,11,1,0,0,0,2,404,84,27083,31175,36167,1,-22,35,630,-2,113,-4703,0,0,1,0,6
EUW1_6882935345',6,35,11,0,0,0,0,8,1,383,103,27678,30525,30114,1,26,16,2,1,1,0,4,373,91,29464,31078,32735,0,10,12,-1786,-5,-553,-2621,-2,-1,-1,0,4
EUW1_6882770683',3,26,9,0,0,0,0,10,1,308,96,25766,27166,35365,6,77,15,1,0,1,0,1,368,83,29695,30796,39555,0,-60,13,-3929,-6,-3630,-4190,-1,0,-1,0,9
EUW1_6882736825',2,23,10,1,0,1,0,7,1,334,89,26317,28210,36245,4,218,16,1,0,2,0,4,378,88,29766,31917,41091,0,-44,1,-3449,-6,-3707,-4846,0,0,-1,0,3
EUW1_6882695945',4,26,14,1,1,2,0,12,1,330,106,28998,29388,32795,4,24,17,0,0,1,0,6,361,70,29946,29441,40590,1,-31,36,-948,-3,-53,-7795,1,1,1,0,6
EUW1_6882552391',3,36,18,1,0,1,0,8,1,373,122,32256,31381,38720,7,31,10,1,0,1,0,4,365,71,25184,27231,25368,1,8,51,7072,8,4150,13352,0,0,0,0,4
EUW1_6882501372',5,28,12,0,1,1,0,6,1,368,119,28535,31225,32277,2,25,12,1,0,1,0,7,330,84,26356,28894,26950,1,38,35,2179,0,2331,5327,-1,1,0,0,-1
EUW1_6882242300',4,49,9,1,0,0,0,14,0,302,95,24153,26092,25601,3,30,14,1,1,3,0,0,361,94,29933,29431,31068,0,-59,1,-5780,-5,-3339,-5467,0,-1,-3,0,14
EUW1_6882224445',7,31,12,1,1,0,0,4,1,375,88,27571,29696,30444,1,21,11,1,0,0,0,6,319,114,26083,29343,22638,1,56,-26,1488,1,353,7806,0,1,0,0,-2
EUW1_6882184726',1,28,13,1,0,3,0,9,0,350,108,29636,31523,28535,3,27,16,1,0,1,0,10,371,84,28423,28897,29368,0,-21,24,1213,-3,2626,-833,0,0,2,0,-1
EUW1_6880032764',5,24,10,0,1,0,0,8,0,343,112,26545,29709,28071,2,30,12,2,0,1,0,2,355,93,28517,28646,25225,1,-12,19,-1972,-2,1063,2846,-2,1,-1,0,6
EUW1_6879647790',8,32,12,1,0,1,0,8,0,368,73,26421,29814,27238,9,33,12,1,0,1,0,3,383,106,27834,31829,30737,0,-15,-33,-1413,0,-2015,-3499,0,0,0,0,5
EUW1_6879585210',3,27,14,1,0,3,0,8,1,372,79,32086,29993,37315,5,28,17,0,0,1,0,8,293,89,27401,27906,39634,1,79,-10,4685,-3,2087,-2319,1,0,2,0,0
EUW1_6879547727',2,26,13,2,0,0,0,13,1,314,80,26849,28603,27862,6,83,12,0,0,2,0,4,379,94,28288,30686,34679,0,-65,-14,-1439,1,-2083,-6817,2,0,-2,0,9
EUW1_6878919275',5,28,16,0,0,0,0,8,0,369,79,28913,29325,28852,6,32,16,1,1,2,0,0,372,93,31098,29856,31614,0,-3,-14,-2185,0,-531,-2762,-1,-1,-2,0,8
EUW1_6875768041',2,23,20,2,0,1,0,10,0,408,107,31357,34628,39795,0,203,10,0,0,2,0,6,354,108,27727,29428,36884,1,54,-1,3630,10,5200,2911,2,0,-1,0,4
EUW1_6874620017',2,32,21,0,0,1,0,7,0,324,100,31999,29724,45170,7,39,18,1,0,1,0,5,282,88,28364,28091,38964,1,42,12,3635,3,1633,6206,-1,0,0,0,2
EUW1_6874559961',4,33,10,1,0,0,0,7,1,407,83,27073,30670,29648,8,33,10,0,0,0,0,1,365,95,26979,29769,25344,1,42,-12,94,0,901,4304,1,0,0,0,6
EUW1_6873631252',4,23,18,2,0,1,0,11,1,381,76,29944,32853,36078,4,138,6,0,0,1,0,4,306,88,23195,27441,32599,1,75,-12,6749,12,5412,3479,2,0,0,0,7
EUW1_6873605593',2,118,17,2,0,2,0,8,1,303,92,29151,28549,31018,2,39,10,0,0,1,0,5,388,92,28300,29753,29064,0,-85,0,851,7,-1204,1954,2,0,1,0,3
EUW1_6873556746',4,29,10,0,0,0,0,10,1,363,75,25747,28275,30980,1,72,14,2,0,2,0,1,395,108,30609,32209,36859,0,-32,-33,-4862,-4,-3934,-5879,-2,0,-2,0,9
EUW1_6873356247',6,28,17,2,0,1,0,6,0,343,88,31087,29897,40308,4,25,10,0,0,0,0,6,288,84,24864,26690,31344,1,55,4,6223,7,3207,8964,2,0,1,0,0
EUW1_6873146471',3,29,14,0,0,1,0,4,0,365,82,28048,29715,31609,11,32,15,1,0,0,0,6,339,95,28174,28449,39129,0,26,-13,-126,-1,1266,-7520,-1,0,1,0,-2
EUW1_6865959561',4,24,16,1,0,2,0,10,0,379,100,31368,31920,37660,1,22,10,0,0,2,0,6,343,78,26379,28609,31800,1,36,22,4989,6,3311,5860,1,0,0,0,4
EUW1_6863388259',6,34,19,1,0,2,0,9,1,376,95,32359,32055,40087,1,27,12,0,0,0,0,7,328,84,26473,29282,32676,1,48,11,5886,7,2773,7411,1,0,2,0,2
EUW1_6863363855',6,29,11,2,0,0,0,10,1,276,84,24776,26853,36045,6,28,19,0,0,1,0,1,310,79,29872,28567,43763,1,-34,5,-5096,-8,-1714,-7718,2,0,-1,0,9
EUW1_6863353725',5,40,5,0,0,0,0,8,0,327,82,22830,27035,23051,3,27,17,2,1,3,0,1,343,119,31398,32636,30781,0,-16,-37,-8568,-12,-5601,-7730,-2,-1,-3,0,7
EUW1_6863330898',3,27,13,0,0,0,0,12,0,306,82,27357,28544,27576,5,32,19,2,0,2,0,3,346,90,29780,29607,36775,0,-40,-8,-2423,-6,-1063,-9199,-2,0,-2,0,9
EUW1_6862898871',7,29,5,1,0,0,0,7,1,382,83,24492,28729,16562,5,26,12,1,0,2,0,3,426,113,30924,33559,28396,0,-44,-30,-6432,-7,-4830,-11834,0,0,-2,0,4
EUW1_6862822107',5,57,15,1,1,1,0,8,1,394,90,30189,31239,33353,1,91,6,1,0,2,0,6,301,89,24562,27602,27296,1,93,1,5627,9,3637,6057,0,1,-1,0,2
EUW1_6862751604',2,31,14,1,0,2,0,8,0,367,61,29246,30525,38919,3,47,9,0,0,0,0,6,336,86,25005,27383,28579,0,31,-25,4241,5,3142,10340,1,0,2,0,2
EUW1_6862482512',2,20,7,0,0,0,0,14,1,336,104,25226,29231,21658,7,28,18,1,1,3,0,4,409,83,31520,32194,32646,0,-73,21,-6294,-11,-2963,-10988,-1,-1,-3,0,10
EUW1_6862442875',1,42,17,1,1,2,0,9,0,330,108,30567,31383,29841,0,22,12,1,0,0,0,9,373,79,26898,27490,31276,1,-43,29,3669,5,3893,-1435,0,1,2,0,0
EUW1_6862348619',5,33,18,1,0,1,0,9,1,353,90,29638,30196,36611,2,22,14,0,0,1,0,4,350,97,28414,29289,30157,0,3,-7,1224,4,907,6454,1,0,0,0,5
EUW1_6883157884',4,27,17,2,0,2,0,8,0,339,84,30577,29014,34692,7,24,19,0,0,1,0,9,350,74,31446,29295,36707,1,-11,10,-869,-2,-281,-2015,2,0,1,0,-1
EUW1_6883772212',4,153,8,0,0,0,0,9,0,366,94,25306,29545,32040,7,39,18,2,0,1,0,0,375,102,29379,31319,28568,0,-9,-8,-4073,-10,-1774,3472,-2,0,-1,0,9
EUW1_6883727583',0,22,19,1,1,4,0,7,1,409,122,34962,32784,34336,2,31,7,1,0,0,0,8,354,74,23976,25752,24174,0,55,48,10986,12,7032,10162,0,1,4,0,-1
EUW1_6883716541',7,32,18,1,1,1,0,6,1,379,103,30400,33447,30904,3,21,3,1,0,0,0,4,379,82,22843,28742,20820,1,0,21,7557,15,4705,10084,0,1,1,0,2
EUW1_6883479663',5,31,19,2,1,0,0,6,0,351,92,29733,29410,35910,3,25,13,0,0,0,0,4,333,106,27126,29084,37192,1,18,-14,2607,6,326,-1282,2,1,0,0,2
EUW1_6883441848',1,33,21,1,1,3,0,11,1,362,116,32937,32879,41612,4,24,12,1,0,0,0,9,336,76,26107,29274,29892,1,26,40,6830,9,3605,11720,0,1,3,0,2
EUW1_6883289510',3,30,24,1,0,1,0,10,0,393,112,33735,32751,42348,7,39,17,0,0,1,0,8,366,79,30284,30239,34848,1,27,33,3451,7,2512,7500,1,0,0,0,2
EUW1_6883229801',3,22,8,0,1,0,0,8,0,342,86,25010,27743,35021,6,31,13,2,0,1,0,3,354,97,30111,31668,31464,0,-12,-11,-5101,-5,-3925,3557,-2,1,-1,0,5
EUW1_6883166836',2,26,13,1,1,2,0,8,1,412,114,29940,32700,33209,6,32,8,1,0,0,0,5,334,101,24963,29035,25797,1,78,13,4977,5,3665,7412,0,1,2,0,3
EUW1_6882567273',4,42,12,1,0,0,0,6,0,378,108,28261,29948,29800,4,138,16,1,0,1,0,4,335,108,28687,30285,32669,0,43,0,-426,-4,-337,-2869,0,0,-1,0,2
EUW1_6879202464',5,25,16,0,0,0,0,9,0,344,66,28374,29131,35403,6,32,15,0,0,0,0,3,323,82,28017,29017,36491,0,21,-16,357,1,114,-1088,0,0,0,0,6
EUW1_6879086379',2,26,19,2,0,3,0,7,1,384,99,33160,32124,31660,2,120,7,0,0,0,0,10,343,87,24501,27722,24213,1,41,12,8659,12,4402,7447,2,0,3,0,-3
EUW1_6878533340',2,19,7,0,0,0,0,13,0,341,76,25097,26682,26781,2,64,23,2,1,1,0,3,344,108,32016,31218,36612,0,-3,-32,-6919,-16,-4536,-9831,-2,-1,-1,0,10
EUW1_6877552073',3,25,16,0,0,1,0,12,0,366,88,30348,30279,37310,3,97,14,2,1,2,0,8,359,98,28960,30363,29953,0,7,-10,1388,2,-84,7357,-2,-1,-1,0,4
EUW1_6877485187',4,25,7,1,0,0,0,3,1,389,111,25365,30236,24551,2,204,9,1,0,0,0,2,392,96,26014,30416,26586,0,-3,15,-649,-2,-180,-2035,0,0,0,0,1
EUW1_6877425504',3,25,12,1,0,0,0,12,0,344,70,26964,28348,36085,6,41,14,0,0,0,0,2,375,85,28689,28618,29514,0,-31,-15,-1725,-2,-270,6571,1,0,0,0,10
EUW1_6877366048',2,16,11,0,0,0,0,16,0,335,84,26788,28564,25368,5,32,19,2,1,4,0,1,349,115,33995,32164,41705,0,-14,-31,-7207,-8,-3600,-16337,-2,-1,-4,0,15
EUW1_6883293703',3,24,4,0,0,1,0,11,0,395,81,25231,29572,24408,8,31,12,2,0,2,0,4,400,80,27947,30438,29266,0,-5,1,-2716,-8,-866,-4858,-2,0,-1,0,7
EUW1_6883224384',7,42,14,1,0,2,0,14,0,350,80,28260,28768,30165,2,52,13,0,0,3,0,6,333,92,29084,29027,31543,1,17,-12,-824,1,-259,-1378,1,0,-1,0,8
EUW1_6883143259',6,28,17,2,0,2,0,6,1,397,74,31646,29903,35688,2,25,8,0,0,2,0,8,364,77,25871,28012,38432,1,33,-3,5775,9,1891,-2744,2,0,0,0,-2
EUW1_6882844782',2,61,16,0,0,0,0,11,0,335,84,28466,27069,37309,5,34,16,2,0,1,0,3,351,73,29097,28475,35968,0,-16,11,-631,0,-1406,1341,-2,0,-1,0,8
EUW1_6882781451',3,25,11,2,1,3,0,5,1,420,102,30072,31113,28974,2,28,3,0,0,0,0,12,335,86,21927,27040,17813,1,85,16,8145,8,4073,11161,2,1,3,0,-7
EUW1_6882736892',2,29,8,0,1,1,0,9,1,305,92,25087,27563,29304,3,38,11,2,0,1,0,6,381,84,27683,29664,31311,0,-76,8,-2596,-3,-2101,-2007,-2,1,0,0,3
EUW1_6882668434',2,36,8,0,1,0,0,8,0,387,93,25171,31006,23052,8,42,8,2,0,0,0,3,366,94,25048,30681,27480,0,21,-1,123,0,325,-4428,-2,1,0,0,5
EUW1_6881742852',3,33,11,0,0,0,0,9,0,334,71,25094,31186,32905,5,28,10,1,0,0,0,0,389,73,26619,31008,40217,1,-55,-2,-1525,1,178,-7312,-1,0,0,0,9
EUW1_6881654078',5,28,11,1,1,0,0,11,1,397,104,28002,31126,27191,7,32,5,1,0,1,0,6,393,100,25788,29821,22571,1,4,4,2214,6,1305,4620,0,1,-1,0,5
EUW1_6881348218',2,27,9,2,0,0,0,10,1,294,98,24384,26350,31399,3,23,12,0,1,1,0,2,351,68,27050,28438,28515,1,-57,30,-2666,-3,-2088,2884,2,-1,-1,0,8
EUW1_6881295690',1,20,14,0,0,1,0,13,0,333,77,28313,29368,38060,3,31,21,2,0,2,0,7,375,91,32388,31902,50237,0,-42,-14,-4075,-7,-2534,-12177,-2,0,-1,0,6
EUW1_6881169187',3,24,12,2,0,0,0,12,0,300,95,26474,28354,31765,6,27,11,0,0,2,0,1,346,91,27560,29198,30185,0,-46,4,-1086,1,-844,1580,2,0,-2,0,11
EUW1_6880525537',6,34,15,0,1,0,0,17,0,377,86,30418,30676,34344,7,49,26,1,0,2,0,1,316,69,32940,28493,40388,1,61,17,-2522,-11,2183,-6044,-1,1,-2,0,16
EUW1_6880459391',4,23,10,0,0,0,0,11,0,315,64,24595,26689,26177,4,69,15,2,0,3,0,1,360,95,29947,31505,34186,1,-45,-31,-5352,-5,-4816,-8009,-2,0,-3,0,10
EUW1_6880219547',5,22,12,1,0,1,0,6,0,407,85,28801,32097,29839,8,35,12,1,0,1,0,5,385,96,28211,30898,26117,1,22,-11,590,0,1199,3722,0,0,0,0,1
EUW1_6883357936',7,34,5,1,0,0,0,7,0,359,72,22841,27659,26638,5,31,17,1,1,1,0,0,383,112,29437,33343,35771,0,-24,-40,-6596,-12,-5684,-9133,0,-1,-1,0,7
EUW1_6883302727',3,26,13,0,0,0,0,9,0,318,111,26667,28636,28155,1,28,17,2,1,1,0,5,316,116,30672,30611,36028,0,2,-5,-4005,-4,-1975,-7873,-2,-1,-1,0,4
EUW1_6883236863',3,23,12,1,0,1,0,11,0,357,80,26698,28943,31203,6,95,16,0,0,1,0,2,355,98,29571,31435,33924,0,2,-18,-2873,-4,-2492,-2721,1,0,0,0,9
EUW1_6881555446',2,25,16,0,0,0,0,11,1,365,88,29662,31127,40638,9,106,17,1,0,1,0,1,313,74,29151,28163,36053,1,52,14,511,-1,2964,4585,-1,0,-1,0,10
EUW1_6881435671',1,24,13,1,0,1,0,10,0,312,91,26922,29331,35255,2,24,20,1,0,2,0,4,318,100,29496,31493,44941,0,-6,-9,-2574,-7,-2162,-9686,0,0,-1,0,6
EUW1_6881363048',3,136,2,0,1,0,0,5,1,375,88,22669,28794,18875,5,132,6,2,0,0,0,1,432,92,25348,30937,24480,0,-57,-4,-2679,-4,-2143,-5605,-2,1,0,0,4
EUW1_6879849037',1,25,10,1,0,0,0,10,0,322,92,26411,29087,29819,3,25,17,1,0,1,0,3,376,98,30500,30855,38882,0,-54,-6,-4089,-7,-1768,-9063,0,0,-1,0,7
EUW1_6879778842',4,25,15,0,0,1,0,6,0,323,72,27943,29401,29860,11,36,13,1,0,1,0,3,381,84,28148,30831,25508,0,-58,-12,-205,2,-1430,4352,-1,0,0,0,3
EUW1_6879724158',6,49,7,1,0,0,0,9,0,338,116,24830,30377,29535,3,24,11,1,0,1,0,0,414,108,28224,31902,28808,1,-76,8,-3394,-4,-1525,727,0,0,-1,0,9
EUW1_6879677457',4,27,9,1,0,1,0,9,0,340,120,26347,30372,24042,2,245,9,0,1,2,0,5,363,104,27381,30350,36243,1,-23,16,-1034,0,22,-12201,1,-1,-1,0,4
EUW1_6879635529',0,25,7,0,0,0,0,18,0,314,87,24291,27079,26719,7,35,13,2,0,2,0,1,332,99,29782,28609,30697,0,-18,-12,-5491,-6,-1530,-3978,-2,0,-2,0,17
EUW1_6879611490',4,27,16,1,0,2,0,1,1,381,79,30360,31810,31615,7,32,5,0,0,0,0,9,358,92,23224,27423,25857,1,23,-13,7136,11,4387,5758,1,0,2,0,-8
EUW1_6879555280',2,25,11,1,0,0,0,9,0,378,86,27084,30130,34056,4,137,17,1,0,0,0,3,375,74,27512,31781,41293,0,3,12,-428,-6,-1651,-7237,0,0,0,0,6
EUW1_6866440363',2,25,9,2,0,0,0,8,0,331,72,24347,27779,29790,4,31,13,0,0,1,0,1,350,92,27330,29488,38730,0,-19,-20,-2983,-4,-1709,-8940,2,0,-1,0,7
EUW1_6866403454',1,25,8,0,0,0,0,8,0,345,81,24672,28966,29245,4,28,13,2,0,0,0,2,353,102,27436,30646,31300,0,-8,-21,-2764,-5,-1680,-2055,-2,0,0,0,6
EUW1_6866376095',4,26,7,2,0,0,0,4,1,385,98,25431,31572,30283,2,68,4,0,0,0,0,0,365,114,22589,30007,23871,1,20,-16,2842,3,1565,6412,2,0,0,0,4
EUW1_6866348857',4,25,13,0,1,0,0,8,0,314,97,27334,30203,36317,3,35,13,2,0,0,0,2,379,86,28452,30238,31567,0,-65,11,-1118,0,-35,4750,-2,1,0,0,6
EUW1_6866326037',4,29,27,1,0,2,0,4,1,375,106,35531,33730,42043,2,27,9,0,0,1,0,9,320,76,24340,26078,30400,1,55,30,11191,18,7652,11643,1,0,1,0,-5
EUW1_6865894015',2,32,10,0,0,0,0,4,1,351,76,25675,29540,25789,4,138,5,1,0,0,0,3,336,100,22946,27780,22600,1,15,-24,2729,5,1760,3189,-1,0,0,0,1
EUW1_6865862759',5,31,22,2,0,3,0,3,0,359,110,33487,31515,40654,4,89,8,0,0,0,0,8,299,68,22673,24485,26929,1,60,42,10814,14,7030,13725,2,0,3,0,-5
EUW1_6865780703',4,78,13,0,0,0,0,5,1,409,80,27842,31703,32536,4,27,7,1,1,0,0,0,387,92,25482,29084,31010,1,22,-12,2360,6,2619,1526,-1,-1,0,0,5
EUW1_6865704872',5,29,16,2,0,1,0,10,1,329,68,29181,26965,35962,5,53,16,0,0,2,0,2,296,75,28323,27155,30306,0,33,-7,858,0,-190,5656,2,0,-1,0,8
EUW1_6883653307',2,32,10,0,0,0,0,8,1,379,70,26002,28246,27247,5,61,20,2,0,1,0,5,373,103,31034,32589,38146,0,6,-33,-5032,-10,-4343,-10899,-2,0,-1,0,3
EUW1_6883643865',6,35,9,0,0,0,0,9,0,359,68,26913,28301,31660,3,36,11,1,0,1,0,2,350,101,26434,29237,29793,0,9,-33,479,-2,-936,1867,-1,0,-1,0,7
EUW1_6883624739',6,32,16,2,0,1,0,6,1,397,94,31442,31371,37560,2,31,12,0,0,1,0,6,351,109,27453,30423,31948,1,46,-15,3989,4,948,5612,2,0,0,0,0
EUW1_6883587422',6,58,12,1,0,1,0,13,1,381,74,27865,28532,31929,4,43,16,0,1,1,0,3,406,97,30731,30798,37818,1,-25,-23,-2866,-4,-2266,-5889,1,-1,0,0,10
EUW1_6883568682',5,33,15,1,0,0,0,11,0,364,105,29518,30177,49396,2,37,12,1,0,2,0,6,348,101,28680,30246,38809,1,16,4,838,3,-69,10587,0,0,-2,0,5
EUW1_6882528256',2,26,12,2,0,2,0,6,1,344,104,28740,29468,32339,8,38,10,0,0,0,0,10,358,102,26360,31557,33936,1,-14,2,2380,2,-2089,-1597,2,0,2,0,-4
EUW1_6882514643',1,32,8,0,0,0,0,12,0,350,88,25104,27481,34448,5,39,13,2,0,2,0,3,388,92,29677,30270,32529,0,-38,-4,-4573,-5,-2789,1919,-2,0,-2,0,9
EUW1_6882485576',3,29,14,0,0,0,0,9,0,374,84,28765,31180,43060,0,45,15,0,0,1,0,2,349,73,28331,28226,44847,0,25,11,434,-1,2954,-1787,0,0,-1,0,7
EUW1_6882459863',1,59,7,0,0,1,0,6,0,336,112,26130,27527,22090,6,53,14,2,0,0,0,1,384,90,27494,30516,26283,0,-48,22,-1364,-7,-2989,-4193,-2,0,1,0,5
EUW1_6882438812',6,38,22,1,1,3,0,12,1,390,104,35302,31740,38745,5,36,9,0,0,1,0,7,349,72,26022,27204,27073,1,41,32,9280,13,4536,11672,1,1,2,0,5
EUW1_6882359790',3,33,14,0,1,0,0,11,1,333,104,28830,29399,30834,9,35,13,2,0,2,0,6,335,68,28351,28123,34062,1,-2,36,479,1,1276,-3228,-2,1,-2,0,5
EUW1_6882331171',1,65,6,1,0,1,0,12,0,351,77,25193,27187,27704,4,40,19,0,0,2,0,4,359,74,30853,30784,37096,0,-8,3,-5660,-13,-3597,-9392,1,0,-1,0,8
EUW1_6882313838',7,27,22,1,0,1,0,9,1,306,74,29495,27876,43884,4,28,20,0,0,0,0,2,333,110,30996,31476,39018,1,-27,-36,-1501,2,-3600,4866,1,0,1,0,7
EUW1_6880873446',4,28,21,1,0,3,0,5,1,413,92,34053,33447,46019,4,30,8,1,0,0,0,12,377,73,26263,27546,35531,1,36,19,7790,13,5901,10488,0,0,3,0,-7
EUW1_6880834181',2,26,17,1,1,0,0,11,0,340,84,28342,28041,43764,2,24,13,1,0,1,0,3,318,96,27878,27566,28758,0,22,-12,464,4,475,15006,0,1,-1,0,8
EUW1_6880826849',4,25,16,1,1,1,0,8,0,334,116,29880,32478,39816,1,36,14,1,0,0,0,4,341,80,26082,28248,32690,1,-7,36,3798,2,4230,7126,0,1,1,0,4
EUW1_6880815868',5,28,15,2,0,0,0,8,0,375,74,27460,30114,34158,6,36,12,0,0,0,0,2,341,96,27566,29684,22823,1,34,-22,-106,3,430,11335,2,0,0,0,6
EUW1_6880781153',0,21,2,0,0,1,0,18,0,338,78,22883,27327,26929,2,90,16,1,0,4,0,2,376,105,32061,33320,38319,0,-38,-27,-9178,-14,-5993,-11390,-1,0,-3,0,16
EUW1_6883296157',4,27,23,0,1,3,0,12,0,308,94,34948,30885,43072,5,34,21,2,0,1,0,9,318,81,29796,27265,30751,1,-10,13,5152,2,3620,12321,-2,1,2,0,3
EUW1_6883228239',0,21,12,1,0,0,0,12,0,329,78,25990,26147,30199,7,35,16,0,0,2,0,2,376,84,30128,30484,35868,0,-47,-6,-4138,-4,-4337,-5669,1,0,-2,0,10
EUW1_6883158208',7,31,11,0,0,0,0,9,0,349,100,25470,29591,32953,2,25,13,2,0,1,0,2,331,74,26615,28738,29842,0,18,26,-1145,-2,853,3111,-2,0,-1,0,7
EUW1_6883103104',3,28,7,1,0,1,0,9,0,353,88,26271,29786,27520,3,20,12,1,0,0,0,0,385,87,26927,30964,32626,0,-32,1,-656,-5,-1178,-5106,0,0,1,0,9
EUW1_6883051164',4,38,5,0,0,0,0,3,1,376,100,24337,28969,25054,4,185,6,2,0,0,0,0,380,108,24618,29847,24925,0,-4,-8,-281,-1,-878,129,-2,0,0,0,3
EUW1_6882985541',3,26,11,2,0,0,0,5,0,287,78,26071,27079,35927,3,19,15,0,0,0,0,4,309,82,27140,28420,37932,1,-22,-4,-1069,-4,-1341,-2005,2,0,0,0,1
EUW1_6882931490',3,24,10,1,0,0,0,3,0,340,89,26565,27976,30615,5,25,18,0,0,0,0,4,343,70,28359,30191,30170,0,-3,19,-1794,-8,-2215,445,1,0,0,0,-1
EUW1_6882884044',5,30,16,0,0,3,0,8,1,411,88,33399,31260,33562,3,20,9,2,0,1,0,9,331,73,25220,28337,29509,1,80,15,8179,7,2923,4053,-2,0,2,0,-1
EUW1_6882831115',5,32,12,1,0,0,0,6,0,359,88,26970,30291,31683,6,32,11,0,0,0,0,3,372,60,24483,30169,36404,0,-13,28,2487,1,122,-4721,1,0,0,0,3
EUW1_6882784829',10,33,11,0,0,2,0,8,1,373,83,28157,30258,30890,4,32,13,2,0,1,0,6,359,100,27993,30002,30009,0,14,-17,164,-2,256,881,-2,0,1,0,2
EUW1_6882224943',4,35,6,0,1,2,0,4,0,393,103,27276,29147,22979,5,31,10,2,0,0,0,6,326,88,24783,27769,24417,1,67,15,2493,-4,1378,-1438,-2,1,2,0,-2
EUW1_6882191341',2,24,18,1,0,0,0,10,0,323,57,29000,28742,35982,9,37,17,1,0,1,0,4,350,68,30721,28591,40435,1,-27,-11,-1721,1,151,-4453,0,0,-1,0,6
EUW1_6882161134',1,25,18,0,0,1,0,10,1,327,88,30069,29445,42518,6,28,21,1,0,1,0,6,346,76,32252,32020,40247,0,-19,12,-2183,-3,-2575,2271,-1,0,0,0,4
EUW1_6882129372',2,30,6,1,0,0,0,14,0,293,80,22679,26623,20163,3,31,14,1,1,4,0,0,423,111,31891,34051,35926,0,-130,-31,-9212,-8,-7428,-15763,0,-1,-4,0,14
EUW1_6882067600',6,56,8,0,0,1,0,8,1,399,67,27010,28942,20890,3,23,8,2,0,0,0,5,363,124,25935,30132,28212,1,36,-57,1075,0,-1190,-7322,-2,0,1,0,3
EUW1_6882007759',6,86,14,2,0,1,0,11,1,375,72,31098,30425,39459,2,20,15,0,0,2,0,6,355,92,29857,30915,34058,1,20,-20,1241,-1,-490,5401,2,0,-1,0,5
EUW1_6881937999',5,25,10,0,1,1,0,8,1,315,108,26772,28915,28175,5,29,8,1,0,2,0,6,372,75,26657,29608,24400,1,-57,33,115,2,-693,3775,-1,1,-1,0,2
EUW1_6881865734',1,28,6,0,0,1,0,12,0,357,90,25018,29274,23961,5,29,13,1,0,2,0,3,401,88,29044,31532,34240,0,-44,2,-4026,-7,-2258,-10279,-1,0,-1,0,9
EUW1_6881680616',3,28,7,0,0,1,0,11,0,350,69,26044,26496,22760,5,141,10,2,1,1,0,8,382,90,28083,30531,29783,0,-32,-21,-2039,-3,-4035,-7023,-2,-1,0,0,3
EUW1_6882185507',5,33,11,1,0,0,0,15,0,349,77,25898,28611,30102,5,36,16,1,1,3,0,0,383,86,32348,31321,36605,0,-34,-9,-6450,-5,-2710,-6503,0,-1,-3,0,15
EUW1_6881584814',2,26,12,0,0,0,0,13,1,345,83,27389,29255,30280,4,29,11,1,1,1,0,1,387,92,28309,28439,30248,0,-42,-9,-920,1,816,32,-1,-1,-1,0,12
EUW1_6881536565',5,28,14,0,0,1,0,16,1,368,84,29947,28477,40983,2,43,20,1,0,2,0,5,354,100,33302,31251,44391,0,14,-16,-3355,-6,-2774,-3408,-1,0,-1,0,11
EUW1_6879748117',1,23,12,1,0,3,0,8,0,365,98,29584,29537,28807,4,28,12,1,0,1,0,9,309,96,27537,26730,29880,0,56,2,2047,0,2807,-1073,0,0,2,0,-1
EUW1_6879630666',8,46,14,0,0,1,0,15,1,355,69,30107,28321,33609,4,103,18,2,0,3,0,4,301,85,29174,29852,43349,0,54,-16,933,-4,-1531,-9740,-2,0,-2,0,11
EUW1_6879195773',2,35,11,0,0,1,0,5,1,370,86,27112,29874,33460,6,31,12,1,0,0,0,3,367,61,26587,30920,31196,1,3,25,525,-1,-1046,2264,-1,0,1,0,2
EUW1_6879122578',5,50,11,0,0,0,0,15,0,346,72,25996,28051,25336,8,32,19,1,0,5,0,1,342,110,33893,30709,43421,0,4,-38,-7897,-8,-2658,-18085,-1,0,-5,0,14
EUW1_6878998353',6,35,7,0,1,0,0,8,0,360,129,26648,31235,25474,4,59,7,2,0,1,0,3,354,72,23280,29181,25634,1,6,57,3368,0,2054,-160,-2,1,-1,0,5
EUW1_6878927872',3,24,16,0,0,0,0,9,0,337,79,29020,28736,30864,5,28,12,1,0,1,0,1,342,68,27361,27778,30742,1,-5,11,1659,4,958,122,-1,0,-1,0,8
EUW1_6878859253',4,26,16,0,0,0,0,9,1,354,83,28960,30116,31518,4,96,14,2,0,1,0,4,365,87,28450,31200,34093,1,-11,-4,510,2,-1084,-2575,-2,0,-1,0,5
EUW1_6878782255',5,24,10,0,0,0,0,10,0,357,88,25723,28682,26910,4,35,13,1,0,1,0,4,359,80,28409,29832,40011,0,-2,8,-2686,-3,-1150,-13101,-1,0,-1,0,6
EUW1_6878755474',7,31,7,1,0,0,0,12,0,370,72,24026,27964,27249,5,27,15,0,1,3,0,1,371,110,31078,32592,35887,0,-1,-38,-7052,-8,-4628,-8638,1,-1,-3,0,11
EUW1_6878718738',2,22,21,0,0,0,0,6,1,334,70,31394,29286,46866,6,29,25,2,0,0,0,4,340,94,31575,31249,47905,0,-6,-24,-181,-4,-1963,-1039,-2,0,0,0,2
EUW1_6878673293',1,27,6,0,0,1,0,13,0,344,78,25978,26203,37979,5,29,25,1,1,3,0,6,355,107,34033,32320,43594,0,-11,-29,-8055,-19,-6117,-5615,-1,-1,-2,0,7
EUW1_6878643478',3,27,7,0,0,0,0,17,0,363,114,26307,27675,25966,0,23,20,1,0,3,0,3,358,74,31493,30547,37364,0,5,40,-5186,-13,-2872,-11398,-1,0,-3,0,14
EUW1_6880515113',2,31,7,1,0,0,0,16,1,351,79,24843,28620,21168,4,23,19,1,0,5,0,2,409,99,36034,31333,42313,0,-58,-20,-11191,-12,-2713,-21145,0,0,-5,0,14
EUW1_6864505266',4,30,13,1,1,1,0,7,1,368,79,30880,28257,32052,3,151,17,1,0,1,0,3,297,95,28640,27443,33946,0,71,-16,2240,-4,814,-1894,0,1,0,0,4
EUW1_6863977265',2,24,16,1,0,1,0,7,1,387,89,30465,32525,44458,1,21,5,0,0,0,0,4,284,81,21482,26271,27659,1,103,8,8983,11,6254,16799,1,0,1,0,3
EUW1_6863198757',3,30,9,2,1,1,0,13,1,314,58,25565,27534,29898,1,26,8,0,0,0,0,2,346,105,25357,29986,33832,1,-32,-47,208,1,-2452,-3934,2,1,1,0,11
EUW1_6863175013',5,29,12,0,0,0,0,7,1,329,77,27320,27361,28540,4,42,20,2,0,0,0,2,325,102,30655,30673,40485,0,4,-25,-3335,-8,-3312,-11945,-2,0,0,0,5
EUW1_6863158875',4,34,16,2,0,0,0,11,1,348,98,28777,31387,35240,3,24,15,0,0,1,0,1,359,121,30780,32352,33425,0,-11,-23,-2003,1,-965,1815,2,0,-1,0,10
EUW1_6863090443',3,35,7,0,0,1,0,13,0,346,68,25924,29263,27167,4,52,16,2,1,1,0,8,403,106,32201,31458,36309,0,-57,-38,-6277,-9,-2195,-9142,-2,-1,0,0,5
EUW1_6863039288',3,29,13,1,1,0,0,13,0,278,95,26897,29134,37920,4,53,17,1,0,2,0,2,359,91,30941,30991,40894,0,-81,4,-4044,-4,-1857,-2974,0,1,-2,0,11
EUW1_6862995469',0,54,12,1,0,1,0,9,1,348,86,26481,30324,32983,2,24,6,0,0,2,0,3,366,94,25895,29555,27854,0,-18,-8,586,6,769,5129,1,0,-1,0,6
EUW1_6862629461',4,34,6,1,0,0,0,8,0,339,88,24328,25965,26206,6,28,18,1,1,3,0,3,408,108,34273,35115,41165,0,-69,-20,-9945,-12,-9150,-14959,0,-1,-3,0,5
EUW1_6862568693',4,280,19,0,0,0,0,5,1,334,88,30399,30552,40865,3,29,14,2,0,0,0,4,344,84,28239,29027,41545,1,-10,4,2160,5,1525,-680,-2,0,0,0,1
EUW1_6862028793',5,32,19,1,0,1,0,17,0,316,82,32346,30240,46034,3,27,17,1,0,4,0,8,308,90,29585,27176,41355,1,8,-8,2761,2,3064,4679,0,0,-3,0,9
EUW1_6862016863',7,349,8,1,0,1,0,11,1,376,87,26498,30575,28045,3,22,14,1,0,1,0,5,357,70,28213,30814,41401,1,19,17,-1715,-6,-239,-13356,0,0,0,0,6
EUW1_6861999311',3,22,7,1,0,1,0,6,0,395,87,27350,28242,34782,8,34,13,1,0,0,0,4,325,82,26661,30251,34071,0,70,5,689,-6,-2009,711,0,0,1,0,2
EUW1_6861982391',1,33,12,1,0,0,0,12,0,347,95,28682,29771,29549,3,27,16,0,0,1,0,3,318,80,28843,28034,28598,0,29,15,-161,-4,1737,951,1,0,-1,0,9
EUW1_6880840199',6,33,5,1,0,0,0,8,0,347,78,23411,26883,17797,1,29,13,1,0,1,0,3,375,106,27887,30218,26161,0,-28,-28,-4476,-8,-3335,-8364,0,0,-1,0,5
EUW1_6880826284',1,24,19,2,0,1,0,13,1,305,94,32086,29201,39198,4,74,16,0,0,3,0,4,338,106,30047,30305,30572,0,-33,-12,2039,3,-1104,8626,2,0,-2,0,9
EUW1_6880823578',4,34,13,0,0,1,0,11,0,330,59,27728,27986,32345,1,25,19,2,0,2,0,7,314,108,29985,31027,44018,0,16,-49,-2257,-6,-3041,-11673,-2,0,-1,0,4
EUW1_6880800955',2,55,10,1,0,0,0,4,0,371,72,25564,29034,32469,5,36,10,1,0,1,0,3,342,61,25283,26537,30793,0,29,11,281,0,2497,1676,0,0,-1,0,1
EUW1_6880784087',2,28,20,0,1,3,0,10,1,346,102,32175,31235,36452,2,29,13,1,0,1,0,9,331,73,27905,28931,27526,0,15,29,4270,7,2304,8926,-1,1,2,0,1
EUW1_6880775772',2,27,4,1,0,0,0,10,0,360,102,23656,28030,23921,5,28,18,1,0,2,0,1,356,96,30297,31576,41143,0,4,6,-6641,-14,-3546,-17222,0,0,-2,0,9
EUW1_6880747715',4,25,11,1,0,1,0,8,0,377,116,27546,33046,28213,3,149,7,1,0,0,0,2,394,92,26191,29611,28693,1,-17,24,1355,4,3435,-480,0,0,1,0,6
EUW1_6880721584',1,27,12,1,0,0,0,16,0,332,77,27263,29413,34305,2,23,18,1,0,3,0,2,353,102,31244,31560,47719,0,-21,-25,-3981,-6,-2147,-13414,0,0,-3,0,14
EUW1_6880680985',3,34,12,0,1,1,0,9,0,329,95,26597,29789,28904,3,91,12,1,0,1,0,0,370,84,26947,29481,35617,1,-41,11,-350,0,308,-6713,-1,1,0,0,9
EUW1_6877916808',3,30,11,1,0,0,0,14,0,355,83,26295,28538,26733,6,23,20,0,0,2,0,2,371,88,31933,32003,42048,1,-16,-5,-5638,-9,-3465,-15315,1,0,-2,0,12
EUW1_6877901538',3,80,13,0,0,0,0,12,0,324,83,26995,30580,29306,4,30,8,2,0,1,0,3,353,97,26227,29209,30901,1,-29,-14,768,5,1371,-1595,-2,0,-1,0,9
EUW1_6877866172',8,32,20,2,0,2,0,10,0,375,96,32271,32887,39853,3,17,6,0,0,1,0,7,296,80,22755,27147,26689,1,79,16,9516,14,5740,13164,2,0,1,0,3
EUW1_6877841736',3,36,12,0,0,1,0,10,1,375,81,27648,31421,34724,0,338,6,0,0,1,0,4,357,66,24614,28970,29233,1,18,15,3034,6,2451,5491,0,0,0,0,6
EUW1_6877807428',1,35,16,0,0,1,0,5,1,387,114,30213,31504,30615,4,26,11,2,1,0,0,5,319,65,25335,25847,33571,1,68,49,4878,5,5657,-2956,-2,-1,1,0,0
EUW1_6877788944',4,45,17,0,0,1,0,5,0,401,92,31108,30716,35832,3,50,11,1,0,1,0,6,351,71,26166,28214,25683,1,50,21,4942,6,2502,10149,-1,0,0,0,-1
EUW1_6877746422',7,29,6,1,0,0,0,8,1,397,106,25783,29147,21641,3,33,9,0,0,1,0,3,388,90,27051,30994,32006,0,9,16,-1268,-3,-1847,-10365,1,0,-1,0,5
EUW1_6877718554',2,22,11,0,0,1,0,10,1,325,100,26511,29245,29231,4,34,7,2,0,1,0,6,355,80,25603,28420,25779,1,-30,20,908,4,825,3452,-2,0,0,0,4
EUW1_6876324258',5,190,13,0,0,2,0,5,0,378,92,30207,30275,36778,2,30,12,2,0,1,0,9,336,92,27503,29112,30558,1,42,0,2704,1,1163,6220,-2,0,1,0,-4
EUW1_6876294812',5,31,7,0,0,1,0,10,1,357,88,25865,28080,28557,8,34,16,2,0,1,0,4,334,104,28711,30465,34382,0,23,-16,-2846,-9,-2385,-5825,-2,0,0,0,6
EUW1_6876245966',4,33,10,1,1,0,0,5,1,378,92,26379,29878,36865,4,30,11,1,0,0,0,1,310,79,25029,28338,31176,0,68,13,1350,-1,1540,5689,0,1,0,0,4
EUW1_6882745080',5,29,7,0,0,0,0,11,1,384,89,26465,30124,21464,2,30,13,2,1,1,0,5,403,106,29099,31483,29133,0,-19,-17,-2634,-6,-1359,-7669,-2,-1,-1,0,6
EUW1_6882714796',7,33,10,0,1,1,0,5,1,391,82,28146,31158,31338,3,26,6,1,0,1,0,5,328,96,23191,28541,20613,1,63,-14,4955,4,2617,10725,-1,1,0,0,0
EUW1_6882084203',4,33,10,2,0,0,0,12,1,300,90,25255,28002,30517,0,19,12,0,0,1,0,2,358,81,28035,28590,24198,0,-58,9,-2780,-2,-588,6319,2,0,-1,0,10
EUW1_6882027260',6,35,11,0,0,0,0,9,1,312,95,25087,29290,28415,1,20,12,2,0,1,0,0,364,96,28096,31402,34636,1,-52,-1,-3009,-1,-2112,-6221,-2,0,-1,0,9
EUW1_6881972190',3,22,14,2,0,1,0,6,1,389,101,29676,31508,29459,3,30,6,0,0,1,0,6,345,86,24251,28045,20803,1,44,15,5425,8,3463,8656,2,0,0,0,0
EUW1_6881788004',2,26,17,0,0,1,0,10,0,366,95,30628,30203,36191,7,25,15,2,1,0,0,4,344,77,28105,28987,31947,0,22,18,2523,2,1216,4244,-2,-1,1,0,6
EUW1_6881117345',5,28,17,2,0,2,0,5,0,376,114,31549,31864,37204,2,31,8,0,0,0,0,9,316,82,23992,26148,25025,1,60,32,7557,9,5716,12179,2,0,2,0,-4
EUW1_6880488748',5,27,4,1,0,0,0,9,1,320,84,21934,26782,24734,2,23,11,0,0,1,0,1,386,88,27348,30942,36479,0,-66,-4,-5414,-7,-4160,-11745,1,0,-1,0,8
EUW1_6880389607',4,27,7,1,1,1,0,6,0,366,79,25736,28169,25729,2,42,8,1,0,0,0,4,359,116,25687,29853,22494,1,7,-37,49,-1,-1684,3235,0,1,1,0,2
EUW1_6880333187',4,26,3,0,0,0,0,9,0,313,84,21341,25139,18074,4,27,11,1,0,1,0,1,413,100,27653,30971,28722,0,-100,-16,-6312,-8,-5832,-10648,-1,0,-1,0,8
EUW1_6879385784',6,31,12,2,0,1,0,8,1,370,98,29238,29678,35271,4,28,13,0,0,1,0,5,299,90,25824,28918,32441,1,71,8,3414,-1,760,2830,2,0,0,0,3
EUW1_6879363190',1,249,9,1,0,1,0,6,1,398,102,28221,31423,25290,5,58,7,1,0,0,0,10,365,88,25270,27987,23496,1,33,14,2951,2,3436,1794,0,0,1,0,-4
EUW1_6879343933',7,34,21,2,0,1,0,7,0,318,79,31533,28649,35844,6,31,17,0,0,1,0,7,323,66,29125,28527,37568,1,-5,13,2408,4,122,-1724,2,0,0,0,0
EUW1_6877926526',4,65,25,0,0,1,0,5,1,328,63,32589,30101,41706,8,67,15,1,0,1,0,5,315,95,28118,28030,39875,1,13,-32,4471,10,2071,1831,-1,0,0,0,0
EUW1_6877904411',3,31,20,0,0,1,0,12,0,315,88,30479,29250,44558,2,80,20,0,0,1,0,5,350,68,30323,30702,40879,0,-35,20,156,0,-1452,3679,0,0,0,0,7
EUW1_6877798906',4,31,12,1,0,0,0,8,0,345,79,28197,26988,29775,1,25,20,1,0,2,0,6,368,90,32803,29318,38512,0,-23,-11,-4606,-8,-2330,-8737,0,0,-2,0,2
EUW1_6877763250',6,30,17,0,0,0,0,16,1,317,79,29186,28458,38378,2,25,20,1,0,2,0,4,293,92,32206,28054,45483,0,24,-13,-3020,-3,404,-7105,-1,0,-2,0,12
EUW1_6876445027',1,20,13,0,0,0,0,11,0,373,105,27868,29882,32593,5,24,15,2,0,1,0,3,298,82,27821,29048,33028,1,75,23,47,-2,834,-435,-2,0,-1,0,8
EUW1_6876433099',1,29,13,1,0,1,0,6,1,372,94,29461,31113,31747,3,24,13,1,0,1,0,8,310,73,24913,27560,35097,1,62,21,4548,0,3553,-3350,0,0,0,0,-2
EUW1_6876424240',3,24,5,1,0,0,0,17,0,296,100,22800,27878,19440,7,34,16,1,1,1,0,2,379,94,30297,29830,31425,0,-83,6,-7497,-11,-1952,-11985,0,-1,-1,0,15
EUW1_6876366546',5,44,12,1,0,1,0,11,0,358,58,27821,27705,31127,5,32,15,1,0,2,0,7,382,96,29255,32178,32199,0,-24,-38,-1434,-3,-4473,-1072,0,0,-1,0,4
EUW1_6876334340',3,76,14,2,0,2,0,6,0,339,89,29221,30065,32539,4,29,7,0,0,1,0,9,303,86,23190,26863,32196,1,36,3,6031,7,3202,343,2,0,1,0,-3
EUW1_6876300442',3,92,11,0,1,0,0,11,0,331,79,25515,29062,23405,4,27,11,2,0,3,0,0,401,130,29601,33237,32526,0,-70,-51,-4086,0,-4175,-9121,-2,1,-3,0,11
EUW1_6875705352',3,52,9,0,0,0,0,11,0,335,77,26876,26875,27425,4,25,26,2,0,2,0,2,329,118,33166,32261,41992,0,6,-41,-6290,-17,-5386,-14567,-2,0,-2,0,9
EUW1_6875637409',1,17,9,0,0,0,0,9,0,336,98,24825,29498,31879,3,30,17,2,1,1,0,1,373,86,30339,32442,29780,0,-37,12,-5514,-8,-2944,2099,-2,-1,-1,0,8
EUW1_6875069308',2,28,13,0,0,0,0,12,0,368,105,28624,31865,32707,1,21,8,1,0,2,0,4,307,74,25117,28649,31158,1,61,31,3507,5,3216,1549,-1,0,-2,0,8
EUW1_6872310262',3,23,17,1,0,0,0,11,0,317,87,28594,31975,34897,0,62,14,1,0,1,0,4,370,86,28615,30145,40203,0,-53,1,-21,3,1830,-5306,0,0,-1,0,7
EUW1_6879686047',4,41,13,2,0,0,0,9,1,368,85,26606,28567,31564,3,56,7,0,0,0,0,2,368,80,24508,28522,24317,1,0,5,2098,6,45,7247,2,0,0,0,7
EUW1_6879662699',1,17,17,0,0,1,0,8,1,383,96,31108,33601,32189,1,28,6,1,0,2,0,2,358,75,24779,27297,31287,1,25,21,6329,11,6304,902,-1,0,-1,0,6
EUW1_6879606314',2,24,16,0,1,1,0,7,1,347,104,30678,31070,40233,3,20,11,2,0,0,0,3,373,96,27048,29510,32894,1,-26,8,3630,5,1560,7339,-2,1,1,0,4
EUW1_6879149114',3,28,12,0,0,0,0,17,0,307,78,26682,25748,36488,5,27,26,2,0,3,0,3,350,97,35335,30756,36240,0,-43,-19,-8653,-14,-5008,248,-2,0,-3,0,14
EUW1_6879116544',3,15,18,0,0,1,0,13,1,363,60,31132,27819,49782,2,25,19,1,0,3,0,4,326,70,30573,28895,39867,0,37,-10,559,-1,-1076,9915,-1,0,-2,0,9
EUW1_6879024760',5,29,9,0,0,0,0,9,1,343,84,25448,27660,38294,3,32,17,1,0,2,0,6,378,72,29978,31088,46954,1,-35,12,-4530,-8,-3428,-8660,-1,0,-2,0,3
EUW1_6878953795',5,28,12,0,1,0,0,11,1,357,97,27243,30721,31918,3,24,11,1,0,1,0,3,410,93,28337,32421,30264,1,-53,4,-1094,1,-1700,1654,-1,1,-1,0,8
EUW1_6878908604',3,18,10,1,0,0,0,10,0,314,78,25765,28520,37164,3,30,21,1,0,0,0,3,342,63,29573,29717,37321,0,-28,15,-3808,-11,-1197,-157,0,0,0,0,7
EUW1_6878267214',3,25,12,0,0,0,0,11,0,397,109,30414,32382,32978,3,27,17,2,0,2,0,3,403,74,29419,30800,35133,1,-6,35,995,-5,1582,-2155,-2,0,-2,0,8
EUW1_6878227025',4,63,14,1,1,2,0,7,0,337,114,29502,31636,31561,1,59,8,0,0,0,0,5,335,81,24425,26511,22091,1,2,33,5077,6,5125,9470,1,1,2,0,2
EUW1_6878177090',3,19,7,1,0,1,0,9,0,366,93,25637,29719,23406,8,28,16,1,0,0,0,2,378,98,29133,30401,31113,0,-12,-5,-3496,-9,-682,-7707,0,0,1,0,7
EUW1_6871481420',3,28,13,0,0,1,0,4,1,440,111,31281,31726,25558,6,36,13,2,0,1,0,11,361,99,27454,30651,27491,1,79,12,3827,0,1075,-1933,-2,0,0,0,-7
EUW1_6871462684',0,22,5,0,0,0,0,18,0,271,74,23975,25369,29439,2,28,27,0,0,5,0,0,390,85,35545,32997,45070,0,-119,-11,-11570,-22,-7628,-15631,0,0,-5,0,18
EUW1_6867573442',3,25,12,2,0,1,0,18,1,282,81,26422,26226,34571,4,34,14,0,0,2,0,1,343,90,29959,27978,33981,0,-61,-9,-3537,-2,-1752,590,2,0,-1,0,17
EUW1_6867555596',3,21,19,1,0,1,0,14,0,358,87,32907,30456,43127,6,31,18,0,0,5,0,8,350,70,30356,28940,38206,1,8,17,2551,1,1516,4921,1,0,-4,0,6
EUW1_6867522870',6,27,11,1,0,0,0,8,1,415,90,27919,31004,35420,2,24,6,0,0,1,0,4,398,106,26870,31245,27405,1,17,-16,1049,5,-241,8015,1,0,-1,0,4
EUW1_6867485482',7,28,21,0,0,0,0,12,0,323,53,30785,28995,44043,4,28,18,1,0,1,0,4,344,94,31724,29371,35909,1,-21,-41,-939,3,-376,8134,-1,0,-1,0,8
EUW1_6867300435',3,24,11,0,0,0,0,12,1,367,102,27455,30328,33602,3,28,14,1,0,1,0,1,356,80,26867,30314,29646,0,11,22,588,-3,14,3956,-1,0,-1,0,11
EUW1_6867207557',1,22,7,0,0,1,0,9,0,406,106,27873,31355,35177,4,30,17,1,0,1,0,4,335,96,27706,30631,32744,1,71,10,167,-10,724,2433,-1,0,0,0,5
EUW1_6866957189',5,26,14,0,0,2,0,12,0,383,89,30400,32500,31198,0,38,13,1,1,1,0,5,383,88,29640,30801,26644,1,0,1,760,1,1699,4554,-1,-1,1,0,7
EUW1_6883769315',4,33,8,1,0,0,0,9,0,344,98,24926,28411,25330,8,35,13,1,0,1,0,1,363,80,27965,30969,33044,0,-19,18,-3039,-5,-2558,-7714,0,0,-1,0,8
EUW1_6882599797',4,25,9,0,0,0,0,9,0,356,112,26138,29493,27655,4,31,13,1,0,1,0,1,358,76,28257,29928,33588,0,-2,36,-2119,-4,-435,-5933,-1,0,-1,0,8
EUW1_6882570789',12,49,8,0,0,0,0,12,1,380,74,25223,29911,29862,4,31,6,2,0,1,0,1,398,106,26319,30590,29149,0,-18,-32,-1096,2,-679,713,-2,0,-1,0,11
EUW1_6879295693',1,26,15,0,0,2,0,4,1,317,84,30637,28700,32731,3,37,13,2,1,0,0,7,313,93,25780,28886,25414,1,4,-9,4857,2,-186,7317,-2,-1,2,0,-3
EUW1_6879279810',2,58,9,0,0,1,0,11,0,324,85,25412,28033,29154,4,53,19,1,1,2,0,4,355,102,30073,32193,35195,0,-31,-17,-4661,-10,-4160,-6041,-1,-1,-1,0,7
EUW1_6874761573',3,22,13,0,0,0,0,12,1,354,85,27640,29892,27762,4,27,12,2,0,2,0,2,362,97,29136,29535,28310,0,-8,-12,-1496,1,357,-548,-2,0,-2,0,10
EUW1_6874724637',3,25,22,2,0,5,0,9,1,398,129,36093,35913,41088,5,21,5,0,0,0,0,11,355,74,23276,27109,29591,1,43,55,12817,17,8804,11497,2,0,5,0,-2
EUW1_6874637489',3,30,19,1,0,1,0,15,1,333,66,31000,28770,40823,3,27,27,1,1,4,0,4,336,90,36227,31704,50609,0,-3,-24,-5227,-8,-2934,-9786,0,-1,-3,0,11
EUW1_6872703570',1,23,12,1,0,0,0,6,1,314,98,26528,29547,32702,5,27,16,1,0,0,0,4,348,58,28130,28849,48749,0,-34,40,-1602,-4,698,-16047,0,0,0,0,2
EUW1_6861988370',5,32,7,1,0,0,0,10,1,277,74,23371,26432,25119,6,38,30,1,0,2,0,2,370,87,35215,33033,51622,0,-93,-13,-11844,-23,-6601,-26503,0,0,-2,0,8
EUW1_6859359518',4,38,15,1,1,1,0,9,0,368,89,28557,29983,38740,7,23,5,1,0,0,0,4,367,82,25380,28112,23888,1,1,7,3177,10,1871,14852,0,1,1,0,5
EUW1_6883761574',2,43,7,0,0,2,0,11,1,350,81,25808,27752,26815,0,23,5,2,0,0,0,6,407,84,25434,30751,31482,1,-57,-3,374,2,-2999,-4667,-2,0,2,0,5
EUW1_6883721526',3,31,10,0,1,0,0,11,0,341,84,25645,28880,28938,3,38,9,1,0,1,0,0,348,84,25628,28776,30967,1,-7,0,17,1,104,-2029,-1,1,-1,0,11
EUW1_6882844489',2,29,15,1,1,1,0,6,1,408,92,30423,31852,36026,6,30,14,0,0,1,0,4,376,62,27734,28273,28109,1,32,30,2689,1,3579,7917,1,1,0,0,2
EUW1_6882602348',0,23,14,1,0,0,0,15,0,300,64,27284,28263,29255,6,27,18,1,0,4,0,3,363,105,32295,30135,38464,0,-63,-41,-5011,-4,-1872,-9209,0,0,-4,0,12
EUW1_6882492547',6,31,17,1,0,2,0,12,0,364,144,32726,35578,39303,2,40,6,1,0,3,0,5,349,69,26227,27822,28419,1,15,75,6499,11,7756,10884,0,0,-1,0,7
EUW1_6882467513',2,29,8,1,0,0,0,11,1,337,88,24301,27507,32225,4,26,16,1,0,2,0,0,342,79,29513,29618,38792,0,-5,9,-5212,-8,-2111,-6567,0,0,-2,0,11
EUW1_6882441778',3,29,11,1,0,1,0,11,0,367,114,28161,31187,38041,2,26,16,1,0,1,0,3,371,85,28856,31075,38429,0,-4,29,-695,-5,112,-388,0,0,0,0,8
EUW1_6882396224',6,36,22,2,0,1,0,5,1,390,70,32861,30447,34209,0,38,6,0,0,1,0,6,338,112,25269,27500,22678,1,52,-42,7592,16,2947,11531,2,0,0,0,-1
EUW1_6882388692',0,20,11,2,0,1,0,3,1,394,112,28279,33054,28242,4,37,8,0,0,0,0,8,353,106,24521,28377,29039,1,41,6,3758,3,4677,-797,2,0,1,0,-5
EUW1_6882370855',5,31,12,2,0,1,0,13,0,347,98,27755,30317,29965,7,36,8,0,0,2,0,3,385,81,27325,27915,22888,1,-38,17,430,4,2402,7077,2,0,-1,0,10
EUW1_6880715031',6,30,13,0,0,1,0,13,0,337,98,28863,27988,37242,6,32,19,2,0,2,0,4,361,74,31825,28690,39073,0,-24,24,-2962,-6,-702,-1831,-2,0,-1,0,9
EUW1_6880686253',5,30,11,1,0,0,0,9,0,329,75,24954,27784,39121,2,26,19,1,1,2,0,0,376,107,32969,32171,49714,0,-47,-32,-8015,-8,-4387,-10593,0,-1,-2,0,9
EUW1_6880669173',2,30,2,0,0,0,0,13,0,298,57,19987,24263,23651,2,45,21,1,1,2,0,2,387,95,31174,32209,34187,0,-89,-38,-11187,-19,-7946,-10536,-1,-1,-2,0,11
EUW1_6880637719',2,38,7,0,0,0,0,15,0,374,91,25196,30038,25374,5,48,22,1,0,2,0,0,398,96,33101,30946,34748,0,-24,-5,-7905,-15,-908,-9374,-1,0,-2,0,15
EUW1_6883771149',5,33,16,1,0,3,0,7,1,354,90,30563,30406,38363,3,29,12,1,0,1,0,7,325,105,27612,30352,30802,1,29,-15,2951,4,54,7561,0,0,2,0,0
EUW1_6883738109',7,32,16,1,0,1,0,9,1,349,98,30484,30170,36472,5,33,12,0,0,1,0,6,353,102,29150,28711,35312,0,-4,-4,1334,4,1459,1160,1,0,0,0,3
EUW1_6883723940',4,22,10,1,0,1,0,13,1,362,101,27616,31602,28854,3,25,5,1,0,1,0,4,390,70,26041,28244,23837,1,-28,31,1575,5,3358,5017,0,0,0,0,9
EUW1_6883714873',6,36,20,1,0,1,0,8,0,336,88,32199,30864,33846,3,32,11,1,1,1,0,10,369,112,27624,28758,28544,1,-33,-24,4575,9,2106,5302,0,-1,0,0,-2
EUW1_6883708126',6,26,13,0,0,0,0,8,0,317,84,27105,28720,30312,2,23,10,1,0,0,0,2,351,80,26836,29483,29433,1,-34,4,269,3,-763,879,-1,0,0,0,6
EUW1_6883672886',4,42,14,2,0,0,0,6,1,307,80,26986,28494,38242,3,70,10,0,0,1,0,2,364,80,27946,29268,34676,1,-57,0,-960,4,-774,3566,2,0,-1,0,4
EUW1_6883637839',10,27,13,1,0,0,0,8,0,323,90,26484,29908,30669,4,32,10,1,0,1,0,3,377,105,27192,31644,29457,0,-54,-15,-708,3,-1736,1212,0,0,-1,0,5
EUW1_6883615250',3,22,10,2,0,0,0,7,0,341,102,25558,30434,24726,3,33,3,0,0,0,0,4,399,102,24081,29166,24518,1,-58,0,1477,7,1268,208,2,0,0,0,3
EUW1_6883584165',4,24,16,0,0,1,0,10,1,374,87,30738,31356,44626,2,94,13,0,0,1,0,7,360,88,28629,31906,32287,1,14,-1,2109,3,-550,12339,0,0,0,0,3
EUW1_6883562868',4,32,16,0,0,0,0,14,0,332,68,29154,27313,42200,6,29,26,2,0,0,0,3,345,96,32760,31841,41407,0,-13,-28,-3606,-10,-4528,793,-2,0,0,0,11
EUW1_6883533060',6,35,16,0,0,2,0,10,1,365,93,32186,31504,35021,3,28,9,2,0,0,0,6,346,90,25656,27085,27165,0,19,3,6530,7,4419,7856,-2,0,2,0,4
EUW1_6882406128',7,144,4,1,0,0,0,8,0,356,109,23480,28239,18572,11,35,9,1,0,1,0,4,412,82,27246,30159,30153,1,-56,27,-3766,-5,-1920,-11581,0,0,-1,0,4
EUW1_6882360892',8,35,15,1,0,1,0,13,0,371,75,29867,31538,39346,6,72,12,0,0,1,0,3,348,96,26608,29271,35371,1,23,-21,3259,3,2267,3975,1,0,0,0,10
EUW1_6882344203',0,31,15,1,1,1,0,7,0,353,101,30734,29970,31924,5,28,14,0,0,0,0,4,349,61,27709,29418,30868,1,4,40,3025,1,552,1056,1,1,1,0,3
EUW1_6882327446',3,28,7,2,0,0,0,8,1,288,112,23424,27265,20646,3,133,11,0,0,2,0,2,395,88,28100,31741,29328,1,-107,24,-4676,-4,-4476,-8682,2,0,-2,0,6
EUW1_6882299492',2,29,23,2,0,3,0,6,0,407,99,34591,34446,50178,7,31,14,0,0,0,0,10,320,60,26104,26815,34551,1,87,39,8487,9,7631,15627,2,0,3,0,-4
EUW1_6875328815',2,29,24,2,0,2,0,5,1,336,85,31686,31383,44528,1,33,1,0,0,0,0,7,317,72,20358,24898,30668,1,19,13,11328,23,6485,13860,2,0,2,0,-2
EUW1_6875253653',3,42,14,0,0,1,0,5,0,387,85,29322,31585,41717,1,21,16,2,0,1,0,7,364,82,29350,30933,32462,1,23,3,-28,-2,652,9255,-2,0,0,0,-2
EUW1_6875227667',3,21,24,1,1,3,0,6,1,372,116,33060,33857,39088,3,23,5,0,0,0,0,6,358,84,24145,27017,18617,1,14,32,8915,19,6840,20471,1,1,3,0,0
EUW1_6875179292',11,31,6,0,0,0,0,5,1,404,104,25640,30033,27572,2,20,10,2,0,0,0,3,390,96,26887,30527,25158,1,14,8,-1247,-4,-494,2414,-2,0,0,0,2
EUW1_6875164665',2,24,17,0,0,0,0,13,0,273,81,29376,27951,33741,3,21,20,2,1,1,0,1,304,73,29686,29117,42960,1,-31,8,-310,-3,-1166,-9219,-2,-1,-1,0,12
EUW1_6875107846',1,26,13,2,0,0,0,15,1,293,67,26060,26655,25307,1,24,13,0,0,3,0,5,407,132,30932,31697,26853,0,-114,-65,-4872,0,-5042,-1546,2,0,-3,0,10
EUW1_6875096690',9,293,14,0,1,1,0,15,0,336,86,29548,29819,33429,2,24,11,2,0,2,0,4,326,90,26772,27972,26959,1,10,-4,2776,3,1847,6470,-2,1,-1,0,11
EUW1_6875084665',5,38,9,0,0,1,0,9,0,335,119,27226,30885,26950,3,26,13,2,0,1,0,3,403,94,29565,31341,28803,0,-68,25,-2339,-4,-456,-1853,-2,0,0,0,6
EUW1_6875071790',3,51,13,1,0,1,0,13,1,365,85,27923,29264,29876,2,243,8,0,0,1,0,8,399,98,28302,31717,19966,1,-34,-13,-379,5,-2453,9910,1,0,0,0,5
EUW1_6875056276',1,25,16,2,0,3,1,3,1,371,94,31105,30403,21930,1,16,3,0,0,1,0,9,265,98,21809,24678,15325,1,106,-4,9296,13,5725,6605,2,0,2,1,-6
EUW1_6875019278',6,46,21,1,1,0,0,12,0,304,90,30496,29172,37105,4,47,16,0,0,1,0,5,342,82,29223,28533,36349,0,-38,8,1273,5,639,756,1,1,-1,0,7
EUW1_6875008761',1,21,12,1,0,0,0,17,0,320,80,27153,27896,31645,3,31,25,1,0,4,0,3,418,110,35030,32978,44123,0,-98,-30,-7877,-13,-5082,-12478,0,0,-4,0,14
EUW1_6874988961',0,70,16,1,1,0,0,10,1,301,104,28704,29231,38505,6,31,20,1,0,1,0,2,339,92,31504,31612,42245,1,-38,12,-2800,-4,-2381,-3740,0,1,-1,0,8
EUW1_6874957924',1,29,9,0,0,0,0,12,1,308,82,25126,25678,30510,4,28,18,2,1,2,0,3,338,92,31106,31717,29963,1,-30,-10,-5980,-9,-6039,547,-2,-1,-2,0,9
EUW1_6874945524',5,29,8,2,1,4,0,1,1,427,125,29920,31848,20464,1,29,3,0,0,0,0,6,355,72,21923,26148,16175,1,72,53,7997,5,5700,4289,2,1,4,0,-5
EUW1_6874912479',3,24,11,2,0,0,0,9,1,335,112,26723,30820,33793,4,31,12,0,0,1,0,2,383,79,28536,30690,36002,0,-48,33,-1813,-1,130,-2209,2,0,-1,0,7
EUW1_6874845621',5,72,18,2,1,3,0,5,1,360,101,31230,32023,35471,6,27,3,0,0,0,0,7,284,78,21010,24935,18605,1,76,23,10220,15,7088,16866,2,1,3,0,-2
EUW1_6874774843',0,37,18,1,0,0,0,7,0,337,92,29993,29574,29455,6,25,13,0,0,1,0,5,370,88,28890,28242,26591,1,-33,4,1103,5,1332,2864,1,0,-1,0,2
EUW1_6874723759',3,61,17,1,0,1,0,3,0,293,88,29169,27791,42108,4,32,16,1,0,0,0,7,320,84,28004,29462,41613,1,-27,4,1165,1,-1671,495,0,0,1,0,-4
EUW1_6864480687',5,25,23,1,0,4,0,7,1,391,104,35498,33536,41795,3,86,6,1,0,0,0,10,307,63,22990,25544,23690,1,84,41,12508,17,7992,18105,0,0,4,0,-3
EUW1_6864456505',2,26,12,1,0,0,0,9,1,348,82,26925,29814,27772,5,145,16,1,0,1,0,7,373,93,29789,30931,36862,0,-25,-11,-2864,-4,-1117,-9090,0,0,-1,0,2
EUW1_6864415903',3,36,10,0,0,1,0,10,0,368,82,28266,29323,29719,4,53,13,2,0,0,0,4,356,106,28435,30169,29728,1,12,-24,-169,-3,-846,-9,-2,0,1,0,6
EUW1_6864359845',5,33,22,2,0,1,0,15,1,301,84,29326,28797,42182,4,24,9,0,0,1,0,3,325,84,26376,26816,28861,1,-24,0,2950,13,1981,13321,2,0,0,0,12
EUW1_6864246013',6,35,15,1,0,0,0,10,1,400,88,30824,32185,36314,3,28,7,1,0,2,0,10,364,95,25540,30559,34136,0,36,-7,5284,8,1626,2178,0,0,-2,0,0
EUW1_6863528830',2,26,16,1,1,1,0,6,1,342,96,29917,30968,34643,3,32,8,0,0,1,0,7,381,84,26757,28436,26346,1,-39,12,3160,8,2532,8297,1,1,0,0,-1
EUW1_6863195458',4,34,15,0,0,0,0,6,0,372,79,28280,29759,35075,2,25,16,2,0,0,0,4,318,112,27662,30153,29088,0,54,-33,618,-1,-394,5987,-2,0,0,0,2
EUW1_6863163174',4,68,12,0,0,0,0,6,1,360,82,28276,28584,31087,6,69,17,1,1,0,0,5,361,93,29583,30553,29772,0,-1,-11,-1307,-5,-1969,1315,-1,-1,0,0,1
EUW1_6863143319',1,59,14,0,0,0,0,11,0,332,92,27418,30343,35467,8,66,21,2,1,2,0,2,379,91,33484,32991,48748,0,-47,1,-6066,-7,-2648,-13281,-2,-1,-2,0,9
EUW1_6863127651',5,27,16,2,0,2,0,11,0,337,90,32558,28472,34443,3,30,20,0,0,0,0,9,322,66,29173,29155,38147,1,15,24,3385,-4,-683,-3704,2,0,2,0,2
EUW1_6863077193',2,32,19,0,0,2,0,6,1,325,111,31991,31635,47750,0,20,17,1,0,0,0,6,335,76,29523,29309,42546,0,-10,35,2468,2,2326,5204,-1,0,2,0,0
EUW1_6863025209',6,26,17,1,1,0,0,4,1,336,124,27806,33923,33287,3,27,8,1,0,0,0,2,357,96,25662,29061,29374,0,-21,28,2144,9,4862,3913,0,1,0,0,2
EUW1_6862951213',5,23,14,1,0,0,0,12,0,318,103,28609,29753,38195,6,35,20,1,0,1,0,3,340,68,30432,29990,40579,1,-22,35,-1823,-6,-237,-2384,0,0,-1,0,9
EUW1_6862911105',0,144,4,0,0,0,0,12,1,340,92,23432,26719,19250,4,21,15,2,0,2,0,1,387,112,29804,33208,27809,0,-47,-20,-6372,-11,-6489,-8559,-2,0,-2,0,11
EUW1_6862824390',2,57,16,1,1,0,0,4,1,336,94,28602,30558,38820,6,28,18,0,0,1,0,0,358,93,30296,30695,40924,0,-22,1,-1694,-2,-137,-2104,1,1,-1,0,4
EUW1_6862780396',9,34,23,1,0,2,0,4,1,362,83,32765,31726,47573,4,41,6,0,0,0,0,6,308,90,23544,26438,25411,1,54,-7,9221,17,5288,22162,1,0,2,0,-2
EUW1_6862738562',4,26,15,1,0,2,0,4,1,417,66,31591,31235,31999,1,24,7,0,0,0,0,9,289,93,23797,26997,24970,1,128,-27,7794,8,4238,7029,1,0,2,0,-5
EUW1_6862677059',5,34,15,2,1,0,0,5,1,396,88,28638,32238,25689,2,19,5,0,0,0,0,0,385,103,24299,29600,18830,1,11,-15,4339,10,2638,6859,2,1,0,0,5
EUW1_6883624747',3,33,20,1,0,1,0,11,0,340,76,31034,30553,40744,5,28,21,0,0,0,0,2,353,104,32350,31418,41024,0,-13,-28,-1316,-1,-865,-280,1,0,1,0,9
EUW1_6883596189',3,28,8,1,0,1,0,9,1,372,106,26633,29171,31893,4,78,13,1,1,1,0,6,364,107,27561,30020,35994,0,8,-1,-928,-5,-849,-4101,0,-1,0,0,3
EUW1_6883568403',2,31,11,0,1,1,0,14,1,329,105,28167,30146,47230,6,27,16,2,0,1,0,3,345,86,29053,30203,31021,0,-16,19,-886,-5,-57,16209,-2,1,0,0,11
EUW1_6883543598',7,45,20,1,1,3,0,11,0,289,80,32034,27305,43445,5,58,16,1,0,2,0,10,316,88,28758,26749,37442,1,-27,-8,3276,4,556,6003,0,1,1,0,1
EUW1_6883489436',8,39,15,1,0,0,0,8,1,365,82,28322,29937,34238,5,173,12,0,1,1,0,2,380,109,29953,31483,34420,0,-15,-27,-1631,3,-1546,-182,1,-1,-1,0,6
EUW1_6883065543',5,56,19,0,1,2,0,6,0,390,87,32348,31006,36593,4,31,9,1,0,0,0,7,320,78,23965,27441,26889,1,70,9,8383,10,3565,9704,-1,1,2,0,-1
EUW1_6882995021',5,32,10,0,0,0,0,17,0,388,95,26767,29281,21878,6,33,10,1,1,2,0,2,414,116,29633,31837,17750,0,-26,-21,-2866,0,-2556,4128,-1,-1,-2,0,15
EUW1_6881492370',2,30,7,0,0,0,0,7,1,345,90,24878,27637,28304,2,58,12,1,0,1,0,6,347,90,27204,29804,31469,1,-2,0,-2326,-5,-2167,-3165,-1,0,-1,0,1
EUW1_6881448889',7,33,12,1,1,0,0,8,0,388,96,27535,31866,34417,1,20,8,1,0,1,0,0,355,92,26033,28726,26929,1,33,4,1502,4,3140,7488,0,1,-1,0,8
EUW1_6881371161',1,28,10,0,0,0,0,14,0,329,98,25785,28589,25053,5,48,20,2,1,1,0,2,356,101,32658,31023,39497,0,-27,-3,-6873,-10,-2434,-14444,-2,-1,-1,0,12
EUW1_6881312803',7,31,11,1,1,1,0,10,0,374,108,27765,30256,27096,7,37,12,1,0,1,0,5,360,93,29234,28905,27706,1,14,15,-1469,-1,1351,-610,0,1,0,0,5
EUW1_6881225619',4,31,17,1,0,1,0,13,1,388,120,31481,32570,34851,3,29,15,1,0,2,0,4,369,67,28984,29019,35423,1,19,53,2497,2,3551,-572,0,0,-1,0,9
EUW1_6881179280',3,27,23,2,0,2,0,6,1,338,94,33526,31176,40406,3,28,13,0,0,2,0,10,241,69,25109,24950,29258,1,97,25,8417,10,6226,11148,2,0,0,0,-4
EUW1_6881136470',6,30,14,0,0,0,0,3,1,393,96,28181,32138,31741,4,25,10,1,0,1,0,1,383,84,26663,30597,34306,1,10,12,1518,4,1541,-2565,-1,0,-1,0,2
EUW1_6881091792',7,35,10,0,0,0,0,10,1,378,98,27618,29735,25496,6,36,12,2,0,2,0,1,387,94,30272,30378,26413,1,-9,4,-2654,-2,-643,-917,-2,0,-2,0,9
EUW1_6881063725',2,27,7,0,0,0,0,12,1,336,92,24186,27293,24651,7,29,21,2,1,1,0,2,366,72,30972,33043,39546,0,-30,20,-6786,-14,-5750,-14895,-2,-1,-1,0,10
EUW1_6881014047',3,30,22,0,1,0,0,10,0,362,83,32343,31544,40124,2,32,14,1,0,1,0,3,349,96,28428,28748,35423,1,13,-13,3915,8,2796,4701,-1,1,-1,0,7
EUW1_6879952466',4,28,3,0,0,0,0,4,0,423,102,24596,29841,21620,9,30,10,2,1,2,0,2,401,102,27858,32818,25186,0,22,0,-3262,-7,-2977,-3566,-2,-1,-2,0,2
EUW1_6879700329',0,21,5,0,0,0,0,14,0,376,92,23657,28613,21128,3,144,11,2,0,3,0,1,390,104,31247,31286,28942,0,-14,-12,-7590,-6,-2673,-7814,-2,0,-3,0,13
EUW1_6879678749',7,41,8,1,0,0,0,9,0,329,108,24501,27866,29902,8,26,17,1,0,2,0,1,352,82,30088,30613,29715,0,-23,26,-5587,-9,-2747,187,0,0,-2,0,8
EUW1_6879293819',1,21,14,0,0,0,0,10,1,322,80,27726,28433,41039,5,31,17,2,0,1,0,4,345,84,30582,30595,41480,1,-23,-4,-2856,-3,-2162,-441,-2,0,-1,0,6
EUW1_6878636197',4,37,12,1,0,0,0,7,0,324,105,27512,28343,32452,5,35,19,0,0,1,0,2,346,78,29759,28985,36866,0,-22,27,-2247,-7,-642,-4414,1,0,-1,0,5
EUW1_6878495881',6,34,11,0,0,0,0,8,1,361,55,26238,27368,35536,3,32,17,1,1,1,0,5,360,83,28682,30682,36877,0,1,-28,-2444,-6,-3314,-1341,-1,-1,-1,0,3
EUW1_6878059794',5,28,12,2,0,1,0,8,1,374,111,28821,30829,31107,2,29,8,0,0,0,0,4,390,110,26507,29585,21286,1,-16,1,2314,4,1244,9821,2,0,1,0,4
EUW1_6878021848',3,26,17,1,0,2,0,7,0,369,90,30592,31836,35504,4,34,6,1,0,0,0,7,343,102,24581,27299,28586,1,26,-12,6011,11,4537,6918,0,0,2,0,0
EUW1_6877984333',6,31,10,1,0,1,0,4,0,368,108,27993,28673,32380,4,58,14,0,0,0,0,3,353,80,28377,28682,32179,1,15,28,-384,-4,-9,201,1,0,1,0,1
EUW1_6877946990',5,32,13,1,0,0,0,10,1,379,82,27482,29990,30910,1,45,10,1,0,2,0,4,392,82,27439,29211,31556,1,-13,0,43,3,779,-646,0,0,-2,0,6
EUW1_6877003470',3,27,6,0,0,0,0,15,1,336,89,24550,27246,23246,5,32,16,2,0,3,0,0,401,86,31365,32036,47647,0,-65,3,-6815,-10,-4790,-24401,-2,0,-3,0,15
EUW1_6876618355',2,77,9,2,0,0,0,13,1,360,90,24899,29897,31750,3,31,11,0,0,2,0,1,373,100,28383,30373,32079,0,-13,-10,-3484,-2,-476,-329,2,0,-2,0,12
EUW1_6876501861',3,24,9,1,1,0,0,11,1,330,102,25695,28179,29084,3,42,14,0,0,1,0,2,359,80,28857,29479,30275,0,-29,22,-3162,-5,-1300,-1191,1,1,-1,0,9
EUW1_6876488638',4,59,12,0,0,1,0,8,1,386,70,27746,29560,29532,6,67,9,1,0,0,0,2,330,110,26015,28956,29361,1,56,-40,1731,3,604,171,-1,0,1,0,6
EUW1_6876468305',3,48,10,0,0,0,0,12,1,300,72,25134,26273,20879,10,37,13,2,0,2,0,2,381,76,29436,29194,31148,0,-81,-4,-4302,-3,-2921,-10269,-2,0,-2,0,10
EUW1_6876463779',5,30,15,0,0,0,0,8,0,310,98,27303,29871,29894,3,145,18,1,0,1,0,1,339,78,29296,30638,42347,0,-29,20,-1993,-3,-767,-12453,-1,0,-1,0,7
EUW1_6876339607',3,40,5,0,0,0,0,13,0,343,85,23609,27619,25609,5,101,9,0,0,2,0,1,397,60,27360,29197,26301,0,-54,25,-3751,-4,-1578,-692,0,0,-2,0,12
EUW1_6883759466',3,27,13,0,0,1,0,14,0,354,81,27752,30113,30092,4,28,12,1,0,1,0,3,339,57,27527,29628,29911,1,15,24,225,1,485,181,-1,0,0,0,11
EUW1_6882444361',6,24,13,0,1,1,0,6,0,308,104,28368,28721,28879,5,30,13,1,0,0,0,7,323,54,26465,26763,30022,0,-15,50,1903,0,1958,-1143,-1,1,1,0,-1
EUW1_6882416285',2,25,14,1,0,0,0,13,0,283,82,26763,26377,27943,3,26,12,0,0,0,0,2,338,104,26963,28508,27479,0,-55,-22,-200,2,-2131,464,1,0,0,0,11
EUW1_6882393321',4,17,11,0,0,1,0,8,0,401,107,29314,32794,32656,9,30,11,1,0,0,0,5,337,101,26946,30466,28891,0,64,6,2368,0,2328,3765,-1,0,1,0,3
EUW1_6880882311',4,25,12,1,0,0,0,13,0,414,100,28247,32545,28749,3,26,11,1,0,0,0,2,384,96,27730,30696,27763,1,30,4,517,1,1849,986,0,0,0,0,11
EUW1_6880868998',3,32,11,1,0,1,0,11,1,411,79,26716,30841,26834,3,27,5,1,0,1,0,1,379,87,24258,28161,27051,1,32,-8,2458,6,2680,-217,0,0,0,0,10
EUW1_6880848238',9,37,13,0,0,0,0,8,1,366,88,28740,29532,36932,5,27,14,1,0,0,0,5,323,75,27501,28970,30543,1,43,13,1239,-1,562,6389,-1,0,0,0,3
EUW1_6880837667',1,24,17,0,0,1,0,9,1,353,116,30970,30751,41377,3,78,19,1,0,0,0,7,325,68,29233,31958,37252,1,28,48,1737,-2,-1207,4125,-1,0,1,0,2
EUW1_6880813066',4,21,10,0,0,0,0,9,1,335,96,26463,28347,31121,5,362,17,2,0,1,0,5,367,80,29717,32816,35044,0,-32,16,-3254,-7,-4469,-3923,-2,0,-1,0,4
EUW1_6880800163',1,26,11,0,0,0,0,12,0,314,101,26139,29174,32856,3,24,12,1,0,1,0,2,349,82,27244,29442,37441,0,-35,19,-1105,-1,-268,-4585,-1,0,-1,0,10
EUW1_6880764800',1,25,13,0,0,0,0,10,0,320,70,27256,27465,40834,5,71,19,2,0,2,0,2,315,97,30785,29648,41219,0,5,-27,-3529,-6,-2183,-385,-2,0,-2,0,8
EUW1_6880748539',1,22,15,0,1,2,0,7,1,383,88,29855,30352,34038,2,24,12,0,0,0,0,6,365,82,27663,30279,31131,1,18,6,2192,3,73,2907,0,1,2,0,1
EUW1_6880718032',2,25,13,0,0,0,0,13,0,371,90,27931,29955,36401,4,47,18,2,0,1,0,4,373,93,30609,32068,35344,0,-2,-3,-2678,-5,-2113,1057,-2,0,-1,0,9
EUW1_6880688900',3,22,7,0,0,0,0,9,0,353,67,25469,29699,21162,6,28,16,1,0,1,0,1,383,128,29360,33028,37507,0,-30,-61,-3891,-9,-3329,-16345,-1,0,-1,0,8
EUW1_6880620085',4,27,15,1,0,1,0,14,0,333,82,28279,28805,34424,4,28,16,1,1,3,0,4,369,99,31855,31634,33841,0,-36,-17,-3576,-1,-2829,583,0,-1,-2,0,10
EUW1_6880513440',3,22,14,2,0,1,0,9,1,359,102,28459,28938,29921,6,25,7,0,0,0,0,5,334,86,23458,27967,25307,1,25,16,5001,7,971,4614,2,0,1,0,4
EUW1_6880470526',4,26,17,0,0,2,0,10,1,344,103,31784,29857,31694,1,31,14,2,0,1,0,9,317,74,27601,27630,34325,1,27,29,4183,3,2227,-2631,-2,0,1,0,1
EUW1_6880348899',5,33,14,1,0,1,0,7,0,361,73,28154,30584,30751,4,23,14,0,0,1,0,5,339,72,27532,28879,38965,1,22,1,622,0,1705,-8214,1,0,0,0,2
EUW1_6876473980',3,29,17,0,0,1,0,8,0,354,94,29726,29178,34931,2,28,13,1,1,1,0,5,323,82,28587,27957,32067,1,31,12,1139,4,1221,2864,-1,-1,0,0,3
EUW1_6876464976',5,41,16,1,0,0,0,16,0,277,70,26399,29373,37255,2,53,11,0,0,2,0,1,375,96,29737,29146,34167,1,-98,-26,-3338,5,227,3088,1,0,-2,0,15
EUW1_6863534576',3,36,10,1,0,0,0,11,1,373,84,26346,29004,28003,6,32,18,1,0,1,0,1,391,100,30926,32260,37837,0,-18,-16,-4580,-8,-3256,-9834,0,0,-1,0,10
EUW1_6862230260',8,30,10,2,0,0,0,13,1,380,116,27919,31338,28443,5,37,10,0,0,2,0,2,426,97,29580,30559,29607,1,-46,19,-1661,0,779,-1164,2,0,-2,0,11
EUW1_6862158915',3,33,13,2,0,0,0,12,0,327,88,27833,29781,31607,7,31,17,0,0,1,0,3,332,116,30640,30861,41956,0,-5,-28,-2807,-4,-1080,-10349,2,0,-1,0,9
EUW1_6862117425',5,38,15,1,0,0,0,9,0,362,90,28718,29381,36656,7,139,14,0,0,1,0,3,322,82,27609,28976,35917,1,40,8,1109,1,405,739,1,0,-1,0,6
EUW1_6862094168',4,28,6,0,0,0,0,11,0,330,60,23274,26970,24505,3,23,21,2,0,1,0,0,394,111,32689,33103,39105,0,-64,-51,-9415,-15,-6133,-14600,-2,0,-1,0,11
EUW1_6862072185',5,28,14,1,0,0,0,8,1,327,78,27892,27975,34936,2,33,14,1,0,0,0,1,345,68,27772,26401,33253,0,-18,10,120,0,1574,1683,0,0,0,0,7
EUW1_6861982876',3,21,12,2,0,0,0,12,0,320,82,26459,29734,30249,2,25,13,0,0,1,0,0,404,89,29812,31656,27661,0,-84,-7,-3353,-1,-1922,2588,2,0,-1,0,12
EUW1_6861812123',9,35,19,1,0,0,0,7,1,348,66,28302,28817,34157,5,36,9,1,0,0,0,2,355,78,25844,28824,33364,0,-7,-12,2458,10,-7,793,0,0,0,0,5
EUW1_6861127568',4,29,10,1,0,0,0,8,0,323,86,25175,26988,26263,6,28,14,1,0,2,0,0,415,94,30164,30781,34647,0,-92,-8,-4989,-4,-3793,-8384,0,0,-2,0,8
EUW1_6861078266',9,27,9,2,0,1,0,9,0,332,80,24564,28126,20964,3,21,14,0,0,1,0,2,352,82,28665,30575,34320,0,-20,-2,-4101,-5,-2449,-13356,2,0,0,0,7
EUW1_6860728053',3,58,11,1,0,0,0,10,1,339,74,26939,26619,29569,1,35,16,1,0,3,0,7,309,92,28989,29019,33499,0,30,-18,-2050,-5,-2400,-3930,0,0,-3,0,3
EUW1_6860725493',37,64,8,0,1,0,0,16,0,282,50,23852,22817,30237,4,23,30,1,0,6,0,2,406,91,37850,32791,42722,0,-124,-41,-13998,-22,-9974,-12485,-1,1,-6,0,14
EUW1_6860697354',3,296,13,2,1,2,0,5,0,376,96,29791,30448,36665,4,22,10,0,0,0,0,8,339,99,26205,28685,30802,1,37,-3,3586,3,1763,5863,2,1,2,0,-3
EUW1_6860685788',4,28,29,0,0,2,0,7,1,367,74,35437,31836,42572,0,26,11,0,0,0,0,7,261,77,24615,24878,30480,1,106,-3,10822,18,6958,12092,0,0,2,0,0
EUW1_6860648582',8,62,16,2,0,3,0,3,1,364,83,29935,28348,27889,0,15,9,0,0,0,0,8,301,84,24357,25556,24532,1,63,-1,5578,7,2792,3357,2,0,3,0,-5
EUW1_6860577222',2,24,14,2,1,0,0,10,1,329,88,27979,26815,38846,7,97,21,0,0,0,0,5,337,88,31354,30458,48852,1,-8,0,-3375,-7,-3643,-10006,2,1,0,0,5
EUW1_6860517553',4,26,13,0,0,1,0,6,1,366,91,27516,30504,30865,2,22,6,1,0,0,0,1,371,102,24568,28414,23894,1,-5,-11,2948,7,2090,6971,-1,0,1,0,5
EUW1_6871880040',5,31,17,1,0,0,0,6,1,361,91,28734,31528,36987,5,32,11,1,1,1,0,6,332,88,27232,29567,34501,1,29,3,1502,6,1961,2486,0,-1,-1,0,0
EUW1_6871736587',3,145,15,0,0,2,0,3,0,387,89,29298,29698,37018,3,28,9,1,0,0,0,4,336,78,24602,27650,24655,1,51,11,4696,6,2048,12363,-1,0,2,0,-1
EUW1_6869320210',5,28,15,1,0,1,0,7,1,341,88,29631,30328,32588,3,28,13,1,1,1,0,7,353,108,27717,31595,45105,1,-12,-20,1914,2,-1267,-12517,0,-1,0,0,0
EUW1_6866991701',3,20,11,0,0,1,0,8,1,395,98,27222,31242,25821,4,30,8,2,0,1,0,6,382,118,27677,31309,30488,1,13,-20,-455,3,-67,-4667,-2,0,0,0,2
EUW1_6866708992',7,35,15,1,0,0,0,7,1,393,86,30555,30379,36232,2,25,9,0,0,1,0,5,363,102,26340,29452,28960,1,30,-16,4215,6,927,7272,1,0,-1,0,2
EUW1_6866647921',4,73,13,1,0,0,0,8,0,376,89,27849,30383,34125,5,27,14,1,0,0,0,1,364,96,27922,29078,32845,1,12,-7,-73,-1,1305,1280,0,0,0,0,7
EUW1_6866581032',3,26,12,0,0,0,0,7,1,372,78,27493,29064,34568,2,26,15,2,0,1,0,6,337,86,28363,30824,33825,1,35,-8,-870,-3,-1760,743,-2,0,-1,0,1
EUW1_6865468953',3,29,11,0,0,0,0,8,0,364,95,26791,30255,26452,8,23,11,1,0,0,0,4,355,88,26958,30614,25536,1,9,7,-167,0,-359,916,-1,0,0,0,4
EUW1_6863799804',8,32,10,1,0,2,0,12,1,373,94,27133,29168,31679,2,17,9,1,0,1,0,6,354,90,26087,29134,32682,0,19,4,1046,1,34,-1003,0,0,1,0,6
EUW1_6863742071',5,35,16,2,0,1,0,5,1,362,99,29605,30505,30738,5,43,6,0,1,0,0,5,365,91,25657,28956,25395,1,-3,8,3948,10,1549,5343,2,-1,1,0,0
EUW1_6863488074',4,35,8,1,0,0,0,7,0,320,78,24254,26381,27813,2,96,15,1,0,0,0,4,335,85,27488,29763,33933,0,-15,-7,-3234,-7,-3382,-6120,0,0,0,0,3
EUW1_6863469483',5,21,19,1,0,1,0,4,1,408,91,31067,33641,35498,5,33,2,1,0,1,0,5,328,84,21562,25609,25414,1,80,7,9505,17,8032,10084,0,0,0,0,-1
EUW1_6863428248',3,52,12,0,0,1,0,11,0,310,88,27173,29113,31200,3,28,20,2,0,2,0,0,339,95,31774,30706,44316,0,-29,-7,-4601,-8,-1593,-13116,-2,0,-1,0,11
EUW1_6862006815',1,25,12,1,0,0,0,6,0,356,113,30107,30213,40760,4,31,23,1,0,1,0,8,316,94,31470,33191,40863,0,40,19,-1363,-11,-2978,-103,0,0,-1,0,-2
EUW1_6861992367',5,30,18,0,0,1,0,7,1,332,117,31681,32862,36843,4,28,9,1,0,0,0,6,370,102,27147,29729,34969,1,-38,15,4534,9,3133,1874,-1,0,1,0,1
EUW1_6861959652',3,21,12,1,0,0,0,8,1,324,79,26697,27625,31058,2,22,16,1,1,3,0,3,345,100,29898,29573,30460,1,-21,-21,-3201,-4,-1948,598,0,-1,-3,0,5
EUW1_6861920786',4,27,16,0,0,3,0,9,0,337,92,31034,30143,36606,3,27,14,2,0,0,0,7,322,75,26705,29229,30380,1,15,17,4329,2,914,6226,-2,0,3,0,2
EUW1_6861855274',3,42,8,1,0,1,0,17,1,392,98,29472,28257,23611,4,29,20,1,0,2,0,6,385,74,32016,30362,33008,1,7,24,-2544,-12,-2105,-9397,0,0,-1,0,11
EUW1_6861824754',5,33,16,0,0,0,0,13,0,291,72,28660,28015,41028,2,87,24,1,0,2,0,0,359,96,35168,31368,39630,0,-68,-24,-6508,-8,-3353,1398,-1,0,-2,0,13
EUW1_6861583360',3,32,12,0,0,0,0,4,1,351,83,25789,29800,34069,1,22,9,2,0,1,0,1,367,108,27826,31669,41238,0,-16,-25,-2037,3,-1869,-7169,-2,0,-1,0,3
EUW1_6861431156',5,23,17,2,0,0,0,9,0,367,72,31096,28023,40737,3,35,15,0,0,1,0,6,359,92,30227,29069,34372,1,8,-20,869,2,-1046,6365,2,0,-1,0,3
EUW1_6861381826',3,30,13,0,0,1,0,12,1,395,95,30220,30861,33099,5,41,12,2,0,2,0,9,400,87,29798,30374,34981,0,-5,8,422,1,487,-1882,-2,0,-1,0,3
EUW1_6861298575',3,29,20,1,0,1,0,4,1,369,69,30759,31653,34685,5,38,6,1,0,0,0,4,403,70,24648,28697,28103,1,-34,-1,6111,14,2956,6582,0,0,1,0,0
EUW1_6861251858',3,83,7,0,0,0,0,11,0,313,74,23994,27232,25961,2,59,9,1,0,3,0,1,399,122,30921,30222,24972,0,-86,-48,-6927,-2,-2990,989,-1,0,-3,0,10
EUW1_6861204561',3,39,19,1,0,0,0,7,1,346,77,30847,30640,38995,5,38,19,0,0,0,0,4,323,82,29270,29624,34981,1,23,-5,1577,0,1016,4014,1,0,0,0,3
EUW1_6860646239',5,23,13,0,0,0,0,13,0,301,89,27284,28272,31384,2,28,19,1,0,2,0,3,352,93,32229,30645,35659,0,-51,-4,-4945,-6,-2373,-4275,-1,0,-2,0,10
EUW1_6860612136',4,30,19,0,0,1,0,10,1,335,74,31336,29107,41753,3,29,14,2,0,1,0,8,336,62,29158,27637,33889,0,-1,12,2178,5,1470,7864,-2,0,0,0,2
EUW1_6860566048',5,26,5,0,0,1,0,3,0,358,90,24721,30156,28255,4,28,14,0,0,0,0,4,365,86,26065,31412,32041,0,-7,4,-1344,-9,-1256,-3786,0,0,1,0,-1
EUW1_6860525891',2,86,11,1,0,0,0,13,0,307,75,26307,27252,30505,2,29,14,0,0,6,0,4,369,103,32010,31553,38682,0,-62,-28,-5703,-3,-4301,-8177,1,0,-6,0,9
EUW1_6860457553',4,59,9,1,0,0,0,9,0,298,82,24391,27519,24782,3,59,16,0,0,1,0,0,380,102,30603,32104,42210,0,-82,-20,-6212,-7,-4585,-17428,1,0,-1,0,9
EUW1_6860396838',3,35,14,0,1,0,0,13,1,318,88,28395,28975,33980,8,34,17,2,0,4,0,2,384,75,31133,31368,41601,0,-66,13,-2738,-3,-2393,-7621,-2,1,-4,0,11
EUW1_6882931992',3,27,12,0,0,1,0,8,0,353,96,28218,29131,29736,2,30,17,1,0,1,0,6,338,68,29708,30062,28910,0,15,28,-1490,-5,-931,826,-1,0,0,0,2
EUW1_6882580390',1,52,15,2,0,1,0,6,0,364,94,29246,30153,29571,7,28,15,0,0,0,0,3,334,100,27348,30596,30300,1,30,-6,1898,0,-443,-729,2,0,1,0,3
EUW1_6882467829',2,26,14,0,0,0,0,10,1,383,98,28704,30436,37962,3,36,17,2,0,0,0,2,322,92,29660,30031,31669,0,61,6,-956,-3,405,6293,-2,0,0,0,8
EUW1_6881494700',3,30,11,0,0,1,0,13,1,307,78,26148,26924,27590,6,28,17,1,1,1,0,2,352,85,30637,29069,35800,0,-45,-7,-4489,-6,-2145,-8210,-1,-1,0,0,11
EUW1_6877136264',3,24,9,1,0,0,0,4,1,347,75,24993,27087,28930,7,35,12,0,0,0,0,4,299,120,26678,28604,42295,0,48,-45,-1685,-3,-1517,-13365,1,0,0,0,0
EUW1_6876833714',4,21,7,1,0,1,0,8,0,426,88,27906,29444,37782,5,32,16,1,1,1,0,8,333,104,28185,30781,32302,0,93,-16,-279,-9,-1337,5480,0,-1,0,0,0
EUW1_6875743060',6,28,13,0,0,1,0,9,1,371,109,28648,30131,36360,7,34,13,2,0,0,0,4,334,88,27310,29058,32232,1,37,21,1338,0,1073,4128,-2,0,1,0,5
EUW1_6875672982',6,33,14,0,0,1,0,9,1,374,80,29981,30090,29436,8,30,11,2,0,2,0,4,321,86,26833,28220,26761,1,53,-6,3148,3,1870,2675,-2,0,-1,0,5
EUW1_6875614418',5,96,25,2,1,2,0,6,1,359,90,33380,32136,53744,8,30,6,0,0,1,0,7,316,97,23875,26250,24575,1,43,-7,9505,19,5886,29169,2,1,1,0,-1
EUW1_6875477322',5,30,14,2,0,0,0,9,1,380,74,28065,30255,27503,5,25,5,0,0,2,0,4,377,98,24907,29093,24215,1,3,-24,3158,9,1162,3288,2,0,-2,0,5
EUW1_6875325170',5,63,13,0,0,0,0,5,0,362,72,26573,29992,29661,4,35,10,1,0,0,0,0,394,78,27031,28551,27683,1,-32,-6,-458,3,1441,1978,-1,0,0,0,5
EUW1_6874072837',4,29,9,0,0,1,0,6,0,430,110,29583,32219,27296,3,33,12,2,0,0,0,4,379,98,26925,30713,34571,1,51,12,2658,-3,1506,-7275,-2,0,1,0,2
EUW1_6874013511',2,30,5,2,0,0,0,14,0,328,118,23756,29099,28017,4,30,12,0,0,2,0,0,366,70,27091,29941,28784,0,-38,48,-3335,-7,-842,-767,2,0,-2,0,14
EUW1_6873742055',4,39,12,1,0,1,0,6,1,310,102,26954,29065,35498,2,28,13,0,0,1,0,5,379,68,28754,30009,28975,0,-69,34,-1800,-1,-944,6523,1,0,0,0,1
EUW1_6873703194',5,26,10,1,0,0,0,7,0,334,102,25735,28812,27796,5,32,10,1,0,1,0,0,344,80,26675,29060,26950,0,-10,22,-940,0,-248,846,0,0,-1,0,7
EUW1_6873693861',8,37,18,1,1,2,0,6,1,397,132,34025,34271,32210,2,25,8,0,0,1,0,12,362,44,24101,25930,18380,1,35,88,9924,10,8341,13830,1,1,1,0,-6
EUW1_6872525838',5,28,10,1,1,1,0,12,1,355,100,27535,29413,30749,5,26,12,1,0,1,0,1,351,84,28301,28707,30424,1,4,16,-766,-2,706,325,0,1,0,0,11
EUW1_6872437777',4,23,6,0,0,2,0,9,0,376,100,27434,29905,24748,3,20,13,2,0,1,0,6,376,104,29129,29911,32488,1,0,-4,-1695,-7,-6,-7740,-2,0,1,0,3
EUW1_6872392675',2,27,8,2,0,0,0,9,0,388,82,25202,28537,21163,6,33,8,0,0,2,0,3,443,100,26847,31578,23366,1,-55,-18,-1645,0,-3041,-2203,2,0,-2,0,6
EUW1_6882882718',5,32,14,2,1,1,0,7,0,367,91,29106,28673,36146,4,39,11,0,0,1,0,4,361,81,26624,29320,33049,1,6,10,2482,3,-647,3097,2,1,0,0,3
EUW1_6882715337',6,34,13,0,0,1,0,9,0,355,80,29000,30346,34294,8,32,16,1,1,1,0,5,350,80,30228,30485,34734,1,5,0,-1228,-3,-139,-440,-1,-1,0,0,4
EUW1_6882691542',2,23,13,1,0,0,0,10,1,343,85,27658,30447,41746,1,31,12,1,0,1,0,4,353,74,27038,30118,42374,0,-10,11,620,1,329,-628,0,0,-1,0,6
EUW1_6881993072',11,36,9,0,0,0,0,12,1,367,67,26175,27767,34093,3,29,18,1,0,2,0,6,409,100,32205,33103,29834,0,-42,-33,-6030,-9,-5336,4259,-1,0,-2,0,6
EUW1_6881922219',4,43,8,0,0,0,0,8,0,357,87,28051,27664,21467,6,42,18,2,0,3,0,9,263,108,28582,26476,35910,1,94,-21,-531,-10,1188,-14443,-2,0,-3,0,-1
EUW1_6881084750',9,37,11,0,0,1,0,7,0,399,106,29331,30292,36625,4,30,9,2,0,0,0,4,315,83,25281,27095,30444,1,84,23,4050,2,3197,6181,-2,0,1,0,3
EUW1_6881053656',3,135,14,2,0,1,0,2,1,409,107,29812,31480,29546,2,29,4,0,0,0,0,10,362,76,24574,28541,21648,1,47,31,5238,10,2939,7898,2,0,1,0,-8
EUW1_6880981279',0,36,11,1,0,0,0,10,1,348,92,27491,28570,25346,7,34,14,0,0,0,0,2,421,84,29008,30730,30044,0,-73,8,-1517,-3,-2160,-4698,1,0,0,0,8
EUW1_6880492574',2,20,11,0,0,0,0,16,0,264,88,25262,25550,28250,6,26,23,2,1,5,0,0,362,113,34793,31684,46399,0,-98,-25,-9531,-12,-6134,-18149,-2,-1,-5,0,16
EUW1_6880409862',4,32,11,1,0,0,0,7,1,379,79,27280,29793,34981,4,28,11,0,0,1,0,4,341,92,27115,29595,37404,1,38,-13,165,0,198,-2423,1,0,-1,0,3
EUW1_6880113534',2,29,14,0,0,0,0,12,0,327,68,27210,29166,35253,2,30,20,0,0,1,0,3,357,80,31234,29203,41376,0,-30,-12,-4024,-6,-37,-6123,0,0,-1,0,9
EUW1_6880064753',1,37,9,0,0,0,0,15,1,355,75,26523,27499,29220,2,26,16,2,0,2,0,4,414,108,32178,32342,31586,0,-59,-33,-5655,-7,-4843,-2366,-2,0,-2,0,11
EUW1_6879790851',7,29,8,0,0,1,0,8,1,368,70,26005,28244,33894,2,29,13,1,0,0,0,4,328,89,26369,28891,28061,0,40,-19,-364,-5,-647,5833,-1,0,1,0,4
EUW1_6879737809',2,22,7,1,0,0,0,8,0,392,106,26517,30205,28451,3,31,14,1,0,1,0,2,322,90,26946,29641,27893,1,70,16,-429,-7,564,558,0,0,-1,0,6
EUW1_6883705796',6,29,22,0,0,2,0,5,0,365,78,32741,32658,40442,4,24,14,1,0,0,0,9,351,96,27694,28078,31854,1,14,-18,5047,8,4580,8588,-1,0,2,0,-4
EUW1_6883670869',4,25,19,0,0,0,0,7,1,348,88,30368,29487,34828,7,26,15,2,1,0,0,6,350,96,28846,30859,33391,1,-2,-8,1522,4,-1372,1437,-2,-1,0,0,1
EUW1_6883135217',1,194,16,2,0,0,0,7,1,344,112,29867,29432,38372,2,24,14,0,0,1,0,6,342,74,27039,28682,34412,1,2,38,2828,2,750,3960,2,0,-1,0,1
EUW1_6882699117',6,46,6,1,1,0,0,8,0,409,122,25735,30472,26732,5,36,6,0,0,0,0,3,383,66,24064,28488,23550,1,26,56,1671,0,1984,3182,1,1,0,0,5
EUW1_6882327065',2,19,13,2,0,1,0,7,0,386,112,29905,29700,28908,5,26,12,0,0,1,0,5,366,88,27944,30063,25511,1,20,24,1961,1,-363,3397,2,0,0,0,2
EUW1_6881637001',2,25,11,0,0,1,0,10,1,352,100,27902,30340,29082,6,90,18,2,1,2,0,3,356,83,30856,30814,31222,0,-4,17,-2954,-7,-474,-2140,-2,-1,-1,0,7
EUW1_6879700330',0,18,14,0,1,1,0,11,0,331,76,28870,27435,35607,6,43,17,1,0,1,0,4,323,82,29134,27971,34308,0,8,-6,-264,-3,-536,1299,-1,1,0,0,7
EUW1_6879343077',5,24,16,1,0,0,0,7,1,375,90,28958,31682,42581,3,37,12,1,0,0,0,4,360,94,27001,30321,36750,1,15,-4,1957,4,1361,5831,0,0,0,0,3
EUW1_6879284094',2,52,11,1,0,2,0,9,1,339,52,26643,28839,36091,5,65,12,1,0,2,0,5,358,76,28157,30618,36569,0,-19,-24,-1514,-1,-1779,-478,0,0,0,0,4
EUW1_6876575140',2,26,13,0,0,1,0,13,0,315,90,27424,25889,33030,7,26,31,1,0,3,0,4,361,75,35471,32890,47824,0,-46,15,-8047,-18,-7001,-14794,-1,0,-2,0,9
EUW1_6876302739',3,28,17,0,0,2,0,5,1,361,90,29935,30032,31935,7,32,6,1,0,0,0,8,303,81,22791,25472,23851,1,58,9,7144,11,4560,8084,-1,0,2,0,-3
EUW1_6876208156',6,30,12,0,0,0,0,11,0,345,82,26746,28383,30214,4,31,10,2,0,3,0,4,370,81,27799,29985,31814,1,-25,1,-1053,2,-1602,-1600,-2,0,-3,0,7
EUW1_6875208577',4,74,11,2,0,0,0,12,0,314,94,26291,28124,28741,7,35,22,0,0,2,0,4,358,75,31998,32741,42484,1,-44,19,-5707,-11,-4617,-13743,2,0,-2,0,8
EUW1_6874787797',9,348,15,1,0,0,0,7,1,384,76,30025,30144,33123,4,34,8,1,0,1,0,7,345,88,24916,27894,27210,1,39,-12,5109,7,2250,5913,0,0,-1,0,0
EUW1_6873738693',7,35,17,0,0,1,0,12,0,356,72,30218,30551,35793,4,40,11,2,0,0,0,6,302,81,27038,27000,32507,1,54,-9,3180,6,3551,3286,-2,0,1,0,6
EUW1_6872584427',4,44,14,2,0,0,0,4,1,380,110,27574,31372,27717,3,30,9,0,0,0,0,6,325,87,24533,27660,25880,1,55,23,3041,5,3712,1837,2,0,0,0,-2
EUW1_6872552430',6,30,26,2,1,2,0,7,1,366,96,34816,32378,43439,6,35,8,0,0,1,0,7,340,86,25875,27491,30350,1,26,10,8941,18,4887,13089,2,1,1,0,0
EUW1_6871981004',3,37,9,0,0,0,0,7,1,357,91,25731,29565,31636,1,38,17,1,0,0,0,1,364,81,29825,30931,37477,0,-7,10,-4094,-8,-1366,-5841,-1,0,0,0,6
EUW1_6871915474',3,26,10,1,1,1,0,5,1,364,103,27596,28917,26932,2,117,9,0,0,0,0,9,314,112,24634,28165,27762,1,50,-9,2962,1,752,-830,1,1,1,0,-4
EUW1_6871179799',5,28,27,1,1,3,0,13,0,401,84,36250,32506,45345,5,27,14,0,0,1,0,10,310,71,28271,26520,28178,1,91,13,7979,13,5986,17167,1,1,2,0,3
EUW1_6883734838',1,23,12,0,0,0,0,10,1,313,98,27575,28859,26974,4,109,16,1,0,2,0,3,364,74,28866,29212,33540,0,-51,24,-1291,-4,-353,-6566,-1,0,-2,0,7
EUW1_6883293068',8,32,13,0,0,0,0,17,1,298,82,26369,26955,30501,5,29,24,1,1,3,0,0,358,141,35322,33552,43565,0,-60,-59,-8953,-11,-6597,-13064,-1,-1,-3,0,17
EUW1_6883246788',7,34,23,2,0,1,0,7,0,335,78,32265,29238,41084,4,24,10,0,0,0,0,8,352,86,27004,27621,30071,1,-17,-8,5261,13,1617,11013,2,0,1,0,-1
EUW1_6883162714',5,21,7,0,0,0,0,7,0,371,65,25460,29283,28301,3,41,17,1,0,0,0,0,324,101,27763,30097,33778,0,47,-36,-2303,-10,-814,-5477,-1,0,0,0,7
EUW1_6883100804',3,29,25,1,0,1,0,9,0,349,76,33340,31152,43108,5,29,20,0,0,0,0,7,343,76,30199,29704,42208,1,6,0,3141,5,1448,900,1,0,1,0,2
EUW1_6883010598',11,33,26,0,0,1,0,14,0,342,68,33974,29711,41616,3,44,28,1,0,1,0,5,324,94,36639,30156,45161,0,18,-26,-2665,-2,-445,-3545,-1,0,0,0,9
EUW1_6882778368',6,34,23,1,0,2,0,10,1,351,88,33793,31585,45304,3,36,13,1,0,1,0,6,328,76,27688,27163,34469,1,23,12,6105,10,4422,10835,0,0,1,0,4
EUW1_6882737351',3,29,14,0,0,2,0,14,0,329,80,30312,30119,29166,2,20,23,2,0,2,0,10,373,98,33094,33111,41426,0,-44,-18,-2782,-9,-2992,-12260,-2,0,0,0,4
EUW1_6882594929',3,21,15,0,0,0,0,12,0,326,80,29148,29223,38567,5,29,26,2,0,2,0,3,371,88,34486,32394,41200,0,-45,-8,-5338,-11,-3171,-2633,-2,0,-2,0,9
EUW1_6882531951',4,67,17,2,0,1,0,9,1,345,106,29786,32207,33282,4,59,8,0,0,1,0,6,321,85,25076,29339,24598,1,24,21,4710,9,2868,8684,2,0,0,0,3
EUW1_6882501689',1,24,17,0,0,1,0,15,1,311,71,29258,29018,37592,4,22,23,1,0,3,0,4,349,84,34079,31171,45958,0,-38,-13,-4821,-6,-2153,-8366,-1,0,-2,0,11
EUW1_6882466295',7,41,18,1,0,1,0,10,1,320,94,30677,27994,42118,3,44,24,1,0,2,0,4,365,65,33046,30506,44589,0,-45,29,-2369,-6,-2512,-2471,0,0,-1,0,6
EUW1_6882402435',7,31,11,1,1,1,0,4,0,355,84,26297,29181,30794,4,31,8,0,0,0,0,4,357,80,24701,27678,27214,1,-2,4,1596,3,1503,3580,1,1,1,0,0
EUW1_6882373251',8,44,18,0,1,1,0,6,0,350,80,31150,30304,31852,1,122,5,1,0,0,0,5,334,87,22940,25966,30095,1,16,-7,8210,13,4338,1757,-1,1,1,0,1
EUW1_6883634964',6,30,14,1,1,3,0,5,1,394,116,31024,31331,33449,2,31,10,1,0,1,0,9,352,77,26534,28450,22717,1,42,39,4490,4,2881,10732,0,1,2,0,-4
EUW1_6883609305',1,145,13,0,0,0,0,16,1,333,80,27138,28720,32941,6,33,20,2,1,2,0,4,315,118,32243,31520,37467,0,18,-38,-5105,-7,-2800,-4526,-2,-1,-2,0,12
EUW1_6883598586',4,27,16,1,0,1,0,10,1,385,96,29477,31977,33173,3,132,10,0,0,0,0,2,326,66,25649,27808,28336,1,59,30,3828,6,4169,4837,1,0,1,0,8
EUW1_6877875140',1,27,11,1,0,0,0,10,0,358,87,26745,31072,32397,4,135,14,1,0,1,0,3,378,98,29113,31289,31215,1,-20,-11,-2368,-3,-217,1182,0,0,-1,0,7
EUW1_6873803191',7,126,12,2,1,2,0,6,1,412,110,30390,32369,30673,2,96,5,0,0,1,0,8,359,77,23304,28596,19945,1,53,33,7086,7,3773,10728,2,1,1,0,-2
EUW1_6873793565',4,131,7,0,0,2,0,10,0,376,70,26091,27994,26097,4,32,11,1,0,1,0,3,372,84,26862,30025,27697,1,4,-14,-771,-4,-2031,-1600,-1,0,1,0,7
EUW1_6872271170',10,31,12,1,1,0,0,4,0,337,126,27303,30347,25499,4,31,9,1,0,1,0,2,396,86,27136,30289,25188,0,-59,40,167,3,58,311,0,1,-1,0,2
EUW1_6872255823',2,39,10,0,0,0,0,11,0,365,79,24910,28454,31035,5,34,14,1,0,1,0,1,379,104,29118,30894,29134,0,-14,-25,-4208,-4,-2440,1901,-1,0,-1,0,10
EUW1_6872232576',2,69,14,0,0,0,0,11,0,294,62,26209,30050,28844,4,62,11,1,0,1,0,5,337,83,26398,26731,31640,0,-43,-21,-189,3,3319,-2796,-1,0,-1,0,6
EUW1_6872198113',5,36,19,2,0,1,0,15,0,368,80,29954,29290,39876,4,31,16,0,1,2,0,5,338,104,31190,31654,33577,1,30,-24,-1236,3,-2364,6299,2,-1,-1,0,10
EUW1_6872170591',6,31,12,2,0,0,0,10,0,395,95,27181,30318,29517,0,56,10,0,0,1,0,3,383,104,28397,30983,33704,0,12,-9,-1216,2,-665,-4187,2,0,-1,0,7
EUW1_6871700079',7,32,11,0,0,0,0,8,0,365,70,26619,29208,26499,4,36,9,2,1,1,0,1,396,102,26646,29645,25681,0,-31,-32,-27,2,-437,818,-2,-1,-1,0,7
EUW1_6871636305',6,23,12,0,0,1,0,5,1,327,86,27175,26526,35562,6,43,14,2,0,2,0,4,351,72,28714,28748,32748,1,-24,14,-1539,-2,-2222,2814,-2,0,-1,0,1
EUW1_6871579473',5,30,15,2,0,1,0,3,1,366,83,29717,30788,33503,1,25,7,0,0,0,0,5,343,100,24823,28429,29767,0,23,-17,4894,8,2359,3736,2,0,1,0,-2
EUW1_6871418513',5,41,6,0,0,0,0,9,1,378,78,25454,28923,28665,5,26,12,1,0,0,0,4,373,98,27100,30106,25881,0,5,-20,-1646,-6,-1183,2784,-1,0,0,0,5
EUW1_6871365674',8,140,10,2,0,1,0,6,1,378,96,27393,29358,28329,3,45,14,0,0,0,0,4,355,82,27215,29293,23690,0,23,14,178,-4,65,4639,2,0,1,0,2
EUW1_6870910800',0,30,11,0,0,3,0,8,1,352,84,28072,26735,22979,2,31,13,2,0,0,0,6,251,104,25398,23507,21286,1,101,-20,2674,-2,3228,1693,-2,0,3,0,2
EUW1_6870888788',3,30,5,1,0,0,0,10,0,365,76,23176,27822,33565,4,27,13,0,1,1,0,2,342,52,26831,29679,34853,1,23,24,-3655,-8,-1857,-1288,1,-1,-1,0,8
EUW1_6882241403',5,37,12,0,0,0,0,9,0,335,82,27283,27340,40588,0,24,30,1,0,3,0,3,320,66,33953,31696,47838,0,15,16,-6670,-18,-4356,-7250,-1,0,-3,0,6
EUW1_6882107011',1,42,21,2,0,2,0,11,1,377,115,31876,35011,36205,2,24,7,0,0,0,0,4,352,92,23932,28186,24535,1,25,23,7944,14,6825,11670,2,0,2,0,7
EUW1_6882064737',3,32,13,0,1,1,0,6,1,392,132,30397,33718,29108,4,107,13,2,0,1,0,5,367,76,27540,31243,32764,0,25,56,2857,0,2475,-3656,-2,1,0,0,1
EUW1_6880561957',2,27,5,0,0,0,0,8,0,375,108,25550,30682,29625,7,36,17,2,0,1,0,4,357,100,27751,30793,31380,0,18,8,-2201,-12,-111,-1755,-2,0,-1,0,4
EUW1_6880156719',5,29,12,0,0,0,0,7,0,393,74,28631,29968,31157,3,27,16,0,0,0,0,2,359,105,28500,30486,31162,0,34,-31,131,-4,-518,-5,0,0,0,0,5
EUW1_6879188674',4,65,13,0,0,0,0,9,0,302,88,27081,28572,37043,4,87,13,2,0,0,0,3,332,74,26091,26785,43004,0,-30,14,990,0,1787,-5961,-2,0,0,0,6
EUW1_6876123783',2,29,5,1,0,0,0,6,1,374,80,24689,28165,28117,2,52,15,1,0,1,0,5,357,103,28452,30844,31123,1,17,-23,-3763,-10,-2679,-3006,0,0,-1,0,1
EUW1_6874954832',0,20,14,0,0,0,0,17,0,248,60,25753,24865,30218,2,31,26,1,1,7,2,2,352,87,38434,30831,44722,0,-104,-27,-12681,-12,-5966,-14504,-1,-1,-7,-2,15
EUW1_6874925642',6,62,15,1,1,0,0,4,1,316,67,26903,28267,32980,3,27,10,0,0,1,0,0,344,104,26755,29619,27539,1,-28,-37,148,5,-1352,5441,1,1,-1,0,4
EUW1_6874756260',3,25,24,0,1,2,0,7,0,360,104,34249,31022,44006,5,56,17,2,0,0,0,8,279,69,28631,25998,37970,1,81,35,5618,7,5024,6036,-2,1,2,0,-1
EUW1_6873644175',2,44,16,0,0,0,0,13,1,330,93,28378,31326,35840,3,22,9,1,0,2,0,2,333,75,25934,28111,31853,1,-3,18,2444,7,3215,3987,-1,0,-2,0,11
EUW1_6873563183',0,30,10,0,0,0,0,12,0,325,106,24949,29545,35017,3,32,15,1,0,2,0,3,395,97,29966,32126,36074,0,-70,9,-5017,-5,-2581,-1057,-1,0,-2,0,9
EUW1_6873276078',5,27,22,0,1,3,0,7,0,317,102,32959,29781,41572,1,24,13,2,0,0,0,6,311,77,26229,26310,30020,1,6,25,6730,9,3471,11552,-2,1,3,0,1
EUW1_6873162437',5,38,15,0,0,2,0,9,1,315,102,28522,30605,33513,1,25,14,1,0,2,0,8,330,101,28890,29708,39506,0,-15,1,-368,1,897,-5993,-1,0,0,0,1
EUW1_6872110040',2,104,12,1,1,0,0,6,1,346,94,25293,28965,29408,6,33,9,1,0,0,0,3,386,114,26650,31465,28476,0,-40,-20,-1357,3,-2500,932,0,1,0,0,3
EUW1_6869100979',2,28,6,0,0,0,0,12,0,355,110,24023,29061,27422,6,32,19,2,1,1,0,0,398,106,32149,33979,32650,0,-43,4,-8126,-13,-4918,-5228,-2,-1,-1,0,12
EUW1_6868912527',5,28,11,0,0,0,0,12,1,350,87,27140,29431,28632,4,272,9,2,0,1,0,5,355,124,27456,29436,38107,0,-5,-37,-316,2,-5,-9475,-2,0,-1,0,7
EUW1_6868718590',4,35,12,0,0,2,0,11,1,369,100,29878,28890,34451,5,24,17,2,0,1,0,8,379,93,31703,31703,32038,1,-10,7,-1825,-5,-2813,2413,-2,0,1,0,3
EUW1_6882191782',6,99,12,1,0,1,0,4,1,379,74,28420,29108,26406,6,35,8,1,0,0,0,6,309,98,24455,26679,22838,1,70,-24,3965,4,2429,3568,0,0,1,0,-2
EUW1_6882172478',5,30,21,1,0,4,0,8,0,381,96,33300,31894,46270,5,30,11,0,0,0,0,8,291,62,24040,24991,33517,1,90,34,9260,10,6903,12753,1,0,4,0,0
EUW1_6878204303',2,25,19,1,0,3,0,7,1,373,110,33417,33995,41242,6,31,12,0,0,0,0,8,312,86,25289,28010,42974,1,61,24,8128,7,5985,-1732,1,0,3,0,-1
EUW1_6878176523',7,48,16,1,0,0,0,10,1,333,94,27909,30452,31390,3,99,10,0,0,1,0,1,343,78,26398,28284,27194,1,-10,16,1511,6,2168,4196,1,0,-1,0,9
EUW1_6877800412',3,32,15,0,1,0,0,11,0,336,96,27654,29907,34128,0,26,13,1,0,1,0,1,407,67,29796,29993,34910,1,-71,29,-2142,2,-86,-782,-1,1,-1,0,10
EUW1_6876491809',3,27,15,0,0,0,0,6,0,380,108,33230,31290,34445,4,46,14,1,0,3,0,8,353,76,27972,29174,32146,1,27,32,5258,1,2116,2299,-1,0,-3,0,-2
EUW1_6875087524',3,21,11,0,0,0,0,12,1,338,89,27941,28491,32515,2,24,15,2,0,2,0,1,342,96,29008,29777,33824,0,-4,-7,-1067,-4,-1286,-1309,-2,0,-2,0,11
EUW1_6875057204',2,33,17,0,0,1,0,5,0,377,89,31744,31315,37479,5,29,10,1,0,1,0,10,305,90,24932,27708,27151,0,72,-1,6812,7,3607,10328,-1,0,0,0,-5
EUW1_6875052791',4,25,8,1,0,0,0,15,1,321,84,25237,25435,30242,3,33,22,1,1,1,0,2,361,106,33855,32567,41045,0,-40,-22,-8618,-14,-7132,-10803,0,-1,-1,0,13
EUW1_6875041956',4,41,18,1,0,1,0,10,1,342,70,29795,29476,32250,3,23,11,1,0,0,0,5,358,74,26047,27983,29114,1,-16,-4,3748,7,1493,3136,0,0,1,0,5
EUW1_6875034887',0,18,7,0,0,0,0,17,0,287,40,21149,23440,20059,5,25,20,2,1,6,0,0,424,140,38028,35997,33936,0,-137,-100,-16879,-13,-12557,-13877,-2,-1,-6,0,17
EUW1_6873765088',7,32,16,2,0,5,0,7,1,370,128,33268,32564,33719,3,23,6,0,0,0,0,11,363,86,24431,28798,19714,1,7,42,8837,10,3766,14005,2,0,5,0,-4
EUW1_6873752297',5,33,11,1,0,0,0,13,0,353,102,27079,28914,26466,8,28,15,1,0,1,0,2,362,82,28685,30123,31188,0,-9,20,-1606,-4,-1209,-4722,0,0,-1,0,11
EUW1_6873745394',3,29,21,2,0,1,0,7,0,331,78,32235,30559,41286,7,29,14,0,0,0,0,7,324,70,27866,27331,34691,0,7,8,4369,7,3228,6595,2,0,1,0,0
EUW1_6872492045',2,140,21,1,1,1,0,10,1,393,112,32540,34033,36346,11,31,6,1,0,1,0,4,361,72,24941,27652,31315,1,32,40,7599,15,6381,5031,0,1,0,0,6
EUW1_6872385470',3,25,13,0,0,0,0,8,0,339,67,26300,28878,27927,4,28,13,2,0,1,0,1,341,97,27369,30079,33730,0,-2,-30,-1069,0,-1201,-5803,-2,0,-1,0,7
EUW1_6872363342',4,27,16,2,0,2,0,4,1,392,81,30882,29937,39379,6,29,10,0,0,0,0,11,317,71,25314,28115,31782,0,75,10,5568,6,1822,7597,2,0,2,0,-7
EUW1_6871095954',6,116,19,1,0,2,0,14,0,381,82,32157,32388,33082,2,26,5,1,1,1,0,8,396,101,26463,30358,39658,1,-15,-19,5694,14,2030,-6576,0,-1,1,0,6
EUW1_6871078704',3,24,8,1,0,1,0,5,1,395,84,25899,29994,23660,4,98,10,1,1,1,0,3,403,128,28216,33928,29442,0,-8,-44,-2317,-2,-3934,-5782,0,-1,0,0,2
EUW1_6883225152',3,29,15,1,0,0,0,15,0,281,71,26425,27516,38511,5,34,26,0,1,3,0,1,355,132,36116,34128,47886,0,-74,-61,-9691,-11,-6612,-9375,1,-1,-3,0,14
EUW1_6882672585',4,237,17,2,0,1,0,13,0,381,85,31320,31779,40718,0,43,11,0,0,1,0,7,338,89,26786,28568,33976,0,43,-4,4534,6,3211,6742,2,0,0,0,6
EUW1_6882618985',6,30,16,1,0,1,0,12,0,335,85,29165,29941,35294,6,33,13,1,0,2,0,5,356,97,29389,30417,35181,0,-21,-12,-224,3,-476,113,0,0,-1,0,7
EUW1_6881572750',6,28,15,2,1,0,0,9,0,350,100,28314,29252,38647,3,290,11,0,0,0,0,2,342,116,27842,29643,37507,1,8,-16,472,4,-391,1140,2,1,0,0,7
EUW1_6881484465',6,36,8,0,0,1,0,14,1,364,104,27665,28116,31069,2,77,20,2,0,3,0,5,403,107,33226,31763,38505,0,-39,-3,-5561,-12,-3647,-7436,-2,0,-2,0,9
EUW1_6881277434',3,31,8,0,0,0,0,16,0,291,105,25364,28291,29322,6,28,18,1,1,2,0,3,376,94,31024,29969,39049,0,-85,11,-5660,-10,-1678,-9727,-1,-1,-2,0,13
EUW1_6881124664',4,32,10,1,0,0,0,10,1,386,82,26468,31162,29374,6,31,16,1,0,0,0,3,383,99,29557,31193,34252,1,3,-17,-3089,-6,-31,-4878,0,0,0,0,7
EUW1_6880477477',4,27,16,1,0,2,0,6,0,412,62,30851,30628,28382,4,54,10,1,1,0,0,7,347,132,26798,31806,29915,1,65,-70,4053,6,-1178,-1533,0,-1,2,0,-1
EUW1_6880397173',6,24,12,0,0,3,0,8,0,405,114,30988,30986,27019,3,25,8,1,0,0,0,8,347,97,25183,26599,28080,1,58,17,5805,4,4387,-1061,-1,0,3,0,0
EUW1_6880357591',4,25,14,0,1,0,0,6,1,416,104,29298,32117,31639,1,26,4,1,0,1,0,3,393,104,24425,28857,23797,1,23,0,4873,10,3260,7842,-1,1,-1,0,3
EUW1_6880282482',2,26,6,0,0,0,0,8,0,362,82,24493,28325,33585,8,31,10,1,0,1,0,0,375,100,27414,30044,32274,0,-13,-18,-2921,-4,-1719,1311,-1,0,-1,0,8
EUW1_6880191026',3,30,11,2,0,1,0,7,1,361,80,27789,28234,34294,4,100,12,0,0,1,0,7,332,88,27384,29454,37084,0,29,-8,405,-1,-1220,-2790,2,0,0,0,0
EUW1_6879654087',10,34,7,1,0,0,0,6,1,368,100,25325,29364,29510,4,25,12,1,0,0,0,2,376,81,27250,30372,28472,0,-8,19,-1925,-5,-1008,1038,0,0,0,0,4
EUW1_6879062186',6,32,9,0,0,0,0,5,1,329,98,26169,28242,23865,2,24,14,1,0,0,0,3,350,79,27120,29116,32371,0,-21,19,-951,-5,-874,-8506,-1,0,0,0,2
EUW1_6878881759',5,27,13,0,0,0,0,14,0,361,84,28049,29881,34472,2,24,14,2,1,3,0,5,434,106,31931,31932,36856,1,-73,-22,-3882,-1,-2051,-2384,-2,-1,-3,0,9
EUW1_6878819349',6,28,8,0,0,1,0,8,0,375,101,26068,28194,26508,8,34,21,2,0,2,0,4,367,94,31380,33017,34704,0,8,7,-5312,-13,-4823,-8196,-2,0,-1,0,4
EUW1_6871606432',5,29,17,0,0,1,0,5,1,319,76,29037,31056,39422,5,33,11,2,0,1,0,3,356,91,27318,29622,32249,1,-37,-15,1719,6,1434,7173,-2,0,0,0,2
EUW1_6866960647',2,18,15,0,0,0,0,7,1,356,93,28096,29716,32741,2,30,10,0,0,0,0,1,350,54,25173,26989,33734,1,6,39,2923,5,2727,-993,0,0,0,0,6
EUW1_6866895124',0,23,11,0,0,1,0,7,0,390,84,29361,30543,35026,2,28,16,1,0,1,0,5,354,112,29768,31657,40017,1,36,-28,-407,-5,-1114,-4991,-1,0,0,0,2
EUW1_6866813657',4,38,12,1,0,0,0,9,1,323,83,25880,28736,41002,5,27,10,1,0,0,0,2,358,83,26583,29021,36335,1,-35,0,-703,2,-285,4667,0,0,0,0,7
EUW1_6866183598',5,25,17,0,0,1,0,7,1,385,113,31014,33652,31360,2,28,9,1,0,0,0,3,357,96,24210,28013,26619,1,28,17,6804,8,5639,4741,-1,0,1,0,4
EUW1_6863379851',1,34,15,0,0,0,0,12,0,309,68,29146,28385,31652,6,24,21,1,1,2,0,2,401,103,32865,33417,40281,0,-92,-35,-3719,-6,-5032,-8629,-1,-1,-2,0,10
EUW1_6863360971',7,31,32,0,0,3,0,6,1,404,133,37680,36693,49574,0,31,9,2,0,0,0,12,281,78,23094,26844,33416,1,123,55,14586,23,9849,16158,-2,0,3,0,-6
EUW1_6863332648',0,23,13,0,0,0,0,14,0,337,68,26258,29443,32317,0,27,15,1,0,3,0,2,404,111,31302,32695,34790,0,-67,-43,-5044,-2,-3252,-2473,-1,0,-3,0,12
EUW1_6863305903',2,23,14,0,0,1,0,8,1,420,116,31933,33355,34174,5,89,11,1,0,1,0,7,401,86,27824,32291,31372,1,19,30,4109,3,1064,2802,-1,0,0,0,1
EUW1_6862038927',2,29,5,2,0,1,0,9,1,384,93,25882,28406,28488,6,28,10,0,0,1,0,6,362,74,26842,30174,29431,0,22,19,-960,-5,-1768,-943,2,0,0,0,3
EUW1_6862012852',2,25,20,1,0,0,0,12,0,299,101,30201,30299,40599,3,35,20,1,0,0,0,1,340,75,32069,30135,46375,0,-41,26,-1868,0,164,-5776,0,0,0,0,11
EUW1_6861999092',5,22,16,0,0,3,0,14,1,323,100,30714,28582,32530,6,27,16,2,0,2,0,6,321,94,30463,30153,43165,0,2,6,251,0,-1571,-10635,-2,0,1,0,8
EUW1_6861987060',5,35,9,2,0,1,0,7,1,359,95,26600,28459,26949,5,23,7,0,0,0,0,4,305,76,23503,26700,26851,1,54,19,3097,2,1759,98,2,0,1,0,3
EUW1_6861974632',4,30,14,1,0,1,0,14,0,327,95,28612,29414,28656,4,29,12,1,0,1,0,1,380,92,28407,29561,30365,1,-53,3,205,2,-147,-1709,0,0,0,0,13
EUW1_6861944549',1,25,13,0,0,1,0,12,0,337,83,29435,28581,25548,3,22,21,2,0,1,0,6,350,103,30714,30497,33250,0,-13,-20,-1279,-8,-1916,-7702,-2,0,0,0,6
EUW1_6882028201',6,33,14,0,0,0,0,8,0,389,100,28554,32319,30468,3,34,11,1,0,0,0,2,350,98,26815,28410,27200,1,39,2,1739,3,3909,3268,-1,0,0,0,6
EUW1_6878171901',2,39,9,0,0,1,0,9,1,385,90,27243,30387,28549,5,22,12,1,0,1,0,2,355,96,28011,30008,29301,1,30,-6,-768,-3,379,-752,-1,0,0,0,7
EUW1_6875364600',6,38,9,1,0,0,0,11,1,348,92,24952,28095,31795,2,58,8,1,0,1,0,0,357,88,26297,28934,40076,0,-9,4,-1345,1,-839,-8281,0,0,-1,0,11
EUW1_6875224771',5,31,4,0,0,0,0,11,0,350,102,23465,27495,21018,5,30,13,1,0,2,0,3,381,94,28984,31333,35067,0,-31,8,-5519,-9,-3838,-14049,-1,0,-2,0,8
EUW1_6875191912',4,24,16,2,0,2,0,10,1,361,91,29306,30401,34187,0,26,9,0,0,2,0,4,298,96,25500,27015,25180,0,63,-5,3806,7,3386,9007,2,0,0,0,6
EUW1_6872625586',0,21,15,0,0,0,0,17,1,264,85,27488,27209,25979,5,27,26,1,1,4,0,1,395,123,37484,34129,43875,0,-131,-38,-9996,-11,-6920,-17896,-1,-1,-4,0,16
EUW1_6883251638',5,30,12,1,0,0,0,10,0,353,101,26831,29583,32283,2,22,15,0,0,0,0,3,337,98,28918,30873,30397,0,16,3,-2087,-3,-1290,1886,1,0,0,0,7
EUW1_6881807208',2,27,7,1,0,0,0,10,0,308,91,24076,26929,28460,3,133,14,1,0,2,0,2,364,79,29223,28540,30425,1,-56,12,-5147,-7,-1611,-1965,0,0,-2,0,8
EUW1_6881747203',5,31,5,0,0,0,0,10,0,366,74,23489,27122,21677,5,34,10,2,0,0,0,2,413,80,27266,32089,33395,0,-47,-6,-3777,-5,-4967,-11718,-2,0,0,0,8
EUW1_6876622657',5,27,12,2,0,1,0,10,1,363,99,27538,31936,27736,8,74,3,0,0,1,0,2,414,109,24795,29852,23953,1,-51,-10,2743,9,2084,3783,2,0,0,0,8
EUW1_6875924321',3,29,15,0,0,1,0,13,0,349,74,29158,30327,37004,3,30,16,1,0,0,0,1,350,74,27483,29224,31629,1,-1,0,1675,-1,1103,5375,-1,0,1,0,12
EUW1_6875872004',7,34,16,2,1,0,0,5,1,338,90,28804,29665,31328,4,84,7,0,0,1,0,4,356,98,25203,29394,27926,1,-18,-8,3601,9,271,3402,2,1,-1,0,1
EUW1_6875750799',6,242,20,1,0,2,0,4,1,369,97,32133,32871,42805,4,32,11,0,0,0,0,7,296,94,25106,27480,35703,1,73,3,7027,9,5391,7102,1,0,2,0,-3
EUW1_6875690857',6,29,13,1,0,1,0,11,0,340,75,26560,29301,30356,4,49,20,1,0,1,0,2,355,72,31144,29599,38048,0,-15,3,-4584,-7,-298,-7692,0,0,0,0,9
EUW1_6875549994',3,33,9,0,0,0,0,7,1,373,90,27299,29749,25833,4,28,15,2,0,1,0,4,377,86,27170,30130,30755,1,-4,4,129,-6,-381,-4922,-2,0,-1,0,3
EUW1_6875485170',5,27,18,2,1,0,0,6,1,369,80,29429,32535,34523,6,40,13,0,0,0,0,2,397,94,26768,30594,33991,0,-28,-14,2661,5,1941,532,2,1,0,0,4
EUW1_6875336635',3,24,5,1,0,0,0,6,0,372,104,24226,29094,27707,5,24,6,1,0,0,0,1,393,80,24189,29397,24064,1,-21,24,37,-1,-303,3643,0,0,0,0,5
EUW1_6875213042',4,29,13,1,0,0,0,16,0,300,86,26552,27959,37579,6,35,21,1,0,3,0,0,379,82,34243,30340,45489,0,-79,4,-7691,-8,-2381,-7910,0,0,-3,0,16
EUW1_6874495554',2,23,11,0,1,1,0,4,1,378,80,27953,29454,34691,3,21,13,2,0,0,0,9,326,88,27331,28506,29090,1,52,-8,622,-2,948,5601,-2,1,1,0,-5
EUW1_6874136231',3,25,5,0,0,0,0,8,0,366,69,23829,27999,24378,6,27,10,2,0,1,0,1,420,106,27752,31469,35562,0,-54,-37,-3923,-5,-3470,-11184,-2,0,-1,0,7
EUW1_6874091376',4,40,9,0,0,0,0,11,1,362,94,25608,27820,28222,4,31,13,1,0,2,0,1,342,86,27708,27675,27861,1,20,8,-2100,-4,145,361,-1,0,-2,0,10
EUW1_6874044146',4,26,17,1,0,1,0,14,1,360,92,29923,29636,37607,7,41,17,0,0,0,0,2,367,68,29589,30457,37621,0,-7,24,334,0,-821,-14,1,0,1,0,12
EUW1_6874000911',8,32,19,0,0,0,0,5,1,337,82,28710,30995,48616,3,24,14,1,1,0,0,4,354,82,28740,29433,39759,0,-17,0,-30,5,1562,8857,-1,-1,0,0,1
EUW1_6873969851',4,63,19,2,0,0,0,12,1,274,98,29020,29768,36304,0,57,12,0,0,2,0,2,327,71,26406,26267,30829,1,-53,27,2614,7,3501,5475,2,0,-2,0,10
EUW1_6883312610',5,265,25,1,0,1,0,7,0,323,84,31913,31468,47566,2,30,15,0,0,0,0,6,306,100,27494,29441,42767,1,17,-16,4419,10,2027,4799,1,0,1,0,1
EUW1_6882959344',1,58,11,1,0,0,0,11,1,357,98,27125,29512,30156,5,65,17,1,0,3,0,1,398,72,30961,31304,32949,0,-41,26,-3836,-6,-1792,-2793,0,0,-3,0,10
EUW1_6882881351',2,24,15,1,0,1,0,12,1,334,94,29277,29851,37141,4,28,11,0,0,0,0,2,364,74,26483,28985,32712,0,-30,20,2794,4,866,4429,1,0,1,0,10
EUW1_6882674331',9,59,10,0,0,0,0,9,1,379,91,26854,29012,25399,4,25,8,1,0,1,0,1,353,88,25043,26367,23510,1,26,3,1811,2,2645,1889,-1,0,-1,0,8
EUW1_6882634282',6,32,13,1,0,1,0,9,1,391,92,28856,30894,30961,4,41,8,1,0,1,0,2,355,86,25184,29173,24592,1,36,6,3672,5,1721,6369,0,0,0,0,7
EUW1_6882618830',9,32,20,0,0,2,0,6,0,394,94,32477,32399,35808,8,33,10,1,0,0,0,5,381,74,26252,28158,30612,1,13,20,6225,10,4241,5196,-1,0,2,0,1
EUW1_6882581968',6,25,15,0,0,3,0,4,1,376,78,31949,29493,34870,1,25,9,2,0,0,0,10,325,97,25656,28460,32625,1,51,-19,6293,6,1033,2245,-2,0,3,0,-6
EUW1_6882017330',5,33,17,0,0,0,0,10,1,362,81,29212,31444,34816,3,27,11,2,0,1,0,4,371,94,26692,29104,33248,1,-9,-13,2520,6,2340,1568,-2,0,-1,0,6
EUW1_6881962034',4,31,19,2,0,1,0,5,1,366,84,30557,31685,35614,3,20,9,0,1,1,0,8,355,89,25793,28867,29075,1,11,-5,4764,10,2818,6539,2,-1,0,0,-3
EUW1_6880582813',3,31,10,0,0,0,0,8,1,365,108,27087,29970,31582,9,31,9,2,0,0,0,1,382,88,25731,29227,30663,0,-17,20,1356,1,743,919,-2,0,0,0,7
EUW1_6880525422',3,82,11,0,0,0,0,8,0,356,97,26164,28794,33222,4,51,6,2,0,1,0,4,357,79,25690,27767,34080,0,-1,18,474,5,1027,-858,-2,0,-1,0,4
EUW1_6880267108',5,29,13,0,0,1,0,6,1,388,88,29396,30514,30399,3,42,14,1,0,0,0,1,384,75,26980,30984,33170,0,4,13,2416,-1,-470,-2771,-1,0,1,0,5
EUW1_6880219862',4,82,13,0,0,1,0,6,1,348,57,28036,29610,31037,0,23,16,1,0,1,0,4,379,123,29861,32759,38485,0,-31,-66,-1825,-3,-3149,-7448,-1,0,0,0,2
EUW1_6879688212',1,27,19,1,0,0,0,15,1,329,69,29657,28986,40913,2,23,19,0,0,3,0,3,358,104,33896,32763,40517,1,-29,-35,-4239,0,-3777,396,1,0,-3,0,12
EUW1_6879646695',5,33,15,0,0,1,0,8,1,412,97,30102,32026,35457,2,32,11,1,0,0,0,4,357,84,26846,30840,32022,1,55,13,3256,4,1186,3435,-1,0,1,0,4
EUW1_6878695132',3,65,9,2,0,0,0,10,0,398,99,25957,29814,26028,6,26,10,0,1,1,0,3,440,88,28627,30578,21314,0,-42,11,-2670,-1,-764,4714,2,-1,-1,0,7
EUW1_6878651387',2,25,10,0,0,0,0,9,1,369,86,26801,28972,28934,5,62,16,1,0,2,0,0,375,88,29117,30345,35858,0,-6,-2,-2316,-6,-1373,-6924,-1,0,-2,0,9
EUW1_6861428419',6,26,16,1,0,2,0,7,0,399,106,31998,32341,36729,4,28,9,0,0,0,0,6,416,90,28008,30502,30700,1,-17,16,3990,7,1839,6029,1,0,2,0,1
EUW1_6861388355',3,29,19,2,0,0,0,14,1,323,87,30832,29333,36146,4,36,20,0,0,2,0,5,316,73,30730,30187,38252,1,7,14,102,-1,-854,-2106,2,0,-2,0,9
EUW1_6861344266',3,29,11,1,1,1,0,8,0,376,96,28047,30900,24977,7,29,5,0,0,0,0,7,393,94,24981,29688,23708,1,-17,2,3066,6,1212,1269,1,1,1,0,1
EUW1_6861310679',1,66,9,2,0,0,0,7,0,397,87,25977,29905,30141,2,26,12,0,0,1,0,3,385,100,29136,31468,30562,0,12,-13,-3159,-3,-1563,-421,2,0,-1,0,4
EUW1_6861275900',6,32,16,1,0,5,0,4,1,396,93,35164,33121,42515,2,50,6,0,0,0,0,12,347,70,23240,26467,19629,1,49,23,11924,10,6654,22886,1,0,5,0,-8
EUW1_6861195960',3,33,20,1,1,1,0,10,1,309,97,31285,30818,48395,3,31,18,1,0,2,0,8,327,70,29761,29604,35727,1,-18,27,1524,2,1214,12668,0,1,-1,0,2
EUW1_6861138199',3,202,11,2,0,1,0,12,1,389,74,27448,31700,31738,5,32,10,0,0,0,0,2,401,78,27367,30337,26272,1,-12,-4,81,1,1363,5466,2,0,1,0,10
EUW1_6861102420',5,35,16,2,0,1,0,14,1,356,92,31422,29006,40420,0,57,13,0,1,2,0,6,373,79,29662,28603,33188,1,-17,13,1760,3,403,7232,2,-1,-1,0,8
EUW1_6861067105',8,28,5,0,0,0,0,3,1,387,66,24863,28647,18253,5,47,7,2,0,0,0,5,375,120,25792,30863,24595,1,12,-54,-929,-2,-2216,-6342,-2,0,0,0,-2
EUW1_6861036178',2,26,23,0,0,1,0,12,1,329,87,32011,31252,44656,0,39,17,2,0,0,0,5,325,88,28656,29080,40525,1,4,-1,3355,6,2172,4131,-2,0,1,0,7
EUW1_6861006553',3,29,18,0,1,3,0,7,1,343,101,32698,31209,39818,6,31,10,1,0,0,0,10,311,110,26274,29125,28100,0,32,-9,6424,8,2084,11718,-1,1,3,0,-3
EUW1_6860970103',2,24,21,2,0,0,0,6,1,360,102,32825,31739,41380,4,29,18,0,0,1,0,9,325,94,30046,31111,37044,1,35,8,2779,3,628,4336,2,0,-1,0,-3
EUW1_6860932410',2,34,13,0,0,3,0,13,1,374,110,31687,29056,44043,6,44,20,2,0,0,0,8,302,80,29390,28256,34688,0,72,30,2297,-7,800,9355,-2,0,3,0,5
EUW1_6860690040',4,25,21,0,1,1,0,9,1,351,84,31579,31865,34834,4,32,11,1,0,1,0,6,370,99,28750,29378,27682,1,-19,-15,2829,10,2487,7152,-1,1,0,0,3
EUW1_6860667398',2,31,16,2,0,0,0,13,0,324,90,29056,30548,36931,5,23,19,0,0,2,0,3,356,82,31980,30270,42396,0,-32,8,-2924,-3,278,-5465,2,0,-2,0,10
EUW1_6860642454',7,34,21,0,1,3,0,6,1,381,78,34567,29643,33656,7,33,14,2,0,1,0,10,301,102,27107,28157,28693,1,80,-24,7460,7,1486,4963,-2,1,2,0,-4
EUW1_6860616153',2,26,14,0,0,0,0,16,0,335,78,28331,27616,41832,2,211,24,2,0,1,0,3,303,91,31850,30010,45479,0,32,-13,-3519,-10,-2394,-3647,-2,0,-1,0,13
EUW1_6860203501',2,31,19,1,1,1,0,6,1,355,99,32335,30881,37892,2,29,7,1,0,1,0,4,359,84,26801,28249,27214,0,-4,15,5534,12,2632,10678,0,1,0,0,2
EUW1_6882825128',5,28,15,0,0,0,0,13,1,322,90,26878,27927,40691,8,28,23,2,0,2,0,0,374,82,31916,32150,41236,0,-52,8,-5038,-8,-4223,-545,-2,0,-2,0,13
EUW1_6882695803',4,30,10,0,0,1,0,11,0,345,104,27377,28655,31764,3,34,15,1,0,1,0,0,362,100,29716,29431,31574,0,-17,4,-2339,-5,-776,190,-1,0,0,0,11
EUW1_6881607865',2,78,18,1,0,0,0,8,1,368,82,29847,30745,40184,4,31,6,0,0,1,0,2,321,102,24311,27019,26090,1,47,-20,5536,12,3726,14094,1,0,-1,0,6
EUW1_6880360164',0,21,17,1,0,4,0,7,1,388,80,32918,31908,37078,6,29,13,1,0,0,0,8,307,88,26679,27932,34350,1,81,-8,6239,4,3976,2728,0,0,4,0,-1
EUW1_6880304813',3,39,15,0,0,0,0,13,0,303,85,27359,26855,37400,6,42,25,2,0,3,0,1,371,74,34712,30636,43137,0,-68,11,-7353,-10,-3781,-5737,-2,0,-3,0,12
EUW1_6880090400',1,30,17,1,1,1,0,11,1,371,103,31363,31002,35861,6,83,17,1,0,1,0,5,369,71,31194,29737,38535,1,2,32,169,0,1265,-2674,0,1,0,0,6
EUW1_6878045889',7,31,8,1,1,0,0,9,0,345,77,24776,28173,31972,2,97,21,0,0,2,0,3,355,94,32262,32970,42690,0,-10,-17,-7486,-13,-4797,-10718,1,1,-2,0,6
EUW1_6868144823',7,28,12,0,0,0,0,8,1,347,88,26291,28913,37414,5,34,14,1,0,0,0,2,367,94,28461,33751,35806,0,-20,-6,-2170,-2,-4838,1608,-1,0,0,0,6
EUW1_6867849184',5,28,16,1,0,1,0,9,1,337,89,30565,28492,41724,4,37,21,0,0,0,0,7,337,70,31381,30273,40024,1,0,19,-816,-5,-1781,1700,1,0,1,0,2
EUW1_6867805094',5,55,15,0,0,1,0,8,1,347,72,28983,29346,38737,2,98,9,1,0,1,0,5,352,96,25427,27201,34330,1,-5,-24,3556,6,2145,4407,-1,0,0,0,3
EUW1_6866799540',1,19,10,0,0,1,0,11,1,349,54,29414,28890,28132,2,26,15,1,0,1,0,7,308,101,27943,29566,37221,0,41,-47,1471,-5,-676,-9089,-1,0,0,0,4
EUW1_6866721677',7,39,21,1,1,1,0,7,0,367,78,32369,32663,42549,3,27,6,0,0,1,0,6,268,99,23020,25412,22227,1,99,-21,9349,15,7251,20322,1,1,0,0,1
EUW1_6866677168',4,35,13,1,0,0,0,11,0,298,80,26477,25925,34317,5,31,25,1,0,1,0,1,327,107,33666,31144,44330,0,-29,-27,-7189,-12,-5219,-10013,0,0,-1,0,10
EUW1_6865845717',4,24,18,0,0,3,0,14,0,304,87,31889,30367,45923,5,23,22,2,1,2,0,11,365,91,33477,30494,45107,0,-61,-4,-1588,-4,-127,816,-2,-1,1,0,3
EUW1_6865784523',4,42,18,0,0,1,0,10,1,352,88,30707,29690,40217,3,23,19,1,0,0,0,5,350,88,29887,32558,45794,0,2,0,820,-1,-2868,-5577,-1,0,1,0,5
EUW1_6865707873',3,29,18,1,0,2,0,12,1,337,96,30764,29242,38873,3,22,14,0,0,1,0,6,361,66,29910,28513,36378,1,-24,30,854,4,729,2495,1,0,1,0,6
EUW1_6865657582',0,23,25,1,0,1,0,7,1,328,72,33824,28773,45589,1,22,17,0,0,1,0,10,281,64,27663,26991,44015,1,47,8,6161,8,1782,1574,1,0,0,0,-3
EUW1_6865387957',3,65,9,0,0,0,0,14,0,302,74,25340,26825,28736,2,28,25,1,0,4,0,1,387,91,36508,32804,42087,0,-85,-17,-11168,-16,-5979,-13351,-1,0,-4,0,13
EUW1_6861243577',4,24,9,0,0,0,0,10,1,349,72,26853,28113,25020,2,53,17,1,1,0,0,2,351,108,29114,31085,32782,0,-2,-36,-2261,-8,-2972,-7762,-1,-1,0,0,8
EUW1_6860229416',6,25,23,2,0,0,0,11,1,366,85,32666,30354,44589,5,27,15,0,0,0,0,3,355,82,30805,28568,37327,1,11,3,1861,8,1786,7262,2,0,0,0,8
EUW1_6860171703',4,78,12,2,0,1,0,9,0,409,94,28852,32316,35024,2,25,10,0,0,0,0,6,382,90,26809,30166,26554,1,27,4,2043,2,2150,8470,2,0,1,0,3
EUW1_6860136531',1,25,6,1,0,0,0,13,0,366,71,24413,27510,22222,6,64,13,0,1,2,0,1,391,115,31000,31801,37365,0,-25,-44,-6587,-7,-4291,-15143,1,-1,-2,0,12
EUW1_6860104474',1,146,5,0,0,0,0,13,0,299,59,22477,25288,24085,5,78,25,2,0,3,0,2,410,112,35998,33995,44091,0,-111,-53,-13521,-20,-8707,-20006,-2,0,-3,0,11
EUW1_6860065102',2,28,6,2,0,0,0,16,0,360,68,23747,26796,29495,6,69,22,0,0,2,0,2,383,88,33068,31542,32756,0,-23,-20,-9321,-16,-4746,-3261,2,0,-2,0,14
EUW1_6860023045',4,82,13,0,0,0,0,6,0,356,76,27434,28364,33677,5,49,16,1,0,0,0,0,358,82,29262,29735,35334,0,-2,-6,-1828,-3,-1371,-1657,-1,0,0,0,6
EUW1_6859841317',3,27,16,2,0,3,0,7,1,398,100,31819,34140,41059,6,74,4,0,0,0,0,6,356,104,23871,27818,23110,1,42,-4,7948,12,6322,17949,2,0,3,0,1
EUW1_6859801323',5,55,10,2,0,1,0,6,0,393,153,28781,33797,21162,4,24,6,0,0,0,0,4,366,56,22854,26953,17863,1,27,97,5927,4,6844,3299,2,0,1,0,2
EUW1_6859758518',5,94,8,0,0,0,0,13,1,338,95,25760,28136,31165,2,26,11,2,1,3,0,2,365,102,29259,31428,31802,0,-27,-7,-3499,-3,-3292,-637,-2,-1,-3,0,11
EUW1_6859712778',4,30,13,2,0,3,0,6,1,374,98,29900,29597,35484,1,62,5,0,0,1,0,9,327,69,24053,25890,27248,1,47,29,5847,8,3707,8236,2,0,2,0,-3
EUW1_6859677599',4,76,6,1,0,1,0,10,1,392,88,25126,30853,20338,5,41,6,0,0,1,0,3,411,88,25974,29855,17968,0,-19,0,-848,0,998,2370,1,0,0,0,7
EUW1_6858882828',3,71,7,0,0,0,0,8,0,358,94,25148,28823,28461,6,36,15,1,0,0,0,0,387,77,28585,30062,31401,0,-29,17,-3437,-8,-1239,-2940,-1,0,0,0,8
EUW1_6858826616',6,66,22,1,0,2,0,5,1,465,95,34409,34787,36575,2,15,7,1,0,1,0,8,322,78,22616,25677,25203,1,143,17,11793,15,9110,11372,0,0,1,0,-3
EUW1_6858777615',3,29,7,0,1,0,0,8,0,376,101,25178,30087,23440,3,71,10,1,0,1,0,0,403,117,29140,32979,25290,0,-27,-16,-3962,-3,-2892,-1850,-1,1,-1,0,8
EUW1_6876403513',5,22,10,0,0,1,0,6,0,333,74,26074,26687,33677,2,34,16,1,0,0,0,3,331,104,26854,30226,30611,0,2,-30,-780,-6,-3539,3066,-1,0,1,0,3
EUW1_6875019785',3,23,11,1,0,0,0,13,0,292,114,25910,27109,30451,4,25,18,0,0,2,0,2,341,74,30050,29435,40428,0,-49,40,-4140,-7,-2326,-9977,1,0,-2,0,11
EUW1_6874990451',4,34,16,0,0,3,0,4,1,369,81,30841,28879,37331,7,39,15,2,0,0,0,8,296,94,28510,28542,29954,0,73,-13,2331,1,337,7377,-2,0,3,0,-4
EUW1_6874023682',4,32,29,1,0,2,0,9,1,364,111,37920,35769,46685,2,22,10,0,0,1,0,9,359,92,26892,28250,28631,1,5,19,11028,19,7519,18054,1,0,1,0,0
EUW1_6873737701',2,22,8,0,0,1,0,8,1,319,66,26209,26056,28180,1,58,26,1,0,2,0,9,353,88,31293,31355,39901,0,-34,-22,-5084,-18,-5299,-11721,-1,0,-1,0,-1
EUW1_6873725917',5,39,11,0,0,0,0,7,0,294,59,24012,25947,26630,3,23,10,1,0,1,0,2,364,102,27247,28689,26001,0,-70,-43,-3235,1,-2742,629,-1,0,-1,0,5
EUW1_6873697799',3,39,16,1,0,0,0,4,1,381,92,30493,32262,30952,6,231,5,1,0,1,0,6,339,76,22773,27160,30475,1,42,16,7720,11,5102,477,0,0,-1,0,-2
EUW1_6873041829',6,30,20,1,0,1,0,11,0,337,71,30500,30660,37958,1,30,11,1,0,0,0,1,378,85,28944,29717,36323,0,-41,-14,1556,9,943,1635,0,0,1,0,10
EUW1_6872995833',3,67,17,1,0,1,0,12,0,376,86,29821,30758,40097,3,57,10,1,0,1,0,2,337,64,26995,27797,28392,1,39,22,2826,7,2961,11705,0,0,0,0,10
EUW1_6865963631',0,25,21,1,1,2,0,5,1,350,103,31621,30924,40391,1,27,11,0,0,0,0,10,324,56,24880,27470,24902,1,26,47,6741,10,3454,15489,1,1,2,0,-5
EUW1_6865719910',1,18,13,0,0,1,0,13,1,332,84,28254,29211,36060,7,268,20,2,0,1,0,4,312,80,29697,30854,45333,0,20,4,-1443,-7,-1643,-9273,-2,0,0,0,9
EUW1_6865614914',1,22,9,1,0,1,0,10,0,381,103,27044,30103,27189,2,28,12,0,0,0,0,7,375,66,26752,29560,30671,0,6,37,292,-3,543,-3482,1,0,1,0,3
EUW1_6865537842',3,26,9,1,0,0,0,10,0,336,70,25983,26752,30488,4,49,18,0,0,1,0,5,360,71,30387,30475,39750,0,-24,-1,-4404,-9,-3723,-9262,1,0,-1,0,5
EUW1_6865463687',1,29,10,0,0,0,0,8,0,355,95,26445,29241,32477,5,293,9,2,0,0,0,6,356,98,26542,29408,35020,0,-1,-3,-97,1,-167,-2543,-2,0,0,0,2
EUW1_6865390594',2,22,11,1,0,0,0,6,1,357,74,26377,29794,30012,7,31,7,1,0,0,0,2,411,81,25586,29422,31916,0,-54,-7,791,4,372,-1904,0,0,0,0,4
EUW1_6865212345',3,27,24,1,0,2,0,8,0,359,87,33845,30653,48688,3,48,12,0,0,0,0,7,286,72,27193,28341,29134,1,73,15,6652,12,2312,19554,1,0,2,0,1
EUW1_6865160999',2,29,12,0,0,0,0,11,1,352,66,27255,29547,37573,5,30,17,2,1,3,0,4,356,132,31438,34058,35661,0,-4,-66,-4183,-5,-4511,1912,-2,-1,-3,0,7
EUW1_6865058076',6,151,19,0,0,0,0,10,1,339,57,28130,31030,41780,1,20,14,1,0,0,0,2,340,98,27691,30589,40981,0,-1,-41,439,5,441,799,-1,0,0,0,8
EUW1_6869600300',5,27,12,1,1,0,0,12,1,346,92,27622,30514,34414,4,29,13,0,0,2,0,6,382,62,27694,29211,38607,1,-36,30,-72,-1,1303,-4193,1,1,-2,0,6
EUW1_6869560901',6,34,11,1,0,2,0,8,0,370,82,28236,28528,28551,3,34,16,1,1,0,0,7,317,83,29230,29723,33872,1,53,-1,-994,-5,-1195,-5321,0,-1,2,0,1
EUW1_6869521292',6,26,21,0,0,0,0,8,1,394,66,32031,30847,42614,4,65,12,1,0,3,0,7,350,83,28208,30995,32160,1,44,-17,3823,9,-148,10454,-1,0,-3,0,1
EUW1_6869496585',2,26,8,1,0,0,0,13,0,332,108,25447,29125,30031,4,31,15,1,0,1,0,2,383,96,30204,31438,31200,0,-51,12,-4757,-7,-2313,-1169,0,0,-1,0,11
EUW1_6868353647',3,17,16,2,0,2,0,4,1,425,84,31121,33615,38511,0,23,6,0,0,0,0,7,376,96,24635,28064,23448,1,49,-12,6486,10,5551,15063,2,0,2,0,-3
EUW1_6868282019',6,29,17,0,0,2,0,12,1,358,76,29817,31067,43415,0,242,13,2,0,0,0,3,324,92,27346,29041,29387,0,34,-16,2471,4,2026,14028,-2,0,2,0,9
EUW1_6868214395',4,22,11,0,0,0,0,13,1,312,91,26455,27324,35384,2,225,16,1,0,1,0,1,344,92,28010,29934,34674,0,-32,-1,-1555,-5,-2610,710,-1,0,-1,0,12
EUW1_6868161862',2,25,18,2,1,3,0,10,0,396,112,31528,32152,37996,0,43,8,0,0,0,0,9,345,80,25300,28542,28586,0,51,32,6228,10,3610,9410,2,1,3,0,1
EUW1_6862510372',2,36,7,0,0,1,0,13,0,347,104,25821,27536,31518,2,21,21,2,0,3,0,7,369,93,31968,32763,40364,0,-22,11,-6147,-14,-5227,-8846,-2,0,-2,0,6
EUW1_6862446612',5,29,18,2,0,0,0,11,1,342,79,28378,30062,34531,2,57,11,0,0,0,0,2,400,84,27914,30031,40129,0,-58,-5,464,7,31,-5598,2,0,0,0,9
EUW1_6861224375',9,28,9,0,0,0,0,10,0,350,94,26086,29490,25778,5,26,16,2,0,1,0,2,350,88,29108,31370,40151,0,0,6,-3022,-7,-1880,-14373,-2,0,-1,0,8
EUW1_6861191625',5,31,15,1,1,0,0,9,1,353,82,29145,29690,36866,2,23,10,0,0,0,0,2,354,92,26820,29733,24030,1,-1,-10,2325,5,-43,12836,1,1,0,0,7
EUW1_6861142463',3,27,6,0,1,0,0,6,1,409,106,26547,30544,26644,1,88,14,1,0,0,0,2,383,102,28148,32173,30615,1,26,4,-1601,-8,-1629,-3971,-1,1,0,0,4
EUW1_6861045420',5,24,0,0,0,0,0,15,0,358,53,20532,25709,17739,5,30,14,2,0,3,0,0,429,126,32313,33166,32126,0,-71,-73,-11781,-14,-7457,-14387,-2,0,-3,0,15
EUW1_6883759299',4,27,5,0,0,0,0,6,0,407,78,24326,28934,26370,7,37,9,2,0,2,0,2,397,93,28071,30476,24771,0,10,-15,-3745,-4,-1542,1599,-2,0,-2,0,4
EUW1_6883356460',7,33,11,0,0,0,0,12,0,369,81,26360,28991,32551,10,32,21,1,0,1,0,2,398,91,32592,34951,40276,0,-29,-10,-6232,-10,-5960,-7725,-1,0,-1,0,10
EUW1_6882638219',3,38,12,0,0,1,0,8,0,374,97,29238,29061,28695,4,31,17,1,0,0,0,4,376,77,29486,29888,34976,0,-2,20,-248,-5,-827,-6281,-1,0,1,0,4
EUW1_6880252940',5,33,26,0,0,1,0,7,1,313,96,33745,30801,46994,5,349,18,2,0,0,0,8,288,73,28372,25287,45547,1,25,23,5373,8,5514,1447,-2,0,1,0,-1
EUW1_6878720322',4,29,16,1,0,2,0,3,1,406,120,32021,31018,34442,1,24,8,0,0,0,0,7,336,80,25062,28134,39030,0,70,40,6959,8,2884,-4588,1,0,2,0,-4
EUW1_6877097860',8,34,20,1,0,1,0,7,0,368,84,31467,30936,44650,5,29,13,1,1,1,0,6,295,89,26945,27078,38072,1,73,-5,4522,7,3858,6578,0,-1,0,0,1
EUW1_6877020404',5,40,14,0,0,2,0,13,0,347,77,29496,29352,28614,3,24,13,2,0,1,0,4,406,93,29421,30658,31975,0,-59,-16,75,1,-1306,-3361,-2,0,1,0,9
EUW1_6876848628',10,37,15,1,1,0,0,15,1,348,112,29822,30225,36700,3,34,11,1,0,3,0,2,370,88,27567,29143,30100,1,-22,24,2255,4,1082,6600,0,1,-3,0,13
EUW1_6876806201',5,27,17,2,0,2,0,5,1,377,93,31422,32133,40599,4,31,5,0,0,0,0,8,350,78,23171,27805,30838,1,27,15,8251,12,4328,9761,2,0,2,0,-3
EUW1_6876223125',11,35,17,1,0,1,0,8,0,398,84,30251,30124,36178,6,30,15,1,0,0,0,5,352,96,29704,29293,31327,1,46,-12,547,2,831,4851,0,0,1,0,3
EUW1_6875600911',0,20,22,2,0,1,0,12,0,382,94,34201,32491,44169,4,42,14,0,0,3,0,8,341,65,28303,27584,34925,1,41,29,5898,8,4907,9244,2,0,-2,0,4
EUW1_6876107943',9,27,25,1,0,1,0,13,1,313,101,34344,30502,46321,6,35,18,0,0,0,0,0,331,79,30334,28018,42529,1,-18,22,4010,7,2484,3792,1,0,1,0,13
EUW1_6875895622',4,26,15,1,0,2,0,5,0,406,80,30420,31033,43028,5,26,11,1,0,0,0,9,337,98,27234,30727,27492,1,69,-18,3186,4,306,15536,0,0,2,0,-4
EUW1_6875411826',5,36,8,0,0,1,0,9,1,369,112,25846,29524,30104,4,22,11,2,0,1,0,5,351,95,27320,29893,30787,1,18,17,-1474,-3,-369,-683,-2,0,0,0,4
EUW1_6875300876',5,30,10,0,0,0,0,2,1,382,77,25687,29167,30363,3,25,4,1,1,0,0,2,355,102,23262,29335,21878,1,27,-25,2425,6,-168,8485,-1,-1,0,0,0
EUW1_6875263933',1,35,8,0,0,1,0,15,0,340,74,25413,27515,33275,2,28,15,2,0,3,0,5,397,102,32663,31592,34578,0,-57,-28,-7250,-7,-4077,-1303,-2,0,-2,0,10
EUW1_6875211446',4,47,8,1,0,0,0,8,1,343,110,25058,28954,38195,7,33,5,1,0,0,0,3,354,95,23979,28670,30023,1,-11,15,1079,3,284,8172,0,0,0,0,5
EUW1_6874715054',2,32,11,0,0,0,0,12,1,314,77,25646,27006,28509,6,35,13,1,0,1,0,4,345,68,27039,28165,32373,0,-31,9,-1393,-2,-1159,-3864,-1,0,-1,0,8
EUW1_6882875095',6,37,14,2,0,0,0,6,1,357,79,26776,29931,32984,3,28,9,0,0,0,0,4,364,82,25632,30813,30028,1,-7,-3,1144,5,-882,2956,2,0,0,0,2
EUW1_6882828160',3,63,4,0,0,0,0,7,0,343,84,22972,27922,24567,7,68,8,1,0,1,0,3,399,86,27176,29487,30463,0,-56,-2,-4204,-4,-1565,-5896,-1,0,-1,0,4
EUW1_6882799668',3,26,22,2,0,2,0,4,1,349,107,32384,32051,44132,2,17,9,0,0,0,0,11,309,76,25420,26685,25464,1,40,31,6964,13,5366,18668,2,0,2,0,-7
EUW1_6882746379',3,29,2,0,0,0,0,6,0,360,76,22092,26702,17400,5,30,11,1,0,1,0,4,369,84,27077,29299,29973,0,-9,-8,-4985,-9,-2597,-12573,-1,0,-1,0,2
EUW1_6882981121',9,31,12,0,0,0,0,7,0,336,86,27432,28471,31845,2,26,10,2,0,2,0,2,334,94,27017,29317,28579,1,2,-8,415,2,-846,3266,-2,0,-2,0,5
EUW1_6882508474',3,28,18,2,0,1,0,11,0,363,97,30521,28882,36144,7,32,7,0,0,1,0,1,370,90,26935,28109,27660,0,-7,7,3586,11,773,8484,2,0,0,0,10
EUW1_6881595666',3,263,8,0,1,0,0,10,0,383,79,26275,29886,28010,2,32,12,1,0,0,0,5,382,94,26808,30287,28893,0,1,-15,-533,-4,-401,-883,-1,1,0,0,5
EUW1_6881116815',4,31,8,1,0,1,0,7,0,374,90,26632,29177,33609,5,28,14,1,0,0,0,4,309,94,27005,30584,34073,0,65,-4,-373,-6,-1407,-464,0,0,1,0,3
EUW1_6881053028',5,30,7,1,0,0,0,12,1,348,88,24727,28690,24949,6,25,7,1,0,1,0,2,414,100,27353,29816,27841,0,-66,-12,-2626,0,-1126,-2892,0,0,-1,0,10
EUW1_6880379729',3,129,9,1,0,0,0,13,1,330,98,26308,29536,28666,4,30,19,1,0,2,0,0,382,98,32204,33212,38030,0,-52,0,-5896,-10,-3676,-9364,0,0,-2,0,13
EUW1_6879808683',2,29,6,2,0,0,0,12,0,271,74,21630,25184,28852,5,24,15,0,0,2,0,0,347,84,30259,27787,31823,0,-76,-10,-8629,-9,-2603,-2971,2,0,-2,0,12
EUW1_6878587240',1,74,11,1,0,1,0,11,1,379,102,28772,29837,34916,5,32,11,1,0,1,0,6,352,98,27542,29895,32325,0,27,4,1230,0,-58,2591,0,0,0,0,5
EUW1_6877254544',7,30,5,1,0,0,0,11,1,351,84,24146,26981,21208,2,96,11,1,0,3,0,2,383,112,28447,30825,25241,0,-32,-28,-4301,-6,-3844,-4033,0,0,-3,0,9
EUW1_6871678919',2,26,13,1,1,0,0,10,0,330,84,28930,29080,35055,3,28,19,0,0,2,0,4,369,74,30328,28524,34804,1,-39,10,-1398,-6,556,251,1,1,-2,0,6
EUW1_6871110044',5,59,16,0,0,0,0,10,1,353,88,28898,28355,37617,8,30,17,1,0,1,0,1,345,103,29946,30623,31814,0,8,-15,-1048,-1,-2268,5803,-1,0,-1,0,9
EUW1_6870867210',1,24,9,1,0,0,0,11,1,309,77,25460,28349,29575,4,25,19,0,0,1,0,1,359,80,31391,29496,37044,0,-50,-3,-5931,-10,-1147,-7469,1,0,-1,0,10
EUW1_6870764960',2,24,18,1,0,0,0,9,1,357,86,28851,29461,40401,3,50,17,0,0,1,0,4,294,86,28967,29831,36226,1,63,0,-116,1,-370,4175,1,0,-1,0,5
EUW1_6870723331',3,23,7,0,0,1,0,9,1,363,99,25986,28438,24640,5,24,6,2,0,1,0,5,399,96,26877,29385,20467,0,-36,3,-891,1,-947,4173,-2,0,0,0,4
EUW1_6869586118',3,28,7,0,0,0,0,10,0,343,90,25006,29178,21814,1,148,13,2,0,1,0,2,419,90,28906,32373,33080,1,-76,0,-3900,-6,-3195,-11266,-2,0,-1,0,8
EUW1_6869534160',3,37,8,1,0,0,0,4,0,384,101,25733,29579,30507,4,36,10,0,0,0,0,3,367,82,25908,29369,21659,0,17,19,-175,-2,210,8848,1,0,0,0,1
EUW1_6868573412',7,32,4,0,0,0,0,12,1,374,88,23487,28511,23248,7,35,11,2,0,3,0,2,396,116,29306,32266,29663,0,-22,-28,-5819,-7,-3755,-6415,-2,0,-3,0,10
EUW1_6866371802',4,29,21,1,0,0,0,6,1,339,89,30172,31101,42235,6,44,16,0,0,0,0,4,345,90,29206,29720,34742,1,-6,-1,966,5,1381,7493,1,0,0,0,2
EUW1_6866336441',1,47,11,1,0,1,0,7,0,345,77,27201,28889,36812,5,35,13,0,0,2,0,7,340,90,29222,29846,34292,0,5,-13,-2021,-2,-957,2520,1,0,-1,0,0
EUW1_6866093042',6,30,28,1,0,3,0,14,1,341,108,38472,31448,51113,3,38,27,1,0,1,0,14,314,68,34821,30644,44764,1,27,40,3651,1,804,6349,0,0,2,0,0
EUW1_6866053323',4,25,16,2,1,0,0,10,1,353,74,27965,30831,32742,1,32,10,0,0,1,0,2,375,99,27465,28999,28191,0,-22,-25,500,6,1832,4551,2,1,-1,0,8
EUW1_6866015817',2,29,11,2,0,0,0,8,0,311,67,24817,26469,31517,3,31,15,0,1,1,0,4,356,100,30614,30549,32753,1,-45,-33,-5797,-4,-4080,-1236,2,-1,-1,0,4
EUW1_6865957195',1,37,4,0,0,0,0,11,0,386,121,24086,29720,19084,6,40,6,1,0,1,0,1,374,82,25864,30225,19747,1,12,39,-1778,-2,-505,-663,-1,0,-1,0,10
EUW1_6865912804',0,29,7,0,0,0,0,14,1,351,78,25259,29055,26132,2,27,15,1,0,3,0,1,374,96,31856,31863,34442,0,-23,-18,-6597,-8,-2808,-8310,-1,0,-3,0,13
EUW1_6865725894',3,38,9,1,0,0,0,11,1,346,90,25408,28439,30257,2,90,16,0,0,1,0,3,366,90,30830,32529,40117,1,-20,0,-5422,-7,-4090,-9860,1,0,-1,0,8
EUW1_6865659177',3,46,13,2,0,1,0,9,1,397,101,29700,30498,28822,6,26,7,0,0,1,0,5,339,78,24714,28341,32829,1,58,23,4986,6,2157,-4007,2,0,0,0,4
EUW1_6865405427',3,24,7,1,0,1,0,11,1,331,76,24795,26921,23340,3,46,17,1,0,1,0,6,365,112,30111,32138,32883,0,-34,-36,-5316,-10,-5217,-9543,0,0,0,0,5
EUW1_6865317160',1,23,20,1,0,0,0,11,0,345,73,30835,30431,38994,4,47,16,1,0,1,0,4,321,76,29339,27904,34614,0,24,-3,1496,4,2527,4380,0,0,-1,0,7
EUW1_6865269666',5,35,13,0,0,1,0,10,0,346,91,28199,28951,30396,5,27,16,2,0,1,0,4,318,76,28939,27314,34801,0,28,15,-740,-3,1637,-4405,-2,0,0,0,6
EUW1_6865172378',3,43,14,2,0,0,0,10,0,334,96,27681,27905,38782,5,27,9,0,0,1,0,3,340,76,25871,26182,33302,1,-6,20,1810,5,1723,5480,2,0,-1,0,7
EUW1_6865105219',1,98,10,2,0,1,0,11,1,385,90,26542,30337,30191,1,26,7,0,0,1,0,4,377,96,25765,27997,22267,1,8,-6,777,3,2340,7924,2,0,0,0,7
EUW1_6865068445',8,28,20,1,1,0,0,5,1,390,74,31335,32717,40308,2,25,10,1,0,1,0,1,357,81,26192,29230,27879,1,33,-7,5143,10,3487,12429,0,1,-1,0,4
EUW1_6864777454',4,26,9,1,1,3,0,11,1,385,81,28614,29619,21445,3,24,10,1,0,0,0,6,320,90,24810,29234,23177,1,65,-9,3804,-1,385,-1732,0,1,3,0,5
EUW1_6864259571',1,35,9,1,0,0,0,12,0,344,87,26688,28032,29957,5,143,12,1,1,2,0,6,352,99,28479,30202,23389,0,-8,-12,-1791,-3,-2170,6568,0,-1,-2,0,6
EUW1_6864101890',1,26,8,1,0,0,0,5,1,356,61,24405,26957,26985,4,31,11,0,0,0,0,3,377,96,27243,30762,35499,0,-21,-35,-2838,-3,-3805,-8514,1,0,0,0,2
EUW1_6864008107',2,137,6,0,0,0,0,11,0,359,77,24952,27172,26021,7,246,18,2,0,2,0,2,363,86,29683,30595,29158,0,-4,-9,-4731,-12,-3423,-3137,-2,0,-2,0,9
EUW1_6883457652',3,26,18,1,0,1,0,3,1,412,109,31163,33361,38651,6,26,4,1,0,1,0,8,334,74,22916,27190,25491,1,78,35,8247,14,6171,13160,0,0,0,0,-5
EUW1_6883398690',0,23,10,0,0,0,0,9,0,375,62,25743,29489,23425,1,43,13,1,1,1,0,2,358,81,27720,29712,31525,0,17,-19,-1977,-3,-223,-8100,-1,-1,-1,0,7
EUW1_6883276358',2,46,6,1,0,1,0,8,0,410,80,24960,29171,23292,3,32,10,0,0,1,0,1,386,112,28091,31109,26897,1,24,-32,-3131,-4,-1938,-3605,1,0,0,0,7
EUW1_6883222701',2,27,14,1,0,2,0,7,1,382,88,30437,31594,35981,2,35,9,0,0,0,0,8,337,72,26040,28774,29620,1,45,16,4397,5,2820,6361,1,0,2,0,-1
EUW1_6882838181',5,29,9,1,0,1,0,7,0,349,100,25918,28232,30946,5,30,10,1,1,1,0,4,353,100,27194,30366,30315,1,-4,0,-1276,-1,-2134,631,0,-1,0,0,3
EUW1_6882782838',5,25,9,1,0,0,0,12,0,401,82,25839,29852,20061,4,28,5,1,0,1,0,2,402,109,27425,30862,26160,0,-1,-27,-1586,4,-1010,-6099,0,0,-1,0,10
EUW1_6882598139',4,27,8,1,0,1,0,7,0,362,84,26833,27529,27091,6,30,12,0,0,1,0,8,396,95,28287,32101,29429,0,-34,-11,-1454,-4,-4572,-2338,1,0,0,0,-1
EUW1_6882566797',3,54,12,1,0,0,0,12,1,355,79,28178,30756,23345,4,69,20,0,0,1,0,3,374,95,30096,31321,34388,1,-19,-16,-1918,-8,-565,-11043,1,0,-1,0,9
EUW1_6882536057',2,21,13,2,0,2,0,8,1,404,113,29694,31992,36471,4,93,9,0,0,1,0,6,346,73,24350,27993,25357,1,58,40,5344,4,3999,11114,2,0,1,0,2
EUW1_6882103790',4,23,17,1,1,0,0,15,1,334,108,29598,30899,34463,2,47,19,1,0,1,0,2,354,85,30556,30746,36184,0,-20,23,-958,-2,153,-1721,0,1,-1,0,13
EUW1_6882050569',6,23,25,0,0,2,0,6,1,374,96,33573,32925,45291,4,30,12,1,0,1,0,9,331,84,26586,29067,31400,1,43,12,6987,13,3858,13891,-1,0,1,0,-3
EUW1_6881985204',3,25,15,2,0,2,0,8,0,394,82,29728,31243,33228,3,52,10,0,0,0,0,3,367,91,26248,28755,29819,1,27,-9,3480,5,2488,3409,2,0,2,0,5
EUW1_6881898361',2,24,18,0,0,1,0,6,1,351,79,29684,30546,36734,5,23,15,1,0,0,0,4,348,104,28700,30654,30092,1,3,-25,984,3,-108,6642,-1,0,1,0,2
EUW1_6881347032',6,61,13,0,0,1,0,9,1,356,89,29252,29256,28447,7,23,16,1,0,0,0,4,338,68,28757,29485,30767,0,18,21,495,-3,-229,-2320,-1,0,1,0,5
EUW1_6880670833',1,31,7,1,0,0,0,4,0,373,107,25572,30000,31316,2,24,13,1,0,1,0,4,349,91,26597,30096,30871,1,24,16,-1025,-6,-96,445,0,0,-1,0,0
EUW1_6873635913',0,22,12,0,0,0,0,12,0,349,70,26984,27852,31061,6,30,23,2,0,2,0,1,337,92,32827,30716,43801,1,12,-22,-5843,-11,-2864,-12740,-2,0,-2,0,11
EUW1_6873601943',7,34,12,0,0,0,0,10,0,317,74,26395,27898,32743,1,236,24,1,0,1,0,0,332,74,31140,30591,38590,0,-15,0,-4745,-12,-2693,-5847,-1,0,-1,0,10
EUW1_6873583463',5,27,22,2,0,3,0,10,1,382,115,33739,33862,46143,2,26,7,0,0,0,0,8,346,76,23861,26261,28904,1,36,39,9878,15,7601,17239,2,0,3,0,2
EUW1_6873509557',5,203,13,1,0,0,0,11,0,289,82,25905,26794,35985,4,28,20,0,0,4,0,1,371,90,32578,30788,47331,0,-82,-8,-6673,-7,-3994,-11346,1,0,-4,0,10
EUW1_6883501516',3,25,24,1,0,0,0,9,1,381,101,34189,34238,43650,5,25,17,0,0,1,0,4,328,86,29232,29335,43881,1,53,15,4957,7,4903,-231,1,0,-1,0,5
EUW1_6882520859',2,31,11,0,0,2,0,4,1,373,80,27502,29328,30822,3,24,7,1,0,0,0,5,398,92,25036,29843,31845,1,-25,-12,2466,4,-515,-1023,-1,0,2,0,-1
EUW1_6882446269',3,29,14,1,0,0,0,8,0,364,111,29435,31065,33410,4,30,14,0,0,1,0,8,342,80,27590,30280,28331,1,22,31,1845,0,785,5079,1,0,-1,0,0
EUW1_6882392551',3,22,15,2,0,3,0,4,1,401,96,31358,31991,28953,2,29,7,0,0,0,0,10,347,84,24227,27479,22892,1,54,12,7131,8,4512,6061,2,0,3,0,-6
EUW1_6880474344',1,51,7,1,0,1,0,6,0,410,68,28384,29725,37120,10,36,17,1,1,0,0,5,346,102,28677,30677,35787,0,64,-34,-293,-10,-952,1333,0,-1,1,0,1
EUW1_6879687576',3,42,8,0,0,0,0,7,0,376,110,26145,29242,28607,1,32,13,1,1,1,0,5,373,102,28953,30554,41126,0,3,8,-2808,-5,-1312,-12519,-1,-1,-1,0,2
EUW1_6863941028',2,20,17,1,0,3,0,8,1,371,104,31836,33061,36037,3,30,15,1,0,0,0,7,346,103,28149,30550,34802,0,25,1,3687,2,2511,1235,0,0,3,0,1
EUW1_6861401095',0,24,20,1,0,2,0,6,1,364,112,32424,31187,38760,4,211,12,0,0,0,0,8,347,68,26801,29754,32681,1,17,44,5623,8,1433,6079,1,0,2,0,-2
EUW1_6861351380',2,24,23,0,0,2,0,8,1,405,96,36208,32468,39501,4,25,10,0,0,1,0,10,302,84,25232,26838,26704,1,103,12,10976,13,5630,12797,0,0,1,0,-2
EUW1_6861126386',0,29,7,1,0,2,0,6,0,354,82,26704,28732,29835,5,26,15,1,0,0,0,3,362,110,28625,31173,39481,0,-8,-28,-1921,-8,-2441,-9646,0,0,2,0,3
EUW1_6861097002',3,31,23,2,0,0,0,9,1,378,91,31545,32726,47123,1,27,3,0,0,1,0,5,322,94,21967,26610,20463,1,56,-3,9578,20,6116,26660,2,0,-1,0,4
EUW1_6857035919',1,38,8,0,0,0,0,9,1,367,76,26309,27563,29103,6,39,16,2,0,1,0,4,360,88,28827,31419,33268,0,7,-12,-2518,-8,-3856,-4165,-2,0,-1,0,5
EUW1_6856990170',9,34,12,2,0,0,0,7,1,346,94,26661,28960,27116,4,138,9,0,0,0,0,1,383,76,25361,29229,30203,1,-37,18,1300,3,-269,-3087,2,0,0,0,6
EUW1_6855878297',3,28,11,1,0,3,0,9,1,415,82,28810,30584,31981,4,32,5,1,0,1,0,4,352,101,24093,29030,24203,0,63,-19,4717,6,1554,7778,0,0,2,0,5
EUW1_6855831675',5,31,12,0,0,0,0,5,0,340,82,27430,29187,35464,3,20,17,2,0,0,0,2,397,107,30230,33441,37504,0,-57,-25,-2800,-5,-4254,-2040,-2,0,0,0,3
EUW1_6854670541',2,28,12,2,1,1,0,8,1,346,110,28964,30750,42326,4,31,10,0,0,0,0,4,354,102,27860,29360,32478,1,-8,8,1104,2,1390,9848,2,1,1,0,4
EUW1_6854624502',0,27,8,0,0,0,0,10,0,335,84,24936,29545,32060,3,23,14,0,0,1,0,2,415,88,29786,31969,39109,0,-80,-4,-4850,-6,-2424,-7049,0,0,-1,0,8
EUW1_6853939000',0,24,15,0,0,0,0,11,1,319,55,29554,25412,40678,6,29,29,1,0,2,0,3,282,68,33592,28275,52508,1,37,-13,-4038,-14,-2863,-11830,-1,0,-2,0,8
EUW1_6853278525',3,24,17,1,0,0,0,13,0,367,124,32020,31194,41939,7,24,16,0,0,3,0,3,333,85,29011,30071,38083,1,34,39,3009,1,1123,3856,1,0,-3,0,10
EUW1_6852366873',9,32,10,1,0,0,0,8,0,344,87,25692,28069,25652,4,142,8,0,0,0,0,1,408,80,26674,29369,35704,0,-64,7,-982,2,-1300,-10052,1,0,0,0,7
EUW1_6851604012',3,24,16,1,0,1,0,11,0,334,90,28676,29754,37701,2,32,9,1,0,1,0,4,321,98,26150,27536,31493,0,13,-8,2526,7,2218,6208,0,0,0,0,7
EUW1_6851594102',5,24,12,1,0,1,0,11,0,303,76,26381,26516,31613,3,31,18,1,0,4,0,2,390,80,33276,31777,35301,0,-87,-4,-6895,-6,-5261,-3688,0,0,-3,0,9
EUW1_6883372469',3,72,12,2,1,1,0,2,0,408,92,27609,31342,23772,3,24,2,0,0,0,0,4,418,96,23318,28055,16832,1,-10,-4,4291,10,3287,6940,2,1,1,0,-2
EUW1_6881023204',6,32,16,2,0,0,0,11,0,331,90,28543,28769,32014,3,25,11,0,0,2,0,3,399,68,29267,29183,31108,1,-68,22,-724,5,-414,906,2,0,-2,0,8
EUW1_6880965192',3,26,18,0,0,0,0,8,0,323,80,28277,29806,33241,3,42,11,2,0,0,0,1,381,64,26485,28591,31058,0,-58,16,1792,7,1215,2183,-2,0,0,0,7
EUW1_6880952469',2,33,33,2,0,2,0,6,1,338,76,35399,30600,57781,3,25,10,0,0,1,0,12,294,84,25260,25866,34926,1,44,-8,10139,23,4734,22855,2,0,1,0,-6
EUW1_6880925731',5,38,9,0,0,1,0,9,0,349,104,26499,27358,31072,4,28,19,2,0,2,0,5,370,72,32005,30909,39493,0,-21,32,-5506,-10,-3551,-8421,-2,0,-1,0,4
EUW1_6880893042',3,38,12,1,1,1,0,7,0,378,96,27837,30543,26966,5,39,13,1,0,1,0,0,367,96,28997,32239,36412,1,11,0,-1160,-1,-1696,-9446,0,1,0,0,7
EUW1_6879886295',2,32,8,2,1,0,0,9,0,333,69,24567,29288,27184,8,38,7,0,0,1,0,2,367,98,25562,27233,24909,0,-34,-29,-995,1,2055,2275,2,1,-1,0,7
EUW1_6879843738',4,51,15,0,1,1,0,9,0,379,99,30054,29742,27642,0,32,7,1,0,0,0,7,335,74,24693,26934,26078,0,44,25,5361,8,2808,1564,-1,1,1,0,2
EUW1_6879786828',4,23,9,0,1,1,0,6,1,395,112,27623,31788,23518,3,31,6,2,0,1,0,3,407,76,24858,28961,24801,0,-12,36,2765,3,2827,-1283,-2,1,0,0,3
EUW1_6879671218',5,34,6,0,0,0,0,13,1,349,90,23972,28702,28525,2,157,13,2,0,1,0,0,389,90,28352,31574,28641,1,-40,0,-4380,-7,-2872,-116,-2,0,-1,0,13
EUW1_6879637697',2,39,6,2,0,1,0,7,1,382,90,25158,29492,24401,5,33,10,0,0,0,0,1,348,94,25888,29030,24886,1,34,-4,-730,-4,462,-485,2,0,1,0,6
EUW1_6879594373',2,23,27,2,1,5,0,9,1,371,96,39772,33772,44665,6,139,11,0,0,0,0,9,339,74,26632,28294,41609,1,32,22,13140,16,5478,3056,2,1,5,0,0
EUW1_6879556689',4,27,15,0,0,1,0,6,1,367,83,29177,31285,34099,3,29,16,2,0,0,0,5,350,96,29101,29573,35182,0,17,-13,76,-1,1712,-1083,-2,0,1,0,1
EUW1_6879434038',2,34,13,1,1,1,0,11,0,370,92,28790,30993,30791,5,33,9,1,0,1,0,3,360,76,26403,27761,26994,1,10,16,2387,4,3232,3797,0,1,0,0,8
EUW1_6878199955',3,25,11,0,0,0,0,11,0,392,99,26939,31318,27809,6,34,8,1,0,0,0,0,377,79,24677,29022,29604,0,15,20,2262,3,2296,-1795,-1,0,0,0,11
EUW1_6878085341',3,32,7,0,0,1,0,5,1,428,103,27069,32169,28052,0,47,10,2,1,0,0,5,360,124,26956,31453,23988,0,68,-21,113,-3,716,4064,-2,-1,1,0,0
EUW1_6878068784',4,63,15,1,0,1,0,4,0,367,71,28370,27544,38405,5,39,10,1,0,0,0,7,307,60,24347,25832,24744,1,60,11,4023,5,1712,13661,0,0,1,0,-3
EUW1_6883469882',4,30,9,0,0,0,0,10,1,373,94,27479,29059,28445,1,18,8,2,0,1,0,6,356,86,25869,29684,24107,1,17,8,1610,1,-625,4338,-2,0,-1,0,4
EUW1_6883441874',5,31,21,2,1,4,0,2,0,388,119,35360,34692,44215,3,35,5,0,0,0,0,13,265,79,21793,26262,22634,1,123,40,13567,16,8430,21581,2,1,4,0,-11
EUW1_6883314473',4,28,24,2,0,2,0,6,1,342,88,33755,32200,45835,2,41,14,0,0,0,0,9,305,83,27960,28179,34102,1,37,5,5795,10,4021,11733,2,0,2,0,-3
EUW1_6883243051',2,26,18,2,1,1,0,7,1,359,104,30109,31213,36529,2,26,15,0,0,0,0,5,338,88,28024,29015,39993,1,21,16,2085,3,2198,-3464,2,1,1,0,2
EUW1_6883176580',4,39,16,1,0,2,0,9,1,351,98,30498,31303,34747,1,26,12,1,0,1,0,8,350,88,27911,30849,35221,0,1,10,2587,4,454,-474,0,0,1,0,1
EUW1_6882067855',4,43,16,1,0,2,0,5,0,400,88,30045,31562,32622,3,32,8,1,0,0,0,6,326,71,24808,27550,29000,1,74,17,5237,8,4012,3622,0,0,2,0,-1
EUW1_6881940259',4,29,10,1,0,0,0,9,1,369,82,26873,28558,20365,3,33,11,1,0,0,0,0,329,116,26164,29483,27944,1,40,-34,709,-1,-925,-7579,0,0,0,0,9
EUW1_6881884560',1,18,13,1,0,0,0,10,1,323,70,25210,27963,29828,1,24,7,1,0,2,0,0,412,109,27965,30303,28391,0,-89,-39,-2755,6,-2340,1437,0,0,-2,0,10
EUW1_6881372608',3,30,11,1,0,0,0,13,1,334,88,26585,29128,33088,4,29,18,1,0,1,0,1,399,84,30648,33017,37320,0,-65,4,-4063,-7,-3889,-4232,0,0,-1,0,12
EUW1_6880625193',0,24,10,0,0,0,0,11,0,330,80,26069,28950,34781,5,35,12,2,0,1,0,0,377,90,28512,29248,32980,0,-47,-10,-2443,-2,-298,1801,-2,0,-1,0,11
EUW1_6880576908',2,71,12,0,0,1,0,7,0,374,60,27377,28828,34813,4,98,13,0,0,0,0,4,316,68,25873,29057,36270,0,58,-8,1504,-1,-229,-1457,0,0,1,0,3
EUW1_6880432977',6,31,11,0,0,0,0,14,1,323,98,26172,27309,25908,2,40,21,2,0,1,0,3,357,102,31130,31506,37997,1,-34,-4,-4958,-10,-4197,-12089,-2,0,-1,0,11
EUW1_6880380541',9,77,26,0,0,0,0,18,1,304,77,31235,28610,41735,2,29,17,1,0,3,0,1,317,60,31315,27509,30663,1,-13,17,-80,9,1101,11072,-1,0,-3,0,17
EUW1_6880276014',5,32,24,2,0,4,0,8,0,367,110,34694,32570,42229,1,45,14,0,0,1,0,9,322,76,28910,26954,37713,1,45,34,5784,10,5616,4516,2,0,3,0,-1
EUW1_6880209686',5,87,14,1,0,0,0,11,0,247,98,26629,28381,36580,4,23,13,1,0,2,0,0,378,107,29708,31044,35113,1,-131,-9,-3079,1,-2663,1467,0,0,-2,0,11
EUW1_6880150445',7,33,9,2,0,0,0,6,1,359,116,26432,28669,30090,7,41,5,0,0,1,0,2,349,60,22820,26127,25055,1,10,56,3612,4,2542,5035,2,0,-1,0,4
EUW1_6879867541',6,30,17,1,0,0,0,9,0,357,96,29635,29946,32162,8,38,21,1,1,0,0,1,359,95,31795,30422,38945,0,-2,1,-2160,-4,-476,-6783,0,-1,0,0,8
EUW1_6880701913',2,20,11,0,1,0,0,10,1,353,100,26664,29634,22088,2,27,10,2,0,2,0,3,419,88,27836,31090,28637,0,-66,12,-1172,1,-1456,-6549,-2,1,-2,0,7
EUW1_6880667101',3,26,10,1,1,1,0,9,1,369,92,29225,31156,29283,7,29,8,1,0,1,0,7,333,87,23921,27415,25526,1,36,5,5304,2,3741,3757,0,1,0,0,2
EUW1_6880641675',2,33,12,1,0,1,0,8,0,353,97,28652,27819,26385,5,30,18,1,0,1,0,8,327,100,30689,30132,38746,0,26,-3,-2037,-6,-2313,-12361,0,0,0,0,0
EUW1_6879009830',4,96,23,1,0,4,0,6,1,377,106,35772,31700,36787,1,149,7,0,0,0,0,9,285,82,23563,23779,26382,1,92,24,12209,16,7921,10405,1,0,4,0,-3
EUW1_6878959992',6,21,7,0,0,0,0,12,0,255,63,22021,25690,21323,4,28,11,1,0,3,0,2,393,109,30294,30827,26208,0,-138,-46,-8273,-4,-5137,-4885,-1,0,-3,0,10
EUW1_6878899332',1,21,15,0,0,0,0,14,1,297,97,25885,30297,28934,4,42,13,2,0,2,0,0,385,82,29930,30912,31752,0,-88,15,-4045,2,-615,-2818,-2,0,-2,0,14
EUW1_6878246531',1,62,7,0,0,0,0,9,0,336,56,24298,27245,33975,3,84,18,2,0,2,0,0,363,98,30722,30532,38063,0,-27,-42,-6424,-11,-3287,-4088,-2,0,-2,0,9
EUW1_6878202807',2,24,12,1,0,1,0,11,0,312,84,26665,28221,42797,2,24,8,0,1,0,0,4,316,76,24549,27678,32645,0,-4,8,2116,4,543,10152,1,-1,1,0,7
EUW1_6877274416',0,23,6,1,0,0,0,12,0,340,100,25224,27808,26415,4,27,13,1,1,1,0,4,390,112,28555,32514,33050,0,-50,-12,-3331,-7,-4706,-6635,0,-1,-1,0,8
EUW1_6877113235',0,34,13,2,0,0,0,11,1,338,94,27735,28974,29089,2,34,6,0,0,1,0,3,346,110,25254,28734,30327,1,-8,-16,2481,7,240,-1238,2,0,-1,0,8
EUW1_6877071824',1,21,18,1,1,0,0,9,1,331,122,29659,30314,35926,6,109,18,1,0,0,0,3,293,82,27765,27004,41521,1,38,40,1894,0,3310,-5595,0,1,0,0,6
EUW1_6877029667',2,35,13,1,0,0,0,5,1,389,82,27894,30324,32308,3,18,18,0,0,0,0,3,296,84,28127,31384,34753,0,93,-2,-233,-5,-1060,-2445,1,0,0,0,2
EUW1_6876974121',2,27,12,1,0,1,0,15,1,348,75,28230,28388,33431,6,38,19,1,0,1,0,6,332,70,29060,28132,33865,1,16,5,-830,-7,256,-434,0,0,0,0,9
EUW1_6876931884',1,22,8,0,0,0,0,13,0,291,94,22756,25499,19597,3,38,8,2,1,3,0,4,420,118,29168,32165,20574,0,-129,-24,-6412,0,-6666,-977,-2,-1,-3,0,9
EUW1_6876420705',2,26,8,1,0,0,0,13,1,324,106,24133,26500,21518,2,136,7,1,0,3,0,3,397,94,27698,29285,20287,0,-73,12,-3565,1,-2785,1231,0,0,-3,0,10
EUW1_6876203559',2,20,17,0,0,2,0,5,1,371,95,30437,32303,31616,1,22,13,1,0,0,0,5,330,107,28460,29945,27927,0,41,-12,1977,4,2358,3689,-1,0,2,0,0
EUW1_6876150737',4,27,15,2,0,1,0,8,1,366,76,27899,28753,33578,2,31,9,0,0,1,0,0,371,80,26188,28866,30860,1,-5,-4,1711,6,-113,2718,2,0,0,0,8
EUW1_6876093551',8,41,18,1,0,3,0,8,1,344,97,32110,28860,39909,5,27,5,0,0,0,0,12,317,61,22573,25758,27094,1,27,36,9537,13,3102,12815,1,0,3,0,-4
EUW1_6876024851',3,20,11,0,0,0,0,8,0,361,84,27028,28771,32495,4,27,18,1,0,2,0,3,306,98,29502,29658,36479,0,55,-14,-2474,-7,-887,-3984,-1,0,-2,0,5
EUW1_6882962460',2,27,10,0,0,0,0,15,1,370,74,26324,27831,35048,3,29,11,2,0,1,0,2,394,98,28964,30328,30687,0,-24,-24,-2640,-1,-2497,4361,-2,0,-1,0,13
EUW1_6882564272',4,32,14,1,0,0,0,11,0,378,89,29645,30236,34407,4,29,22,0,0,2,0,4,382,100,32526,32480,46898,1,-4,-11,-2881,-8,-2244,-12491,1,0,-2,0,7
EUW1_6882496063',3,27,7,0,0,0,0,11,0,342,76,25905,27035,27774,1,27,17,1,0,0,0,5,326,84,28379,29998,33155,0,16,-8,-2474,-10,-2963,-5381,-1,0,0,0,6
EUW1_6879891744',1,23,17,2,0,0,0,17,1,320,80,30195,29290,40277,1,30,30,0,0,2,0,3,310,58,33283,30067,47196,0,10,22,-3088,-13,-777,-6919,2,0,-2,0,14
EUW1_6879841051',1,17,6,0,0,0,0,5,1,372,93,24929,28368,25399,2,23,13,2,0,1,0,5,374,102,27917,31034,33120,0,-2,-9,-2988,-7,-2666,-7721,-2,0,-1,0,0
EUW1_6879798700',3,39,15,1,0,1,0,10,1,434,92,30183,32361,33864,1,26,5,0,0,1,0,4,348,92,23752,28651,17488,1,86,0,6431,10,3710,16376,1,0,0,0,6
EUW1_6878550254',2,29,16,0,0,1,0,5,1,399,88,29790,32609,32289,4,24,5,2,0,0,0,6,361,89,22995,27069,26657,1,38,-1,6795,11,5540,5632,-2,0,1,0,-1
EUW1_6878496298',3,126,22,0,0,0,0,7,1,379,69,32125,29524,41818,0,25,19,1,0,3,0,6,369,74,31998,30914,42391,0,10,-5,127,3,-1390,-573,-1,0,-3,0,1
EUW1_6878442883',2,29,8,0,0,1,0,5,1,378,94,26975,30213,30312,2,26,9,2,0,0,0,6,365,82,25284,30008,34453,1,13,12,1691,-1,205,-4141,-2,0,1,0,-1
EUW1_6878394862',7,33,10,0,0,1,0,9,0,362,77,26928,29924,29056,1,27,12,2,0,1,0,3,385,102,29198,30146,28456,0,-23,-25,-2270,-2,-222,600,-2,0,0,0,6
EUW1_6878349625',2,29,7,0,0,1,0,11,1,374,75,25509,29156,28344,4,36,8,2,0,0,0,5,399,94,25861,30153,19754,1,-25,-19,-352,-1,-997,8590,-2,0,1,0,6
EUW1_6878286358',6,33,9,0,0,1,0,11,1,310,72,25432,27507,29886,1,28,13,2,0,2,0,4,375,104,28991,30636,36718,0,-65,-32,-3559,-4,-3129,-6832,-2,0,-1,0,7
EUW1_6878203569',5,34,17,2,1,1,0,6,1,352,93,30061,29790,32871,1,42,12,0,0,0,0,5,361,78,27958,29383,30063,1,-9,15,2103,5,407,2808,2,1,1,0,1
EUW1_6878167004',1,144,14,0,0,1,0,1,0,359,100,28861,30174,28461,10,41,9,1,0,0,0,3,329,84,24307,26199,30178,1,30,16,4554,5,3975,-1717,-1,0,1,0,-2
EUW1_6878118934',2,62,14,1,1,1,0,8,0,394,120,30174,33013,34985,8,28,8,1,0,0,0,5,384,72,24820,28066,23053,1,10,48,5354,6,4947,11932,0,1,1,0,3
EUW1_6878089152',4,299,15,1,1,1,0,12,1,374,104,32129,31901,29559,2,40,12,1,0,3,0,6,328,52,26260,27750,27875,1,46,52,5869,3,4151,1684,0,1,-2,0,6
EUW1_6878049293',1,55,15,0,0,1,0,3,1,359,99,28529,31002,37176,2,22,8,1,0,2,0,11,360,120,26572,30721,28434,1,-1,-21,1957,7,281,8742,-1,0,-1,0,-8
EUW1_6874219859',4,32,17,0,0,0,0,5,1,367,91,28998,29654,40619,2,27,14,1,0,0,0,3,346,68,26326,29115,33896,1,21,23,2672,3,539,6723,-1,0,0,0,2
EUW1_6874171114',1,32,13,2,0,1,0,12,1,336,90,29285,30242,37789,4,101,19,0,0,1,0,3,346,68,30340,29180,41235,1,-10,22,-1055,-6,1062,-3446,2,0,0,0,9
EUW1_6872572826',3,27,8,0,0,1,0,7,1,379,80,25388,28406,27128,6,41,11,2,0,1,0,4,366,56,26843,27743,33375,0,13,24,-1455,-3,663,-6247,-2,0,0,0,3
EUW1_6872537347',2,25,11,0,0,0,0,15,1,335,104,27644,28160,29247,2,25,25,2,0,2,0,2,410,89,33748,30998,40560,0,-75,15,-6104,-14,-2838,-11313,-2,0,-2,0,13
EUW1_6872500397',5,35,17,1,1,0,0,13,0,297,86,27553,27618,32352,7,30,15,0,0,4,0,0,400,84,31990,29196,39117,0,-103,2,-4437,2,-1578,-6765,1,1,-4,0,13
EUW1_6872054145',4,29,12,1,0,0,0,10,0,340,82,26735,30502,30238,5,42,15,1,0,0,0,3,344,90,28054,30046,31745,0,-4,-8,-1319,-3,456,-1507,0,0,0,0,7
EUW1_6871800980',0,23,10,1,0,1,0,5,1,386,108,28734,29399,25881,1,23,15,0,0,2,0,5,375,83,29788,31640,37470,0,11,25,-1054,-5,-2241,-11589,1,0,-1,0,0
EUW1_6871360677',3,30,7,0,0,0,0,15,0,297,70,24039,24525,25544,6,37,24,2,1,4,0,2,417,112,35652,34417,40248,0,-120,-42,-11613,-17,-9892,-14704,-2,-1,-4,0,13
EUW1_6863677498',4,23,22,2,0,0,0,13,1,342,82,32614,31351,42687,4,27,16,0,0,3,0,6,332,102,29043,30830,36676,1,10,-20,3571,6,521,6011,2,0,-3,0,7
EUW1_6863637496',5,29,13,1,0,0,0,2,0,329,76,26571,28203,33302,5,21,14,0,0,0,0,5,362,88,27929,30121,31242,0,-33,-12,-1358,-1,-1918,2060,1,0,0,0,-3
EUW1_6861257743',4,28,16,0,0,0,0,11,0,382,68,29997,30538,34050,1,36,15,2,1,3,0,4,352,80,30536,30092,34466,1,30,-12,-539,1,446,-416,-2,-1,-3,0,7
EUW1_6861062549',1,35,12,1,0,1,0,6,0,324,72,27197,26693,35580,5,28,22,1,0,1,0,3,303,76,29641,29824,37941,0,21,-4,-2444,-10,-3131,-2361,0,0,0,0,3
EUW1_6859242718',5,20,12,1,0,1,0,14,0,344,71,28411,27285,37207,5,27,21,1,0,1,0,0,365,68,31598,30505,42973,0,-21,3,-3187,-9,-3220,-5766,0,0,0,0,14
EUW1_6859184287',3,27,19,1,0,0,0,8,1,335,95,31974,30547,34954,2,29,13,1,0,3,0,1,364,84,30415,29474,32254,1,-29,11,1559,6,1073,2700,0,0,-3,0,7
EUW1_6859143036',3,34,9,0,1,1,0,6,1,357,92,26757,27640,31107,4,30,12,2,0,1,0,5,367,88,28236,30262,30455,0,-10,4,-1479,-3,-2622,652,-2,1,0,0,1
EUW1_6859100540',4,27,13,2,0,0,0,4,1,308,96,27079,29881,31377,6,32,7,0,1,1,0,4,359,99,25640,29245,24136,1,-51,-3,1439,6,636,7241,2,-1,-1,0,0
EUW1_6856531186',6,32,11,1,0,1,0,10,0,337,110,27889,28921,29755,5,30,14,1,0,1,0,5,393,94,29962,30497,34428,0,-56,16,-2073,-3,-1576,-4673,0,0,0,0,5
EUW1_6856438937',4,256,10,0,0,1,0,7,0,323,108,27049,31075,28395,6,26,16,2,0,2,0,8,368,88,30138,30936,31231,1,-45,20,-3089,-6,139,-2836,-2,0,-1,0,-1
EUW1_6856376685',2,29,13,0,0,1,0,14,0,372,89,29668,30961,33118,4,29,19,2,1,2,0,3,391,86,32280,31959,40617,1,-19,3,-2612,-6,-998,-7499,-2,-1,-1,0,11
EUW1_6879678067',1,29,13,1,0,0,0,10,0,401,82,27995,31511,25038,4,29,13,0,0,2,0,0,413,96,30458,30677,34797,1,-12,-14,-2463,0,834,-9759,1,0,-2,0,10
EUW1_6879568887',3,26,9,1,0,0,0,4,1,376,108,25628,30077,21650,3,25,11,0,0,0,0,1,397,112,27256,31592,28792,1,-21,-4,-1628,-2,-1515,-7142,1,0,0,0,3
EUW1_6879535128',3,128,9,0,0,0,0,14,0,302,72,25052,24200,26940,1,49,25,2,0,5,0,1,417,95,37692,33402,43852,0,-115,-23,-12640,-16,-9202,-16912,-2,0,-5,0,13
EUW1_6877881780',4,29,16,1,0,0,0,9,0,297,81,27895,28312,34512,2,26,14,1,0,1,0,3,365,70,27160,28840,34681,1,-68,11,735,2,-528,-169,0,0,-1,0,6
EUW1_6877866610',1,35,17,1,0,1,0,13,1,356,91,33612,28568,45132,2,22,31,0,0,0,0,5,333,80,35048,30636,46926,0,23,11,-1436,-14,-2068,-1794,1,0,1,0,8
EUW1_6877841214',9,32,17,0,0,0,0,13,0,341,81,28861,26964,32651,5,24,25,1,1,1,0,0,320,70,33762,29281,47377,0,21,11,-4901,-8,-2317,-14726,-1,-1,-1,0,13
EUW1_6877833513',2,33,14,0,0,1,0,10,1,348,87,29694,29999,35297,1,22,19,2,0,2,0,3,349,76,31017,30684,34544,1,-1,11,-1323,-5,-685,753,-2,0,-1,0,7
EUW1_6876873548',6,36,14,2,0,0,0,11,1,351,96,26971,31659,29258,0,36,5,0,0,0,0,2,400,106,25666,29479,26803,1,-49,-10,1305,9,2180,2455,2,0,0,0,9
EUW1_6876720068',2,29,8,2,0,0,0,4,1,375,104,24835,29336,23995,7,31,11,0,0,0,0,2,382,74,26300,30979,30710,1,-7,30,-1465,-3,-1643,-6715,2,0,0,0,2
EUW1_6876689260',4,26,20,2,0,0,0,4,0,358,96,30191,31482,40771,3,76,9,0,0,0,0,2,368,88,24997,27193,29667,1,-10,8,5194,11,4289,11104,2,0,0,0,2
EUW1_6876414273',6,27,15,1,1,0,0,14,1,367,110,29023,30872,30427,1,26,9,1,0,2,0,5,342,94,27217,29370,29685,1,25,16,1806,6,1502,742,0,1,-2,0,9
EUW1_6876402407',7,26,17,1,0,1,0,4,1,369,76,29751,30783,34376,2,93,10,0,0,0,0,4,352,114,26946,30380,26967,0,17,-38,2805,7,403,7409,1,0,1,0,0
EUW1_6876398599',4,33,14,0,0,0,0,17,1,376,99,29927,31650,43915,3,22,18,2,0,3,0,6,365,88,32294,30106,39011,1,11,11,-2367,-4,1544,4904,-2,0,-3,0,11
EUW1_6876349426',6,27,17,2,1,2,0,8,0,357,89,29202,31648,30697,1,21,3,0,0,0,0,2,363,98,22775,26318,21066,1,-6,-9,6427,14,5330,9631,2,1,2,0,6
EUW1_6876321876',3,31,18,2,0,1,0,11,1,393,105,31697,33062,37577,3,34,15,0,0,0,0,5,338,94,27095,33018,42485,0,55,11,4602,3,44,-4908,2,0,1,0,6
EUW1_6875282609',3,26,11,0,0,0,0,9,1,406,100,28635,31651,30491,3,30,13,1,0,1,0,4,339,84,26462,29680,28339,1,67,16,2173,-2,1971,2152,-1,0,-1,0,5
EUW1_6883510070',3,61,22,1,0,0,0,8,1,337,94,31258,31590,43635,3,74,11,0,0,0,0,4,340,72,25405,28808,30658,1,-3,22,5853,11,2782,12977,1,0,0,0,4
EUW1_6883473844',2,36,8,0,0,0,0,7,0,358,78,25089,28190,27842,3,25,7,2,0,0,0,2,355,100,24472,28172,26503,0,3,-22,617,1,18,1339,-2,0,0,0,5
EUW1_6882142434',2,21,8,0,0,0,0,13,1,312,94,24564,26435,27546,5,21,21,2,0,3,0,6,341,88,33587,31331,41534,0,-29,6,-9023,-13,-4896,-13988,-2,0,-3,0,7
EUW1_6882118484',4,23,14,2,0,1,0,4,1,366,107,30968,31597,37488,2,21,14,0,0,1,0,6,348,48,26312,27969,31483,1,18,59,4656,0,3628,6005,2,0,0,0,-2
EUW1_6882060810',1,311,19,0,0,2,0,10,0,370,102,32320,31884,43806,8,55,19,1,0,2,0,12,360,81,32076,30684,41467,1,10,21,244,0,1200,2339,-1,0,0,0,-2
EUW1_6880617676',4,25,7,0,0,0,0,15,0,318,80,22947,27081,29056,6,29,29,2,1,4,0,1,404,127,39032,36402,48221,0,-86,-47,-16085,-22,-9321,-19165,-2,-1,-4,0,14
EUW1_6880561041',3,30,11,0,0,2,0,11,1,357,92,27876,31576,23345,6,27,7,1,0,2,0,4,396,104,27097,31035,27256,0,-39,-12,779,4,541,-3911,-1,0,0,0,7
EUW1_6876257805',1,28,15,0,0,3,0,7,1,384,77,29912,29612,26359,2,35,10,2,0,0,0,4,327,94,25401,27162,25407,1,57,-17,4511,5,2450,952,-2,0,3,0,3
EUW1_6876218571',4,28,10,1,0,0,0,11,1,326,88,25316,27356,26331,0,29,9,1,0,1,0,2,355,108,27196,29743,29766,0,-29,-20,-1880,1,-2387,-3435,0,0,-1,0,9
EUW1_6876164736',1,25,17,1,0,0,0,14,1,335,94,28667,28666,36871,1,36,15,1,0,3,0,5,362,88,31298,30621,36372,0,-27,6,-2631,2,-1955,499,0,0,-3,0,9
EUW1_6876095420',3,26,10,1,0,0,0,11,0,383,80,26380,28422,27019,3,72,14,1,0,2,0,2,419,112,31060,32182,39456,0,-36,-32,-4680,-4,-3760,-12437,0,0,-2,0,9
EUW1_6862449634',9,37,17,0,0,1,0,3,1,367,108,30636,31289,41015,5,29,8,2,0,0,0,8,298,60,25345,28402,27598,0,69,48,5291,9,2887,13417,-2,0,1,0,-5
EUW1_6862321688',6,31,11,0,0,0,0,5,0,388,108,27967,29979,31631,3,74,15,2,0,0,0,4,342,72,28489,30807,35834,0,46,36,-522,-4,-828,-4203,-2,0,0,0,1
EUW1_6862219347',5,35,13,1,0,2,0,13,0,354,82,28302,28364,33773,8,26,12,1,0,1,0,3,338,88,28240,28191,25605,0,16,-6,62,1,173,8168,0,0,1,0,10
EUW1_6861087582',7,28,12,1,0,0,0,13,1,404,96,28899,31929,33587,3,84,11,0,0,2,0,1,369,92,27770,32490,31639,0,35,4,1129,1,-561,1948,1,0,-2,0,12
EUW1_6860897900',3,62,9,0,0,0,0,7,0,360,78,25605,28725,24769,7,75,13,1,0,1,0,2,343,98,28063,28627,33137,0,17,-20,-2458,-4,98,-8368,-1,0,-1,0,5
EUW1_6855229303',6,61,11,0,0,0,0,12,0,355,82,27143,31339,41213,0,61,22,1,0,1,0,1,371,101,32908,32320,40155,0,-16,-19,-5765,-11,-981,1058,-1,0,-1,0,11
EUW1_6801067049',3,34,18,2,0,2,0,9,0,382,76,30515,30505,38013,8,30,11,0,0,1,0,8,374,103,28873,30981,31677,0,8,-27,1642,7,-476,6336,2,0,1,0,1
EUW1_6883623511',8,34,22,0,1,3,0,5,1,365,95,34007,30140,38157,1,23,15,1,0,1,0,10,275,76,26677,24215,33350,1,90,19,7330,7,5925,4807,-1,1,2,0,-5
EUW1_6883580383',6,32,10,1,0,0,0,10,1,352,99,26168,28928,26542,3,49,13,1,0,0,0,2,390,92,28555,30506,26691,1,-38,7,-2387,-3,-1578,-149,0,0,0,0,8
EUW1_6883513033',4,31,9,0,0,0,0,6,0,417,108,27224,30816,22393,1,39,11,1,0,1,0,4,355,95,27154,30696,27459,0,62,13,70,-2,120,-5066,-1,0,-1,0,2
EUW1_6882209333',5,24,8,0,0,1,0,9,0,355,92,24790,28405,23046,1,51,17,1,0,0,0,4,343,82,29031,30537,29593,1,12,10,-4241,-9,-2132,-6547,-1,0,1,0,5
EUW1_6882189809',5,29,6,2,0,1,0,8,1,350,98,25388,27773,29190,7,26,15,0,0,1,0,6,318,90,28538,29271,35104,1,32,8,-3150,-9,-1498,-5914,2,0,0,0,2
EUW1_6874989128',7,63,28,1,0,0,0,10,1,370,78,34032,30694,43654,3,28,16,1,0,0,0,5,309,82,27774,26320,30804,1,61,-4,6258,12,4374,12850,0,0,0,0,5
EUW1_6874965968',7,30,8,0,0,0,0,10,0,353,90,24995,29783,27839,6,29,9,1,0,1,0,2,391,94,27105,30638,26869,0,-38,-4,-2110,-1,-855,970,-1,0,-1,0,8
EUW1_6874936131',1,50,17,0,0,0,0,12,1,300,106,28534,28604,38475,5,27,22,2,0,3,0,1,349,110,34444,30702,36886,1,-49,-4,-5910,-5,-2098,1589,-2,0,-3,0,11
EUW1_6874888358',6,38,17,2,0,0,0,9,1,296,89,27282,27872,27851,8,33,15,0,0,1,0,1,384,86,29863,29892,34520,0,-88,3,-2581,2,-2020,-6669,2,0,-1,0,8
EUW1_6863796099',4,29,12,1,0,1,0,2,0,377,102,28058,31203,28942,0,29,11,1,0,0,0,6,386,94,27970,30433,31225,1,-9,8,88,1,770,-2283,0,0,1,0,-4
EUW1_6863123116',1,25,4,0,0,0,0,15,0,323,78,23258,25006,31305,5,29,16,1,1,2,0,4,385,93,31190,32310,27101,0,-62,-15,-7932,-12,-7304,4204,-1,-1,-2,0,11
EUW1_6862724421',5,42,10,2,0,0,0,6,1,381,92,25872,29773,27657,4,24,10,0,0,1,0,1,369,70,27132,30481,33839,0,12,22,-1260,0,-708,-6182,2,0,-1,0,5
EUW1_6862680307',6,94,11,1,0,0,0,9,1,374,117,27620,31803,25534,5,29,7,1,1,1,0,3,394,97,26478,31465,27833,1,-20,20,1142,4,338,-2299,0,-1,-1,0,6
EUW1_6871906218',2,23,20,1,0,0,0,6,0,341,80,29294,31301,42357,7,35,16,1,0,0,0,0,341,91,28406,30359,47842,0,0,-11,888,4,942,-5485,0,0,0,0,6
EUW1_6871526175',3,21,13,1,0,1,0,9,1,316,88,28240,30888,37918,2,33,15,1,0,0,0,3,372,77,28559,29593,35959,0,-56,11,-319,-2,1295,1959,0,0,1,0,6
EUW1_6870365258',5,30,10,1,0,0,0,8,0,348,63,25424,30481,34535,2,21,14,1,1,0,0,2,373,112,28742,32332,35176,0,-25,-49,-3318,-4,-1851,-641,0,-1,0,0,6
EUW1_6878293410',2,29,8,1,0,1,0,3,1,388,84,26874,28807,31766,3,23,12,1,0,0,0,5,318,80,25503,27187,25431,0,70,4,1371,-4,1620,6335,0,0,1,0,-2
EUW1_6877111284',6,30,6,0,0,0,0,9,0,373,84,24042,28030,24043,4,24,15,2,0,1,0,2,376,112,29594,32958,35681,0,-3,-28,-5552,-9,-4928,-11638,-2,0,-1,0,7
EUW1_6875957319',1,25,11,1,1,0,0,9,0,344,74,25859,28181,27579,2,36,7,1,0,1,0,1,349,98,26299,27227,24428,1,-5,-24,-440,4,954,3151,0,1,-1,0,8
EUW1_6875887955',5,25,5,1,0,1,0,8,0,371,92,25275,28655,27205,2,54,13,1,0,0,0,2,306,92,25418,27559,29007,0,65,0,-143,-8,1096,-1802,0,0,1,0,6
EUW1_6875850836',4,29,19,2,0,1,0,4,1,375,90,31495,32253,40597,1,24,9,0,0,1,0,7,298,87,24880,26531,30878,1,77,3,6615,10,5722,9719,2,0,0,0,-3
EUW1_6875799651',6,35,9,1,0,0,0,17,0,274,60,23863,24278,29269,3,58,18,1,0,3,0,2,346,106,31541,30092,41790,0,-72,-46,-7678,-9,-5814,-12521,0,0,-3,0,15
EUW1_6875740341',6,31,18,2,1,1,0,4,0,407,82,31909,30543,32682,5,28,11,0,0,1,0,8,295,105,25979,26048,25649,1,112,-23,5930,7,4495,7033,2,1,0,0,-4
EUW1_6875694193',2,23,5,0,0,0,0,11,1,271,74,22526,23873,25562,4,23,18,1,0,3,0,2,383,102,30966,31926,43818,0,-112,-28,-8440,-13,-8053,-18256,-1,0,-3,0,9
EUW1_6873006351',2,84,16,0,0,3,0,9,1,383,89,31413,29253,41839,4,28,13,2,0,0,0,4,316,86,26711,28472,31270,1,67,3,4702,3,781,10569,-2,0,3,0,5
EUW1_6872944213',5,28,10,0,0,0,0,12,1,337,78,25913,28903,31835,5,33,10,1,0,0,0,1,354,92,26307,29121,33373,1,-17,-14,-394,0,-218,-1538,-1,0,0,0,11
EUW1_6872863281',5,80,7,0,0,0,0,11,0,320,91,23806,26012,28077,7,31,7,2,0,1,0,3,350,75,24973,26307,20701,1,-30,16,-1167,0,-295,7376,-2,0,-1,0,8
EUW1_6872821505',5,30,17,2,0,1,0,8,1,325,76,29511,28761,34377,2,24,15,0,0,1,0,3,328,100,27594,29450,33636,1,-3,-24,1917,2,-689,741,2,0,0,0,5
EUW1_6871749881',4,166,15,0,0,1,0,15,0,356,80,28426,29627,23299,6,23,9,2,0,3,0,5,374,79,28978,28188,32406,0,-18,1,-552,6,1439,-9107,-2,0,-2,0,10
EUW1_6871705472',2,21,11,1,0,0,0,11,0,348,77,26506,27802,38891,5,30,22,1,1,3,0,3,340,99,32604,31534,47105,0,8,-22,-6098,-11,-3732,-8214,0,-1,-3,0,8
EUW1_6871650466',1,26,7,0,0,0,0,14,1,310,77,23419,25881,22582,4,24,16,2,0,5,0,2,374,94,32450,32031,32472,0,-64,-17,-9031,-9,-6150,-9890,-2,0,-5,0,12
EUW1_6883151658',1,21,10,0,0,0,0,11,0,337,62,26066,26465,40186,1,30,30,1,0,3,0,1,323,101,35998,32434,48315,0,14,-39,-9932,-20,-5969,-8129,-1,0,-3,0,10
EUW1_6882940565',4,64,12,1,0,0,0,5,0,369,84,27869,30509,38569,4,59,11,1,0,1,0,4,353,84,26443,28749,29652,0,16,0,1426,1,1760,8917,0,0,-1,0,1
EUW1_6882582610',5,28,8,0,0,0,0,12,1,305,73,24125,27435,26530,2,28,9,2,0,1,0,1,393,112,26534,30170,30121,0,-88,-39,-2409,-1,-2735,-3591,-2,0,-1,0,11
EUW1_6876695736',2,24,9,0,1,1,0,6,1,395,90,26720,29383,30142,4,52,11,2,0,1,0,6,357,106,26557,30611,24145,0,38,-16,163,-2,-1228,5997,-2,1,0,0,0
EUW1_6876641162',3,28,13,1,0,0,0,8,1,378,99,29204,30532,27301,7,28,15,1,0,2,0,3,326,120,29165,31369,31407,0,52,-21,39,-2,-837,-4106,0,0,-2,0,5
EUW1_6876613859',2,27,14,0,1,2,0,8,0,365,82,29574,29779,38049,1,27,14,1,0,0,0,4,357,64,26663,28945,39460,1,8,18,2911,0,834,-1411,-1,1,2,0,4
EUW1_6875788532',3,31,9,0,0,0,0,10,1,410,80,27058,29553,29808,6,42,11,1,0,0,0,3,349,88,26491,28354,24738,0,61,-8,567,-2,1199,5070,-1,0,0,0,7
EUW1_6874164610',4,24,12,0,0,0,0,10,0,311,68,25865,26642,31919,2,26,20,2,0,1,0,3,390,104,32451,32026,37626,0,-79,-36,-6586,-8,-5384,-5707,-2,0,-1,0,7
EUW1_6874111373',7,34,12,2,1,1,0,12,0,323,88,27021,28912,35890,4,19,12,0,0,1,0,2,383,65,27880,29865,27787,0,-60,23,-859,0,-953,8103,2,1,0,0,10
EUW1_6873314133',4,26,8,1,0,0,0,16,0,352,86,26386,28019,28902,5,60,20,1,1,3,0,0,390,78,31716,29275,34165,1,-38,8,-5330,-12,-1256,-5263,0,-1,-3,0,16
EUW1_6882460765',5,28,12,1,1,2,0,7,1,349,106,29766,30525,43980,1,23,8,1,0,0,0,7,321,86,23715,26866,25481,1,28,20,6051,4,3659,18499,0,1,2,0,0
EUW1_6882434568',5,27,14,2,1,1,0,9,1,383,92,29946,30644,35002,5,26,10,0,0,2,0,6,376,107,28462,31186,24090,0,7,-15,1484,4,-542,10912,2,1,-1,0,3
EUW1_6881155380',4,32,6,0,0,0,0,15,0,329,76,23817,26955,30140,5,28,16,2,0,3,0,3,386,108,31517,31772,36870,0,-57,-32,-7700,-10,-4817,-6730,-2,0,-3,0,12
EUW1_6881108515',3,23,16,0,0,0,0,7,0,380,93,30274,31745,33486,5,29,14,1,0,2,0,4,354,82,28507,30895,38831,1,26,11,1767,2,850,-5345,-1,0,-2,0,3
EUW1_6881065829',5,30,6,0,0,0,0,6,0,365,90,25118,28453,26692,4,85,18,2,0,0,0,5,384,88,30028,30970,33199,0,-19,2,-4910,-12,-2517,-6507,-2,0,0,0,1
EUW1_6881025482',5,34,10,1,0,0,0,13,1,309,102,25532,29069,31062,1,42,14,1,0,1,0,2,370,82,28067,30041,33093,1,-61,20,-2535,-4,-972,-2031,0,0,-1,0,11
EUW1_6880988817',4,26,16,0,0,0,0,11,0,348,94,28797,31225,42196,2,20,19,2,0,1,0,3,358,78,31686,31829,43130,0,-10,16,-2889,-3,-604,-934,-2,0,-1,0,8
EUW1_6880945201',3,46,12,1,0,0,0,10,1,390,82,27685,32184,36191,4,23,11,1,0,0,0,2,330,84,25601,27728,33743,1,60,-2,2084,1,4456,2448,0,0,0,0,8
EUW1_6880902405',7,30,16,1,0,0,0,5,0,391,94,30897,31710,34257,6,39,14,1,0,1,0,6,370,69,27709,29417,34377,1,21,25,3188,2,2293,-120,0,0,-1,0,-1
EUW1_6880882190',6,71,13,2,0,3,0,8,1,380,96,29683,30898,26962,7,69,8,0,0,0,0,10,318,88,24808,27212,19310,1,62,8,4875,5,3686,7652,2,0,3,0,-2
EUW1_6879500322',3,24,10,1,1,0,0,12,0,340,98,25439,29055,23951,3,23,11,1,0,2,0,1,390,80,28884,29461,32385,0,-50,18,-3445,-1,-406,-8434,0,1,-2,0,11
EUW1_6879480903',2,71,9,0,0,0,0,12,0,321,97,26189,29836,29471,1,37,20,2,0,3,0,5,383,116,32802,35261,53298,0,-62,-19,-6613,-11,-5425,-23827,-2,0,-3,0,7
EUW1_6879436380',6,31,12,0,0,1,0,9,0,363,88,28353,29487,28664,7,31,14,2,0,2,0,7,331,88,28777,29920,30557,0,32,0,-424,-2,-433,-1893,-2,0,-1,0,2
EUW1_6879421513',1,23,7,1,0,1,0,5,1,400,76,26437,30412,27529,5,30,4,1,0,0,0,8,372,123,23205,29609,20501,1,28,-47,3232,3,803,7028,0,0,1,0,-3
EUW1_6878553166',6,34,8,1,1,0,0,10,1,385,82,26455,28371,36504,10,38,15,1,0,0,0,2,377,74,28651,31398,36942,0,8,8,-2196,-7,-3027,-438,0,1,0,0,8
EUW1_6876519804',4,28,7,1,0,1,0,5,1,378,106,27869,30347,32457,6,155,12,1,0,1,0,4,304,66,24566,29818,32752,0,74,40,3303,-5,529,-295,0,0,0,0,1
EUW1_6876508518',3,98,13,0,0,0,0,10,0,365,70,26099,28285,35120,5,36,16,2,0,2,0,2,363,106,30590,30967,36005,0,2,-36,-4491,-3,-2682,-885,-2,0,-2,0,8
EUW1_6871886500',3,29,17,2,0,0,0,9,0,351,76,28313,31600,34809,3,28,14,0,0,2,0,3,342,82,28784,28390,37805,1,9,-6,-471,3,3210,-2996,2,0,-2,0,6
EUW1_6871798532',5,24,17,2,0,1,0,10,1,361,104,31360,33175,40897,6,30,9,0,0,1,0,6,334,94,25467,29188,32820,0,27,10,5893,8,3987,8077,2,0,0,0,4
EUW1_6871217992',3,27,6,0,0,0,0,14,0,349,60,23294,26634,27620,3,43,14,1,0,1,0,0,359,99,29134,30390,32078,0,-10,-39,-5840,-8,-3756,-4458,-1,0,-1,0,14
EUW1_6862207734',6,34,13,2,0,2,0,3,1,393,68,28302,28790,27699,7,41,2,0,0,0,0,6,335,103,22378,26152,20001,1,58,-35,5924,11,2638,7698,2,0,2,0,-3
EUW1_6862174119',6,31,12,0,0,1,0,8,0,384,82,28432,30397,31716,6,45,10,1,0,0,0,6,326,65,25147,27743,28463,1,58,17,3285,2,2654,3253,-1,0,1,0,2
EUW1_6862147147',4,25,16,1,0,1,0,8,0,377,83,30662,30552,39395,4,29,11,1,0,1,0,5,346,76,26773,26874,30724,1,31,7,3889,5,3678,8671,0,0,0,0,3
EUW1_6862121375',2,22,6,0,0,0,0,8,0,400,68,25150,27828,32603,4,33,12,2,0,1,0,4,343,80,27043,28652,30574,0,57,-12,-1893,-6,-824,2029,-2,0,-1,0,4
EUW1_6862110746',6,49,20,1,0,2,0,12,0,332,92,32333,30010,39155,5,36,17,0,0,0,0,7,319,80,28414,28431,37025,1,13,12,3919,3,1579,2130,1,0,2,0,5
EUW1_6862073573',3,25,17,1,0,2,0,15,1,340,102,32052,28765,36638,0,69,14,1,0,2,0,5,367,94,30034,31079,34634,1,-27,8,2018,3,-2314,2004,0,0,0,0,10
EUW1_6862056229',3,28,15,1,0,0,0,9,1,296,76,26561,26518,43173,0,35,24,0,1,1,0,3,341,74,33077,32544,47340,0,-45,2,-6516,-9,-6026,-4167,1,-1,-1,0,6
EUW1_6862050789',5,32,15,1,0,1,0,6,1,317,104,28257,30697,30903,4,28,9,1,0,1,0,1,395,104,27117,31445,23773,1,-78,0,1140,6,-748,7130,0,0,0,0,5
EUW1_6862041712',8,41,15,1,0,0,0,8,0,359,64,30874,29584,30876,5,26,13,1,0,1,0,6,358,96,28309,27514,35577,1,1,-32,2565,2,2070,-4701,0,0,-1,0,2
EUW1_6862030926',2,45,11,0,0,0,0,3,1,420,103,27551,32372,25861,1,27,5,0,0,0,0,4,390,72,23500,28342,19749,1,30,31,4051,6,4030,6112,0,0,0,0,-1
EUW1_6861114336',8,309,11,0,0,0,0,8,1,342,91,27610,28620,29594,4,30,7,1,0,1,0,2,371,92,26234,29214,24298,1,-29,-1,1376,4,-594,5296,-1,0,-1,0,6
EUW1_6861087441',5,26,15,2,0,0,0,6,1,367,89,29158,31227,35328,3,37,8,0,0,1,0,4,336,78,25188,27321,25657,1,31,11,3970,7,3906,9671,2,0,-1,0,2
EUW1_6861055654',3,43,8,0,0,0,0,10,1,372,99,25906,29503,24797,5,30,10,2,0,1,0,2,399,86,27347,29411,31174,1,-27,13,-1441,-2,92,-6377,-2,0,-1,0,8
EUW1_6861015206',6,31,18,1,0,2,0,7,1,366,98,31994,30807,34760,5,29,13,1,0,0,0,7,382,88,29832,31574,32650,1,-16,10,2162,5,-767,2110,0,0,2,0,0
EUW1_6860983263',2,122,5,0,0,0,0,8,0,373,84,25078,27883,28840,2,33,13,1,1,0,0,5,404,87,29075,31775,33972,0,-31,-3,-3997,-8,-3892,-5132,-1,-1,0,0,3
EUW1_6860957770',6,30,18,0,0,1,0,7,0,303,88,30395,28703,39272,0,24,24,0,0,0,0,0,318,85,31440,30321,45364,1,-15,3,-1045,-6,-1618,-6092,0,0,1,0,7
EUW1_6860937919',1,22,13,2,1,1,0,4,1,394,102,29550,32723,34203,3,29,6,0,0,0,0,7,342,92,24421,28697,22887,1,52,10,5129,7,4026,11316,2,1,1,0,-3
EUW1_6860903215',6,34,11,0,0,0,0,8,0,331,102,26510,30158,28029,6,35,13,2,0,1,0,1,372,90,28514,31706,34444,0,-41,12,-2004,-2,-1548,-6415,-2,0,-1,0,7
EUW1_6860892637',6,40,8,1,0,0,0,10,1,360,90,25079,28416,32679,2,39,8,0,1,1,0,0,373,101,27734,30221,26168,0,-13,-11,-2655,0,-1805,6511,1,-1,-1,0,10
EUW1_6883353541',5,36,23,1,0,1,0,14,1,376,77,33370,29977,38629,4,40,14,1,0,1,0,4,313,89,28794,25767,37570,1,63,-12,4576,9,4210,1059,0,0,0,0,10
EUW1_6883288488',2,34,12,0,0,0,0,7,0,342,92,27993,30923,37586,8,89,14,1,0,0,0,2,346,98,26451,29244,31998,1,-4,-6,1542,-2,1679,5588,-1,0,0,0,5
EUW1_6883227870',2,30,6,0,0,0,0,10,0,344,73,24866,27419,22991,6,48,21,2,1,1,0,2,371,110,31835,32367,35974,0,-27,-37,-6969,-15,-4948,-12983,-2,-1,-1,0,8
EUW1_6882701359',5,152,17,2,0,3,0,5,1,386,99,32584,30483,40599,0,26,14,0,0,0,0,13,342,84,27661,29602,27584,1,44,15,4923,3,881,13015,2,0,3,0,-8
EUW1_6882665097',2,63,14,0,0,0,0,13,1,334,93,29974,29950,27499,9,77,13,2,0,2,0,6,360,90,27598,27546,32361,0,-26,3,2376,1,2404,-4862,-2,0,-2,0,7
EUW1_6882643924',3,21,18,2,1,3,0,4,1,393,110,35258,32828,28548,1,32,6,0,0,1,0,11,326,90,24244,27483,24206,1,67,20,11014,12,5345,4342,2,1,2,0,-7
EUW1_6882554745',3,32,13,1,0,0,0,13,0,329,61,27392,29066,32822,8,53,19,1,0,2,0,2,388,118,31656,30961,38244,0,-59,-57,-4264,-6,-1895,-5422,0,0,-2,0,11
EUW1_6882523711',4,47,3,1,0,0,0,7,0,415,79,24227,28966,20554,1,29,8,1,0,0,0,3,417,80,25717,28953,19167,0,-2,-1,-1490,-5,13,1387,0,0,0,0,4
EUW1_6882022909',5,40,8,1,0,1,0,7,1,380,106,27064,30782,25586,3,40,6,0,1,1,0,6,376,84,25322,29606,29712,1,4,22,1742,2,1176,-4126,1,-1,0,0,1
EUW1_6881960377',8,57,15,2,0,1,0,12,0,373,92,29603,29620,33445,9,34,11,0,0,0,0,4,329,84,27177,28761,32832,1,44,8,2426,4,859,613,2,0,1,0,8
EUW1_6881388777',1,19,9,1,0,0,0,15,0,314,80,25884,28308,27585,7,88,27,0,1,3,0,3,386,124,36645,35582,51430,0,-72,-44,-10761,-18,-7274,-23845,1,-1,-3,0,12
EUW1_6881331075',3,33,21,1,0,2,0,4,0,350,88,31431,28713,40943,8,44,12,1,0,1,0,7,306,88,26160,27615,31103,1,44,0,5271,9,1098,9840,0,0,1,0,-3
EUW1_6881230450',3,45,12,0,0,0,0,13,0,316,88,26745,28529,30706,2,42,22,2,0,3,0,2,407,84,34007,33411,42683,0,-91,4,-7262,-10,-4882,-11977,-2,0,-3,0,11
EUW1_6881176342',3,45,12,1,0,0,0,8,0,334,92,27580,29396,35975,4,48,12,0,0,1,0,7,421,78,29227,30593,36796,0,-87,14,-1647,0,-1197,-821,1,0,-1,0,1
EUW1_6881151935',3,22,6,0,0,0,0,13,0,340,93,23088,27062,20048,2,40,15,2,1,4,0,3,389,126,32602,32458,29293,0,-49,-33,-9514,-9,-5396,-9245,-2,-1,-4,0,10
EUW1_6881054220',5,26,8,1,0,0,0,16,0,291,118,25504,27854,23382,4,38,18,1,0,3,0,3,391,80,31862,29830,43371,0,-100,38,-6358,-10,-1976,-19989,0,0,-3,0,13
EUW1_6881026170',4,22,10,0,0,1,0,8,1,348,83,26445,29133,27126,7,37,7,2,1,0,0,3,361,108,25759,29057,24283,1,-13,-25,686,3,76,2843,-2,-1,1,0,5
EUW1_6882686751',2,24,12,0,1,1,0,6,1,365,110,28570,29700,25983,6,23,12,2,0,1,0,2,385,93,27988,30265,31299,0,-20,17,582,0,-565,-5316,-2,1,0,0,4
EUW1_6882608365',3,33,11,1,0,0,0,9,0,351,86,26997,29566,33534,5,53,26,1,0,1,0,0,357,93,34164,32539,46597,0,-6,-7,-7167,-15,-2973,-13063,0,0,-1,0,9
EUW1_6881771650',0,26,19,2,1,2,0,7,1,376,102,32095,31599,29443,2,22,5,0,0,1,0,9,277,76,22419,25015,21945,1,99,26,9676,14,6584,7498,2,1,1,0,-2
EUW1_6881702843',2,39,8,1,0,0,0,4,1,371,81,24893,29095,29689,2,26,14,1,0,0,0,2,386,74,28138,30469,26560,0,-15,7,-3245,-6,-1374,3129,0,0,0,0,2
EUW1_6881244258',4,24,12,0,1,0,0,13,0,300,88,26949,27138,27135,1,24,22,2,0,1,0,3,396,102,31977,32215,43337,0,-96,-14,-5028,-10,-5077,-16202,-2,1,-1,0,10
EUW1_6881170761',1,36,7,0,0,0,0,17,0,231,64,22156,21708,27059,2,24,26,2,0,6,0,1,398,103,37353,33390,45987,0,-167,-39,-15197,-19,-11682,-18928,-2,0,-6,0,16
EUW1_6880181830',7,165,10,1,0,0,0,13,1,330,81,25835,27663,36083,8,36,11,0,0,0,0,0,393,78,27916,29644,33854,0,-63,3,-2081,-1,-1981,2229,1,0,0,0,13
EUW1_6861951644',2,30,11,0,0,1,0,11,1,315,89,28363,27628,33695,2,22,28,1,0,2,0,1,358,70,33525,32505,51635,0,-43,19,-5162,-17,-4877,-17940,-1,0,-1,0,10
EUW1_6861099767',5,31,17,0,0,0,0,8,0,302,76,29086,27693,34247,1,13,18,0,0,2,0,7,357,38,28599,29649,37139,1,-55,38,487,-1,-1956,-2892,0,0,-2,0,1
EUW1_6861049280',8,41,11,1,0,0,0,5,1,377,80,26470,28903,28229,4,25,9,1,0,0,0,1,380,86,26612,29208,30914,1,-3,-6,-142,2,-305,-2685,0,0,0,0,4
EUW1_6851319976',5,53,9,2,0,0,0,13,1,233,88,23489,22554,22118,1,26,16,0,0,2,0,0,370,70,31259,27801,45955,0,-137,18,-7770,-7,-5247,-23837,2,0,-2,0,13
EUW1_6849464835',5,40,11,0,0,0,0,9,1,347,90,27699,29834,39450,3,28,18,1,0,0,0,3,344,94,29593,31315,39893,0,3,-4,-1894,-7,-1481,-443,-1,0,0,0,6
EUW1_6848708056',2,21,23,0,0,2,0,7,1,366,62,34813,32477,47421,2,28,14,1,0,0,0,9,366,84,28700,28995,35611,1,0,-22,6113,9,3482,11810,-1,0,2,0,-2
EUW1_6848686360',2,28,9,1,0,0,0,6,0,412,93,27042,31390,30104,3,71,5,0,0,0,0,2,388,88,24173,29926,22556,1,24,5,2869,4,1464,7548,1,0,0,0,4
EUW1_6848673827',6,26,15,1,0,0,0,16,0,323,65,28721,27922,35202,4,26,16,1,0,2,0,1,372,108,31184,30645,37148,0,-49,-43,-2463,-1,-2723,-1946,0,0,-2,0,15
EUW1_6846019402',4,26,11,1,0,0,0,7,0,372,92,28129,30184,35866,5,39,12,0,0,1,0,5,370,72,26927,28458,30201,0,2,20,1202,-1,1726,5665,1,0,-1,0,2
EUW1_6846014572',3,35,25,2,0,2,0,7,1,400,68,36136,32840,47137,4,32,13,0,0,1,0,12,307,82,28005,27130,31296,1,93,-14,8131,12,5710,15841,2,0,1,0,-5
EUW1_6845464007',2,21,19,2,0,2,0,16,0,371,128,34021,34069,36185,2,41,7,0,0,1,0,8,355,71,24971,26561,26165,1,16,57,9050,12,7508,10020,2,0,1,0,8
EUW1_6829457775',5,59,11,0,1,2,0,6,1,360,98,29575,31112,27806,0,25,12,2,0,0,0,8,325,86,25826,28328,32808,1,35,12,3749,-1,2784,-5002,-2,1,2,0,-2
EUW1_6825298755',2,21,11,1,0,0,0,10,0,330,116,27664,30120,35206,3,32,10,1,0,1,0,4,374,99,27713,31906,37481,0,-44,17,-49,1,-1786,-2275,0,0,-1,0,6
EUW1_6825271766',3,26,15,0,0,1,0,9,0,303,99,29200,29524,32362,5,46,15,1,0,0,0,4,350,90,28626,28725,32814,1,-47,9,574,0,799,-452,-1,0,1,0,5
EUW1_6811573845',0,37,11,0,0,0,0,8,1,351,96,27195,28671,27420,5,32,13,2,0,1,0,1,365,99,28281,30540,28212,0,-14,-3,-1086,-2,-1869,-792,-2,0,-1,0,7
EUW1_6811471885',8,28,5,1,0,0,0,12,0,333,75,23048,27482,24278,3,18,15,1,0,3,0,2,391,131,31356,32419,34401,0,-58,-56,-8308,-10,-4937,-10123,0,0,-3,0,10
EUW1_6811393279',1,27,9,0,0,0,0,8,0,361,92,27004,27366,25950,6,33,17,2,0,1,0,6,334,78,29327,27331,26380,0,27,14,-2323,-8,35,-430,-2,0,-1,0,2
EUW1_6809572636',3,24,18,1,0,0,0,14,0,345,78,31076,30719,38382,2,23,22,1,0,2,0,6,380,113,34314,32562,42874,1,-35,-35,-3238,-4,-1843,-4492,0,0,-2,0,8
EUW1_6809503751',1,25,22,2,0,1,0,11,1,337,84,33314,29850,41953,6,30,17,0,0,1,0,5,327,76,29661,29190,37589,1,10,8,3653,5,660,4364,2,0,0,0,6
EUW1_6868622416',1,34,14,0,0,0,0,9,0,355,56,28306,29739,37641,4,19,19,2,0,1,0,4,319,73,28818,28648,38526,0,36,-17,-512,-5,1091,-885,-2,0,-1,0,5
EUW1_6866534201',2,29,8,2,0,1,0,8,1,399,70,27205,30043,24074,3,27,6,0,0,0,0,8,333,105,24697,28765,21968,1,66,-35,2508,2,1278,2106,2,0,1,0,0
EUW1_6862304844',4,29,6,0,0,0,0,6,1,359,78,24127,27736,24067,4,62,9,1,0,2,0,0,384,116,27846,31445,28708,0,-25,-38,-3719,-3,-3709,-4641,-1,0,-2,0,6
EUW1_6862238274',4,30,8,0,0,0,0,7,0,358,70,25213,28112,21591,1,39,16,1,0,1,0,3,339,92,28491,29969,30109,0,19,-22,-3278,-8,-1857,-8518,-1,0,-1,0,4
EUW1_6861308060',4,58,10,1,0,1,0,6,1,355,81,26492,30371,25687,2,31,4,0,0,0,0,5,329,86,22778,26852,23048,1,26,-5,3714,6,3519,2639,1,0,1,0,1
EUW1_6861178410',4,30,12,0,0,3,0,10,0,346,94,28606,29151,37012,5,56,12,2,0,1,0,5,365,80,28147,28032,36447,0,-19,14,459,0,1119,565,-2,0,2,0,5
EUW1_6861144134',4,39,13,1,0,0,0,8,1,362,108,29637,31764,36967,4,71,8,0,0,1,0,5,350,64,24835,27198,26279,1,12,44,4802,5,4566,10688,1,0,-1,0,3
EUW1_6861106683',7,40,6,0,0,1,0,7,0,404,83,26471,29421,21193,1,40,5,1,0,0,0,4,399,99,25148,29417,23440,0,5,-16,1323,1,4,-2247,-1,0,1,0,3
EUW1_6861057217',9,43,18,0,0,3,0,3,0,347,96,31321,31798,28051,4,36,12,2,0,0,0,5,352,79,26056,28489,36069,1,-5,17,5265,6,3309,-8018,-2,0,3,0,-2
EUW1_6861011125',3,34,18,0,0,1,0,6,1,347,85,30033,28955,42340,3,39,15,2,0,0,0,5,310,100,27478,28321,38926,0,37,-15,2555,3,634,3414,-2,0,1,0,1
EUW1_6858328482',2,27,8,0,0,0,0,7,1,356,75,25265,28687,31085,6,29,6,2,0,1,0,6,372,91,24848,29113,32473,0,-16,-16,417,2,-426,-1388,-2,0,-1,0,1
EUW1_6858286068',2,29,8,0,0,1,0,13,0,337,74,25381,28292,36610,4,99,17,1,0,3,0,2,344,106,32067,30213,40362,0,-7,-32,-6686,-9,-1921,-3752,-1,0,-2,0,11
EUW1_6858246747',7,42,15,1,0,0,0,7,1,359,88,28710,29769,33579,2,54,15,0,0,0,0,2,385,74,29705,30804,31947,0,-26,14,-995,0,-1035,1632,1,0,0,0,5
EUW1_6875742579',3,27,14,0,0,1,0,11,1,354,98,28923,31076,29513,0,34,15,2,0,2,0,5,340,76,28368,29760,33394,0,14,22,555,-1,1316,-3881,-2,0,-1,0,6
EUW1_6875681269',3,37,10,2,0,0,0,9,1,329,73,25624,28477,34102,3,33,15,0,0,1,0,1,374,118,31427,30953,35097,0,-45,-45,-5803,-5,-2476,-995,2,0,-1,0,8
EUW1_6875570302',3,36,18,1,1,1,0,10,0,342,82,32938,31210,36342,5,39,14,0,0,1,0,6,355,62,28083,27495,32420,1,-13,20,4855,4,3715,3922,1,1,0,0,4
EUW1_6875503259',3,24,16,1,0,0,0,7,0,355,40,27411,28004,35331,0,19,13,0,0,1,0,0,350,93,28296,29492,29176,1,5,-53,-885,3,-1488,6155,1,0,-1,0,7
EUW1_6875288522',5,31,11,0,0,1,0,7,0,378,76,27193,30070,34138,6,29,9,2,0,0,0,1,343,84,24752,27934,25962,1,35,-8,2441,2,2136,8176,-2,0,1,0,6
EUW1_6875158843',5,35,2,1,0,0,0,11,0,343,87,21798,26954,21502,5,80,12,1,0,1,0,1,339,76,27909,29620,25340,0,4,11,-6111,-10,-2666,-3838,0,0,-1,0,10
EUW1_6872267382',2,38,13,1,0,1,0,4,1,361,90,27520,29083,29430,2,19,7,1,0,1,0,4,368,110,25797,28670,31775,1,-7,-20,1723,6,413,-2345,0,0,0,0,0
EUW1_6872244387',7,26,13,1,0,0,0,10,0,371,62,27525,29360,32125,1,27,8,1,0,0,0,3,329,114,25167,28337,27120,1,42,-52,2358,5,1023,5005,0,0,0,0,7
EUW1_6872231481',5,53,11,1,0,1,0,4,1,335,108,26736,29306,28168,3,33,6,0,0,0,0,5,336,56,22790,27428,31245,1,-1,52,3946,5,1878,-3077,1,0,1,0,-1
EUW1_6872191565',3,25,10,1,0,1,0,5,0,354,94,26316,27700,27156,2,23,8,1,0,1,0,6,330,92,24762,28165,28755,0,24,2,1554,2,-465,-1599,0,0,0,0,-1
EUW1_6872156691',7,32,16,1,0,0,0,6,1,387,82,28066,30781,30881,3,27,6,0,0,0,0,4,361,89,23860,27842,30387,1,26,-7,4206,10,2939,494,1,0,0,0,2
EUW1_6870730906',4,24,9,0,0,1,0,12,1,361,72,25378,27473,24998,4,26,16,1,0,1,0,1,397,99,30594,34028,36440,0,-36,-27,-5216,-7,-6555,-11442,-1,0,0,0,11
EUW1_6870129017',0,25,14,1,0,0,0,4,1,362,100,28551,31184,34677,3,32,9,1,1,1,0,4,323,88,26271,28384,37892,0,39,12,2280,5,2800,-3215,0,-1,-1,0,0
EUW1_6869967203',5,25,16,2,0,0,0,4,1,333,92,27864,29214,39920,4,23,11,0,0,0,0,3,343,68,25602,28934,29249,0,-10,24,2262,5,280,10671,2,0,0,0,1
EUW1_6869881786',5,24,15,0,0,0,0,13,0,312,93,27666,29663,33866,4,25,17,1,0,1,0,2,378,76,30747,31667,39868,0,-66,17,-3081,-2,-2004,-6002,-1,0,-1,0,11
EUW1_6869728915',5,35,11,0,0,0,0,6,0,364,88,25739,31053,33993,3,95,8,2,0,0,0,1,362,80,24576,28707,23923,0,2,8,1163,3,2346,10070,-2,0,0,0,5
EUW1_6869664316',2,27,11,0,0,1,0,6,0,316,90,26917,28361,34976,2,28,13,2,0,0,0,4,336,94,27188,28572,39245,1,-20,-4,-271,-2,-211,-4269,-2,0,1,0,2
EUW1_6867569572',5,27,12,0,0,0,0,10,0,332,90,27317,29480,32369,3,38,15,2,1,2,0,0,383,102,30266,31769,34498,1,-51,-12,-2949,-3,-2289,-2129,-2,-1,-2,0,10
EUW1_6867534688',4,25,16,1,0,1,0,10,1,294,86,28733,26924,36255,5,28,18,0,0,1,0,1,363,82,30365,28415,34817,0,-69,4,-1632,-2,-1491,1438,1,0,0,0,9
EUW1_6883130524',3,28,7,0,0,0,0,9,1,387,114,25701,31087,25302,6,24,9,2,0,1,0,1,438,90,27719,31980,25319,0,-51,24,-2018,-2,-893,-17,-2,0,-1,0,8
EUW1_6882572509',5,43,25,1,0,4,0,8,1,359,100,35418,32958,46894,6,30,8,1,0,0,0,9,300,104,25094,27487,32575,1,59,-4,10324,17,5471,14319,0,0,4,0,-1
EUW1_6875303971',3,26,9,1,0,0,0,12,1,353,98,26069,27626,23713,4,24,17,1,1,2,0,2,412,81,32403,31464,34507,0,-59,17,-6334,-8,-3838,-10794,0,-1,-2,0,10
EUW1_6875234821',7,33,7,0,1,1,0,10,1,391,92,26215,29004,30365,6,103,11,2,0,1,0,4,355,84,26852,28641,27362,0,36,8,-637,-4,363,3003,-2,1,0,0,6
EUW1_6875208299',7,47,6,0,0,0,0,12,0,406,109,25496,30007,25253,3,31,11,2,0,3,0,0,424,98,29605,32135,27213,0,-18,11,-4109,-5,-2128,-1960,-2,0,-3,0,12
EUW1_6874740811',3,33,13,1,0,0,0,12,0,323,96,26685,29045,33245,5,29,21,1,1,3,0,1,375,74,33269,30849,40745,0,-52,22,-6584,-8,-1804,-7500,0,-1,-3,0,11
EUW1_6883725200',3,32,8,1,0,0,0,10,0,375,83,24502,28569,29258,1,50,12,1,1,1,0,2,336,92,27543,29282,24178,0,39,-9,-3041,-4,-713,5080,0,-1,-1,0,8
EUW1_6883714856',4,69,8,1,0,2,0,10,1,394,112,29792,33470,25294,1,23,2,0,0,1,0,7,359,100,22473,28632,22200,1,35,12,7319,6,4838,3094,1,0,1,0,3
EUW1_6883642904',0,22,9,1,0,1,0,5,0,433,83,28719,31318,38351,3,27,10,0,0,0,0,4,348,98,25932,30201,36210,0,85,-15,2787,-1,1117,2141,1,0,1,0,1
EUW1_6883594821',2,26,23,1,0,1,0,7,1,345,104,32765,32055,45497,0,27,9,0,0,2,0,7,278,72,23141,25425,24896,1,67,32,9624,14,6630,20601,1,0,-1,0,0
EUW1_6882679657',3,81,9,0,0,0,0,12,0,274,101,25220,26586,31850,8,24,27,2,0,2,0,3,333,86,32237,31563,43871,0,-59,15,-7017,-18,-4977,-12021,-2,0,-2,0,9
EUW1_6882643274',7,30,13,1,0,1,0,6,1,333,108,28295,30349,35815,1,33,7,1,0,0,0,3,315,99,23215,27031,24622,1,18,9,5080,6,3318,11193,0,0,1,0,3
EUW1_6882613605',4,24,18,1,0,1,0,16,1,312,68,29924,28420,38966,4,99,23,1,0,3,0,5,324,92,34051,30013,42532,1,-12,-24,-4127,-5,-1593,-3566,0,0,-2,0,11
EUW1_6882558962',2,39,19,1,0,3,0,12,1,375,83,32590,29740,34055,7,34,12,0,0,0,0,7,323,71,26987,27834,26025,0,52,12,5603,7,1906,8030,1,0,3,0,5
EUW1_6882531608',4,31,5,0,0,1,0,10,0,352,104,25338,27503,30453,2,58,20,2,1,1,0,7,344,99,30517,31937,37510,0,8,5,-5179,-15,-4434,-7057,-2,-1,0,0,3
EUW1_6882472981',6,39,20,1,1,0,0,7,1,373,88,32617,30936,38819,5,30,13,1,0,1,0,2,337,81,26427,26794,32006,1,36,7,6190,7,4142,6813,0,1,-1,0,5
EUW1_6882443148',6,26,7,2,0,0,0,10,1,335,78,23770,28075,22767,5,35,6,0,1,1,0,0,374,98,25606,30012,26420,0,-39,-20,-1836,1,-1937,-3653,2,-1,-1,0,10
EUW1_6882423686',6,63,16,2,0,0,0,11,0,384,104,30057,32657,33492,3,18,10,0,0,1,0,5,367,83,27430,28796,29510,1,17,21,2627,6,3861,3982,2,0,-1,0,6
EUW1_6882401058',7,30,10,0,0,1,0,7,1,340,58,26456,27456,25716,3,34,14,1,0,1,0,4,363,98,29814,30431,37202,0,-23,-40,-3358,-4,-2975,-11486,-1,0,0,0,3
EUW1_6882380065',4,32,7,1,1,0,0,9,1,345,98,26210,29546,28780,5,26,18,0,0,1,0,7,379,97,28857,32361,35405,0,-34,1,-2647,-11,-2815,-6625,1,1,-1,0,2
EUW1_6882368957',4,33,12,0,0,0,0,6,0,328,99,27459,28738,34640,6,27,16,2,0,1,0,5,385,92,29444,30164,36162,1,-57,7,-1985,-4,-1426,-1522,-2,0,-1,0,1
EUW1_6882237261',2,17,8,0,0,1,0,7,1,383,86,27445,30713,27400,3,27,6,1,0,1,0,9,323,82,24107,27478,25255,0,60,4,3338,2,3235,2145,-1,0,0,0,-2
EUW1_6881838132',7,25,14,0,0,0,0,9,0,326,70,26827,28131,30896,2,36,10,1,0,0,0,2,326,114,26210,28866,32466,1,0,-44,617,4,-735,-1570,-1,0,0,0,7
EUW1_6883768863',4,26,8,0,0,0,0,3,0,396,82,26589,29962,29995,4,22,10,2,0,0,0,4,353,99,25699,30584,26327,0,43,-17,890,-2,-622,3668,-2,0,0,0,-1
EUW1_6882606697',4,36,14,0,0,0,0,7,1,338,74,27010,27283,41564,3,28,15,2,0,1,0,1,352,85,29413,30097,38306,1,-14,-11,-2403,-1,-2814,3258,-2,0,-1,0,6
EUW1_6882563496',6,32,9,0,0,0,0,10,0,380,93,25579,30426,27044,3,31,9,1,0,1,0,4,397,82,27551,29596,27649,0,-17,11,-1972,0,830,-605,-1,0,-1,0,6
EUW1_6881130758',3,27,18,1,0,2,0,6,1,375,82,30478,30319,37417,1,364,11,1,0,0,0,8,343,106,27007,30832,30837,1,32,-24,3471,7,-513,6580,0,0,2,0,-2
EUW1_6881083476',2,24,7,0,0,0,0,7,0,386,98,25069,30134,28314,4,192,11,1,0,0,0,1,386,93,26931,33353,28246,1,0,5,-1862,-4,-3219,68,-1,0,0,0,6
EUW1_6881040869',6,30,5,1,0,0,0,8,0,396,109,24371,28898,20104,3,40,10,0,0,1,0,1,425,90,28529,31256,26317,0,-29,19,-4158,-5,-2358,-6213,1,0,-1,0,7
EUW1_6880940119',3,28,15,0,0,0,0,8,0,344,105,28063,29585,31769,2,65,17,1,0,1,0,3,328,74,29290,29128,35869,1,16,31,-1227,-2,457,-4100,-1,0,-1,0,5
EUW1_6880911612',6,23,14,1,0,0,0,9,1,341,70,27869,28915,33040,2,28,16,1,0,2,0,3,373,86,30394,31270,33372,0,-32,-16,-2525,-2,-2355,-332,0,0,-2,0,6
EUW1_6880486987',3,39,7,0,0,0,0,5,0,387,102,24901,31033,21244,4,29,10,2,0,0,0,3,398,117,27378,31344,27014,0,-11,-15,-2477,-3,-311,-5770,-2,0,0,0,2
EUW1_6880423980',8,28,13,0,0,1,0,7,1,333,61,26502,29860,35123,3,26,18,1,0,1,0,4,330,101,28585,31246,35714,0,3,-40,-2083,-5,-1386,-591,-1,0,0,0,3
EUW1_6880364895',3,23,14,1,0,1,0,13,0,368,98,28468,30752,31958,4,26,11,1,1,1,0,2,366,101,28305,30426,34684,1,2,-3,163,3,326,-2726,0,-1,0,0,11
EUW1_6880298603',2,22,9,0,0,0,0,5,1,373,104,26167,30103,28153,9,33,12,2,0,0,0,4,330,87,25732,29535,32320,1,43,17,435,-3,568,-4167,-2,0,0,0,1
EUW1_6880233268',6,27,7,1,0,0,0,7,1,400,78,24973,30866,30020,5,29,10,0,0,0,0,4,394,98,26856,30964,33774,0,6,-20,-1883,-3,-98,-3754,1,0,0,0,3
EUW1_6880167387',2,27,9,1,1,1,0,5,0,326,107,26826,30428,33683,6,29,14,1,0,1,0,3,368,88,27210,29958,31966,1,-42,19,-384,-5,470,1717,0,1,0,0,2
EUW1_6880121999',5,34,10,0,0,0,0,12,0,330,122,26062,30505,28112,3,40,17,2,0,2,0,3,416,102,31638,34127,35467,0,-86,20,-5576,-7,-3622,-7355,-2,0,-2,0,9
EUW1_6880093580',6,45,22,0,0,2,0,5,1,400,104,34485,33090,37735,2,28,4,1,0,0,0,9,319,96,22001,25600,25541,1,81,8,12484,18,7490,12194,-1,0,2,0,-4
EUW1_6880035237',2,24,10,0,0,0,0,11,0,341,80,25219,29329,29140,1,21,11,1,1,2,0,1,377,136,29822,34309,29093,0,-36,-56,-4603,-1,-4980,47,-1,-1,-2,0,10
EUW1_6879982610',2,26,15,1,1,2,0,6,0,409,106,32757,33112,39937,2,27,12,1,0,1,0,10,346,117,26823,30216,30032,1,63,-11,5934,3,2896,9905,0,1,1,0,-4
EUW1_6879716374',0,19,9,0,0,0,0,11,0,327,83,24820,27074,22402,2,41,10,2,0,1,0,3,371,88,27640,29566,29714,1,-44,-5,-2820,-1,-2492,-7312,-2,0,-1,0,8
EUW1_6879675784',6,33,15,0,1,0,0,9,1,321,88,28311,29242,34471,1,29,16,2,0,2,0,5,361,112,29333,31249,38486,0,-40,-24,-1022,-1,-2007,-4015,-2,1,-2,0,4
EUW1_6881739619',2,32,15,0,0,0,0,15,0,298,72,27322,26424,37091,6,36,23,1,1,2,0,2,353,84,33284,30711,38940,0,-55,-12,-5962,-8,-4287,-1849,-1,-1,-2,0,13
EUW1_6881687655',7,28,17,2,0,4,0,4,1,382,100,32638,29649,36445,3,33,8,0,0,0,0,13,288,60,23673,26667,20361,1,94,40,8965,9,2982,16084,2,0,4,0,-9
EUW1_6881615126',0,32,14,1,0,1,0,10,1,339,98,28605,28563,27956,2,20,14,1,0,1,0,6,330,105,28424,29863,33620,1,9,-7,181,0,-1300,-5664,0,0,0,0,4
EUW1_6881529998',4,26,17,1,0,0,0,13,0,315,80,27345,30135,34288,7,33,14,1,0,2,0,2,401,104,30586,32402,35737,0,-86,-24,-3241,3,-2267,-1449,0,0,-2,0,11
EUW1_6881468428',4,24,10,0,0,1,0,11,0,318,78,25549,24944,35022,0,30,20,2,1,3,0,4,299,90,30723,28779,35166,0,19,-12,-5174,-10,-3835,-144,-2,-1,-2,0,7
EUW1_6881417418',4,22,12,1,0,1,0,1,0,400,125,29634,31965,25686,3,29,7,1,0,0,0,7,308,102,24514,29708,24523,1,92,23,5120,5,2257,1163,0,0,1,0,-6
EUW1_6881233756',4,30,15,1,0,1,0,9,0,374,116,30766,32046,38922,2,18,13,1,0,1,0,4,359,60,26854,29208,33821,1,15,56,3912,2,2838,5101,0,0,0,0,5
EUW1_6881171900',4,24,9,1,0,0,0,7,0,332,91,26562,27376,28410,3,27,12,1,0,0,0,6,334,112,27371,29112,25994,0,-2,-21,-809,-3,-1736,2416,0,0,0,0,1
EUW1_6878367183',3,27,9,0,0,1,0,13,1,322,72,26531,27445,24684,3,23,20,1,0,1,0,6,382,114,31411,32878,38300,0,-60,-42,-4880,-11,-5433,-13616,-1,0,0,0,7
EUW1_6878325709',3,26,9,1,0,2,0,11,0,326,85,26665,28043,29819,3,24,24,1,1,1,0,0,334,96,32426,31996,36423,0,-8,-11,-5761,-15,-3953,-6604,0,-1,1,0,11
EUW1_6875531787',3,27,12,0,1,0,0,8,0,379,102,28555,31809,28927,1,22,11,1,0,1,0,1,343,122,28038,32901,25830,1,36,-20,517,1,-1092,3097,-1,1,-1,0,7
EUW1_6870855684',4,30,18,2,0,1,0,10,1,384,78,31184,32359,35109,3,38,17,0,0,1,0,5,391,94,31206,32817,37909,0,-7,-16,-22,1,-458,-2800,2,0,0,0,5
EUW1_6870824887',3,27,28,1,0,1,0,7,0,381,82,33075,33767,49447,1,27,11,1,0,0,0,5,319,60,27438,27840,35842,1,62,22,5637,17,5927,13605,0,0,1,0,2
EUW1_6870781658',3,23,14,0,0,2,0,9,1,406,115,30549,33607,27999,6,31,6,1,0,1,0,7,378,82,25174,29046,23069,1,28,33,5375,8,4561,4930,-1,0,1,0,2
EUW1_6864416717',2,23,8,0,0,1,0,11,0,401,70,26278,29442,25728,6,448,11,2,0,2,0,1,405,96,28168,32047,26951,0,-4,-26,-1890,-3,-2605,-1223,-2,0,-1,0,10
EUW1_6862002055',6,23,15,2,1,0,0,7,1,358,98,30769,30432,32899,3,32,20,0,0,1,0,6,330,76,28122,28160,30994,1,28,22,2647,-5,2272,1905,2,1,-1,0,1
EUW1_6861994999',2,27,26,0,0,1,0,5,1,341,86,34060,32155,47136,1,28,9,1,0,2,0,10,296,74,24865,25940,30570,1,45,12,9195,17,6215,16566,-1,0,-1,0,-5
EUW1_6861983677',3,29,17,0,0,0,0,12,1,358,84,31003,31524,42080,2,31,8,2,0,0,0,3,353,109,25858,29480,26160,0,5,-25,5145,9,2044,15920,-2,0,0,0,9
EUW1_6861961877',3,32,14,0,0,0,0,15,1,301,55,26901,27821,29492,1,203,24,1,0,2,0,0,376,127,35867,34465,45404,1,-75,-72,-8966,-10,-6644,-15912,-1,0,-2,0,15
EUW1_6860717837',3,21,11,0,0,0,0,12,0,342,61,26373,28667,28448,3,26,22,2,0,4,0,4,380,109,34775,34838,36602,0,-38,-48,-8402,-11,-6171,-8154,-2,0,-4,0,8
EUW1_6860687199',3,26,12,1,0,1,0,8,1,375,80,28164,31353,31018,3,49,12,0,0,0,0,7,412,96,29438,32852,35695,0,-37,-16,-1274,0,-1499,-4677,1,0,1,0,1
EUW1_6860664686',5,33,4,1,1,0,0,7,1,353,122,24251,29260,21629,2,26,7,0,0,0,0,3,390,79,25330,29173,26926,1,-37,43,-1079,-3,87,-5297,1,1,0,0,4
EUW1_6859981200',3,60,18,0,0,0,0,10,0,321,86,29728,27180,45907,5,29,20,1,0,1,0,1,334,80,31756,29609,44630,1,-13,6,-2028,-2,-2429,1277,-1,0,-1,0,9
EUW1_6859921446',1,17,16,1,0,7,1,6,1,363,100,33320,28644,30901,2,11,5,0,0,2,1,12,193,76,18791,21985,13104,1,170,24,14529,11,6659,17797,1,0,5,0,-6
EUW1_6851704694',1,25,5,1,0,1,0,11,0,388,96,25854,28916,20666,3,48,11,1,0,1,0,3,355,108,27007,29402,23453,1,33,-12,-1153,-6,-486,-2787,0,0,0,0,8
EUW1_6851681384',3,49,18,1,1,3,0,9,1,356,112,32944,31374,37966,2,30,7,0,0,1,0,7,337,60,23065,25542,22895,1,19,52,9879,11,5832,15071,1,1,2,0,2
EUW1_6851677766',0,23,15,1,0,0,0,10,1,366,100,28846,31384,36335,6,31,14,1,1,0,0,2,386,100,29207,31055,33701,0,-20,0,-361,1,329,2634,0,-1,0,0,8
EUW1_6839023626',3,28,11,1,0,0,0,11,0,353,94,26748,29236,24012,5,47,10,1,1,2,0,1,416,109,29038,29709,30331,1,-63,-15,-2290,1,-473,-6319,0,-1,-2,0,10
EUW1_6838966270',4,30,19,2,0,3,0,5,1,342,90,31504,31620,37127,5,33,6,0,0,0,0,6,368,77,24695,27710,28199,1,-26,13,6809,13,3910,8928,2,0,3,0,-1
EUW1_6838908255',7,100,7,2,0,0,0,9,0,351,88,24307,28986,32234,5,32,7,0,0,1,0,2,349,95,25787,28370,31279,0,2,-7,-1480,0,616,955,2,0,-1,0,7
EUW1_6835082866',4,28,8,0,0,1,0,15,0,388,92,26582,29785,25004,5,31,9,2,0,1,0,0,395,103,27430,29885,23614,0,-7,-11,-848,-1,-100,1390,-2,0,0,0,15
EUW1_6883603159',7,57,8,0,0,1,0,9,0,348,78,25881,27540,20232,3,32,14,2,0,1,0,5,408,86,28422,29608,30546,0,-60,-8,-2541,-6,-2068,-10314,-2,0,0,0,4
EUW1_6883592689',3,27,2,0,0,0,0,5,0,330,47,21447,25033,26125,5,53,24,1,0,0,0,5,334,115,30497,33479,41986,0,-4,-68,-9050,-22,-8446,-15861,-1,0,0,0,0
EUW1_6882797500',3,35,27,1,0,1,0,12,0,284,80,33851,29876,44083,3,44,30,0,0,2,0,6,335,92,36392,31188,55169,0,-51,-12,-2541,-3,-1312,-11086,1,0,-1,0,6
EUW1_6882747009',2,24,7,0,1,1,0,7,0,397,100,27048,29525,24027,5,34,9,2,0,0,0,7,397,92,26844,31537,28880,1,0,8,204,-2,-2012,-4853,-2,1,1,0,0
EUW1_6882713718',8,32,7,1,0,0,0,5,1,361,68,24786,28449,27179,4,31,11,0,0,0,0,2,359,103,26447,28658,31474,0,2,-35,-1661,-4,-209,-4295,1,0,0,0,3
EUW1_6858456057',2,38,6,0,0,0,0,14,0,297,91,23362,25917,25687,6,30,19,2,0,3,0,0,403,92,32981,32651,41057,0,-106,-1,-9619,-13,-6734,-15370,-2,0,-3,0,14
EUW1_6858410433',5,39,13,1,0,0,0,12,0,368,84,28185,29043,36966,6,36,18,1,0,1,0,3,343,69,31650,30380,33047,0,25,15,-3465,-5,-1337,3919,0,0,-1,0,9
EUW1_6858349148',3,28,15,1,0,1,0,10,0,358,88,28928,30560,35267,6,30,7,0,0,1,0,4,340,76,26236,28558,30990,1,18,12,2692,8,2002,4277,1,0,0,0,6
EUW1_6857942141',3,33,10,0,0,0,0,8,0,369,68,25674,29933,26482,2,23,11,1,0,1,0,0,409,111,28765,31487,30515,1,-40,-43,-3091,-1,-1554,-4033,-1,0,-1,0,8
EUW1_6857914166',4,39,10,1,0,0,0,7,1,356,92,26404,28906,27878,4,45,4,0,0,0,0,0,383,81,24465,27607,28867,0,-27,11,1939,6,1299,-989,1,0,0,0,7
EUW1_6857887756',3,23,12,1,0,0,0,4,1,371,96,27237,29473,31646,4,31,8,1,1,1,0,4,340,82,25376,29075,22810,1,31,14,1861,4,398,8836,0,-1,-1,0,0
EUW1_6857842396',1,17,13,2,0,1,0,5,1,365,118,29513,31593,28893,3,19,13,0,0,1,0,3,384,98,28027,31326,35324,1,-19,20,1486,0,267,-6431,2,0,0,0,2
EUW1_6847501505',6,31,19,2,0,2,0,5,1,326,86,31081,30331,34940,5,24,12,0,0,1,0,6,362,86,28651,28993,28758,0,-36,0,2430,7,1338,6182,2,0,1,0,-1
EUW1_6844449511',5,24,6,0,0,0,0,16,0,310,79,23955,28154,30530,3,75,13,2,0,3,0,0,387,96,30854,29689,33731,0,-77,-17,-6899,-7,-1535,-3201,-2,0,-3,0,16
EUW1_6859546308',3,27,12,0,0,1,0,7,1,400,83,28257,28429,34756,8,45,16,2,0,1,0,4,351,76,29189,30805,36226,0,49,7,-932,-4,-2376,-1470,-2,0,0,0,3
EUW1_6859514852',4,26,16,0,0,0,0,10,1,345,98,27954,28470,36510,2,32,15,1,0,0,0,1,334,82,28954,29890,36501,0,11,16,-1000,1,-1420,9,-1,0,0,0,9
EUW1_6859483884',7,28,12,1,0,0,0,8,0,329,90,26623,28965,26684,4,34,14,0,1,2,0,2,357,64,28961,30630,37999,0,-28,26,-2338,-2,-1665,-11315,1,-1,-2,0,6
EUW1_6859442073',2,110,18,2,1,1,0,10,0,333,76,30149,29625,36749,2,70,15,0,0,0,0,5,351,80,29152,30234,38060,0,-18,-4,997,3,-609,-1311,2,1,1,0,5
EUW1_6859427116',0,36,17,0,0,0,0,9,1,318,85,29283,28722,32046,5,89,11,1,0,1,0,3,387,74,28695,29947,33887,1,-69,11,588,6,-1225,-1841,-1,0,-1,0,6
EUW1_6882153264',2,30,4,0,0,2,0,8,1,339,87,24980,26409,26330,3,25,19,2,0,1,0,6,346,86,28792,30679,39491,0,-7,1,-3812,-15,-4270,-13161,-2,0,1,0,2
EUW1_6882104204',3,39,10,0,0,2,0,7,1,365,80,27563,29249,33318,2,21,8,1,0,1,0,5,364,98,25997,29595,19767,0,1,-18,1566,2,-346,13551,-1,0,1,0,2
EUW1_6882037345',5,27,10,0,0,0,0,7,0,360,78,25272,27541,29863,4,26,10,2,1,0,0,3,356,101,26283,29276,33225,1,4,-23,-1011,0,-1735,-3362,-2,-1,0,0,4
EUW1_6881990278',4,20,12,0,0,2,0,12,1,334,94,28775,27925,29991,3,29,14,1,0,3,0,3,363,74,30542,30887,32188,0,-29,20,-1767,-2,-2962,-2197,-1,0,-1,0,9
EUW1_6881938592',4,50,28,2,0,2,0,11,1,349,112,36122,32386,47694,2,30,14,0,0,2,0,9,269,72,27515,26564,37228,1,80,40,8607,14,5822,10466,2,0,0,0,2
EUW1_6881852418',5,23,20,2,0,1,0,11,0,327,88,31981,30945,38748,5,23,20,0,0,4,0,5,317,63,30689,29645,41273,1,10,25,1292,0,1300,-2525,2,0,-3,0,6
EUW1_6881604995',4,146,25,1,0,3,0,11,1,371,80,34210,32255,44252,6,27,10,1,0,1,0,6,295,80,25120,26331,31013,1,76,0,9090,15,5924,13239,0,0,2,0,5
EUW1_6881528535',3,28,8,2,0,0,0,8,0,346,82,23607,27802,24405,4,27,7,0,0,1,0,3,388,78,25561,29115,30253,1,-42,4,-1954,1,-1313,-5848,2,0,-1,0,5
EUW1_6881460134',2,19,14,0,0,0,0,8,0,357,82,27610,29359,35063,3,30,17,1,0,0,0,1,341,86,29785,30446,42422,0,16,-4,-2175,-3,-1087,-7359,-1,0,0,0,7
EUW1_6881406812',3,30,9,2,0,1,0,19,0,307,80,26622,26173,37146,3,31,23,0,0,2,0,4,351,100,33801,31644,38146,0,-44,-20,-7179,-14,-5471,-1000,2,0,-1,0,15
EUW1_6881367406',0,21,8,0,0,0,0,11,0,319,88,24720,27782,30244,4,19,25,1,0,2,0,0,395,72,33520,32506,38827,0,-76,16,-8800,-17,-4724,-8583,-1,0,-2,0,11
EUW1_6881297438',4,27,15,0,0,0,0,15,0,278,108,28603,28125,31954,7,33,22,2,0,2,0,1,316,74,32243,28748,39304,0,-38,34,-3640,-7,-623,-7350,-2,0,-2,0,14
EUW1_6881046447',3,28,18,0,0,0,0,10,1,316,101,29533,30815,49583,2,29,15,1,0,0,0,3,334,94,28484,29803,34405,1,-18,7,1049,3,1012,15178,-1,0,0,0,7
EUW1_6880971646',4,26,11,1,0,0,0,13,0,380,99,27154,29159,29457,3,24,10,0,0,1,0,2,375,112,28648,30595,29698,1,5,-13,-1494,1,-1436,-241,1,0,-1,0,11
EUW1_6876424884',2,20,17,0,0,1,0,6,1,352,100,29500,31856,43271,4,28,12,1,0,1,0,8,360,99,29726,31051,33357,1,-8,1,-226,5,805,9914,-1,0,0,0,-2
EUW1_6876406061',5,42,14,1,0,0,0,11,0,288,77,28149,28069,32522,3,28,26,0,0,2,0,3,322,120,33712,32489,45021,1,-34,-43,-5563,-12,-4420,-12499,1,0,-2,0,8
EUW1_6882247577',2,40,11,0,1,1,0,9,0,363,101,27170,29513,29651,2,90,19,1,0,2,0,4,334,88,28504,31277,26819,1,29,13,-1334,-8,-1764,2832,-1,1,-1,0,5
EUW1_6882127782',3,28,11,1,0,0,0,9,0,319,104,26145,27956,36364,1,20,22,1,0,1,0,4,364,99,31841,32668,38933,1,-45,5,-5696,-11,-4712,-2569,0,0,-1,0,5
EUW1_6882013062',0,27,16,2,0,1,0,7,0,333,103,29206,28320,42068,3,26,17,0,0,0,0,4,337,93,29694,29878,35927,1,-4,10,-488,-1,-1558,6141,2,0,1,0,3
EUW1_6880783283',6,28,8,2,0,0,0,13,1,384,104,25762,30691,24220,5,27,12,0,0,2,0,1,384,96,28545,30377,27801,0,0,8,-2783,-4,314,-3581,2,0,-2,0,12
EUW1_6879212479',3,31,18,2,1,0,0,6,0,356,126,30352,35425,39402,1,23,10,0,0,0,0,2,361,90,26446,28436,26820,1,-5,36,3906,8,6989,12582,2,1,0,0,4
EUW1_6878949004',3,22,17,0,0,1,0,3,1,402,106,30464,34001,37285,3,25,13,1,0,0,0,6,365,90,27960,32664,29858,0,37,16,2504,4,1337,7427,-1,0,1,0,-3
EUW1_6877596066',2,39,15,1,0,2,0,9,1,383,86,30502,31032,36725,0,28,8,0,0,0,0,7,347,82,24553,27621,28820,1,36,4,5949,7,3411,7905,1,0,2,0,2
EUW1_6877434610',2,26,10,1,0,1,0,11,1,392,82,27478,29752,31151,4,32,16,1,1,0,0,5,320,110,28593,31532,32873,0,72,-28,-1115,-6,-1780,-1722,0,-1,1,0,6
EUW1_6877360353',2,269,22,1,0,0,0,11,1,352,82,30308,33496,46079,2,20,6,0,0,1,0,1,378,77,24748,28024,31564,0,-26,5,5560,16,5472,14515,1,0,-1,0,10
EUW1_6877307084',1,27,8,0,0,0,0,15,0,309,94,24906,27941,21310,3,16,17,2,0,2,0,2,346,102,30662,29430,33044,0,-37,-8,-5756,-9,-1489,-11734,-2,0,-2,0,13
EUW1_6877239189',8,37,15,1,0,0,0,13,0,326,74,27212,28168,35879,5,29,5,1,0,2,0,4,384,77,26680,28415,21877,1,-58,-3,532,10,-247,14002,0,0,-2,0,9
EUW1_6877022548',2,22,22,1,0,2,0,16,1,375,98,32808,32552,42097,2,24,18,0,0,1,0,2,373,86,31593,33128,36840,1,2,12,1215,4,-576,5257,1,0,1,0,14
EUW1_6876944708',2,29,5,0,0,1,0,9,0,397,75,26298,30417,19933,4,40,9,2,0,1,0,4,383,100,26167,29844,25625,0,14,-25,131,-4,573,-5692,-2,0,0,0,5
EUW1_6876896628',1,30,9,0,0,2,0,7,1,327,83,27649,28380,30992,4,99,17,2,0,0,0,7,288,102,27598,30499,37261,1,39,-19,51,-8,-2119,-6269,-2,0,2,0,0
EUW1_6876684709',4,36,8,2,1,0,0,8,1,366,90,26775,30057,24708,4,28,8,0,0,1,0,5,371,90,25735,29700,27113,1,-5,0,1040,0,357,-2405,2,1,-1,0,3
EUW1_6876652660',3,28,10,1,0,1,0,11,1,338,105,26779,28277,33391,3,27,20,0,0,3,0,5,375,90,32538,34665,32054,0,-37,15,-5759,-10,-6388,1337,1,0,-2,0,6
EUW1_6876608300',4,23,19,1,0,0,0,9,0,336,70,29925,29238,34842,2,20,11,1,0,0,0,4,370,103,27706,29196,30669,1,-34,-33,2219,8,42,4173,0,0,0,0,5
EUW1_6876583751',1,22,9,1,0,0,0,10,0,341,80,26205,30764,31085,1,28,11,0,0,2,0,5,398,123,29325,31910,34252,0,-57,-43,-3120,-2,-1146,-3167,1,0,-2,0,5
EUW1_6883791806',3,33,2,0,0,0,0,12,0,344,74,21144,27130,19919,5,38,18,2,0,3,0,0,411,116,32217,34090,43781,0,-67,-42,-11073,-16,-6960,-23862,-2,0,-3,0,12
EUW1_6883757219',3,28,11,0,0,0,0,12,1,380,59,27031,27764,29247,4,33,19,2,0,2,0,3,369,100,30895,29774,36215,0,11,-41,-3864,-8,-2010,-6968,-2,0,-2,0,9
EUW1_6883217723',6,39,9,0,1,0,0,7,1,412,90,28652,31184,35657,1,36,16,0,0,1,0,9,371,96,28860,31659,27233,0,41,-6,-208,-7,-475,8424,0,1,-1,0,-2
EUW1_6883142079',8,32,22,1,0,2,0,12,1,334,88,33415,30658,39316,3,34,9,1,0,1,0,5,349,108,26333,28701,32146,0,-15,-20,7082,13,1957,7170,0,0,1,0,7
EUW1_6883079758',0,30,15,1,0,0,0,5,1,358,102,28479,31598,30711,4,31,10,1,0,0,0,4,408,90,26488,32094,24629,1,-50,12,1991,5,-496,6082,0,0,0,0,1
EUW1_6883020196',4,36,10,0,1,1,0,15,1,322,65,26795,27102,28744,6,33,17,2,0,3,0,4,402,97,31589,31674,41812,1,-80,-32,-4794,-7,-4572,-13068,-2,1,-2,0,11
EUW1_6882990050',6,30,4,1,0,0,0,8,0,348,70,22718,26964,22652,3,33,16,1,0,1,0,1,384,61,29047,30445,34410,0,-36,9,-6329,-12,-3481,-11758,0,0,-1,0,7
EUW1_6882927210',4,29,18,2,0,2,0,12,1,337,84,30632,30940,36424,1,26,9,0,0,1,0,5,318,88,26664,26056,31415,1,19,-4,3968,9,4884,5009,2,0,1,0,7
EUW1_6882885577',3,71,20,0,0,0,0,12,0,362,73,30209,29190,36706,2,33,13,0,0,0,0,5,356,72,27042,27194,31092,1,6,1,3167,7,1996,5614,0,0,0,0,7
EUW1_6882843952',5,28,20,1,1,2,0,7,0,340,82,32748,30637,43245,3,33,14,1,0,0,0,3,313,102,27529,29388,39019,1,27,-20,5219,6,1249,4226,0,1,2,0,4
EUW1_6882814135',2,150,3,0,0,0,0,15,1,332,72,21801,23715,22156,2,30,17,2,1,4,0,1,394,124,33202,33053,30594,0,-62,-52,-11401,-14,-9338,-8438,-2,-1,-4,0,14
EUW1_6882694114',7,68,18,0,0,1,0,7,1,406,116,32863,31411,33399,6,27,4,1,0,1,0,4,361,79,23685,26183,21688,1,45,37,9178,14,5228,11711,-1,0,0,0,3
EUW1_6882659637',4,32,18,0,0,2,0,10,0,384,119,32752,33365,46727,5,51,17,2,0,0,0,8,369,70,30139,30471,33583,0,15,49,2613,1,2894,13144,-2,0,2,0,2
EUW1_6882630726',7,40,9,1,0,1,0,5,0,441,111,29168,31811,26367,2,57,8,1,0,0,0,5,403,78,26024,28528,26430,1,38,33,3144,1,3283,-63,0,0,1,0,0
EUW1_6882566628',4,49,10,2,0,0,0,11,1,362,79,26419,28309,27806,7,31,6,0,0,1,0,5,375,80,25503,27065,29823,1,-13,-1,916,4,1244,-2017,2,0,-1,0,6
EUW1_6882533638',5,36,16,1,0,0,0,10,1,349,77,30144,30751,37943,7,35,14,0,0,3,0,4,368,82,30560,30207,28417,0,-19,-5,-416,2,544,9526,1,0,-3,0,6
EUW1_6882489878',3,26,17,1,0,1,0,11,0,354,84,31142,29887,41971,2,37,19,0,1,1,0,1,358,63,31462,29436,38795,0,-4,21,-320,-2,451,3176,1,-1,0,0,10
EUW1_6882462020',6,32,7,2,0,0,0,10,0,407,118,26696,30158,33363,4,39,17,0,0,1,0,3,395,92,32126,31177,36254,1,12,26,-5430,-10,-1019,-2891,2,0,-1,0,7
EUW1_6881774647',2,29,6,1,0,1,0,6,0,441,74,26063,29956,25573,3,35,6,0,0,1,0,5,394,113,25348,30411,27503,1,47,-39,715,0,-455,-1930,1,0,0,0,1
EUW1_6864480250',6,33,27,0,0,0,0,15,1,322,106,33198,32191,48041,4,77,19,1,0,2,0,3,341,73,32413,28950,40726,0,-19,33,785,8,3241,7315,-1,0,-2,0,12
EUW1_6860744929',4,32,24,1,0,1,0,9,1,260,78,30760,27502,40385,4,29,18,1,1,1,0,5,354,78,31446,29093,37505,1,-94,0,-686,6,-1591,2880,0,-1,0,0,4
EUW1_6860733694',9,32,12,0,1,1,0,11,1,376,86,29117,30674,32378,1,98,13,2,0,1,0,3,326,108,28844,29858,28889,1,50,-22,273,-1,816,3489,-2,1,0,0,8
EUW1_6860720644',5,28,31,1,0,4,0,8,0,335,94,38510,29491,52074,7,50,19,0,0,0,0,9,289,50,30517,26097,37492,1,46,44,7993,12,3394,14582,1,0,4,0,-1
EUW1_6860705474',1,25,13,1,1,0,0,4,1,347,117,28532,30292,22750,2,29,12,1,0,1,0,7,320,86,26500,28816,36253,1,27,31,2032,1,1476,-13503,0,1,-1,0,-3
EUW1_6859575376',1,24,14,1,0,0,0,13,1,269,78,27847,26116,30145,7,32,17,1,0,1,0,1,396,94,31627,30794,39384,0,-127,-16,-3780,-3,-4678,-9239,0,0,-1,0,12
EUW1_6844767418',3,33,27,1,1,0,0,7,0,318,76,32988,32153,46695,0,97,20,0,0,0,0,2,350,62,30522,30635,39454,1,-32,14,2466,7,1518,7241,1,1,0,0,5
EUW1_6864540932',1,23,8,1,0,0,0,4,0,393,119,27871,31557,25012,2,19,7,1,0,1,0,4,394,86,23770,30194,20979,1,-1,33,4101,1,1363,4033,0,0,-1,0,0
EUW1_6862023606',0,79,9,2,0,1,0,7,0,374,84,26149,29914,31142,3,25,9,0,0,1,0,4,358,72,26234,29336,24884,1,16,12,-85,0,578,6258,2,0,0,0,3
EUW1_6861997240',8,37,21,1,0,0,0,14,0,298,71,30238,28651,34168,3,24,16,1,0,2,0,4,355,108,32127,30230,39680,0,-57,-37,-1889,5,-1579,-5512,0,0,-2,0,10
EUW1_6861987021',2,24,8,0,0,1,0,11,0,355,85,25987,28214,20155,6,29,15,1,0,2,0,0,405,94,30168,32068,31263,0,-50,-9,-4181,-7,-3854,-11108,-1,0,-1,0,11
EUW1_6861973191',1,20,9,1,0,0,0,11,1,363,76,26264,29555,24675,4,24,13,1,0,1,0,3,353,127,28240,30796,32130,0,10,-51,-1976,-4,-1241,-7455,0,0,-1,0,8
EUW1_6861945437',4,29,8,0,0,0,0,11,1,324,72,25079,26502,30535,3,27,15,2,0,1,0,3,355,104,29239,29590,37929,0,-31,-32,-4160,-7,-3088,-7394,-2,0,-1,0,8
EUW1_6861930747',1,24,18,2,1,0,0,9,1,362,96,30296,32658,36592,1,26,9,0,0,2,0,5,336,91,25789,29203,30395,1,26,5,4507,9,3455,6197,2,1,-2,0,4
EUW1_6861412062',8,33,7,0,0,0,0,12,0,344,71,24140,27140,34849,6,41,16,1,0,1,0,2,391,76,30559,32437,38555,0,-47,-5,-6419,-9,-5297,-3706,-1,0,-1,0,10
EUW1_6861351057',3,26,10,1,0,0,0,5,1,404,76,27389,30349,32042,4,23,7,1,0,0,0,3,379,83,25553,29478,20366,1,25,-7,1836,3,871,11676,0,0,0,0,2
EUW1_6861292318',8,28,5,0,0,1,0,3,0,442,78,27153,30385,24819,2,31,8,1,0,0,0,8,353,106,25307,29778,18083,0,89,-28,1846,-3,607,6736,-1,0,1,0,-5
EUW1_6861249258',6,28,19,2,0,1,0,8,0,419,98,32790,34135,42291,5,26,10,0,0,1,0,8,358,89,26929,30433,30254,1,61,9,5861,9,3702,12037,2,0,0,0,0
EUW1_6859437420',4,42,10,0,0,0,0,9,0,333,100,27011,28667,30505,5,150,18,1,0,0,0,2,357,68,28634,30004,36207,0,-24,32,-1623,-8,-1337,-5702,-1,0,0,0,7
EUW1_6881423519',5,30,16,1,1,0,0,5,0,369,74,27978,31479,33008,1,89,8,1,0,0,0,4,340,87,24723,29099,25790,0,29,-13,3255,8,2380,7218,0,1,0,0,1
EUW1_6881336341',5,27,13,1,0,1,0,8,1,406,82,28976,30273,32117,0,72,11,1,0,2,0,11,311,94,26187,29221,28660,1,95,-12,2789,2,1052,3457,0,0,-1,0,-3
EUW1_6881284336',3,34,16,1,0,2,0,10,1,359,84,30494,29733,34845,4,37,8,1,0,0,0,9,338,103,24537,27583,32398,1,21,-19,5957,8,2150,2447,0,0,2,0,1
EUW1_6881231191',2,27,10,0,0,0,0,9,0,364,105,25450,30974,24852,3,27,9,2,0,1,0,3,376,86,27049,28788,27802,0,-12,19,-1599,1,2186,-2950,-2,0,-1,0,6
EUW1_6881172558',6,31,12,1,0,0,0,9,1,390,72,27496,29527,31764,3,64,8,1,0,1,0,2,384,73,26742,29027,28905,1,6,-1,754,4,500,2859,0,0,-1,0,7
EUW1_6879369537',6,29,7,0,0,0,0,13,0,274,72,23672,26325,23621,5,36,17,2,0,3,0,1,411,86,31687,31626,36299,0,-137,-14,-8015,-10,-5301,-12678,-2,0,-3,0,12
EUW1_6879356770',5,91,22,2,0,1,0,7,1,372,96,32624,31054,37798,3,34,8,0,0,1,0,10,327,95,24860,28232,22949,1,45,1,7764,14,2822,14849,2,0,0,0,-3
EUW1_6877987958',7,37,13,1,1,1,0,9,1,329,98,29329,27687,37384,5,28,14,1,0,1,0,7,322,82,27452,27777,30138,0,7,16,1877,-1,-90,7246,0,1,0,0,2
EUW1_6869577841',3,145,8,0,0,0,0,11,0,377,69,25164,29202,31002,5,27,9,0,0,1,0,0,366,85,26258,29355,28088,0,11,-16,-1094,-1,-153,2914,0,0,-1,0,11
EUW1_6868379634',4,84,6,1,0,0,0,9,1,363,84,24461,27947,32659,2,28,9,0,1,1,0,4,373,68,25394,29512,32535,0,-10,16,-933,-3,-1565,124,1,-1,-1,0,5
EUW1_6865423619',1,23,7,0,0,0,0,12,0,372,73,25529,28940,23657,3,26,19,2,0,3,0,2,385,119,33410,33147,38145,1,-13,-46,-7881,-12,-4207,-14488,-2,0,-3,0,10
EUW1_6865291119',3,27,14,0,0,0,0,14,0,302,50,26073,26122,29251,4,28,22,2,0,2,0,2,361,115,34546,31529,41244,0,-59,-65,-8473,-8,-5407,-11993,-2,0,-2,0,12
EUW1_6865232354',4,34,18,1,0,1,0,7,1,399,82,30956,31565,32221,3,30,10,0,0,1,0,6,355,65,26623,28545,34021,1,44,17,4333,8,3020,-1800,1,0,0,0,1
EUW1_6883742638',8,54,17,1,0,0,0,13,1,363,76,28621,29981,39078,6,31,14,1,0,1,0,0,393,100,30013,31275,33589,0,-30,-24,-1392,3,-1294,5489,0,0,-1,0,13
EUW1_6883715216',2,27,11,0,0,0,0,8,0,366,87,25814,29253,29999,0,96,12,2,0,2,0,4,317,107,27538,28775,25813,0,49,-20,-1724,-1,478,4186,-2,0,-2,0,4
EUW1_6883709588',2,24,20,1,0,2,0,7,1,396,90,31344,34718,38038,1,29,1,0,0,0,0,7,335,106,21470,25843,26425,1,61,-16,9874,19,8875,11613,1,0,2,0,0
EUW1_6883697881',1,26,15,1,0,2,0,5,0,400,100,31152,31051,41180,5,29,12,0,0,0,0,10,371,64,26792,28732,25808,1,29,36,4360,3,2319,15372,1,0,2,0,-5
EUW1_6882284774',3,35,15,1,0,0,0,10,0,343,75,27964,29284,35498,1,55,7,0,0,1,0,5,338,92,25305,28546,27255,1,5,-17,2659,8,738,8243,1,0,-1,0,5
EUW1_6882250127',2,47,15,0,0,1,0,5,1,396,94,31018,32874,39913,4,30,11,1,0,0,0,5,367,85,26762,29809,37215,1,29,9,4256,4,3065,2698,-1,0,1,0,0
EUW1_6882219996',2,21,9,0,0,0,0,16,0,291,77,24400,24991,22592,4,26,14,2,0,8,1,3,410,75,32052,31003,32399,0,-119,2,-7652,-5,-6012,-9807,-2,0,-8,-1,13
EUW1_6882167927',4,25,23,1,1,3,0,3,1,434,104,36787,34669,50089,2,27,14,1,0,0,0,12,365,70,28044,30044,39765,1,69,34,8743,9,4625,10324,0,1,3,0,-9
EUW1_6880919935',4,30,6,1,0,0,0,9,1,390,100,26243,29306,29256,5,24,12,0,0,1,0,3,361,96,27085,30683,29076,0,29,4,-842,-6,-1377,180,1,0,-1,0,6
EUW1_6880899693',2,32,16,2,0,2,0,9,1,386,86,31010,31320,27765,2,139,12,0,0,0,0,10,331,102,28027,29891,32448,1,55,-16,2983,4,1429,-4683,2,0,2,0,-1
EUW1_6880872445',5,35,7,0,1,0,0,7,0,365,92,26208,29362,25617,3,33,4,1,0,0,0,5,348,84,22570,28036,22652,1,17,8,3638,3,1326,2965,-1,1,0,0,2
EUW1_6880862298',2,29,10,0,0,0,0,13,1,341,71,24713,28329,31091,0,101,19,2,1,2,0,3,391,100,32733,34016,41987,0,-50,-29,-8020,-9,-5687,-10896,-2,-1,-2,0,10
EUW1_6880860523',5,28,23,1,0,1,0,4,0,364,67,31322,32133,41160,6,40,11,1,0,0,0,7,344,86,26117,26870,34266,1,20,-19,5205,12,5263,6894,0,0,1,0,-3
EUW1_6880843989',4,23,25,2,0,9,1,8,1,378,103,38907,31494,40965,2,25,6,0,0,0,0,9,241,84,22143,21501,19680,1,137,19,16764,19,9993,21285,2,0,9,1,-1
EUW1_6880836577',6,29,14,0,1,2,0,9,1,376,74,31115,29334,33754,3,27,17,2,0,1,0,12,329,97,29708,29397,34524,0,47,-23,1407,-3,-63,-770,-2,1,1,0,-3
EUW1_6880826550',3,34,6,0,0,0,0,10,1,358,112,25020,27724,24175,3,27,15,2,0,0,0,0,348,96,28120,29610,31541,0,10,16,-3100,-9,-1886,-7366,-2,0,0,0,10
EUW1_6860111428',5,54,26,1,0,0,0,10,1,340,106,33168,30753,47415,1,25,19,0,0,1,0,5,325,71,31036,27927,43831,1,15,35,2132,7,2826,3584,1,0,-1,0,5
EUW1_6860062949',5,141,9,1,0,0,0,6,0,356,96,25369,29252,23198,1,26,9,1,0,0,0,1,386,92,25808,28815,26712,1,-30,4,-439,0,437,-3514,0,0,0,0,5
EUW1_6859419751',4,24,12,2,0,1,0,8,0,343,84,28391,29973,34660,1,33,14,0,0,1,0,4,394,88,28071,29411,33737,1,-51,-4,320,-2,562,923,2,0,0,0,4
EUW1_6856535258',3,33,13,0,0,2,0,15,0,347,86,30752,30371,35425,5,39,17,2,0,3,0,8,330,78,29526,27072,36876,0,17,8,1226,-4,3299,-1451,-2,0,-1,0,7
EUW1_6854209460',2,53,13,1,0,0,0,7,1,367,80,27735,30668,39198,4,43,17,1,0,1,0,7,328,102,29480,31904,38782,0,39,-22,-1745,-4,-1236,416,0,0,-1,0,0
EUW1_6846242919',1,23,17,0,0,0,0,7,0,373,90,29960,28996,35633,8,32,18,0,0,0,0,2,356,81,30378,28990,50719,1,17,9,-418,-1,6,-15086,0,0,0,0,5
EUW1_6846147752',2,116,13,0,1,1,0,7,0,375,96,29483,29108,34077,8,29,16,2,0,0,0,5,329,109,28951,30521,40178,1,46,-13,532,-3,-1413,-6101,-2,1,1,0,2
EUW1_6845690217',3,30,14,0,0,0,0,4,0,311,100,28305,28779,36057,7,25,10,1,0,1,0,4,322,72,24963,27749,37198,1,-11,28,3342,4,1030,-1141,-1,0,-1,0,0
EUW1_6843868109',5,246,11,2,0,1,0,9,1,295,94,26142,26787,30808,1,30,13,0,1,1,0,5,356,82,27073,28981,29724,0,-61,12,-931,-2,-2194,1084,2,-1,0,0,4
EUW1_6843834776',2,21,19,1,0,0,0,11,1,332,64,30830,29120,43606,7,29,18,1,0,1,0,4,338,92,29647,30443,42029,0,-6,-28,1183,1,-1323,1577,0,0,-1,0,7
EUW1_6843806688',7,27,14,2,0,0,0,6,1,342,109,28621,30559,39307,5,34,8,0,0,1,0,4,354,78,25097,28647,38964,1,-12,31,3524,6,1912,343,2,0,-1,0,2
EUW1_6843767341',1,25,15,0,0,1,0,9,1,370,75,30270,30388,44168,7,31,10,1,0,2,0,7,392,88,26590,29552,36744,1,-22,-13,3680,5,836,7424,-1,0,-1,0,2
EUW1_6883651698',5,32,11,0,0,0,0,9,0,395,85,27449,29640,35064,2,27,11,1,0,1,0,2,363,60,26109,27510,34982,0,32,25,1340,0,2130,82,-1,0,-1,0,7
EUW1_6883635360',0,33,16,2,0,2,0,8,1,408,67,31145,30041,33152,3,50,10,0,0,0,0,7,325,86,25695,27337,29237,1,83,-19,5450,6,2704,3915,2,0,2,0,1
EUW1_6882291386',9,29,17,0,0,0,0,11,0,361,64,28743,29550,40994,6,32,14,1,1,1,0,2,312,76,28518,28104,33837,1,49,-12,225,3,1446,7157,-1,-1,-1,0,9
EUW1_6882271050',2,22,4,1,0,1,0,8,0,357,99,23467,28113,33234,6,27,9,1,0,1,0,3,334,83,26142,28359,28603,1,23,16,-2675,-5,-246,4631,0,0,0,0,5
EUW1_6883008517',4,34,7,0,0,1,0,7,0,403,94,26493,29172,31989,1,22,15,1,0,0,0,8,338,64,26546,30285,40903,1,65,30,-53,-8,-1113,-8914,-1,0,1,0,-1
EUW1_6882916016',6,29,21,1,0,1,0,11,1,331,76,31252,30552,39797,5,29,17,1,0,0,0,8,319,77,28121,28007,40738,1,12,-1,3131,4,2545,-941,0,0,1,0,3
EUW1_6882868119',3,23,14,0,0,0,0,13,0,292,72,26567,25239,30414,4,27,19,2,1,3,0,3,320,112,30336,31085,41021,0,-28,-40,-3769,-5,-5846,-10607,-2,-1,-3,0,10
EUW1_6882802635',5,29,10,1,0,0,0,9,1,387,110,27438,31187,32503,3,227,8,0,1,1,0,2,404,76,26962,30821,26258,0,-17,34,476,2,366,6245,1,-1,-1,0,7
EUW1_6881530839',3,25,13,1,0,2,0,10,1,369,92,29159,29980,39545,2,27,10,0,0,0,0,8,337,67,25156,28610,35704,0,32,25,4003,3,1370,3841,1,0,2,0,2
EUW1_6881472041',3,34,12,1,1,2,0,5,0,393,118,30050,32565,35756,3,29,9,0,0,0,0,10,341,61,24834,27595,33957,0,52,57,5216,3,4970,1799,1,1,2,0,-5
EUW1_6881312502',3,192,8,0,0,0,0,11,0,344,78,25687,28781,25347,4,36,17,1,0,2,0,3,386,67,29663,29697,30820,0,-42,11,-3976,-9,-916,-5473,-1,0,-2,0,8
EUW1_6881150757',7,30,13,2,0,0,0,7,0,313,96,26639,30718,28663,3,25,10,0,0,0,0,1,392,87,26304,29098,30577,1,-79,9,335,3,1620,-1914,2,0,0,0,6
EUW1_6880917622',3,38,12,1,0,0,0,8,1,408,76,28308,29809,33409,4,16,6,1,0,1,0,4,359,78,23112,27279,25395,1,49,-2,5196,6,2530,8014,0,0,-1,0,4
EUW1_6880871809',3,103,12,1,1,1,0,10,1,366,75,27109,29533,30993,3,28,7,1,0,0,0,5,355,106,24689,30321,23163,1,11,-31,2420,5,-788,7830,0,1,1,0,5
EUW1_6880864467',4,134,19,0,0,0,0,11,0,321,60,29515,28076,34271,4,52,22,2,0,1,0,3,339,77,30607,28637,42485,0,-18,-17,-1092,-3,-561,-8214,-2,0,-1,0,8
EUW1_6880843526',3,29,11,2,1,0,0,13,0,342,108,27408,30125,35382,3,57,8,0,0,1,0,2,383,94,26869,28935,22639,1,-41,14,539,3,1190,12743,2,1,-1,0,11
EUW1_6880825402',6,25,28,1,0,6,1,5,1,404,104,38690,32879,48555,2,23,6,0,0,1,0,11,235,36,21609,21511,22433,1,169,68,17081,22,11368,26122,1,0,5,1,-6
EUW1_6883515668',2,24,12,0,1,0,0,7,0,400,106,29498,30306,26016,6,35,10,2,0,1,0,8,358,109,25884,28481,26165,0,42,-3,3614,2,1825,-149,-2,1,-1,0,-1
EUW1_6883471532',2,31,16,1,0,2,0,5,1,373,106,31363,30370,37824,4,35,13,0,0,0,0,6,347,93,27409,27892,41688,0,26,13,3954,3,2478,-3864,1,0,2,0,-1
EUW1_6883408203',2,79,17,1,0,2,0,7,1,328,106,30191,29443,29476,2,26,11,0,0,1,0,7,376,91,28127,28683,33714,1,-48,15,2064,6,760,-4238,1,0,1,0,0
EUW1_6883339516',7,48,12,1,0,0,0,5,0,375,86,26854,29185,28531,3,27,11,1,0,1,0,2,394,91,28928,30884,28248,0,-19,-5,-2074,1,-1699,283,0,0,-1,0,3
EUW1_6883261476',3,29,15,0,0,1,0,8,0,351,100,29269,31405,32090,8,33,11,1,0,0,0,2,364,83,27095,29373,31170,1,-13,17,2174,4,2032,920,-1,0,1,0,6
EUW1_6883184666',2,68,9,1,0,0,0,11,0,363,87,26172,29128,36233,4,19,11,1,0,2,0,2,345,84,28183,28222,29887,1,18,3,-2011,-2,906,6346,0,0,-2,0,9
EUW1_6883083842',7,35,6,1,0,0,0,7,0,400,98,25430,30943,22323,2,27,8,1,0,0,0,2,431,78,26274,30845,26535,0,-31,20,-844,-2,98,-4212,0,0,0,0,5
EUW1_6882964459',0,24,23,1,1,0,0,13,1,339,108,31672,31908,39024,3,130,16,1,0,2,0,1,344,81,28144,28206,34023,0,-5,27,3528,7,3702,5001,0,1,-2,0,12
EUW1_6882310389',2,23,13,1,0,0,0,14,0,286,83,26237,27042,32369,4,24,19,0,0,2,0,1,394,84,32363,30783,36383,0,-108,-1,-6126,-6,-3741,-4014,1,0,-2,0,13
EUW1_6882242641',2,56,9,1,0,0,0,11,0,354,95,25794,28941,29366,2,27,14,0,1,1,0,0,399,88,29604,32018,31096,0,-45,7,-3810,-5,-3077,-1730,1,-1,-1,0,11
EUW1_6872446547',6,39,8,1,0,0,0,8,1,361,78,24525,28575,32080,0,40,17,1,0,1,0,2,368,101,30063,32837,39125,0,-7,-23,-5538,-9,-4262,-7045,0,0,-1,0,6
EUW1_6872392235',4,37,7,1,0,0,0,6,0,328,121,24502,29528,31939,1,21,11,1,0,1,0,2,359,82,27071,29761,28280,1,-31,39,-2569,-4,-233,3659,0,0,-1,0,4
EUW1_6871419413',2,20,13,1,0,0,0,10,1,353,87,26146,29504,32134,1,17,17,1,0,2,0,1,370,114,30687,34173,41215,0,-17,-27,-4541,-4,-4669,-9081,0,0,-2,0,9
EUW1_6871389794',1,31,12,0,0,1,0,14,1,332,78,27151,29795,23439,1,24,10,2,0,0,0,2,315,101,25834,28132,28933,1,17,-23,1317,2,1663,-5494,-2,0,1,0,12
EUW1_6869537829',2,22,23,2,0,3,0,6,1,398,118,34860,32820,48211,3,28,14,0,0,0,0,11,278,61,25456,27542,27803,1,120,57,9404,9,5278,20408,2,0,3,0,-5
EUW1_6869500931',4,51,5,0,0,0,0,13,0,325,117,24679,29103,22580,7,34,18,2,0,3,0,3,350,89,31462,29777,33012,0,-25,28,-6783,-13,-674,-10432,-2,0,-3,0,10
EUW1_6869456717',2,24,10,1,0,0,0,7,0,339,94,27371,29073,24508,8,37,14,1,0,1,0,5,317,88,26479,30111,30402,0,22,6,892,-4,-1038,-5894,0,0,-1,0,2
EUW1_6869421592',3,24,17,0,0,2,0,14,0,312,114,30154,29121,40959,4,403,18,1,0,2,0,8,336,54,30547,29407,41113,0,-24,60,-393,-1,-286,-154,-1,0,0,0,6
EUW1_6869396000',1,71,13,0,0,0,0,12,1,285,79,27855,27699,29682,2,21,17,1,0,3,0,4,349,128,29968,31951,35156,0,-64,-49,-2113,-4,-4252,-5474,-1,0,-3,0,8
EUW1_6869381661',5,23,3,0,0,1,0,14,0,357,90,23739,27839,19256,4,26,8,2,0,2,0,4,362,88,27050,30209,20690,0,-5,2,-3311,-5,-2370,-1434,-2,0,-1,0,10
EUW1_6868350788',1,19,12,0,0,1,0,10,1,358,111,27736,31627,35503,0,22,11,1,0,2,0,1,396,87,28780,29690,30680,0,-38,24,-1044,1,1937,4823,-1,0,-1,0,9
EUW1_6862114621',7,29,22,1,0,2,0,12,1,347,104,32574,31238,33200,2,19,8,0,0,1,0,6,350,96,25684,27845,29389,1,-3,8,6890,14,3393,3811,1,0,1,0,6
EUW1_6862082400',2,35,17,2,0,0,0,13,1,330,84,29837,28808,34125,3,25,15,0,0,1,0,5,342,79,29170,28243,37324,1,-12,5,667,2,565,-3199,2,0,-1,0,8
EUW1_6862050386',1,68,18,1,0,2,0,7,0,306,152,31343,31538,27882,5,30,13,1,0,1,0,6,341,76,28357,28375,30742,1,-35,76,2986,5,3163,-2860,0,0,1,0,1
EUW1_6862017172',2,234,9,0,1,1,0,7,0,352,106,27393,30324,26392,4,28,21,1,0,1,0,2,398,117,31801,33251,43062,0,-46,-11,-4408,-12,-2927,-16670,-1,1,0,0,5
EUW1_6861997619',6,37,12,0,0,0,0,6,1,380,86,28110,28703,23608,3,27,5,2,0,0,0,2,409,103,24761,29428,22356,1,-29,-17,3349,7,-725,1252,-2,0,0,0,4
EUW1_6859472849',4,116,7,0,0,0,0,12,0,327,90,24020,25908,22701,6,65,14,2,0,2,0,3,364,76,29169,29115,35776,0,-37,14,-5149,-7,-3207,-13075,-2,0,-2,0,9
EUW1_6859451262',0,37,12,0,0,0,0,16,0,283,81,28035,26956,36720,1,21,32,2,1,4,0,0,401,98,40546,33780,49059,0,-118,-17,-12511,-20,-6824,-12339,-2,-1,-4,0,16
EUW1_6859432339',2,22,8,0,0,0,0,4,0,343,92,25372,28874,32192,0,24,10,1,0,0,0,2,329,78,26694,30022,26915,0,14,14,-1322,-2,-1148,5277,-1,0,0,0,2
EUW1_6882702673',1,35,8,1,0,0,0,14,1,279,107,24235,28465,24407,3,24,14,1,0,2,0,3,371,92,28581,30431,34408,0,-92,15,-4346,-6,-1966,-10001,0,0,-2,0,11
EUW1_6882666049',0,42,15,0,1,1,0,9,0,344,114,29639,31384,36958,5,27,14,2,0,0,0,3,307,54,24738,26653,29499,1,37,60,4901,1,4731,7459,-2,1,1,0,6
EUW1_6882508965',3,20,11,1,0,0,0,10,1,348,85,27335,29050,34976,2,95,12,0,0,1,0,7,358,105,27049,31570,32361,1,-10,-20,286,-1,-2520,2615,1,0,-1,0,3
EUW1_6882494494',4,31,15,2,0,3,0,7,0,420,74,33136,31555,35832,5,23,10,0,0,1,0,8,349,100,25546,27695,24917,1,71,-26,7590,5,3860,10915,2,0,2,0,-1
EUW1_6882460132',3,30,12,1,1,0,0,11,0,362,94,29159,30834,32440,3,23,16,1,0,2,0,4,345,76,28471,29801,33843,1,17,18,688,-4,1033,-1403,0,1,-2,0,7
EUW1_6882442852',3,62,7,1,0,0,0,11,0,352,88,24794,30239,24643,4,66,9,0,0,1,0,4,423,100,28842,31930,35850,0,-71,-12,-4048,-2,-1691,-11207,1,0,-1,0,7
EUW1_6882432685',2,31,29,2,0,0,0,9,1,378,72,34462,32115,48669,1,27,10,0,0,2,0,8,308,72,26538,25638,32238,1,70,0,7924,19,6477,16431,2,0,-2,0,1
EUW1_6882408947',3,23,10,0,0,0,0,13,0,351,78,26702,28517,29957,4,34,24,2,0,1,0,2,381,56,31735,30838,36735,0,-30,22,-5033,-14,-2321,-6778,-2,0,-1,0,11
EUW1_6882395689',2,26,15,0,0,2,0,3,1,385,90,29181,30428,30883,4,35,7,1,0,0,0,4,341,85,24246,27276,23529,1,44,5,4935,8,3152,7354,-1,0,2,0,-1
EUW1_6882358957',3,30,9,0,0,0,0,10,0,323,78,24950,28004,29624,3,24,13,2,0,1,0,4,327,98,27727,29806,34762,0,-4,-20,-2777,-4,-1802,-5138,-2,0,-1,0,6
EUW1_6882353648',2,20,5,0,0,0,0,15,0,236,70,21191,21956,23033,2,25,24,1,0,8,1,0,420,101,37378,33536,37307,0,-184,-31,-16187,-19,-11580,-14274,-1,0,-8,-1,15
EUW1_6882338953',4,25,9,0,0,1,0,14,0,374,95,27744,29561,29095,2,150,21,1,1,3,0,9,366,114,31885,33040,43498,0,8,-19,-4141,-12,-3479,-14403,-1,-1,-2,0,5
EUW1_6882325163',5,31,17,1,0,2,0,14,1,361,72,31021,28669,40183,2,31,17,1,0,2,0,8,379,108,31368,31975,40527,1,-18,-36,-347,0,-3306,-344,0,0,0,0,6
EUW1_6882315982',3,27,18,1,0,1,0,13,1,347,106,29556,31001,32038,4,93,11,0,0,1,0,4,367,66,27476,29817,33381,1,-20,40,2080,7,1184,-1343,1,0,0,0,9
EUW1_6882301276',4,38,12,0,0,1,0,18,0,292,72,27981,27893,27780,7,56,22,2,0,5,0,7,374,128,34479,30920,43845,0,-82,-56,-6498,-10,-3027,-16065,-2,0,-4,0,11
EUW1_6881423860',2,25,12,0,0,1,0,9,0,376,80,28384,28528,34782,4,42,18,2,0,1,0,7,390,92,30564,31707,44081,0,-14,-12,-2180,-6,-3179,-9299,-2,0,0,0,2
EUW1_6881373423',3,22,21,1,0,3,0,9,1,347,85,33411,30766,47048,4,93,12,1,0,0,0,13,326,78,27267,28373,36517,1,21,7,6144,9,2393,10531,0,0,3,0,-4
EUW1_6881312092',3,30,17,0,1,2,0,12,1,343,112,30792,32740,35364,3,30,15,1,0,1,0,2,372,71,29647,29664,35722,0,-29,41,1145,2,3076,-358,-1,1,1,0,10
EUW1_6877116286',3,30,9,1,0,0,0,4,0,380,96,26497,29300,33785,6,28,13,0,0,2,0,2,341,82,28653,30243,34175,0,39,14,-2156,-4,-943,-390,1,0,-2,0,2
EUW1_6877066385',6,23,11,1,0,0,0,15,0,320,82,26295,28496,33201,6,30,22,1,0,2,0,0,385,86,32537,31836,45735,0,-65,-4,-6242,-11,-3340,-12534,0,0,-2,0,15
EUW1_6877032151',4,24,11,1,0,0,0,12,0,355,90,27305,27871,31153,4,28,15,1,1,2,0,2,424,123,31570,32391,28807,0,-69,-33,-4265,-4,-4520,2346,0,-1,-2,0,10
EUW1_6870528933',3,137,10,1,0,0,0,10,1,381,100,26019,31110,28581,6,32,10,0,0,0,0,2,395,92,27281,30677,28646,0,-14,8,-1262,0,433,-65,1,0,0,0,8
EUW1_6870327082',5,70,15,1,0,1,0,8,0,383,85,28980,31843,36150,7,28,10,0,0,1,0,3,345,90,26791,29409,32810,0,38,-5,2189,5,2434,3340,1,0,0,0,5
EUW1_6870049678',1,23,12,1,0,0,0,14,0,375,74,27422,30167,36709,4,36,15,1,0,2,0,3,352,97,29973,32621,39704,0,23,-23,-2551,-3,-2454,-2995,0,0,-2,0,11
EUW1_6869817780',5,38,15,1,0,1,0,8,0,404,100,30027,32335,31657,9,36,4,1,0,0,0,3,383,88,23836,29307,22659,1,21,12,6191,11,3028,8998,0,0,1,0,5
EUW1_6869766203',2,35,22,1,0,1,0,12,0,362,87,33487,32455,48389,6,37,19,1,0,2,0,4,333,59,30307,29161,38120,1,29,28,3180,3,3294,10269,0,0,-1,0,8
EUW1_6869725620',4,34,17,2,0,2,0,5,1,366,98,31963,29369,34713,5,29,9,0,0,1,0,11,333,85,24707,28101,28561,1,33,13,7256,8,1268,6152,2,0,1,0,-6
EUW1_6869660942',3,38,15,1,0,0,0,12,1,344,94,28026,29537,34800,5,45,16,1,0,2,0,3,356,97,29977,30596,35003,0,-12,-3,-1951,-1,-1059,-203,0,0,-2,0,9
EUW1_6869605608',4,26,7,1,0,1,0,13,1,362,94,25804,27320,26396,4,100,13,1,0,1,0,4,392,98,28912,30927,29508,1,-30,-4,-3108,-6,-3607,-3112,0,0,0,0,9
EUW1_6868511836',4,34,13,2,0,1,0,9,1,330,96,28249,28311,31945,4,31,17,0,0,1,0,6,351,96,29850,29605,38731,0,-21,0,-1601,-4,-1294,-6786,2,0,0,0,3
EUW1_6868383345',2,26,9,0,1,0,0,12,0,329,98,26733,28739,35072,3,26,20,2,0,1,0,3,343,105,30949,32273,37035,0,-14,-7,-4216,-11,-3534,-1963,-2,1,-1,0,9
EUW1_6868341725',7,44,14,2,0,1,0,5,0,371,105,28911,30823,34697,1,21,6,0,1,0,0,6,328,86,23445,25829,19329,1,43,19,5466,8,4994,15368,2,-1,1,0,-1
EUW1_6868268335',7,29,19,2,0,2,0,13,0,335,102,31669,31310,42511,7,29,13,0,0,0,0,5,324,88,27802,27080,33542,1,11,14,3867,6,4230,8969,2,0,2,0,8
EUW1_6868218550',6,26,4,0,0,0,0,6,0,364,100,23947,28362,21119,3,22,10,2,0,1,0,4,374,87,26687,29630,29636,0,-10,13,-2740,-6,-1268,-8517,-2,0,-1,0,2
EUW1_6868182564',3,22,12,0,0,0,0,6,1,315,96,26361,28223,25947,5,26,13,1,1,1,0,2,364,92,28236,30877,36002,0,-49,4,-1875,-1,-2654,-10055,-1,-1,-1,0,4
EUW1_6868145769',6,41,13,0,0,1,0,9,0,376,87,28950,30016,38189,6,30,19,1,0,0,0,2,370,88,30416,32141,38317,0,6,-1,-1466,-6,-2125,-128,-1,0,1,0,7
EUW1_6863120797',5,63,14,1,0,1,0,6,0,367,103,29823,32229,29479,2,57,13,1,0,0,0,3,349,88,27617,30205,36205,1,18,15,2206,1,2024,-6726,0,0,1,0,3
EUW1_6869027240',2,45,17,1,0,0,0,4,1,377,98,30902,30394,37739,5,102,13,1,0,1,0,4,330,89,27309,29771,39628,0,47,9,3593,4,623,-1889,0,0,-1,0,0
EUW1_6868657667',5,352,15,0,0,0,0,18,1,300,66,26873,27555,32555,4,36,27,2,0,4,0,1,391,106,37227,32976,45351,0,-91,-40,-10354,-12,-5421,-12796,-2,0,-4,0,17
EUW1_6868597630',6,22,9,0,0,0,0,11,1,355,91,26071,28445,30425,3,229,19,2,0,0,0,1,329,88,29291,31661,38331,0,26,3,-3220,-10,-3216,-7906,-2,0,0,0,10
EUW1_6866867251',4,31,10,0,0,1,0,11,0,319,117,27349,28527,34974,3,29,15,0,0,1,0,3,401,106,29978,33373,36853,0,-82,11,-2629,-5,-4846,-1879,0,0,0,0,8
EUW1_6866422739',5,28,17,2,0,0,0,7,1,347,68,28343,30408,34365,1,40,6,0,0,1,0,4,322,107,23773,28014,23263,1,25,-39,4570,11,2394,11102,2,0,-1,0,3
EUW1_6866387527',4,27,17,0,0,1,0,10,1,351,77,29209,30606,33376,5,28,13,1,0,1,0,4,331,72,26997,28567,32649,0,20,5,2212,4,2039,727,-1,0,0,0,6
EUW1_6866356923',7,33,14,2,0,1,0,3,0,395,96,29156,31527,27679,1,30,10,0,0,1,0,7,339,88,25617,29023,22331,1,56,8,3539,4,2504,5348,2,0,0,0,-4
EUW1_6866001366',3,23,23,2,0,2,0,12,1,338,89,33617,32448,48499,4,26,24,0,0,0,0,3,317,74,31049,29491,42681,1,21,15,2568,-1,2957,5818,2,0,2,0,9
EUW1_6865952810',2,23,9,1,0,0,0,8,0,389,75,27042,30962,30720,2,31,9,1,0,2,0,4,367,80,25939,29232,31169,1,22,-5,1103,0,1730,-449,0,0,-2,0,4
EUW1_6865347051',2,100,23,1,1,0,0,4,1,354,89,31558,33495,44210,4,22,11,1,0,0,0,4,358,82,26667,28443,33575,0,-4,7,4891,12,5052,10635,0,1,0,0,0
EUW1_6865232343',1,24,6,0,1,0,0,7,0,372,74,24471,29115,27267,9,37,14,1,0,0,0,2,388,106,27842,32641,29460,1,-16,-32,-3371,-8,-3526,-2193,-1,1,0,0,5
EUW1_6864936377',1,34,17,2,0,0,0,4,0,365,108,29230,31188,36203,0,129,9,0,0,0,0,7,361,88,26089,29978,35717,0,4,20,3141,8,1210,486,2,0,0,0,-3
EUW1_6864888513',4,259,14,0,0,2,0,5,0,401,85,29669,30491,33485,2,25,6,1,0,1,0,5,320,74,23150,25717,31368,1,81,11,6519,8,4774,2117,-1,0,1,0,0
EUW1_6864114771',2,27,15,0,0,1,0,10,1,355,76,28943,29576,34695,4,29,14,2,1,1,0,4,362,94,28493,30819,28124,0,-7,-18,450,1,-1243,6571,-2,-1,0,0,6
EUW1_6864037478',2,25,4,0,0,0,0,12,0,356,77,22980,27489,25025,5,23,13,2,0,2,0,2,387,110,30639,31415,33018,0,-31,-33,-7659,-9,-3926,-7993,-2,0,-2,0,10
EUW1_6863942411',3,23,7,0,0,0,0,16,1,290,72,24283,26221,23631,4,24,28,2,0,3,0,1,380,100,33674,34012,45836,0,-90,-28,-9391,-21,-7791,-22205,-2,0,-3,0,15
EUW1_6863895439',2,22,21,2,1,1,0,9,1,380,84,32209,33218,36881,2,174,2,0,0,2,0,9,391,100,24833,27867,26561,1,-11,-16,7376,19,5351,10320,2,1,-1,0,0
EUW1_6863827409',1,25,16,1,0,1,0,4,1,362,76,29510,31447,34711,10,35,14,1,1,0,0,5,322,109,28244,30570,33857,1,40,-33,1266,2,877,854,0,-1,1,0,-1
EUW1_6863530576',2,24,11,1,1,1,0,6,0,376,100,28093,31031,27666,4,22,7,1,0,0,0,6,344,104,25226,28668,29906,1,32,-4,2867,4,2363,-2240,0,1,1,0,0
EUW1_6883490017',10,28,22,2,0,1,0,5,0,351,88,31512,31999,39615,7,29,9,0,0,0,0,7,354,88,25294,28050,29994,1,-3,0,6218,13,3949,9621,2,0,1,0,-2
EUW1_6883469528',7,30,12,1,0,0,0,12,1,326,64,25404,25334,32559,7,36,28,1,0,1,0,4,323,84,33603,32054,44311,0,3,-20,-8199,-16,-6720,-11752,0,0,-1,0,8
EUW1_6883406045',8,29,15,1,1,2,0,11,0,339,105,30647,29979,36997,7,34,11,1,0,1,0,7,344,76,26245,27601,31623,1,-5,29,4402,4,2378,5374,0,1,1,0,4
EUW1_6883353492',0,25,6,0,1,1,0,15,0,351,89,24539,28530,23949,3,30,19,1,0,3,0,1,364,85,30940,30977,45441,0,-13,4,-6401,-13,-2447,-21492,-1,1,-2,0,14
EUW1_6883280023',4,22,12,0,0,1,0,9,0,391,80,29288,30662,30726,3,100,14,1,0,0,0,3,357,80,29678,30446,33048,1,34,0,-390,-2,216,-2322,-1,0,1,0,6
EUW1_6883232928',5,24,14,1,0,1,0,11,0,325,96,29277,30149,34149,3,30,13,1,0,1,0,6,369,71,28064,29597,36527,1,-44,25,1213,1,552,-2378,0,0,0,0,5
EUW1_6883162658',5,29,10,0,0,1,0,10,0,374,70,27077,27972,34219,4,26,22,2,0,1,0,6,371,100,32819,33013,39302,0,3,-30,-5742,-12,-5041,-5083,-2,0,0,0,4
EUW1_6883100579',8,28,23,1,1,2,0,5,1,395,82,34448,33213,40536,2,34,10,1,0,1,0,5,306,81,24776,26659,28914,1,89,1,9672,13,6554,11622,0,1,1,0,0
EUW1_6882181245',5,25,14,0,0,0,0,14,1,339,119,27962,30234,29226,3,29,9,2,0,2,0,2,428,88,29069,31158,26782,0,-89,31,-1107,5,-924,2444,-2,0,-2,0,12
EUW1_6882164899',6,26,21,2,0,2,0,9,1,355,84,31810,30426,38447,1,26,9,0,0,1,0,7,304,103,26147,26672,34563,1,51,-19,5663,12,3754,3884,2,0,1,0,2
EUW1_6882112385',6,31,9,0,0,1,0,11,1,394,112,28864,30904,25704,3,187,15,2,0,2,0,3,412,75,30096,32894,31958,0,-18,37,-1232,-6,-1990,-6254,-2,0,-1,0,8
EUW1_6882060340',4,92,17,2,0,2,0,9,1,363,100,31276,32924,37090,2,26,12,0,0,1,0,5,348,98,27569,30444,34614,1,15,2,3707,5,2480,2476,2,0,1,0,4
EUW1_6881773697',3,33,14,0,0,0,0,7,1,379,83,27574,30463,29795,11,30,9,1,0,0,0,3,353,88,25299,28279,26517,1,26,-5,2275,5,2184,3278,-1,0,0,0,4
EUW1_6881724189',4,22,33,2,0,2,0,6,1,370,86,36195,34129,47341,1,24,8,0,0,1,0,11,228,86,23224,23925,35733,1,142,0,12971,25,10204,11608,2,0,1,0,-5
EUW1_6880098920',6,28,8,0,0,1,0,12,1,352,93,27582,28639,33664,2,63,18,1,0,3,0,7,381,90,31809,31129,33732,0,-29,3,-4227,-10,-2490,-68,-1,0,-2,0,5
EUW1_6879148222',8,54,13,0,0,1,0,5,1,368,72,28909,28222,38601,4,94,13,2,0,1,0,9,379,92,28434,30570,33300,0,-11,-20,475,0,-2348,5301,-2,0,0,0,-4
EUW1_6879114968',2,25,24,0,0,2,0,10,1,374,88,34750,34598,48410,4,22,12,1,0,0,0,7,302,63,25595,26915,43546,1,72,25,9155,12,7683,4864,-1,0,2,0,3
EUW1_6879072428',8,26,20,2,0,2,0,5,1,349,74,31230,30310,43082,5,26,6,0,0,0,0,10,336,82,23697,27191,27120,1,13,-8,7533,14,3119,15962,2,0,2,0,-5
EUW1_6882596771',5,30,13,2,0,1,0,7,1,395,108,29132,30968,34022,6,32,5,0,0,0,0,3,345,67,23611,25969,19225,1,50,41,5521,8,4999,14797,2,0,1,0,4
EUW1_6882499355',2,33,18,1,0,2,0,8,1,386,107,33963,32191,36195,2,20,9,1,0,1,0,10,297,104,24326,27417,22882,1,89,3,9637,9,4774,13313,0,0,1,0,-2
EUW1_6879761989',4,89,15,1,0,0,0,10,1,331,81,28697,29098,33190,7,36,13,0,0,0,0,1,350,99,28093,30094,33831,1,-19,-18,604,2,-996,-641,1,0,0,0,9
EUW1_6879451385',2,61,4,0,0,0,0,10,0,394,80,23668,28378,26248,6,62,19,2,0,2,0,0,324,98,30377,32174,33707,0,70,-18,-6709,-15,-3796,-7459,-2,0,-2,0,10
EUW1_6877578322',0,26,18,1,0,3,0,6,1,383,109,32866,31687,33505,1,23,9,0,0,0,0,10,315,70,24678,26038,20700,1,68,39,8188,9,5649,12805,1,0,3,0,-4
EUW1_6876750473',3,30,11,0,0,0,0,14,1,356,84,26569,29045,26630,1,25,13,2,0,2,0,1,434,108,30735,31500,29680,0,-78,-24,-4166,-2,-2455,-3050,-2,0,-2,0,13
EUW1_6876704944',5,20,12,1,1,0,0,7,1,353,120,28010,29227,35861,6,22,11,1,0,1,0,3,356,84,27016,30065,30032,0,-3,36,994,1,-838,5829,0,1,-1,0,4
EUW1_6876184985',4,89,18,1,0,0,0,14,1,268,67,29824,24197,36963,3,42,17,1,0,3,0,5,305,110,30491,28351,34360,0,-37,-43,-667,1,-4154,2603,0,0,-3,0,9
EUW1_6875710774',4,29,6,1,0,0,0,11,0,389,79,24472,28270,24424,5,41,11,0,0,1,0,2,402,88,28186,30835,28902,0,-13,-9,-3714,-5,-2565,-4478,1,0,-1,0,9
EUW1_6875669805',5,29,13,2,0,1,0,14,1,361,99,29607,32093,34558,4,48,8,0,0,2,0,6,386,77,26005,29673,24409,1,-25,22,3602,5,2420,10149,2,0,-1,0,8
EUW1_6875611807',3,22,10,2,0,0,0,2,1,380,105,28038,30019,34974,5,29,10,0,0,1,0,8,349,82,24606,28979,31789,1,31,23,3432,0,1040,3185,2,0,-1,0,-6
EUW1_6875563713',4,27,10,0,0,1,0,6,1,350,100,27141,28209,29485,4,26,10,1,0,0,0,3,386,87,26233,31263,29414,0,-36,13,908,0,-3054,71,-1,0,1,0,3
EUW1_6875526616',4,31,5,0,0,0,0,14,0,309,91,22801,27966,22439,5,30,18,2,0,4,0,0,386,96,33539,31757,36228,0,-77,-5,-10738,-13,-3791,-13789,-2,0,-4,0,14
EUW1_6873873120',2,20,10,1,0,2,0,13,1,382,123,28390,31305,32166,3,25,8,1,0,0,0,4,370,76,25893,29183,28089,1,12,47,2497,2,2122,4077,0,0,2,0,9
EUW1_6864472757',3,23,10,0,0,0,0,9,1,336,72,25647,27846,30929,6,30,18,1,1,1,0,6,348,90,31197,31640,38301,0,-12,-18,-5550,-8,-3794,-7372,-1,-1,-1,0,3
EUW1_6864440192',3,26,11,0,0,1,0,6,0,372,90,27627,30628,23465,3,22,11,2,0,0,0,3,324,86,26275,28039,29216,0,48,4,1352,0,2589,-5751,-2,0,1,0,3
EUW1_6864387075',6,28,18,1,0,0,0,15,1,337,108,30835,29951,46835,3,32,23,1,0,2,0,3,335,84,32351,31767,43350,1,2,24,-1516,-5,-1816,3485,0,0,-2,0,12
EUW1_6863666306',8,52,13,1,1,0,0,14,0,367,90,28620,31490,33194,7,34,15,1,0,2,0,1,359,94,29922,28719,29861,0,8,-4,-1302,-2,2771,3333,0,1,-2,0,13
EUW1_6863250130',2,35,7,0,0,0,0,11,0,315,68,23124,27954,26176,1,29,11,2,1,1,0,0,374,104,28530,30680,34735,0,-59,-36,-5406,-4,-2726,-8559,-2,-1,-1,0,11
EUW1_6882929705',2,33,15,1,0,0,0,11,1,356,88,28501,30542,29466,0,45,11,0,0,1,0,0,367,90,28390,29056,32251,0,-11,-2,111,4,1486,-2785,1,0,-1,0,11
EUW1_6879350618',1,72,19,1,0,1,0,8,1,389,76,31441,30097,32533,1,27,14,0,0,0,0,5,324,79,27822,28068,33647,0,65,-3,3619,5,2029,-1114,1,0,1,0,3
EUW1_6879341682',2,24,18,0,0,0,0,8,1,343,101,29773,30560,42036,3,46,20,1,0,1,0,3,302,86,29863,29491,39964,1,41,15,-90,-2,1069,2072,-1,0,-1,0,5
EUW1_6879326859',6,36,22,0,0,0,0,14,1,264,74,28827,27699,43716,2,493,17,1,0,2,0,3,351,99,31816,30264,49128,1,-87,-25,-2989,5,-2565,-5412,-1,0,-2,0,11
EUW1_6879317903',1,29,8,0,0,0,0,17,1,277,76,23892,24163,27586,2,47,26,2,0,4,0,2,337,89,34008,30943,42727,0,-60,-13,-10116,-18,-6780,-15141,-2,0,-4,0,15
EUW1_6879308710',3,43,19,1,0,5,0,9,1,369,76,33824,30305,40052,2,23,8,0,0,1,0,9,275,76,23210,24218,28166,1,94,0,10614,11,6087,11886,1,0,4,0,0
EUW1_6879255648',5,41,11,1,0,1,0,9,1,361,103,28899,30173,31280,4,38,10,1,0,0,0,4,356,84,26296,29136,31003,1,5,19,2603,1,1037,277,0,0,1,0,5
EUW1_6879226848',7,48,10,0,0,0,0,10,0,350,84,27286,29300,25581,4,32,12,1,0,2,0,3,377,86,26757,27476,28585,1,-27,-2,529,-2,1824,-3004,-1,0,-2,0,7
EUW1_6878057711',7,30,16,0,0,0,0,15,0,294,82,28256,25753,32550,1,23,25,1,0,1,0,2,300,102,34094,29844,41628,0,-6,-20,-5838,-9,-4091,-9078,-1,0,-1,0,13
EUW1_6878019415',1,48,25,0,0,1,0,8,1,349,84,34632,32730,42878,4,25,18,2,0,2,0,7,335,100,31004,30073,36195,1,14,-16,3628,7,2657,6683,-2,0,-1,0,1
EUW1_6877995418',3,29,15,1,0,0,0,14,1,320,100,26681,30311,28732,1,47,14,0,0,1,0,4,328,92,28710,29325,32187,1,-8,8,-2029,1,986,-3455,1,0,-1,0,10
EUW1_6877982106',5,51,4,0,0,0,0,14,0,391,92,25383,28954,25900,5,28,10,2,1,1,0,4,386,104,26732,31482,27790,0,5,-12,-1349,-6,-2528,-1890,-2,-1,-1,0,10
EUW1_6877966091',6,32,5,0,0,1,0,7,0,399,96,24933,29607,18201,4,30,7,2,0,1,0,4,390,92,25844,28956,18745,0,9,4,-911,-2,651,-544,-2,0,0,0,3
EUW1_6876638462',0,45,17,2,0,1,0,12,1,371,116,31051,32793,42593,3,24,11,0,0,1,0,5,272,86,25272,26567,38407,1,99,30,5779,6,6226,4186,2,0,0,0,7
EUW1_6876597699',4,47,11,0,0,0,0,12,1,334,84,26297,28949,30685,4,26,13,1,1,2,0,3,350,96,30260,28325,36951,0,-16,-12,-3963,-2,624,-6266,-1,-1,-2,0,9
EUW1_6876450020',4,27,30,1,0,0,0,9,1,357,107,34358,32444,48194,1,89,13,0,0,2,0,6,303,78,28038,27250,30707,1,54,29,6320,17,5194,17487,1,0,-2,0,3
EUW1_6875042912',1,24,16,1,1,0,0,13,0,318,104,29338,31156,31032,3,23,14,1,0,2,0,6,287,102,26719,28450,29631,1,31,2,2619,2,2706,1401,0,1,-2,0,7
EUW1_6875022225',4,44,17,0,0,1,0,6,1,313,82,27832,28259,33373,3,27,11,2,0,0,0,3,367,86,26571,30123,35224,0,-54,-4,1261,6,-1864,-1851,-2,0,1,0,3
EUW1_6883562322',8,28,15,2,0,0,0,15,1,352,68,29114,28583,31864,3,26,10,0,0,2,0,2,399,91,29874,28286,28240,0,-47,-23,-760,5,297,3624,2,0,-2,0,13
EUW1_6883531982',6,29,13,0,0,0,0,4,0,318,101,26098,29388,34119,3,27,7,2,0,0,0,3,353,86,24736,27360,28570,0,-35,15,1362,6,2028,5549,-2,0,0,0,1
EUW1_6883436408',10,45,16,0,0,2,0,12,1,339,84,30541,29635,36567,4,32,17,2,0,1,0,3,390,80,30462,30286,39011,0,-51,4,79,-1,-651,-2444,-2,0,1,0,9
EUW1_6883379370',4,27,18,0,0,2,0,6,1,354,66,30870,29989,36193,4,27,12,2,0,0,0,8,403,78,29798,31275,30262,1,-49,-12,1072,6,-1286,5931,-2,0,2,0,-2
EUW1_6882416455',2,29,7,0,0,0,0,11,0,356,91,26111,26829,25162,4,31,21,2,0,0,0,5,329,92,29675,29430,31870,0,27,-1,-3564,-14,-2601,-6708,-2,0,0,0,6
EUW1_6882408593',2,22,8,0,0,0,0,6,0,361,95,25676,29855,32921,4,27,11,1,0,1,0,1,388,82,27242,30379,25283,0,-27,13,-1566,-3,-524,7638,-1,0,-1,0,5
EUW1_6882380854',4,32,8,1,0,0,0,9,1,389,76,26607,29006,28516,1,39,7,0,0,1,0,2,426,87,26393,31372,27495,0,-37,-11,214,1,-2366,1021,1,0,-1,0,7
EUW1_6882303146',4,42,8,1,0,1,0,8,0,401,117,27392,31939,33149,4,26,3,1,0,1,0,4,346,77,23333,26684,21731,1,55,40,4059,5,5255,11418,0,0,0,0,4
EUW1_6882276106',9,29,7,0,0,0,0,10,0,340,68,23657,28376,20405,3,65,13,1,1,1,0,0,402,108,29105,32182,34942,0,-62,-40,-5448,-6,-3806,-14537,-1,-1,-1,0,10
EUW1_6882179735',2,25,14,1,0,0,0,11,0,375,96,28308,31831,28885,3,25,9,1,0,2,0,2,403,92,27741,29756,32835,1,-28,4,567,5,2075,-3950,0,0,-2,0,9
EUW1_6882149542',0,34,13,0,0,0,0,10,0,327,93,28092,27694,34786,6,138,18,2,0,1,0,1,317,66,28570,28707,37334,0,10,27,-478,-5,-1013,-2548,-2,0,-1,0,9
EUW1_6882016987',3,27,12,1,0,1,0,11,0,351,88,27112,29034,30455,6,29,8,1,0,1,0,2,400,89,26191,28639,28866,0,-49,-1,921,4,395,1589,0,0,0,0,9
EUW1_6867337648',6,102,5,1,0,0,0,7,1,368,84,24715,27756,25938,5,32,9,0,0,1,0,4,344,94,25814,30467,24160,0,24,-10,-1099,-4,-2711,1778,1,0,-1,0,3
EUW1_6866985556',6,174,5,0,0,0,0,8,0,291,48,22346,26668,23920,2,28,14,1,0,1,0,3,411,124,29931,33217,27732,0,-120,-76,-7585,-9,-6549,-3812,-1,0,-1,0,5
EUW1_6866876869',6,66,10,2,0,0,0,10,1,397,86,27462,30435,29118,5,33,8,0,0,2,0,1,363,98,26045,29710,27677,1,34,-12,1417,2,725,1441,2,0,-2,0,9
EUW1_6866812880',1,38,11,0,0,0,0,8,0,402,59,25798,31710,34525,5,31,18,1,0,0,0,3,370,98,28560,31674,37728,0,32,-39,-2762,-7,36,-3203,-1,0,0,0,5
EUW1_6866745867',3,29,11,0,0,1,0,8,1,347,76,26659,28841,38099,2,29,14,1,0,0,0,3,367,90,28433,29692,33682,0,-20,-14,-1774,-3,-851,4417,-1,0,1,0,5
EUW1_6866694964',5,59,15,0,0,2,0,14,0,362,97,30217,31512,33436,5,33,8,2,0,1,0,3,345,81,25636,27374,35206,1,17,16,4581,7,4138,-1770,-2,0,1,0,11
EUW1_6866553403',4,44,11,2,0,1,0,9,0,394,75,28344,31329,25391,1,29,2,0,0,0,0,3,386,80,22227,27317,24866,1,8,-5,6117,9,4012,525,2,0,1,0,6
EUW1_6866509859',1,91,15,0,0,0,0,8,1,310,86,27344,27664,35311,9,33,10,1,0,1,0,2,365,82,27020,28758,34063,0,-55,4,324,5,-1094,1248,-1,0,-1,0,6
EUW1_6866455686',2,190,19,1,1,1,0,16,1,287,115,31472,28982,41205,4,36,6,0,0,3,0,6,354,76,26565,28186,28310,1,-67,39,4907,13,796,12895,1,1,-2,0,10
EUW1_6866326265',4,40,11,2,0,0,0,5,1,363,87,26080,30135,34167,2,32,9,0,0,0,0,5,328,70,24299,26866,28062,1,35,17,1781,2,3269,6105,2,0,0,0,0
EUW1_6866259239',2,28,3,0,1,1,0,8,0,404,92,24107,29973,26322,8,29,9,2,0,0,0,5,396,91,25411,31892,26027,1,8,1,-1304,-6,-1919,295,-2,1,1,0,3
EUW1_6866245165',5,44,16,1,0,7,2,6,1,380,102,33284,30721,28236,2,24,0,0,0,0,0,10,321,74,19472,23261,13852,1,59,28,13812,16,7460,14384,1,0,7,2,-4
EUW1_6866211352',1,27,8,0,0,1,0,4,1,400,79,27869,29757,22180,5,30,6,1,0,0,0,8,378,85,24414,28686,19868,0,22,-6,3455,2,1071,2312,-1,0,1,0,-4
EUW1_6865570745',8,34,12,2,0,0,0,7,0,373,99,28417,30993,30210,4,32,8,0,0,1,0,4,379,89,25962,29188,26562,1,-6,10,2455,4,1805,3648,2,0,-1,0,3
EUW1_6865463143',1,65,15,1,0,2,0,7,0,369,96,30201,30575,36839,5,28,13,1,0,1,0,3,360,80,28584,29636,34183,0,9,16,1617,2,939,2656,0,0,1,0,4
EUW1_6865387691',4,96,11,1,0,0,0,12,0,278,75,24618,25828,32681,3,27,14,1,0,2,0,3,351,76,28832,28450,34545,0,-73,-1,-4214,-3,-2622,-1864,0,0,-2,0,9
EUW1_6860822568',3,33,12,0,0,1,0,12,0,366,84,27833,30653,30689,2,34,15,2,0,1,0,3,374,100,29826,31075,33665,0,-8,-16,-1993,-3,-422,-2976,-2,0,0,0,9
EUW1_6860804230',7,35,9,0,0,0,0,12,0,366,96,27387,30997,38262,3,85,16,2,0,2,0,4,373,99,30505,32161,34733,0,-7,-3,-3118,-7,-1164,3529,-2,0,-2,0,8
EUW1_6876507763',5,52,9,0,0,0,0,7,1,351,84,25251,27895,25871,4,42,12,2,0,2,0,3,393,74,28604,30012,35227,0,-42,10,-3353,-3,-2117,-9356,-2,0,-2,0,4
EUW1_6876493672',3,38,10,0,0,1,0,7,0,370,87,27560,28698,41244,9,32,13,2,0,2,0,5,380,77,28338,29010,38661,1,-10,10,-778,-3,-312,2583,-2,0,-1,0,2
EUW1_6874871862',4,22,18,2,0,2,0,7,1,395,82,30559,31705,34874,0,29,5,0,0,1,0,7,297,89,22779,25914,24852,1,98,-7,7780,13,5791,10022,2,0,1,0,0
EUW1_6874770287',3,184,21,0,1,1,0,14,1,359,96,33171,32331,36574,2,23,19,1,0,4,0,4,359,107,32286,32546,41094,0,0,-11,885,2,-215,-4520,-1,1,-3,0,10
EUW1_6874299852',2,36,11,0,0,0,0,5,0,324,68,26034,26981,32495,0,22,19,1,0,0,0,4,343,92,28703,31658,29887,0,-19,-24,-2669,-8,-4677,2608,-1,0,0,0,1
EUW1_6873681764',4,25,18,2,0,1,0,9,1,383,94,30413,33710,39144,1,21,9,0,0,1,0,4,339,86,27688,30699,24565,1,44,8,2725,9,3011,14579,2,0,0,0,5
EUW1_6873639412',5,32,15,1,1,2,0,11,1,318,90,29906,29079,28752,3,40,8,0,0,3,0,4,347,72,26068,26080,28753,1,-29,18,3838,7,2999,-1,1,1,-1,0,7
EUW1_6873494817',4,31,12,1,0,0,0,10,1,297,82,24146,26787,26531,3,27,11,1,0,1,0,1,336,74,26119,27237,32018,0,-39,8,-1973,1,-450,-5487,0,0,-1,0,9
EUW1_6873436859',2,28,17,1,0,2,0,13,1,352,80,32415,31261,50074,4,30,20,1,0,1,0,6,310,70,30274,29950,38796,1,42,10,2141,-3,1311,11278,0,0,1,0,7
EUW1_6872265454',3,30,3,1,0,0,0,16,0,284,72,20406,22929,18806,5,52,13,1,1,8,2,1,439,108,35165,32500,31628,0,-155,-36,-14759,-10,-9571,-12822,0,-1,-8,-2,15
EUW1_6872203940',2,22,9,0,0,0,0,7,1,344,100,25004,27874,25217,3,28,13,2,0,2,0,0,380,112,29126,31414,29319,0,-36,-12,-4122,-4,-3540,-4102,-2,0,-2,0,7
EUW1_6872178662',2,28,19,0,0,0,0,6,1,300,77,30493,28879,37779,1,31,18,1,0,0,0,3,325,77,28359,26658,37858,1,-25,0,2134,1,2221,-79,-1,0,0,0,3
EUW1_6872112935',5,37,19,1,0,1,0,9,1,373,78,31400,30401,33322,1,29,14,1,0,0,0,3,343,122,28697,29119,29822,1,30,-44,2703,5,1282,3500,0,0,1,0,6
EUW1_6872050152',3,44,17,1,0,2,0,4,1,331,89,32284,30337,31501,4,97,10,1,0,0,0,10,343,80,25270,27714,27065,1,-12,9,7014,7,2623,4436,0,0,2,0,-6
EUW1_6883284696',2,26,14,0,0,0,0,11,1,383,78,29668,30463,34334,7,32,17,0,0,1,0,4,383,74,29279,29401,34088,0,0,4,389,-3,1062,246,0,0,-1,0,7
EUW1_6883127560',8,33,15,1,1,3,0,8,0,401,115,33424,33319,34327,6,45,9,0,0,1,0,8,351,80,25807,28890,28832,1,50,35,7617,6,4429,5495,1,1,2,0,0
EUW1_6883029918',3,27,12,0,0,1,0,8,1,383,78,28435,28285,29804,4,29,10,2,0,2,0,8,355,104,28146,29159,30658,1,28,-26,289,2,-874,-854,-2,0,-1,0,0
EUW1_6882804503',4,29,6,0,0,0,0,13,0,367,90,24133,29043,23279,5,25,14,1,0,3,0,1,409,106,30749,33288,34870,0,-42,-16,-6616,-8,-4245,-11591,-1,0,-3,0,12
EUW1_6882724022',7,31,15,2,0,4,0,5,0,359,95,32061,31059,35863,1,24,5,0,0,1,0,10,324,82,21834,25704,21448,1,35,13,10227,10,5355,14415,2,0,3,0,-5
EUW1_6882055051',4,81,20,2,0,1,0,13,0,304,92,29786,28307,41051,4,30,10,0,0,1,0,1,325,66,26302,26501,41100,1,-21,26,3484,10,1806,-49,2,0,0,0,12
EUW1_6880564294',5,33,9,0,0,0,0,14,0,369,82,25692,28322,29791,3,32,17,2,1,2,0,1,404,100,31641,33476,40561,0,-35,-18,-5949,-8,-5154,-10770,-2,-1,-2,0,13
EUW1_6880370033',7,74,13,1,0,0,0,9,0,351,80,26991,30863,28790,5,28,13,1,0,1,0,0,392,96,28064,28969,34499,1,-41,-16,-1073,0,1894,-5709,0,0,-1,0,9
EUW1_6880306174',1,32,4,0,0,0,0,13,0,344,90,23227,28589,25627,7,35,12,2,0,3,0,0,411,96,29795,31345,33820,0,-67,-6,-6568,-8,-2756,-8193,-2,0,-3,0,13
EUW1_6880224086',6,28,19,1,0,1,0,7,1,381,88,31437,31410,37004,3,42,9,0,0,1,0,6,344,91,25371,27883,26222,1,37,-3,6066,10,3527,10782,1,0,0,0,1
EUW1_6877780037',2,39,17,0,0,1,0,13,0,303,40,28116,24828,31090,2,51,18,2,0,3,0,4,322,97,31149,27870,34483,0,-19,-57,-3033,-1,-3042,-3393,-2,0,-2,0,9
EUW1_6877746481',5,30,12,0,1,3,0,4,1,370,84,28693,28004,29690,2,35,13,1,0,0,0,10,223,70,24661,25289,29539,1,147,14,4032,-1,2715,151,-1,1,3,0,-6
EUW1_6877708626',6,33,11,0,0,2,0,8,0,371,86,27290,30547,33145,2,46,10,1,0,1,0,5,352,78,26686,27966,28523,1,19,8,604,1,2581,4622,-1,0,1,0,3
EUW1_6876998058',4,26,5,0,0,0,0,9,0,297,78,22268,25116,26984,2,23,19,2,0,3,0,1,381,112,32951,33640,38235,0,-84,-34,-10683,-14,-8524,-11251,-2,0,-3,0,8
EUW1_6882942559',5,228,16,0,0,0,0,8,1,365,88,29121,30351,42646,5,24,14,2,0,0,0,2,321,64,26403,28375,33883,1,44,24,2718,2,1976,8763,-2,0,0,0,6
EUW1_6882886561',3,33,8,0,0,1,0,12,0,323,82,24930,28431,23579,4,22,25,2,0,3,0,2,385,105,33611,33378,40654,0,-62,-23,-8681,-17,-4947,-17075,-2,0,-2,0,10
EUW1_6882635060',5,34,8,0,0,0,0,12,0,332,104,25035,28293,20752,1,26,12,1,0,2,0,3,421,92,29473,31692,35922,0,-89,12,-4438,-4,-3399,-15170,-1,0,-2,0,9
EUW1_6882610534',2,69,15,1,0,0,0,13,0,335,85,27690,29376,30042,3,26,12,0,0,1,0,2,387,78,29475,28432,29801,1,-52,7,-1785,3,944,241,1,0,-1,0,11
EUW1_6882269614',6,27,15,1,0,1,0,14,1,300,74,28586,27526,40202,3,23,19,1,0,1,0,2,336,73,30348,29375,34897,0,-36,1,-1762,-4,-1849,5305,0,0,0,0,12
EUW1_6882239369',6,35,14,0,0,0,0,6,1,354,77,29463,28217,37510,1,30,17,2,0,0,0,5,361,102,28588,29888,33757,1,-7,-25,875,-3,-1671,3753,-2,0,0,0,1
EUW1_6882218353',5,32,11,0,0,1,0,12,0,353,73,27254,27500,31088,9,33,20,1,1,1,0,0,396,109,32535,33468,38401,0,-43,-36,-5281,-9,-5968,-7313,-1,-1,0,0,12
EUW1_6882192010',6,27,17,1,0,1,0,10,0,384,100,30414,31341,35566,1,27,11,1,0,0,0,4,372,79,27259,29244,31611,0,12,21,3155,6,2097,3955,0,0,1,0,6
EUW1_6882170609',3,21,20,2,0,2,0,7,1,397,105,32856,32756,34380,1,73,10,0,0,0,0,7,343,70,25207,26294,23196,1,54,35,7649,10,6462,11184,2,0,2,0,0
EUW1_6882039959',4,34,11,1,0,0,0,13,0,315,78,27176,26579,37186,1,20,15,1,0,2,0,3,337,90,28431,28532,36613,1,-22,-12,-1255,-4,-1953,573,0,0,-2,0,10
EUW1_6880138845',3,22,8,0,0,0,0,7,0,334,65,24038,27171,25360,8,41,9,1,0,0,0,0,378,107,25348,29782,23411,0,-44,-42,-1310,-1,-2611,1949,-1,0,0,0,7
EUW1_6879958715',6,27,12,2,0,1,0,11,1,375,85,26961,27846,27825,4,34,6,0,0,1,0,0,409,64,24389,29444,23998,0,-34,21,2572,6,-1598,3827,2,0,0,0,11
EUW1_6879853900',1,62,15,2,0,1,0,7,1,338,64,27205,28787,29172,4,56,12,0,0,0,0,5,317,74,26140,26903,33861,1,21,-10,1065,3,1884,-4689,2,0,1,0,2
EUW1_6879810144',5,29,16,1,0,2,0,11,1,367,88,32571,32087,29634,5,22,17,1,0,1,0,8,304,84,28029,26889,30575,1,63,4,4542,-1,5198,-941,0,0,1,0,3
EUW1_6879752413',4,23,14,1,0,0,0,8,1,373,82,27100,28954,26901,6,29,5,0,0,1,0,0,389,86,25452,27571,23172,1,-16,-4,1648,9,1383,3729,1,0,-1,0,8
EUW1_6876404077',1,24,26,1,1,1,0,8,1,348,88,32466,31787,40672,3,129,8,0,0,2,0,6,327,84,25004,28032,26843,1,21,4,7462,18,3755,13829,1,1,-1,0,2
EUW1_6876386426',2,24,13,0,1,0,0,5,1,277,91,27008,26193,30364,5,34,23,1,0,0,0,0,364,88,31264,30160,39258,0,-87,3,-4256,-10,-3967,-8894,-1,1,0,0,5
EUW1_6876380834',6,32,16,1,0,0,0,5,1,387,104,30174,31523,32768,2,59,9,1,0,0,0,3,295,91,24187,26652,22595,1,92,13,5987,7,4871,10173,0,0,0,0,2
EUW1_6876361814',7,31,8,1,0,0,0,6,1,356,94,25362,27915,29944,3,96,11,1,0,0,0,2,373,84,27000,29098,35226,0,-17,10,-1638,-3,-1183,-5282,0,0,0,0,4
EUW1_6876187840',4,26,14,1,0,0,0,5,1,369,95,28109,30893,35677,2,69,11,1,0,0,0,4,354,119,25590,30468,30056,1,15,-24,2519,3,425,5621,0,0,0,0,1
EUW1_6876126379',2,30,14,2,0,2,0,11,1,379,84,29932,30134,41270,1,36,11,0,0,0,0,5,362,100,27590,30471,28847,1,17,-16,2342,3,-337,12423,2,0,2,0,6
EUW1_6875947426',4,28,4,0,0,1,0,7,0,382,98,24895,29456,32243,7,31,10,2,1,0,0,2,383,129,26653,31709,25421,0,-1,-31,-1758,-6,-2253,6822,-2,-1,1,0,5
EUW1_6875877618',6,36,15,1,1,1,0,10,1,376,72,28565,29853,30405,1,18,5,1,0,0,0,4,385,104,24611,28310,24573,1,-9,-32,3954,10,1543,5832,0,1,1,0,6
EUW1_6875815138',0,18,7,0,0,0,0,9,0,348,71,24226,27039,26372,0,15,16,1,0,1,0,3,362,115,29754,30750,30381,0,-14,-44,-5528,-9,-3711,-4009,-1,0,-1,0,6
EUW1_6875027066',3,64,15,1,0,1,0,8,1,357,97,29196,32021,28917,4,27,12,1,0,0,0,5,357,104,28005,31443,38435,1,0,-7,1191,3,578,-9518,0,0,1,0,3
EUW1_6874993372',2,25,9,0,0,1,0,10,0,368,92,25205,29389,19626,1,28,5,2,0,1,0,3,386,92,24725,28710,22065,1,-18,0,480,4,679,-2439,-2,0,0,0,7
EUW1_6874970386',5,41,16,0,0,2,0,9,0,319,114,30961,29586,36316,1,22,19,2,0,1,0,7,340,60,30219,29701,39185,0,-21,54,742,-3,-115,-2869,-2,0,1,0,2
EUW1_6874945127',4,27,6,0,0,0,0,9,0,321,94,24062,26754,21452,5,38,14,2,0,2,0,2,407,123,29780,33759,31468,0,-86,-29,-5718,-8,-7005,-10016,-2,0,-2,0,7
EUW1_6874912338',8,48,15,1,0,1,0,9,1,359,89,30316,28719,34794,4,34,11,1,1,1,0,7,340,94,27265,28680,32470,1,19,-5,3051,4,39,2324,0,-1,0,0,2
EUW1_6874737637',3,37,14,0,0,0,0,9,0,359,109,28946,30990,29999,2,80,10,1,0,0,0,2,375,90,27666,28432,26219,1,-16,19,1280,4,2558,3780,-1,0,0,0,7
EUW1_6874607625',8,36,9,0,0,0,0,10,0,377,70,25903,27984,27740,5,25,24,2,0,0,0,2,387,97,31078,32237,39690,0,-10,-27,-5175,-15,-4253,-11950,-2,0,0,0,8
EUW1_6874532904',1,28,13,0,1,0,0,10,1,367,100,27494,30990,26654,5,28,4,2,0,1,0,4,355,120,25354,28594,28609,0,12,-20,2140,9,2396,-1955,-2,1,-1,0,6
EUW1_6874480766',5,35,6,0,0,2,0,8,0,379,104,27608,29757,22453,2,39,13,2,0,1,0,7,350,92,28632,30166,36016,1,29,12,-1024,-7,-409,-13563,-2,0,1,0,1
EUW1_6874428139',4,81,11,0,0,1,0,18,0,280,90,26755,27061,33156,2,26,19,1,0,3,0,4,384,106,32613,31909,39389,0,-104,-16,-5858,-8,-4848,-6233,-1,0,-2,0,14
EUW1_6866589526',1,27,11,0,0,1,0,15,0,387,85,28283,30685,35750,7,29,24,2,1,2,0,4,357,104,33028,33431,38757,0,30,-19,-4745,-13,-2746,-3007,-2,-1,-1,0,11
EUW1_6859410815',5,25,8,0,0,0,0,4,1,363,88,25279,28927,23985,7,31,7,1,0,0,0,2,360,100,25062,28202,20406,0,3,-12,217,1,725,3579,-1,0,0,0,2
EUW1_6859401554',1,26,6,1,0,0,0,9,0,351,88,23290,28521,25402,3,32,13,1,0,1,0,0,369,108,29276,31870,32070,0,-18,-20,-5986,-7,-3349,-6668,0,0,-1,0,9
EUW1_6859382045',5,32,17,1,0,2,0,8,1,393,96,31478,31539,33356,1,27,7,1,0,0,0,5,319,95,24594,28363,27934,0,74,1,6884,10,3176,5422,0,0,2,0,3
EUW1_6859374570',4,22,10,0,0,0,0,13,1,353,70,25926,26205,34397,1,195,22,2,0,2,0,1,368,97,33317,32050,38054,0,-15,-27,-7391,-12,-5845,-3657,-2,0,-2,0,12
EUW1_6859364505',5,24,11,0,0,0,0,17,0,308,88,25967,27041,27576,0,26,14,2,0,3,0,3,362,76,29755,31777,31403,0,-54,12,-3788,-3,-4736,-3827,-2,0,-3,0,14
EUW1_6859332222',5,29,12,1,0,0,0,8,0,355,93,27153,30082,29809,0,21,12,0,0,0,0,3,395,98,28008,31795,34942,0,-40,-5,-855,0,-1713,-5133,1,0,0,0,5
EUW1_6859216908',3,25,4,0,0,0,0,11,1,369,94,23353,27975,23277,3,24,15,2,0,1,0,1,402,106,30610,32883,35170,0,-33,-12,-7257,-11,-4908,-11893,-2,0,-1,0,10
EUW1_6859194576',4,21,23,1,0,6,0,9,1,389,98,35882,31415,39234,0,12,10,0,0,1,0,7,206,47,21069,21954,20506,1,183,51,14813,13,9461,18728,1,0,5,0,2
EUW1_6796973837',7,28,3,2,0,0,0,2,1,387,87,24444,29024,22403,3,45,3,0,0,0,0,6,362,96,22640,28573,21523,1,25,-9,1804,0,451,880,2,0,0,0,-4
EUW1_6796301513',5,64,13,1,0,0,0,9,1,388,82,28003,31677,36421,4,65,10,1,0,0,0,4,369,98,26697,30456,40806,0,19,-16,1306,3,1221,-4385,0,0,0,0,5
EUW1_6796252264',6,37,7,0,0,0,0,8,0,358,82,25092,27797,32035,13,35,16,1,1,2,0,2,368,90,29990,32310,37729,0,-10,-8,-4898,-9,-4513,-5694,-1,-1,-2,0,6
EUW1_6794565645',2,25,19,1,0,1,0,14,1,322,60,29815,27635,37599,6,34,16,1,0,0,0,0,286,104,28400,28353,34241,1,36,-44,1415,3,-718,3358,0,0,1,0,14
EUW1_6794551951',4,29,22,1,0,1,0,7,1,419,98,33159,34125,35683,5,30,7,0,0,0,0,3,362,89,25556,29148,33052,1,57,9,7603,15,4977,2631,1,0,1,0,4
EUW1_6794542880',5,72,6,0,0,0,0,7,0,361,84,24357,27481,25883,2,57,11,1,0,0,0,0,363,72,25720,28146,30534,1,-2,12,-1363,-5,-665,-4651,-1,0,0,0,7
EUW1_6794525298',2,22,19,0,0,1,0,12,1,330,106,29908,33194,31094,7,36,12,2,0,1,0,5,317,97,27591,27831,32143,0,13,9,2317,7,5363,-1049,-2,0,0,0,7
EUW1_6794521921',3,38,7,1,0,0,0,9,0,312,99,23372,27671,35005,2,25,13,0,0,1,0,2,373,79,28644,29805,42899,0,-61,20,-5272,-6,-2134,-7894,1,0,-1,0,7
EUW1_6794504063',7,32,14,0,0,0,0,3,0,346,83,27947,28099,37137,3,46,18,1,0,0,0,6,274,79,27127,28048,28775,0,72,4,820,-4,51,8362,-1,0,0,0,-3
EUW1_6794493665',6,27,12,1,1,1,0,6,0,373,95,28599,31320,30525,1,21,8,0,0,0,0,4,311,84,24589,27795,29409,1,62,11,4010,4,3525,1116,1,1,1,0,2
EUW1_6878757810',3,189,10,0,1,0,0,10,1,352,108,27427,30067,26393,4,47,8,2,0,3,0,5,337,75,25576,27962,23885,0,15,33,1851,2,2105,2508,-2,1,-3,0,5
EUW1_6878162557',5,22,10,1,0,0,0,7,0,378,76,25463,29309,26357,7,43,4,1,0,0,0,4,389,88,24094,29264,31334,1,-11,-12,1369,6,45,-4977,0,0,0,0,3
EUW1_6876978943',2,39,23,0,0,0,0,8,1,342,74,30964,30675,41016,4,28,11,2,0,0,0,5,317,90,25537,27493,31977,1,25,-16,5427,12,3182,9039,-2,0,0,0,3
EUW1_6876914308',3,29,24,1,1,0,0,16,0,327,84,31821,28889,38948,1,23,11,1,0,4,0,6,349,74,28561,27904,30982,1,-22,10,3260,13,985,7966,0,1,-4,0,10
EUW1_6876864903',1,15,4,1,0,0,0,12,0,345,84,23777,27415,22484,9,48,14,1,0,1,0,0,350,100,28084,30277,29650,1,-5,-16,-4307,-10,-2862,-7166,0,0,-1,0,12
EUW1_6876687262',1,18,12,0,0,2,0,11,0,355,77,28611,28983,29859,6,33,18,2,0,0,0,4,346,93,29125,30369,36049,0,9,-16,-514,-6,-1386,-6190,-2,0,2,0,7
EUW1_6875329060',2,26,5,0,0,0,0,5,0,344,72,21615,29566,19593,2,24,13,2,0,1,0,0,370,120,29130,33445,30366,0,-26,-48,-7515,-8,-3879,-10773,-2,0,-1,0,5
EUW1_6874761506',1,34,13,1,0,1,0,8,1,308,78,26433,27813,38694,1,24,12,0,0,0,0,4,272,59,24758,27123,32257,0,36,19,1675,1,690,6437,1,0,1,0,4
EUW1_6874312109',6,42,20,2,1,4,0,5,1,383,118,33384,31710,44108,6,49,9,0,0,0,0,8,330,55,24565,26573,31685,1,53,63,8819,11,5137,12423,2,1,4,0,-3
EUW1_6874248044',3,21,18,1,0,2,0,9,1,398,108,31339,34938,35490,5,21,12,1,0,0,0,5,345,84,27712,30726,30193,1,53,24,3627,6,4212,5297,0,0,2,0,4
EUW1_6874381424',2,61,20,1,0,1,0,9,1,337,112,30097,28430,28522,3,27,5,1,0,2,0,6,357,50,23591,26370,23598,1,-20,62,6506,15,2060,4924,0,0,-1,0,3
EUW1_6874329383',5,27,10,2,1,2,0,8,0,381,88,27811,31096,27878,5,30,9,0,0,2,0,5,373,90,27362,30077,25563,1,8,-2,449,1,1019,2315,2,1,0,0,3
EUW1_6874284677',3,31,8,0,1,1,0,4,0,375,97,26022,29525,30345,4,26,10,1,0,0,0,3,360,82,25009,28421,25320,1,15,15,1013,-2,1104,5025,-1,1,1,0,1
EUW1_6874227512',1,20,9,1,0,0,0,9,0,366,102,26402,28096,23648,5,35,13,1,0,1,0,2,398,70,29754,30113,23697,0,-32,32,-3352,-4,-2017,-49,0,0,-1,0,7
EUW1_6873585664',3,24,12,1,0,1,0,10,0,333,88,26952,30195,26174,3,24,7,1,0,2,0,5,382,76,26724,28272,29543,1,-49,12,228,5,1923,-3369,0,0,-1,0,5
EUW1_6873523352',3,27,5,1,0,3,0,5,0,358,88,26223,27113,25397,6,99,8,0,0,0,0,10,287,72,23387,27266,24269,0,71,16,2836,-3,-153,1128,1,0,3,0,-5
EUW1_6873481662',1,23,16,0,0,2,0,7,1,360,98,28433,30508,31208,4,27,10,2,0,1,0,7,344,85,27321,29461,30385,1,16,13,1112,6,1047,823,-2,0,1,0,0
EUW1_6873365225',1,27,11,1,0,2,0,6,1,363,76,27850,28436,28291,2,26,11,0,0,0,0,9,319,62,25381,26110,26985,1,44,14,2469,0,2326,1306,1,0,2,0,-3
EUW1_6873310819',5,35,16,1,0,1,0,12,0,336,71,28976,29434,34085,1,23,19,0,0,1,0,3,311,88,30039,29005,33497,0,25,-17,-1063,-3,429,588,1,0,0,0,9
EUW1_6873232518',2,27,8,1,0,0,0,1,0,371,128,25588,31246,29797,9,35,8,1,0,0,0,5,359,80,24842,29070,36884,0,12,48,746,0,2176,-7087,0,0,0,0,-4
EUW1_6873151529',1,28,12,0,0,0,0,6,1,368,114,28787,32254,30926,2,33,7,1,0,2,0,4,391,98,24592,30072,24687,0,-23,16,4195,5,2182,6239,-1,0,-2,0,2
EUW1_6883451828',1,33,16,0,0,1,0,6,0,371,84,30066,31164,37797,7,31,10,2,0,0,0,6,352,76,27136,28204,31052,1,19,8,2930,6,2960,6745,-2,0,1,0,0
EUW1_6882790275',3,228,23,2,0,1,0,8,0,330,153,32231,34988,43218,9,37,13,0,0,1,0,10,352,53,28702,29326,33248,1,-22,100,3529,10,5662,9970,2,0,0,0,-2
EUW1_6882739339',0,42,15,1,0,1,0,9,1,349,60,28201,29565,40681,3,26,12,1,0,1,0,6,330,71,26153,27615,28985,1,19,-11,2048,3,1950,11696,0,0,0,0,3
EUW1_6882725506',2,55,27,2,0,4,0,6,0,403,124,36428,34301,45443,8,46,9,0,0,0,0,10,298,68,24836,24700,27107,1,105,56,11592,18,9601,18336,2,0,4,0,-4
EUW1_6882696898',2,31,27,1,0,1,0,7,0,387,70,32630,30638,45970,5,26,13,0,0,0,0,6,282,74,25710,25628,33103,1,105,-4,6920,14,5010,12867,1,0,1,0,1
EUW1_6882667622',6,35,14,1,0,2,0,4,1,408,104,30664,31591,30420,2,17,8,1,0,0,0,7,346,86,23992,27736,23337,1,62,18,6672,6,3855,7083,0,0,2,0,-3
EUW1_6882540897',4,49,13,0,0,1,0,10,1,362,98,28310,30079,37094,1,29,6,2,0,1,0,2,394,70,26182,29269,27598,0,-32,28,2128,7,810,9496,-2,0,0,0,8
EUW1_6882076103',3,25,14,1,0,2,0,9,1,384,72,29213,31549,34165,7,26,12,1,0,0,0,5,316,103,26623,28429,36488,1,68,-31,2590,2,3120,-2323,0,0,2,0,4
EUW1_6881440207',6,37,18,1,0,0,0,9,0,341,103,30271,30903,39805,4,29,10,1,0,2,0,7,366,96,27765,27515,32974,0,-25,7,2506,8,3388,6831,0,0,-2,0,2
EUW1_6883728449',4,29,23,0,0,2,0,4,1,340,69,32259,29629,41023,4,31,11,2,0,0,0,7,283,74,24444,24555,29297,1,57,-5,7815,12,5074,11726,-2,0,2,0,-3
EUW1_6883711269',5,30,13,2,0,3,0,8,1,353,96,29062,29077,27868,4,46,7,0,0,0,0,10,348,108,24734,29452,22687,1,5,-12,4328,6,-375,5181,2,0,3,0,-2
EUW1_6882704608',2,21,17,1,1,1,0,5,1,336,103,29563,31905,32931,3,27,12,1,0,0,0,5,316,63,25009,26834,32349,1,20,40,4554,5,5071,582,0,1,1,0,0
EUW1_6882658296',3,23,18,2,0,0,0,12,1,376,96,30785,31803,34785,3,34,7,0,0,1,0,2,374,90,25660,29750,26358,1,2,6,5125,11,2053,8427,2,0,-1,0,10
EUW1_6881023148',5,34,20,0,0,1,0,8,1,344,82,30038,30316,37266,3,27,10,1,0,0,0,2,367,78,27026,28474,31791,1,-23,4,3012,10,1842,5475,-1,0,1,0,6
EUW1_6879955744',1,18,16,2,0,2,0,7,1,402,80,31431,32247,40728,3,23,4,0,0,1,0,5,338,76,22747,27739,20689,1,64,4,8684,12,4508,20039,2,0,1,0,2
EUW1_6879549667',4,28,16,0,0,3,0,7,1,388,80,31610,30035,40848,6,32,17,1,0,0,0,5,222,54,25810,25416,32885,1,166,26,5800,-1,4619,7963,-1,0,3,0,2
EUW1_6877967240',3,34,11,0,0,0,0,12,0,370,78,26878,29711,29411,0,19,18,2,0,3,0,1,352,98,32614,29936,40518,1,18,-20,-5736,-7,-225,-11107,-2,0,-3,0,11
EUW1_6877382758',2,77,9,1,0,0,0,12,0,360,77,24643,29067,31539,0,47,17,1,1,0,0,2,342,118,29906,31984,31562,0,18,-41,-5263,-8,-2917,-23,0,-1,0,0,10
EUW1_6877314118',2,29,15,1,0,0,0,11,1,380,105,29091,32028,31415,4,29,8,1,0,0,0,3,376,98,26535,31015,29483,0,4,7,2556,7,1013,1932,0,0,0,0,8
EUW1_6877263762',7,31,15,0,0,1,0,11,1,370,100,29965,29441,32079,7,33,23,1,0,2,0,6,329,92,33179,31382,35634,0,41,8,-3214,-8,-1941,-3555,-1,0,-1,0,5
EUW1_6877035644',4,60,14,0,0,0,0,8,0,381,91,28682,32858,30950,1,69,8,2,1,2,0,3,320,96,25692,28234,31074,1,61,-5,2990,6,4624,-124,-2,-1,-2,0,5
EUW1_6876732293',8,50,15,2,0,1,0,3,0,366,86,27867,29006,28518,1,21,9,0,0,0,0,8,346,88,24851,26147,25674,1,20,-2,3016,6,2859,2844,2,0,1,0,-5
EUW1_6876676914',2,22,12,1,0,0,0,7,1,345,86,26979,28192,29679,2,29,14,1,0,0,0,2,384,77,27767,29621,31085,0,-39,9,-788,-2,-1429,-1406,0,0,0,0,5
EUW1_6876606248',6,28,5,0,0,0,0,8,1,390,85,26023,29063,23618,6,41,9,2,0,0,0,6,383,97,26551,30380,23783,0,7,-12,-528,-4,-1317,-165,-2,0,0,0,2
EUW1_6877987637',4,120,10,1,0,0,0,11,1,297,61,23128,26788,24045,0,21,15,1,0,2,0,1,349,124,30469,33004,38399,0,-52,-63,-7341,-5,-6216,-14354,0,0,-2,0,10
EUW1_6876076171',6,28,12,0,0,0,0,8,0,366,76,28639,30215,34879,1,45,14,2,0,1,0,8,320,84,26733,26927,29625,0,46,-8,1906,-2,3288,5254,-2,0,-1,0,0
EUW1_6872330025',0,30,18,1,0,0,0,6,0,386,84,29790,29356,35376,3,29,8,0,1,0,0,1,359,80,25744,28188,28710,0,27,4,4046,10,1168,6666,1,-1,0,0,5
EUW1_6871995186',2,23,7,1,0,1,0,14,0,335,76,24844,26031,33085,3,27,22,1,0,2,0,4,357,111,33137,34270,41653,0,-22,-35,-8293,-15,-8239,-8568,0,0,-1,0,10
EUW1_6861915095',5,86,16,0,0,0,0,12,0,305,81,28426,28686,38739,3,60,16,2,0,1,0,2,330,76,29514,28081,37745,1,-25,5,-1088,0,605,994,-2,0,-1,0,10
EUW1_6861643471',2,26,9,0,0,0,0,15,0,334,83,25698,27481,20751,5,32,12,2,1,1,0,2,373,132,30725,31702,35693,0,-39,-49,-5027,-3,-4221,-14942,-2,-1,-1,0,13
EUW1_6861549610',6,28,16,1,1,0,0,5,0,335,84,28359,28242,38526,6,31,15,1,0,1,0,3,354,92,29291,28807,43273,1,-19,-8,-932,1,-565,-4747,0,1,-1,0,2
EUW1_6861495483',1,80,6,0,0,0,0,14,0,284,63,22856,25513,22859,4,59,20,1,0,3,0,2,413,95,33631,33152,43486,0,-129,-32,-10775,-14,-7639,-20627,-1,0,-3,0,12
EUW1_6861210590',4,31,16,1,0,1,0,5,1,368,98,29364,31005,31488,4,29,11,1,0,0,0,5,336,71,25161,27000,31734,1,32,27,4203,5,4005,-246,0,0,1,0,0
EUW1_6859406307',3,24,15,0,0,0,0,11,1,310,94,26915,29922,31660,3,30,9,2,0,1,0,2,347,93,26432,29075,26095,1,-37,1,483,6,847,5565,-2,0,-1,0,9
EUW1_6858597238',6,35,11,1,0,0,0,6,1,350,106,26826,30668,43197,1,37,6,0,0,0,0,2,347,83,24704,29602,31245,1,3,23,2122,5,1066,11952,1,0,0,0,4
EUW1_6857402999',9,35,18,0,0,1,0,11,1,332,67,31035,29213,40984,1,29,19,2,0,2,0,4,351,83,32010,30329,42667,0,-19,-16,-975,-1,-1116,-1683,-2,0,-1,0,7
EUW1_6849352364',3,25,14,1,0,0,0,6,1,347,90,28606,28813,42703,4,25,14,1,0,0,0,5,364,94,29106,30235,33093,0,-17,-4,-500,0,-1422,9610,0,0,0,0,1
EUW1_6836524389',4,19,12,1,0,0,0,11,0,341,77,27775,29266,36335,2,26,13,1,0,2,0,4,324,90,27299,26977,30022,0,17,-13,476,-1,2289,6313,0,0,-2,0,7
EUW1_6836464386',3,27,21,0,0,1,0,4,1,368,86,30933,30085,41254,1,23,12,0,0,0,0,8,302,63,26100,26334,34944,1,66,23,4833,9,3751,6310,0,0,1,0,-4
EUW1_6876374407',1,47,21,2,0,4,0,8,1,384,100,33826,32296,34178,3,21,11,0,1,0,0,8,346,99,28407,29510,34374,1,38,1,5419,10,2786,-196,2,-1,4,0,0
EUW1_6876241990',3,79,12,1,0,0,0,16,0,334,72,26950,26922,27143,2,38,15,1,0,2,0,4,368,111,31113,30860,31959,0,-34,-39,-4163,-3,-3938,-4816,0,0,-2,0,12
EUW1_6876192036',2,25,10,2,0,1,0,7,1,369,89,27416,28547,23128,2,25,9,0,0,0,0,4,411,78,25804,28849,30119,1,-42,11,1612,1,-302,-6991,2,0,1,0,3
EUW1_6875491540',5,35,23,0,0,0,0,8,0,297,75,28614,27295,44054,1,28,10,1,0,0,0,4,331,113,26707,27315,36122,1,-34,-38,1907,13,-20,7932,-1,0,0,0,4
EUW1_6875447371',1,67,5,0,0,0,0,11,0,317,92,22884,25842,33042,8,63,23,1,0,1,0,0,395,88,32250,33241,39453,0,-78,4,-9366,-18,-7399,-6411,-1,0,-1,0,11
EUW1_6875421858',2,25,7,0,0,0,0,14,0,331,78,25032,27608,24510,7,45,31,1,0,2,0,2,420,115,36209,36715,53061,0,-89,-37,-11177,-24,-9107,-28551,-1,0,-2,0,12
EUW1_6875404511',7,51,22,2,1,5,0,4,1,407,102,34760,33770,42239,1,18,6,0,0,0,0,10,318,58,22063,26206,19760,1,89,44,12697,16,7564,22479,2,1,5,0,-6
EUW1_6875041936',0,56,13,2,0,4,0,6,0,421,100,31138,32678,28712,5,62,7,0,0,0,0,9,310,71,23733,26555,24873,1,111,29,7405,6,6123,3839,2,0,4,0,-3
EUW1_6875020575',3,24,20,0,0,0,0,11,0,391,98,30098,31802,42600,0,80,11,1,0,0,0,4,344,114,27282,28732,30319,1,47,-16,2816,9,3070,12281,-1,0,0,0,7
EUW1_6874999110',2,27,7,1,0,0,0,16,0,334,89,24952,27687,33470,1,72,12,0,0,3,0,2,380,106,29717,31353,33844,0,-46,-17,-4765,-5,-3666,-374,1,0,-3,0,14
EUW1_6874978503',1,99,15,0,0,3,0,8,0,340,84,30485,29241,37950,2,27,12,1,0,1,0,9,326,70,27826,26107,31652,1,14,14,2659,3,3134,6298,-1,0,2,0,-1
EUW1_6874946207',7,37,11,2,1,1,0,12,0,360,92,27470,28912,31029,3,296,13,0,0,2,0,3,404,79,30115,30632,32651,0,-44,13,-2645,-2,-1720,-1622,2,1,-1,0,9
EUW1_6874856664',2,35,13,2,0,1,0,9,0,366,112,29641,31134,36295,2,29,13,0,0,1,0,7,384,96,28617,30744,30845,1,-18,16,1024,0,390,5450,2,0,0,0,2
EUW1_6874789443',5,34,19,2,0,1,0,6,0,348,84,30480,29561,40625,0,23,15,0,0,1,0,6,338,81,28635,30190,33047,1,10,3,1845,4,-629,7578,2,0,0,0,0
EUW1_6874670041',5,26,11,0,0,1,0,6,1,343,86,26907,28406,31075,3,36,7,2,0,0,0,4,333,90,24492,26493,30107,1,10,-4,2415,4,1913,968,-2,0,1,0,2
EUW1_6874614453',3,23,8,2,0,1,0,8,1,432,111,29116,31517,29376,6,54,9,0,0,1,0,7,367,89,26393,29609,24003,1,65,22,2723,-1,1908,5373,2,0,0,0,1
EUW1_6874070488',5,36,6,2,0,0,0,17,0,306,68,23098,24966,18896,4,32,17,0,1,3,0,2,418,132,33323,33022,35181,0,-112,-64,-10225,-11,-8056,-16285,2,-1,-3,0,15
EUW1_6873949986',4,31,2,1,0,0,0,10,1,357,110,22449,28293,25169,7,34,12,1,1,0,0,1,370,98,26649,31396,24146,0,-13,12,-4200,-10,-3103,1023,0,-1,0,0,9
EUW1_6873680591',4,36,15,1,0,1,0,9,0,341,96,29495,27643,32537,1,311,18,1,1,1,0,9,349,64,30082,31357,37876,1,-8,32,-587,-3,-3714,-5339,0,-1,0,0,0
EUW1_6883170518',3,24,18,1,0,0,0,9,1,346,78,30214,29595,38512,2,116,13,0,0,3,0,2,287,82,26157,27560,29441,0,59,-4,4057,5,2035,9071,1,0,-3,0,7
EUW1_6883067554',4,25,13,0,0,0,0,14,1,341,82,27119,31141,32179,4,304,14,1,0,2,0,0,410,130,31815,34065,40857,0,-69,-48,-4696,-1,-2924,-8678,-1,0,-2,0,14
EUW1_6881156088',5,25,12,0,1,1,0,10,1,433,92,31543,30473,35296,2,23,5,1,0,1,0,5,327,118,23662,29916,18272,1,106,-26,7881,7,557,17024,-1,1,0,0,5
EUW1_6877781503',0,23,21,2,1,3,0,7,1,358,102,33004,34074,42371,1,25,10,0,0,0,0,7,315,94,25527,27217,36425,1,43,8,7477,11,6857,5946,2,1,3,0,0
EUW1_6877744113',1,24,15,2,0,0,0,8,1,327,90,28518,28837,36143,5,25,18,0,0,1,0,4,356,87,30126,30868,45319,0,-29,3,-1608,-3,-2031,-9176,2,0,-1,0,4
EUW1_6883633676',2,28,14,0,1,0,0,5,0,325,108,27799,29118,28754,2,17,8,1,0,0,0,2,380,80,25747,28367,33521,1,-55,28,2052,6,751,-4767,-1,1,0,0,3
EUW1_6881920097',3,30,25,1,1,3,0,6,1,358,102,35507,33041,40056,3,32,4,1,0,0,0,8,374,84,23897,27100,21032,1,-16,18,11610,21,5941,19024,0,1,3,0,-2
EUW1_6881886671',4,22,3,1,0,0,0,9,0,345,98,23340,27822,18583,4,47,10,1,0,3,0,3,439,121,30486,33634,26963,0,-94,-23,-7146,-7,-5812,-8380,0,0,-3,0,6
EUW1_6881825915',4,20,10,0,0,0,0,12,0,316,70,24716,27345,30528,6,30,13,2,0,3,0,0,435,92,30179,31561,38844,0,-119,-22,-5463,-3,-4216,-8316,-2,0,-3,0,12
EUW1_6880846634',5,39,12,1,0,0,0,5,1,361,102,27826,29276,33792,2,23,12,1,0,1,0,2,379,92,27662,30348,29840,1,-18,10,164,0,-1072,3952,0,0,-1,0,3
EUW1_6880837466',4,27,11,0,0,0,0,8,1,384,93,26469,29611,33628,2,34,14,1,0,1,0,3,359,106,28913,30895,34861,1,25,-13,-2444,-3,-1284,-1233,-1,0,-1,0,5
EUW1_6880737221',1,24,5,1,0,0,0,5,1,383,96,23617,28357,25135,5,32,14,1,0,0,0,2,374,89,27325,29983,26484,1,9,7,-3708,-9,-1626,-1349,0,0,0,0,3
EUW1_6880720773',3,31,4,0,0,0,0,14,0,331,78,23056,27637,23857,7,99,10,2,0,3,0,5,352,86,28437,30280,31970,0,-21,-8,-5381,-6,-2643,-8113,-2,0,-3,0,9
EUW1_6880684336',3,21,18,1,0,0,0,11,0,353,108,30015,32366,43290,2,24,14,1,0,0,0,1,362,70,27260,27910,30736,1,-9,38,2755,4,4456,12554,0,0,0,0,10
EUW1_6880647761',5,33,19,2,0,0,0,10,1,335,74,28779,29400,35025,4,27,13,0,0,1,0,0,360,122,29501,30117,31068,1,-25,-48,-722,6,-717,3957,2,0,-1,0,10
EUW1_6880551084',1,27,20,2,0,2,0,5,1,392,128,33212,32279,34942,3,19,11,0,0,1,0,8,343,76,25327,29596,24992,1,49,52,7885,9,2683,9950,2,0,1,0,-3
EUW1_6880478766',2,25,11,0,0,0,0,11,1,346,94,27565,29618,31054,4,24,14,1,0,2,0,2,374,85,29694,30294,39329,1,-28,9,-2129,-3,-676,-8275,-1,0,-2,0,9
EUW1_6880405470',7,33,10,2,0,1,0,8,1,410,70,27965,29335,22623,3,30,5,0,0,0,0,6,380,90,24844,27849,20042,1,30,-20,3121,5,1486,2581,2,0,1,0,2
EUW1_6880320418',7,36,11,1,0,2,0,7,1,319,76,27275,27175,30977,4,27,12,1,0,0,0,5,369,71,26437,27688,34854,0,-50,5,838,-1,-513,-3877,0,0,2,0,2
EUW1_6879296984',5,24,17,2,1,3,0,6,0,317,97,30421,27294,32113,4,34,7,0,0,0,0,9,302,70,22951,24332,23749,1,15,27,7470,10,2962,8364,2,1,3,0,-3
EUW1_6879254245',0,28,20,2,0,0,0,7,1,373,84,30253,30531,43729,2,23,9,0,0,0,0,6,359,88,25876,26717,29913,1,14,-4,4377,11,3814,13816,2,0,0,0,1
EUW1_6879234471',6,34,16,1,0,0,0,10,1,356,90,28724,30106,30483,4,25,14,0,0,1,0,3,336,74,27740,26624,30424,0,20,16,984,2,3482,59,1,0,-1,0,7
EUW1_6862685444',8,29,6,0,0,0,0,9,0,353,102,24570,28818,24036,6,32,10,2,1,1,0,1,389,89,27197,30739,34771,0,-36,13,-2627,-4,-1921,-10735,-2,-1,-1,0,8
EUW1_6862632954',4,27,9,0,0,0,0,11,0,392,107,26509,29821,21128,9,34,12,2,0,0,0,0,398,96,28563,31666,24883,1,-6,11,-2054,-3,-1845,-3755,-2,0,0,0,11
EUW1_6862582756',4,28,9,0,0,0,0,10,0,357,118,27238,30817,32267,5,30,11,2,0,2,0,4,410,90,28532,30702,24788,0,-53,28,-1294,-2,115,7479,-2,0,-2,0,6
EUW1_6862398396',5,40,14,0,0,1,0,12,1,312,90,28195,27261,25924,6,23,15,2,0,2,0,4,343,82,28826,28007,29201,1,-31,8,-631,-1,-746,-3277,-2,0,-1,0,8
EUW1_6860764983',7,23,13,0,0,0,0,12,0,315,80,27341,28380,35563,3,32,16,2,0,1,0,3,350,80,29996,29378,36457,0,-35,0,-2655,-3,-998,-894,-2,0,-1,0,9
EUW1_6860749272',4,23,9,0,0,0,0,10,1,326,60,24297,26072,25166,8,35,21,2,0,2,0,3,327,84,31671,29630,38775,0,-1,-24,-7374,-12,-3558,-13609,-2,0,-2,0,7
EUW1_6860743735',5,30,17,0,0,1,0,4,1,331,84,29688,30068,31760,6,31,12,2,0,0,0,6,323,80,26215,26673,29314,1,8,4,3473,5,3395,2446,-2,0,1,0,-2
EUW1_6860728732',4,42,10,1,0,0,0,6,1,354,85,25726,28076,28953,5,31,12,0,0,0,0,3,332,78,27427,29712,28683,1,22,7,-1701,-2,-1636,270,1,0,0,0,3
EUW1_6860715883',2,26,16,2,0,2,0,7,1,376,107,30961,31657,32438,3,20,3,0,0,0,0,11,307,104,22070,25828,23044,1,69,3,8891,13,5829,9394,2,0,2,0,-4
EUW1_6860684200',8,82,14,1,1,1,0,9,1,357,90,29038,30734,38750,6,62,7,1,0,0,0,5,378,95,25982,28585,31965,1,-21,-5,3056,7,2149,6785,0,1,1,0,4
EUW1_6860666579',6,70,15,0,0,0,0,19,0,302,97,28768,29719,33396,5,25,21,1,0,3,0,0,355,84,34366,29042,35351,0,-53,13,-5598,-6,677,-1955,-1,0,-3,0,19
EUW1_6860625048',6,37,16,1,0,1,0,7,0,318,91,29674,31277,31462,3,24,19,1,0,0,0,4,367,82,30041,30038,31511,1,-49,9,-367,-3,1239,-49,0,0,1,0,3
EUW1_6860602169',4,38,13,2,0,1,0,8,1,403,92,30283,33153,27992,3,31,2,0,0,2,0,4,357,84,21902,27485,17977,1,46,8,8381,11,5668,10015,2,0,-1,0,4
EUW1_6860557192',3,70,10,0,0,1,0,4,0,363,80,29014,28945,32272,4,26,11,2,0,1,0,9,350,90,26519,29458,39966,1,13,-10,2495,-1,-513,-7694,-2,0,0,0,-5
EUW1_6860479697',6,34,15,0,1,2,0,13,0,381,105,30422,31274,33730,6,33,11,1,0,1,0,3,362,68,27654,28554,30167,0,19,37,2768,4,2720,3563,-1,1,1,0,10
EUW1_6860405982',2,56,9,1,0,1,0,4,1,447,100,28424,32493,27139,6,31,1,1,0,0,0,5,337,92,21359,26316,24038,1,110,8,7065,8,6177,3101,0,0,1,0,-1
EUW1_6859398624',6,36,15,1,0,3,0,8,0,350,60,29586,28931,36684,2,27,13,0,0,0,0,6,309,92,25832,26915,33054,1,41,-32,3754,2,2016,3630,1,0,3,0,2
EUW1_6859386822',4,36,11,1,0,4,0,6,1,406,99,31122,31633,35750,3,26,11,0,0,0,0,9,278,79,24638,26701,24918,1,128,20,6484,0,4932,10832,1,0,4,0,-3
EUW1_6859366398',2,24,4,0,0,0,0,10,0,298,88,22414,26186,19483,4,27,11,2,0,1,0,3,333,92,27047,27221,29706,0,-35,-4,-4633,-7,-1035,-10223,-2,0,-1,0,7
EUW1_6883701795',2,40,12,0,0,0,0,14,0,296,93,26310,27779,30078,4,25,19,1,0,3,0,1,423,66,32760,31963,38424,0,-127,27,-6450,-7,-4184,-8346,-1,0,-3,0,13
EUW1_6883132754',4,25,3,1,0,1,0,8,1,354,96,24506,27407,19621,3,26,10,1,0,0,0,6,384,104,26021,29991,24952,0,-30,-8,-1515,-7,-2584,-5331,0,0,1,0,2
EUW1_6883075205',1,28,11,1,0,1,0,6,1,390,90,27926,30873,28898,2,93,9,1,0,1,0,5,382,61,25649,28853,28144,1,8,29,2277,2,2020,754,0,0,0,0,1
EUW1_6882360094',2,23,11,0,1,0,0,4,0,381,68,27003,31029,33901,1,28,12,1,0,0,0,6,351,88,26702,30584,36865,1,30,-20,301,-1,445,-2964,-1,1,0,0,-2
EUW1_6882343227',8,29,11,1,0,0,0,10,1,346,112,27804,30392,27526,5,41,9,1,0,0,0,3,335,88,24727,27770,28592,1,11,24,3077,2,2622,-1066,0,0,0,0,7
EUW1_6882333852',1,22,18,2,0,0,0,13,1,278,102,28493,27986,35011,3,25,20,0,1,1,0,2,331,82,30570,28868,32557,1,-53,20,-2077,-2,-882,2454,2,-1,-1,0,11
EUW1_6882070594',3,40,19,0,0,2,0,6,0,360,96,31190,29847,37137,1,24,14,0,0,0,0,6,325,64,26369,27881,30181,1,35,32,4821,5,1966,6956,0,0,2,0,0
EUW1_6881993229',4,26,8,2,0,0,0,8,0,316,102,25267,28264,27444,4,31,15,0,0,2,0,2,388,90,29456,31940,35639,1,-72,12,-4189,-7,-3676,-8195,2,0,-2,0,6
EUW1_6881903393',4,70,13,0,0,4,0,11,1,345,91,30751,28131,35168,1,29,10,1,0,0,0,8,275,64,24598,25806,30788,0,70,27,6153,3,2325,4380,-1,0,4,0,3
EUW1_6881854626',6,29,13,1,1,1,0,7,1,374,115,29954,31069,33124,5,144,4,0,0,1,0,4,338,96,23848,27833,23152,1,36,19,6106,9,3236,9972,1,1,0,0,3
EUW1_6880768892',4,27,16,0,0,0,0,13,1,364,90,29040,32267,34716,1,60,6,2,0,1,0,7,345,94,25802,27357,28754,1,19,-4,3238,10,4910,5962,-2,0,-1,0,6
EUW1_6880750964',3,29,17,2,0,2,0,9,1,352,74,29774,30893,38987,5,28,12,0,0,0,0,4,281,91,25072,28170,30528,1,71,-17,4702,5,2723,8459,2,0,2,0,5
EUW1_6880717356',2,24,11,0,0,2,0,6,1,384,80,29299,29869,28121,3,24,9,1,0,2,0,7,306,87,24935,26379,24799,1,78,-7,4364,2,3490,3322,-1,0,0,0,-1
EUW1_6880462125',0,132,10,1,0,0,0,9,0,321,84,25474,28985,27960,3,31,17,1,0,2,0,1,344,108,29598,31357,36426,0,-23,-24,-4124,-7,-2372,-8466,0,0,-2,0,8
EUW1_6880402378',6,34,9,0,0,1,0,7,1,344,70,25902,27377,25199,2,28,13,1,0,1,0,3,386,114,29177,30887,30126,0,-42,-44,-3275,-4,-3510,-4927,-1,0,0,0,4
EUW1_6880336137',5,23,10,1,0,1,0,9,1,373,100,26814,30425,28555,7,30,10,0,0,0,0,2,356,85,25961,29505,38259,0,17,15,853,0,920,-9704,1,0,1,0,7
EUW1_6879920118',1,20,17,1,1,1,0,10,1,347,73,30365,30466,35358,10,26,13,1,0,1,0,4,279,95,26053,27412,33931,1,68,-22,4312,4,3054,1427,0,1,0,0,6
EUW1_6879373321',5,27,15,1,0,0,0,8,0,296,79,26342,27660,34212,2,33,9,0,0,0,0,1,321,82,24973,25985,28637,0,-25,-3,1369,6,1675,5575,1,0,0,0,7
EUW1_6879207866',5,33,9,1,0,0,0,9,0,351,84,25726,27733,29145,3,30,14,0,0,2,0,2,297,72,27036,27649,29970,0,54,12,-1310,-5,84,-825,1,0,-2,0,7
EUW1_6859418054',4,26,17,1,0,0,0,4,1,346,99,29023,30319,34099,2,36,16,1,0,0,0,3,303,72,26961,28518,39625,1,43,27,2062,1,1801,-5526,0,0,0,0,1
EUW1_6859400399',4,30,17,2,0,3,0,7,1,390,117,32486,32278,29142,4,55,4,0,0,0,0,7,299,74,22200,25113,21502,1,91,43,10286,13,7165,7640,2,0,3,0,0
EUW1_6859399570',5,44,10,0,0,1,0,7,1,338,92,27569,28818,30729,2,26,14,1,0,1,0,5,380,77,28435,31246,29984,0,-42,15,-866,-4,-2428,745,-1,0,0,0,2
EUW1_6859335164',4,28,18,1,0,1,0,7,0,351,82,29779,31233,41248,1,30,21,0,0,0,0,3,331,94,29749,31240,39080,1,20,-12,30,-3,-7,2168,1,0,1,0,4
EUW1_6840809997',2,27,13,0,0,0,0,10,0,363,110,27781,30674,28029,6,31,16,2,0,0,0,4,313,91,28001,28712,32059,1,50,19,-220,-3,1962,-4030,-2,0,0,0,6
EUW1_6840801575',4,23,16,0,0,1,0,15,0,340,86,31008,31071,40075,5,24,19,2,0,1,0,5,371,110,32354,31906,40877,0,-31,-24,-1346,-3,-835,-802,-2,0,0,0,10
EUW1_6840786561',3,32,9,1,0,0,0,3,0,380,110,26080,29951,25439,2,27,11,0,0,0,0,2,360,94,26260,30988,29352,1,20,16,-180,-2,-1037,-3913,1,0,0,0,1
EUW1_6840770264',2,44,25,0,0,2,0,13,0,371,88,32952,33880,42054,3,32,13,2,0,0,0,5,332,92,27494,28509,33191,1,39,-4,5458,12,5371,8863,-2,0,2,0,8
EUW1_6826193551',2,42,21,0,0,0,0,9,1,373,64,32991,30445,43405,4,99,17,2,0,2,0,7,280,96,28087,27993,34326,0,93,-32,4904,4,2452,9079,-2,0,-2,0,2
EUW1_6826081236',7,31,20,1,0,0,0,8,1,388,94,32780,31508,40759,2,145,8,0,0,2,0,2,302,59,23692,25225,30122,1,86,35,9088,12,6283,10637,1,0,-2,0,6
EUW1_6826018685',8,32,9,0,0,0,0,2,1,369,88,26223,29575,25965,2,24,9,2,0,0,0,5,395,104,27531,30204,23463,1,-26,-16,-1308,0,-629,2502,-2,0,0,0,-3
EUW1_6819132185',6,30,14,0,0,0,0,10,0,331,81,28264,29854,32631,7,80,17,2,0,1,0,2,353,74,28029,29277,31250,0,-22,7,235,-3,577,1381,-2,0,-1,0,8
EUW1_6864342603',1,24,19,2,0,1,0,11,0,341,105,31746,30400,37621,0,26,17,0,0,2,0,7,350,82,30163,29688,36196,0,-9,23,1583,2,712,1425,2,0,-1,0,4
EUW1_6864278273',3,29,9,0,0,0,0,14,0,309,88,24258,26078,24497,1,76,18,1,0,2,0,0,398,94,32117,33300,38548,0,-89,-6,-7859,-9,-7222,-14051,-1,0,-2,0,14
EUW1_6864132442',2,24,11,0,0,1,0,10,0,346,84,28375,29129,37082,8,43,22,1,0,2,0,6,361,107,33507,32361,36574,0,-15,-23,-5132,-11,-3232,508,-1,0,-1,0,4
EUW1_6863994513',6,33,6,0,1,1,0,14,1,308,86,25669,25507,19665,3,46,18,2,0,2,0,2,400,114,32402,32392,42367,0,-92,-28,-6733,-12,-6885,-22702,-2,1,-1,0,12
EUW1_6863924204',5,64,20,2,0,0,0,8,0,344,120,30164,32128,42177,6,60,13,0,0,1,0,2,328,62,28029,28241,31367,1,16,58,2135,7,3887,10810,2,0,-1,0,6
EUW1_6861477506',4,32,7,2,0,1,0,8,1,388,80,26892,29026,22638,6,32,9,0,0,1,0,7,380,95,27213,28977,24337,1,8,-15,-321,-2,49,-1699,2,0,0,0,1
EUW1_6861423590',2,33,14,1,1,1,0,14,0,348,64,30043,29307,37278,5,28,17,1,0,2,0,3,333,100,31669,28577,43076,1,15,-36,-1626,-3,730,-5798,0,1,-1,0,11
EUW1_6861357654',5,233,11,1,0,0,0,4,1,385,119,28870,30290,26384,4,77,8,0,0,1,0,4,395,76,25513,29838,29480,1,-10,43,3357,3,452,-3096,1,0,-1,0,0
EUW1_6861317690',4,29,14,0,0,0,0,12,1,319,76,27479,29069,32300,4,30,19,2,0,2,0,1,362,107,32017,32419,41987,0,-43,-31,-4538,-5,-3350,-9687,-2,0,-2,0,11
EUW1_6861253185',5,27,33,1,0,1,0,8,1,315,100,36263,30942,51727,3,61,20,0,0,0,0,3,260,78,30657,25803,39432,1,55,22,5606,13,5139,12295,1,0,1,0,5
EUW1_6861216119',2,34,11,0,0,0,0,11,0,296,62,24915,27413,38350,2,20,27,2,0,0,0,1,323,108,32950,34005,47723,0,-27,-46,-8035,-16,-6592,-9373,-2,0,0,0,10
EUW1_6860778230',2,31,27,2,0,1,0,7,1,317,87,33851,30124,44977,2,68,16,0,0,1,0,6,307,60,26974,25878,34617,1,10,27,6877,11,4246,10360,2,0,0,0,1
EUW1_6860770077',2,28,10,2,0,0,0,14,1,332,91,26005,26627,33900,4,25,23,0,0,1,0,0,380,104,32377,33211,41736,1,-48,-13,-6372,-13,-6584,-7836,2,0,-1,0,14
EUW1_6860763518',5,34,15,0,0,0,0,13,0,271,67,26965,25961,35419,4,26,22,2,0,3,0,0,347,114,33777,31721,41377,0,-76,-47,-6812,-7,-5760,-5958,-2,0,-3,0,13
EUW1_6860739284',3,28,13,1,0,1,0,8,0,332,116,28162,31804,40752,3,25,11,1,0,0,0,3,333,74,25666,29773,28519,1,-1,42,2496,2,2031,12233,0,0,1,0,5
EUW1_6860597441',7,173,10,0,0,1,0,8,1,378,82,28213,30199,32441,4,43,4,1,0,1,0,6,401,102,25041,30412,22159,0,-23,-20,3172,6,-213,10282,-1,0,0,0,2
EUW1_6860294609',2,22,6,0,0,1,0,9,0,375,100,26520,30440,26597,2,28,20,2,0,1,0,2,394,112,31981,32609,36994,0,-19,-12,-5461,-14,-2169,-10397,-2,0,0,0,7
EUW1_6883669634',3,30,14,2,1,1,0,9,1,403,100,29870,32527,32754,4,41,7,0,0,0,0,5,380,80,24798,28584,20543,1,23,20,5072,7,3943,12211,2,1,1,0,4
EUW1_6883643287',4,24,9,1,0,0,0,9,0,350,56,25895,27722,29355,5,26,19,0,0,0,0,5,353,92,30025,30750,32961,1,-3,-36,-4130,-10,-3028,-3606,1,0,0,0,4
EUW1_6864583602',2,27,4,0,1,1,0,4,0,373,107,24628,30224,19958,5,35,10,2,0,1,0,4,384,108,27241,31200,28478,0,-11,-1,-2613,-6,-976,-8520,-2,1,0,0,0
EUW1_6864567823',6,148,11,0,0,0,0,7,1,344,67,26180,27472,29699,0,24,10,2,0,1,0,1,371,126,27207,30945,30680,0,-27,-59,-1027,1,-3473,-981,-2,0,-1,0,6
EUW1_6864564514',4,26,7,0,0,1,0,7,1,374,95,25491,29408,29445,1,42,9,2,0,1,0,8,350,95,25829,29505,23100,0,24,0,-338,-2,-97,6345,-2,0,0,0,-1
EUW1_6864548666',3,22,13,1,0,0,0,10,1,321,86,26514,26555,35718,3,30,22,1,0,2,0,2,342,90,32074,32786,34492,0,-21,-4,-5560,-9,-6231,1226,0,0,-2,0,8
EUW1_6864529125',3,22,8,0,0,0,0,8,0,368,66,25009,27609,24829,8,43,18,1,0,1,0,1,392,85,30888,31582,32861,0,-24,-19,-5879,-10,-3973,-8032,-1,0,-1,0,7
EUW1_6862046079',1,25,17,1,1,1,0,13,0,319,96,29007,30725,33090,12,39,12,0,0,1,0,4,364,71,28170,28493,31111,1,-45,25,837,5,2232,1979,1,1,0,0,9
EUW1_6862037193',4,132,20,0,0,0,0,14,1,298,113,30485,30889,36622,1,41,18,1,0,1,0,2,398,80,31315,31397,38724,1,-100,33,-830,2,-508,-2102,-1,0,-1,0,12
EUW1_6862036621',2,28,22,1,0,1,0,5,1,354,120,32263,32833,36891,1,27,4,0,0,0,0,6,357,60,23088,25892,22663,1,-3,60,9175,18,6941,14228,1,0,1,0,-1
EUW1_6862012343',5,33,14,0,0,0,0,10,1,364,77,28207,27352,38535,0,232,15,1,0,1,0,2,351,74,29255,29667,35014,0,13,3,-1048,-1,-2315,3521,-1,0,-1,0,8
EUW1_6862005275',2,26,6,0,0,0,0,11,0,326,99,23028,26907,28316,1,26,14,2,0,2,0,1,361,94,29845,31730,40028,0,-35,5,-6817,-8,-4823,-11712,-2,0,-2,0,10
EUW1_6861999822',2,25,13,0,0,0,0,8,0,375,66,27542,29984,29999,4,30,14,1,0,0,0,1,354,89,28263,30116,30465,0,21,-23,-721,-1,-132,-466,-1,0,0,0,7
EUW1_6861982263',0,22,6,1,0,1,0,6,1,396,98,27020,30364,24240,8,29,12,1,0,1,0,2,390,88,28154,31146,27277,0,6,10,-1134,-6,-782,-3037,0,0,0,0,4
EUW1_6860812364',3,27,10,1,0,1,0,8,1,451,117,30429,32769,28383,5,32,10,1,0,0,0,2,398,86,26478,31572,18884,0,53,31,3951,0,1197,9499,0,0,1,0,6
EUW1_6860810890',3,17,5,0,1,0,0,11,1,328,96,24469,26708,22234,4,34,19,2,0,2,0,0,376,107,31576,32444,33369,0,-48,-11,-7107,-14,-5736,-11135,-2,1,-2,0,11
EUW1_6883639026',3,23,4,0,0,0,0,9,0,333,110,23712,27853,28443,9,31,16,1,0,2,0,1,337,110,28548,31947,30184,0,-4,0,-4836,-12,-4094,-1741,-1,0,-2,0,8
EUW1_6883027520',2,25,13,1,0,0,0,2,1,404,86,28482,30379,30803,1,26,10,0,0,0,0,7,353,78,25655,28814,25009,0,51,8,2827,3,1565,5794,1,0,0,0,-5
EUW1_6874173608',5,86,16,2,0,0,0,5,1,335,102,28682,31094,35151,1,22,12,0,0,0,0,2,346,90,26509,28389,33282,1,-11,12,2173,4,2705,1869,2,0,0,0,3
EUW1_6883481547',4,25,4,0,0,0,0,6,0,381,84,23925,29052,17229,5,34,8,2,1,0,0,3,381,108,25419,29829,19447,1,0,-24,-1494,-4,-777,-2218,-2,-1,0,0,3
EUW1_6883329261',1,21,9,1,0,0,0,13,0,375,80,26916,29913,32335,2,26,20,1,0,2,0,2,343,96,30843,32210,37186,0,32,-16,-3927,-11,-2297,-4851,0,0,-2,0,11
EUW1_6882078888',3,27,14,0,0,0,0,7,0,332,80,27813,28652,25810,5,33,14,1,0,0,0,6,317,87,27145,29157,34152,0,15,-7,668,0,-505,-8342,-1,0,0,0,1
EUW1_6881914776',1,24,5,0,0,0,0,6,1,410,96,24993,29118,20661,6,32,10,1,0,1,0,3,422,92,27141,31155,21694,0,-12,4,-2148,-5,-2037,-1033,-1,0,-1,0,3
EUW1_6881840539',1,20,10,0,0,1,0,7,1,375,69,27007,28130,33785,1,28,16,1,0,0,0,4,356,96,29027,31091,29564,0,19,-27,-2020,-6,-2961,4221,-1,0,1,0,3
EUW1_6882256763',3,29,10,2,0,2,0,4,1,422,100,30210,29479,26340,4,24,9,0,0,0,0,10,331,80,23914,28795,27501,1,91,20,6296,1,684,-1161,2,0,2,0,-6
EUW1_6882227284',4,31,20,1,0,1,0,9,1,330,80,30653,29286,41405,3,75,21,1,0,0,0,5,279,64,29270,27212,37856,1,51,16,1383,-1,2074,3549,0,0,1,0,4
EUW1_6874973618',5,28,13,1,1,2,0,9,0,347,88,28839,28472,36055,5,35,9,0,0,0,0,6,362,91,26402,30249,27011,0,-15,-3,2437,4,-1777,9044,1,1,2,0,3
EUW1_6883600786',1,142,20,1,0,0,0,7,1,291,105,29139,27725,37633,1,21,20,1,0,3,0,2,289,85,29143,28421,30852,1,2,20,-4,0,-696,6781,0,0,-3,0,5
EUW1_6883485710',6,33,24,1,1,2,0,8,0,357,102,33729,33361,44617,3,28,10,1,0,0,0,9,332,108,27597,28612,34901,0,25,-6,6132,14,4749,9716,0,1,2,0,-1
EUW1_6883431916',3,68,9,0,0,1,0,10,0,421,64,27255,28979,29971,7,31,11,1,0,1,0,3,361,90,27743,31892,27990,0,60,-26,-488,-2,-2913,1981,-1,0,0,0,7
EUW1_6883367313',4,63,9,1,0,0,0,8,1,379,97,26381,29985,36130,3,95,8,0,0,1,0,5,343,78,25635,30700,27959,0,36,19,746,1,-715,8171,1,0,-1,0,3
EUW1_6883316553',3,64,13,1,1,2,0,10,1,392,114,29727,30612,25953,5,32,2,1,0,0,0,5,355,109,23331,27189,13733,1,37,5,6396,11,3423,12220,0,1,2,0,5
EUW1_6883256621',3,29,15,1,0,2,0,7,1,347,108,30736,30965,35688,6,48,12,0,0,0,0,8,348,84,26718,29723,31085,1,-1,24,4018,3,1242,4603,1,0,2,0,-1
EUW1_6882252088',1,26,11,2,0,1,0,7,0,346,122,28014,30806,31990,6,21,14,0,1,0,0,5,341,66,27045,28481,29671,0,5,56,969,-3,2325,2319,2,-1,1,0,2
EUW1_6882238536',3,17,8,0,0,0,0,12,0,314,72,24137,26402,27287,3,23,20,1,0,1,0,0,362,79,31541,30754,41851,0,-48,-7,-7404,-12,-4352,-14564,-1,0,-1,0,12
EUW1_6882203205',3,27,19,1,0,2,0,8,0,386,104,33177,32613,37937,2,30,15,0,0,1,0,9,272,52,27024,28009,25831,1,114,52,6153,4,4604,12106,1,0,1,0,-1
EUW1_6882191804',0,29,5,1,0,0,0,13,0,363,94,23385,27548,27487,6,40,15,1,1,1,0,1,396,106,30094,31226,37809,0,-33,-12,-6709,-10,-3678,-10322,0,-1,-1,0,12
EUW1_6882052584',4,34,11,0,0,1,0,12,0,373,66,27298,31449,30859,4,33,18,2,0,0,0,4,342,80,29465,32366,38414,0,31,-14,-2167,-7,-917,-7555,-2,0,1,0,8
EUW1_6881974674',1,21,18,1,0,3,0,10,1,309,68,30463,29035,38709,1,28,12,0,0,0,0,6,312,92,26025,31341,39829,1,-3,-24,4438,6,-2306,-1120,1,0,3,0,4
EUW1_6881902531',2,27,12,0,0,0,0,10,0,338,80,26736,30587,33680,7,24,18,2,0,0,0,0,369,103,31394,31685,36845,0,-31,-23,-4658,-6,-1098,-3165,-2,0,0,0,10
EUW1_6881832710',4,27,12,1,0,0,0,5,1,367,93,27460,30862,28541,5,29,6,1,0,0,0,2,338,93,23411,27717,25871,1,29,0,4049,6,3145,2670,0,0,0,0,3
EUW1_6880773888',1,28,18,1,0,1,0,9,1,358,104,31076,31652,34914,3,29,14,0,0,0,0,4,369,69,28712,29109,32607,1,-11,35,2364,4,2543,2307,1,0,1,0,5
EUW1_6880767535',3,20,7,0,0,0,0,15,1,277,54,22651,24968,29587,1,17,22,1,0,4,0,1,412,112,33412,34642,53309,0,-135,-58,-10761,-15,-9674,-23722,-1,0,-4,0,14
EUW1_6880747601',3,28,3,1,0,0,0,14,0,314,88,21352,26550,20369,2,27,23,0,1,3,0,0,353,104,32534,32532,38523,0,-39,-16,-11182,-20,-5982,-18154,1,-1,-3,0,14
EUW1_6880707452',3,30,5,2,0,2,0,7,1,394,100,27292,28619,26550,2,26,3,0,0,0,0,4,382,88,23285,28278,25347,1,12,12,4007,2,341,1203,2,0,2,0,3
EUW1_6880681375',7,32,16,1,0,1,0,10,1,348,91,29683,28240,38348,2,95,11,0,0,0,0,4,317,88,25514,29188,27631,1,31,3,4169,5,-948,10717,1,0,1,0,6
EUW1_6880613171',5,23,7,1,0,0,0,10,1,362,78,23568,27079,25235,4,26,15,1,1,1,0,0,393,82,28785,30252,35185,0,-31,-4,-5217,-8,-3173,-9950,0,-1,-1,0,10
EUW1_6883312659',6,21,22,0,0,0,0,13,1,306,54,28608,27712,36329,1,22,17,1,0,2,0,4,298,97,32137,29050,38761,0,8,-43,-3529,5,-1338,-2432,-1,0,-2,0,9
EUW1_6882099520',4,31,16,1,0,0,0,12,1,372,107,29338,31976,32332,3,22,11,1,1,1,0,1,369,91,27907,29265,28038,1,3,16,1431,5,2711,4294,0,-1,-1,0,11
EUW1_6881251955',1,34,17,1,0,0,0,7,0,384,108,31533,32211,29486,7,30,13,0,0,2,0,4,356,68,26848,26504,25610,1,28,40,4685,4,5707,3876,1,0,-2,0,3
EUW1_6880772255',6,29,16,0,0,0,0,6,1,358,68,27930,29797,33642,10,53,18,2,0,0,0,0,291,106,28507,28858,36398,1,67,-38,-577,-2,939,-2756,-2,0,0,0,6
EUW1_6880748998',2,34,13,0,0,1,0,9,1,323,100,28439,28705,31137,5,32,17,2,0,1,0,5,363,82,30438,30405,33575,0,-40,18,-1999,-4,-1700,-2438,-2,0,0,0,4
EUW1_6880727381',2,29,13,0,0,0,0,10,0,326,66,26729,28765,25379,6,171,17,2,0,2,0,1,382,138,32186,32627,34413,0,-56,-72,-5457,-4,-3862,-9034,-2,0,-2,0,9
EUW1_6880706035',2,23,3,0,0,0,0,11,0,359,96,22836,27467,20883,8,38,15,2,1,3,0,2,425,96,31177,32195,26049,0,-66,0,-8341,-12,-4728,-5166,-2,-1,-3,0,9
EUW1_6880685640',5,31,8,0,0,0,0,5,0,307,80,23798,25842,21448,1,38,15,2,1,1,0,0,385,89,29175,30966,34431,0,-78,-9,-5377,-7,-5124,-12983,-2,-1,-1,0,5
EUW1_6879820508',3,28,10,2,0,0,0,7,0,282,96,25234,27293,38634,2,29,14,0,0,0,0,2,350,92,27779,29851,28259,0,-68,4,-2545,-4,-2558,10375,2,0,0,0,5
EUW1_6879268940',6,30,12,1,0,1,0,9,0,363,96,29297,29609,34063,0,35,11,1,0,2,0,11,380,96,28231,30956,32382,1,-17,0,1066,1,-1347,1681,0,0,-1,0,-2
EUW1_6879237743',3,23,23,0,0,0,0,7,1,378,84,33384,30896,36317,2,31,22,1,0,0,0,5,362,87,33250,30342,41907,0,16,-3,134,1,554,-5590,-1,0,0,0,2
EUW1_6879219639',1,37,18,1,0,4,0,8,1,357,100,34099,30597,36287,2,34,12,0,0,1,0,11,265,62,24558,22254,28197,1,92,38,9541,6,8343,8090,1,0,3,0,-3
EUW1_6879121771',7,26,14,1,0,1,0,17,1,333,80,28015,29834,27847,3,30,12,1,0,4,0,3,363,100,30454,28644,32593,1,-30,-20,-2439,2,1190,-4746,0,0,-3,0,14
EUW1_6879061300',5,26,14,1,0,1,0,13,0,334,70,28823,28869,38342,7,41,12,0,1,0,0,3,298,114,26724,28307,31545,0,36,-44,2099,2,562,6797,1,-1,1,0,10
EUW1_6879021956',3,29,20,1,1,2,0,9,1,372,106,32033,31991,40852,5,43,6,0,0,0,0,6,346,82,24487,25985,31065,1,26,24,7546,14,6006,9787,1,1,2,0,3
EUW1_6878965362',4,62,9,0,1,0,0,14,1,314,71,25698,29739,31765,1,60,11,1,0,3,0,2,413,86,30150,31184,33578,0,-99,-15,-4452,-2,-1445,-1813,-1,1,-3,0,12
EUW1_6878903320',5,31,13,2,0,1,0,7,1,360,74,29360,28061,34036,4,24,20,0,1,0,0,6,349,85,31020,31370,33119,0,11,-11,-1660,-7,-3309,917,2,-1,1,0,1
EUW1_6878833159',4,71,7,0,0,0,0,7,1,309,86,24888,27304,31474,1,81,21,2,0,1,0,2,351,76,29375,31493,35290,0,-42,10,-4487,-14,-4189,-3816,-2,0,-1,0,5
EUW1_6878786735',5,25,14,1,0,1,0,5,1,380,94,29370,30790,27947,8,38,9,0,0,0,0,6,329,86,24816,28018,33741,1,51,8,4554,5,2772,-5794,1,0,1,0,-1
EUW1_6880605024',2,53,3,0,0,0,0,10,0,424,62,23266,27582,18302,3,38,9,2,0,1,0,2,420,110,28205,32674,22624,0,4,-48,-4939,-6,-5092,-4322,-2,0,-1,0,8
EUW1_6880023799',3,31,6,0,0,0,0,13,1,371,93,24793,28163,21766,8,40,9,2,1,1,0,3,418,78,27525,29910,29209,0,-47,15,-2732,-3,-1747,-7443,-2,-1,-1,0,10
EUW1_6878966578',2,138,16,0,0,0,0,7,1,332,73,29754,27799,41743,5,25,17,2,0,0,0,4,344,94,29119,29890,35777,0,-12,-21,635,-1,-2091,5966,-2,0,0,0,3
EUW1_6878906101',0,105,13,2,0,0,0,8,1,336,83,27001,30433,30757,0,27,3,0,0,0,0,1,367,91,23038,28255,26815,1,-31,-8,3963,10,2178,3942,2,0,0,0,7
EUW1_6878846038',1,29,18,1,0,1,0,4,1,376,88,30149,31434,37779,3,26,10,0,0,0,0,6,328,96,25321,29222,29882,1,48,-8,4828,8,2212,7897,1,0,1,0,-2
EUW1_6878779601',5,34,5,0,0,1,0,6,0,395,110,26305,29184,22206,3,47,8,2,0,1,0,7,386,89,26989,29692,22291,0,9,21,-684,-3,-508,-85,-2,0,0,0,-1
EUW1_6878725361',4,28,11,2,0,0,0,4,1,403,74,27041,29847,28720,4,41,9,0,0,0,0,5,374,106,26528,29517,32200,1,29,-32,513,2,330,-3480,2,0,0,0,-1
EUW1_6878691959',3,97,26,2,0,2,0,7,0,349,88,34974,31108,48291,5,30,11,0,0,0,0,8,314,72,25585,25927,27598,1,35,16,9389,15,5181,20693,2,0,2,0,-1
EUW1_6878654991',4,25,13,0,0,0,0,9,1,371,120,28503,32382,33314,1,51,4,2,0,2,0,4,354,76,23219,29744,24549,1,17,44,5284,9,2638,8765,-2,0,-2,0,5
EUW1_6878602940',0,29,12,1,0,1,0,12,0,363,101,27786,31559,31628,1,22,10,1,0,1,0,4,374,118,28997,31124,31651,0,-11,-17,-1211,2,435,-23,0,0,0,0,8
EUW1_6878567903',2,28,15,1,0,2,0,11,0,366,106,31723,30621,28816,4,23,10,0,0,1,0,7,303,83,24064,24686,31222,1,63,23,7659,5,5935,-2406,1,0,1,0,4
EUW1_6878524087',7,38,7,0,0,0,0,4,1,394,91,25319,30251,27391,2,26,8,1,0,0,0,1,365,75,24363,29125,26503,1,29,16,956,-1,1126,888,-1,0,0,0,3
EUW1_6878401388',2,30,13,1,0,1,0,13,0,321,72,28458,26346,34299,5,31,19,0,0,2,0,2,338,84,30615,28896,35657,0,-17,-12,-2157,-6,-2550,-1358,1,0,-1,0,11
EUW1_6878368085',4,25,12,0,0,0,0,11,0,344,77,25612,26724,33337,5,26,18,2,0,1,0,2,370,103,31879,32094,39875,0,-26,-26,-6267,-6,-5370,-6538,-2,0,-1,0,9
EUW1_6877664190',4,25,12,0,0,1,0,8,0,323,110,27469,28054,29976,1,29,15,2,0,0,0,5,354,78,28256,29721,38071,0,-31,32,-787,-3,-1667,-8095,-2,0,1,0,3
EUW1_6877635517',3,27,12,1,0,0,0,15,0,381,82,26750,29763,38047,1,32,13,1,0,2,0,3,413,87,30119,32068,39560,0,-32,-5,-3369,-1,-2305,-1513,0,0,-2,0,12
EUW1_6877559114',1,40,12,1,1,1,0,11,0,377,98,28333,31736,26688,3,31,8,1,0,2,0,3,346,109,25845,28461,26685,0,31,-11,2488,4,3275,3,0,1,-1,0,8
EUW1_6877490138',4,131,13,1,0,2,0,5,1,344,100,28995,30620,33818,2,29,11,1,0,0,0,7,349,85,25553,28312,28809,1,-5,15,3442,2,2308,5009,0,0,2,0,-2
EUW1_6877434700',3,25,14,1,0,0,0,12,0,317,77,26720,29131,38790,4,26,17,0,0,0,0,2,373,74,29469,30469,40047,0,-56,3,-2749,-3,-1338,-1257,1,0,0,0,10
EUW1_6883612661',4,27,10,0,0,0,0,5,1,348,71,25424,26312,26767,3,31,17,2,0,0,0,3,325,92,28225,30290,33294,0,23,-21,-2801,-7,-3978,-6527,-2,0,0,0,2
EUW1_6883588311',3,43,25,2,0,2,0,11,1,347,88,32538,31723,37881,2,21,7,0,0,1,0,10,335,68,25645,26122,31208,1,12,20,6893,18,5601,6673,2,0,1,0,1
EUW1_6883470277',1,21,19,0,0,1,0,15,1,326,96,31103,29722,39903,3,27,16,0,0,2,0,5,328,84,30746,32067,37251,1,-2,12,357,3,-2345,2652,0,0,-1,0,10
EUW1_6883426765',1,27,10,1,0,0,0,11,0,322,89,26507,27537,38130,4,24,17,0,0,0,0,5,324,80,28780,30163,36977,1,-2,9,-2273,-7,-2626,1153,1,0,0,0,6
EUW1_6883380375',1,26,5,0,0,0,0,7,0,355,94,23479,28046,22551,7,26,13,1,1,1,0,2,378,105,28957,31689,27496,0,-23,-11,-5478,-8,-3643,-4945,-1,-1,-1,0,5
EUW1_6883321445',4,131,10,0,0,1,0,11,1,375,118,28389,31753,35528,8,33,13,1,0,0,0,6,372,78,27243,30473,24341,0,3,40,1146,-3,1280,11187,-1,0,1,0,5
EUW1_6882299976',4,26,13,1,0,0,0,8,1,328,74,27180,29637,32220,2,24,17,0,0,1,0,4,347,97,30254,30296,47187,0,-19,-23,-3074,-4,-659,-14967,1,0,-1,0,4
EUW1_6882212223',2,30,15,1,0,0,0,12,1,316,88,28260,27284,39292,3,26,20,0,0,3,0,6,365,79,31057,30713,43595,1,-49,9,-2797,-5,-3429,-4303,1,0,-3,0,6
EUW1_6882198477',2,34,12,2,0,0,0,4,0,354,71,25305,28336,35890,7,31,15,0,0,1,0,3,293,88,27315,27077,37461,0,61,-17,-2010,-3,1259,-1571,2,0,-1,0,1
EUW1_6880818796',6,27,15,0,0,0,0,6,1,358,68,29123,28960,41171,3,19,16,2,0,1,0,7,343,83,28075,30531,34158,0,15,-15,1048,-1,-1571,7013,-2,0,-1,0,-1
EUW1_6880809584',3,24,13,2,0,0,0,13,1,357,76,28338,29887,33240,2,24,10,0,0,3,0,6,324,96,27474,28321,27394,1,33,-20,864,3,1566,5846,2,0,-3,0,7
EUW1_6880795720',0,20,13,1,0,0,0,15,0,333,83,25801,30516,32112,3,25,18,1,1,3,0,3,356,95,31681,32750,33941,0,-23,-12,-5880,-5,-2234,-1829,0,-1,-3,0,12
EUW1_6880761410',0,24,8,1,0,0,0,11,0,325,92,25367,27272,29525,1,31,13,0,0,2,0,3,359,72,27554,29720,34097,1,-34,20,-2187,-5,-2448,-4572,1,0,-2,0,8
EUW1_6880756617',5,70,12,2,0,0,0,6,0,360,92,26572,30229,32051,4,40,9,0,0,0,0,7,344,97,25257,28283,31680,1,16,-5,1315,3,1946,371,2,0,0,0,-1
EUW1_6880730831',1,23,14,1,0,1,0,11,1,327,89,29806,30752,34465,1,25,16,1,0,2,0,3,358,88,29069,30930,30210,1,-31,1,737,-2,-178,4255,0,0,-1,0,8
EUW1_6880702026',2,28,22,0,1,1,0,8,1,363,68,31813,30824,40254,6,25,12,1,0,0,0,2,374,90,28143,29252,34300,1,-11,-22,3670,10,1572,5954,-1,1,1,0,6
EUW1_6880627703',3,29,10,1,0,0,0,6,1,351,82,25138,29097,26375,3,26,5,1,0,0,0,1,371,89,24110,28869,24050,1,-20,-7,1028,5,228,2325,0,0,0,0,5
EUW1_6880583467',4,27,12,1,0,2,0,3,0,396,94,30060,32125,28934,2,30,6,0,0,1,0,5,368,82,23667,28841,29051,1,28,12,6393,6,3284,-117,1,0,1,0,-2
EUW1_6880539588',3,19,8,0,0,0,0,12,0,336,86,24657,26617,29530,4,22,31,1,0,1,0,4,371,90,35609,32345,43743,0,-35,-4,-10952,-23,-5728,-14213,-1,0,-1,0,8
EUW1_6883743266',2,36,11,1,0,0,0,10,0,378,96,26644,31112,26080,5,103,4,1,0,1,0,1,377,92,24731,28936,26316,1,1,4,1913,7,2176,-236,0,0,-1,0,9
EUW1_6883731891',3,70,11,0,0,1,0,8,1,411,81,28603,32207,27649,2,20,10,2,0,1,0,4,377,90,26203,30327,31481,1,34,-9,2400,1,1880,-3832,-2,0,0,0,4
EUW1_6882599134',4,38,13,0,0,1,0,7,0,408,70,28662,29515,34771,3,293,16,2,0,0,0,2,365,82,29201,30660,35301,0,43,-12,-539,-3,-1145,-530,-2,0,1,0,5
EUW1_6881069396',6,39,9,0,0,1,0,9,1,382,118,27362,30364,26446,3,33,11,2,0,0,0,3,380,80,27225,29789,27690,1,2,38,137,-2,575,-1244,-2,0,1,0,6
EUW1_6881038991',5,137,13,0,0,0,0,8,0,312,96,26412,28013,33087,2,31,19,1,0,1,0,1,356,97,30732,32541,33410,0,-44,-1,-4320,-6,-4528,-323,-1,0,-1,0,7
EUW1_6881015557',2,23,17,2,0,0,0,9,0,320,102,29091,30897,40494,6,28,20,0,0,1,0,2,336,78,30261,30728,43198,1,-16,24,-1170,-3,169,-2704,2,0,-1,0,7
EUW1_6879603859',1,42,6,0,0,0,0,13,0,415,91,25697,29629,22593,4,31,7,2,0,2,0,5,373,108,26780,28841,27790,0,42,-17,-1083,-1,788,-5197,-2,0,-2,0,8
EUW1_6879491055',3,24,14,0,0,1,0,7,0,353,86,28653,29760,30267,4,48,12,2,0,0,0,3,331,70,26065,27225,30002,0,22,16,2588,2,2535,265,-2,0,1,0,4
EUW1_6878069851',4,27,16,1,0,0,0,11,0,309,81,28419,28689,32391,4,28,20,1,0,2,0,5,374,84,32761,29668,33531,0,-65,-3,-4342,-4,-979,-1140,0,0,-2,0,6
EUW1_6875053746',7,85,15,1,0,2,0,10,1,338,75,29779,29284,38866,2,27,17,0,0,2,0,8,350,80,31435,29926,47864,0,-12,-5,-1656,-2,-642,-8998,1,0,0,0,2
EUW1_6875035672',3,33,10,2,0,0,0,10,0,338,84,27432,29676,32912,6,45,16,0,1,2,0,3,397,92,29965,30889,36089,1,-59,-8,-2533,-6,-1213,-3177,2,-1,-2,0,7
EUW1_6875012865',1,58,13,0,0,0,0,11,0,287,74,27125,26506,33094,7,131,22,2,0,2,0,4,294,80,31171,29040,43366,0,-7,-6,-4046,-9,-2534,-10272,-2,0,-2,0,7
EUW1_6874969679',4,26,15,0,1,0,0,10,0,320,100,28409,32538,35476,2,42,15,2,0,0,0,3,343,74,27037,27875,39160,1,-23,26,1372,0,4663,-3684,-2,1,0,0,7
EUW1_6874944772',8,33,14,0,0,0,0,6,0,288,89,26322,26922,35277,8,41,10,2,0,0,0,3,331,94,26416,28053,32675,0,-43,-5,-94,4,-1131,2602,-2,0,0,0,3
EUW1_6873743796',10,32,9,0,0,2,0,10,1,404,96,28547,29610,32137,2,20,14,1,0,0,0,2,394,88,28095,31044,28988,1,10,8,452,-5,-1434,3149,-1,0,2,0,8
EUW1_6873720633',5,25,9,0,0,0,0,15,0,355,66,25397,28343,29122,2,26,27,1,0,3,0,0,410,89,35066,34954,44584,0,-55,-23,-9669,-18,-6611,-15462,-1,0,-3,0,15
EUW1_6882461734',2,29,16,1,0,1,0,11,1,377,100,32069,32838,39961,5,26,11,1,0,3,0,9,377,82,27396,30931,32487,1,0,18,4673,5,1907,7474,0,0,-2,0,2
EUW1_6882438159',2,166,5,0,0,0,0,12,0,350,72,22565,27669,17097,4,31,18,2,0,3,0,1,405,104,32962,32385,35126,0,-55,-32,-10397,-13,-4716,-18029,-2,0,-3,0,11
EUW1_6881318172',3,25,26,1,0,1,0,8,0,352,83,34950,31295,47938,4,28,10,1,0,2,0,7,275,52,23677,25786,31592,1,77,31,11273,16,5509,16346,0,0,-1,0,1
EUW1_6881147450',2,30,15,0,0,1,0,6,1,366,72,28172,28332,35058,7,32,11,2,0,0,0,2,379,90,27218,29549,33226,1,-13,-18,954,4,-1217,1832,-2,0,1,0,4
EUW1_6881109350',2,28,8,1,0,0,0,9,0,345,94,23491,26990,30878,6,34,17,0,0,3,0,2,355,86,31090,31352,36557,0,-10,8,-7599,-9,-4362,-5679,1,0,-3,0,7
EUW1_6881040635',3,25,10,1,0,0,0,16,1,315,106,26031,29075,25664,3,22,19,1,0,5,0,0,407,105,34850,34038,36616,0,-92,1,-8819,-9,-4963,-10952,0,0,-5,0,16
EUW1_6881008271',2,28,6,1,0,0,0,15,0,328,95,23488,25051,24107,6,29,20,1,1,3,0,0,396,107,34333,32032,35919,0,-68,-12,-10845,-14,-6981,-11812,0,-1,-3,0,15
EUW1_6880525979',5,33,12,1,0,0,0,9,1,351,96,27392,30235,28924,4,77,13,1,0,1,0,1,413,73,29213,30884,34979,1,-62,23,-1821,-1,-649,-6055,0,0,-1,0,8
EUW1_6873815053',1,21,14,0,0,0,0,14,1,296,109,27799,29900,34549,4,31,20,2,0,3,0,3,391,94,34613,32523,40087,0,-95,15,-6814,-6,-2623,-5538,-2,0,-3,0,11
EUW1_6873798427',5,30,9,0,0,0,0,5,0,334,110,25684,29327,33285,7,30,16,1,0,1,0,2,391,114,30672,32061,38022,0,-57,-4,-4988,-7,-2734,-4737,-1,0,-1,0,3
EUW1_6873788204',4,34,10,0,0,0,0,10,0,379,72,26303,29531,30295,5,74,14,2,0,1,0,3,398,95,29728,31913,31138,0,-19,-23,-3425,-4,-2382,-843,-2,0,-1,0,7
EUW1_6873352934',6,65,21,1,0,2,0,8,1,351,78,33281,30025,40037,3,151,22,0,0,0,0,9,304,88,31318,27191,43982,0,47,-10,1963,-1,2834,-3945,1,0,2,0,-1
EUW1_6872898470',3,25,9,0,0,0,0,13,0,318,94,25353,27573,25429,5,32,14,2,0,2,0,0,368,94,28673,29121,33802,0,-50,0,-3320,-5,-1548,-8373,-2,0,-2,0,13
EUW1_6872847086',3,26,21,2,1,2,0,8,1,380,99,33573,31201,40438,1,27,10,0,0,2,0,9,296,76,24954,25730,26445,1,84,23,8619,11,5471,13993,2,1,0,0,-1
EUW1_6872498528',5,80,14,1,0,2,0,4,1,343,64,28361,28346,27731,6,77,11,0,0,0,0,7,332,83,25759,27955,25754,1,11,-19,2602,3,391,1977,1,0,2,0,-3
EUW1_6872456387',5,30,7,1,0,1,0,5,0,418,108,26801,31013,21762,5,30,8,1,0,0,0,6,428,100,26811,31555,25203,0,-10,8,-10,-1,-542,-3441,0,0,1,0,-1
EUW1_6883667712',1,63,16,0,0,0,0,7,1,369,96,29190,32663,40031,4,141,9,2,0,0,0,2,325,68,24431,26898,30815,1,44,28,4759,7,5765,9216,-2,0,0,0,5
EUW1_6883646548',2,15,16,0,0,2,0,6,1,353,94,29966,30348,33908,7,36,7,1,0,0,0,5,329,101,24615,27939,26444,0,24,-7,5351,9,2409,7464,-1,0,2,0,1
EUW1_6883028051',0,21,10,1,0,0,0,12,0,306,93,26102,28584,31453,2,16,17,0,0,2,0,2,373,84,29407,31589,44861,0,-67,9,-3305,-7,-3005,-13408,1,0,-2,0,10
EUW1_6882985678',3,26,7,1,0,0,0,6,1,369,90,24558,30304,29357,5,27,5,0,0,0,0,2,378,86,24503,28530,28715,0,-9,4,55,2,1774,642,1,0,0,0,4
EUW1_6877889896',3,22,12,1,0,0,0,15,0,285,113,26609,29203,23832,3,30,13,1,1,2,0,4,358,106,28072,29381,30723,1,-73,7,-1463,-1,-178,-6891,0,-1,-2,0,11
EUW1_6877823067',5,28,6,2,0,0,0,5,0,391,90,25584,29454,21892,1,27,9,0,1,1,0,6,352,128,25075,30039,23977,1,39,-38,509,-3,-585,-2085,2,-1,-1,0,-1
EUW1_6877662270',2,23,14,0,0,1,0,12,0,361,92,29158,30393,36572,6,37,15,2,0,1,0,0,338,77,27250,28421,33244,0,23,15,1908,-1,1972,3328,-2,0,0,0,12
EUW1_6877626458',5,27,13,0,1,2,0,17,0,366,117,30411,32164,37605,3,29,12,2,0,1,0,4,352,102,27358,29015,30416,1,14,15,3053,1,3149,7189,-2,1,1,0,13
EUW1_6877420072',2,58,14,1,0,1,0,10,1,382,97,29235,31349,26962,1,22,13,1,0,0,0,5,369,90,28500,28960,38634,1,13,7,735,1,2389,-11672,0,0,1,0,5
EUW1_6876422687',5,24,21,0,0,1,0,6,0,341,77,32297,29714,41424,2,23,14,2,0,1,0,7,327,74,28100,28153,36370,0,14,3,4197,7,1561,5054,-2,0,0,0,-1
EUW1_6876395988',1,25,12,0,0,0,0,11,0,335,82,26377,29522,29358,6,26,15,2,0,1,0,1,367,81,28771,28998,33669,0,-32,1,-2394,-3,524,-4311,-2,0,-1,0,10
EUW1_6874968734',2,29,9,0,0,0,0,7,0,372,84,26086,28913,25529,5,28,11,2,0,1,0,2,354,67,26042,28924,26913,0,18,17,44,-2,-11,-1384,-2,0,-1,0,5
EUW1_6870921196',1,23,25,1,1,3,0,11,1,368,92,35733,31874,41867,3,77,16,1,0,1,0,7,331,80,29257,29356,38817,1,37,12,6476,9,2518,3050,0,1,2,0,4
EUW1_6870909427',4,25,13,0,0,0,0,12,0,295,75,26327,26986,30360,5,32,23,1,0,1,0,1,349,79,30842,31242,41665,0,-54,-4,-4515,-10,-4256,-11305,-1,0,-1,0,11
EUW1_6870894538',7,26,28,0,0,2,0,5,1,333,76,34884,29535,47710,11,34,22,1,0,1,0,9,286,92,31822,30403,41278,0,47,-16,3062,6,-868,6432,-1,0,1,0,-4
EUW1_6870817742',3,29,15,0,0,0,0,11,0,339,66,27487,31066,37950,5,46,17,1,0,1,0,1,378,78,29787,31743,39758,0,-39,-12,-2300,-2,-677,-1808,-1,0,-1,0,10
EUW1_6869280999',6,31,11,2,1,1,0,8,1,352,96,27765,29688,29108,2,25,12,0,0,0,0,5,348,104,27293,30679,34108,1,4,-8,472,-1,-991,-5000,2,1,1,0,3
EUW1_6869246314',3,36,8,0,0,1,0,7,0,362,67,24926,25770,31479,2,19,23,2,0,1,0,6,346,80,31282,32089,37286,0,16,-13,-6356,-15,-6319,-5807,-2,0,0,0,1
EUW1_6883734581',4,100,13,0,0,2,0,3,1,382,90,29739,30317,23328,2,26,5,2,1,0,0,9,377,105,25012,29175,22332,0,5,-15,4727,8,1142,996,-2,-1,2,0,-6
EUW1_6883650226',0,26,22,0,1,3,0,8,0,387,108,34124,34099,50852,6,35,15,1,0,0,0,12,305,83,27892,29263,34124,1,82,25,6232,7,4836,16728,-1,1,3,0,-4
EUW1_6878717723',7,40,9,1,0,0,0,8,0,350,98,24828,29748,28274,1,21,10,0,0,1,0,1,368,86,26478,30201,26820,1,-18,12,-1650,-1,-453,1454,1,0,-1,0,7
EUW1_6878569379',3,27,16,0,0,2,0,4,1,385,81,30571,29919,32704,3,23,10,2,0,1,0,5,380,116,26808,31405,22014,1,5,-35,3763,6,-1486,10690,-2,0,1,0,-1
EUW1_6877603995',5,26,17,1,0,0,0,8,0,360,68,29546,29873,36078,2,29,8,0,0,0,0,6,374,99,26497,29921,34420,1,-14,-31,3049,9,-48,1658,1,0,0,0,2
EUW1_6877551593',3,29,10,0,0,0,0,9,0,368,70,26346,26906,28879,6,29,15,1,0,1,0,2,369,116,30306,30721,30478,0,-1,-46,-3960,-5,-3815,-1599,-1,0,-1,0,7
EUW1_6876263375',6,28,8,2,1,1,0,4,1,352,99,26272,28327,22576,6,30,10,0,0,0,0,4,336,80,25714,25638,25262,1,16,19,558,-2,2689,-2686,2,1,1,0,0
EUW1_6876215227',6,34,11,0,0,1,0,13,1,367,62,27822,27451,30647,2,40,20,1,0,2,0,4,379,84,30802,32408,42290,0,-12,-22,-2980,-9,-4957,-11643,-1,0,-1,0,9
EUW1_6870157037',1,28,19,0,0,1,0,7,1,367,100,31395,33058,41226,2,432,11,1,0,0,0,2,376,71,26554,29728,32253,1,-9,29,4841,8,3330,8973,-1,0,1,0,5
EUW1_6868806361',5,64,14,0,0,0,0,8,1,311,73,27197,28865,39017,7,78,21,1,0,2,0,1,346,85,31921,31165,52986,0,-35,-12,-4724,-7,-2300,-13969,-1,0,-2,0,7
EUW1_6876443728',4,23,17,1,0,0,0,5,0,344,102,29755,31501,40513,5,28,22,1,0,1,0,3,280,74,28859,29234,31096,1,64,28,896,-5,2267,9417,0,0,-1,0,2
EUW1_6876426201',3,27,20,0,0,3,0,13,0,341,73,31523,30182,43561,5,31,11,1,0,2,0,10,356,90,28860,27950,30713,1,-15,-17,2663,9,2232,12848,-1,0,1,0,3
EUW1_6876362883',2,18,17,0,1,1,0,6,1,355,122,30938,32504,35617,2,23,11,1,0,1,0,9,329,81,25266,28615,25220,1,26,41,5672,6,3889,10397,-1,1,0,0,-3
EUW1_6876334324',5,29,12,0,0,0,0,11,0,315,104,27008,30527,30505,4,29,17,2,0,1,0,2,361,100,30261,31585,33369,0,-46,4,-3253,-5,-1058,-2864,-2,0,-1,0,9
EUW1_6876270061',2,31,21,0,0,1,0,6,0,348,59,30178,29444,43712,2,24,16,2,0,0,0,6,293,84,27671,30641,40531,1,55,-25,2507,5,-1197,3181,-2,0,1,0,0
EUW1_6876130109',3,24,26,2,0,4,0,14,0,367,94,36406,32169,45152,7,58,17,0,0,2,0,9,273,71,29393,26430,39954,1,94,23,7013,9,5739,5198,2,0,2,0,5
EUW1_6875019579',5,32,12,0,0,0,0,9,0,335,76,26487,28440,37445,4,25,15,2,0,2,0,2,340,97,29102,29083,33041,0,-5,-21,-2615,-3,-643,4404,-2,0,-2,0,7
EUW1_6874992853',5,29,15,1,0,0,0,6,1,336,86,28806,30065,35498,1,26,12,0,0,1,0,2,341,90,26120,28250,34486,1,-5,-4,2686,3,1815,1012,1,0,-1,0,4
EUW1_6874950136',2,27,17,0,0,0,0,11,0,340,101,29817,31364,33961,2,30,15,2,1,1,0,3,367,105,29348,30613,39199,0,-27,-4,469,2,751,-5238,-2,-1,-1,0,8
EUW1_6873767195',3,23,8,1,0,0,0,12,0,347,103,24981,28153,23093,5,44,10,0,0,1,0,0,373,100,27846,31322,36667,0,-26,3,-2865,-2,-3169,-13574,1,0,-1,0,12
EUW1_6873755108',4,30,7,1,0,0,0,9,0,322,72,24259,27004,29120,3,211,15,1,0,1,0,4,358,80,28135,29671,30368,1,-36,-8,-3876,-8,-2667,-1248,0,0,-1,0,5
EUW1_6873743434',2,24,13,0,0,1,0,8,1,365,96,29445,33215,37082,5,30,11,1,0,1,0,7,360,84,25748,30272,25150,1,5,12,3697,2,2943,11932,-1,0,0,0,1
EUW1_6873735155',3,129,14,1,0,1,0,8,1,357,83,29003,30527,36355,2,28,12,1,0,1,0,3,311,92,26624,28002,29659,0,46,-9,2379,2,2525,6696,0,0,0,0,5
EUW1_6873722401',6,19,9,1,0,2,0,6,0,389,82,27301,30418,28938,6,35,10,1,0,0,0,5,326,121,25588,29549,32094,1,63,-39,1713,-1,869,-3156,0,0,2,0,1
EUW1_6873640865',3,24,18,2,0,2,0,6,0,378,104,32247,32263,30030,5,41,7,0,0,0,0,7,330,108,24549,27437,26351,1,48,-4,7698,11,4826,3679,2,0,2,0,-1
EUW1_6873605915',3,26,17,0,0,0,0,7,1,341,82,28203,30335,40020,3,31,14,1,0,0,0,4,347,122,28414,31082,36037,1,-6,-40,-211,3,-747,3983,-1,0,0,0,3
EUW1_6873567480',1,137,7,0,0,0,0,3,1,404,82,25883,29229,23751,6,32,6,1,0,0,0,4,386,79,24376,29463,35142,0,18,3,1507,1,-234,-11391,-1,0,0,0,-1
EUW1_6883627247',1,27,7,0,0,1,0,10,0,369,101,26989,29614,25067,4,23,16,2,0,2,0,3,377,95,30511,30406,36388,1,-8,6,-3522,-9,-792,-11321,-2,0,-1,0,7
EUW1_6883160032',8,54,7,0,1,0,0,14,1,375,82,26392,29817,25670,0,29,3,2,0,3,0,3,366,90,24009,28429,22772,1,9,-8,2383,4,1388,2898,-2,1,-3,0,11
EUW1_6882963701',2,22,9,1,0,0,0,7,0,378,80,25626,28144,27384,6,55,16,0,0,1,0,0,338,94,29247,27875,33385,0,40,-14,-3621,-7,269,-6001,1,0,-1,0,7
EUW1_6882922142',4,30,5,0,0,0,0,8,0,324,103,23595,26868,22413,5,30,17,2,1,2,0,1,415,84,31476,32883,31842,0,-91,19,-7881,-12,-6015,-9429,-2,-1,-2,0,7
EUW1_6882880761',4,28,10,2,0,1,0,9,0,346,105,26848,30568,24997,4,31,7,0,0,1,0,1,372,74,25016,28580,22262,0,-26,31,1832,3,1988,2735,2,0,0,0,8
EUW1_6882664378',0,26,15,1,0,2,0,5,1,387,92,30458,31040,34621,2,23,20,0,0,1,0,6,299,95,30674,30273,38561,1,88,-3,-216,-5,767,-3940,1,0,1,0,-1
EUW1_6882521004',2,30,12,0,1,1,0,10,0,376,96,28119,29365,33039,7,43,14,2,0,2,0,4,355,64,29498,29634,26595,0,21,32,-1379,-2,-269,6444,-2,1,-1,0,6
EUW1_6882498724',4,28,11,2,0,0,0,15,1,320,68,26603,29300,30584,4,28,10,0,0,2,0,4,392,104,28846,30925,29465,0,-72,-36,-2243,1,-1625,1119,2,0,-2,0,11
EUW1_6882068987',5,33,21,1,0,2,0,8,1,337,102,32293,31382,33999,1,23,10,0,0,0,0,11,297,90,26054,28995,29171,1,40,12,6239,11,2387,4828,1,0,2,0,-3
EUW1_6881900943',4,39,6,2,1,0,0,9,1,397,96,25244,30533,24952,1,26,2,0,0,1,0,4,411,100,24969,30088,21657,1,-14,-4,275,4,445,3295,2,1,-1,0,5
EUW1_6881834770',4,90,11,2,0,0,0,14,0,304,81,25792,28191,39877,2,34,15,0,1,2,0,0,367,86,30790,30553,39738,1,-63,-5,-4998,-4,-2362,139,2,-1,-2,0,14
EUW1_6881730536',10,33,6,2,1,1,0,5,0,434,116,27220,32559,28003,7,27,6,0,0,0,0,4,380,95,24490,29400,28564,1,54,21,2730,0,3159,-561,2,1,1,0,1
EUW1_6881658451',6,30,13,1,0,1,0,9,1,367,90,28790,29488,39543,6,38,11,0,0,1,0,1,364,86,26894,27905,31244,1,3,4,1896,2,1583,8299,1,0,0,0,8
EUW1_6883223754',4,49,27,1,1,1,0,3,1,383,96,35024,31055,47331,6,25,6,0,0,1,0,8,277,40,23190,23453,22978,1,106,56,11834,21,7602,24353,1,1,0,0,-5
EUW1_6883161168',4,33,6,1,0,0,0,11,0,344,87,23720,27382,32795,3,29,15,1,0,1,0,2,381,82,28662,29932,29833,0,-37,5,-4942,-9,-2550,2962,0,0,-1,0,9
EUW1_6883103853',13,35,18,2,0,1,0,7,0,395,97,30771,32896,33969,3,35,8,0,0,1,0,5,375,86,26483,28668,30874,1,20,11,4288,10,4228,3095,2,0,0,0,2
EUW1_6883048002',5,33,18,1,0,0,0,11,1,328,80,29181,29293,37311,6,49,12,0,0,1,0,2,338,91,28524,27376,31818,1,-10,-11,657,6,1917,5493,1,0,-1,0,9
EUW1_6881747982',6,35,12,0,0,1,0,9,0,352,103,28621,29866,31793,9,37,18,2,0,2,0,7,319,107,30864,31525,38684,0,33,-4,-2243,-6,-1659,-6891,-2,0,-1,0,2
EUW1_6881668423',4,26,14,2,0,2,0,9,1,374,101,30036,31747,33986,0,25,10,0,0,1,0,9,353,112,27004,30057,30319,1,21,-11,3032,4,1690,3667,2,0,1,0,0
EUW1_6881592234',5,32,5,1,0,0,0,14,1,333,70,22585,25268,20876,1,39,23,0,0,4,0,3,370,78,33359,30358,43210,0,-37,-8,-10774,-18,-5090,-22334,1,0,-4,0,11
EUW1_6881553834',8,32,9,0,0,0,0,8,0,269,79,24231,26185,31742,2,25,15,2,0,0,0,0,407,124,29763,31692,40592,0,-138,-45,-5532,-6,-5507,-8850,-2,0,0,0,8
EUW1_6881509349',3,26,23,2,1,2,0,4,1,374,148,34685,36559,45165,3,33,8,0,0,0,0,9,342,82,25144,29918,29119,1,32,66,9541,15,6641,16046,2,1,2,0,-5
EUW1_6881453898',1,27,9,0,0,0,0,4,0,340,88,25047,29004,24743,6,47,13,2,0,0,0,2,384,80,26112,30792,30910,0,-44,8,-1065,-4,-1788,-6167,-2,0,0,0,2
EUW1_6881392981',2,28,7,1,1,0,0,7,1,340,108,25498,28344,30912,6,34,15,0,0,1,0,3,347,88,28623,29726,31475,1,-7,20,-3125,-8,-1382,-563,1,1,-1,0,4
EUW1_6881335367',8,43,19,2,0,2,0,7,1,375,106,31752,30372,37912,4,21,11,0,0,0,0,8,364,78,26528,29192,32115,1,11,28,5224,8,1180,5797,2,0,2,0,-1
EUW1_6881279218',6,32,15,0,1,1,0,12,1,386,80,30056,29882,29838,0,28,11,2,0,0,0,7,352,103,27146,30087,31461,0,34,-23,2910,4,-205,-1623,-2,1,1,0,5
EUW1_6878090271',6,31,7,1,0,0,0,8,0,354,69,23589,27256,22084,3,37,12,1,0,0,0,0,339,120,26856,30101,29298,1,15,-51,-3267,-5,-2845,-7214,0,0,0,0,8
EUW1_6875976306',6,27,12,1,0,0,0,11,0,386,76,28384,29344,31008,5,33,11,0,0,0,0,3,374,91,27166,29391,27195,1,12,-15,1218,1,-47,3813,1,0,0,0,8
EUW1_6875918285',4,74,6,0,0,1,0,9,0,377,84,25922,28122,34059,4,31,19,2,0,1,0,6,357,71,28546,29974,36155,0,20,13,-2624,-13,-1852,-2096,-2,0,0,0,3
EUW1_6875865568',1,25,10,0,0,0,0,11,1,401,95,29490,31058,24461,7,37,15,2,0,1,0,3,428,92,29023,30573,27261,1,-27,3,467,-5,485,-2800,-2,0,-1,0,8
EUW1_6875819047',5,37,10,2,0,4,0,6,1,378,112,30408,30703,24283,3,29,3,0,0,0,0,12,301,95,21545,25120,16105,1,77,17,8863,7,5583,8178,2,0,4,0,-6
EUW1_6875777977',8,30,9,1,0,1,0,11,1,353,80,28262,27625,39880,5,28,16,0,0,2,0,5,336,108,29320,29850,32588,0,17,-28,-1058,-7,-2225,7292,1,0,-1,0,6
EUW1_6875722987',3,24,16,0,0,0,0,11,0,317,84,27871,29629,41829,3,24,23,1,0,2,0,0,347,78,33632,31376,47045,0,-30,6,-5761,-7,-1747,-5216,-1,0,-2,0,11
EUW1_6862267851',3,21,12,1,0,0,0,7,1,329,98,27898,29858,32661,4,30,13,1,0,1,0,5,376,102,28781,30860,33002,0,-47,-4,-883,-1,-1002,-341,0,0,-1,0,2
EUW1_6862237601',3,23,11,0,0,0,0,7,1,390,98,27923,30438,28208,4,28,13,1,0,0,0,0,393,92,28043,30283,33849,1,-3,6,-120,-2,155,-5641,-1,0,0,0,7
EUW1_6861285926',4,28,13,0,0,0,0,13,0,325,106,27084,30469,27314,3,29,17,2,1,2,0,0,397,92,31463,32695,40192,1,-72,14,-4379,-4,-2226,-12878,-2,-1,-2,0,13
EUW1_6859458680',1,70,3,0,0,0,0,11,0,312,76,21613,23400,24323,2,66,22,1,1,4,0,2,386,120,33460,32420,44384,0,-74,-44,-11847,-19,-9020,-20061,-1,-1,-4,0,9
EUW1_6858179444',1,49,8,0,0,0,0,8,0,359,94,27181,27742,24328,7,33,14,2,0,0,0,2,345,84,26587,29526,31031,1,14,10,594,-6,-1784,-6703,-2,0,0,0,6
EUW1_6858143304',7,102,15,2,0,0,0,6,1,327,105,29167,28659,36012,6,30,6,0,0,2,0,5,333,72,24299,26312,30842,1,-6,33,4868,9,2347,5170,2,0,-2,0,1
EUW1_6858118042',7,32,10,0,0,1,0,2,1,368,112,28375,29500,25757,7,33,10,1,0,0,0,8,377,80,25629,29072,26689,0,-9,32,2746,0,428,-932,-1,0,1,0,-6
EUW1_6857210644',3,33,6,0,0,0,0,8,0,284,102,23861,27083,34759,4,36,14,2,0,2,0,3,392,78,29809,32265,37299,0,-108,24,-5948,-8,-5182,-2540,-2,0,-2,0,5
EUW1_6855645366',10,38,10,0,0,1,0,14,1,363,99,28237,29186,27945,2,52,18,1,1,1,0,3,361,108,31444,30487,32071,0,2,-9,-3207,-8,-1301,-4126,-1,-1,0,0,11
EUW1_6854480587',3,22,12,0,0,1,0,5,1,339,114,28925,30325,32466,4,42,13,1,0,0,0,8,334,102,26430,30341,33717,1,5,12,2495,-1,-16,-1251,-1,0,1,0,-3
EUW1_6851952589',4,49,15,0,0,1,0,9,0,378,105,30324,31383,34209,5,28,11,1,0,1,0,5,371,105,28142,30367,36420,0,7,0,2182,4,1016,-2211,-1,0,0,0,4
EUW1_6850618014',5,24,13,1,0,0,0,9,1,406,90,30105,29791,30865,3,31,14,1,0,2,0,6,391,106,30796,30716,33342,1,15,-16,-691,-1,-925,-2477,0,0,-2,0,3
EUW1_6848802545',6,39,12,0,1,0,0,6,1,339,99,27728,29690,30172,3,27,8,1,0,0,0,5,364,84,25575,28048,28585,1,-25,15,2153,4,1642,1587,-1,1,0,0,1
EUW1_6848743588',8,32,29,1,1,1,0,6,1,370,120,38260,34651,46563,2,353,10,0,0,3,0,10,302,88,25198,27366,30841,1,68,32,13062,19,7285,15722,1,1,-2,0,-4
EUW1_6848692271',2,26,10,0,0,0,0,11,0,354,100,27183,30098,31978,1,31,7,0,0,2,0,2,345,95,26304,29395,34467,1,9,5,879,3,703,-2489,0,0,-2,0,9
EUW1_6847667941',7,32,8,1,0,0,0,8,0,394,98,26422,29287,23988,2,100,14,1,0,0,0,1,354,94,29007,31738,32277,0,40,4,-2585,-6,-2451,-8289,0,0,0,0,7
EUW1_6847432177',2,70,7,0,0,0,0,6,0,357,101,24975,29742,23891,3,62,6,2,1,1,0,2,392,118,26982,31232,25637,0,-35,-17,-2007,1,-1490,-1746,-2,-1,-1,0,4
EUW1_6846610198',4,276,18,2,0,2,0,11,0,375,68,30930,31374,34334,6,23,6,0,0,2,0,8,354,111,25519,29067,27283,1,21,-43,5411,12,2307,7051,2,0,0,0,3
EUW1_6846384209',5,52,19,1,0,0,0,12,1,348,82,28835,29549,38896,6,32,14,1,0,2,0,3,359,89,31364,31671,37757,0,-11,-7,-2529,5,-2122,1139,0,0,-2,0,9
EUW1_6846360520',5,66,12,1,0,1,0,14,1,380,77,29069,31043,28824,5,115,6,0,1,2,0,4,347,108,26293,28226,26154,1,33,-31,2776,6,2817,2670,1,-1,-1,0,10
EUW1_6878834228',1,31,13,2,0,0,0,12,0,364,88,28920,29126,37145,7,33,17,0,1,2,0,4,329,95,30838,28984,32654,0,35,-7,-1918,-4,142,4491,2,-1,-2,0,8
EUW1_6878729827',5,27,16,0,0,0,0,9,1,361,85,28493,30302,37383,3,30,12,2,0,1,0,0,352,118,29070,32212,36708,0,9,-33,-577,4,-1910,675,-2,0,-1,0,9
EUW1_6870978336',4,28,14,0,0,0,0,6,1,336,81,26802,28301,31876,4,26,12,2,0,0,0,5,342,98,27036,30623,41179,1,-6,-17,-234,2,-2322,-9303,-2,0,0,0,1
EUW1_6870744685',5,268,26,1,0,1,0,6,0,334,104,34313,33200,46684,2,29,10,0,0,1,0,8,322,70,26225,27157,32133,1,12,34,8088,16,6043,14551,1,0,0,0,-2
EUW1_6863297233',4,27,10,1,0,1,0,11,1,424,84,29472,30884,31215,4,40,15,1,0,0,0,4,366,68,27393,28586,31145,0,58,16,2079,-5,2298,70,0,0,1,0,7
EUW1_6861770623',3,272,14,1,1,0,0,8,0,377,77,29832,28237,32079,2,37,11,0,0,1,0,3,341,87,26096,28540,23860,0,36,-10,3736,3,-303,8219,1,1,-1,0,5
EUW1_6861682561',6,31,24,0,0,1,0,6,1,313,82,32176,27770,36577,7,33,15,1,0,0,0,6,333,68,29167,27171,33724,1,-20,14,3009,9,599,2853,-1,0,1,0,0
EUW1_6861620582',1,131,4,0,0,0,0,9,0,368,94,23568,27527,26290,5,51,21,2,0,1,0,1,373,75,30553,31245,37705,0,-5,19,-6985,-17,-3718,-11415,-2,0,-1,0,8
EUW1_6861479230',6,40,19,1,0,2,0,9,1,378,108,31610,32565,44551,1,80,12,0,0,1,0,7,342,80,27618,29681,34829,0,36,28,3992,7,2884,9722,1,0,1,0,2
EUW1_6858468641',7,35,11,1,0,1,0,6,0,414,84,28915,31001,31039,6,33,9,1,0,0,0,5,370,80,26408,27914,33655,1,44,4,2507,2,3087,-2616,0,0,1,0,1
EUW1_6858413424',1,31,9,0,1,1,0,10,1,392,114,27730,30096,27989,2,24,17,2,0,1,0,6,348,88,28476,28610,32923,0,44,26,-746,-8,1486,-4934,-2,1,0,0,4
EUW1_6857696976',3,83,11,1,0,1,0,8,1,376,90,28050,30793,32102,6,104,11,0,0,1,0,4,344,106,28027,29905,25295,1,32,-16,23,0,888,6807,1,0,0,0,4
EUW1_6857646104',1,25,15,0,0,1,0,12,0,326,88,29003,30853,32017,2,21,15,2,0,1,0,3,308,107,28539,29651,34820,0,18,-19,464,0,1202,-2803,-2,0,0,0,9
EUW1_6857382643',3,24,11,2,0,2,0,5,1,395,135,30355,32626,28954,4,82,7,0,0,1,0,4,337,67,23913,27077,28018,1,58,68,6442,4,5549,936,2,0,1,0,1
EUW1_6857268738',5,34,16,0,0,1,0,9,1,337,84,30353,28746,38545,3,33,15,2,0,0,0,6,381,80,28792,31195,38610,0,-44,4,1561,1,-2449,-65,-2,0,1,0,3
EUW1_6857105974',5,30,17,2,0,2,0,4,1,373,76,30253,31810,37777,1,56,3,0,0,0,0,7,311,90,21722,27006,23241,1,62,-14,8531,14,4804,14536,2,0,2,0,-3
EUW1_6857067464',7,26,5,0,0,0,0,7,1,368,112,24850,29028,19358,6,39,11,2,0,1,0,0,448,86,27981,33704,27840,1,-80,26,-3131,-6,-4676,-8482,-2,0,-1,0,7
EUW1_6857008549',1,23,7,1,0,1,0,8,1,383,106,26480,30167,28651,2,33,9,1,0,1,0,4,393,90,27663,31692,33561,1,-10,16,-1183,-2,-1525,-4910,0,0,0,0,4
EUW1_6883424007',3,68,6,0,0,1,0,9,0,338,74,24194,28355,24190,4,27,13,2,0,0,0,1,372,90,27713,31784,32990,0,-34,-16,-3519,-7,-3429,-8800,-2,0,1,0,8
EUW1_6883136554',4,290,14,0,0,1,0,7,1,364,76,28803,29978,43781,5,29,15,2,0,0,0,5,331,100,28209,30673,39963,0,33,-24,594,-1,-695,3818,-2,0,1,0,2
EUW1_6882140542',4,34,12,1,0,0,0,14,1,327,84,26620,28836,37822,6,33,6,1,0,0,0,4,315,84,23901,24441,28393,1,12,0,2719,6,4395,9429,0,0,0,0,10
EUW1_6882109836',1,23,16,0,0,0,0,10,1,343,69,28202,26773,40880,5,28,24,1,0,1,0,4,364,88,34476,31479,43687,0,-21,-19,-6274,-8,-4706,-2807,-1,0,-1,0,6
EUW1_6870710517',5,26,22,2,0,0,0,9,1,323,106,30907,32182,40259,4,28,13,0,0,2,0,2,368,80,29661,31701,40340,1,-45,26,1246,9,481,-81,2,0,-2,0,7
EUW1_6866396773',4,30,10,1,1,0,0,12,0,338,62,26261,27733,29956,4,37,23,1,0,2,0,0,361,78,31787,31189,40074,0,-23,-16,-5526,-13,-3456,-10118,0,1,-2,0,12
EUW1_6866343102',3,24,9,1,0,0,0,5,0,398,72,26052,29019,28664,6,32,15,1,0,1,0,4,336,116,29156,31642,35990,1,62,-44,-3104,-6,-2623,-7326,0,0,-1,0,1
EUW1_6866264463',3,27,8,0,0,0,0,15,0,267,77,24165,27017,31458,3,32,23,2,0,2,0,1,385,86,32366,31781,38452,0,-118,-9,-8201,-15,-4764,-6994,-2,0,-2,0,14
EUW1_6865031950',4,31,12,2,0,1,0,5,1,345,124,27959,30421,30621,2,27,11,0,1,0,0,3,329,100,26304,29306,26907,1,16,24,1655,1,1115,3714,2,-1,1,0,2
EUW1_6863978254',3,39,8,1,0,1,0,8,1,346,110,26323,28909,27285,4,31,10,1,0,1,0,7,351,81,26375,29303,30091,1,-5,29,-52,-2,-394,-2806,0,0,0,0,1
EUW1_6863887696',10,37,13,0,0,1,0,8,0,385,120,30573,31136,31283,6,32,10,1,0,1,0,8,321,83,24346,28003,23812,1,64,37,6227,3,3133,7471,-1,0,0,0,0
EUW1_6863097243',4,21,7,0,0,0,0,7,0,321,76,23361,27428,31878,5,35,18,2,0,0,0,1,337,84,27506,29819,36537,0,-16,-8,-4145,-11,-2391,-4659,-2,0,0,0,6
EUW1_6863085608',4,31,22,1,1,2,0,9,1,361,96,32105,33877,46669,1,19,6,0,0,0,0,4,301,88,23455,28837,28676,1,60,8,8650,16,5040,17993,1,1,2,0,5
EUW1_6860399777',4,31,9,2,0,1,0,7,0,342,78,25736,30265,32812,1,24,10,0,0,0,0,4,317,121,25558,30307,27323,0,25,-43,178,-1,-42,5489,2,0,1,0,3
EUW1_6860342033',1,42,13,0,0,1,0,9,0,345,88,28021,29106,33979,9,37,10,1,0,1,0,3,391,59,27670,29687,32287,1,-46,29,351,3,-581,1692,-1,0,0,0,6
EUW1_6860269371',5,35,14,0,0,0,0,7,1,385,68,28795,30944,37175,2,31,20,1,0,1,0,3,380,80,31006,30772,36251,0,5,-12,-2211,-6,172,924,-1,0,-1,0,4
EUW1_6860220199',7,29,22,2,0,0,0,12,1,346,90,29673,31029,41214,1,30,10,0,0,2,0,1,357,97,28192,29179,32375,1,-11,-7,1481,12,1850,8839,2,0,-2,0,11
EUW1_6860170659',4,33,16,1,0,2,0,10,1,344,111,31944,30180,34073,1,24,17,1,0,0,0,4,297,75,28258,27951,32103,0,47,36,3686,-1,2229,1970,0,0,2,0,6
EUW1_6860097235',5,30,13,2,1,0,0,7,0,347,80,27296,27830,35859,6,43,20,0,0,1,0,5,359,83,32057,32577,41016,0,-12,-3,-4761,-7,-4747,-5157,2,1,-1,0,2
EUW1_6859982472',3,31,11,1,0,0,0,10,1,381,117,26503,30606,32044,9,34,9,1,0,0,0,1,373,62,25070,27795,35875,1,8,55,1433,2,2811,-3831,0,0,0,0,9
EUW1_6859904120',5,146,9,1,0,0,0,5,1,376,90,26543,29598,34111,9,53,12,1,0,1,0,3,351,101,27822,31186,28055,1,25,-11,-1279,-3,-1588,6056,0,0,-1,0,2
EUW1_6859860365',3,25,15,0,0,1,0,10,0,381,77,30149,30927,43397,5,28,11,1,0,2,0,5,317,87,26625,29168,32734,1,64,-10,3524,4,1759,10663,-1,0,-1,0,5
EUW1_6859809420',5,39,10,0,0,1,0,6,1,329,84,26251,28271,33417,7,30,10,2,0,1,0,3,374,84,26208,29128,30902,0,-45,0,43,0,-857,2515,-2,0,0,0,3
EUW1_6859635940',5,38,8,1,1,0,0,7,0,373,88,26277,30420,29622,8,31,8,1,0,1,0,2,386,108,27771,29372,31144,0,-13,-20,-1494,0,1048,-1522,0,1,-1,0,5
EUW1_6859601931',3,30,15,0,0,3,0,6,1,379,88,32394,30111,34502,4,46,14,2,0,2,0,11,217,90,26417,26276,35649,0,162,-2,5977,1,3835,-1147,-2,0,1,0,-5
EUW1_6859558117',6,64,15,1,0,0,0,13,0,353,74,27676,29444,30233,4,26,15,1,0,1,0,2,390,83,30493,29731,40492,0,-37,-9,-2817,0,-287,-10259,0,0,-1,0,11
EUW1_6859508621',6,46,11,0,1,1,0,6,1,386,108,28290,31549,25685,1,19,4,2,0,0,0,5,393,96,24217,29848,23896,1,-7,12,4073,7,1701,1789,-2,1,1,0,1
EUW1_6859473422',3,27,11,0,0,0,0,12,0,320,72,25703,29280,32166,5,27,11,2,0,3,0,3,369,100,29257,29936,39446,0,-49,-28,-3554,0,-656,-7280,-2,0,-3,0,9
EUW1_6859463109',3,31,10,0,0,0,0,15,1,305,84,24493,27030,38087,4,31,15,1,1,2,0,2,366,100,30541,30559,38031,0,-61,-16,-6048,-5,-3529,56,-1,-1,-2,0,13
EUW1_6858749182',3,26,16,1,0,1,0,11,1,341,66,29864,28528,28547,5,33,11,0,0,2,0,7,382,90,28171,29369,33916,1,-41,-24,1693,5,-841,-5369,1,0,-1,0,4
EUW1_6858698359',3,36,14,1,1,0,0,9,1,372,86,29227,30268,32496,5,25,10,0,0,1,0,3,387,100,27326,30535,28233,1,-15,-14,1901,4,-267,4263,1,1,-1,0,6
EUW1_6858454440',3,27,6,2,0,0,0,8,1,430,105,26079,30896,31453,3,32,9,0,0,0,0,3,339,82,25720,28544,24643,1,91,23,359,-3,2352,6810,2,0,0,0,5
EUW1_6858419964',4,32,5,0,0,0,0,8,1,376,76,24036,26838,28343,1,31,12,2,0,2,0,2,357,72,27049,29471,38001,0,19,4,-3013,-7,-2633,-9658,-2,0,-2,0,6
EUW1_6871761764',5,29,13,1,0,1,0,9,1,361,78,28379,28882,28671,2,59,12,1,1,1,0,7,388,95,27999,31597,27565,0,-27,-17,380,1,-2715,1106,0,-1,0,0,2
EUW1_6870187899',3,26,9,0,0,0,0,10,0,376,90,27577,30034,36032,3,28,14,2,0,2,0,3,397,67,29551,30636,40331,0,-21,23,-1974,-5,-602,-4299,-2,0,-2,0,7
EUW1_6870128035',3,28,9,2,0,2,0,3,1,418,88,29734,30938,30215,2,67,2,0,0,0,0,10,371,108,22921,28681,16491,1,47,-20,6813,7,2257,13724,2,0,2,0,-7
EUW1_6870058383',4,40,15,1,0,0,0,4,0,326,114,28522,30984,32457,3,25,16,1,0,1,0,3,342,92,28180,32212,31310,0,-16,22,342,-1,-1228,1147,0,0,-1,0,1
EUW1_6870005305',3,30,4,0,0,0,0,9,0,363,66,22406,25413,22410,3,28,17,1,0,1,0,2,392,95,30573,31088,31672,0,-29,-29,-8167,-13,-5675,-9262,-1,0,-1,0,7
EUW1_6869953932',1,52,12,1,0,1,0,15,1,331,94,27032,29072,28651,4,65,17,1,0,3,0,3,426,85,33350,33642,37853,0,-95,9,-6318,-5,-4570,-9202,0,0,-2,0,12
EUW1_6869883046',4,25,20,2,0,3,1,11,0,374,115,34860,32479,36995,3,21,10,0,0,3,0,6,310,75,26203,27906,34449,1,64,40,8657,10,4573,2546,2,0,0,1,5
EUW1_6869831904',5,29,12,2,1,1,0,12,0,396,94,29009,31032,33600,3,29,5,0,0,0,0,3,329,106,23975,27839,24202,1,67,-12,5034,7,3193,9398,2,1,1,0,9
EUW1_6869769755',2,21,14,1,0,0,0,13,1,415,81,30113,31307,35310,3,29,9,0,0,2,0,3,342,92,26323,29551,25638,1,73,-11,3790,5,1756,9672,1,0,-2,0,10
EUW1_6869722849',7,30,11,1,0,0,0,6,0,412,93,27851,32014,30615,7,32,13,1,0,0,0,3,318,90,26543,27712,27962,1,94,3,1308,-2,4302,2653,0,0,0,0,3
EUW1_6869629719',3,89,5,0,1,0,0,10,1,350,77,24648,27619,15553,3,30,13,2,0,2,0,2,415,127,29800,32905,27264,0,-65,-50,-5152,-8,-5286,-11711,-2,1,-2,0,8
EUW1_6869413253',4,26,20,1,0,2,0,8,1,412,72,32756,32053,49364,4,31,8,1,0,0,0,3,302,76,23571,27290,27036,1,110,-4,9185,12,4763,22328,0,0,2,0,5
EUW1_6869400503',5,27,22,2,0,2,0,10,0,352,110,33359,34258,45728,1,19,11,0,0,1,0,7,280,72,25528,26794,28972,1,72,38,7831,11,7464,16756,2,0,1,0,3
EUW1_6869375648',7,33,10,0,0,0,0,13,0,392,84,27022,28976,38748,6,37,17,2,0,3,0,4,388,78,31066,32022,32686,0,4,6,-4044,-7,-3046,6062,-2,0,-3,0,9
EUW1_6867838803',2,31,9,0,0,0,0,12,1,363,86,26006,29192,23461,2,29,8,1,0,1,0,1,400,90,26917,29537,28754,0,-37,-4,-911,1,-345,-5293,-1,0,-1,0,11
EUW1_6867804741',3,27,9,0,0,0,0,8,0,387,76,25219,28744,28809,5,25,10,2,0,0,0,2,405,84,26648,29484,31814,0,-18,-8,-1429,-1,-740,-3005,-2,0,0,0,6
EUW1_6867287621',1,25,10,0,0,1,0,12,1,319,106,26718,28872,30599,3,31,12,1,0,1,0,5,391,86,27834,31597,33291,1,-72,20,-1116,-2,-2725,-2692,-1,0,0,0,7
EUW1_6867236488',5,36,21,2,1,2,0,7,1,371,124,33111,31105,34836,2,29,7,0,0,1,0,10,325,56,23506,24495,22551,1,46,68,9605,14,6610,12285,2,1,1,0,-3
EUW1_6883781585',4,30,24,2,0,2,0,9,0,377,118,34851,34023,46603,5,33,12,0,0,0,0,6,322,64,26559,26320,32103,1,55,54,8292,12,7703,14500,2,0,2,0,3
EUW1_6883737954',4,28,12,1,0,2,0,4,1,403,91,28866,30780,29447,4,36,3,0,0,0,0,5,365,69,21550,27055,17689,1,38,22,7316,9,3725,11758,1,0,2,0,-1
EUW1_6882570553',0,24,5,0,0,0,0,8,0,407,80,24267,28519,22602,3,29,13,2,0,0,0,1,412,84,27935,30688,27901,0,-5,-4,-3668,-8,-2169,-5299,-2,0,0,0,7
EUW1_6882528948',0,35,6,1,0,1,0,11,0,363,114,26130,28587,26364,3,29,12,0,0,1,0,4,382,86,28696,29339,29965,0,-19,28,-2566,-6,-752,-3601,1,0,0,0,7
EUW1_6882500873',3,22,24,1,0,2,0,11,1,377,116,33446,33527,35552,2,121,10,1,0,2,0,5,368,81,27809,30091,29788,1,9,35,5637,14,3436,5764,0,0,0,0,6
EUW1_6882486496',2,29,10,0,0,0,0,15,0,307,56,25051,25769,30352,7,48,24,1,0,3,0,1,360,77,33504,31433,49328,0,-53,-21,-8453,-14,-5664,-18976,-1,0,-3,0,14
EUW1_6882449467',6,36,12,1,1,0,0,7,0,355,78,27204,29704,30653,6,30,14,1,0,1,0,1,347,90,27753,28280,32110,0,8,-12,-549,-2,1424,-1457,0,1,-1,0,6
EUW1_6881096647',2,28,5,0,1,0,0,9,0,411,84,25220,29966,21813,3,26,13,2,0,0,0,1,376,116,28380,30711,28258,0,35,-32,-3160,-8,-745,-6445,-2,1,0,0,8
EUW1_6881056032',1,21,14,1,0,1,0,11,1,418,113,29569,33192,38237,6,26,9,1,0,2,0,9,399,105,28935,31699,24482,0,19,8,634,5,1493,13755,0,0,-1,0,2
EUW1_6881014726',1,30,13,0,1,2,0,7,0,396,106,31381,32700,35634,6,37,14,2,0,1,0,5,364,98,28803,31539,34065,0,32,8,2578,-1,1161,1569,-2,1,1,0,2
EUW1_6880978317',1,28,17,2,0,1,0,9,0,354,101,31203,32429,40666,5,26,6,0,0,1,0,11,333,70,23875,27207,32376,1,21,31,7328,11,5222,8290,2,0,0,0,-2
EUW1_6880948615',10,39,18,0,0,0,0,12,0,364,94,29458,31777,40385,7,33,14,2,0,0,0,2,387,89,30688,32350,35314,0,-23,5,-1230,4,-573,5071,-2,0,0,0,10
EUW1_6880913944',1,64,5,0,0,0,0,9,0,325,84,22563,27551,25776,2,61,11,2,0,3,0,2,399,92,29420,31393,31461,0,-74,-8,-6857,-6,-3842,-5685,-2,0,-3,0,7
EUW1_6878155754',6,53,10,1,0,0,0,9,1,389,89,26919,29239,26119,4,33,12,1,0,1,0,2,393,80,28113,30077,30870,0,-4,9,-1194,-2,-838,-4751,0,0,-1,0,7
EUW1_6878122072',5,195,8,1,0,0,0,12,0,334,104,25227,28395,36070,2,33,22,1,0,2,0,0,381,91,33058,33281,44358,0,-47,13,-7831,-14,-4886,-8288,0,0,-2,0,12
EUW1_6878092187',3,24,14,1,1,2,0,7,1,382,92,31027,32094,33410,6,35,13,1,0,0,0,10,382,98,27239,30572,36272,1,0,-6,3788,1,1522,-2862,0,1,2,0,-3
EUW1_6878072686',3,26,17,1,0,1,0,4,0,372,110,29984,30458,36447,3,69,4,1,0,1,0,6,305,82,23241,26069,23397,1,67,28,6743,13,4389,13050,0,0,0,0,-2
EUW1_6878040773',5,20,13,1,0,1,0,11,0,376,98,29054,31234,30014,3,172,14,1,0,1,0,2,360,96,29200,30940,36618,0,16,2,-146,-1,294,-6604,0,0,0,0,9
EUW1_6875356392',3,28,8,0,0,0,0,12,1,372,79,26088,27552,28499,4,30,13,2,0,2,0,7,402,76,29922,30915,29143,1,-30,3,-3834,-5,-3363,-644,-2,0,-2,0,5
EUW1_6875331543',5,57,11,0,0,3,0,5,1,411,112,30503,32056,23740,3,41,2,1,0,0,0,6,348,95,22082,27271,22102,1,63,17,8421,9,4785,1638,-1,0,3,0,-1
EUW1_6875294577',6,69,17,1,0,0,0,6,0,380,74,31126,30964,42886,2,22,16,1,0,2,0,9,332,81,28097,30984,34824,1,48,-7,3029,1,-20,8062,0,0,-2,0,-3
EUW1_6874519023',1,30,21,1,0,1,0,8,0,310,75,31790,28488,41723,2,21,19,0,0,1,0,4,345,64,30253,27452,39803,1,-35,11,1537,2,1036,1920,1,0,0,0,4
EUW1_6873879028',9,35,12,2,0,0,0,6,1,339,92,26723,29395,33464,3,54,9,0,0,0,0,0,376,81,25815,29021,26855,1,-37,11,908,3,374,6609,2,0,0,0,6
EUW1_6873860828',5,29,10,0,0,1,0,9,0,362,74,26703,27254,27480,6,45,13,1,0,1,0,2,393,101,28165,31735,32067,1,-31,-27,-1462,-3,-4481,-4587,-1,0,0,0,7
EUW1_6873832809',5,32,6,0,1,0,0,9,0,355,91,24763,28591,26803,7,31,14,2,0,0,0,2,379,92,28264,29663,27454,0,-24,-1,-3501,-8,-1072,-651,-2,1,0,0,7
EUW1_6873815694',2,23,16,1,0,0,0,10,1,357,97,27151,30099,30590,9,27,11,1,0,1,0,2,381,103,28663,30178,32944,0,-24,-6,-1512,5,-79,-2354,0,0,-1,0,8
EUW1_6873789376',0,18,2,1,0,0,0,13,0,347,80,22302,26840,22631,4,25,14,1,0,2,0,1,402,99,30332,30842,35155,0,-55,-19,-8030,-12,-4002,-12524,0,0,-2,0,12
EUW1_6873020740',1,20,13,0,0,1,0,8,1,380,81,28794,30535,35572,6,61,14,2,0,1,0,5,336,113,28865,31191,27369,1,44,-32,-71,-1,-656,8203,-2,0,0,0,3
EUW1_6872957392',4,248,15,1,0,1,0,5,1,353,97,28164,30050,28255,5,125,7,0,0,1,0,0,363,86,24961,27969,26768,1,-10,11,3203,8,2081,1487,1,0,0,0,5
EUW1_6872889670',5,29,8,0,0,0,0,6,1,351,86,24781,29478,25540,4,72,6,2,0,1,0,4,370,110,25002,29641,23305,1,-19,-24,-221,2,-163,2235,-2,0,-1,0,2
EUW1_6871188672',3,24,14,1,0,2,0,5,0,351,100,29892,31225,37905,2,80,10,0,0,0,0,9,347,76,24895,30327,21329,1,4,24,4997,4,898,16576,1,0,2,0,-4
EUW1_6871144814',4,67,14,1,0,1,0,11,1,346,97,30615,30074,31055,0,56,19,0,0,1,0,8,335,65,29944,30902,31515,0,11,32,671,-5,-828,-460,1,0,0,0,3
EUW1_6871115622',3,26,6,0,0,0,0,6,0,367,92,23962,28994,17653,2,27,12,2,0,1,0,2,379,92,27759,30024,26820,0,-12,0,-3797,-6,-1030,-9167,-2,0,-1,0,4
EUW1_6870316319',6,47,21,2,0,2,0,13,0,293,80,30580,26796,38149,4,33,20,0,0,3,0,6,321,84,32212,29251,37088,1,-28,-4,-1632,1,-2455,1061,2,0,-1,0,7
EUW1_6870220107',6,27,10,0,0,1,0,11,1,353,90,27645,30543,34026,2,29,10,1,0,1,0,4,346,106,26341,29777,31358,1,7,-16,1304,0,766,2668,-1,0,0,0,7
EUW1_6870159971',0,27,8,0,1,1,0,9,0,364,88,27665,29289,26813,5,22,10,2,0,1,0,5,368,96,26400,29111,28848,0,-4,-8,1265,-2,178,-2035,-2,1,0,0,4
EUW1_6883318840',1,222,9,0,0,0,0,15,1,285,71,25286,25748,34445,9,54,22,2,0,3,0,2,348,111,33140,31272,45439,0,-63,-40,-7854,-13,-5524,-10994,-2,0,-3,0,13
EUW1_6883275778',2,21,15,0,0,0,0,8,0,389,104,29284,30845,37310,6,25,16,1,0,0,0,6,345,88,28244,29011,35806,0,44,16,1040,-1,1834,1504,-1,0,0,0,2
EUW1_6883200004',2,27,2,0,0,0,0,15,0,350,77,21571,27780,23101,8,33,17,2,0,3,0,0,381,104,31045,32602,37893,0,-31,-27,-9474,-15,-4822,-14792,-2,0,-3,0,15
EUW1_6883140333',6,43,11,0,0,1,0,8,0,352,78,26953,27904,29881,1,26,14,1,0,2,0,7,352,82,29089,30337,28628,0,0,-4,-2136,-3,-2433,1253,-1,0,-1,0,1
EUW1_6883088793',2,42,11,0,0,0,0,17,0,372,68,26550,29332,35870,4,34,14,2,0,3,0,0,361,103,30254,31340,35332,0,11,-35,-3704,-3,-2008,538,-2,0,-3,0,17
EUW1_6882878371',5,55,21,1,0,0,0,6,1,343,92,30579,31906,42624,3,27,7,0,0,2,0,4,350,68,25048,27594,34878,1,-7,24,5531,14,4312,7746,1,0,-2,0,2
EUW1_6882838807',4,22,11,1,1,1,0,4,0,405,108,28673,30552,24957,2,24,5,1,0,0,0,7,368,87,23509,27351,24433,1,37,21,5164,6,3201,524,0,1,1,0,-3
EUW1_6882788052',3,24,16,1,0,1,0,9,1,367,80,30307,29597,46375,3,92,17,0,0,1,0,7,389,67,30811,30308,43514,1,-22,13,-504,-1,-711,2861,1,0,0,0,2
EUW1_6881508136',5,43,5,1,0,0,0,11,0,308,68,22612,24889,22686,0,22,13,1,0,3,0,1,382,108,29970,31073,35142,0,-74,-40,-7358,-8,-6184,-12456,0,0,-3,0,10
EUW1_6881461317',3,28,7,0,0,0,0,9,0,342,67,24230,26948,30360,5,52,25,1,0,2,0,2,402,113,34259,34815,44095,0,-60,-46,-10029,-18,-7867,-13735,-1,0,-2,0,7
EUW1_6881427042',3,24,4,0,0,0,0,9,0,374,87,23311,28510,32773,0,19,8,1,0,1,0,0,416,108,27105,32016,30704,0,-42,-21,-3794,-4,-3506,2069,-1,0,-1,0,9
EUW1_6881377349',4,26,15,1,0,1,0,3,0,420,102,30944,30729,34826,6,37,9,0,0,0,0,7,323,70,24175,26012,26540,1,97,32,6769,6,4717,8286,1,0,1,0,-4
EUW1_6881254657',4,25,8,0,0,0,0,14,0,331,86,24118,27963,23636,3,22,18,1,0,3,0,0,360,103,31134,30082,35841,1,-29,-17,-7016,-10,-2119,-12205,-1,0,-3,0,14
EUW1_6881191428',3,26,18,0,1,2,0,14,1,370,94,31624,32354,35559,5,30,13,2,0,1,0,7,357,95,28961,28286,39544,1,13,-1,2663,5,4068,-3985,-2,1,1,0,7
EUW1_6876559965',2,24,9,1,0,0,0,9,1,351,67,25964,27125,30160,2,27,19,1,0,1,0,4,362,92,29578,31534,39679,0,-11,-25,-3614,-10,-4409,-9519,0,0,-1,0,5
EUW1_6876538559',3,30,13,2,0,0,0,11,0,361,92,27450,29293,32029,5,28,11,0,0,1,0,1,343,81,27607,28321,32060,1,18,11,-157,2,972,-31,2,0,-1,0,10
EUW1_6876510401',5,29,7,0,0,0,0,7,0,343,102,24796,28336,22297,4,27,10,2,0,1,0,2,393,122,28609,32559,29849,0,-50,-20,-3813,-3,-4223,-7552,-2,0,-1,0,5
EUW1_6876511460',5,28,17,1,1,1,0,12,1,331,88,28652,31080,31678,1,94,7,1,0,0,0,5,351,91,25256,28186,28534,1,-20,-3,3396,10,2894,3144,0,1,1,0,7
EUW1_6876490886',3,31,13,1,1,0,0,7,0,395,104,28657,32467,28950,9,33,7,1,0,0,0,1,350,108,24522,29702,27426,1,45,-4,4135,6,2765,1524,0,1,0,0,6
EUW1_6875193222',3,30,14,0,0,0,0,14,0,334,72,26518,28760,31887,3,42,13,2,0,3,0,2,403,75,30063,31821,34094,0,-69,-3,-3545,1,-3061,-2207,-2,0,-3,0,12
EUW1_6882483674',5,30,14,1,0,0,0,13,1,362,91,28717,30311,29100,2,99,12,1,0,2,0,5,368,114,28771,31575,29664,0,-6,-23,-54,2,-1264,-564,0,0,-2,0,8
EUW1_6861003975',3,27,6,0,0,0,0,11,0,373,90,24266,28302,26900,4,28,17,1,0,1,0,1,394,93,31194,32016,33195,1,-21,-3,-6928,-11,-3714,-6295,-1,0,-1,0,10
EUW1_6858096730',6,45,10,0,0,0,0,10,0,340,105,25846,27111,28934,5,30,17,2,0,1,0,2,322,92,29869,29202,34428,0,18,13,-4023,-7,-2091,-5494,-2,0,-1,0,8
EUW1_6856766428',2,81,20,2,0,1,0,11,0,354,82,31761,30657,37618,3,30,11,0,0,1,0,4,292,99,25723,27350,28404,1,62,-17,6038,9,3307,9214,2,0,0,0,7
EUW1_6855516522',4,29,11,2,0,0,0,11,0,352,97,26274,29801,22116,8,29,10,0,0,2,0,3,361,76,27518,29818,33600,1,-9,21,-1244,1,-17,-11484,2,0,-2,0,8
EUW1_6855497052',1,21,7,1,0,1,0,9,1,327,88,24852,26476,30630,5,30,14,0,0,2,0,3,399,67,29035,31171,29347,0,-72,21,-4183,-7,-4695,1283,1,0,-1,0,6
EUW1_6742537667',2,30,8,0,1,0,0,10,0,336,92,24590,28801,30949,5,25,12,2,0,1,0,3,400,84,28812,30599,28569,0,-64,8,-4222,-4,-1798,2380,-2,1,-1,0,7
EUW1_6742473112',3,41,14,0,1,0,0,10,0,411,74,30000,30776,33948,3,262,14,2,0,1,0,4,392,60,28966,29975,34357,1,19,14,1034,0,801,-409,-2,1,-1,0,6
EUW1_6742370111',6,28,18,1,2,2,0,8,1,371,84,31394,31318,34687,2,24,9,0,0,0,0,8,361,74,25287,28036,29904,1,10,10,6107,9,3282,4783,1,2,2,0,0
EUW1_6742244892',4,24,11,0,0,0,0,11,0,367,90,26622,31405,25203,2,31,6,2,1,1,0,1,334,120,24843,28173,25411,1,33,-30,1779,5,3232,-208,-2,-1,-1,0,10
EUW1_6742189786',1,24,14,2,1,0,0,8,0,362,80,28266,29622,37065,3,68,20,0,0,1,0,3,369,91,31948,33612,42486,0,-7,-11,-3682,-6,-3990,-5421,2,1,-1,0,5
EUW1_6742152725',1,35,13,1,0,1,0,18,0,297,80,28511,28742,32817,3,26,29,1,1,5,0,5,341,84,37350,31366,46046,0,-44,-4,-8839,-16,-2624,-13229,0,-1,-4,0,13
EUW1_6742100892',2,25,10,1,1,1,0,5,1,379,112,28079,30316,29039,5,28,9,0,0,0,0,5,312,80,24602,27306,21756,1,67,32,3477,1,3010,7283,1,1,1,0,0
EUW1_6741378337',3,24,7,0,0,0,0,9,0,319,79,23965,27342,30533,2,93,15,1,1,1,0,4,317,96,27826,31229,30624,0,2,-17,-3861,-8,-3887,-91,-1,-1,-1,0,5
EUW1_6741295453',6,22,10,0,0,0,0,9,1,401,100,27611,29211,29606,7,30,12,1,1,0,0,2,373,87,27337,31224,24592,1,28,13,274,-2,-2013,5014,-1,-1,0,0,7
EUW1_6741226827',4,54,3,1,0,1,0,11,1,342,92,23763,26594,23550,3,44,10,1,1,2,0,1,393,84,28856,31561,30608,0,-51,8,-5093,-7,-4967,-7058,0,-1,-1,0,10
EUW1_6741146069',3,58,6,2,0,0,0,9,1,391,100,24590,29022,21756,4,56,13,0,1,0,0,3,354,88,27005,28749,25479,0,37,12,-2415,-7,273,-3723,2,-1,0,0,6
EUW1_6741062837',4,17,15,1,0,1,0,10,0,357,111,29064,31826,26491,4,26,15,0,1,0,0,4,377,91,28973,31306,33217,0,-20,20,91,0,520,-6726,1,-1,1,0,6
EUW1_6740995917',1,25,17,1,1,4,0,3,1,374,114,33470,30889,29670,0,102,7,0,0,1,0,13,233,65,22586,20883,27838,1,141,49,10884,10,10006,1832,1,1,3,0,-10
EUW1_6883000520',3,26,9,1,0,0,0,6,0,349,82,25361,29137,27871,5,29,7,1,0,1,0,3,364,91,25249,28878,26653,1,-15,-9,112,2,259,1218,0,0,-1,0,3
EUW1_6882907600',5,175,14,1,0,0,0,8,1,367,106,28714,31384,33520,5,27,12,1,0,0,0,1,417,105,29663,31263,31399,0,-50,1,-949,2,121,2121,0,0,0,0,7
EUW1_6866307680',5,33,7,2,0,1,0,12,0,365,102,26502,28964,26984,3,66,10,0,0,1,0,3,402,102,28385,30855,29500,0,-37,0,-1883,-3,-1891,-2516,2,0,0,0,9
EUW1_6866274426',6,79,10,0,0,0,0,10,1,329,90,26173,28483,24050,3,38,15,2,0,1,0,2,380,97,29349,31695,33985,0,-51,-7,-3176,-5,-3212,-9935,-2,0,-1,0,8
EUW1_6866252231',4,27,9,0,0,2,0,9,0,376,103,28902,30361,27063,7,41,11,1,0,1,0,4,365,79,26816,27541,27601,1,11,24,2086,-2,2820,-538,-1,0,1,0,5
EUW1_6866216038',8,34,8,0,1,1,0,6,1,402,116,26745,32124,19285,3,18,0,1,0,0,0,3,417,65,22070,28441,11718,0,-15,51,4675,8,3683,7567,-1,1,1,0,3
EUW1_6864714426',3,27,9,0,0,0,0,10,0,321,73,25229,26425,34399,2,25,19,2,0,1,0,1,385,93,30445,30396,31852,0,-64,-20,-5216,-10,-3971,2547,-2,0,-1,0,9
EUW1_6864665974',4,31,13,1,0,2,0,8,1,409,109,28536,32443,33124,2,39,2,1,0,1,0,4,404,82,23565,27532,28153,0,5,27,4971,11,4911,4971,0,0,1,0,4
EUW1_6864644385',5,29,13,1,0,0,0,9,0,349,87,27371,29693,29686,2,120,7,0,0,2,0,3,406,98,26771,30128,27161,1,-57,-11,600,6,-435,2525,1,0,-2,0,6
EUW1_6863319991',4,28,13,1,0,3,0,5,0,381,88,29700,29221,37359,4,93,12,0,0,0,0,11,300,86,25915,27939,30462,1,81,2,3785,1,1282,6897,1,0,3,0,-6
EUW1_6863294161',0,22,21,1,0,2,0,6,1,366,105,33140,30037,37432,6,31,10,1,0,0,0,8,290,58,25441,26080,29503,1,76,47,7699,11,3957,7929,0,0,2,0,-2
EUW1_6863291808',2,27,8,1,0,0,0,10,0,368,84,26456,28837,30963,6,32,11,0,1,2,0,1,378,116,28050,32644,28902,0,-10,-32,-1594,-3,-3807,2061,1,-1,-2,0,9
EUW1_6862092537',3,25,10,1,1,1,0,9,1,355,108,28278,29241,33066,6,35,11,1,0,2,0,5,365,84,28388,32669,29280,0,-10,24,-110,-1,-3428,3786,0,1,-1,0,4
EUW1_6862062269',2,20,4,1,0,0,0,6,0,344,84,22945,28023,28911,8,50,14,1,0,1,0,3,359,76,28000,30644,38407,1,-15,8,-5055,-10,-2621,-9496,0,0,-1,0,3
EUW1_6856816557',2,23,9,0,0,0,0,12,0,317,82,25449,27443,27038,5,33,20,2,0,2,0,1,359,70,31432,30225,38233,0,-42,12,-5983,-11,-2782,-11195,-2,0,-2,0,11
EUW1_6856787017',5,28,14,2,0,2,0,6,1,377,88,29495,30776,41471,2,23,13,0,0,0,0,8,319,84,26998,28631,30163,1,58,4,2497,1,2145,11308,2,0,2,0,-2
EUW1_6856759926',5,30,18,2,0,0,0,9,1,337,97,29078,28896,35147,4,30,11,0,0,0,0,2,300,87,25578,25860,28902,1,37,10,3500,7,3036,6245,2,0,0,0,7
EUW1_6855580100',1,26,4,1,1,1,0,14,0,369,76,24467,27895,23761,5,28,12,1,0,1,0,1,398,79,28401,30241,27067,0,-29,-3,-3934,-8,-2346,-3306,0,1,0,0,13
EUW1_6855560292',6,67,14,2,1,1,0,7,1,382,78,28913,31851,34503,2,57,4,0,0,0,0,1,408,114,24816,29941,21682,1,-26,-36,4097,10,1910,12821,2,1,1,0,6
EUW1_6878339751',1,24,13,0,0,1,0,7,1,390,72,28584,31338,28218,5,28,10,2,0,0,0,7,379,124,28068,33395,36895,0,11,-52,516,3,-2057,-8677,-2,0,1,0,0
EUW1_6878245511',2,45,14,0,0,2,0,8,0,320,75,28785,28207,32573,3,30,20,2,0,1,0,6,349,83,29331,29973,41353,1,-29,-8,-546,-6,-1766,-8780,-2,0,1,0,2
EUW1_6878123607',4,23,12,0,0,0,0,14,0,367,90,26827,28094,27944,2,26,16,2,0,2,0,1,350,103,32214,30611,30917,0,17,-13,-5387,-4,-2517,-2973,-2,0,-2,0,13
EUW1_6878085327',3,23,14,1,0,1,0,15,0,332,75,28127,27908,31921,4,18,18,1,0,2,0,7,356,96,31575,30670,32224,0,-24,-21,-3448,-4,-2762,-303,0,0,-1,0,8
EUW1_6877774648',0,23,12,0,0,0,0,4,1,311,116,26814,29120,30119,3,40,15,1,0,1,0,6,317,80,27406,28054,39537,1,-6,36,-592,-3,1066,-9418,-1,0,-1,0,-2
EUW1_6877727746',3,28,21,0,0,0,0,7,1,314,66,29645,27159,43772,4,27,19,0,0,1,0,2,312,84,30341,29265,46476,0,2,-18,-696,2,-2106,-2704,0,0,-1,0,5
EUW1_6877563962',4,58,12,0,1,0,0,8,1,345,95,27705,30084,26836,4,61,11,2,0,1,0,4,378,74,27154,27970,31348,0,-33,21,551,1,2114,-4512,-2,1,-1,0,4
EUW1_6877518930',4,38,26,1,1,3,0,10,1,370,125,35941,32704,46718,0,88,11,0,0,2,0,11,309,78,27102,29648,29416,1,61,47,8839,15,3056,17302,1,1,1,0,-1
EUW1_6877451325',2,26,3,0,0,1,0,6,0,416,102,26602,29060,18301,4,30,15,2,1,0,0,4,365,114,28948,31552,31304,0,51,-12,-2346,-12,-2492,-13003,-2,-1,1,0,2
EUW1_6877327736',2,17,6,0,0,0,0,16,0,310,80,23204,24481,21338,6,29,21,1,0,7,0,3,421,127,37956,34231,36512,0,-111,-47,-14752,-15,-9750,-15174,-1,0,-7,0,13
EUW1_6877210276',1,22,5,0,1,0,0,9,0,372,82,24369,28391,26685,2,27,10,2,0,1,0,3,415,106,26565,33135,35058,1,-43,-24,-2196,-5,-4744,-8373,-2,1,-1,0,6
EUW1_6877155830',7,31,23,2,0,1,0,7,0,369,100,33907,31420,40559,5,27,13,0,0,1,0,9,321,74,27358,27756,32380,0,48,26,6549,10,3664,8179,2,0,0,0,-2
EUW1_6877000713',2,25,16,0,0,1,0,8,0,363,96,28979,31287,47510,4,117,15,2,0,0,0,3,337,75,27961,29064,33182,1,26,21,1018,1,2223,14328,-2,0,1,0,5
EUW1_6876952796',4,32,16,0,0,0,0,15,0,326,95,28530,28587,33398,3,27,15,1,0,2,0,2,385,109,32701,30393,30697,0,-59,-14,-4171,1,-1806,2701,-1,0,-2,0,13
EUW1_6876837762',1,21,18,0,0,2,0,6,0,377,100,31956,31480,38606,4,24,14,2,0,0,0,7,340,72,26367,28163,30048,1,37,28,5589,4,3317,8558,-2,0,2,0,-1
EUW1_6876785083',4,26,18,1,0,1,0,7,1,383,72,29859,30731,40925,3,37,7,1,0,0,0,7,359,112,24858,28367,29839,1,24,-40,5001,11,2364,11086,0,0,1,0,0
EUW1_6876706351',7,33,18,2,0,1,0,9,1,345,98,31276,29181,35478,0,150,14,0,0,2,0,6,341,88,28640,27734,29381,1,4,10,2636,4,1447,6097,2,0,-1,0,3
EUW1_6876664455',3,28,11,0,0,1,0,8,0,345,65,26442,26794,33028,3,92,19,0,0,2,0,6,367,73,31138,29692,41539,0,-22,-8,-4696,-8,-2898,-8511,0,0,-1,0,2
EUW1_6878704349',7,25,15,1,0,1,0,12,0,346,66,30698,30716,34391,4,22,9,0,0,2,0,9,354,102,25252,29204,32745,1,-8,-36,5446,6,1512,1646,1,0,-1,0,3
EUW1_6878657004',2,27,14,0,0,1,0,9,1,296,63,28198,25090,37004,2,48,26,2,0,2,0,10,341,96,33884,31604,48481,0,-45,-33,-5686,-12,-6514,-11477,-2,0,-1,0,-1
EUW1_6878459268',2,55,9,1,0,1,0,9,0,401,67,26917,28801,31255,2,23,13,0,0,2,0,5,378,92,29446,31522,37646,0,23,-25,-2529,-4,-2721,-6391,1,0,-1,0,4
EUW1_6878398111',0,18,9,2,0,0,0,9,1,358,58,24810,27592,24519,3,27,9,0,0,1,0,1,326,120,26742,28664,26987,1,32,-62,-1932,0,-1072,-2468,2,0,-1,0,8
EUW1_6878355956',2,32,27,0,0,2,0,11,1,373,77,34421,33085,52087,1,38,10,2,0,2,0,6,332,103,28025,28440,38761,1,41,-26,6396,17,4645,13326,-2,0,0,0,5
EUW1_6878310161',3,32,14,0,0,1,0,12,1,379,67,28768,31834,33605,4,155,15,1,0,1,0,6,354,108,28927,31553,39220,0,25,-41,-159,-1,281,-5615,-1,0,0,0,6
EUW1_6864873831',4,22,13,0,0,0,0,16,0,312,100,27767,28862,29066,2,24,16,2,0,2,0,3,349,93,29931,29818,31918,0,-37,7,-2164,-3,-956,-2852,-2,0,-2,0,13
EUW1_6864837780',3,29,11,0,0,0,0,10,1,357,91,27734,29876,28011,3,21,15,2,0,2,0,4,385,80,28258,29960,34894,0,-28,11,-524,-4,-84,-6883,-2,0,-2,0,6
EUW1_6864806895',4,26,19,0,0,0,0,10,0,334,108,30007,29453,36580,7,29,17,1,0,2,0,3,338,56,30437,29081,40093,0,-4,52,-430,2,372,-3513,-1,0,-2,0,7
EUW1_6864766170',6,20,6,0,0,1,0,12,0,352,95,26729,29933,26201,2,26,10,1,0,1,0,5,382,94,27293,33228,38904,0,-30,1,-564,-4,-3295,-12703,-1,0,0,0,7
EUW1_6864743391',4,23,9,0,0,1,0,11,0,298,101,25616,24451,30888,7,33,24,2,0,4,0,4,334,110,31813,31498,46918,0,-36,-9,-6197,-15,-7047,-16030,-2,0,-3,0,7
EUW1_6864720542',11,34,13,0,0,0,0,8,0,336,71,27390,28435,36376,4,27,11,1,0,0,0,2,364,96,27318,30354,32359,0,-28,-25,72,2,-1919,4017,-1,0,0,0,6
EUW1_6864676337',4,29,8,0,0,1,0,16,1,366,65,25649,28441,32293,6,302,21,2,0,2,0,3,374,100,30639,33534,35213,1,-8,-35,-4990,-13,-5093,-2920,-2,0,-1,0,13
EUW1_6864652859',5,23,19,1,0,4,0,11,1,361,82,33893,30042,34415,2,24,11,0,0,0,0,5,334,70,26582,27872,28637,1,27,12,7311,8,2170,5778,1,0,4,0,6
EUW1_6864617862',2,27,13,1,0,0,0,12,1,361,98,27664,31274,32473,2,21,8,0,0,1,0,2,358,66,25273,27323,32287,1,3,32,2391,5,3951,186,1,0,-1,0,10
EUW1_6864602825',2,27,8,0,0,1,0,10,0,351,75,25799,30266,26266,4,28,10,2,0,1,0,6,340,92,26310,29581,30396,1,11,-17,-511,-2,685,-4130,-2,0,0,0,4
EUW1_6859434528',5,23,13,2,0,0,0,15,1,316,80,26242,27123,25499,4,29,10,0,0,4,0,1,366,78,28812,27737,26850,1,-50,2,-2570,3,-614,-1351,2,0,-4,0,14
EUW1_6879686322',4,23,19,1,0,1,0,13,0,294,82,29550,28025,40013,5,28,18,1,1,1,0,1,324,101,29795,30302,39074,0,-30,-19,-245,1,-2277,939,0,-1,0,0,12
EUW1_6879650605',3,34,11,0,0,0,0,11,0,348,88,27184,30688,30457,3,88,9,2,0,0,0,4,387,108,26979,29426,33494,1,-39,-20,205,2,1262,-3037,-2,0,0,0,7
EUW1_6879610582',5,28,13,1,1,1,0,9,1,358,112,28754,31038,34497,3,293,8,1,0,1,0,3,385,84,26525,29778,31225,1,-27,28,2229,5,1260,3272,0,1,0,0,6
EUW1_6879557419',6,26,17,0,0,1,0,9,0,339,108,30311,31178,39537,2,29,16,2,1,0,0,7,341,79,27998,31193,32637,1,-2,29,2313,1,-15,6900,-2,-1,1,0,2
EUW1_6875723473',6,25,18,1,0,1,0,12,1,316,74,30684,28411,41971,1,46,15,0,0,2,0,8,306,92,27550,27325,40377,1,10,-18,3134,3,1086,1594,1,0,-1,0,4
EUW1_6859169832',3,49,25,0,0,3,0,10,1,362,90,36096,33122,46734,3,27,17,1,0,1,0,9,311,83,30434,28136,38751,1,51,7,5662,8,4986,7983,-1,0,2,0,1
EUW1_6859107372',3,27,18,1,1,1,0,11,1,316,84,29383,29142,40819,0,32,14,0,0,1,0,3,331,87,29560,28861,36354,1,-15,-3,-177,4,281,4465,1,1,0,0,8
EUW1_6858209586',2,58,9,1,0,0,0,7,0,304,84,23980,27924,30441,6,63,12,0,0,0,0,3,362,76,26487,27625,38893,1,-58,8,-2507,-3,299,-8452,1,0,0,0,4
EUW1_6858154406',2,25,13,0,0,0,0,9,1,328,64,25868,27989,40328,5,29,25,1,0,2,0,0,374,106,33623,35012,47772,0,-46,-42,-7755,-12,-7023,-7444,-1,0,-2,0,9
EUW1_6856786173',1,27,13,0,0,0,0,10,0,335,76,28063,29974,34848,1,23,14,2,0,1,0,4,331,98,28357,30009,33507,1,4,-22,-294,-1,-35,1341,-2,0,-1,0,6
EUW1_6829624369',1,53,9,1,0,0,0,13,1,358,100,26501,30142,30032,2,25,15,1,1,1,0,3,402,81,30107,32019,36313,1,-44,19,-3606,-6,-1877,-6281,0,-1,-1,0,10
EUW1_6829586572',2,33,7,0,0,0,0,11,0,316,81,25067,28353,26749,4,23,17,1,0,2,0,1,357,108,30609,31491,37314,0,-41,-27,-5542,-10,-3138,-10565,-1,0,-2,0,10
EUW1_6874266633',4,29,13,1,1,1,0,12,1,390,79,30195,30198,32846,6,31,16,1,0,4,0,7,320,90,30080,29543,39165,0,70,-11,115,-3,655,-6319,0,1,-3,0,5
EUW1_6874228491',8,62,2,0,0,0,0,10,0,367,75,22762,27086,14275,7,208,6,2,0,1,0,0,424,110,28258,30623,18363,0,-57,-35,-5496,-4,-3537,-4088,-2,0,-1,0,10
EUW1_6874176764',2,27,8,2,0,0,0,7,1,385,80,25207,29224,25835,8,57,12,0,0,1,0,3,395,83,27817,29928,31639,0,-10,-3,-2610,-4,-704,-5804,2,0,-1,0,4
EUW1_6874136638',5,55,10,0,0,0,0,9,1,337,72,25390,28700,25260,5,31,12,1,0,1,0,1,415,87,30054,30683,26888,0,-78,-15,-4664,-2,-1983,-1628,-1,0,-1,0,8
EUW1_6863904422',8,37,19,1,0,0,0,9,1,329,78,30782,31116,42887,3,43,15,1,0,1,0,2,324,82,28331,27176,39011,1,5,-4,2451,4,3940,3876,0,0,-1,0,7
EUW1_6863877682',2,21,10,0,0,0,0,15,0,303,55,25116,27215,27601,3,26,29,0,0,5,0,1,378,118,37612,36196,47372,0,-75,-63,-12496,-19,-8981,-19771,0,0,-5,0,14
EUW1_6863816784',5,30,13,0,0,1,0,7,1,357,92,28717,30220,36838,7,26,13,2,0,1,0,4,327,96,27214,29074,30560,1,30,-4,1503,0,1146,6278,-2,0,0,0,3
EUW1_6856999004',4,32,11,0,0,0,0,13,0,332,100,26416,27710,29887,9,46,11,2,0,1,0,3,342,84,28652,27161,31765,0,-10,16,-2236,0,549,-1878,-2,0,-1,0,10
EUW1_6856901382',7,44,9,0,0,0,0,12,1,335,63,24794,26859,33335,8,35,18,1,0,1,0,1,333,90,29372,30392,37672,0,2,-27,-4578,-9,-3533,-4337,-1,0,-1,0,11
EUW1_6856874424',3,27,11,0,0,1,0,8,0,344,116,27791,30210,39194,3,28,17,1,0,0,0,1,362,96,30220,30199,40062,0,-18,20,-2429,-6,11,-868,-1,0,1,0,7
EUW1_6856848846',4,28,4,1,0,1,0,5,0,387,92,25362,28565,21390,6,33,12,1,0,1,0,3,366,120,28204,31409,27392,1,21,-28,-2842,-8,-2844,-6002,0,0,0,0,2
EUW1_6883100904',5,75,10,0,0,1,0,9,1,351,104,27341,28947,29919,3,26,10,2,0,1,0,3,396,96,28107,29680,30189,1,-45,8,-766,0,-733,-270,-2,0,0,0,6
EUW1_6883046775',2,21,11,1,0,1,0,11,0,360,66,26377,28808,36461,3,28,18,0,0,0,0,2,362,114,29934,33929,44513,0,-2,-48,-3557,-7,-5121,-8052,1,0,1,0,9
EUW1_6882994188',7,42,15,0,0,0,0,5,1,381,107,29425,31483,37649,5,28,11,2,0,0,0,5,404,92,27187,28992,29153,1,-23,15,2238,4,2491,8496,-2,0,0,0,0
EUW1_6882950587',4,27,9,0,0,0,0,10,0,355,106,26085,28235,24407,4,45,18,2,0,3,0,4,354,86,32128,31179,40071,0,1,20,-6043,-9,-2944,-15664,-2,0,-3,0,6
EUW1_6882889412',1,46,10,0,1,0,0,7,0,353,111,26466,29723,24408,4,28,13,2,0,0,0,1,379,81,27041,29401,30720,0,-26,30,-575,-3,322,-6312,-2,1,0,0,6
EUW1_6882847715',5,26,13,1,0,1,0,10,1,371,107,29136,30422,31460,3,29,14,1,1,1,0,5,373,92,28687,31444,40400,1,-2,15,449,-1,-1022,-8940,0,-1,0,0,5
EUW1_6882750460',6,29,8,1,0,0,0,4,1,363,80,25415,27838,32321,7,29,10,0,0,0,0,1,357,104,26956,30770,30264,0,6,-24,-1541,-2,-2932,2057,1,0,0,0,3
EUW1_6882698390',4,195,5,0,0,0,0,12,0,334,114,23334,28891,21101,7,31,13,2,1,1,0,1,417,78,29500,32778,32843,0,-83,36,-6166,-8,-3887,-11742,-2,-1,-1,0,11
EUW1_6882587060',6,30,17,1,0,2,0,10,0,338,96,29648,30638,34181,2,25,16,1,0,1,0,4,376,80,29352,29651,35844,1,-38,16,296,1,987,-1663,0,0,1,0,6
EUW1_6882534095',4,29,11,0,0,0,0,9,1,357,60,27225,28822,29852,3,25,17,1,0,2,0,0,367,116,30804,31625,31303,0,-10,-56,-3579,-6,-2803,-1451,-1,0,-2,0,9
EUW1_6881923347',2,28,9,1,0,0,0,8,1,362,101,25632,30207,29247,3,23,11,0,0,1,0,2,405,88,28888,32292,33364,0,-43,13,-3256,-2,-2085,-4117,1,0,-1,0,6
EUW1_6881850794',6,32,10,2,1,1,0,7,0,377,84,26556,29482,25299,2,28,10,0,0,1,0,5,375,106,27851,28689,34675,1,2,-22,-1295,0,793,-9376,2,1,0,0,2
EUW1_6881775845',2,27,7,0,0,0,0,6,0,403,108,25750,30320,23133,1,26,7,1,0,0,0,1,411,72,26285,30275,35454,0,-8,36,-535,0,45,-12321,-1,0,0,0,5
EUW1_6881703246',3,38,9,0,0,2,0,11,1,363,98,27054,29724,28681,5,98,10,1,0,1,0,2,387,81,26810,30170,27464,0,-24,17,244,-1,-446,1217,-1,0,1,0,9
EUW1_6881314307',7,30,9,1,0,1,0,4,0,388,86,26530,28994,26958,6,29,7,1,0,0,0,3,336,80,23526,26718,18217,1,52,6,3004,2,2276,8741,0,0,1,0,1
EUW1_6881277051',6,41,16,1,0,0,0,14,1,363,72,28734,29586,33436,5,26,23,1,1,2,0,0,415,104,35296,33028,44072,0,-52,-32,-6562,-7,-3442,-10636,0,-1,-2,0,14
EUW1_6880265013',4,21,16,2,0,2,0,4,0,418,91,31957,32774,38861,2,54,9,0,0,0,0,11,298,85,25143,27644,27732,0,120,6,6814,7,5130,11129,2,0,2,0,-7
EUW1_6875921009',6,32,16,1,0,0,0,11,1,286,87,27450,28631,35149,4,30,12,1,1,1,0,2,399,91,28952,29741,33210,0,-113,-4,-1502,4,-1110,1939,0,-1,-1,0,9
EUW1_6875864180',2,23,9,0,1,0,0,13,0,298,86,24518,26060,32695,3,26,13,1,0,2,0,1,349,95,28419,30393,31022,0,-51,-9,-3901,-4,-4333,1673,-1,1,-2,0,12
EUW1_6875789348',1,24,9,1,0,0,0,9,0,346,81,26201,29301,28637,8,31,15,1,0,1,0,2,348,98,27702,29486,35768,1,-2,-17,-1501,-6,-185,-7131,0,0,-1,0,7
EUW1_6875678571',5,26,5,0,1,1,0,7,0,368,100,24429,28637,26384,4,25,13,1,0,1,0,2,395,88,28508,30985,28334,0,-27,12,-4079,-8,-2348,-1950,-1,1,0,0,5
EUW1_6875646678',3,67,25,0,0,2,0,9,1,358,90,34312,31931,44988,7,320,10,1,0,1,0,8,312,66,23418,25449,27484,1,46,24,10894,15,6482,17504,-1,0,1,0,1
EUW1_6874617322',3,81,14,0,0,1,0,13,0,352,78,27977,29561,35633,3,62,16,1,0,2,0,6,393,76,31462,30679,35373,1,-41,2,-3485,-2,-1118,260,-1,0,-1,0,7
EUW1_6874569553',3,22,17,2,0,1,0,12,1,335,102,30246,30768,39334,2,39,16,0,0,1,0,4,366,64,29561,28073,35669,1,-31,38,685,1,2695,3665,2,0,0,0,8
EUW1_6874498319',5,26,12,0,0,0,0,8,0,389,86,28296,30465,32965,7,39,16,2,0,1,0,5,381,74,28088,30729,30705,0,8,12,208,-4,-264,2260,-2,0,-1,0,3
EUW1_6874374768',3,40,4,1,0,0,0,7,0,370,72,22590,28018,23038,10,45,9,1,1,0,0,1,393,104,27542,30895,30754,0,-23,-32,-4952,-5,-2877,-7716,0,-1,0,0,6
EUW1_6874336476',0,21,5,0,0,0,0,11,0,359,103,24112,28451,25254,1,21,18,2,0,2,0,3,377,94,32061,32216,35394,0,-18,9,-7949,-13,-3765,-10140,-2,0,-2,0,8
EUW1_6874274956',5,29,11,1,1,0,0,12,0,347,103,26682,28363,32618,4,22,13,0,0,0,0,2,358,68,26661,28792,30643,1,-11,35,21,-2,-429,1975,1,1,0,0,10
EUW1_6872882284',3,24,7,0,0,1,0,9,0,415,105,27534,29663,20247,3,26,17,1,0,1,0,0,390,102,29554,32446,32670,0,25,3,-2020,-10,-2783,-12423,-1,0,0,0,9
EUW1_6871821713',3,50,5,0,0,2,0,10,0,379,69,25551,28541,26846,6,98,14,1,0,2,0,6,341,82,28587,27754,27733,0,38,-13,-3036,-9,787,-887,-1,0,0,0,4
EUW1_6871571418',6,31,6,0,0,1,0,10,1,347,90,25432,27856,22286,1,29,13,2,0,2,0,2,415,118,30798,32729,28281,0,-68,-28,-5366,-7,-4873,-5995,-2,0,-1,0,8
EUW1_6871538653',5,31,7,1,0,1,0,11,0,369,115,26270,32257,27321,1,26,12,1,0,3,0,3,386,76,28632,31422,35623,1,-17,39,-2362,-5,835,-8302,0,0,-2,0,8
EUW1_6871473613',3,37,10,0,0,4,0,7,1,362,92,29087,29588,27764,2,26,10,2,0,0,0,9,359,80,25099,29332,29354,1,3,12,3988,0,256,-1590,-2,0,4,0,-2
EUW1_6872613548',3,27,19,1,0,2,0,6,1,331,97,30879,29935,33736,4,37,9,1,0,0,0,8,331,94,25682,27812,25692,1,0,3,5197,10,2123,8044,0,0,2,0,-2
EUW1_6871211633',2,24,19,1,0,1,0,3,1,325,105,28966,29312,38786,4,24,16,1,1,1,0,3,311,78,28118,31244,32024,1,14,27,848,3,-1932,6762,0,-1,0,0,0
EUW1_6869654750',3,29,7,0,0,0,0,7,0,359,75,23766,27543,23300,5,27,9,2,0,1,0,2,358,91,25133,26292,27972,0,1,-16,-1367,-2,1251,-4672,-2,0,-1,0,5
EUW1_6856761858',2,36,4,1,0,0,0,19,0,324,89,22877,25941,23894,6,32,17,1,1,3,0,0,323,85,30486,30289,34099,0,1,4,-7609,-13,-4348,-10205,0,-1,-3,0,19
EUW1_6856739879',6,30,17,1,0,1,0,8,0,341,73,30198,28368,31826,4,32,16,1,1,1,0,1,325,80,28143,26755,38967,0,16,-7,2055,1,1613,-7141,0,-1,0,0,7
EUW1_6856722451',2,27,13,1,0,1,0,7,1,376,100,29833,29939,37801,3,102,12,1,0,1,0,7,311,99,25837,27509,26734,1,65,1,3996,1,2430,11067,0,0,0,0,0
EUW1_6856721659',2,27,10,0,0,0,0,8,0,298,82,25178,28442,23358,5,28,13,1,0,0,0,1,371,99,28293,30857,30262,0,-73,-17,-3115,-3,-2415,-6904,-1,0,0,0,7
EUW1_6856074227',0,35,17,2,0,1,0,10,1,323,88,30473,29070,41125,4,27,7,0,0,2,0,5,330,85,26033,27458,33994,1,-7,3,4440,10,1612,7131,2,0,-1,0,5
EUW1_6855997288',5,29,8,0,0,0,0,8,0,389,84,26470,29777,29323,4,24,14,1,0,2,0,4,364,98,28812,31296,40631,0,25,-14,-2342,-6,-1519,-11308,-1,0,-2,0,4
EUW1_6855926131',2,33,13,1,0,0,0,11,1,392,98,30071,30983,37168,6,30,15,1,1,4,0,5,329,74,28885,31654,24644,1,63,24,1186,-2,-671,12524,0,-1,-4,0,6
EUW1_6855873221',4,30,6,0,0,0,0,4,0,387,70,24605,28506,23679,3,127,5,1,0,0,0,1,371,87,24057,28506,25877,0,16,-17,548,1,0,-2198,-1,0,0,0,3
EUW1_6855529534',4,27,11,0,0,2,0,8,0,404,116,29139,32759,25988,3,47,8,1,0,0,0,6,346,70,24719,27928,20460,1,58,46,4420,3,4831,5528,-1,0,2,0,2
EUW1_6855492194',1,33,11,0,0,1,0,9,1,408,141,28715,33488,30094,4,27,1,1,0,1,0,3,395,94,23372,27893,17030,1,13,47,5343,10,5595,13064,-1,0,0,0,6
EUW1_6855482525',6,33,17,1,0,0,0,6,1,304,104,28813,28941,34655,4,32,17,0,0,1,0,2,351,96,30650,31440,39638,1,-47,8,-1837,0,-2499,-4983,1,0,-1,0,4
EUW1_6855462125',4,31,18,0,0,1,0,11,1,303,125,31431,30179,38130,4,25,21,2,0,1,0,6,282,72,29295,27489,40428,1,21,53,2136,-3,2690,-2298,-2,0,0,0,5
EUW1_6846215520',2,24,8,1,0,2,0,12,0,393,105,28771,30501,28575,3,22,15,1,0,1,0,4,366,98,29669,31598,33956,0,27,7,-898,-7,-1097,-5381,0,0,1,0,8
EUW1_6838368913',5,20,18,0,0,1,0,4,1,369,80,31155,30569,38303,5,31,15,1,0,0,0,7,334,80,28297,29056,36043,0,35,0,2858,3,1513,2260,-1,0,1,0,-3
EUW1_6838311976',2,36,6,0,0,0,0,3,0,376,107,25146,31052,30623,3,25,7,2,0,0,0,2,347,120,24665,30375,32923,0,29,-13,481,-1,677,-2300,-2,0,0,0,1
EUW1_6836980267',2,46,17,0,0,1,0,13,1,297,79,28707,27933,35886,4,27,19,2,0,2,0,3,373,84,32923,29740,43868,0,-76,-5,-4216,-2,-1807,-7982,-2,0,-1,0,10
EUW1_6826885206',1,25,10,0,0,0,0,11,0,332,88,25881,28221,29223,4,96,18,2,1,2,0,0,394,84,31034,33134,42841,0,-62,4,-5153,-8,-4913,-13618,-2,-1,-2,0,11
EUW1_6807067981',1,27,6,0,0,0,0,13,0,378,76,25371,31338,23647,5,68,13,2,0,2,0,0,425,109,31289,33445,30601,0,-47,-33,-5918,-7,-2107,-6954,-2,0,-2,0,13
EUW1_6868055979',3,26,14,2,0,0,0,6,0,348,88,27361,30903,33343,4,24,8,0,0,0,0,5,389,73,26047,28381,35525,1,-41,15,1314,6,2522,-2182,2,0,0,0,1
EUW1_6867989905',4,26,5,0,0,0,0,12,0,347,84,23984,27053,20434,3,41,19,2,0,1,0,2,377,82,31042,31235,34268,1,-30,2,-7058,-14,-4182,-13834,-2,0,-1,0,10
EUW1_6864178664',1,27,9,1,0,1,0,13,0,290,129,26010,27050,30176,4,31,16,1,1,1,0,3,324,77,29185,27570,31019,0,-34,52,-3175,-7,-520,-843,0,-1,0,0,10
EUW1_6863936919',3,22,15,2,0,3,0,7,0,393,108,30411,31354,33694,3,150,7,0,0,0,0,4,354,87,24549,28384,36059,1,39,21,5862,8,2970,-2365,2,0,3,0,3
EUW1_6859212274',0,44,15,1,0,1,0,3,1,392,130,30516,33084,37514,4,28,8,1,1,0,0,4,357,71,24525,27878,21641,1,35,59,5991,7,5206,15873,0,-1,1,0,-1
EUW1_6859115367',1,35,10,0,0,1,0,12,1,351,84,27066,28746,33654,3,46,14,2,0,1,0,5,371,92,28773,31698,33107,0,-20,-8,-1707,-4,-2952,547,-2,0,0,0,7
EUW1_6859064900',4,46,14,0,0,1,0,9,0,361,76,27420,30337,38261,4,41,8,1,1,1,0,1,327,90,25384,27898,25979,1,34,-14,2036,6,2439,12282,-1,-1,0,0,8
EUW1_6858313661',3,24,8,0,0,0,0,10,0,359,90,25619,29250,22995,6,29,16,2,0,1,0,3,379,108,30044,30775,38403,0,-20,-18,-4425,-8,-1525,-15408,-2,0,-1,0,7
EUW1_6858270828',1,25,14,1,0,0,0,14,0,283,84,27554,28190,36064,3,31,26,0,0,3,0,0,379,77,35059,32808,43156,0,-96,7,-7505,-12,-4618,-7092,1,0,-3,0,14
EUW1_6857929719',0,19,9,1,0,0,0,10,0,350,95,25486,30113,33513,0,31,13,1,0,1,0,4,359,79,27661,30438,38431,0,-9,16,-2175,-4,-325,-4918,0,0,-1,0,6
EUW1_6857862707',7,34,16,0,0,1,0,9,0,357,73,29426,29470,32337,2,30,17,2,0,1,0,4,346,105,29995,30763,33466,0,11,-32,-569,-1,-1293,-1129,-2,0,0,0,5
EUW1_6857834939',0,24,17,2,0,1,0,6,1,400,109,31646,33282,38599,2,22,4,0,0,1,0,7,362,81,23137,29221,18593,1,38,28,8509,13,4061,20006,2,0,0,0,-1
EUW1_6857764064',1,24,22,0,0,2,0,9,1,331,97,32741,29024,42371,8,35,18,2,0,1,0,3,344,54,29969,27340,35971,0,-13,43,2772,4,1684,6400,-2,0,1,0,6
EUW1_6857512607',7,30,10,2,0,0,0,6,0,356,90,25566,28196,33911,2,22,9,0,1,1,0,3,314,106,26333,29989,28985,0,42,-16,-767,1,-1793,4926,2,-1,-1,0,3
EUW1_6856734165',1,45,18,2,0,1,0,15,1,333,79,30923,30000,40170,4,29,18,0,0,3,0,5,321,104,32195,30397,39213,0,12,-25,-1272,0,-397,957,2,0,-2,0,10
EUW1_6856375085',1,22,15,1,0,2,0,3,0,358,84,31455,30294,36263,1,26,17,1,0,0,0,9,325,95,29470,29686,35735,1,33,-11,1985,-2,608,528,0,0,2,0,-6
EUW1_6856112190',3,52,12,0,0,0,0,17,0,332,92,27039,30056,31550,4,68,17,2,0,1,0,0,372,108,31155,32344,33950,0,-40,-16,-4116,-5,-2288,-2400,-2,0,-1,0,17
EUW1_6849743448',2,20,15,1,1,1,0,15,0,330,85,29023,27798,38548,1,19,17,0,0,2,0,2,329,82,31003,29511,35286,0,1,3,-1980,-2,-1713,3262,1,1,-1,0,13
EUW1_6849681921',3,27,5,0,0,0,0,9,0,348,83,23202,25620,21866,4,22,10,1,1,1,0,1,335,96,25684,27414,24267,0,13,-13,-2482,-5,-1794,-2401,-1,-1,-1,0,8
EUW1_6883367708',7,34,16,1,1,0,0,7,0,326,74,27961,26951,36022,2,48,14,1,0,0,0,3,264,75,26939,25009,35114,1,62,-1,1022,2,1942,908,0,1,0,0,4
EUW1_6883322859',6,28,14,0,0,1,0,8,0,382,78,29963,31105,31268,1,37,8,1,0,1,0,6,328,97,24399,27320,25514,1,54,-19,5564,6,3785,5754,-1,0,0,0,2
EUW1_6883268781',5,39,20,2,0,2,0,11,1,345,98,31873,30210,38354,0,15,13,0,0,1,0,6,324,85,27472,29142,26169,1,21,13,4401,7,1068,12185,2,0,1,0,5
EUW1_6882681048',2,25,8,1,0,1,0,15,0,345,79,26173,29197,28838,6,26,12,1,0,2,0,6,368,100,29126,29652,36058,1,-23,-21,-2953,-4,-455,-7220,0,0,-1,0,9
EUW1_6882632034',2,24,5,0,0,0,0,12,0,350,88,23191,28374,31542,3,30,14,1,0,1,0,0,394,100,29785,33185,37249,0,-44,-12,-6594,-9,-4811,-5707,-1,0,-1,0,12
EUW1_6882453266',4,38,2,0,0,1,0,11,0,416,102,24735,29498,25646,1,24,6,2,0,2,0,4,399,110,26469,32318,20677,0,17,-8,-1734,-4,-2820,4969,-2,0,-1,0,7
EUW1_6880967313',4,27,13,2,0,1,0,5,0,420,119,29793,33156,29047,8,36,7,0,0,1,0,3,377,72,25471,28883,24880,1,43,47,4322,6,4273,4167,2,0,0,0,2
EUW1_6880931562',7,28,5,0,1,1,0,11,0,325,109,25365,28535,26384,2,27,21,1,0,2,0,6,337,85,30942,29654,38636,0,-12,24,-5577,-16,-1119,-12252,-1,1,-1,0,5
EUW1_6879507350',6,29,14,1,0,0,0,7,1,370,92,28631,30681,31803,6,162,13,1,0,2,0,4,321,80,27286,29906,32235,1,49,12,1345,1,775,-432,0,0,-2,0,3
EUW1_6879446901',3,77,9,0,0,0,0,7,1,362,72,25685,28345,33113,6,50,16,1,0,1,0,2,325,90,28881,29964,28065,1,37,-18,-3196,-7,-1619,5048,-1,0,-1,0,5
EUW1_6879422789',8,23,13,0,0,0,0,6,1,364,85,26582,28073,35660,6,32,17,1,0,1,0,2,354,66,29150,28988,37985,1,10,19,-2568,-4,-915,-2325,-1,0,-1,0,4
EUW1_6879044056',3,37,5,0,0,0,0,8,0,291,72,22514,25770,21925,4,26,20,2,0,2,0,3,380,114,31577,32970,40374,0,-89,-42,-9063,-15,-7200,-18449,-2,0,-2,0,5
EUW1_6883607862',4,31,12,2,0,0,0,15,0,376,100,28125,31345,27795,1,21,13,0,1,2,0,0,380,104,30612,32039,27202,0,-4,-4,-2487,-1,-694,593,2,-1,-2,0,15
EUW1_6883581069',3,23,9,1,1,2,0,10,1,371,99,27944,29923,28451,5,37,16,1,0,1,0,6,327,96,29142,29731,32191,1,44,3,-1198,-7,192,-3740,0,1,1,0,4
EUW1_6883564558',5,201,14,0,0,0,0,6,1,331,78,27558,27004,29476,0,26,18,2,0,0,0,3,332,113,30166,30178,38303,0,-1,-35,-2608,-4,-3174,-8827,-2,0,0,0,3
EUW1_6883472314',2,28,17,1,0,0,0,7,0,353,107,29586,31572,40247,6,29,9,1,0,1,0,3,354,80,26691,28918,33919,1,-1,27,2895,8,2654,6328,0,0,-1,0,4
EUW1_6883436224',5,26,5,0,0,0,0,10,0,373,76,23227,26914,27055,4,103,15,1,0,1,0,3,371,116,30047,32471,31780,0,2,-40,-6820,-10,-5557,-4725,-1,0,-1,0,7
EUW1_6882885873',3,23,7,0,0,2,0,5,0,379,92,27405,28519,25108,5,95,11,1,1,0,0,5,387,92,27135,31776,29682,0,-8,0,270,-4,-3257,-4574,-1,-1,2,0,0
EUW1_6882834775',3,26,12,2,0,0,0,12,1,343,95,26845,28636,30994,5,26,12,0,1,2,0,3,405,94,30290,30647,31674,0,-62,1,-3445,0,-2011,-680,2,-1,-2,0,9
EUW1_6882776156',3,29,19,2,1,4,1,5,1,368,112,33250,32501,35063,2,33,3,0,0,1,0,10,280,75,19934,23392,18551,1,88,37,13316,16,9109,16512,2,1,3,1,-5
EUW1_6882737658',3,72,12,0,0,2,0,10,1,371,84,28910,28215,37633,5,54,14,2,0,0,0,4,332,82,26322,29699,34064,1,39,2,2588,-2,-1484,3569,-2,0,2,0,6
EUW1_6882689476',6,32,14,0,0,0,0,9,0,357,97,27463,27491,31194,2,23,19,1,0,2,0,4,348,87,30400,28293,36548,0,9,10,-2937,-5,-802,-5354,-1,0,-2,0,5
EUW1_6882311277',4,43,18,1,0,1,0,12,0,292,64,29187,26391,33587,2,22,22,1,0,2,0,4,322,112,32810,29254,39827,0,-30,-48,-3623,-4,-2863,-6240,0,0,-1,0,8
EUW1_6882315462',0,19,16,1,1,3,0,6,0,393,128,32817,34437,35267,6,29,3,0,0,0,0,10,366,84,22456,27080,18689,1,27,44,10361,13,7357,16578,1,1,3,0,-4
EUW1_6882291124',4,27,32,1,1,3,0,7,1,302,84,37320,31303,55481,5,25,22,1,0,0,0,8,332,55,31260,26198,42618,1,-30,29,6060,10,5105,12863,0,1,3,0,-1
EUW1_6882280013',4,25,12,1,0,1,0,6,1,329,113,28167,29779,30414,0,34,8,1,0,0,0,5,361,101,24826,28200,28062,1,-32,12,3341,4,1579,2352,0,0,1,0,1
EUW1_6882261314',4,35,27,0,0,1,0,9,0,339,76,33996,30923,45836,3,26,18,2,0,1,0,8,325,63,29166,28296,47775,1,14,13,4830,9,2627,-1939,-2,0,0,0,1
EUW1_6882225110',2,29,13,0,0,0,0,9,0,364,100,27944,31423,35271,7,35,14,1,0,1,0,2,357,100,29464,31153,32863,0,7,0,-1520,-1,270,2408,-1,0,-1,0,7
EUW1_6881384675',3,24,10,0,1,0,0,4,1,379,102,26893,30676,24546,5,37,10,1,0,1,0,6,396,93,27883,30940,27324,0,-17,9,-990,0,-264,-2778,-1,1,-1,0,-2
EUW1_6881325342',4,25,13,0,0,0,0,10,0,242,67,24362,25619,31544,2,22,23,0,0,2,0,0,333,91,33008,32114,37786,0,-91,-24,-8646,-10,-6495,-6242,0,0,-2,0,10
EUW1_6882252320',4,33,19,1,0,1,0,19,1,328,108,32066,31738,42997,4,33,23,1,0,1,0,3,342,88,31973,31008,42221,0,-14,20,93,-4,730,776,0,0,0,0,16
EUW1_6881841361',1,35,16,1,1,1,0,4,1,342,82,29175,28676,36613,5,27,13,0,0,1,0,6,362,60,27741,27941,31135,1,-20,22,1434,3,735,5478,1,1,0,0,-2
EUW1_6881790498',2,115,11,1,0,2,0,5,0,358,88,28927,30760,27642,4,62,11,1,0,0,0,9,299,72,24706,25607,26151,1,59,16,4221,0,5153,1491,0,0,2,0,-4
EUW1_6881389692',8,36,16,0,0,0,0,9,1,348,84,28772,28850,38927,9,31,14,2,0,1,0,0,332,104,27715,28192,33874,0,16,-20,1057,2,658,5053,-2,0,-1,0,9
EUW1_6879215651',4,26,12,1,0,1,0,10,1,310,84,26919,28243,34332,6,36,16,0,0,0,0,2,352,78,27680,29395,31577,1,-42,6,-761,-4,-1152,2755,1,0,1,0,8
EUW1_6879180870',3,226,14,1,0,1,0,5,1,393,95,30305,30486,29748,7,28,11,1,0,1,0,7,346,88,27816,30280,30522,1,47,7,2489,3,206,-774,0,0,0,0,-2
EUW1_6879127242',7,35,13,1,0,0,0,12,1,361,80,28004,29946,27478,3,31,7,0,0,2,0,2,362,86,25413,28782,34303,1,-1,-6,2591,6,1164,-6825,1,0,-2,0,10
EUW1_6878852118',4,28,10,2,0,0,0,7,0,352,88,25718,27861,31413,4,43,10,0,0,0,0,1,349,71,25117,28214,27534,0,3,17,601,0,-353,3879,2,0,0,0,6
EUW1_6878794533',6,29,11,1,0,0,0,7,0,351,109,27044,30926,32009,9,51,8,1,0,0,0,3,352,87,24928,28019,31171,1,-1,22,2116,3,2907,838,0,0,0,0,4
EUW1_6878729886',5,43,13,1,0,2,0,8,0,397,86,29119,31191,31611,6,26,10,0,0,0,0,6,357,102,26089,30798,31775,0,40,-16,3030,3,393,-164,1,0,2,0,2
EUW1_6878687705',3,133,16,2,0,2,0,7,1,411,90,31889,30750,32706,1,44,7,0,0,1,0,10,290,94,22814,25691,28272,1,121,-4,9075,9,5059,4434,2,0,1,0,-3
EUW1_6878559917',5,62,9,0,0,1,0,10,1,389,84,25654,30637,20170,5,192,8,1,0,1,0,2,365,92,26924,29492,27401,1,24,-8,-1270,1,1145,-7231,-1,0,0,0,8
EUW1_6878507983',4,25,12,0,0,0,0,10,1,320,73,27092,26983,31467,5,29,11,1,0,0,0,4,357,98,27312,30342,40452,0,-37,-25,-220,1,-3359,-8985,-1,0,0,0,6
EUW1_6877832143',5,28,10,1,1,0,0,16,0,306,72,25179,25709,27631,5,22,12,1,0,3,0,3,369,108,29460,29235,37007,0,-63,-36,-4281,-2,-3526,-9376,0,1,-3,0,13
EUW1_6877801307',2,34,14,2,0,1,0,9,0,342,128,29714,30336,30889,3,29,12,0,0,2,0,6,364,67,27179,28292,31642,1,-22,61,2535,2,2044,-753,2,0,-1,0,3
EUW1_6877773033',2,22,19,1,0,0,0,9,0,311,101,31757,29398,37408,7,39,23,1,0,1,0,5,344,80,32701,30794,41301,0,-33,21,-944,-4,-1396,-3893,0,0,-1,0,4
EUW1_6877085552',4,26,16,0,0,0,0,10,0,343,82,29869,30013,33566,4,36,15,2,1,1,0,6,350,99,29238,29752,36025,0,-7,-17,631,1,261,-2459,-2,-1,-1,0,4
EUW1_6877039339',2,27,10,1,0,1,0,5,1,444,111,28644,32389,30651,9,34,2,1,0,0,0,6,320,80,21270,27864,19488,1,124,31,7374,8,4525,11163,0,0,1,0,-1
EUW1_6876983185',3,22,12,1,0,1,0,7,1,377,74,27300,29600,25030,3,27,8,0,1,0,0,3,349,86,24295,29130,22859,1,28,-12,3005,4,470,2171,1,-1,1,0,4
EUW1_6882476366',0,24,22,1,1,0,0,6,0,355,117,31790,32911,40968,2,28,14,0,0,0,0,4,327,84,28383,28547,40260,1,28,33,3407,8,4364,708,1,1,0,0,2
EUW1_6882460185',2,223,20,0,1,1,0,11,1,316,103,31370,30646,36310,4,28,12,2,0,1,0,6,365,92,29043,30065,32133,1,-49,11,2327,8,581,4177,-2,1,0,0,5
EUW1_6856807021',7,34,16,0,0,0,0,11,0,299,76,28535,27463,41934,3,26,22,1,0,2,0,2,356,72,32740,31049,46912,0,-57,4,-4205,-6,-3586,-4978,-1,0,-2,0,9
EUW1_6856791212',0,24,8,0,0,0,0,20,0,327,74,24579,26076,26653,7,44,17,2,0,3,0,2,359,109,31906,31196,32614,0,-32,-35,-7327,-9,-5120,-5961,-2,0,-3,0,18
EUW1_6854337611',3,32,9,0,0,0,0,13,1,366,75,26417,28045,32209,4,27,25,2,1,2,0,2,343,108,34838,33462,40549,1,23,-33,-8421,-16,-5417,-8340,-2,-1,-2,0,11
EUW1_6853410433',5,145,13,0,0,1,0,9,1,368,72,29076,30088,36464,2,38,10,2,0,1,0,4,334,96,25831,29821,33011,0,34,-24,3245,3,267,3453,-2,0,0,0,5
EUW1_6853362973',0,23,18,1,0,1,0,10,0,336,69,31675,30130,35695,5,29,11,0,0,1,0,3,297,72,24958,24718,28773,1,39,-3,6717,7,5412,6922,1,0,0,0,7
EUW1_6838138771',6,34,25,2,0,2,0,5,1,316,110,32779,29274,44514,6,31,9,0,0,0,0,8,273,78,25170,25446,27190,1,43,32,7609,16,3828,17324,2,0,2,0,-3
EUW1_6838021124',5,40,14,2,0,0,0,10,0,379,88,27714,29616,31020,4,62,6,0,0,1,0,2,364,73,24656,28043,27242,1,15,15,3058,8,1573,3778,2,0,-1,0,8
EUW1_6828051140',6,37,15,0,0,0,0,7,1,365,73,28568,30362,36952,4,67,16,2,0,0,0,4,347,85,28904,29913,30094,0,18,-12,-336,-1,449,6858,-2,0,0,0,3
EUW1_6827388313',2,29,19,2,0,2,0,5,1,378,84,30727,31069,34431,5,32,8,0,0,0,0,7,335,112,26417,29861,22568,0,43,-28,4310,11,1208,11863,2,0,2,0,-2
EUW1_6817745475',0,21,6,1,0,1,0,14,0,312,79,24694,28213,26280,5,28,13,1,0,2,0,4,376,76,28307,28296,29184,0,-64,3,-3613,-7,-83,-2904,0,0,-1,0,10
EUW1_6815707342',7,35,11,0,0,0,0,8,0,324,74,25730,27209,40228,7,30,22,2,1,1,0,1,353,117,31372,33388,38805,0,-29,-43,-5642,-11,-6179,1423,-2,-1,-1,0,7
EUW1_6813422515',0,19,13,0,1,1,0,11,1,350,100,27210,30065,34554,3,24,12,2,0,1,0,3,358,90,28193,29451,35096,1,-8,10,-983,1,614,-542,-2,1,0,0,8
EUW1_6813384215',3,27,18,0,0,2,0,11,0,379,102,31202,31594,30945,5,37,10,2,0,1,0,4,346,98,29084,28610,33959,0,33,4,2118,8,2984,-3014,-2,0,1,0,7
EUW1_6810939195',4,25,14,1,0,1,0,8,1,349,90,28224,29517,33585,1,94,7,0,0,0,0,6,351,58,24424,27380,29546,1,-2,32,3800,7,2137,4039,1,0,1,0,2
EUW1_6810734148',5,32,7,0,0,0,0,11,1,343,90,25577,26995,32330,4,29,15,1,0,0,0,1,365,70,28938,29471,36602,1,-22,20,-3361,-8,-2476,-4272,-1,0,0,0,10
EUW1_6883426183',4,35,14,1,0,1,0,8,1,376,96,28967,30767,37409,2,33,7,0,1,1,0,8,381,100,26503,30111,25558,1,-5,-4,2464,7,656,11851,1,-1,0,0,0
EUW1_6880612226',2,20,5,0,0,0,0,13,0,302,78,22693,24165,26011,8,30,19,1,0,2,0,3,392,90,31904,31871,41308,0,-90,-12,-9211,-14,-7706,-15297,-1,0,-2,0,10
EUW1_6880200204',6,86,13,1,0,0,0,9,0,334,90,26199,28157,31101,6,37,18,1,0,1,0,0,383,90,32058,30572,37705,0,-49,0,-5859,-5,-2415,-6604,0,0,-1,0,9
EUW1_6877875292',1,61,16,0,0,0,0,7,1,365,75,30164,29457,32635,5,29,14,2,0,0,0,7,372,76,27299,29463,30905,0,-7,-1,2865,2,-6,1730,-2,0,0,0,0
EUW1_6877680915',4,28,15,1,1,2,0,8,0,385,91,29647,31070,29542,4,33,10,1,0,0,0,7,320,96,25905,28170,22927,0,65,-5,3742,5,2900,6615,0,1,2,0,1
EUW1_6867973405',4,80,4,0,0,0,0,7,0,327,76,21788,25300,18658,7,48,9,2,0,1,0,2,382,107,27319,28712,22231,0,-55,-31,-5531,-5,-3412,-3573,-2,0,-1,0,5
EUW1_6867832637',3,88,7,0,0,0,0,4,1,398,93,25503,29111,24132,2,21,10,2,0,0,0,4,359,98,25210,32330,27398,0,39,-5,293,-3,-3219,-3266,-2,0,0,0,0
EUW1_6866520416',2,25,9,0,0,0,0,10,1,365,75,25405,28968,26342,3,32,11,1,0,1,0,2,349,108,27060,30082,24553,1,16,-33,-1655,-2,-1114,1789,-1,0,-1,0,8
EUW1_6866478637',7,32,17,2,0,1,0,6,1,386,83,28250,32837,34410,4,29,6,0,0,0,0,3,313,88,23281,28450,23194,1,73,-5,4969,11,4387,11216,2,0,1,0,3
EUW1_6866321479',1,94,5,0,0,0,0,7,0,370,87,23594,28002,27053,2,29,9,1,0,1,0,2,374,91,26877,30999,22943,0,-4,-4,-3283,-4,-2997,4110,-1,0,-1,0,5
EUW1_6866286525',5,26,14,1,0,0,0,10,1,347,80,26806,30690,28837,3,29,9,1,1,1,0,2,352,96,27359,30344,32527,0,-5,-16,-553,5,346,-3690,0,-1,-1,0,8
EUW1_6864687277',8,87,10,1,0,0,0,11,0,291,85,25229,24922,32123,2,28,14,1,0,1,0,0,367,82,27718,28881,33815,0,-76,3,-2489,-4,-3959,-1692,0,0,-1,0,11
EUW1_6864665957',4,76,10,1,0,1,0,10,1,390,80,27178,30954,30622,6,80,5,0,0,0,0,1,398,96,25031,29852,30613,1,-8,-16,2147,5,1102,9,1,0,1,0,9
EUW1_6864639312',5,27,14,2,0,0,0,8,1,397,70,28040,31058,32386,12,107,10,0,0,0,0,6,362,78,26509,30224,31068,1,35,-8,1531,4,834,1318,2,0,0,0,2
EUW1_6861280001',1,22,14,2,0,0,0,7,1,315,102,28081,29132,37739,6,110,11,0,0,0,0,4,338,78,25509,28348,28654,1,-23,24,2572,3,784,9085,2,0,0,0,3
EUW1_6861242391',10,38,16,0,0,4,0,7,1,407,74,31528,31780,34358,2,86,11,1,0,0,0,8,345,90,25988,29461,24398,1,62,-16,5540,5,2319,9960,-1,0,4,0,-1
EUW1_6860833720',4,26,17,1,0,1,0,5,0,397,84,30677,31463,32666,2,84,16,1,0,0,0,3,328,108,28117,28585,25951,1,69,-24,2560,1,2878,6715,0,0,1,0,2
EUW1_6860820995',3,23,4,0,0,0,0,15,0,367,80,24182,29473,28742,6,82,21,1,1,2,0,2,395,100,32526,31822,33163,0,-28,-20,-8344,-17,-2349,-4421,-1,-1,-2,0,13
EUW1_6860042987',0,146,12,1,0,1,0,6,0,342,98,29405,28253,36446,4,86,10,0,0,1,0,8,292,77,25271,28179,25930,0,50,21,4134,2,74,10516,1,0,0,0,-2
EUW1_6860002628',3,27,19,2,0,0,0,6,1,335,80,29812,28814,44908,6,90,9,0,0,0,0,3,293,65,23753,23243,34514,1,42,15,6059,10,5571,10394,2,0,0,0,3
EUW1_6858064142',6,208,13,1,0,1,0,12,0,371,104,29589,31743,28691,3,38,8,0,0,1,0,5,367,88,27092,27261,27342,1,4,16,2497,5,4482,1349,1,0,0,0,7
EUW1_6856738043',4,73,10,0,0,1,0,6,1,360,89,27746,29508,26205,3,38,7,2,0,0,0,8,382,96,25262,29129,25128,0,-22,-7,2484,3,379,1077,-2,0,1,0,-2
EUW1_6883070257',3,83,13,1,1,0,0,6,0,353,98,27858,31017,26715,5,63,12,1,0,1,0,1,371,97,27519,29429,28305,0,-18,1,339,1,1588,-1590,0,1,-1,0,5
EUW1_6883012634',7,23,20,1,1,2,0,9,1,374,93,32137,31406,35038,4,32,11,0,0,0,0,7,365,93,27513,30809,35070,0,9,0,4624,9,597,-32,1,1,2,0,2
EUW1_6882954941',2,33,15,1,0,0,0,13,1,348,94,27879,29036,28354,2,138,8,1,0,2,0,3,377,90,27096,29085,25300,0,-29,4,783,7,-49,3054,0,0,-2,0,10
EUW1_6882904178',5,37,7,0,0,0,0,5,1,371,78,25259,29046,27570,8,28,13,1,0,0,0,2,370,86,27652,29998,29704,0,1,-8,-2393,-6,-952,-2134,-1,0,0,0,3
EUW1_6881645829',5,27,11,0,0,0,0,8,0,374,65,26831,29034,31094,4,31,23,1,0,1,0,4,377,93,32561,32581,36906,0,-3,-28,-5730,-12,-3547,-5812,-1,0,-1,0,4
EUW1_6881590631',5,27,12,0,0,1,0,13,0,376,96,27467,29683,28952,3,22,12,2,0,1,0,4,400,91,27827,30463,27859,1,-24,5,-360,0,-780,1093,-2,0,0,0,9
EUW1_6881529594',1,26,1,1,0,0,0,12,0,330,66,20529,24886,17048,6,99,18,1,0,2,0,1,392,118,32132,32628,32940,0,-62,-52,-11603,-17,-7742,-15892,0,0,-2,0,11
EUW1_6881470153',5,28,8,0,0,0,0,11,0,350,72,23472,28223,27929,1,25,9,1,0,1,0,0,406,98,27533,31183,34943,0,-56,-26,-4061,-1,-2960,-7014,-1,0,-1,0,11
EUW1_6879961386',4,27,21,1,0,1,0,15,1,292,70,30307,29792,36515,2,28,16,1,0,1,0,4,352,78,28241,28982,38576,1,-60,-8,2066,5,810,-2061,0,0,0,0,11
EUW1_6879930531',3,33,11,0,0,0,0,14,0,304,86,25400,28091,30637,0,33,17,1,1,3,0,0,357,96,32620,30250,41225,0,-53,-10,-7220,-6,-2159,-10588,-1,-1,-3,0,14
EUW1_6879871650',5,28,7,1,0,1,0,9,0,417,108,26895,30534,23809,1,22,14,1,0,1,0,5,394,80,28747,31846,26716,0,23,28,-1852,-7,-1312,-2907,0,0,0,0,4
EUW1_6879537125',5,26,14,1,0,0,0,10,0,370,86,27962,30342,29565,5,23,10,1,0,0,0,4,384,107,27248,30865,24498,1,-14,-21,714,4,-523,5067,0,0,0,0,6
EUW1_6878570555',2,28,17,0,0,0,0,13,1,315,95,29601,29064,41148,6,29,20,0,0,1,0,4,348,67,30564,29416,37078,0,-33,28,-963,-3,-352,4070,0,0,-1,0,9
EUW1_6878526607',7,31,23,1,0,2,0,5,0,381,103,34752,32833,52283,8,28,13,0,0,0,0,9,294,67,26337,26965,31211,1,87,36,8415,10,5868,21072,1,0,2,0,-4
EUW1_6878464425',2,27,11,1,0,0,0,17,0,294,82,26542,29005,27904,3,70,16,1,0,3,0,0,391,76,31711,30669,41436,0,-97,6,-5169,-5,-1664,-13532,0,0,-3,0,17
EUW1_6883014621',2,21,12,1,0,2,0,9,0,373,83,29096,30953,33226,1,26,9,0,0,0,0,6,337,102,26026,28975,29342,1,36,-19,3070,3,1978,3884,1,0,2,0,3
EUW1_6882484941',1,25,7,0,0,1,0,11,0,332,78,25977,27473,26186,4,27,18,2,0,0,0,5,329,79,27346,30511,35818,0,3,-1,-1369,-11,-3038,-9632,-2,0,1,0,6
EUW1_6882016918',3,27,22,1,0,3,0,10,1,372,92,34812,30213,40974,2,27,11,1,0,0,0,6,275,68,26424,26372,31432,1,97,24,8388,11,3841,9542,0,0,3,0,4
EUW1_6881886828',4,66,8,1,0,0,0,7,1,349,90,24892,28315,29773,4,54,15,1,1,1,0,4,373,105,29309,32288,34617,0,-24,-15,-4417,-7,-3973,-4844,0,-1,-1,0,3
EUW1_6880227941',1,73,16,0,1,1,0,4,1,338,97,30698,30423,31316,1,19,14,2,0,1,0,7,341,67,26260,28563,30666,0,-3,30,4438,2,1860,650,-2,1,0,0,-3
EUW1_6880187780',0,17,17,1,0,2,0,5,1,374,95,31237,29588,38403,6,25,10,0,0,0,0,8,326,68,24650,26596,28502,1,48,27,6587,7,2992,9901,1,0,2,0,-3
EUW1_6875315432',3,29,8,0,0,0,0,9,1,345,79,24463,27181,33367,3,25,19,1,0,0,0,3,345,84,29030,32012,35938,0,0,-5,-4567,-11,-4831,-2571,-1,0,0,0,6
EUW1_6875298468',4,23,23,2,0,1,0,5,0,366,90,31831,32108,39211,3,25,8,0,0,0,0,8,315,67,24424,27076,31362,1,51,23,7407,15,5032,7849,2,0,1,0,-3
EUW1_6875249169',5,55,14,2,0,1,0,12,1,326,103,28353,28936,35698,4,54,16,0,0,1,0,7,398,94,30277,31947,43358,1,-72,9,-1924,-2,-3011,-7660,2,0,0,0,5
EUW1_6874782867',5,26,11,2,0,1,0,9,0,317,106,26515,28420,25177,2,27,11,0,0,1,0,5,332,82,26371,27408,31723,1,-15,24,144,0,1012,-6546,2,0,0,0,4
EUW1_6874742746',2,79,5,0,0,0,0,16,0,279,56,20767,22455,20531,2,41,22,1,1,10,2,0,388,116,37764,34299,35671,0,-109,-60,-16997,-17,-11844,-15140,-1,-1,-10,-2,16
EUW1_6870379272',5,29,15,1,0,1,0,7,0,328,100,29592,28413,36923,5,41,20,1,0,1,0,6,359,92,31509,30879,35934,0,-31,8,-1917,-5,-2466,989,0,0,0,0,1
EUW1_6867908287',7,26,22,1,0,3,0,9,1,418,82,32503,33405,35072,1,19,5,1,0,0,0,7,322,103,23309,26331,22890,1,96,-21,9194,17,7074,12182,0,0,3,0,2
EUW1_6867875351',5,31,21,0,1,2,0,8,1,389,91,33685,31701,35215,4,26,15,1,0,0,0,7,328,100,27642,29538,31016,1,61,-9,6043,6,2163,4199,-1,1,2,0,1
EUW1_6862636435',4,26,4,0,0,2,0,11,1,379,98,25329,29609,22569,2,26,8,2,0,0,0,4,403,80,26368,31142,27766,0,-24,18,-1039,-4,-1533,-5197,-2,0,2,0,7
EUW1_6860347646',5,42,23,1,0,3,0,3,1,383,98,33277,32590,39800,3,20,8,1,0,0,0,11,275,79,23670,24928,21552,1,108,19,9607,15,7662,18248,0,0,3,0,-8
EUW1_6859858362',5,34,13,1,1,0,0,6,0,372,90,27626,32983,33153,3,33,9,1,0,0,0,7,355,89,24976,29206,31503,0,17,1,2650,4,3777,1650,0,1,0,0,-1
EUW1_6859791928',3,21,10,0,0,0,0,12,0,322,94,25093,27615,32541,4,29,14,2,0,2,0,1,349,92,29958,29250,35622,0,-27,2,-4865,-4,-1635,-3081,-2,0,-2,0,11
EUW1_6859614222',2,25,9,0,0,0,0,2,1,349,108,25721,29672,31013,3,28,15,2,0,0,0,1,320,91,26340,30132,32179,0,29,17,-619,-6,-460,-1166,-2,0,0,0,1
EUW1_6859580149',6,56,12,1,1,0,0,10,0,364,100,27929,30137,30505,5,22,14,0,0,2,0,3,339,91,30066,28784,32083,1,25,9,-2137,-2,1353,-1578,1,1,-2,0,7
EUW1_6876239032',1,21,15,0,0,0,0,12,1,327,66,27939,27314,31674,3,33,19,1,0,2,0,3,369,80,32580,31383,45382,0,-42,-14,-4641,-4,-4069,-13708,-1,0,-2,0,9
EUW1_6876192435',5,40,17,1,1,1,0,3,1,394,78,30429,31101,35968,7,33,5,0,0,0,0,6,361,61,22307,27906,28143,1,33,17,8122,12,3195,7825,1,1,1,0,-3
EUW1_6876141520',2,27,13,1,0,0,0,5,1,335,82,26695,28793,31287,4,31,7,1,0,0,0,2,363,70,23364,27449,25941,1,-28,12,3331,6,1344,5346,0,0,0,0,3
EUW1_6876074929',5,27,16,0,0,1,0,12,1,376,72,30431,31019,32551,6,30,12,1,0,1,0,6,373,83,28429,29179,31239,1,3,-11,2002,4,1840,1312,-1,0,0,0,6
EUW1_6868998349',3,28,15,1,0,4,0,4,0,389,121,33110,31146,37720,4,30,6,1,0,0,0,12,275,81,23605,25804,25514,1,114,40,9505,9,5342,12206,0,0,4,0,-8
EUW1_6868926239',6,27,9,0,0,1,0,5,1,369,84,25815,30274,23463,6,30,4,2,0,0,0,3,364,100,23745,28709,19487,1,5,-16,2070,5,1565,3976,-2,0,1,0,2
EUW1_6868883743',5,23,13,1,0,1,0,7,0,365,87,28184,30459,31010,1,30,5,1,0,0,0,7,331,86,22273,27468,28979,1,34,1,5911,8,2991,2031,0,0,1,0,0
EUW1_6867905512',3,257,4,1,0,0,0,9,1,362,89,23035,28278,22320,1,98,8,1,0,0,0,1,365,86,24619,28714,23278,0,-3,3,-1584,-4,-436,-958,0,0,0,0,8
EUW1_6867858281',4,81,13,1,0,1,0,5,1,382,84,28018,29691,37751,6,36,9,1,0,0,0,3,334,94,24895,27871,30575,1,48,-10,3123,4,1820,7176,0,0,1,0,2
EUW1_6865762720',1,26,19,1,0,2,0,2,1,374,86,32063,31151,40853,3,33,15,1,0,0,0,8,324,80,27597,28810,32105,0,50,6,4466,4,2341,8748,0,0,2,0,-6
EUW1_6865670382',4,41,23,1,0,0,0,10,1,260,86,29814,26871,39349,6,34,20,0,1,0,0,1,318,78,31272,27864,43822,0,-58,8,-1458,3,-993,-4473,1,-1,0,0,9
EUW1_6882775336',2,32,8,1,0,0,0,7,0,353,62,25575,26711,32037,3,22,24,1,0,1,0,5,307,118,31182,32208,35939,0,46,-56,-5607,-16,-5497,-3902,0,0,-1,0,2
EUW1_6882732449',5,30,17,1,0,3,0,9,1,394,64,30913,30677,31398,2,44,9,0,0,0,0,8,324,101,24780,28258,28028,1,70,-37,6133,8,2419,3370,1,0,3,0,1
EUW1_6881348666',6,190,12,0,1,1,0,12,0,361,98,28805,30988,30806,6,34,6,2,0,1,0,5,364,86,25660,28735,27406,0,-3,12,3145,6,2253,3400,-2,1,0,0,7
EUW1_6875158581',6,38,11,1,0,0,0,9,1,367,104,28622,29012,27231,3,69,10,0,0,2,0,5,354,73,25961,28895,28546,1,13,31,2661,1,117,-1315,1,0,-2,0,4
EUW1_6872816519',2,26,22,1,0,3,0,10,1,390,74,33309,33562,38306,2,26,13,0,0,2,0,7,321,106,29185,31238,33930,1,69,-32,4124,9,2324,4376,1,0,1,0,3
EUW1_6872517976',4,28,18,2,1,0,0,8,1,370,136,31125,32384,36593,3,32,4,0,0,1,0,5,321,73,22287,24590,22292,1,49,63,8838,14,7794,14301,2,1,-1,0,3
EUW1_6872485322',5,25,15,0,0,1,0,12,0,411,86,30578,31782,36841,1,30,13,1,0,0,0,6,341,91,27963,30560,32782,1,70,-5,2615,2,1222,4059,-1,0,1,0,6
EUW1_6872424561',2,28,26,1,0,1,0,6,1,360,92,34861,32312,46530,3,17,6,1,0,2,0,9,281,74,23947,25546,24435,1,79,18,10914,20,6766,22095,0,0,-1,0,-3
EUW1_6872345524',5,27,11,0,0,1,0,9,0,378,68,26736,29289,26503,1,31,10,2,0,1,0,3,369,92,27368,30066,25242,0,9,-24,-632,1,-777,1261,-2,0,0,0,6
EUW1_6871850307',8,32,12,1,0,1,0,6,0,341,78,27861,28525,26601,5,32,16,0,0,1,0,7,332,68,29873,28402,36991,1,9,10,-2012,-4,123,-10390,1,0,0,0,-1
EUW1_6871417777',5,27,14,1,0,1,0,5,1,339,82,28482,28599,39940,4,26,11,0,0,0,0,4,313,76,25331,27063,30923,0,26,6,3151,3,1536,9017,1,0,1,0,1
EUW1_6871115145',3,43,16,0,0,0,0,11,0,335,75,28127,27883,43444,7,32,19,2,0,2,0,4,348,54,30724,29034,39415,0,-13,21,-2597,-3,-1151,4029,-2,0,-2,0,7
EUW1_6871091912',7,34,13,0,0,1,0,7,0,368,92,28381,29304,34139,8,31,16,1,0,0,0,6,347,72,27025,29988,34359,1,21,20,1356,-3,-684,-220,-1,0,1,0,1
EUW1_6871027412',3,26,14,0,0,1,0,9,0,385,96,30798,31592,28680,4,27,7,1,0,1,0,7,369,111,25322,28604,26320,1,16,-15,5476,7,2988,2360,-1,0,0,0,2
EUW1_6871012357',3,23,15,2,0,1,0,6,1,363,74,27900,28875,28965,6,32,14,0,0,1,0,7,377,125,29641,32220,34893,1,-14,-51,-1741,1,-3345,-5928,2,0,0,0,-1
EUW1_6870615595',5,25,8,1,0,0,0,11,1,367,86,24608,29938,24269,7,64,13,1,1,0,0,3,337,97,27656,29347,29353,1,30,-11,-3048,-5,591,-5084,0,-1,0,0,8
EUW1_6870542299',2,27,16,0,0,2,0,5,0,383,72,30186,30162,38417,5,50,13,1,0,0,0,6,274,100,25753,27450,36604,1,109,-28,4433,3,2712,1813,-1,0,2,0,-1
EUW1_6870492964',4,31,24,1,0,2,0,6,1,342,70,32800,30954,44618,4,42,8,0,0,0,0,7,287,71,23979,26046,31046,1,55,-1,8821,16,4908,13572,1,0,2,0,-1
EUW1_6880579731',4,25,13,1,0,1,0,11,1,343,80,27664,28558,33804,5,27,17,0,0,1,0,5,372,93,30852,29782,37515,0,-29,-13,-3188,-4,-1224,-3711,1,0,0,0,6
EUW1_6880518213',0,27,17,0,0,1,0,5,0,353,85,29264,29655,35964,2,54,13,0,0,0,0,4,302,69,26712,26617,34469,1,51,16,2552,4,3038,1495,0,0,1,0,1
EUW1_6879227825',0,20,8,1,0,0,0,13,0,296,95,25044,25500,24071,4,28,16,0,1,2,0,3,382,83,30073,29740,33527,0,-86,12,-5029,-8,-4240,-9456,1,-1,-2,0,10
EUW1_6879169179',3,28,19,1,1,0,0,11,0,326,82,29231,27983,33301,2,49,16,0,0,1,0,2,346,78,28881,29040,36163,1,-20,4,350,3,-1057,-2862,1,1,-1,0,9
EUW1_6862156385',1,21,14,1,0,2,0,7,1,388,84,31152,30570,37587,5,21,13,1,0,2,0,8,316,100,27410,30010,28250,1,72,-16,3742,1,560,9337,0,0,0,0,-1
EUW1_6862139691',3,30,13,0,0,1,0,8,1,335,86,29065,27662,35194,5,31,15,1,0,0,0,2,320,82,26934,28547,33083,1,15,4,2131,-2,-885,2111,-1,0,1,0,6
EUW1_6862111394',4,22,4,0,0,1,0,11,0,314,92,24402,26183,18649,3,33,12,1,0,2,0,0,380,75,27827,30073,33698,0,-66,17,-3425,-8,-3890,-15049,-1,0,-1,0,11
EUW1_6862095108',6,50,21,1,0,1,0,11,0,332,92,30317,30540,41718,6,54,22,1,0,1,0,4,334,67,32145,29195,42017,0,-2,25,-1828,-1,1345,-299,0,0,0,0,7
EUW1_6851601472',3,28,25,1,0,0,0,12,0,333,82,33794,28528,42677,1,22,11,0,0,3,0,6,301,78,26049,24596,27647,0,32,4,7745,14,3932,15030,1,0,-3,0,6
EUW1_6851568411',4,29,17,0,0,1,0,7,0,367,63,29969,29732,37646,5,36,17,2,0,0,0,6,301,88,29460,27832,31836,1,66,-25,509,0,1900,5810,-2,0,1,0,1
EUW1_6844766356',8,35,21,1,0,1,0,7,1,335,96,30695,28567,35319,0,28,18,1,0,0,0,6,334,68,29528,27264,37056,0,1,28,1167,3,1303,-1737,0,0,1,0,1
EUW1_6842047021',3,33,12,0,0,2,0,8,0,369,84,28962,29135,35127,4,27,13,1,0,0,0,4,332,56,25839,27387,38675,1,37,28,3123,-1,1748,-3548,-1,0,2,0,4
EUW1_6842010474',2,17,25,1,0,1,0,9,0,307,64,33760,28284,44409,3,39,25,1,0,2,0,7,320,96,34942,29735,54353,0,-13,-32,-1182,0,-1451,-9944,0,0,-1,0,2
EUW1_6838265110',4,26,14,1,0,1,0,10,1,378,110,28722,30564,29221,2,154,13,1,0,1,0,5,311,110,28450,30008,37227,1,67,0,272,1,556,-8006,0,0,0,0,5
EUW1_6838215839',4,29,13,1,0,1,0,11,0,356,102,30075,30423,30444,5,29,19,0,0,0,0,6,355,72,29388,31868,39024,0,1,30,687,-6,-1445,-8580,1,0,1,0,5
EUW1_6838172905',4,49,15,1,0,3,0,14,1,318,110,30737,29054,34326,4,24,19,1,0,1,0,9,344,62,30502,27585,36037,1,-26,48,235,-4,1469,-1711,0,0,2,0,5
EUW1_6838137930',2,17,11,0,0,0,0,11,0,282,61,24660,24373,31505,3,45,27,2,1,2,0,1,427,97,36216,34352,50691,0,-145,-36,-11556,-16,-9979,-19186,-2,-1,-2,0,10
EUW1_6838118465',5,52,31,1,0,3,0,10,1,348,96,37557,34001,49060,4,216,11,1,0,0,0,5,292,80,26016,26858,33083,1,56,16,11541,20,7143,15977,0,0,3,0,5
EUW1_6882962634',4,28,5,1,0,1,0,6,1,385,66,24827,27947,22954,4,28,5,1,0,0,0,1,383,105,24788,28317,22979,0,2,-39,39,0,-370,-25,0,0,1,0,5
EUW1_6882531912',2,27,13,1,0,0,0,7,0,365,112,29173,30213,31216,1,26,14,1,0,0,0,3,361,84,28522,28724,30393,0,4,28,651,-1,1489,823,0,0,0,0,4
EUW1_6881869657',2,31,21,1,0,0,0,10,0,377,92,30112,31528,39316,2,24,10,0,0,1,0,4,353,80,26683,28197,27045,1,24,12,3429,11,3331,12271,1,0,-1,0,6
EUW1_6881520737',4,31,13,1,0,1,0,6,1,370,93,28498,28308,28592,1,22,11,1,0,0,0,8,375,90,27377,28484,30683,0,-5,3,1121,2,-176,-2091,0,0,1,0,-2
EUW1_6879617158',2,30,9,0,0,0,0,11,0,362,86,26843,27988,32980,3,26,21,2,0,1,0,2,375,91,31906,32570,33058,0,-13,-5,-5063,-12,-4582,-78,-2,0,-1,0,9
EUW1_6878382204',4,90,7,1,0,0,0,9,1,330,93,24788,29117,20371,4,25,7,1,0,1,0,1,432,96,26937,31588,27159,1,-102,-3,-2149,0,-2471,-6788,0,0,-1,0,8
EUW1_6878213935',3,29,13,1,0,0,0,4,1,333,84,27168,27749,39736,7,29,12,1,0,0,0,3,363,76,27320,28540,31748,1,-30,8,-152,1,-791,7988,0,0,0,0,1
EUW1_6878000430',3,34,3,0,0,0,0,9,0,391,90,23961,27848,15578,5,28,10,1,0,2,0,4,401,106,28687,30602,22894,0,-10,-16,-4726,-7,-2754,-7316,-1,0,-2,0,5
EUW1_6876605510',2,52,17,1,0,0,0,9,1,345,83,28859,29243,32342,6,26,13,0,0,0,0,2,374,62,27248,27330,32629,1,-29,21,1611,4,1913,-287,1,0,0,0,7
EUW1_6876150378',6,40,14,0,0,0,0,5,1,357,88,28958,29907,32747,6,36,15,1,0,0,0,5,382,98,29484,30284,40289,0,-25,-10,-526,-1,-377,-7542,-1,0,0,0,0
EUW1_6876108488',7,36,22,2,0,1,0,6,1,349,96,31475,30168,38772,2,26,11,0,0,1,0,4,299,90,26687,28428,39926,1,50,6,4788,11,1740,-1154,2,0,0,0,2
EUW1_6876032234',3,24,9,1,0,0,0,11,1,382,106,26955,30353,24989,6,25,17,1,1,2,0,3,412,82,30327,31626,33149,1,-30,24,-3372,-8,-1273,-8160,0,-1,-2,0,8
EUW1_6875978655',2,20,14,0,0,1,0,8,0,396,82,30090,30200,37044,6,35,14,2,0,1,0,6,318,98,27573,29365,33213,0,78,-16,2517,0,835,3831,-2,0,0,0,2
EUW1_6883191940',0,27,16,1,1,2,0,8,0,371,123,30574,32229,36061,1,23,5,0,0,1,0,7,357,96,24422,27308,29297,1,14,27,6152,11,4921,6764,1,1,1,0,1
EUW1_6882629484',1,37,14,1,0,1,0,13,1,361,71,29618,29566,29231,3,31,13,0,0,2,0,6,379,107,30546,31030,24976,0,-18,-36,-928,1,-1464,4255,1,0,-1,0,7
EUW1_6881993955',6,33,9,0,0,0,0,8,0,321,94,24735,29515,22799,3,26,9,0,0,0,0,2,375,101,26939,30125,33194,0,-54,-7,-2204,0,-610,-10395,0,0,0,0,6
EUW1_6881940515',6,42,9,1,0,1,0,6,1,393,110,28126,31712,26689,6,31,8,1,0,0,0,7,386,91,26693,30327,28475,1,7,19,1433,1,1385,-1786,0,0,1,0,-1
EUW1_6881871636',3,25,17,2,0,2,0,9,0,373,98,31202,31932,42200,1,25,12,0,0,0,0,6,358,80,27155,29159,30110,1,15,18,4047,5,2773,12090,2,0,2,0,3
EUW1_6881483602',4,28,14,0,0,0,0,8,0,382,82,29364,30315,31209,7,37,22,2,0,3,0,5,325,90,31503,31049,37595,0,57,-8,-2139,-8,-734,-6386,-2,0,-3,0,3
EUW1_6880902922',5,26,24,1,0,1,0,5,0,371,90,33680,33506,46074,2,29,17,1,0,0,0,10,297,105,28146,30086,36036,1,74,-15,5534,7,3420,10038,0,0,1,0,-5
EUW1_6880333876',3,24,13,1,1,2,0,10,1,363,98,30472,32665,38209,2,278,5,1,0,1,0,6,367,115,24084,29770,25141,1,-4,-17,6388,8,2895,13068,0,1,1,0,4
EUW1_6879928361',5,32,12,1,0,0,0,11,1,331,118,27163,28834,29208,4,30,11,1,1,1,0,3,401,96,29388,32284,38261,0,-70,22,-2225,1,-3450,-9053,0,-1,-1,0,8
EUW1_6879865249',9,32,11,0,0,1,0,13,0,363,78,27615,28478,26626,3,32,13,2,0,0,0,5,356,100,28465,30069,29261,1,7,-22,-850,-2,-1591,-2635,-2,0,1,0,8
EUW1_6873139429',5,62,11,0,0,0,0,7,0,369,70,27028,29859,31654,4,32,14,1,0,1,0,1,357,93,26294,29880,37586,0,12,-23,734,-3,-21,-5932,-1,0,-1,0,6
EUW1_6873084147',7,27,16,0,0,0,0,9,1,345,94,28252,28099,29229,2,24,11,2,0,1,0,8,358,96,27493,29015,29091,1,-13,-2,759,5,-916,138,-2,0,-1,0,1
EUW1_6872755932',2,26,14,0,0,1,0,9,1,359,121,29807,31565,34111,4,28,10,1,0,0,0,6,361,73,25549,29454,34754,1,-2,48,4258,4,2111,-643,-1,0,1,0,3
EUW1_6872702987',7,27,15,0,0,0,0,6,1,331,100,28216,29817,41233,4,28,13,2,0,0,0,4,354,98,27007,30550,31023,0,-23,2,1209,2,-733,10210,-2,0,0,0,2
EUW1_6872579633',2,26,13,1,0,1,0,10,1,399,96,28836,31735,23198,5,25,9,1,0,0,0,2,344,106,25729,29384,24376,1,55,-10,3107,4,2351,-1178,0,0,1,0,8
EUW1_6872532370',5,59,16,1,0,0,0,7,1,306,76,27615,29541,29618,3,56,11,0,0,1,0,1,368,115,28353,33373,31643,1,-62,-39,-738,5,-3832,-2025,1,0,-1,0,6
EUW1_6872506843',4,68,13,1,0,1,0,15,0,350,100,28083,31643,32931,6,103,11,1,0,2,0,1,354,84,28627,31314,30334,0,-4,16,-544,2,329,2597,0,0,-1,0,14
EUW1_6872678626',2,30,8,1,0,0,0,13,0,314,70,24928,26368,28088,4,38,17,0,0,2,0,4,365,98,29794,31689,37002,0,-51,-28,-4866,-9,-5321,-8914,1,0,-2,0,9
EUW1_6868917070',4,32,3,0,0,0,0,11,0,353,66,23374,26771,27166,4,29,24,1,0,2,0,3,342,106,32239,33166,39495,0,11,-40,-8865,-21,-6395,-12329,-1,0,-2,0,8
EUW1_6846364324',7,33,13,1,0,0,0,12,0,308,97,26792,27088,29740,3,20,24,1,0,1,0,2,339,69,31954,30744,39020,0,-31,28,-5162,-11,-3656,-9280,0,0,-1,0,10
EUW1_6882755271',2,26,21,0,0,0,0,12,1,279,102,30875,30100,47748,1,20,19,1,1,2,0,1,338,78,30460,30343,33700,0,-59,24,415,2,-243,14048,-1,-1,-2,0,11
EUW1_6880500491',3,26,20,1,0,1,0,10,1,402,91,34241,33964,42395,1,41,10,1,0,1,0,4,368,95,25638,28574,36449,1,34,-4,8603,10,5390,5946,0,0,0,0,6
EUW1_6876942400',4,29,11,0,1,3,0,5,0,376,104,30314,29555,37207,2,25,13,2,0,1,0,9,379,76,28179,29202,35191,0,-3,28,2135,-2,353,2016,-2,1,2,0,-4
EUW1_6875995472',2,25,12,1,0,1,0,8,0,372,95,27950,30513,33913,5,94,11,1,0,1,0,5,352,81,28332,30234,42197,0,20,14,-382,1,279,-8284,0,0,0,0,3
EUW1_6875932113',3,23,6,0,0,0,0,12,1,350,77,24596,27459,23448,5,27,18,1,0,2,0,4,369,89,30929,32107,38468,0,-19,-12,-6333,-12,-4648,-15020,-1,0,-2,0,8
EUW1_6875828977',2,29,8,0,0,0,0,11,1,294,71,25147,27204,33860,6,30,20,2,0,2,0,4,370,113,31171,32420,44579,0,-76,-42,-6024,-12,-5216,-10719,-2,0,-2,0,7
EUW1_6874432523',3,23,18,1,1,1,0,11,1,375,108,32077,31403,36767,3,25,9,1,0,1,0,1,397,79,26674,29318,30151,1,-22,29,5403,9,2085,6616,0,1,0,0,10
EUW1_6883714838',3,31,15,1,0,1,0,12,1,366,87,29956,30160,33279,7,32,9,0,0,3,0,2,377,104,28760,29489,29103,0,-11,-17,1196,6,671,4176,1,0,-2,0,10
EUW1_6881273282',3,62,12,0,0,1,0,10,1,330,111,28243,29671,33159,4,62,20,2,0,2,0,2,363,88,32416,32130,40580,0,-33,23,-4173,-8,-2459,-7421,-2,0,-1,0,8
EUW1_6880892703',8,33,21,2,0,3,0,6,1,394,104,35079,33274,40133,0,29,11,0,0,1,0,8,306,84,25790,27530,32415,1,88,20,9289,10,5744,7718,2,0,2,0,-2
EUW1_6880882506',5,27,11,0,0,0,0,12,1,313,91,26650,26388,35906,3,26,20,0,0,3,0,0,359,99,33070,32211,44417,0,-46,-8,-6420,-9,-5823,-8511,0,0,-3,0,12
EUW1_6880865827',1,21,7,0,0,0,0,15,0,329,101,25581,28306,19007,1,22,16,2,1,5,0,0,429,113,34512,34228,35063,0,-100,-12,-8931,-9,-5922,-16056,-2,-1,-5,0,15
EUW1_6880489080',4,68,12,1,0,0,0,6,1,399,94,28883,28932,34914,5,32,7,0,0,0,0,5,301,86,23728,26543,25808,0,98,8,5155,5,2389,9106,1,0,0,0,1
EUW1_6880428407',6,37,22,0,0,3,0,7,1,349,94,33212,28987,39737,5,47,15,2,0,0,0,9,300,96,27816,27890,33235,1,49,-2,5396,7,1097,6502,-2,0,3,0,-2
EUW1_6879415570',5,50,13,2,0,0,0,5,0,396,94,27961,31483,32473,6,133,9,0,0,0,0,2,373,94,27111,29247,26745,1,23,0,850,4,2236,5728,2,0,0,0,3
EUW1_6878434049',4,27,13,1,0,0,0,13,0,324,95,28304,28475,34794,6,33,23,1,0,1,0,2,371,60,32713,30308,45701,0,-47,35,-4409,-10,-1833,-10907,0,0,-1,0,11
EUW1_6873066357',5,55,19,0,0,1,0,15,0,265,69,28598,27085,44084,2,21,18,1,0,1,0,4,322,97,30753,29556,44992,0,-57,-28,-2155,1,-2471,-908,-1,0,0,0,11
EUW1_6872943327',2,25,22,2,0,0,0,10,1,394,75,31323,32632,48556,0,37,15,0,0,1,0,3,312,82,27182,29380,31520,1,82,-7,4141,7,3252,17036,2,0,-1,0,7
EUW1_6866542981',0,24,10,0,0,0,0,14,0,377,84,25720,29636,31832,2,26,18,2,0,2,0,2,383,100,31813,33465,45825,0,-6,-16,-6093,-8,-3829,-13993,-2,0,-2,0,12
EUW1_6883574685',5,31,7,1,1,1,0,10,1,376,97,25026,28628,20025,2,52,8,1,0,1,0,3,378,110,26565,30874,24935,1,-2,-13,-1539,-1,-2246,-4910,0,1,0,0,7
EUW1_6863535140',4,29,12,0,0,0,0,10,0,382,88,26674,30398,27603,4,25,8,1,0,1,0,3,426,81,28091,31216,27317,0,-44,7,-1417,4,-818,286,-1,0,-1,0,7
EUW1_6883757243',2,21,14,1,0,1,0,11,0,355,88,28623,30994,35152,3,28,15,0,0,1,0,3,371,87,29395,31574,37406,1,-16,1,-772,-1,-580,-2254,1,0,0,0,8
EUW1_6883746559',5,149,7,0,0,2,0,8,0,358,101,26184,28359,23492,5,99,12,2,0,0,0,7,320,90,26285,29347,23747,1,38,11,-101,-5,-988,-255,-2,0,2,0,1
EUW1_6883714443',7,33,10,0,0,0,0,11,1,400,100,28142,30483,18443,6,25,9,2,0,0,0,3,386,96,27182,30696,24248,0,14,4,960,1,-213,-5805,-2,0,0,0,8
EUW1_6883712742',3,32,5,1,0,0,0,10,1,315,78,21851,27627,16007,5,31,12,1,1,1,0,2,384,125,28835,33410,31221,0,-69,-47,-6984,-7,-5783,-15214,0,-1,-1,0,8
EUW1_6881980969',6,28,17,1,0,2,0,6,0,363,90,31049,31796,33662,1,22,8,0,0,0,0,8,318,80,23844,26749,26914,1,45,10,7205,9,5047,6748,1,0,2,0,-2
EUW1_6881863943',2,27,4,0,0,1,0,13,0,340,80,23917,27657,26953,4,33,20,2,1,1,0,2,418,96,32071,33479,40392,0,-78,-16,-8154,-16,-5822,-13439,-2,-1,0,0,11
EUW1_6881794798',6,31,15,0,0,0,0,10,1,343,76,27774,29173,33174,7,29,15,2,0,0,0,2,381,87,29733,30201,38875,0,-38,-11,-1959,0,-1028,-5701,-2,0,0,0,8
EUW1_6881732365',7,23,16,2,0,1,0,5,1,378,100,30790,30701,30449,5,53,8,0,0,2,0,8,359,82,26238,29144,28914,1,19,18,4552,8,1557,1535,2,0,-1,0,-3
EUW1_6881521704',3,26,12,1,0,1,0,6,0,390,101,28348,30748,36120,5,30,9,1,0,0,0,8,334,70,24932,27276,25399,1,56,31,3416,3,3472,10721,0,0,1,0,-2
EUW1_6881458120',5,46,15,0,0,0,0,12,0,362,100,28901,30459,39269,2,42,14,1,0,2,0,5,349,84,28699,29677,31954,0,13,16,202,1,782,7315,-1,0,-2,0,7
EUW1_6881386628',1,29,12,2,0,0,0,6,1,362,102,26887,30151,32899,6,31,13,0,0,0,0,3,311,93,26434,30587,29376,0,51,9,453,-1,-436,3523,2,0,0,0,3
EUW1_6881321249',7,30,13,0,0,0,0,5,0,378,95,27555,32321,31088,4,33,13,2,0,0,0,4,347,94,28638,30230,32196,0,31,1,-1083,0,2091,-1108,-2,0,0,0,1
EUW1_6880116605',1,25,11,1,0,0,0,13,0,332,102,27165,28942,33953,7,41,23,0,0,2,0,2,361,90,32254,31756,42496,1,-29,12,-5089,-12,-2814,-8543,1,0,-2,0,11
EUW1_6880071596',3,29,13,2,0,1,0,5,1,444,96,30464,33833,32856,1,25,6,0,0,1,0,7,400,83,25330,29216,18950,1,44,13,5134,7,4617,13906,2,0,0,0,-2
EUW1_6880013980',3,27,7,0,0,0,0,13,0,330,77,23523,27052,32248,3,55,18,1,0,2,0,0,346,74,29998,30292,40163,0,-16,3,-6475,-11,-3240,-7915,-1,0,-2,0,13
EUW1_6879952213',5,24,10,0,0,0,0,10,1,380,88,26436,29062,26634,6,42,15,1,0,2,0,3,369,76,29742,29831,32879,1,11,12,-3306,-5,-769,-6245,-1,0,-2,0,7
EUW1_6879895325',6,32,12,0,0,1,0,7,0,371,77,28582,29720,33259,1,53,11,1,0,1,0,7,352,65,26262,27398,28938,1,19,12,2320,1,2322,4321,-1,0,0,0,0
EUW1_6879833172',2,29,12,1,0,0,0,11,1,337,78,27267,28127,29737,2,28,20,1,0,1,0,5,363,86,31528,31314,48490,0,-26,-8,-4261,-8,-3187,-18753,0,0,-1,0,6
EUW1_6879775238',7,70,11,1,0,0,0,6,1,352,81,26584,29638,30712,4,62,21,0,0,1,0,2,409,97,31531,33927,37142,0,-57,-16,-4947,-10,-4289,-6430,1,0,-1,0,4
EUW1_6879726142',1,31,3,0,0,0,0,6,1,379,76,22530,26469,21258,6,44,7,2,0,0,0,3,387,98,24706,28557,17361,0,-8,-22,-2176,-4,-2088,3897,-2,0,0,0,3
EUW1_6879694394',2,36,6,0,0,0,0,11,0,357,67,23019,27967,19507,4,29,16,2,0,2,0,3,420,83,30491,32353,31725,0,-63,-16,-7472,-10,-4386,-12218,-2,0,-2,0,8
EUW1_6879662547',3,31,10,1,0,0,0,13,0,342,71,25660,28533,33694,9,105,17,1,1,2,0,3,379,91,30926,33045,40423,0,-37,-20,-5266,-7,-4512,-6729,0,-1,-2,0,10
EUW1_6877338817',3,30,10,0,0,2,0,8,0,381,84,28164,29253,30165,6,53,14,2,0,1,0,6,334,122,28068,32286,30359,0,47,-38,96,-4,-3033,-194,-2,0,1,0,2
EUW1_6876981266',7,42,18,1,0,2,0,9,1,368,108,32200,30722,35012,5,33,16,1,0,0,0,10,309,75,28060,28034,32290,1,59,33,4140,2,2688,2722,0,0,2,0,-1
EUW1_6876945616',8,32,11,0,0,1,0,11,0,395,84,26878,29060,25862,6,50,11,1,0,2,0,5,391,84,29157,30668,29524,0,4,0,-2279,0,-1608,-3662,-1,0,-1,0,6
EUW1_6876897100',6,61,21,1,0,0,0,6,1,309,76,30643,29066,38456,2,54,17,0,0,0,0,5,329,54,28620,26996,36933,1,-20,22,2023,4,2070,1523,1,0,0,0,1
EUW1_6876854113',4,28,21,2,0,2,0,10,1,346,88,32314,30792,39391,3,22,15,0,0,1,0,6,307,100,29703,28323,39920,1,39,-12,2611,6,2469,-529,2,0,1,0,4
EUW1_6876307920',0,26,6,0,0,0,0,14,1,304,89,23185,27684,19928,0,23,16,1,0,3,0,2,404,98,31828,33371,44042,0,-100,-9,-8643,-10,-5687,-24114,-1,0,-3,0,12
EUW1_6879292788',3,37,14,1,0,0,0,7,1,383,83,27908,30456,29679,6,27,10,0,1,0,0,4,324,99,25978,27471,28622,0,59,-16,1930,4,2985,1057,1,-1,0,0,3
EUW1_6877630128',1,23,19,2,1,2,0,7,1,352,102,32021,31404,33495,1,20,12,0,0,2,0,11,359,110,28735,30655,28339,0,-7,-8,3286,7,749,5156,2,1,0,0,-4
EUW1_6877442128',5,29,16,1,0,2,0,17,0,327,84,30291,29627,31429,5,28,20,1,1,3,0,6,374,80,33441,31562,31195,1,-47,4,-3150,-4,-1935,234,0,-1,-1,0,11
EUW1_6875524353',4,39,6,0,0,1,0,4,0,413,84,26267,30430,27114,1,24,8,2,0,0,0,1,418,95,25343,30466,22368,0,-5,-11,924,-2,-36,4746,-2,0,1,0,3
EUW1_6875488629',5,27,9,1,1,0,0,12,0,366,90,26577,28009,32704,2,170,17,1,0,2,0,3,349,90,29650,31369,32728,1,17,0,-3073,-8,-3360,-24,0,1,-2,0,9
EUW1_6875445939',2,25,9,0,0,2,0,10,1,398,80,28368,29515,24515,4,27,9,1,1,1,0,4,358,96,26534,30412,23868,1,40,-16,1834,0,-897,647,-1,-1,1,0,6
EUW1_6875404097',4,27,10,0,0,0,0,11,0,362,104,26536,30086,27092,3,26,14,2,0,1,0,0,346,74,28381,28793,32623,0,16,30,-1845,-4,1293,-5531,-2,0,-1,0,11
EUW1_6871960757',3,31,9,0,0,1,0,6,0,391,88,27211,29240,24068,5,169,14,2,1,1,0,5,366,77,28523,30709,28867,0,25,11,-1312,-5,-1469,-4799,-2,-1,0,0,1
EUW1_6871879019',2,32,16,1,1,1,0,6,1,373,98,29871,30689,32325,0,24,7,0,0,0,0,2,402,59,23934,27879,27058,1,-29,39,5937,9,2810,5267,1,1,1,0,4
EUW1_6871808571',1,23,15,2,0,0,0,7,1,346,92,28840,30248,28586,3,137,12,0,0,2,0,3,367,91,28483,29713,42784,0,-21,1,357,3,535,-14198,2,0,-2,0,4
EUW1_6871733671',2,25,12,1,0,0,0,7,1,337,78,25484,28156,34869,2,22,13,1,0,0,0,1,374,94,27812,30325,38860,0,-37,-16,-2328,-1,-2169,-3991,0,0,0,0,6
EUW1_6871647157',5,34,16,0,0,1,0,10,1,331,96,29516,29988,33162,4,28,17,1,0,2,0,5,340,70,28909,30609,35282,0,-9,26,607,-1,-621,-2120,-1,0,-1,0,5
EUW1_6871573293',2,26,15,0,0,0,0,13,1,337,101,28156,30916,30574,6,27,10,2,0,1,0,6,356,103,26463,29658,36773,1,-19,-2,1693,5,1258,-6199,-2,0,-1,0,7
EUW1_6867962942',7,36,13,0,0,0,0,10,0,321,89,28656,27534,34215,4,24,20,2,0,2,0,5,358,66,31159,30617,37972,0,-37,23,-2503,-7,-3083,-3757,-2,0,-2,0,5
EUW1_6867931270',1,23,4,0,0,0,0,10,0,314,81,21527,24962,24830,5,32,17,2,0,1,0,2,388,106,31155,31759,34461,0,-74,-25,-9628,-13,-6797,-9631,-2,0,-1,0,8
EUW1_6867880886',3,27,10,0,1,0,0,6,1,383,106,26882,30854,24506,4,30,11,2,0,0,0,0,347,86,25332,28887,27035,1,36,20,1550,-1,1967,-2529,-2,1,0,0,6
EUW1_6866926162',1,26,10,0,0,2,0,4,0,359,91,27718,28467,32469,3,46,11,1,0,0,0,4,330,104,26001,26788,27140,1,29,-13,1717,-1,1679,5329,-1,0,2,0,0
EUW1_6866854598',2,25,8,1,0,0,0,10,1,375,80,26788,28493,27304,5,28,14,1,0,1,0,0,396,88,28467,30091,31603,1,-21,-8,-1679,-6,-1598,-4299,0,0,-1,0,10
EUW1_6866798522',1,120,6,0,0,0,0,7,0,338,78,24830,25783,28744,7,86,20,2,0,0,0,5,305,78,28152,29400,36604,0,33,0,-3322,-14,-3617,-7860,-2,0,0,0,2
EUW1_6879366311',2,27,12,0,0,0,0,11,0,356,94,26297,31504,29021,2,28,11,1,0,0,0,0,371,90,27908,30974,29468,1,-15,4,-1611,1,530,-447,-1,0,0,0,11
EUW1_6877944062',7,27,8,0,0,0,0,7,1,354,124,25537,30663,20218,2,43,5,1,0,1,0,3,355,74,23669,27496,21011,0,-1,50,1868,3,3167,-793,-1,0,-1,0,4
EUW1_6877927294',2,29,12,0,0,0,0,6,1,383,67,26852,29358,32933,3,36,10,1,0,1,0,5,355,84,25605,28785,32665,1,28,-17,1247,2,573,268,-1,0,-1,0,1
EUW1_6877918890',4,26,13,0,0,0,0,11,0,334,68,26752,28802,34893,6,26,6,1,0,3,0,1,371,86,25383,28708,35077,0,-37,-18,1369,7,94,-184,-1,0,-3,0,10
EUW1_6876441349',4,28,24,1,0,4,0,7,0,365,103,34475,32214,39216,1,22,12,0,0,1,0,11,279,82,25105,27060,24975,1,86,21,9370,12,5154,14241,1,0,3,0,-4
EUW1_6876441516',2,224,8,1,0,0,0,11,0,327,68,24319,27171,35350,2,31,14,1,0,1,0,2,360,120,28864,33091,36230,0,-33,-52,-4545,-6,-5920,-880,0,0,-1,0,9
EUW1_6875023223',7,21,13,0,0,0,0,9,1,339,83,27511,27673,32233,3,29,19,2,0,1,0,1,373,80,30489,32164,38659,0,-34,3,-2978,-6,-4491,-6426,-2,0,-1,0,8
EUW1_6874999351',6,31,17,2,0,0,0,10,1,389,76,31581,30192,37515,4,25,14,0,0,1,0,4,373,100,29366,29945,32271,0,16,-24,2215,3,247,5244,2,0,-1,0,6
EUW1_6874934564',5,34,18,1,0,1,0,11,1,327,109,30810,29814,38525,3,22,16,1,0,1,0,7,342,74,28398,29050,32142,0,-15,35,2412,2,764,6383,0,0,0,0,4
EUW1_6874829115',8,32,11,0,0,0,0,3,1,324,87,25389,26370,29349,3,27,14,2,0,0,0,3,336,83,27828,30301,36403,0,-12,4,-2439,-3,-3931,-7054,-2,0,0,0,0
EUW1_6874757006',11,32,7,1,0,0,0,5,0,363,88,25683,27767,30551,2,23,18,1,0,2,0,5,364,91,30419,32020,34885,0,-1,-3,-4736,-11,-4253,-4334,0,0,-2,0,0
EUW1_6874695684',5,33,13,1,0,1,0,6,1,356,104,28459,30730,31358,7,32,9,1,0,1,0,7,328,80,25570,30588,28261,0,28,24,2889,4,142,3097,0,0,0,0,-1
EUW1_6872157948',3,28,12,1,0,0,0,8,1,338,87,26989,30594,36679,9,29,9,0,1,0,0,1,343,108,25031,29590,31910,0,-5,-21,1958,3,1004,4769,1,-1,0,0,7
EUW1_6862134636',0,21,14,1,0,0,0,13,0,345,104,28298,28946,38598,4,32,26,0,0,2,0,0,354,58,33765,29712,46039,0,-9,46,-5467,-12,-766,-7441,1,0,-2,0,13
EUW1_6862039716',3,27,9,0,0,0,0,7,0,315,96,24974,28192,28103,2,26,15,2,0,1,0,4,382,76,28889,30117,32575,0,-67,20,-3915,-6,-1925,-4472,-2,0,-1,0,3
EUW1_6862026144',3,34,10,2,0,0,0,11,1,287,68,24746,24885,32558,6,57,20,0,0,2,0,1,359,99,31479,32341,38819,0,-72,-31,-6733,-10,-7456,-6261,2,0,-2,0,10
EUW1_6862020858',5,31,17,0,1,4,0,5,0,373,82,32290,32186,36840,3,31,10,2,0,0,0,12,291,96,25296,29728,23638,1,82,-14,6994,7,2458,13202,-2,1,4,0,-7
EUW1_6862014562',4,32,9,1,0,1,0,11,1,358,84,27234,28566,21224,5,27,12,1,0,2,0,6,416,99,29824,30606,27464,0,-58,-15,-2590,-3,-2040,-6240,0,0,-1,0,5
EUW1_6861984454',3,23,22,2,0,0,0,11,1,315,100,31251,29236,46009,7,30,16,0,0,0,0,2,357,67,28272,28841,36744,1,-42,33,2979,6,395,9265,2,0,0,0,9
EUW1_6861637175',6,29,17,1,0,1,0,11,0,347,77,29665,30255,37066,6,27,20,1,0,1,0,5,352,65,30231,28053,35195,0,-5,12,-566,-3,2202,1871,0,0,0,0,6
EUW1_6860557705',2,42,7,0,0,1,0,6,1,398,114,26451,31381,21751,2,96,3,2,0,0,0,5,380,113,24533,31199,24948,1,18,1,1918,4,182,-3197,-2,0,1,0,1
EUW1_6860436273',4,38,23,0,0,2,0,10,1,344,92,32598,30174,40375,2,29,18,1,1,2,0,9,376,104,33508,33338,33951,1,-32,-12,-910,5,-3164,6424,-1,-1,0,0,1
EUW1_6860358008',4,160,4,1,0,1,0,5,1,438,87,26235,30838,20965,2,26,5,1,0,0,0,4,382,111,24568,29862,22970,1,56,-24,1667,-1,976,-2005,0,0,1,0,1
EUW1_6860293184',7,28,20,1,0,0,0,16,1,289,94,29959,29329,36000,1,30,19,1,0,3,0,1,377,98,33035,32347,44560,0,-88,-4,-3076,1,-3018,-8560,0,0,-3,0,15
EUW1_6860227101',6,26,9,1,0,0,0,8,1,392,78,26100,29484,24166,6,150,10,1,0,1,0,3,400,101,28262,30705,31534,0,-8,-23,-2162,-1,-1221,-7368,0,0,-1,0,5
EUW1_6860169394',4,31,12,2,0,0,0,11,1,327,80,27142,28053,28799,3,25,13,0,0,1,0,3,384,92,29216,30562,37422,0,-57,-12,-2074,-1,-2509,-8623,2,0,-1,0,8
EUW1_6860064541',4,37,21,1,0,1,0,8,1,343,120,32443,31607,44628,0,45,11,0,0,0,0,2,322,60,25497,28669,26759,1,21,60,6946,10,2938,17869,1,0,1,0,6
EUW1_6859973420',0,23,19,1,0,2,0,10,1,340,104,31590,30932,35122,1,23,11,0,0,1,0,7,282,71,24896,27079,32711,1,58,33,6694,8,3853,2411,1,0,1,0,3
EUW1_6859920368',4,26,15,1,0,1,0,14,0,380,92,31509,31008,32766,1,28,8,0,0,2,0,6,324,92,25831,27737,28665,1,56,0,5678,7,3271,4101,1,0,-1,0,8
EUW1_6859881860',3,41,12,2,0,1,0,6,1,372,95,28085,29802,31610,4,27,10,0,0,0,0,6,360,86,25583,29227,29116,1,12,9,2502,2,575,2494,2,0,1,0,0
EUW1_6864286358',4,41,5,0,0,0,0,15,0,314,63,21954,25812,21571,2,133,26,2,1,3,0,1,400,136,36405,34958,41897,0,-86,-73,-14451,-21,-9146,-20326,-2,-1,-3,0,14
EUW1_6864214211',4,137,12,2,1,3,0,10,0,355,82,27931,29871,27600,1,39,8,0,0,1,0,7,350,78,25362,29087,25424,1,5,4,2569,4,784,2176,2,1,2,0,3
EUW1_6864146198',4,32,10,0,0,0,0,10,1,342,102,26986,30168,30320,5,31,14,2,0,1,0,2,361,98,27249,32014,35375,0,-19,4,-263,-4,-1846,-5055,-2,0,-1,0,8
EUW1_6864075792',7,37,7,1,0,1,0,10,0,352,76,24617,28268,38817,2,41,7,1,0,2,0,2,340,79,25837,27854,33154,0,12,-3,-1220,0,414,5663,0,0,-1,0,8
EUW1_6864000898',1,34,14,2,0,0,0,8,1,273,74,25087,28184,35899,2,26,10,0,0,1,0,1,309,102,26251,27639,29785,0,-36,-28,-1164,4,545,6114,2,0,-1,0,7
EUW1_6863525595',6,38,5,2,0,0,0,10,0,357,82,23300,27854,27861,1,29,10,0,0,1,0,2,356,69,26137,29445,26845,1,1,13,-2837,-5,-1591,1016,2,0,-1,0,8
EUW1_6863489186',6,35,13,1,0,0,0,6,1,348,77,27011,28108,28251,0,25,11,1,0,2,0,4,339,82,27595,28197,28835,0,9,-5,-584,2,-89,-584,0,0,-2,0,2
EUW1_6863454114',3,35,10,1,0,0,0,11,1,353,94,26815,28737,28155,6,37,12,0,1,2,0,2,367,94,29063,30841,34420,0,-14,0,-2248,-2,-2104,-6265,1,-1,-2,0,9
EUW1_6863094955',3,29,11,2,0,0,0,9,0,347,78,27860,28107,35427,4,39,15,0,0,1,0,7,286,88,27670,28253,31222,1,61,-10,190,-4,-146,4205,2,0,-1,0,2
EUW1_6863049900',3,37,7,0,0,0,0,8,1,388,70,24411,27893,26179,1,24,6,1,0,1,0,0,395,84,24964,29911,29436,0,-7,-14,-553,1,-2018,-3257,-1,0,-1,0,8
EUW1_6862992286',3,26,15,0,0,0,0,5,0,391,98,29590,31218,33105,3,26,6,2,0,0,0,2,335,76,23931,28114,26141,1,56,22,5659,9,3104,6964,-2,0,0,0,3
EUW1_6862885320',4,30,13,0,0,1,0,8,0,359,80,28683,29179,28823,3,31,9,2,0,1,0,4,367,88,28677,28980,34004,0,-8,-8,6,4,199,-5181,-2,0,0,0,4
EUW1_6862837236',3,36,15,0,0,0,0,11,0,281,88,27233,28148,38403,6,26,21,2,0,3,0,0,348,88,31855,29791,40345,0,-67,0,-4622,-6,-1643,-1942,-2,0,-3,0,11
EUW1_6862781744',2,25,10,0,0,0,0,8,0,364,75,25659,29344,32824,2,32,13,2,0,1,0,3,356,80,28271,29909,37785,1,8,-5,-2612,-3,-565,-4961,-2,0,-1,0,5
EUW1_6862733919',4,20,10,2,0,1,0,11,1,396,90,29995,29934,30736,4,27,9,0,0,3,0,7,274,93,24322,26424,30914,1,122,-3,5673,1,3510,-178,2,0,-2,0,4
EUW1_6862689336',8,274,14,2,1,0,0,11,0,317,79,25966,27783,38972,5,31,14,0,0,1,0,3,349,60,28098,28162,37429,1,-32,19,-2132,0,-379,1543,2,1,-1,0,8
EUW1_6862567019',4,32,20,1,1,2,0,6,1,318,122,33309,31043,35011,2,28,14,0,0,3,0,10,329,74,29096,28256,29605,1,-11,48,4213,6,2787,5406,1,1,-1,0,-4
EUW1_6862527697',3,69,11,0,0,2,0,8,0,340,90,28213,28745,25819,4,49,19,1,0,0,0,6,373,73,30515,30792,37490,0,-33,17,-2302,-8,-2047,-11671,-1,0,2,0,2
EUW1_6862474104',4,28,7,1,0,0,0,5,1,402,108,26192,30943,30774,9,33,5,1,0,0,0,3,391,91,24260,29901,22870,1,11,17,1932,2,1042,7904,0,0,0,0,2
EUW1_6862423270',5,29,4,1,0,1,0,6,0,412,93,25370,28807,20007,7,40,7,1,1,0,0,4,398,110,25834,31658,25592,0,14,-17,-464,-3,-2851,-5585,0,-1,1,0,2
EUW1_6873975886',2,17,16,1,0,6,2,4,1,371,74,31607,28847,29322,1,21,6,0,0,2,0,11,241,67,20779,21057,16315,1,130,7,10828,10,7790,13007,1,0,4,2,-7
EUW1_6873945598',3,17,5,0,0,0,0,15,0,326,66,22906,25282,21419,4,31,18,1,1,3,0,4,402,114,31660,32611,35365,0,-76,-48,-8754,-13,-7329,-13946,-1,-1,-3,0,11
EUW1_6873905090',1,46,16,0,1,0,0,13,1,374,74,29790,30818,35942,2,22,12,1,0,3,0,1,372,79,28531,29136,31992,1,2,-5,1259,4,1682,3950,-1,1,-3,0,12
EUW1_6873845290',1,19,5,1,1,0,0,15,0,363,80,23299,28069,17617,6,28,13,1,0,2,0,4,342,92,29515,30278,32892,0,21,-12,-6216,-8,-2209,-15275,0,1,-2,0,11
EUW1_6873829953',5,39,19,2,1,3,0,6,1,365,88,31946,31601,42853,2,25,8,0,0,0,0,10,310,99,24630,26439,26337,1,55,-11,7316,11,5162,16516,2,1,3,0,-4
EUW1_6873809604',4,33,11,0,0,0,0,11,0,388,76,26636,29057,29371,4,27,11,2,0,0,0,2,353,92,26383,28463,37211,1,35,-16,253,0,594,-7840,-2,0,0,0,9
EUW1_6873773467',6,35,22,0,0,1,0,7,1,321,101,31501,31131,42741,1,31,10,1,0,0,0,5,310,94,26276,27819,32108,1,11,7,5225,12,3312,10633,-1,0,1,0,2
EUW1_6873733014',5,41,19,0,0,1,0,6,1,365,93,31262,32494,33347,2,30,7,1,0,0,0,4,342,54,23363,26750,31521,1,23,39,7899,12,5744,1826,-1,0,1,0,2
EUW1_6873718433',5,34,14,1,0,1,0,7,0,391,72,29205,30244,25947,2,25,7,0,0,2,0,7,341,90,25810,30113,23438,1,50,-18,3395,7,131,2509,1,0,-1,0,0
EUW1_6873629022',3,26,14,1,0,1,0,10,0,376,81,28688,31122,33551,3,25,7,0,1,1,0,4,373,92,26367,28912,23600,1,3,-11,2321,7,2210,9951,1,-1,0,0,6
EUW1_6873497136',4,24,13,2,0,0,0,8,0,321,88,27757,30340,32270,1,33,12,0,0,1,0,2,352,82,26488,27241,32831,0,-31,6,1269,1,3099,-561,2,0,-1,0,6
EUW1_6873443336',1,28,15,1,0,0,0,13,0,267,57,26293,25559,42464,2,28,28,1,0,2,0,2,336,91,34234,29936,47820,0,-69,-34,-7941,-13,-4377,-5356,0,0,-2,0,11
EUW1_6883668181',1,21,9,0,0,1,0,2,0,388,106,27895,31114,24657,2,27,10,2,0,0,0,5,345,86,24865,28284,30968,0,43,20,3030,-1,2830,-6311,-2,0,1,0,-3
EUW1_6883651230',2,19,12,0,0,1,0,17,0,298,99,27363,27291,31150,3,26,28,2,0,3,0,4,305,78,33385,29854,44708,0,-7,21,-6022,-16,-2563,-13558,-2,0,-2,0,13
EUW1_6883639857',2,95,14,0,0,0,0,13,0,320,48,26416,28051,31214,3,28,24,2,0,3,0,2,381,96,33895,30893,49346,0,-61,-48,-7479,-10,-2842,-18132,-2,0,-3,0,11
EUW1_6883610975',5,28,18,0,0,0,0,8,0,339,106,29322,31017,38796,4,30,12,0,0,0,0,1,345,98,27687,29026,33122,1,-6,8,1635,6,1991,5674,0,0,0,0,7
EUW1_6883562181',3,25,18,1,0,3,0,9,1,374,95,34083,30208,34816,3,98,9,0,0,0,0,10,298,92,25691,27666,27334,1,76,3,8392,9,2542,7482,1,0,3,0,-1
EUW1_6883522434',5,33,12,2,0,1,0,8,1,326,74,26361,27883,40823,4,32,15,0,0,0,0,3,362,74,28967,30141,36325,0,-36,0,-2606,-3,-2258,4498,2,0,1,0,5
EUW1_6882209862',5,30,28,0,0,1,0,8,0,349,74,32763,31709,45364,2,24,16,0,1,0,0,6,309,69,29663,28736,37473,1,40,5,3100,12,2973,7891,0,-1,1,0,2
EUW1_6881267228',4,29,12,0,1,1,0,8,0,375,76,27318,30390,29471,7,37,10,2,0,1,0,3,351,104,27779,29738,29373,1,24,-28,-461,2,652,98,-2,1,0,0,5
EUW1_6881111387',1,21,17,0,0,1,0,13,0,316,76,30083,27528,47831,4,28,20,1,0,2,0,7,298,96,31285,28521,41552,0,18,-20,-1202,-3,-993,6279,-1,0,-1,0,6
EUW1_6881078186',2,67,11,0,0,1,0,8,0,345,92,28154,30247,30473,5,62,16,2,1,0,0,6,368,86,28044,29926,38296,0,-23,6,110,-5,321,-7823,-2,-1,1,0,2
EUW1_6878843797',0,52,9,1,0,0,0,10,0,349,74,25413,29091,28553,0,55,12,1,0,1,0,3,362,121,29489,31737,32795,0,-13,-47,-4076,-3,-2646,-4242,0,0,-1,0,7
EUW1_6878762369',3,368,15,1,0,2,0,6,0,375,73,30059,30234,41425,3,52,17,0,1,0,0,3,345,102,29722,32381,36249,0,30,-29,337,-2,-2147,5176,1,-1,2,0,3
EUW1_6878721808',2,30,7,1,0,0,0,11,0,438,107,26053,31825,22246,4,233,4,1,1,1,0,2,399,115,25379,30945,17481,0,39,-8,674,3,880,4765,0,-1,-1,0,9
EUW1_6877966086',3,28,10,1,0,0,0,14,1,333,71,24997,27423,28688,6,28,14,1,1,3,0,1,363,115,29769,30490,36585,0,-30,-44,-4772,-4,-3067,-7897,0,-1,-3,0,13
EUW1_6877957619',1,25,6,1,0,1,0,8,0,393,116,26452,30097,33180,2,30,10,0,0,0,0,5,354,95,26425,29321,29958,1,39,21,27,-4,776,3222,1,0,1,0,3
EUW1_6883585837',2,54,11,0,0,1,0,10,0,395,95,29225,29873,31730,7,54,19,2,0,2,0,3,346,73,30440,29531,37547,0,49,22,-1215,-8,342,-5817,-2,0,-1,0,7
EUW1_6880748428',4,32,15,1,0,1,0,3,1,375,78,28780,29829,39276,4,28,13,1,0,0,0,10,318,80,25478,27912,33057,1,57,-2,3302,2,1917,6219,0,0,1,0,-7
EUW1_6880637866',3,26,14,0,0,1,0,15,0,333,82,29216,28449,35286,2,18,17,2,0,2,0,5,386,76,30988,30892,33967,1,-53,6,-1772,-3,-2443,1319,-2,0,-1,0,10
EUW1_6880603648',5,67,8,0,0,0,0,15,1,344,54,23872,26736,33319,4,77,15,1,0,5,0,0,416,106,33743,32907,43857,0,-72,-52,-9871,-7,-6171,-10538,-1,0,-5,0,15
EUW1_6880548635',5,22,17,0,0,1,0,10,0,374,96,30195,31750,33182,3,22,9,2,0,1,0,5,360,69,27163,26978,27729,1,14,27,3032,8,4772,5453,-2,0,0,0,5
EUW1_6872670980',3,26,24,2,0,2,0,6,1,389,100,34399,33140,44728,2,33,12,0,0,1,0,10,376,96,28538,30038,36864,1,13,4,5861,12,3102,7864,2,0,1,0,-4
EUW1_6865060018',3,29,9,0,0,0,0,14,0,351,86,25131,26747,29087,7,51,18,2,0,1,0,3,375,81,30279,32255,38738,0,-24,5,-5148,-9,-5508,-9651,-2,0,-1,0,11
EUW1_6865013095',9,31,27,1,1,0,0,7,0,363,73,31341,31641,40527,1,24,9,0,0,0,0,5,348,88,27852,28312,34425,1,15,-15,3489,18,3329,6102,1,1,0,0,2
EUW1_6864970427',3,59,11,0,0,0,0,16,0,332,88,27010,27707,29866,4,66,21,2,0,1,0,2,362,80,32051,30984,35233,0,-30,8,-5041,-10,-3277,-5367,-2,0,-1,0,14
EUW1_6864720659',4,30,21,1,0,0,0,9,1,342,90,30979,32602,41718,2,24,8,0,0,1,0,4,345,94,25293,28387,33484,1,-3,-4,5686,13,4215,8234,1,0,-1,0,5
EUW1_6859699235',4,34,14,1,0,2,0,6,1,394,82,31000,31388,33916,3,31,10,1,0,1,0,11,369,82,26209,31132,29869,1,25,0,4791,4,256,4047,0,0,1,0,-5
EUW1_6859667577',2,33,15,0,0,0,0,7,1,294,94,27231,29206,35801,5,37,12,1,0,2,0,4,364,86,27787,29080,34868,1,-70,8,-556,3,126,933,-1,0,-2,0,3
EUW1_6859624006',2,24,16,0,0,2,0,8,0,339,89,31204,28362,31257,3,30,15,2,0,0,0,5,305,105,28117,26799,32865,0,34,-16,3087,1,1563,-1608,-2,0,2,0,3
EUW1_6859595709',3,31,16,0,0,0,0,7,1,343,70,28698,29278,32935,3,35,9,1,0,1,0,5,355,106,26615,28167,30921,0,-12,-36,2083,7,1111,2014,-1,0,-1,0,2
EUW1_6859552051',4,26,17,0,1,0,0,12,0,343,91,29597,30814,42118,0,80,17,2,0,2,0,4,386,70,31084,29599,38165,0,-43,21,-1487,0,1215,3953,-2,1,-2,0,8
EUW1_6857914898',4,31,22,0,0,2,0,8,1,356,80,32528,31417,39834,6,36,9,1,0,2,0,9,287,76,26144,26818,28145,1,69,4,6384,13,4599,11689,-1,0,0,0,-1
EUW1_6881269654',3,32,12,1,0,0,0,11,1,351,68,27111,27941,34616,4,31,15,1,0,2,0,1,361,98,29969,29959,36190,0,-10,-30,-2858,-3,-2018,-1574,0,0,-2,0,10
EUW1_6881197452',1,50,20,2,0,3,0,9,0,281,119,31564,31169,41821,1,16,10,0,0,1,0,7,351,50,26217,26276,26396,1,-70,69,5347,10,4893,15425,2,0,2,0,2
EUW1_6881107641',6,38,10,0,0,1,0,8,1,348,108,28461,29409,28418,4,28,13,1,0,2,0,7,341,87,26993,29373,31517,1,7,21,1468,-3,36,-3099,-1,0,-1,0,1
EUW1_6881064838',3,30,12,1,0,1,0,11,1,382,78,28228,30610,34708,8,30,10,1,0,1,0,1,349,88,26424,29735,34259,0,33,-10,1804,2,875,449,0,0,0,0,10
EUW1_6881012303',1,25,14,0,0,0,0,11,0,321,67,27607,27133,32103,5,29,20,1,0,1,0,6,352,94,30281,31205,40159,0,-31,-27,-2674,-6,-4072,-8056,-1,0,-1,0,5
EUW1_6880031819',1,66,9,0,0,0,0,10,1,368,111,27155,30714,31629,2,124,15,1,0,2,0,2,387,68,28399,30190,34799,1,-19,43,-1244,-6,524,-3170,-1,0,-2,0,8
EUW1_6879996600',6,39,14,1,0,1,0,9,1,331,96,28604,29265,33402,1,35,13,1,0,0,0,7,344,87,26839,30069,30404,1,-13,9,1765,1,-804,2998,0,0,1,0,2
EUW1_6879954716',2,75,27,0,1,2,0,7,1,333,94,34033,33124,50529,3,25,13,1,0,0,0,11,344,74,27231,27589,36699,1,-11,20,6802,14,5535,13830,-1,1,2,0,-4
EUW1_6879486371',2,24,14,0,0,0,0,10,1,357,80,27584,30614,41681,4,30,8,1,0,0,0,0,326,100,25098,28824,32038,1,31,-20,2486,6,1790,9643,-1,0,0,0,10
EUW1_6879462220',4,27,13,0,0,0,0,14,0,344,70,26028,25379,40981,4,30,20,2,0,3,0,3,322,129,33375,32076,39892,0,22,-59,-7347,-7,-6697,1089,-2,0,-3,0,11
EUW1_6879433147',4,27,14,0,0,1,0,8,1,360,76,29190,30819,39847,5,98,16,1,0,1,0,6,327,98,29106,30104,39503,1,33,-22,84,-2,715,344,-1,0,0,0,2
EUW1_6879416805',2,37,8,0,0,1,0,10,0,331,84,25130,27309,28701,11,40,20,1,0,0,0,6,285,88,28627,29436,43271,0,46,-4,-3497,-12,-2127,-14570,-1,0,1,0,4
EUW1_6879369959',2,66,16,0,0,0,0,8,0,325,60,27529,31177,32117,2,53,11,0,0,0,0,1,365,96,27124,30361,36286,1,-40,-36,405,5,816,-4169,0,0,0,0,7
EUW1_6879353286',3,24,7,0,0,0,0,12,0,381,82,25185,28189,28585,1,51,18,1,0,3,0,3,378,74,30332,31699,33099,0,3,8,-5147,-11,-3510,-4514,-1,0,-3,0,9
EUW1_6875447060',2,27,9,0,0,0,0,11,0,356,84,24726,29253,26207,9,38,15,2,1,2,0,0,402,92,30639,31388,37681,0,-46,-8,-5913,-6,-2135,-11474,-2,-1,-2,0,11
EUW1_6875424459',7,58,19,1,0,5,0,5,1,385,108,35314,31765,36528,1,28,5,0,0,0,0,11,307,82,22763,25073,19253,1,78,26,12551,14,6692,17275,1,0,5,0,-6
EUW1_6875379400',5,26,17,2,0,1,0,4,1,335,84,29488,28646,40644,4,30,12,0,0,0,0,6,289,77,24964,25457,36448,1,46,7,4524,5,3189,4196,2,0,1,0,-2
EUW1_6875349080',3,32,9,1,0,0,0,7,0,417,75,28453,30227,29952,2,27,6,0,1,1,0,4,374,104,24613,28238,21534,1,43,-29,3840,3,1989,8418,1,-1,-1,0,3
EUW1_6875315664',2,34,14,0,1,2,0,7,1,389,112,30339,31815,30766,3,28,6,2,0,1,0,9,366,96,26617,27668,25766,1,23,16,3722,8,4147,5000,-2,1,1,0,-2
EUW1_6871474001',5,35,10,1,0,0,0,13,1,351,76,25814,28276,32131,5,37,16,1,1,3,0,1,401,126,30798,33961,35169,0,-50,-50,-4984,-6,-5685,-3038,0,-1,-3,0,12
EUW1_6871425157',2,27,9,0,1,0,0,10,0,347,70,25689,28348,35572,3,26,22,2,0,1,0,0,374,90,31918,31952,39805,0,-27,-20,-6229,-13,-3604,-4233,-2,1,-1,0,10
EUW1_6881207638',2,34,13,1,0,0,0,11,0,381,112,27618,30401,37996,8,35,17,1,0,0,0,4,323,96,29366,28656,34991,1,58,16,-1748,-4,1745,3005,0,0,0,0,7
EUW1_6881169331',3,26,12,0,0,0,0,13,0,330,74,27210,27472,33195,3,28,20,2,0,3,0,2,397,117,33933,32745,45016,0,-67,-43,-6723,-8,-5273,-11821,-2,0,-3,0,11
EUW1_6880855422',1,23,20,1,0,1,0,10,0,398,102,32629,31134,35042,4,32,12,1,0,1,0,5,355,48,26323,26756,26776,1,43,54,6306,8,4378,8266,0,0,0,0,5
EUW1_6880830136',6,33,26,1,1,3,0,10,0,411,127,37667,35912,50571,1,27,10,1,0,2,0,6,338,80,27065,29915,34920,1,73,47,10602,16,5997,15651,0,1,1,0,4
EUW1_6880829504',3,29,15,0,0,0,0,6,0,344,78,27386,28940,35483,3,96,7,1,0,0,0,3,328,80,23443,27028,28965,1,16,-2,3943,8,1912,6518,-1,0,0,0,3
EUW1_6880814212',2,49,12,0,0,0,0,12,1,317,80,27041,28646,33817,6,152,20,1,0,2,0,1,389,82,31653,30710,35414,0,-72,-2,-4612,-8,-2064,-1597,-1,0,-2,0,11
EUW1_6880794579',4,378,16,1,0,1,0,10,0,367,92,31073,31709,47319,6,34,13,1,0,1,0,5,363,76,27903,29989,36629,1,4,16,3170,3,1720,10690,0,0,0,0,5
EUW1_6880772955',4,29,15,0,0,2,0,10,0,407,94,30820,31295,40231,0,25,16,1,0,1,0,3,400,85,30372,32382,32002,0,7,9,448,-1,-1087,8229,-1,0,1,0,7
EUW1_6880751421',1,27,9,0,0,0,0,16,0,370,104,26346,31496,31854,5,77,11,1,0,3,0,3,390,110,29532,31731,35892,1,-20,-6,-3186,-2,-235,-4038,-1,0,-3,0,13
EUW1_6880730362',5,27,10,0,0,0,0,11,0,387,63,26065,29283,29457,1,29,11,1,0,3,0,1,410,119,30687,32941,34328,0,-23,-56,-4622,-1,-3658,-4871,-1,0,-3,0,10
EUW1_6880058595',5,30,17,1,1,1,0,12,1,385,71,32209,30758,41257,4,33,11,0,0,2,0,5,307,102,24675,27224,31261,1,78,-31,7534,6,3534,9996,1,1,-1,0,7
EUW1_6879879666',2,24,12,1,0,0,0,11,1,362,51,26338,26356,24688,3,29,9,0,0,1,0,2,400,83,26976,30301,29367,0,-38,-32,-638,3,-3945,-4679,1,0,-1,0,9
EUW1_6879452018',6,31,6,0,0,0,0,11,0,310,70,23298,26987,24344,6,31,17,2,0,1,0,3,370,98,30062,31151,37518,0,-60,-28,-6764,-11,-4164,-13174,-2,0,-1,0,8
EUW1_6879427376',4,59,9,1,0,0,0,10,0,367,65,26534,28658,26781,6,80,16,1,0,3,0,6,353,92,30952,30975,34126,0,14,-27,-4418,-7,-2317,-7345,0,0,-3,0,4
EUW1_6879417485',6,23,11,0,0,0,0,12,1,355,104,26329,29041,31465,3,36,10,2,0,1,0,0,370,80,27852,30534,29602,0,-15,24,-1523,1,-1493,1863,-2,0,-1,0,12
EUW1_6879378342',5,33,16,1,0,0,0,11,1,372,112,29677,31900,35666,4,26,7,1,0,3,0,1,352,95,24836,30025,28143,1,20,17,4841,9,1875,7523,0,0,-3,0,10
EUW1_6883436124',2,95,10,1,0,2,0,10,0,381,76,27362,30290,36992,1,34,8,0,0,1,0,8,337,68,25446,28221,31387,0,44,8,1916,2,2069,5605,1,0,1,0,2
EUW1_6883398205',5,64,20,1,1,2,0,9,1,417,125,33993,33748,42250,1,24,11,1,0,1,0,10,308,70,26401,27306,28382,1,109,55,7592,9,6442,13868,0,1,1,0,-1
EUW1_6883341198',9,73,20,0,0,1,0,8,1,333,78,31747,30458,39269,7,29,12,2,0,1,0,7,300,93,26041,27106,38775,1,33,-15,5706,8,3352,494,-2,0,0,0,1
EUW1_6882256954',9,38,15,1,0,0,0,7,1,360,98,29071,31231,37762,5,28,16,1,0,0,0,1,391,86,28487,31792,37638,0,-31,12,584,-1,-561,124,0,0,0,0,6
EUW1_6882171255',4,21,9,0,0,0,0,10,1,258,100,23205,26452,20747,3,194,12,1,0,3,0,0,408,72,29660,31158,33798,0,-150,28,-6455,-3,-4706,-13051,-1,0,-3,0,10
EUW1_6882134883',7,33,15,1,0,0,0,7,0,391,107,29869,31689,30500,5,30,9,0,0,0,0,2,395,100,27430,29975,28764,1,-4,7,2439,6,1714,1736,1,0,0,0,5
EUW1_6882068179',5,46,18,2,0,0,0,9,0,312,102,28036,28653,39974,4,44,20,0,0,1,0,1,342,74,31505,30290,36603,1,-30,28,-3469,-2,-1637,3371,2,0,-1,0,8
EUW1_6876504235',2,22,16,2,0,1,0,11,1,366,102,29933,30258,29216,2,26,9,0,0,0,0,3,343,89,25863,28267,29315,1,23,13,4070,7,1991,-99,2,0,1,0,8
EUW1_6875488759',2,30,18,0,0,1,0,12,1,355,86,30807,31126,37441,9,43,14,2,0,1,0,1,339,78,28814,29472,32306,0,16,8,1993,4,1654,5135,-2,0,0,0,11
EUW1_6875308143',1,26,8,1,0,0,0,11,1,365,103,25118,28739,21186,7,31,13,0,1,1,0,2,378,108,29348,31680,26403,0,-13,-5,-4230,-5,-2941,-5217,1,-1,-1,0,9
EUW1_6875210454',1,27,8,0,1,0,0,7,0,363,82,25601,28659,25374,5,27,23,2,0,1,0,2,392,94,30771,31801,38559,0,-29,-12,-5170,-15,-3142,-13185,-2,1,-1,0,5
EUW1_6875185579',1,23,8,0,0,0,0,12,0,363,106,24290,30044,22159,3,28,12,2,1,2,0,3,371,106,30155,30001,27614,0,-8,0,-5865,-4,43,-5455,-2,-1,-2,0,9
EUW1_6875142167',4,29,13,1,0,1,0,9,1,380,96,29983,31378,39517,2,54,7,0,0,2,0,4,357,96,25397,29598,29776,1,23,0,4586,6,1780,9741,1,0,-1,0,5
EUW1_6875121411',6,30,24,0,1,3,0,7,0,382,75,33755,31667,40667,0,24,15,2,0,0,0,10,318,88,28397,27575,29881,1,64,-13,5358,9,4092,10786,-2,1,3,0,-3
EUW1_6875091375',3,36,14,1,1,2,0,8,1,360,114,30932,30946,35724,2,26,11,1,0,1,0,6,345,88,26749,30816,33235,0,15,26,4183,3,130,2489,0,1,1,0,2
EUW1_6875047944',1,15,23,0,0,1,0,9,1,335,78,30291,31254,39055,3,26,6,0,0,0,0,2,318,76,23634,26811,24796,1,17,2,6657,17,4443,14259,0,0,1,0,7
EUW1_6874186493',7,31,8,0,1,1,0,13,0,366,82,25204,28586,24976,4,28,13,1,0,1,0,3,373,85,29082,29386,30580,1,-7,-3,-3878,-5,-800,-5604,-1,1,0,0,10
EUW1_6874122067',3,30,10,1,0,0,0,5,1,326,80,25766,27490,28723,3,20,13,1,0,2,0,0,343,72,27538,28193,38318,1,-17,8,-1772,-3,-703,-9595,0,0,-2,0,5
EUW1_6873933980',1,30,9,0,1,0,0,10,0,340,86,24958,29254,26978,6,31,9,1,0,0,0,1,356,90,26155,28684,31442,1,-16,-4,-1197,0,570,-4464,-1,1,0,0,9
EUW1_6873823185',2,25,19,0,0,1,0,5,0,357,90,30990,31874,43695,5,102,17,0,0,0,0,1,325,81,28942,27891,38111,1,32,9,2048,2,3983,5584,0,0,1,0,4
EUW1_6873804598',6,27,19,1,0,0,0,6,0,338,86,29017,31624,35396,1,93,15,1,0,0,0,3,368,73,29286,29859,40029,0,-30,13,-269,4,1765,-4633,0,0,0,0,3
EUW1_6873778632',6,66,13,0,1,1,0,5,1,333,108,28216,30038,27429,6,31,7,1,0,1,0,4,363,79,24610,27769,26599,1,-30,29,3606,6,2269,830,-1,1,0,0,1
EUW1_6873751661',2,35,19,0,0,1,0,7,1,340,91,30293,31885,40442,3,36,10,2,0,0,0,4,331,75,24869,28849,28231,0,9,16,5424,9,3036,12211,-2,0,1,0,3
EUW1_6872265068',4,26,17,2,0,0,0,7,0,335,100,28504,29360,31852,2,28,17,0,0,0,0,2,380,62,29679,30113,32453,0,-45,38,-1175,0,-753,-601,2,0,0,0,5
EUW1_6872239879',7,25,13,0,0,1,0,11,1,305,58,27662,26103,35747,0,141,33,1,0,1,0,3,312,58,33810,30000,52779,0,-7,0,-6148,-20,-3897,-17032,-1,0,0,0,8
EUW1_6872198560',5,27,17,2,0,0,0,13,1,378,88,31307,32001,39302,2,24,9,0,0,1,0,4,380,92,25575,28170,35524,1,-2,-4,5732,8,3831,3778,2,0,-1,0,9
EUW1_6872158865',3,17,13,1,0,0,0,4,0,370,93,28278,31042,30816,4,22,12,0,0,0,0,3,380,98,26627,29097,33519,0,-10,-5,1651,1,1945,-2703,1,0,0,0,1
EUW1_6872040824',4,24,9,2,0,0,0,10,1,323,96,24705,28160,41880,3,214,15,0,0,0,0,0,395,95,29191,33824,33778,0,-72,1,-4486,-6,-5664,8102,2,0,0,0,10
EUW1_6871960900',4,30,23,1,1,1,0,5,1,371,68,32040,29841,40412,6,31,12,0,0,0,0,7,310,58,25738,26812,34744,1,61,10,6302,11,3029,5668,1,1,1,0,-2
EUW1_6871653897',4,45,9,0,0,1,0,11,0,377,69,26459,28320,23419,8,30,14,2,0,1,0,2,395,95,30032,30720,26515,1,-18,-26,-3573,-5,-2400,-3096,-2,0,0,0,9
EUW1_6871592890',1,62,10,0,0,0,0,7,0,399,90,26901,30056,34292,6,65,16,1,0,0,0,3,364,82,29369,30277,29976,0,35,8,-2468,-6,-221,4316,-1,0,0,0,4
EUW1_6870911143',5,29,11,0,0,0,0,4,1,432,90,27259,31327,33634,10,35,13,1,0,0,0,2,373,106,27129,31742,27749,0,59,-16,130,-2,-415,5885,-1,0,0,0,2
EUW1_6870892699',11,51,9,0,0,1,0,8,0,354,99,28164,28714,26959,5,29,18,1,0,2,0,5,347,68,29706,29213,32367,0,7,31,-1542,-9,-499,-5408,-1,0,-1,0,3
EUW1_6870870074',5,63,10,0,0,0,0,11,0,339,70,27323,28679,34460,5,76,20,1,0,3,0,4,405,105,33488,33743,44218,0,-66,-35,-6165,-10,-5064,-9758,-1,0,-3,0,7
EUW1_6870851504',2,50,10,0,0,1,0,14,0,346,93,26947,30135,28101,4,25,13,2,1,0,0,1,349,110,28123,31649,34511,0,-3,-17,-1176,-3,-1514,-6410,-2,-1,1,0,13
EUW1_6870772738',5,28,17,1,0,2,0,9,1,333,68,29957,26503,40047,5,26,10,0,0,0,0,9,403,74,26639,28383,27126,0,-70,-6,3318,7,-1880,12921,1,0,2,0,0
EUW1_6870724458',2,24,13,1,0,0,0,10,1,338,100,27965,29311,35698,6,29,14,1,0,1,0,4,364,70,27253,31092,35361,1,-26,30,712,-1,-1781,337,0,0,-1,0,6
EUW1_6870638870',2,30,7,0,0,0,0,11,0,379,86,25863,28867,22133,4,27,15,2,0,2,0,2,414,94,31003,31797,30306,0,-35,-8,-5140,-8,-2930,-8173,-2,0,-2,0,9
EUW1_6870560321',5,34,10,0,0,0,0,10,1,345,90,26445,27198,27312,7,26,18,2,0,2,0,1,356,90,30928,30470,37327,1,-11,0,-4483,-8,-3272,-10015,-2,0,-2,0,9
EUW1_6870503799',4,58,19,1,0,0,0,6,1,427,69,31052,31613,39377,4,35,8,1,0,1,0,5,355,94,24958,27716,34945,1,72,-25,6094,11,3897,4432,0,0,-1,0,1
EUW1_6870103612',3,32,6,1,0,0,0,7,1,384,76,23554,28907,23081,5,38,8,0,0,0,0,0,364,75,25225,29292,26652,1,20,1,-1671,-2,-385,-3571,1,0,0,0,7
EUW1_6870035412',6,43,16,1,0,0,0,11,0,333,90,28107,29549,34545,7,29,19,0,1,1,0,2,356,74,30574,30774,41004,0,-23,16,-2467,-3,-1225,-6459,1,-1,-1,0,9
EUW1_6863486376',3,33,12,0,0,1,0,6,0,381,113,29695,31392,35547,5,40,12,1,0,0,0,3,383,102,28431,31393,28676,1,-2,11,1264,0,-1,6871,-1,0,1,0,3
EUW1_6883036907',3,62,17,0,1,0,0,7,1,340,82,29735,29458,39357,2,56,19,1,0,1,0,5,336,85,30904,31911,42214,0,4,-3,-1169,-2,-2453,-2857,-1,1,-1,0,2
EUW1_6878244017',3,52,10,0,0,0,0,9,0,349,69,27658,28992,37382,5,28,15,1,0,2,0,6,358,102,30511,29611,37279,1,-9,-33,-2853,-5,-619,103,-1,0,-2,0,3
EUW1_6875360991',4,19,17,2,0,1,0,8,0,363,89,31529,32028,37384,0,26,13,0,0,0,0,7,391,102,28157,32232,33083,0,-28,-13,3372,4,-204,4301,2,0,1,0,1
EUW1_6875131160',2,218,14,0,0,2,0,13,0,334,76,29296,29336,37194,1,23,15,2,0,1,0,5,338,88,29390,31343,37934,0,-4,-12,-94,-1,-2007,-740,-2,0,1,0,8
EUW1_6875114472',8,45,10,2,0,2,0,5,1,386,92,28405,29502,30163,4,24,5,0,0,0,0,3,332,92,24014,27837,27698,0,54,0,4391,5,1665,2465,2,0,2,0,2
EUW1_6875091407',6,21,11,1,0,1,0,6,0,388,68,27567,29590,32316,6,25,10,0,0,0,0,3,387,64,26404,28880,27933,0,1,4,1163,1,710,4383,1,0,1,0,3
EUW1_6874616842',2,20,11,1,0,2,0,6,0,341,92,27236,29727,31291,1,18,20,1,0,0,0,1,320,63,29257,28806,35134,1,21,29,-2021,-9,921,-3843,0,0,2,0,5
EUW1_6874515966',4,30,3,0,0,0,0,13,0,327,104,22210,26535,15334,7,31,10,1,0,3,0,1,377,116,28514,30727,24726,0,-50,-12,-6304,-7,-4192,-9392,-1,0,-3,0,12
EUW1_6874379908',3,40,15,1,0,1,0,9,0,356,83,28998,31949,28634,4,38,9,1,0,0,0,3,368,112,27295,29378,30684,1,-12,-29,1703,6,2571,-2050,0,0,1,0,6
EUW1_6874196504',6,28,12,1,0,1,0,10,1,346,98,27801,28969,35266,5,31,14,0,0,1,0,3,351,66,28742,27254,37156,1,-5,32,-941,-2,1715,-1890,1,0,0,0,7
EUW1_6874117673',6,31,14,0,0,0,0,6,0,325,74,26854,29428,31607,1,27,17,1,0,0,0,4,366,97,30387,31839,42121,0,-41,-23,-3533,-3,-2411,-10514,-1,0,0,0,2
EUW1_6874061453',2,37,14,2,0,0,0,7,0,375,78,28443,29091,29197,5,83,13,0,0,1,0,0,351,90,29467,29448,30854,1,24,-12,-1024,1,-357,-1657,2,0,-1,0,7
EUW1_6874033406',3,27,7,2,0,0,0,9,0,354,92,24316,27374,26289,6,35,16,0,0,3,0,1,370,92,31645,31297,41666,0,-16,0,-7329,-9,-3923,-15377,2,0,-3,0,8
EUW1_6873983141',4,27,11,2,1,1,0,17,1,359,99,27351,29402,27020,3,69,8,0,0,1,0,3,367,84,27774,27846,24544,0,-8,15,-423,3,1556,2476,2,1,0,0,14
EUW1_6873953827',3,25,10,0,0,0,0,5,1,347,97,26457,28959,27525,3,44,14,1,0,0,0,3,374,70,27355,30575,33555,0,-27,27,-898,-4,-1616,-6030,-1,0,0,0,2
EUW1_6873806164',1,27,25,1,1,2,0,7,1,334,94,33279,30872,44517,6,29,15,1,0,0,0,10,328,102,29544,30153,44960,0,6,-8,3735,10,719,-443,0,1,2,0,-3
EUW1_6873790377',4,23,23,2,1,3,0,5,1,385,90,33159,30029,35653,1,18,6,0,0,0,0,11,312,81,23978,25441,22072,1,73,9,9181,17,4588,13581,2,1,3,0,-6
EUW1_6873779956',8,33,14,0,0,0,0,10,1,357,84,27287,31296,27746,4,31,8,2,0,1,0,1,414,100,27724,31055,30949,0,-57,-16,-437,6,241,-3203,-2,0,-1,0,9
EUW1_6873768493',5,39,11,1,0,0,0,12,0,336,77,25622,28445,27044,8,29,14,0,0,2,0,1,406,90,30391,29913,38198,1,-70,-13,-4769,-3,-1468,-11154,1,0,-2,0,11
EUW1_6883746035',4,41,22,1,0,1,0,7,1,391,102,31678,31705,40176,8,35,11,1,0,0,0,7,336,77,27617,29951,33970,1,55,25,4061,11,1754,6206,0,0,1,0,0
EUW1_6882592932',5,22,26,0,0,1,0,11,1,386,69,33885,32103,49797,3,27,9,1,0,1,0,9,329,70,26178,27828,35079,1,57,-1,7707,17,4275,14718,-1,0,0,0,2
EUW1_6882526050',2,27,14,1,0,1,0,10,1,348,71,29426,28583,25690,4,50,12,1,0,1,0,5,370,120,29418,29845,31291,0,-22,-49,8,2,-1262,-5601,0,0,0,0,5
EUW1_6882506474',5,80,10,0,0,0,0,10,1,347,74,25682,28884,29596,7,31,12,1,0,2,0,1,401,82,29471,30467,38270,0,-54,-8,-3789,-2,-1583,-8674,-1,0,-2,0,9
EUW1_6882476825',6,35,13,1,0,1,0,5,1,357,84,28145,28709,29637,2,31,8,0,0,1,0,8,360,95,25896,28933,33037,1,-3,-11,2249,5,-224,-3400,1,0,0,0,-3
EUW1_6882450563',1,24,10,1,0,0,0,10,1,341,93,25996,29470,32083,4,28,10,1,0,0,0,1,379,93,25910,29933,31153,1,-38,0,86,0,-463,930,0,0,0,0,9
EUW1_6882050532',2,30,8,0,0,0,0,6,1,385,86,25450,28819,28026,1,30,7,1,0,0,0,2,379,82,24774,29352,23464,1,6,4,676,1,-533,4562,-1,0,0,0,4
EUW1_6881611501',7,27,16,2,0,0,0,10,0,370,70,27982,30625,31618,2,32,16,0,0,1,0,0,344,104,29188,30261,32882,1,26,-34,-1206,0,364,-1264,2,0,-1,0,10
EUW1_6881548075',2,74,16,1,0,0,0,6,1,375,75,29020,31596,43695,1,28,7,1,0,1,0,6,276,92,23957,28043,30572,1,99,-17,5063,9,3553,13123,0,0,-1,0,0
EUW1_6881456273',6,27,11,1,0,2,0,10,1,350,88,27687,27949,27886,3,27,17,1,0,2,0,8,365,92,30067,31073,34435,0,-15,-4,-2380,-6,-3124,-6549,0,0,0,0,2
EUW1_6881347546',5,31,18,2,0,2,0,14,0,388,104,30941,30246,35684,6,30,12,0,0,1,0,2,335,68,26354,28073,32495,1,53,36,4587,6,2173,3189,2,0,1,0,12
EUW1_6881089160',6,24,6,0,0,1,0,9,1,336,95,23613,27954,18063,3,30,11,2,0,1,0,4,366,104,26773,29999,23241,0,-30,-9,-3160,-5,-2045,-5178,-2,0,0,0,5
EUW1_6881058737',2,25,16,1,0,0,0,6,1,390,98,30293,31447,32534,4,26,8,0,0,2,0,5,346,92,24790,27328,27157,1,44,6,5503,8,4119,5377,1,0,-2,0,1
EUW1_6881030537',5,38,17,1,0,1,0,5,1,431,100,30869,32646,34203,4,34,7,0,0,1,0,4,338,88,23631,28330,22950,1,93,12,7238,10,4316,11253,1,0,0,0,1
EUW1_6876559348',2,23,19,0,0,0,0,7,1,332,75,30229,30355,41260,1,24,22,1,0,0,0,1,346,91,30954,30930,43544,0,-14,-16,-725,-3,-575,-2284,-1,0,0,0,6
EUW1_6876003519',6,44,8,0,1,0,0,10,0,332,106,25083,27774,26443,7,32,11,2,0,1,0,2,390,85,28085,30386,25555,0,-58,21,-3002,-3,-2612,888,-2,1,-1,0,8
EUW1_6875222775',3,59,12,1,0,1,0,5,0,374,81,29631,29275,29446,7,40,9,0,0,0,0,8,329,84,25127,26879,24711,1,45,-3,4504,3,2396,4735,1,0,1,0,-3
EUW1_6875192804',1,20,21,2,1,0,0,8,1,355,82,29842,31108,38207,1,22,8,0,0,1,0,1,356,69,26309,27592,32257,1,-1,13,3533,13,3516,5950,2,1,-1,0,7
EUW1_6875166801',4,45,23,1,1,2,0,8,1,406,90,35988,34197,43746,1,97,7,1,0,1,0,7,369,81,26370,28145,22169,1,37,9,9618,16,6052,21577,0,1,1,0,1
EUW1_6883621290',5,43,14,1,0,0,0,12,0,343,110,28777,28599,29660,6,32,15,0,0,1,0,3,325,84,27752,27489,27283,1,18,26,1025,-1,1110,2377,1,0,-1,0,9
EUW1_6883605015',7,35,7,1,0,0,0,9,1,317,94,23959,28279,25830,3,35,12,1,0,2,0,2,352,90,28168,29626,27122,1,-35,4,-4209,-5,-1347,-1292,0,0,-2,0,7
EUW1_6883587616',4,39,9,0,0,2,0,13,0,352,77,25835,27914,26684,0,35,11,1,0,2,0,5,389,82,28481,29808,28711,0,-37,-5,-2646,-2,-1894,-2027,-1,0,0,0,8
EUW1_6883561685',3,28,12,0,0,0,0,14,1,356,74,26665,29770,29479,3,30,7,2,0,2,0,0,383,106,26949,28867,30374,0,-27,-32,-284,5,903,-895,-2,0,-2,0,14
EUW1_6883521678',3,50,11,0,0,1,0,7,0,344,84,26604,29098,34000,2,21,14,1,0,1,0,5,361,79,28559,30079,34851,1,-17,5,-1955,-3,-981,-851,-1,0,0,0,2
EUW1_6883287493',3,80,18,1,0,1,0,10,0,363,78,31121,30541,31352,1,27,13,0,1,1,0,6,401,108,31063,31245,32465,0,-38,-30,58,5,-704,-1113,1,-1,0,0,4
EUW1_6882201389',5,26,8,1,0,0,0,15,1,334,71,25638,26246,33242,7,34,19,1,0,2,0,2,362,92,31238,32056,37019,0,-28,-21,-5600,-11,-5810,-3777,0,0,-2,0,13
EUW1_6882176733',1,26,14,0,0,2,0,8,0,330,91,29843,31389,35358,3,41,17,2,0,0,0,6,365,82,29431,29462,37090,1,-35,9,412,-3,1927,-1732,-2,0,2,0,2
EUW1_6882133888',7,35,16,1,0,1,0,8,1,376,84,29008,31956,33411,8,32,12,1,0,2,0,3,340,86,27991,30151,33841,0,36,-2,1017,4,1805,-430,0,0,-1,0,5
EUW1_6882095872',4,27,13,0,0,1,0,10,1,331,104,28369,29012,32887,7,31,14,1,0,1,0,5,340,91,29176,30186,36364,0,-9,13,-807,-1,-1174,-3477,-1,0,0,0,5
EUW1_6881323943',7,28,5,1,0,0,0,10,0,382,82,23621,27980,21083,2,26,8,1,0,2,0,2,387,110,27599,31180,26279,0,-5,-28,-3978,-3,-3200,-5196,0,0,-2,0,8
EUW1_6881146272',6,30,12,1,0,1,0,14,0,365,90,28924,29467,32210,1,21,22,0,0,2,0,5,362,109,33544,34718,46681,0,3,-19,-4620,-10,-5251,-14471,1,0,-1,0,9
EUW1_6880998202',5,26,4,1,0,0,0,8,1,413,93,24981,29492,24101,5,23,5,0,0,0,0,2,387,110,24205,31017,18992,0,26,-17,776,-1,-1525,5109,1,0,0,0,6
EUW1_6877462900',0,53,17,1,0,2,0,8,0,359,99,30857,29729,28170,3,21,4,0,0,0,0,8,351,78,23956,26416,22763,1,8,21,6901,13,3313,5407,1,0,2,0,0
EUW1_6877368361',4,31,10,1,0,1,0,5,1,329,108,26371,27243,30985,6,102,12,0,1,0,0,5,345,84,26892,28889,33288,1,-16,24,-521,-2,-1646,-2303,1,-1,1,0,0
EUW1_6877244308',1,25,6,0,0,0,0,9,0,352,80,24561,27853,23480,6,29,16,1,0,1,0,1,386,123,30439,31569,30030,0,-34,-43,-5878,-10,-3716,-6550,-1,0,-1,0,8
EUW1_6877219574',4,25,6,0,0,0,0,14,1,355,89,24076,28144,23896,3,151,18,2,0,3,0,1,357,105,31463,33851,34478,0,-2,-16,-7387,-12,-5707,-10582,-2,0,-3,0,13
EUW1_6876864756',2,36,12,1,0,1,0,7,0,356,74,27521,29827,30063,4,42,9,0,0,0,0,5,389,87,26136,28732,32498,1,-33,-13,1385,3,1095,-2435,1,0,1,0,2
EUW1_6876824001',8,25,19,1,1,1,0,4,1,346,103,30753,32525,42777,3,34,7,1,0,1,0,8,318,92,23338,26362,29969,1,28,11,7415,12,6163,12808,0,1,0,0,-4
EUW1_6876233851',5,40,10,1,0,1,0,12,1,398,94,28131,29891,30428,2,25,7,1,0,1,0,5,351,94,25221,27912,24951,1,47,0,2910,3,1979,5477,0,0,0,0,7
EUW1_6883778360',0,26,12,1,0,0,0,8,0,331,70,25805,27640,33044,5,30,16,1,0,1,0,1,343,74,28907,30413,34844,1,-12,-4,-3102,-4,-2773,-1800,0,0,-1,0,7
EUW1_6883758797',2,30,9,2,0,0,0,5,0,342,112,26856,29355,28761,9,29,15,0,0,0,0,2,382,100,28648,29288,31726,1,-40,12,-1792,-6,67,-2965,2,0,0,0,3
EUW1_6883724301',1,29,10,0,0,0,0,11,0,315,75,24170,26032,31752,4,23,14,1,0,1,0,1,356,84,28381,30851,28785,0,-41,-9,-4211,-4,-4819,2967,-1,0,-1,0,10
EUW1_6883088087',4,155,4,1,1,0,0,10,0,346,84,22655,28112,21577,5,39,13,1,0,1,0,2,372,88,28303,30775,28652,0,-26,-4,-5648,-9,-2663,-7075,0,1,-1,0,8
EUW1_6883020287',3,28,20,2,0,1,0,8,1,340,106,31363,29546,43721,2,23,10,0,0,2,0,6,322,66,25679,26058,31466,1,18,40,5684,10,3488,12255,2,0,-1,0,2
EUW1_6882864187',4,33,14,1,0,0,0,11,0,286,76,26349,27891,31612,3,23,12,1,0,1,0,1,339,96,27631,29212,31220,1,-53,-20,-1282,2,-1321,392,0,0,-1,0,10
EUW1_6882481283',6,63,9,0,0,0,0,15,1,326,82,26238,27344,31084,4,23,22,1,0,3,0,2,360,83,31929,32060,43034,0,-34,-1,-5691,-13,-4716,-11950,-1,0,-3,0,13
EUW1_6882452890',3,42,11,2,1,3,0,6,1,423,75,29890,31359,25004,7,142,4,0,0,0,0,8,383,93,24708,29075,22908,1,40,-18,5182,7,2284,2096,2,1,3,0,-2
EUW1_6882345865',10,31,13,2,0,1,0,8,1,313,92,27533,27449,33952,4,45,17,0,0,1,0,4,333,96,29388,29958,34502,1,-20,-4,-1855,-4,-2509,-550,2,0,0,0,4
EUW1_6882334876',1,24,8,2,0,0,0,11,0,341,110,25396,28514,26185,2,23,15,0,0,0,0,2,351,74,27575,29237,31701,1,-10,36,-2179,-7,-723,-5516,2,0,0,0,9
EUW1_6881399479',5,23,17,1,1,0,0,13,1,345,94,32004,30145,35450,2,20,15,0,0,2,0,2,299,70,28645,27407,39475,1,46,24,3359,2,2738,-4025,1,1,-2,0,11
EUW1_6881337218',5,65,19,1,0,0,0,7,0,321,102,30933,31397,41444,5,24,16,1,0,1,0,6,326,84,27565,30227,31691,1,-5,18,3368,3,1170,9753,0,0,-1,0,1
EUW1_6881255041',2,42,12,0,0,0,0,8,1,349,50,25977,28712,28702,3,28,20,2,0,1,0,2,328,92,29876,31589,41266,1,21,-42,-3899,-8,-2877,-12564,-2,0,-1,0,6
EUW1_6881010088',3,25,14,2,0,0,0,19,1,350,71,29291,27105,32426,2,34,14,0,1,4,0,4,341,92,31122,31923,39128,0,9,-21,-1831,0,-4818,-6702,2,-1,-4,0,15
EUW1_6880959445',2,22,17,0,1,1,0,6,0,343,143,30844,32926,35228,4,93,11,2,0,0,0,7,329,80,26063,26910,28979,0,14,63,4781,6,6016,6249,-2,1,1,0,-1
EUW1_6880731410',2,22,16,2,0,1,0,9,1,359,109,30272,31275,33049,1,28,12,0,1,1,0,8,315,70,26258,27850,34181,1,44,39,4014,4,3425,-1132,2,-1,0,0,1
EUW1_6880697898',2,41,10,1,1,0,0,7,1,406,114,27145,31132,24698,5,50,6,1,0,0,0,2,380,86,23814,29575,22622,0,26,28,3331,4,1557,2076,0,1,0,0,5
EUW1_6880667928',4,29,22,1,1,0,0,5,1,350,84,32356,29670,36606,2,23,13,0,0,1,0,9,364,66,27918,28209,33845,1,-14,18,4438,9,1461,2761,1,1,-1,0,-4
EUW1_6883768335',5,142,7,0,0,0,0,8,0,308,104,24158,29318,27802,5,26,11,2,0,0,0,0,351,74,25688,29049,28391,0,-43,30,-1530,-4,269,-589,-2,0,0,0,8
EUW1_6882461746',4,33,20,1,1,4,0,10,1,381,78,33255,32222,37933,2,93,9,0,0,0,0,8,384,89,26313,28757,25205,1,-3,-11,6942,11,3465,12728,1,1,4,0,2
EUW1_6882007742',1,34,8,1,0,0,0,6,1,416,114,27053,31942,22237,7,27,5,0,0,0,0,3,350,90,23366,27865,22318,0,66,24,3687,3,4077,-81,1,0,0,0,3
EUW1_6881918778',1,20,15,1,0,1,0,10,0,313,97,28607,29047,34180,4,42,21,1,0,2,0,3,375,88,33138,31423,35997,0,-62,9,-4531,-6,-2376,-1817,0,0,-1,0,7
EUW1_6881841696',5,27,13,1,0,1,0,11,0,415,94,28876,32324,32766,4,28,4,1,0,1,0,2,358,95,24331,28730,23543,1,57,-1,4545,9,3594,9223,0,0,0,0,9
EUW1_6881670402',4,32,7,1,0,0,0,6,0,360,86,24695,28283,21816,3,27,8,0,0,0,0,6,388,90,25209,29879,29458,1,-28,-4,-514,-1,-1596,-7642,1,0,0,0,0
EUW1_6881466691',1,21,5,1,0,1,0,11,0,398,127,25489,31218,23777,4,29,8,1,0,1,0,2,351,71,24952,30090,18267,1,47,56,537,-3,1128,5510,0,0,0,0,9
EUW1_6881046793',0,27,11,1,1,1,0,11,1,372,104,29129,29473,26716,7,89,12,1,0,2,0,6,329,76,26905,29089,24230,0,43,28,2224,-1,384,2486,0,1,-1,0,5
EUW1_6880598221',5,31,11,0,0,0,0,11,1,313,72,25339,27687,30598,2,19,11,2,0,1,0,4,365,90,28159,30011,36020,0,-52,-18,-2820,0,-2324,-5422,-2,0,-1,0,7
EUW1_6880544267',1,25,12,1,1,1,0,10,0,383,92,29156,30530,29086,1,20,17,1,0,1,0,7,341,79,28614,31822,32482,0,42,13,542,-5,-1292,-3396,0,1,0,0,3
EUW1_6880323560',0,31,16,2,0,1,0,4,1,436,91,30439,33754,33136,3,28,9,0,1,1,0,2,357,112,27063,30150,24361,1,79,-21,3376,7,3604,8775,2,-1,0,0,2
EUW1_6880127825',4,29,16,1,0,0,0,9,1,337,62,28607,29736,37000,1,21,7,1,0,1,0,5,368,117,26674,30467,38462,1,-31,-55,1933,9,-731,-1462,0,0,-1,0,4
EUW1_6880050238',4,32,13,0,0,0,0,8,0,364,116,28801,32568,28076,4,25,11,1,0,0,0,3,426,80,27084,31019,25441,1,-62,36,1717,2,1549,2635,-1,0,0,0,5
EUW1_6879693850',4,51,13,1,0,1,0,9,1,342,97,28762,30297,27671,4,29,7,1,0,1,0,7,272,83,23034,26627,23184,1,70,14,5728,6,3670,4487,0,0,0,0,2
EUW1_6879660814',2,229,10,1,1,0,0,11,1,360,84,25569,30243,29103,3,29,3,1,0,1,0,4,361,72,23202,28074,23549,1,-1,12,2367,7,2169,5554,0,1,-1,0,7
EUW1_6879572815',3,22,9,0,0,0,0,9,0,337,72,24274,26712,21746,4,32,12,2,0,0,0,3,352,120,28474,29717,31630,0,-15,-48,-4200,-3,-3005,-9884,-2,0,0,0,6
EUW1_6858265811',8,58,14,1,0,0,0,8,0,381,86,28626,29928,34180,4,31,13,0,0,0,0,0,356,114,28151,30337,34198,1,25,-28,475,1,-409,-18,1,0,0,0,8
EUW1_6858233249',5,30,11,0,0,0,0,7,1,425,104,29747,33496,31395,3,36,4,2,0,0,0,2,371,108,23013,28858,17725,1,54,-4,6734,7,4638,13670,-2,0,0,0,5
EUW1_6858192078',2,30,12,1,0,0,0,6,1,375,93,26932,30737,34932,2,28,11,0,0,0,0,1,329,90,26689,28823,33147,1,46,3,243,1,1914,1785,1,0,0,0,5
EUW1_6858140995',2,24,14,2,0,1,0,10,0,356,102,30533,29430,34652,3,20,21,0,0,1,0,8,371,94,32073,29947,37551,1,-15,8,-1540,-7,-517,-2899,2,0,0,0,2
EUW1_6857172292',4,29,12,2,1,1,0,5,1,373,124,27944,31364,27852,6,27,8,0,0,0,0,3,367,100,24539,30329,20947,1,6,24,3405,4,1035,6905,2,1,1,0,2
EUW1_6856924062',4,38,13,1,1,1,0,4,1,339,93,28489,27074,31772,5,39,12,0,0,0,0,6,313,94,25886,27012,30008,1,26,-1,2603,1,62,1764,1,1,1,0,-2
EUW1_6856891403',0,23,10,0,0,0,0,9,0,323,92,26480,29509,25509,3,46,14,1,0,1,0,2,350,98,28080,30032,30118,0,-27,-6,-1600,-4,-523,-4609,-1,0,-1,0,7
EUW1_6856866673',2,27,6,0,0,0,0,13,0,361,112,25387,28308,24270,3,21,15,2,0,2,0,2,385,88,30312,32056,25831,0,-24,24,-4925,-9,-3748,-1561,-2,0,-2,0,11
EUW1_6856828892',3,44,7,1,0,0,0,9,1,374,92,24953,29902,31077,2,26,7,1,0,0,0,1,361,115,25398,31275,31639,1,13,-23,-445,0,-1373,-562,0,0,0,0,8
EUW1_6856810791',2,70,9,1,0,0,0,9,1,362,84,25823,29069,29933,2,30,15,1,0,0,0,0,366,97,27964,30487,40318,0,-4,-13,-2141,-6,-1418,-10385,0,0,0,0,9
EUW1_6856784665',4,26,6,0,0,1,0,15,0,394,104,25436,29545,22466,7,27,9,2,0,2,0,3,430,88,28571,32291,30526,1,-36,16,-3135,-3,-2746,-8060,-2,0,-1,0,12
EUW1_6856759916',6,28,16,1,0,1,0,13,0,298,116,29607,27655,27261,1,29,14,1,1,2,0,3,332,100,30257,28636,28572,1,-34,16,-650,2,-981,-1311,0,-1,-1,0,10
EUW1_6856743978',2,19,9,1,1,1,0,11,1,379,108,27703,31828,24281,1,23,7,1,0,1,0,4,363,108,26932,30750,28686,0,16,0,771,2,1078,-4405,0,1,0,0,7
EUW1_6856739482',4,40,18,2,0,2,0,6,0,373,122,31119,32971,39826,4,25,7,0,0,0,0,5,338,68,25163,27117,27818,1,35,54,5956,11,5854,12008,2,0,2,0,1
EUW1_6856718013',3,196,12,1,0,0,0,13,0,341,78,26780,29990,28550,1,39,16,1,0,2,0,4,366,117,31279,32425,33306,0,-25,-39,-4499,-4,-2435,-4756,0,0,-2,0,9
EUW1_6856711502',2,15,18,1,0,3,0,10,1,348,108,32452,32986,36535,0,25,9,0,0,0,0,8,345,92,25971,28274,33967,1,3,16,6481,9,4712,2568,1,0,3,0,2
EUW1_6856700794',4,24,4,1,0,0,0,14,0,339,104,23765,27304,21173,11,37,23,1,0,4,0,2,366,75,34600,32500,36533,0,-27,29,-10835,-19,-5196,-15360,0,0,-4,0,12
EUW1_6856689791',2,25,4,1,0,0,0,5,0,417,116,24874,31518,18222,6,67,4,1,0,0,0,3,381,86,23804,28037,13913,1,36,30,1070,0,3481,4309,0,0,0,0,2
EUW1_6854819828',7,31,15,0,0,1,0,7,0,398,98,30843,31050,30542,4,25,17,2,0,0,0,6,374,102,31065,33089,35804,0,24,-4,-222,-2,-2039,-5262,-2,0,1,0,1
EUW1_6877825235',4,51,12,0,0,1,0,10,0,344,78,27348,28716,34354,1,28,20,1,0,1,0,3,357,108,31597,29976,42545,0,-13,-30,-4249,-8,-1260,-8191,-1,0,0,0,7
EUW1_6877497543',6,222,6,2,0,0,0,5,1,406,97,25411,29056,26398,5,29,12,0,0,0,0,3,373,123,27369,31287,33522,0,33,-26,-1958,-6,-2231,-7124,2,0,0,0,2
EUW1_6876467196',5,30,9,0,0,0,0,7,0,383,67,25322,30111,26940,3,33,12,1,0,0,0,1,397,111,27898,31143,37009,0,-14,-44,-2576,-3,-1032,-10069,-1,0,0,0,6
EUW1_6876456227',1,20,15,1,0,1,0,5,0,371,99,29405,31398,32966,3,51,11,0,0,0,0,5,360,83,26705,28759,28973,0,11,16,2700,4,2639,3993,1,0,1,0,0
EUW1_6876449793',5,32,13,0,0,1,0,3,0,380,108,29479,31064,26800,3,32,9,2,0,0,0,6,345,100,24491,27966,25674,0,35,8,4988,4,3098,1126,-2,0,1,0,-3
EUW1_6876359344',2,25,11,0,0,0,0,5,1,414,68,28107,30453,27697,3,29,8,1,0,1,0,5,404,99,27006,30917,31199,1,10,-31,1101,3,-464,-3502,-1,0,-1,0,0
EUW1_6876340124',3,26,10,1,1,1,0,4,0,434,80,27353,31608,23964,5,31,7,0,0,0,0,1,437,92,26130,29678,25030,0,-3,-12,1223,3,1930,-1066,1,1,1,0,3
EUW1_6876231278',2,28,6,1,0,0,0,7,0,372,72,23545,27397,16587,9,26,13,1,0,1,0,2,399,90,29538,32381,29837,0,-27,-18,-5993,-7,-4984,-13250,0,0,-1,0,5
EUW1_6876176832',5,37,15,0,0,1,0,10,0,335,104,29896,30479,34445,6,38,12,2,0,1,0,6,408,82,29514,30647,40722,1,-73,22,382,3,-168,-6277,-2,0,0,0,4
EUW1_6876121454',5,28,15,2,0,0,0,6,1,367,76,28236,30081,33991,3,27,12,0,0,0,0,4,383,96,27759,30619,32196,1,-16,-20,477,3,-538,1795,2,0,0,0,2
EUW1_6875928014',2,26,7,1,0,0,0,6,1,409,100,25763,31202,31240,4,28,5,1,0,0,0,1,440,90,25799,30564,19062,1,-31,10,-36,2,638,12178,0,0,0,0,5
EUW1_6875864109',8,35,14,0,0,0,0,9,1,378,87,28331,31156,36336,3,22,6,1,0,1,0,3,394,67,25527,28789,30120,0,-16,20,2804,8,2367,6216,-1,0,-1,0,6
EUW1_6875824906',6,141,14,2,0,0,0,7,1,403,68,28374,31118,32378,5,32,7,0,0,0,0,6,348,104,25641,29214,26120,1,55,-36,2733,7,1904,6258,2,0,0,0,1
EUW1_6875705116',3,42,13,1,0,1,0,9,1,348,96,29281,32319,39363,4,315,16,0,0,1,0,5,378,100,30210,31380,37493,1,-30,-4,-929,-3,939,1870,1,0,0,0,4
EUW1_6875649645',0,140,3,0,0,0,0,7,0,360,120,24678,30197,44219,2,25,15,1,0,0,0,5,363,92,27811,31623,40038,0,-3,28,-3133,-12,-1426,4181,-1,0,0,0,2
EUW1_6875593438',4,46,11,0,0,0,0,11,0,337,73,25749,27770,26897,2,24,14,2,0,2,0,2,348,112,27959,30349,32738,0,-11,-39,-2210,-3,-2579,-5841,-2,0,-2,0,9
EUW1_6875542293',4,27,1,1,0,0,0,8,1,357,86,22190,27566,32604,5,35,10,1,0,1,0,1,414,100,28212,29880,34927,0,-57,-14,-6022,-9,-2314,-2323,0,0,-1,0,7
EUW1_6875495237',6,112,20,1,0,0,0,8,0,371,84,30835,31346,39877,3,31,13,0,0,1,0,3,299,80,26147,26590,37933,1,72,4,4688,7,4756,1944,1,0,-1,0,5
EUW1_6875075912',6,28,14,0,0,2,0,8,0,367,92,30462,30475,28932,2,24,13,2,1,2,0,5,370,98,28482,31676,31452,0,-3,-6,1980,1,-1201,-2520,-2,-1,0,0,3
EUW1_6875063022',3,45,17,2,0,1,0,8,1,327,69,30595,28474,34737,1,97,16,0,1,1,0,5,307,101,28013,31204,37068,0,20,-32,2582,1,-2730,-2331,2,-1,0,0,3
EUW1_6883653924',5,187,15,0,0,0,0,14,1,363,67,29105,29058,24936,5,26,17,2,0,2,0,4,333,101,29164,30546,33161,0,30,-34,-59,-2,-1488,-8225,-2,0,-2,0,10
EUW1_6883638564',3,30,9,1,0,0,0,13,1,388,89,26394,28862,28725,7,177,18,1,0,2,0,2,366,94,30893,31715,32037,1,22,-5,-4499,-9,-2853,-3312,0,0,-2,0,11
EUW1_6883597274',1,31,19,2,1,2,0,12,1,380,115,32601,33639,47167,2,62,9,0,0,1,0,9,335,76,26555,27325,30467,1,45,39,6046,10,6314,16700,2,1,1,0,3
EUW1_6883572382',4,95,16,0,1,0,0,9,0,322,70,27006,30066,34283,4,135,12,1,0,0,0,2,343,83,25616,29317,44701,1,-21,-13,1390,4,749,-10418,-1,1,0,0,7
EUW1_6883534215',3,25,16,1,0,1,0,7,1,378,107,30950,32053,30838,5,30,11,1,0,0,0,3,399,92,27473,31714,30068,1,-21,15,3477,5,339,770,0,0,1,0,4
EUW1_6883453673',7,31,19,1,0,3,0,11,1,350,52,30454,27259,44797,1,125,9,1,0,1,0,9,285,86,25562,27038,31923,0,65,-34,4892,10,221,12874,0,0,2,0,2
EUW1_6883367891',2,31,12,0,0,1,0,9,0,366,92,27236,30622,29058,1,22,17,1,0,1,0,3,352,108,30406,32202,34795,0,14,-16,-3170,-5,-1580,-5737,-1,0,0,0,6
EUW1_6883295216',5,31,6,2,0,1,0,5,0,339,80,24179,28360,31673,2,24,11,0,0,0,0,5,368,88,26189,30585,32014,0,-29,-8,-2010,-5,-2225,-341,2,0,1,0,0
EUW1_6883239414',3,25,18,0,1,0,0,16,0,342,104,30360,30240,38608,3,41,13,1,0,2,0,4,317,79,27846,27432,36726,0,25,25,2514,5,2808,1882,-1,1,-2,0,12
EUW1_6883109059',2,63,13,1,1,1,0,7,1,403,98,28877,32989,28059,0,59,5,1,0,1,0,2,351,112,24179,28885,28263,1,52,-14,4698,8,4104,-204,0,1,0,0,5
EUW1_6883053591',3,27,12,1,1,0,0,13,0,306,79,27461,30496,35501,5,45,18,1,0,2,0,0,333,116,31214,31598,44836,0,-27,-37,-3753,-6,-1102,-9335,0,1,-2,0,13
EUW1_6882995918',4,36,23,1,0,1,0,15,0,383,102,34849,32023,44296,6,34,17,0,0,2,0,7,340,69,29842,28628,37110,1,43,33,5007,6,3395,7186,1,0,-1,0,8
EUW1_6882817542',4,19,13,0,0,0,0,5,1,389,108,30097,32190,30389,1,26,11,2,0,2,0,1,360,92,25789,29546,37706,1,29,16,4308,2,2644,-7317,-2,0,-2,0,4
EUW1_6882336474',2,23,14,0,0,1,0,17,1,292,85,27339,27632,35500,5,32,17,1,1,3,0,4,387,78,33740,31233,37060,0,-95,7,-6401,-3,-3601,-1560,-1,-1,-2,0,13
EUW1_6882320458',3,27,13,1,0,1,0,7,1,376,82,27809,30934,32441,1,29,9,1,1,0,0,6,344,106,26400,30807,30441,0,32,-24,1409,4,127,2000,0,-1,1,0,1
EUW1_6882303527',3,27,10,1,0,1,0,7,1,351,99,26759,29822,32971,4,26,14,1,0,0,0,1,356,101,27026,31599,41570,0,-5,-2,-267,-4,-1777,-8599,0,0,1,0,6
EUW1_6882286903',1,30,16,1,0,2,0,7,1,394,114,32052,32146,31623,4,33,10,0,0,0,0,7,302,66,25077,26766,29506,1,92,48,6975,6,5380,2117,1,0,2,0,0
EUW1_6882272570',5,42,12,1,0,2,0,8,1,416,90,29926,32396,28411,5,42,8,1,0,0,0,5,359,99,25087,29394,26780,1,57,-9,4839,4,3002,1631,0,0,2,0,3
EUW1_6883772359',4,29,11,1,0,0,0,3,1,395,80,26422,29943,31452,3,29,10,1,0,0,0,3,412,84,26762,31160,26816,1,-17,-4,-340,1,-1217,4636,0,0,0,0,0
EUW1_6883668290',2,24,6,0,0,0,0,9,0,355,73,24208,29296,33232,6,27,17,1,0,2,0,1,345,92,28892,33755,32243,0,10,-19,-4684,-11,-4459,989,-1,0,-2,0,8
EUW1_6883659209',3,26,9,1,0,1,0,6,0,330,85,25375,27677,26535,5,29,12,1,1,1,0,2,324,66,25175,29108,26241,1,6,19,200,-3,-1431,294,0,-1,0,0,4
EUW1_6883584738',1,20,18,0,0,2,0,3,1,371,88,31837,31201,40997,4,25,13,2,0,0,0,9,316,72,26599,28606,31621,0,55,16,5238,5,2595,9376,-2,0,2,0,-6
EUW1_6883563516',5,26,15,1,0,3,0,14,1,347,92,30486,30587,30820,2,20,14,1,0,2,0,4,345,92,29268,30175,28160,0,2,0,1218,1,412,2660,0,0,1,0,10
EUW1_6883530262',1,22,7,2,1,0,0,12,0,344,99,25482,27986,23453,5,26,20,0,0,2,0,0,355,100,31001,32403,34817,0,-11,-1,-5519,-13,-4417,-11364,2,1,-2,0,12
EUW1_6882684799',6,35,23,1,1,1,0,12,1,358,108,33426,33010,41172,3,27,13,0,0,1,0,3,362,116,28139,31051,30984,1,-4,-8,5287,10,1959,10188,1,1,0,0,9
EUW1_6882643146',4,30,13,0,1,1,0,7,0,378,79,28104,30852,28369,3,29,9,2,0,1,0,2,342,120,26961,29764,28859,0,36,-41,1143,4,1088,-490,-2,1,0,0,5
EUW1_6882615649',3,29,20,0,1,1,0,7,0,356,91,31447,31003,43192,2,30,18,1,0,0,0,5,326,87,29452,28794,35465,1,30,4,1995,2,2209,7727,-1,1,1,0,2
EUW1_6882582091',3,24,7,0,0,0,0,11,0,356,97,25009,28589,25228,6,35,21,2,1,1,0,3,359,82,31493,31539,32653,0,-3,15,-6484,-14,-2950,-7425,-2,-1,-1,0,8
EUW1_6882554153',3,30,19,1,0,1,0,4,0,370,81,30113,30467,37613,3,24,17,1,0,1,0,7,373,104,30265,31695,37805,0,-3,-23,-152,2,-1228,-192,0,0,0,0,-3
EUW1_6882532715',2,34,10,0,0,0,0,10,0,304,91,25247,28350,28794,5,27,23,1,0,0,0,0,364,108,30457,33925,39155,0,-60,-17,-5210,-13,-5575,-10361,-1,0,0,0,10
EUW1_6882408944',2,18,12,0,1,1,0,10,0,329,102,27410,30746,26353,5,29,13,2,0,1,0,3,362,89,26859,29873,30774,1,-33,13,551,-1,873,-4421,-2,1,0,0,7
EUW1_6882392544',3,22,7,0,0,1,0,10,0,312,98,24955,27569,27034,1,18,17,2,0,0,0,3,340,81,28253,29867,34799,0,-28,17,-3298,-10,-2298,-7765,-2,0,1,0,7
EUW1_6882367224',4,67,26,1,1,4,0,8,1,373,95,38433,34131,52325,4,35,17,1,0,0,0,12,265,88,28272,28518,34810,1,108,7,10161,9,5613,17515,0,1,4,0,-4
EUW1_6882358696',2,29,13,1,1,1,0,6,1,337,96,28067,29027,29341,1,26,10,1,0,0,0,8,334,96,25654,28973,26401,0,3,0,2413,3,54,2940,0,1,1,0,-2
EUW1_6881746306',3,49,10,0,0,0,0,9,1,312,81,24873,27209,22114,6,31,10,1,0,2,0,5,348,94,27027,28321,23069,0,-36,-13,-2154,0,-1112,-955,-1,0,-2,0,4
EUW1_6881684999',6,35,17,1,1,0,0,10,1,340,86,30051,29962,31473,5,25,12,1,0,1,0,8,271,92,26489,27123,30989,1,69,-6,3562,5,2839,484,0,1,-1,0,2
EUW1_6881624979',8,46,5,0,0,0,0,12,0,331,108,23590,29962,21692,4,35,17,2,0,2,0,0,391,96,30312,33080,41677,0,-60,12,-6722,-12,-3118,-19985,-2,0,-2,0,12
EUW1_6881572249',3,22,11,1,0,1,0,10,1,374,83,26825,30566,30967,4,25,7,0,0,2,0,2,375,94,26273,28999,30073,0,-1,-11,552,4,1567,894,1,0,-1,0,8
EUW1_6883308112',5,26,8,0,0,1,0,14,0,371,92,26992,30513,24018,5,35,10,2,0,2,0,6,362,112,28138,28793,18930,1,9,-20,-1146,-2,1720,5088,-2,0,-1,0,8
EUW1_6883247497',5,57,6,0,0,0,0,11,0,356,82,24429,28267,22408,3,179,9,0,1,2,0,1,410,88,28744,31278,30129,0,-54,-6,-4315,-3,-3011,-7721,0,-1,-2,0,10
EUW1_6882947070',3,61,11,0,0,0,0,4,1,404,99,27255,30296,28408,4,38,13,2,0,0,0,2,393,104,27514,31170,24942,0,11,-5,-259,-2,-874,3466,-2,0,0,0,2
EUW1_6882890969',1,26,9,0,0,0,0,8,0,375,94,26808,30000,24362,2,27,16,2,1,2,0,6,397,77,29573,32167,33531,0,-22,17,-2765,-7,-2167,-9169,-2,-1,-2,0,2
EUW1_6882833926',4,44,14,0,0,0,0,15,0,347,81,27500,27837,28337,8,33,19,2,0,3,0,1,380,93,32188,31166,34982,1,-33,-12,-4688,-5,-3329,-6645,-2,0,-3,0,14
EUW1_6882455660',1,22,9,0,0,1,0,11,0,378,86,28050,28554,27134,10,36,15,1,1,2,0,5,387,96,30252,31612,27721,0,-9,-10,-2202,-6,-3058,-587,-1,-1,-1,0,6
EUW1_6882412099',6,34,15,0,0,0,0,13,0,356,92,28871,31138,28531,3,29,10,1,0,1,0,4,375,94,26978,27966,30273,1,-19,-2,1893,5,3172,-1742,-1,0,-1,0,9
EUW1_6882394783',3,21,14,1,0,2,0,7,0,417,116,31000,32694,27556,4,28,6,1,0,0,0,4,378,76,24246,27698,19690,1,39,40,6754,8,4996,7866,0,0,2,0,3
EUW1_6882360160',3,20,18,1,0,2,0,11,1,352,72,31417,28863,35285,1,24,15,0,0,1,0,7,305,79,27659,27124,35746,1,47,-7,3758,3,1739,-461,1,0,1,0,4
EUW1_6882353726',3,45,11,1,0,1,0,8,1,368,90,27919,28929,28739,5,27,7,0,0,0,0,5,347,84,24431,28299,28494,1,21,6,3488,4,630,245,1,0,1,0,3
EUW1_6881973286',3,27,4,1,0,0,0,7,0,383,100,24414,28068,19592,2,99,10,1,0,1,0,2,369,96,26661,29512,19156,0,14,4,-2247,-6,-1444,436,0,0,-1,0,5
EUW1_6881918889',6,38,15,0,0,2,0,9,0,360,92,31421,30103,34050,6,29,15,1,0,0,0,5,352,73,27594,26416,26813,1,8,19,3827,0,3687,7237,-1,0,2,0,4
EUW1_6881535743',9,31,9,0,0,0,0,10,0,364,114,25654,29799,18879,4,40,9,1,1,1,0,0,405,102,27760,30244,22227,0,-41,12,-2106,0,-445,-3348,-1,-1,-1,0,10
EUW1_6881456985',6,40,12,1,0,1,0,12,0,342,92,27918,26529,28624,4,35,15,0,0,2,0,7,374,92,30289,29046,34356,1,-32,0,-2371,-3,-2517,-5732,1,0,-1,0,5
EUW1_6881397993',2,25,9,0,0,1,0,12,0,374,112,28122,29326,23886,3,30,14,2,0,0,0,5,377,72,28660,31038,27443,0,-3,40,-538,-5,-1712,-3557,-2,0,1,0,7
EUW1_6881345297',5,28,17,1,1,3,0,3,0,391,112,32752,32369,35672,1,21,8,1,0,0,0,10,359,104,25495,28606,18969,1,32,8,7257,9,3763,16703,0,1,3,0,-7
EUW1_6881309375',2,24,19,1,1,1,0,7,1,420,104,32252,34642,32239,2,29,7,0,0,1,0,7,374,84,23828,28770,18794,1,46,20,8424,12,5872,13445,1,1,0,0,0
EUW1_6881239125',1,24,5,0,0,1,0,6,1,403,69,24155,29089,20217,2,25,9,2,0,2,0,4,445,114,28026,32532,22149,0,-42,-45,-3871,-4,-3443,-1932,-2,0,-1,0,2
EUW1_6881045343',4,29,13,1,0,3,0,5,0,404,113,31887,30460,29538,3,26,9,1,0,0,0,9,364,86,26877,28479,21165,1,40,27,5010,4,1981,8373,0,0,3,0,-4
EUW1_6883673153',6,27,17,0,0,0,0,11,1,308,97,28456,28553,30437,5,29,9,2,0,0,0,3,359,76,26269,27970,31530,0,-51,21,2187,8,583,-1093,-2,0,0,0,8
EUW1_6883665928',3,33,16,1,0,0,0,9,1,354,93,30009,30464,34258,4,37,6,0,0,2,0,3,370,38,25139,25959,31893,1,-16,55,4870,10,4505,2365,1,0,-2,0,6
EUW1_6883622699',3,67,7,1,0,0,0,8,0,335,67,24433,26577,24572,8,33,19,1,0,1,0,5,359,90,30289,30868,41609,0,-24,-23,-5856,-12,-4291,-17037,0,0,-1,0,3
EUW1_6883596641',7,29,21,1,0,1,0,7,1,370,107,32546,31303,49414,3,259,14,1,0,0,0,3,329,64,27592,27043,42148,0,41,43,4954,7,4260,7266,0,0,1,0,4
EUW1_6883537759',3,19,27,1,1,2,0,3,1,363,88,33117,32859,49064,5,32,10,0,0,0,0,11,332,78,25272,29239,38900,1,31,10,7845,17,3620,10164,1,1,2,0,-8
EUW1_6883466676',6,48,15,0,0,0,0,7,1,323,90,27713,29241,34876,6,56,11,0,0,0,0,6,352,70,26098,27640,35623,1,-29,20,1615,4,1601,-747,0,0,0,0,1
EUW1_6882560226',4,30,11,0,0,0,0,6,1,406,84,27732,30900,29825,2,28,3,2,1,1,0,2,431,103,24741,30751,29931,1,-25,-19,2991,8,149,-106,-2,-1,-1,0,4
EUW1_6882536714',8,28,24,0,0,2,0,5,1,386,57,33821,30372,40794,4,150,12,0,0,1,0,10,314,77,27156,27015,34659,1,72,-20,6665,12,3357,6135,0,0,1,0,-5
EUW1_6882508318',3,24,13,0,0,1,0,10,1,383,92,28110,31027,30109,5,46,16,2,0,1,0,2,362,94,30716,31835,32758,0,21,-2,-2606,-3,-808,-2649,-2,0,0,0,8
EUW1_6882491556',7,32,25,1,1,2,0,5,1,387,71,33447,31770,45885,3,281,16,0,0,0,0,5,292,108,28321,29400,47136,1,95,-37,5126,9,2370,-1251,1,1,2,0,0
EUW1_6882454362',3,47,16,1,0,0,0,16,0,328,76,27899,27136,30151,5,39,16,1,0,3,0,0,355,81,32457,26616,35734,0,-27,-5,-4558,0,520,-5583,0,0,-3,0,16
EUW1_6882429038',2,36,7,0,0,0,0,10,0,352,70,25281,26208,21513,4,25,13,2,0,2,0,4,368,89,28204,29695,31262,0,-16,-19,-2923,-6,-3487,-9749,-2,0,-2,0,6
EUW1_6882417706',6,29,13,1,0,2,0,8,1,379,78,29837,30321,30062,6,32,9,0,0,0,0,8,352,98,25593,29008,21673,1,27,-20,4244,4,1313,8389,1,0,2,0,0
EUW1_6882387978',4,32,10,0,0,1,0,9,1,417,71,27809,30540,24211,6,31,12,1,1,0,0,2,367,87,27788,31948,32076,0,50,-16,21,-2,-1408,-7865,-1,-1,1,0,7
EUW1_6882367241',4,26,14,0,0,0,0,11,0,374,88,28797,30962,33423,6,29,14,1,0,3,0,5,335,73,28864,29378,34390,0,39,15,-67,0,1584,-967,-1,0,-3,0,6
EUW1_6883271466',4,26,20,2,0,3,0,7,1,377,118,33177,33555,37936,0,17,5,0,0,0,0,7,329,69,22074,25285,28946,1,48,49,11103,15,8270,8990,2,0,3,0,0
EUW1_6856678677',5,28,15,0,0,0,0,7,1,321,93,28268,29446,28011,7,28,12,2,0,1,0,2,369,74,27845,29396,29024,0,-48,19,423,3,50,-1013,-2,0,-1,0,5
EUW1_6856665636',5,25,21,1,0,1,0,8,1,386,95,32167,32589,43629,4,28,8,0,0,1,0,4,341,80,24503,27652,31257,1,45,15,7664,13,4937,12372,1,0,0,0,4
EUW1_6854088198',3,27,6,0,1,1,0,6,0,381,100,26357,29178,23939,5,27,10,2,0,0,0,5,371,96,25786,30188,24139,1,10,4,571,-4,-1010,-200,-2,1,1,0,1
EUW1_6854058096',1,26,10,0,0,0,0,13,0,377,94,26759,29898,28669,5,33,16,2,0,1,0,2,368,85,29326,30005,33219,0,9,9,-2567,-6,-107,-4550,-2,0,-1,0,11
EUW1_6845959035',3,31,11,1,0,0,0,9,1,378,88,26538,30504,35582,0,25,5,1,0,1,0,1,360,88,24134,27445,23638,0,18,0,2404,6,3059,11944,0,0,-1,0,8
EUW1_6845945624',3,27,6,0,0,0,0,8,1,348,106,24329,28299,20508,2,22,8,2,1,2,0,3,401,78,28338,29685,20954,1,-53,28,-4009,-2,-1386,-446,-2,-1,-2,0,5
EUW1_6844120307',1,25,21,0,0,1,0,5,1,339,88,32399,32833,37645,0,27,17,1,0,0,0,5,383,96,29129,29779,35065,1,-44,-8,3270,4,3054,2580,-1,0,1,0,0
EUW1_6844063105',3,29,11,1,0,1,0,12,0,327,78,26636,29344,31973,5,33,15,0,0,2,0,3,380,94,29840,31375,31280,0,-53,-16,-3204,-4,-2031,693,1,0,-1,0,9
EUW1_6844020605',1,67,15,0,1,2,0,9,1,372,106,30829,31223,31623,2,26,12,2,0,2,0,7,336,80,27871,28336,35754,1,36,26,2958,3,2887,-4131,-2,1,0,0,2
EUW1_6843970936',3,35,14,0,0,2,0,8,1,404,92,30298,31408,32137,3,48,5,1,0,0,0,1,331,101,23586,28233,25274,1,73,-9,6712,9,3175,6863,-1,0,2,0,7
EUW1_6843561581',3,28,10,1,0,0,0,12,0,324,70,24710,26309,25763,1,20,16,1,0,3,0,2,361,134,30786,31588,32140,0,-37,-64,-6076,-6,-5279,-6377,0,0,-3,0,10
EUW1_6883260843',2,34,15,0,0,3,0,13,1,364,117,32299,31757,35745,3,20,12,1,0,3,0,12,347,80,29065,30101,26290,1,17,37,3234,3,1656,9455,-1,0,0,0,1
EUW1_6883191804',1,48,22,1,0,2,0,12,0,394,110,33796,34612,39635,1,25,8,0,0,1,0,6,352,80,25907,28420,32614,1,42,30,7889,14,6192,7021,1,0,1,0,6
EUW1_6883097349',2,46,12,2,1,0,0,11,0,371,112,27717,32063,39208,5,20,11,0,0,1,0,4,408,88,28479,30107,26028,1,-37,24,-762,1,1956,13180,2,1,-1,0,7
EUW1_6883069802',4,35,5,2,0,0,0,7,0,378,86,23840,28122,20974,6,33,20,0,0,0,0,3,411,76,30487,31398,37346,0,-33,10,-6647,-15,-3276,-16372,2,0,0,0,4
EUW1_6882824685',5,37,17,0,1,1,0,8,1,382,85,31108,31049,37875,8,26,16,1,0,0,0,2,306,74,27780,26730,29435,0,76,11,3328,1,4319,8440,-1,1,1,0,6
EUW1_6882780061',5,44,9,0,0,0,0,5,0,371,76,25487,28765,28714,4,115,11,2,1,0,0,1,383,100,26492,31125,32144,0,-12,-24,-1005,-2,-2360,-3430,-2,-1,0,0,4
EUW1_6881898228',2,33,6,0,0,0,0,8,0,395,75,24796,28292,30454,9,40,11,1,0,1,0,2,347,104,27458,30587,29060,0,48,-29,-2662,-5,-2295,1394,-1,0,-1,0,6
EUW1_6871300725',6,28,17,1,0,0,0,12,0,348,99,29059,31815,34693,7,30,15,1,0,2,0,3,369,92,31189,30504,32021,0,-21,7,-2130,2,1311,2672,0,0,-2,0,9
EUW1_6871250200',4,26,8,1,0,0,0,15,1,387,99,25652,29880,21049,4,62,12,1,0,2,0,3,398,104,29963,31123,28013,0,-11,-5,-4311,-4,-1243,-6964,0,0,-2,0,12
EUW1_6871216093',8,30,15,0,0,0,0,9,0,379,96,29348,31946,31433,3,27,14,2,0,1,0,2,401,84,30645,30589,33898,0,-22,12,-1297,1,1357,-2465,-2,0,-1,0,7
EUW1_6871191371',5,33,21,2,1,3,0,9,1,320,101,32125,30943,36880,1,21,8,0,0,1,0,5,410,80,26031,27772,23374,1,-90,21,6094,13,3171,13506,2,1,2,0,4
EUW1_6856682530',4,25,7,0,0,0,0,11,0,281,92,23893,26000,24782,2,24,20,2,0,3,0,3,418,100,34203,35776,39061,0,-137,-8,-10310,-13,-9776,-14279,-2,0,-3,0,8
EUW1_6856661428',3,31,11,1,1,0,0,14,0,318,87,25715,26052,31305,5,30,18,1,0,2,0,0,409,95,31706,30832,32514,0,-91,-8,-5991,-7,-4780,-1209,0,1,-2,0,14
EUW1_6856654933',6,33,18,0,0,2,0,4,0,387,105,33140,31803,39560,0,21,15,2,0,0,0,11,335,76,29152,30374,37547,0,52,29,3988,3,1429,2013,-2,0,2,0,-7
EUW1_6856634302',5,29,14,0,0,0,0,6,0,308,89,28412,27668,38779,4,34,16,1,0,0,0,7,357,79,28089,28931,36532,1,-49,10,323,-2,-1263,2247,-1,0,0,0,-1
EUW1_6856575986',3,32,21,0,0,0,0,13,1,335,79,31733,29553,44946,1,51,20,2,0,2,0,3,349,74,32159,30034,47784,0,-14,5,-426,1,-481,-2838,-2,0,-2,0,10
EUW1_6856548852',6,24,8,0,0,0,0,14,0,278,59,22948,24133,28008,4,27,20,0,1,3,0,1,405,104,33362,32728,35535,0,-127,-45,-10414,-12,-8595,-7527,0,-1,-3,0,13
EUW1_6856492389',1,63,7,0,0,0,0,5,1,383,80,25001,29875,24438,5,78,11,2,0,1,0,3,396,111,28180,30564,35104,0,-13,-31,-3179,-4,-689,-10666,-2,0,-1,0,2
EUW1_6856464326',2,25,7,0,0,0,0,10,0,354,112,24865,28323,23993,1,29,15,2,1,1,0,1,403,87,30948,31973,33876,0,-49,25,-6083,-8,-3650,-9883,-2,-1,-1,0,9
EUW1_6883760163',2,27,8,2,1,1,0,3,1,405,106,27365,31492,31092,4,36,8,0,0,1,0,4,372,86,25795,30931,27658,0,33,20,1570,0,561,3434,2,1,0,0,-1
EUW1_6882552887',3,27,14,0,1,0,0,10,1,340,84,27444,29943,33262,6,31,11,2,0,1,0,3,365,114,27474,30625,30081,0,-25,-30,-30,3,-682,3181,-2,1,-1,0,7
EUW1_6881013078',4,30,18,2,0,1,0,5,1,378,123,31287,32152,38568,2,18,7,0,0,0,0,11,353,101,24802,28972,20538,0,25,22,6485,11,3180,18030,2,0,1,0,-6
EUW1_6880983377',3,25,8,1,1,0,0,11,0,349,82,26004,28181,27973,5,28,16,1,0,1,0,1,377,118,31570,32517,34616,0,-28,-36,-5566,-8,-4336,-6643,0,1,-1,0,10
EUW1_6880966343',4,25,6,0,0,0,0,14,0,318,64,22717,24580,19502,3,29,26,1,0,4,0,0,406,82,35358,33442,43926,0,-88,-18,-12641,-20,-8862,-24424,-1,0,-4,0,14
EUW1_6880941711',7,29,11,1,1,0,0,7,0,374,97,26481,30273,26011,4,21,12,1,0,0,0,4,376,106,27130,31113,28602,1,-2,-9,-649,-1,-840,-2591,0,1,0,0,3
EUW1_6880912348',2,73,20,1,0,0,0,10,0,334,82,28743,30549,34602,3,33,15,1,0,1,0,1,361,94,29711,29760,35491,1,-27,-12,-968,5,789,-889,0,0,-1,0,9
EUW1_6880216398',4,27,13,1,0,2,0,6,1,354,102,28927,30333,30857,4,175,9,0,0,0,0,8,346,78,25078,27767,27450,1,8,24,3849,4,2566,3407,1,0,2,0,-2
EUW1_6880168945',6,40,15,1,0,0,0,17,0,322,84,28848,29143,33695,1,18,13,0,0,3,0,3,367,95,30068,30054,38695,0,-45,-11,-1220,2,-911,-5000,1,0,-3,0,14
EUW1_6880106827',5,42,6,0,0,0,0,10,0,350,82,22991,27287,26193,8,24,13,1,1,0,0,2,347,102,26553,29767,28880,0,3,-20,-3562,-7,-2480,-2687,-1,-1,0,0,8
EUW1_6880050225',5,33,10,1,0,0,0,12,1,299,78,24563,25878,22456,3,33,14,0,1,1,0,1,339,93,28366,28397,33425,0,-40,-15,-3803,-4,-2519,-10969,1,-1,-1,0,11
EUW1_6883664195',1,27,16,0,0,1,0,7,1,356,89,29478,31751,32246,8,31,14,1,0,0,0,2,333,80,26884,28856,32510,0,23,9,2594,2,2895,-264,-1,0,1,0,5
EUW1_6883641299',4,28,15,1,0,0,0,9,0,374,97,29478,31340,32479,4,30,17,1,0,0,0,2,351,106,29962,31381,41411,1,23,-9,-484,-2,-41,-8932,0,0,0,0,7
EUW1_6882920559',1,28,11,1,0,0,0,12,0,304,82,26275,27724,26232,6,26,14,0,1,2,0,4,359,102,29986,29929,37293,0,-55,-20,-3711,-3,-2205,-11061,1,-1,-2,0,8
EUW1_6879319287',4,66,21,1,0,2,0,13,0,385,83,34417,32368,42464,4,38,19,1,0,1,0,6,297,85,28234,28342,30970,1,88,-2,6183,2,4026,11494,0,0,1,0,7
EUW1_6879307696',2,271,9,1,1,1,0,13,1,340,104,25991,28302,29287,4,27,16,0,0,1,0,3,343,63,28699,31072,31837,0,-3,41,-2708,-7,-2770,-2550,1,1,0,0,10
EUW1_6874604299',5,32,11,0,0,1,0,13,1,364,82,27951,28395,33593,1,43,15,1,0,2,0,5,353,83,28753,28251,33270,0,11,-1,-802,-4,144,323,-1,0,-1,0,8
EUW1_6867635413',6,122,10,1,0,2,0,8,1,368,76,27641,28452,30516,3,30,9,0,0,1,0,7,359,107,25408,28126,32026,1,9,-31,2233,1,326,-1510,1,0,1,0,1
EUW1_6856661406',7,146,10,0,0,0,0,11,1,329,92,26102,27589,29175,3,24,23,2,0,1,0,1,368,112,33778,33884,45310,0,-39,-20,-7676,-13,-6295,-16135,-2,0,-1,0,10
EUW1_6856662629',2,26,13,1,0,0,0,12,1,337,80,27031,28168,34882,4,35,21,0,0,3,0,1,382,80,33128,32619,35602,0,-45,0,-6097,-8,-4451,-720,1,0,-3,0,11
EUW1_6856645044',9,30,17,1,0,1,0,8,1,349,96,31769,30455,33923,4,27,10,0,1,0,0,9,389,87,27313,28041,27094,1,-40,9,4456,7,2414,6829,1,-1,1,0,-1
EUW1_6856631108',6,63,14,1,0,1,0,6,1,405,90,29850,32199,30628,8,79,12,0,0,0,0,3,429,80,27966,30465,26241,1,-24,10,1884,2,1734,4387,1,0,1,0,3
EUW1_6851673747',4,25,17,0,0,1,0,10,0,295,86,28486,29848,30330,3,81,13,1,0,2,0,4,390,80,28625,29652,33743,1,-95,6,-139,4,196,-3413,-1,0,-1,0,6
EUW1_6850168199',5,25,11,2,1,0,0,8,1,392,92,28178,30166,22791,2,25,8,0,0,1,0,1,349,88,24585,28609,22306,0,43,4,3593,3,1557,485,2,1,-1,0,7
EUW1_6882849417',10,33,14,0,0,2,0,6,0,394,84,30154,30677,33389,3,25,10,1,0,0,0,4,372,73,26387,28218,32514,1,22,11,3767,4,2459,875,-1,0,2,0,2
EUW1_6882789269',3,26,16,1,0,2,0,14,0,343,116,31302,32386,39969,3,64,10,0,0,1,0,3,344,65,26550,27912,31657,1,-1,51,4752,6,4474,8312,1,0,1,0,11
EUW1_6882597630',3,23,8,0,0,0,0,13,1,348,72,25446,28551,24181,2,34,9,2,1,2,0,4,393,86,28169,30292,29367,0,-45,-14,-2723,-1,-1741,-5186,-2,-1,-2,0,9
EUW1_6882563767',3,60,19,1,1,1,0,8,1,356,96,30666,31359,50029,7,65,18,0,0,0,0,6,326,92,29373,30380,39063,1,30,4,1293,1,979,10966,1,1,1,0,2
EUW1_6882539783',8,67,15,2,0,3,0,5,1,437,89,33040,32917,36180,3,60,5,0,0,2,0,12,357,55,23959,26271,26658,1,80,34,9081,10,6646,9522,2,0,1,0,-7
EUW1_6881346790',0,22,8,2,0,0,0,7,1,398,70,25900,28158,27554,6,30,8,0,0,1,0,2,408,120,28048,31313,28616,0,-10,-50,-2148,0,-3155,-1062,2,0,-1,0,5
EUW1_6876745333',2,30,13,0,0,0,0,16,0,300,88,26793,27010,42769,0,19,27,1,1,3,0,2,336,84,35642,31965,51390,0,-36,4,-8849,-14,-4955,-8621,-1,-1,-3,0,14
EUW1_6876694339',5,28,7,0,1,0,0,8,1,364,82,25742,28266,29553,8,27,9,2,0,0,0,5,396,95,26593,31226,30296,0,-32,-13,-851,-2,-2960,-743,-2,1,0,0,3
EUW1_6876650244',4,31,8,1,1,1,0,8,1,351,88,26341,27826,23585,4,35,9,1,0,1,0,5,337,96,25896,27916,25548,0,14,-8,445,-1,-90,-1963,0,1,0,0,3
EUW1_6876633001',6,22,18,2,1,4,0,3,1,392,96,33100,32109,33605,1,19,4,0,0,0,0,11,325,96,22731,26073,27590,1,67,0,10369,14,6036,6015,2,1,4,0,-8
EUW1_6875740906',2,24,16,1,0,2,0,11,1,383,98,30005,30635,37384,2,32,9,1,0,0,0,5,303,78,25587,27180,24886,1,80,20,4418,7,3455,12498,0,0,2,0,6
EUW1_6875663317',2,30,7,0,0,0,0,3,0,433,80,26365,30023,21740,7,30,7,2,0,0,0,3,407,104,25349,30260,28329,1,26,-24,1016,0,-237,-6589,-2,0,0,0,0
EUW1_6875598814',4,23,10,0,0,2,0,7,1,374,86,28172,28152,31546,6,28,19,0,0,1,0,3,351,82,29880,31024,32177,0,23,4,-1708,-9,-2872,-631,0,0,1,0,4
EUW1_6875545921',4,31,21,2,1,2,0,5,1,411,90,34317,32155,44376,3,25,12,0,0,1,0,10,354,102,27571,28931,33766,1,57,-12,6746,9,3224,10610,2,1,1,0,-5
EUW1_6875507734',4,28,6,0,0,0,0,9,1,355,87,23686,27720,26250,3,24,12,1,1,3,0,3,386,88,29323,32156,30913,0,-31,-1,-5637,-6,-4436,-4663,-1,-1,-3,0,6
EUW1_6875447453',5,27,16,0,0,0,0,8,1,296,88,29474,30074,39978,6,28,21,1,0,1,0,4,348,78,30516,29818,38660,1,-52,10,-1042,-5,256,1318,-1,0,-1,0,4
EUW1_6883655316',5,27,21,1,0,4,0,2,1,411,128,37400,33862,31184,0,20,2,1,0,1,0,13,303,75,20840,24821,15864,1,108,53,16560,19,9041,15320,0,0,3,0,-11
EUW1_6883644150',1,23,19,1,0,0,0,9,0,347,97,29196,30232,34681,4,31,19,1,0,0,0,2,385,94,31591,31306,37523,1,-38,3,-2395,0,-1074,-2842,0,0,0,0,7
EUW1_6883610244',1,26,16,1,0,0,0,11,0,322,74,28214,28811,33687,7,25,19,0,0,1,0,2,339,90,29809,29450,34731,1,-17,-16,-1595,-3,-639,-1044,1,0,-1,0,9
EUW1_6883503957',3,25,10,0,0,0,0,13,0,277,61,24410,24871,35551,3,26,17,1,0,3,0,1,391,78,31006,30536,42190,0,-114,-17,-6596,-7,-5665,-6639,-1,0,-3,0,12
EUW1_6883416645',1,25,9,0,0,1,0,8,1,358,132,27432,30901,33320,2,27,13,2,0,0,0,4,347,84,26752,28992,30126,0,11,48,680,-4,1909,3194,-2,0,1,0,4
EUW1_6883361365',5,40,16,1,0,1,0,11,0,374,74,29656,31995,36445,3,24,9,1,0,0,0,3,352,99,26291,28732,34419,1,22,-25,3365,7,3263,2026,0,0,1,0,8
EUW1_6863408237',4,46,4,0,0,1,0,6,0,351,84,24070,27262,23479,5,37,12,2,0,1,0,5,387,94,27987,29457,27137,0,-36,-10,-3917,-8,-2195,-3658,-2,0,0,0,1
EUW1_6862160032',1,55,12,0,0,1,0,8,0,369,80,27348,28455,31115,6,68,19,1,0,1,0,6,389,115,32154,31703,38418,1,-20,-35,-4806,-7,-3248,-7303,-1,0,0,0,2
EUW1_6862137948',2,35,17,2,1,0,0,6,1,383,134,30845,33469,33756,6,35,8,0,0,0,0,4,367,90,25121,28179,25859,1,16,44,5724,9,5290,7897,2,1,0,0,2
EUW1_6862052570',5,25,13,0,0,0,0,13,1,344,91,27992,29123,35510,3,28,21,1,0,1,0,3,343,100,33274,31840,39539,0,1,-9,-5282,-8,-2717,-4029,-1,0,-1,0,10
EUW1_6860776515',1,27,4,0,0,0,0,11,1,354,77,22800,27229,24079,3,29,17,2,0,2,0,1,434,87,30538,32749,34602,0,-80,-10,-7738,-13,-5520,-10523,-2,0,-2,0,10
EUW1_6859415235',2,18,5,0,0,0,0,12,0,343,87,24372,27172,30530,1,26,15,2,0,3,0,5,369,104,30790,32159,38490,0,-26,-17,-6418,-10,-4987,-7960,-2,0,-3,0,7
EUW1_6872832804',5,45,6,0,0,0,0,12,0,310,80,23453,26282,30783,6,29,21,2,0,2,0,1,383,70,32178,32346,40283,0,-73,10,-8725,-15,-6064,-9500,-2,0,-2,0,11
EUW1_6872786852',9,34,9,0,0,0,0,7,1,358,115,25317,30815,29592,4,30,9,2,0,1,0,3,394,68,26494,29982,32372,0,-36,47,-1177,0,833,-2780,-2,0,-1,0,4
EUW1_6872700999',3,27,13,1,1,2,0,7,1,378,86,29251,30482,34077,2,32,15,1,0,0,0,7,328,88,27519,28190,28079,1,50,-2,1732,-2,2292,5998,0,1,2,0,0
EUW1_6872611723',5,30,7,0,0,0,0,4,0,381,84,24359,29148,23618,7,37,8,1,0,0,0,0,391,87,24808,29359,31089,0,-10,-3,-449,-1,-211,-7471,-1,0,0,0,4
EUW1_6872423182',4,27,7,1,0,1,0,12,0,320,88,25827,28193,25454,4,32,13,0,0,2,0,3,387,100,28547,30519,31560,0,-67,-12,-2720,-6,-2326,-6106,1,0,-1,0,9
EUW1_6871774004',7,29,11,1,0,1,0,8,0,356,90,28220,31139,30918,6,42,9,0,0,1,0,4,383,86,27170,30224,29612,1,-27,4,1050,2,915,1306,1,0,0,0,4
EUW1_6871740597',2,23,10,1,0,1,0,6,0,331,106,27208,28677,24830,4,39,7,1,0,0,0,8,355,70,23839,27232,21557,1,-24,36,3369,3,1445,3273,0,0,1,0,-2
EUW1_6871661548',5,30,16,1,0,0,0,7,1,366,81,29295,31183,30001,3,35,10,0,0,1,0,3,368,88,26429,28326,32340,1,-2,-7,2866,6,2857,-2339,1,0,-1,0,4
EUW1_6871610024',2,62,14,0,0,0,0,13,1,326,67,26958,28379,35700,4,65,15,1,0,3,0,0,358,93,30888,29100,34553,0,-32,-26,-3930,-1,-721,1147,-1,0,-3,0,13
EUW1_6871522475',2,27,17,0,1,1,0,7,1,362,97,30987,30677,28716,5,26,10,2,0,0,0,4,366,96,26466,29604,24273,1,-4,1,4521,7,1073,4443,-2,1,1,0,3
EUW1_6871454332',3,23,16,0,1,0,0,6,1,397,140,31284,34757,32211,2,19,10,1,0,1,0,6,402,78,27451,31901,28039,1,-5,62,3833,6,2856,4172,-1,1,-1,0,0
EUW1_6875029425',3,31,9,0,0,1,0,8,0,371,94,26342,29091,27902,5,27,14,1,0,1,0,1,328,102,28240,30310,28359,0,43,-8,-1898,-5,-1219,-457,-1,0,0,0,7
EUW1_6875022667',3,39,7,1,0,0,0,9,1,383,123,25420,29713,26373,4,191,9,1,0,2,0,1,378,76,26719,28603,27498,0,5,47,-1299,-2,1110,-1125,0,0,-2,0,8
EUW1_6875004263',7,45,9,0,0,0,0,10,0,397,91,26140,30658,29240,2,32,9,2,0,1,0,4,349,116,27220,30044,30433,0,48,-25,-1080,0,614,-1193,-2,0,-1,0,6
EUW1_6874987084',1,31,7,0,0,0,0,10,0,348,90,25344,28526,28987,4,28,14,1,0,1,0,0,362,108,28712,31329,34575,0,-14,-18,-3368,-7,-2803,-5588,-1,0,-1,0,10
EUW1_6873579742',6,32,6,0,0,1,0,4,0,395,95,26607,29364,21952,4,27,11,1,0,1,0,5,369,83,26654,29570,28817,1,26,12,-47,-5,-206,-6865,-1,0,0,0,-1
EUW1_6872962978',2,44,10,2,0,1,0,5,1,371,84,26909,29534,33020,6,70,7,0,0,0,0,4,347,90,24574,30191,32135,0,24,-6,2335,3,-657,885,2,0,1,0,1
EUW1_6868170334',2,21,7,0,0,0,0,10,0,346,93,24037,26564,32635,3,28,13,1,0,2,0,0,347,102,28684,30944,35167,0,-1,-9,-4647,-6,-4380,-2532,-1,0,-2,0,10
EUW1_6868031376',2,31,11,1,0,1,0,9,1,402,123,29729,31159,30091,2,25,10,0,0,2,0,6,353,88,26013,30051,27390,1,49,35,3716,1,1108,2701,1,0,-1,0,3
EUW1_6866115624',3,27,16,0,0,1,0,6,1,384,96,30015,30904,38887,4,27,15,2,0,1,0,1,400,67,29415,31559,36085,0,-16,29,600,1,-655,2802,-2,0,0,0,5
EUW1_6866086052',4,22,12,2,0,0,0,10,0,390,124,28200,32413,22000,0,23,2,0,0,2,0,6,371,84,22766,26471,20603,1,19,40,5434,10,5942,1397,2,0,-2,0,4
EUW1_6866043319',2,22,15,2,0,1,0,8,1,378,108,30834,30961,30602,2,51,14,0,0,0,0,3,387,67,28234,29440,36611,0,-9,41,2600,1,1521,-6009,2,0,1,0,5
EUW1_6865131276',2,24,13,1,0,1,0,10,1,325,88,27964,27003,26821,3,29,16,0,0,1,0,7,325,80,29008,29221,34264,0,0,8,-1044,-3,-2218,-7443,1,0,0,0,3
EUW1_6865088509',5,43,14,2,1,0,0,6,0,346,90,27651,29681,31421,1,148,11,0,0,0,0,4,329,84,25656,29551,31528,1,17,6,1995,3,130,-107,2,1,0,0,2
EUW1_6864965846',0,51,12,1,0,1,0,12,1,341,63,27486,29740,31133,1,72,20,1,0,2,0,3,369,84,32046,30550,46252,0,-28,-21,-4560,-8,-810,-15119,0,0,-1,0,9
EUW1_6864882468',5,38,9,2,0,0,0,9,0,310,76,24938,26771,27618,2,25,7,0,0,0,0,3,338,88,24575,27722,21206,0,-28,-12,363,2,-951,6412,2,0,0,0,6
EUW1_6864473880',2,24,3,0,0,0,0,16,1,351,94,22854,26875,19696,6,32,16,2,1,3,0,3,400,118,32811,33529,29638,0,-49,-24,-9957,-13,-6654,-9942,-2,-1,-3,0,13
EUW1_6864453159',2,37,19,1,0,1,0,6,0,352,92,30032,29589,35949,5,30,11,0,0,0,0,4,340,76,26100,29101,25757,1,12,16,3932,8,488,10192,1,0,1,0,2
EUW1_6864423101',1,23,23,0,0,2,0,8,0,318,90,34294,30587,49514,3,28,17,2,0,1,0,12,355,70,29564,28374,41136,0,-37,20,4730,6,2213,8378,-2,0,1,0,-4
EUW1_6863192168',5,29,13,2,1,2,0,12,0,390,99,31559,31060,33832,5,95,12,0,0,1,0,7,356,75,26387,29399,27144,1,34,24,5172,1,1661,6688,2,1,1,0,5
EUW1_6881609349',0,55,13,0,0,1,0,11,0,326,102,27911,28721,34063,5,25,16,1,0,0,0,4,340,86,28308,28735,31422,1,-14,16,-397,-3,-14,2641,-1,0,1,0,7
EUW1_6881547728',7,34,14,1,0,0,0,11,0,349,106,28309,29767,34685,5,28,13,1,0,0,0,2,367,84,27802,29257,30329,0,-18,22,507,1,510,4356,0,0,0,0,9
EUW1_6881454968',3,27,10,0,0,0,0,11,1,379,88,26819,29807,26476,6,64,20,1,0,1,0,4,349,83,31248,30164,35984,0,30,5,-4429,-10,-357,-9508,-1,0,-1,0,7
EUW1_6881368096',5,62,11,1,0,0,0,8,1,318,94,27075,29560,28561,5,66,5,0,0,0,0,3,368,112,24400,29309,25824,0,-50,-18,2675,6,251,2737,1,0,0,0,5
EUW1_6872625616',2,29,17,0,0,1,0,9,0,372,103,30311,31637,45402,2,30,15,1,0,0,0,6,345,88,29147,30481,38042,0,27,15,1164,2,1156,7360,-1,0,1,0,3
EUW1_6872587398',3,34,11,2,1,1,0,7,0,387,100,28462,30539,21925,2,20,11,0,0,0,0,4,356,96,26714,28115,27080,1,31,4,1748,0,2424,-5155,2,1,1,0,3
EUW1_6872566573',3,36,9,0,0,0,0,6,1,380,112,26308,29759,28923,5,24,12,1,0,0,0,2,357,96,26685,30602,32034,0,23,16,-377,-3,-843,-3111,-1,0,0,0,4
EUW1_6872521374',3,25,11,0,0,0,0,7,0,333,78,26029,28886,26818,1,30,12,2,0,1,0,6,407,108,29301,31485,30801,1,-74,-30,-3272,-1,-2599,-3983,-2,0,-1,0,1
EUW1_6871375159',3,57,12,0,0,0,0,16,0,295,62,25674,26969,28282,5,63,19,2,0,3,0,2,407,118,34051,31882,41686,0,-112,-56,-8377,-7,-4913,-13404,-2,0,-3,0,14
EUW1_6871341788',4,30,18,1,0,2,0,5,1,413,98,30792,31999,38223,0,28,12,0,0,0,0,7,319,109,27159,30132,26709,1,94,-11,3633,6,1867,11514,1,0,2,0,-2
EUW1_6871292911',5,38,8,0,0,1,0,7,1,360,79,26413,27941,32581,3,26,13,1,0,0,0,5,377,90,27572,29878,32234,0,-17,-11,-1159,-5,-1937,347,-1,0,1,0,2
EUW1_6871242802',7,46,10,0,0,0,0,7,0,375,77,25839,28772,24939,3,29,12,1,0,0,0,1,393,104,28250,32452,27033,1,-18,-27,-2411,-2,-3680,-2094,-1,0,0,0,6
EUW1_6864808972',5,27,16,1,0,1,0,12,1,372,112,29817,32303,33911,3,23,9,0,0,1,0,4,372,72,26124,29047,30242,1,0,40,3693,7,3256,3669,1,0,0,0,8
EUW1_6864788583',3,27,27,2,0,2,0,11,0,398,82,35570,33360,44648,5,30,11,0,0,2,0,4,341,78,26914,28292,40081,1,57,4,8656,16,5068,4567,2,0,0,0,7
EUW1_6864765798',3,44,28,1,0,4,0,6,1,413,106,37673,34565,48323,0,24,8,0,0,0,0,11,305,58,23580,26293,29675,1,108,48,14093,20,8272,18648,1,0,4,0,-5
EUW1_6864735735',1,49,10,1,0,0,0,10,1,395,94,28131,30955,33536,0,31,4,1,0,2,0,4,364,73,23484,28165,27726,1,31,21,4647,6,2790,5810,0,0,-2,0,6
EUW1_6864711859',3,62,9,0,0,1,0,15,1,314,61,24859,26247,31661,3,125,22,1,0,2,0,3,364,90,32090,32462,34771,0,-50,-29,-7231,-13,-6215,-3110,-1,0,-1,0,12
EUW1_6864689498',3,25,13,0,0,0,0,7,0,340,92,27051,29578,38198,2,25,21,2,0,1,0,0,384,88,31095,31444,41042,0,-44,4,-4044,-8,-1866,-2844,-2,0,-1,0,7
EUW1_6864665644',1,210,15,1,0,2,0,11,1,368,99,29178,29308,24400,4,29,5,0,0,1,0,4,396,78,24873,28968,19648,0,-28,21,4305,10,340,4752,1,0,1,0,7
EUW1_6863417760',1,17,5,1,0,0,0,16,0,330,100,22817,25910,23111,0,104,22,1,0,3,0,2,407,89,33182,33967,35953,0,-77,11,-10365,-17,-8057,-12842,0,0,-3,0,14
EUW1_6882944423',3,232,16,0,1,0,0,7,0,395,94,30321,33326,34729,4,31,9,1,0,1,0,3,383,102,26944,29469,30217,1,12,-8,3377,7,3857,4512,-1,1,-1,0,4
EUW1_6882884423',6,36,12,1,0,1,0,16,0,342,95,26656,28433,27204,6,26,14,0,0,2,0,6,357,87,29999,29798,34915,0,-15,8,-3343,-2,-1365,-7711,1,0,-1,0,10
EUW1_6882828412',2,25,15,0,0,1,0,11,1,336,86,28855,28915,35600,2,98,16,0,0,0,0,4,317,70,28411,30807,33096,1,19,16,444,-1,-1892,2504,0,0,1,0,7
EUW1_6882247898',5,29,5,1,0,0,0,10,0,325,78,23040,26869,22650,1,49,15,1,0,3,0,1,375,81,31413,30089,36154,0,-50,-3,-8373,-10,-3220,-13504,0,0,-3,0,9
EUW1_6882187441',5,28,12,1,0,0,0,6,0,398,106,28417,31924,28027,5,28,9,1,0,0,0,4,396,97,27550,30347,31012,0,2,9,867,3,1577,-2985,0,0,0,0,2
EUW1_6882048478',5,44,15,0,0,2,0,5,1,398,92,31246,31805,35597,2,36,16,1,0,0,0,10,346,92,28762,31932,37850,0,52,0,2484,-1,-127,-2253,-1,0,2,0,-5
EUW1_6881911148',6,31,14,1,0,1,0,11,1,368,112,29382,31803,34179,3,23,9,1,0,1,0,2,366,72,26131,28024,29170,0,2,40,3251,5,3779,5009,0,0,0,0,9
EUW1_6881384779',5,27,13,1,0,0,0,9,1,336,92,27368,27935,33155,7,63,15,1,0,1,0,0,329,84,28007,28426,28001,0,7,8,-639,-2,-491,5154,0,0,-1,0,9
EUW1_6881335070',9,52,10,0,0,0,0,13,0,310,76,24968,26470,25275,5,28,20,1,0,3,0,0,378,88,33094,30965,43510,0,-68,-12,-8126,-10,-4495,-18235,-1,0,-3,0,13
EUW1_6880644770',4,29,13,2,0,4,0,8,1,388,82,31040,28153,34722,0,22,13,0,0,1,0,9,273,73,25817,27643,30943,1,115,9,5223,0,510,3779,2,0,3,0,-1
EUW1_6880595784',3,44,15,0,0,1,0,12,0,377,90,28834,30292,37409,3,51,15,1,0,1,0,2,351,85,28665,29655,31225,0,26,5,169,0,637,6184,-1,0,0,0,10
EUW1_6880560490',4,28,18,2,0,2,0,6,0,370,104,31382,33567,37293,2,33,9,0,0,1,0,5,342,71,24175,27174,31355,1,28,33,7207,9,6393,5938,2,0,1,0,1
EUW1_6870933487',6,36,23,2,0,0,0,10,1,325,64,31904,27203,46839,5,34,9,0,0,1,0,3,331,72,25741,25718,29025,1,-6,-8,6163,14,1485,17814,2,0,-1,0,7
EUW1_6870914413',5,30,11,0,0,0,0,14,0,273,86,25685,26539,30005,6,32,26,2,1,5,0,0,384,102,36600,33102,45340,0,-111,-16,-10915,-15,-6563,-15335,-2,-1,-5,0,14
EUW1_6870899261',1,26,14,2,0,3,0,8,1,346,82,30084,27981,35424,5,25,16,0,0,1,0,7,308,95,28780,29127,36632,1,38,-13,1304,-2,-1146,-1208,2,0,2,0,1
EUW1_6870884652',4,25,20,0,1,0,0,10,1,352,102,30373,31571,43991,7,28,18,1,0,2,0,4,390,92,31145,31261,35432,1,-38,10,-772,2,310,8559,-1,1,-2,0,6
EUW1_6870860476',4,28,14,0,0,0,0,12,1,288,81,26970,27540,38699,4,63,14,2,0,1,0,4,392,80,29026,30285,33558,0,-104,1,-2056,0,-2745,5141,-2,0,-1,0,8
EUW1_6870817130',8,32,12,0,0,1,0,5,1,363,80,27437,29447,31049,6,24,7,1,0,0,0,5,282,72,23352,25487,22253,1,81,8,4085,5,3960,8796,-1,0,1,0,0
EUW1_6870786108',3,28,11,0,0,1,0,10,0,335,90,27484,28321,34668,2,31,20,1,0,0,0,4,314,87,30791,29811,34224,0,21,3,-3307,-9,-1490,444,-1,0,1,0,6
EUW1_6870742013',3,21,17,1,0,1,0,7,0,337,76,28529,28306,36933,4,47,18,1,0,1,0,4,357,80,31522,30880,43788,0,-20,-4,-2993,-1,-2574,-6855,0,0,0,0,3
EUW1_6870531456',3,29,19,2,0,4,0,2,1,398,120,33342,33265,35953,4,17,5,0,0,0,0,13,366,68,22989,26471,24551,1,32,52,10353,14,6794,11402,2,0,4,0,-11
EUW1_6870459105',2,26,12,2,0,3,1,3,1,390,86,31046,30047,27915,1,69,4,0,0,3,0,11,357,68,22964,27115,19277,1,33,18,8082,8,2932,8638,2,0,0,1,-8
EUW1_6870353347',3,18,13,0,0,0,0,15,1,321,86,25827,28377,30112,2,21,16,2,0,1,0,1,370,109,29386,32512,39399,0,-49,-23,-3559,-3,-4135,-9287,-2,0,-1,0,14
EUW1_6870210032',3,138,11,1,1,1,0,9,0,318,136,27544,28816,30921,1,35,7,0,0,2,0,5,335,30,23025,24055,22074,1,-17,106,4519,4,4761,8847,1,1,-1,0,4
EUW1_6870120915',1,11,9,0,0,1,0,11,0,322,99,25844,29463,27485,3,19,17,2,0,4,0,4,395,80,30905,31577,38055,0,-73,19,-5061,-8,-2114,-10570,-2,0,-3,0,7
EUW1_6869989155',1,22,9,1,0,0,0,5,1,306,62,24091,27481,22777,3,20,6,1,0,1,0,1,395,98,25712,29631,24372,1,-89,-36,-1621,3,-2150,-1595,0,0,-1,0,4
EUW1_6869791909',4,26,14,1,0,1,0,5,1,350,115,29358,31597,29853,1,34,16,0,0,0,0,6,354,86,27260,30531,27408,1,-4,29,2098,-2,1066,2445,1,0,1,0,-1
EUW1_6869731023',2,19,12,1,0,0,0,10,0,385,85,27178,29850,34196,3,29,13,0,0,1,0,2,372,97,29721,32617,36021,0,13,-12,-2543,-1,-2767,-1825,1,0,-1,0,8
EUW1_6869635748',2,23,16,2,0,7,1,5,1,427,76,33073,31016,36679,5,17,1,0,0,0,0,9,250,72,18313,20830,17988,1,177,4,14760,15,10186,18691,2,0,7,1,-4
EUW1_6869605514',2,25,18,1,0,1,0,15,0,362,106,32923,32505,41062,3,28,10,0,0,2,0,7,347,58,27549,26856,27162,1,15,48,5374,8,5649,13900,1,0,-1,0,8
EUW1_6869563659',0,23,4,0,0,0,0,10,0,336,61,22452,25116,20773,7,33,14,2,0,1,0,3,371,86,28238,30612,31634,0,-35,-25,-5786,-10,-5496,-10861,-2,0,-1,0,7
EUW1_6877095053',3,26,10,1,0,0,0,12,0,315,91,26068,28964,38705,2,23,18,1,0,2,0,1,383,92,30959,33060,38604,0,-68,-1,-4891,-8,-4096,101,0,0,-2,0,11
EUW1_6872427991',6,33,14,2,0,1,0,9,1,341,70,28070,29148,28343,5,31,14,0,0,1,0,1,353,97,27261,29405,31738,1,-12,-27,809,0,-257,-3395,2,0,0,0,8
EUW1_6872383702',4,28,9,2,0,0,0,9,1,337,88,24594,27766,27249,5,26,14,0,0,1,0,1,386,107,28805,31368,29489,0,-49,-19,-4211,-5,-3602,-2240,2,0,-1,0,8
EUW1_6870964019',5,29,22,0,0,2,0,6,1,361,84,33196,31068,41169,4,26,6,0,0,1,0,10,311,67,23733,25856,32060,1,50,17,9463,16,5212,9109,0,0,1,0,-4
EUW1_6869486851',5,41,8,0,0,0,0,6,1,376,100,26318,31043,28937,5,26,13,2,0,0,0,3,380,103,27394,32263,31456,0,-4,-3,-1076,-5,-1220,-2519,-2,0,0,0,3
EUW1_6867629418',2,48,8,0,0,1,0,7,0,353,122,28218,29827,26990,4,48,16,2,0,0,0,7,347,80,27251,28854,26745,0,6,42,967,-8,973,245,-2,0,1,0,0
EUW1_6866625923',2,26,14,1,1,0,0,8,1,352,96,27288,31331,25683,0,32,9,1,0,0,0,2,381,103,27199,29422,31549,1,-29,-7,89,5,1909,-5866,0,1,0,0,6
EUW1_6866257768',5,32,8,0,0,1,0,9,1,351,72,25622,27668,28648,4,31,12,0,0,2,0,4,386,67,27849,29804,35327,1,-35,5,-2227,-4,-2136,-6679,0,0,-1,0,5
EUW1_6866184146',1,23,12,1,0,0,0,19,0,269,94,25684,26575,34831,0,29,22,1,0,4,0,0,335,92,33546,29339,40397,0,-66,2,-7862,-10,-2764,-5566,0,0,-4,0,19
EUW1_6864383655',1,23,16,1,1,3,0,9,1,347,82,31469,28720,34310,0,21,10,1,0,0,0,10,351,94,25902,28290,28750,1,-4,-12,5567,6,430,5560,0,1,3,0,-1
EUW1_6864239356',3,29,12,1,0,0,0,15,0,343,82,26662,30240,30445,5,29,8,0,0,2,0,2,397,82,27503,28982,25963,1,-54,0,-841,4,1258,4482,1,0,-2,0,13
EUW1_6862225002',2,28,11,0,0,1,0,9,1,367,82,27830,30048,31712,4,37,16,1,0,0,0,2,377,97,28856,33305,30492,0,-10,-15,-1026,-5,-3257,1220,-1,0,1,0,7
EUW1_6862036650',3,25,13,1,0,0,0,2,0,357,88,27523,29969,34463,1,22,11,1,0,0,0,5,351,76,26721,29543,25177,1,6,12,802,2,426,9286,0,0,0,0,-3
EUW1_6862012649',1,21,9,0,0,1,0,13,0,324,81,26933,28199,34315,4,96,20,2,0,1,0,4,312,93,29950,28870,36181,0,12,-12,-3017,-11,-671,-1866,-2,0,0,0,9
EUW1_6860266647',5,35,13,1,0,0,0,7,1,356,83,28315,28476,29491,6,31,8,0,0,0,0,5,357,95,26188,28920,32511,1,-1,-12,2127,5,-444,-3020,1,0,0,0,2
EUW1_6859366974',3,29,9,0,0,0,0,18,0,317,83,24851,27122,26248,3,65,22,2,0,3,0,4,381,80,34633,32322,43312,0,-64,3,-9782,-13,-5200,-17064,-2,0,-3,0,14
EUW1_6858015543',1,28,8,1,0,0,0,6,1,359,64,25407,26736,30563,4,32,15,1,0,1,0,3,365,92,29741,29989,32377,0,-6,-28,-4334,-7,-3253,-1814,0,0,-1,0,3
EUW1_6857950292',2,22,8,0,0,0,0,12,0,324,71,24114,26620,23727,5,29,19,2,0,2,0,0,410,92,32262,32117,32750,0,-86,-21,-8148,-11,-5497,-9023,-2,0,-2,0,12
EUW1_6883437692',5,28,9,0,0,0,0,10,1,340,74,26176,29297,30289,1,32,17,2,0,1,0,3,378,110,30018,32741,41937,0,-38,-36,-3842,-8,-3444,-11648,-2,0,-1,0,7
EUW1_6869119207',3,25,12,0,0,0,0,11,1,317,80,24487,24898,28037,4,225,22,1,0,1,0,2,331,87,30887,30946,35474,0,-14,-7,-6400,-10,-6048,-7437,-1,0,-1,0,9
EUW1_6869093479',3,29,6,1,0,0,0,11,0,333,89,24086,27636,24289,7,38,15,1,0,2,0,1,356,126,29445,30991,31546,0,-23,-37,-5359,-9,-3355,-7257,0,0,-2,0,10
EUW1_6869046123',4,28,17,1,0,0,0,8,1,402,122,30974,32845,38448,4,22,10,1,0,1,0,4,351,94,26354,29184,27745,1,51,28,4620,7,3661,10703,0,0,-1,0,4
EUW1_6878586130',3,27,8,1,0,1,0,7,0,391,83,26454,29816,28451,5,39,8,0,0,0,0,5,393,103,27240,31187,30437,0,-2,-20,-786,0,-1371,-1986,1,0,1,0,2
EUW1_6878548392',4,27,11,0,0,0,0,15,0,350,78,26201,30428,32437,3,30,18,1,0,3,0,5,377,93,32452,33743,39530,0,-27,-15,-6251,-7,-3315,-7093,-1,0,-3,0,10
EUW1_6878500721',3,26,15,1,0,1,0,7,1,372,99,30077,30007,36613,2,76,12,1,0,1,0,4,347,80,26422,27801,29147,1,25,19,3655,3,2206,7466,0,0,0,0,3
EUW1_6878337697',5,20,18,1,1,2,0,5,1,331,106,31514,29480,36526,3,23,10,1,0,0,0,9,288,78,23972,24152,27868,1,43,28,7542,8,5328,8658,0,1,2,0,-4
EUW1_6878293595',3,23,10,1,0,0,0,15,0,358,96,27373,29014,31832,8,161,24,1,1,3,0,2,391,98,34574,35125,45446,0,-33,-2,-7201,-14,-6111,-13614,0,-1,-3,0,13
EUW1_6878148108',6,31,19,1,1,2,0,4,1,396,94,32427,34350,37781,7,41,4,0,0,0,0,9,339,106,23389,27589,24863,1,57,-12,9038,15,6761,12918,1,1,2,0,-5
EUW1_6876732893',2,34,16,1,1,1,0,11,1,323,116,30058,29003,33020,5,31,12,1,0,2,0,4,344,68,27866,28450,30942,0,-21,48,2192,4,553,2078,0,1,-1,0,7
EUW1_6876687332',1,32,14,1,1,0,0,12,1,368,70,29041,28759,33980,3,27,10,0,0,3,0,5,354,78,27023,28504,26121,0,14,-8,2018,4,255,7859,1,1,-3,0,7
EUW1_6876579002',5,26,17,1,0,1,0,10,0,316,82,30101,30057,29555,4,29,8,1,0,1,0,5,356,117,26210,27730,28044,0,-40,-35,3891,9,2327,1511,0,0,0,0,5
EUW1_6875273275',0,27,6,1,0,2,0,9,1,403,92,27153,30433,29624,2,23,7,1,0,0,0,5,372,92,24562,27859,23279,0,31,0,2591,-1,2574,6345,0,0,2,0,4
EUW1_6875080561',4,25,11,0,0,0,0,12,0,306,73,26180,26560,31822,6,34,20,1,0,1,0,4,324,90,30187,30320,35219,0,-18,-17,-4007,-9,-3760,-3397,-1,0,-1,0,8
EUW1_6872412785',4,53,6,0,0,0,0,7,0,368,83,23730,27434,29463,4,29,6,1,0,0,0,0,321,94,23827,28557,24929,0,47,-11,-97,0,-1123,4534,-1,0,0,0,7
EUW1_6872391839',2,44,10,1,0,0,0,7,0,360,118,25973,28487,22378,8,26,11,0,0,1,0,0,387,64,27052,27550,22886,1,-27,54,-1079,-1,937,-508,1,0,-1,0,7
EUW1_6869000053',4,24,11,1,0,0,0,13,0,345,74,26802,28819,44286,3,22,16,0,0,2,0,2,338,89,29560,29009,36530,0,7,-15,-2758,-5,-190,7756,1,0,-2,0,11
EUW1_6868950131',5,30,13,2,0,2,0,7,1,415,132,29890,32898,28668,4,34,4,0,0,0,0,4,382,76,23190,28103,16708,1,33,56,6700,9,4795,11960,2,0,2,0,3
EUW1_6881654956',5,27,19,1,0,3,0,4,1,359,84,31962,30932,31886,2,31,10,0,0,0,0,9,361,81,25299,28227,32602,1,-2,3,6663,9,2705,-716,1,0,3,0,-5
EUW1_6881378950',1,31,8,2,0,1,0,14,0,344,104,26711,29246,33677,6,25,18,0,0,2,0,3,353,100,31150,31976,36918,0,-9,4,-4439,-10,-2730,-3241,2,0,-1,0,11
EUW1_6881220042',4,36,29,2,0,1,0,8,1,383,85,35934,32818,50173,3,29,9,0,0,0,0,5,377,79,26491,29109,31666,1,6,6,9443,20,3709,18507,2,0,1,0,3
EUW1_6880163700',2,25,22,2,0,1,0,14,1,329,91,30967,30414,32254,7,36,12,0,0,3,0,2,359,79,30931,28966,30485,1,-30,12,36,10,1448,1769,2,0,-2,0,12
EUW1_6880120235',5,24,21,0,0,3,0,9,1,370,94,34900,30284,37954,0,24,11,2,0,1,0,9,293,77,26017,25910,28926,1,77,17,8883,10,4374,9028,-2,0,2,0,0
EUW1_6880059852',8,42,10,0,0,0,0,10,0,323,76,25568,28672,29628,3,30,13,1,0,1,0,0,370,100,28501,29709,31262,1,-47,-24,-2933,-3,-1037,-1634,-1,0,-1,0,10
EUW1_6879988156',3,27,10,1,0,1,0,9,1,375,82,27534,28980,27688,3,257,11,0,0,0,0,4,319,92,25836,27558,25800,1,56,-10,1698,-1,1422,1888,1,0,1,0,5
EUW1_6879950880',3,29,13,2,0,2,0,10,1,362,92,30120,30719,36860,0,54,11,0,0,3,0,7,313,78,25770,28700,35590,1,49,14,4350,2,2019,1270,2,0,-1,0,3
EUW1_6879897900',5,26,11,0,0,0,0,2,1,357,78,25484,28550,38138,3,111,10,2,1,0,0,3,339,114,26114,30458,39094,0,18,-36,-630,1,-1908,-956,-2,-1,0,0,-1
EUW1_6879804958',3,25,15,2,1,0,0,6,1,372,104,29114,31795,29564,4,31,11,0,0,0,0,2,372,96,27230,30544,30432,1,0,8,1884,4,1251,-868,2,1,0,0,4
EUW1_6879759990',3,28,10,0,0,0,0,12,1,348,48,25658,28233,29450,5,37,8,1,0,1,0,1,376,107,26682,29035,30431,0,-28,-59,-1024,2,-802,-981,-1,0,-1,0,11
EUW1_6879703075',5,29,7,1,0,1,0,7,1,374,78,26242,28484,27174,8,25,7,1,0,0,0,7,306,102,23797,27809,25026,0,68,-24,2445,0,675,2148,0,0,1,0,0
EUW1_6883643377',6,31,12,1,1,0,0,13,0,342,68,26151,27437,25978,2,45,13,0,0,1,0,1,359,96,28434,28041,27561,0,-17,-28,-2283,-1,-604,-1583,1,1,-1,0,12
EUW1_6883561916',5,28,15,1,0,0,0,7,1,362,68,27635,28199,32672,6,30,17,0,0,1,0,2,360,101,30800,31023,32096,1,2,-33,-3165,-2,-2824,576,1,0,-1,0,5
EUW1_6880227421',5,30,22,2,0,2,0,15,0,369,92,33177,31647,46575,7,46,9,0,0,2,0,6,324,65,26779,26274,32793,1,45,27,6398,13,5373,13782,2,0,0,0,9
EUW1_6873969398',2,25,21,1,1,2,0,8,0,318,104,30984,30567,40697,3,22,11,0,0,0,0,6,330,68,27342,27808,32745,1,-12,36,3642,10,2759,7952,1,1,2,0,2
EUW1_6873948143',8,70,9,0,0,0,0,7,1,350,92,25247,28992,31150,7,65,11,2,0,0,0,3,386,112,28117,33018,41005,0,-36,-20,-2870,-2,-4026,-9855,-2,0,0,0,4
EUW1_6873562292',3,41,6,2,0,2,0,6,0,402,83,26942,28638,22909,4,44,13,0,0,0,0,6,322,89,26115,28341,21383,0,80,-6,827,-7,297,1526,2,0,2,0,0
EUW1_6873519154',0,21,13,0,0,0,0,3,0,430,101,29720,32312,32295,7,24,7,1,0,0,0,8,337,60,23462,27011,17173,1,93,41,6258,6,5301,15122,-1,0,0,0,-5
EUW1_6873369475',4,45,5,1,0,0,0,8,1,371,96,23808,29252,17391,3,29,10,1,0,1,0,1,425,120,28433,32802,22020,0,-54,-24,-4625,-5,-3550,-4629,0,0,-1,0,7
EUW1_6873292424',2,26,8,0,0,0,0,12,1,378,90,26280,31190,25544,5,33,9,2,0,1,0,5,400,93,27084,30226,29119,0,-22,-3,-804,-1,964,-3575,-2,0,-1,0,7
EUW1_6873191667',5,28,19,0,1,0,0,9,0,363,76,31791,28858,39082,2,31,19,1,0,2,0,3,334,71,30322,29540,36797,0,29,5,1469,0,-682,2285,-1,1,-2,0,6
EUW1_6873109793',0,60,6,1,0,0,0,13,0,273,91,24070,24469,25712,4,95,16,1,0,3,0,4,335,64,28684,28318,39588,0,-62,27,-4614,-10,-3849,-13876,0,0,-3,0,9
EUW1_6873033285',6,31,15,1,0,0,0,12,1,350,102,28784,32046,28999,3,30,4,1,0,3,0,7,364,100,25491,29523,30289,1,-14,2,3293,11,2523,-1290,0,0,-3,0,5
EUW1_6872694069',6,35,16,0,0,0,0,7,1,338,94,29736,31786,39517,5,193,15,2,0,0,0,3,341,84,28837,29052,34287,0,-3,10,899,1,2734,5230,-2,0,0,0,4
EUW1_6872647344',1,25,10,0,0,0,0,13,0,364,78,25989,30446,27803,4,31,10,2,0,2,0,3,426,114,29911,31466,34200,1,-62,-36,-3922,0,-1020,-6397,-2,0,-2,0,10
EUW1_6870273932',6,31,11,1,0,1,0,9,1,319,106,27271,27639,25035,2,28,7,1,1,1,0,6,378,98,27055,29901,20387,1,-59,8,216,4,-2262,4648,0,-1,0,0,3
EUW1_6870222469',3,135,4,1,0,0,0,10,1,335,96,22872,27260,20878,4,30,15,1,0,2,0,2,377,83,28675,32045,29221,0,-42,13,-5803,-11,-4785,-8343,0,0,-2,0,8
EUW1_6870121887',3,23,15,1,0,2,0,9,1,397,102,31044,32677,30092,3,29,10,1,0,0,0,5,401,89,28524,29234,27387,1,-4,13,2520,5,3443,2705,0,0,2,0,4
EUW1_6883773097',6,154,9,0,0,0,0,8,1,347,80,25756,28858,29785,5,37,12,2,1,1,0,3,407,79,28323,31677,27977,0,-60,1,-2567,-3,-2819,1808,-2,-1,-1,0,5
EUW1_6883763554',5,35,10,1,0,0,0,11,0,324,70,26922,28346,33403,4,32,19,1,0,1,0,1,372,84,30922,31469,40998,0,-48,-14,-4000,-9,-3123,-7595,0,0,-1,0,10
EUW1_6883732196',4,25,13,0,0,0,0,9,1,344,75,26883,27318,39182,6,29,10,2,0,0,0,2,344,101,25540,29638,24423,1,0,-26,1343,3,-2320,14759,-2,0,0,0,7
EUW1_6883721807',4,22,9,0,0,0,0,12,1,294,102,24802,27670,26751,4,25,22,2,0,3,0,2,379,94,33810,33023,36930,0,-85,8,-9008,-13,-5353,-10179,-2,0,-3,0,10
EUW1_6882846139',3,55,8,2,0,1,0,11,0,382,77,26985,27987,28854,2,36,10,0,0,1,0,5,347,88,25455,28534,22683,1,35,-11,1530,-2,-547,6171,2,0,0,0,6
EUW1_6881524378',4,24,9,0,1,1,0,10,0,391,90,27509,30464,26532,4,31,10,2,0,0,0,3,391,106,27509,30428,22842,0,0,-16,0,-1,36,3690,-2,1,1,0,7
EUW1_6881447764',1,28,10,1,0,1,0,13,1,368,87,27938,29151,29561,10,35,13,1,0,3,0,5,372,78,29229,28812,26655,1,-4,9,-1291,-3,339,2906,0,0,-2,0,8
EUW1_6881402751',5,27,14,0,1,1,0,8,1,346,90,29125,29529,33597,8,26,19,2,0,1,0,3,380,81,31633,32232,37494,0,-34,9,-2508,-5,-2703,-3897,-2,1,0,0,5
EUW1_6881347681',4,29,19,0,0,0,0,10,1,348,80,31260,29194,33308,5,103,17,2,0,1,0,8,338,91,30091,29172,29732,1,10,-11,1169,2,22,3576,-2,0,-1,0,2
EUW1_6881291892',2,26,5,0,1,0,0,9,0,383,106,24316,30639,21021,5,28,5,1,0,0,0,2,398,82,24525,29831,25060,0,-15,24,-209,0,808,-4039,-1,1,0,0,7
EUW1_6880886899',5,42,16,2,0,1,0,6,1,408,110,29902,32456,37808,1,21,6,0,0,1,0,6,369,74,25056,27665,23406,1,39,36,4846,10,4791,14402,2,0,0,0,0
EUW1_6880872194',0,25,2,0,0,0,0,13,0,359,87,22628,27363,24794,6,37,18,2,0,2,0,5,416,72,30910,32705,36822,0,-57,15,-8282,-16,-5342,-12028,-2,0,-2,0,8
EUW1_6880852230',2,86,11,2,0,1,0,5,1,352,106,27453,30006,29821,3,27,10,0,0,0,0,6,370,74,25865,29586,26555,1,-18,32,1588,1,420,3266,2,0,1,0,-1
EUW1_6880164420',3,26,12,1,1,0,0,7,1,371,79,26541,29591,27358,4,35,12,1,0,1,0,1,359,92,27837,28954,35937,0,12,-13,-1296,0,637,-8579,0,1,-1,0,6
EUW1_6883101118',3,27,18,2,0,0,0,5,1,321,112,30371,30645,37436,4,24,22,0,0,1,0,7,315,72,29779,29683,42738,1,6,40,592,-4,962,-5302,2,0,-1,0,-2
EUW1_6883045818',7,35,13,0,0,0,0,8,0,355,71,26492,29697,45091,9,149,16,1,0,1,0,1,385,84,29186,30291,36117,0,-30,-13,-2694,-3,-594,8974,-1,0,-1,0,7
EUW1_6882994137',5,93,9,0,0,0,0,11,1,286,60,24754,23679,36757,1,31,16,2,0,3,0,7,303,86,29886,28835,40710,0,-17,-26,-5132,-7,-5156,-3953,-2,0,-3,0,4
EUW1_6882966737',3,56,21,2,1,2,0,6,1,363,107,31210,34024,33816,6,86,6,0,0,0,0,5,314,82,22916,25546,28510,1,49,25,8294,15,8478,5306,2,1,2,0,1
EUW1_6882838987',6,34,9,0,0,1,0,6,0,372,93,26046,29749,27973,3,28,8,2,0,0,0,2,381,86,25130,30567,27678,1,-9,7,916,1,-818,295,-2,0,1,0,4
EUW1_6882803256',6,31,19,2,0,1,0,8,0,409,92,34464,32999,50069,3,46,10,0,1,2,0,9,313,87,25727,28825,30237,1,96,5,8737,9,4174,19832,2,-1,-1,0,-1
EUW1_6882750141',3,21,22,0,0,1,0,9,1,367,90,31877,32954,38328,1,24,7,2,0,1,0,4,355,80,24628,26826,24513,0,12,10,7249,15,6128,13815,-2,0,0,0,5
EUW1_6881466694',1,28,7,1,0,0,0,10,0,381,78,25866,29532,35149,4,35,17,1,0,1,0,2,348,94,29208,30522,36304,0,33,-16,-3342,-10,-990,-1155,0,0,-1,0,8
EUW1_6881379356',5,72,18,2,0,2,0,12,0,370,104,32078,31158,39905,6,35,10,0,0,0,0,8,357,86,25958,29235,27514,1,13,18,6120,8,1923,12391,2,0,2,0,4
EUW1_6881351837',9,55,15,0,0,0,0,14,1,320,71,27823,27842,41835,2,64,21,1,0,2,0,2,339,84,32210,30416,43615,0,-19,-13,-4387,-6,-2574,-1780,-1,0,-2,0,12
EUW1_6881237651',2,26,11,2,0,1,0,7,1,360,108,28039,30062,34767,4,96,14,0,0,0,0,4,302,88,25584,29631,34410,1,58,20,2455,-3,431,357,2,0,1,0,3
EUW1_6881170306',3,289,12,1,0,2,0,11,0,386,92,29047,30030,30320,3,26,11,1,0,1,0,9,342,84,28026,29076,35595,0,44,8,1021,1,954,-5275,0,0,1,0,2
EUW1_6881119373',5,30,11,1,0,0,0,10,0,348,89,27369,29049,31405,5,30,18,0,0,0,0,4,346,78,28279,29015,35068,1,2,11,-910,-7,34,-3663,1,0,0,0,6
EUW1_6880709550',5,31,18,1,0,1,0,9,1,301,71,28903,27543,33633,1,25,14,1,0,1,0,3,286,98,26997,27976,32936,0,15,-27,1906,4,-433,697,0,0,0,0,6
EUW1_6880679518',3,65,8,2,0,0,0,14,1,327,84,23756,27777,29935,3,60,12,0,0,3,0,1,364,79,28977,30202,35356,1,-37,5,-5221,-4,-2425,-5421,2,0,-3,0,13
EUW1_6880343597',4,29,16,1,0,1,0,7,0,365,72,29050,31740,33784,1,23,10,1,0,0,0,8,360,94,25197,28437,30345,1,5,-22,3853,6,3303,3439,0,0,1,0,-1
EUW1_6880134510',10,37,16,1,0,1,0,13,0,375,103,30576,31367,31217,6,34,12,1,0,1,0,6,362,86,29615,31258,26940,1,13,17,961,4,109,4277,0,0,0,0,7
EUW1_6879338762',4,25,11,0,0,1,0,12,1,344,92,29307,29923,30588,4,66,18,1,0,2,0,4,358,79,30210,29998,37263,1,-14,13,-903,-7,-75,-6675,-1,0,-1,0,8
EUW1_6877912614',1,45,9,0,0,0,0,13,0,313,90,25628,29121,28731,3,28,18,2,0,2,0,5,367,109,31503,32431,37688,0,-54,-19,-5875,-9,-3310,-8957,-2,0,-2,0,8
EUW1_6877898580',0,49,7,0,0,0,0,13,0,311,86,24101,27460,25675,3,35,18,1,0,1,0,1,349,89,30011,31592,36294,0,-38,-3,-5910,-11,-4132,-10619,-1,0,-1,0,12
EUW1_6877889536',2,33,16,1,0,2,0,10,1,327,78,28407,27868,30500,2,27,12,0,0,0,0,6,297,114,26566,27591,31298,0,30,-36,1841,4,277,-798,1,0,2,0,4
EUW1_6877722232',4,28,15,1,1,3,0,7,1,386,86,31657,29742,33479,8,49,13,0,0,0,0,11,344,78,27104,28368,28873,1,42,8,4553,2,1374,4606,1,1,3,0,-4
EUW1_6877683357',5,25,11,2,0,0,0,4,0,359,90,26388,31029,35958,3,30,10,0,0,0,0,6,329,90,25977,29987,35773,1,30,0,411,1,1042,185,2,0,0,0,-2
EUW1_6877581511',1,24,14,2,0,2,0,11,1,399,98,30075,32315,38248,0,16,9,0,0,1,0,8,310,110,25454,28574,33094,1,89,-12,4621,5,3741,5154,2,0,1,0,3
EUW1_6877468523',1,25,5,1,1,1,0,12,0,350,90,24390,28478,27387,5,25,19,1,0,1,0,2,366,97,30132,31450,31142,0,-16,-7,-5742,-14,-2972,-3755,0,1,0,0,10
EUW1_6876420978',2,16,15,0,0,2,0,11,1,360,114,30628,33200,28668,6,28,12,2,0,2,0,8,359,88,28010,29759,31797,0,1,26,2618,3,3441,-3129,-2,0,0,0,3
EUW1_6876384755',2,23,11,1,0,0,0,8,0,398,90,28515,31140,24628,5,29,10,0,0,2,0,4,371,104,27726,29814,28602,1,27,-14,789,1,1326,-3974,1,0,-2,0,4
EUW1_6876322210',6,28,15,2,0,1,0,9,1,350,110,29351,30422,38014,2,50,12,0,0,1,0,3,372,82,27915,29635,28421,1,-22,28,1436,3,787,9593,2,0,0,0,6
EUW1_6876240691',2,29,11,0,1,0,0,10,0,393,98,28254,32015,34109,6,36,13,2,0,0,0,4,399,110,28585,31286,27640,1,-6,-12,-331,-2,729,6469,-2,1,0,0,6
EUW1_6876125128',4,71,11,1,0,0,0,6,0,409,97,26850,32078,27392,3,68,6,0,0,0,0,1,406,82,26037,30740,23925,1,3,15,813,5,1338,3467,1,0,0,0,5
EUW1_6875914950',0,24,17,2,0,2,0,6,1,361,97,30694,32851,32774,6,30,6,0,0,0,0,7,364,77,24524,26365,23496,1,-3,20,6170,11,6486,9278,2,0,2,0,-1
EUW1_6873707636',2,28,13,0,0,0,0,16,0,302,76,26655,26367,33525,4,24,27,2,0,2,0,2,318,88,33772,31161,49331,1,-16,-12,-7117,-14,-4794,-15806,-2,0,-2,0,14
EUW1_6873660870',1,34,7,0,0,1,0,11,1,350,76,25171,27297,25847,3,34,16,2,0,2,0,7,328,116,29281,32945,33043,0,22,-40,-4110,-9,-5648,-7196,-2,0,-1,0,4
EUW1_6873641058',1,22,20,2,1,3,0,4,1,366,99,34476,32698,36755,0,21,6,0,0,1,0,13,297,76,22877,24988,22808,1,69,23,11599,14,7710,13947,2,1,2,0,-9
EUW1_6873530915',5,26,12,0,0,0,0,12,1,338,97,27077,31688,27563,4,28,11,1,0,1,0,3,386,95,28270,31120,32834,1,-48,2,-1193,1,568,-5271,-1,0,-1,0,9
EUW1_6873485490',1,17,14,1,0,0,0,7,0,431,98,29855,32519,36105,3,23,8,1,0,2,0,5,389,82,26924,28670,31418,1,42,16,2931,6,3849,4687,0,0,-2,0,2
EUW1_6873257400',1,19,19,1,0,1,0,10,0,332,74,30651,30103,32498,5,32,14,1,0,0,0,4,339,83,28847,28687,32096,1,-7,-9,1804,5,1416,402,0,0,1,0,6
EUW1_6873165937',4,25,7,0,0,0,0,15,0,372,68,24173,27337,21653,4,25,17,1,0,3,0,0,425,93,32369,31261,36289,0,-53,-25,-8196,-10,-3924,-14636,-1,0,-3,0,15
EUW1_6873102945',2,23,14,1,1,1,0,8,1,362,92,28949,31165,38765,4,33,9,1,0,0,0,4,386,82,25927,29363,29704,1,-24,10,3022,5,1802,9061,0,1,1,0,4
EUW1_6866072578',5,24,16,0,0,0,0,9,1,378,92,29931,30927,32831,2,24,16,2,0,1,0,2,296,75,26827,27110,37599,1,82,17,3104,0,3817,-4768,-2,0,-1,0,7
EUW1_6877509217',2,21,15,2,0,1,0,5,1,383,102,29024,31563,38216,3,50,9,0,0,0,0,4,352,71,24390,27390,33157,1,31,31,4634,6,4173,5059,2,0,1,0,1
EUW1_6877367089',5,182,10,1,0,0,0,9,1,353,96,26999,29228,29955,3,49,12,1,0,2,0,5,346,71,26641,30155,31304,0,7,25,358,-2,-927,-1349,0,0,-2,0,4
EUW1_6877293192',4,22,9,1,0,2,0,9,1,326,72,26249,26961,31191,1,42,8,0,1,0,0,9,333,52,24318,26768,24226,0,-7,20,1931,1,193,6965,1,-1,2,0,0
EUW1_6874806384',5,33,16,2,0,0,0,16,0,330,98,28402,28897,29598,5,34,16,0,0,1,0,3,399,94,32328,32516,42707,0,-69,4,-3926,0,-3619,-13109,2,0,-1,0,13
EUW1_6874750671',5,53,9,0,0,0,0,6,0,368,84,25683,28503,27325,6,30,12,1,0,0,0,4,383,89,27058,30630,30279,0,-15,-5,-1375,-3,-2127,-2954,-1,0,0,0,2
EUW1_6872725165',5,32,14,0,0,0,0,8,1,352,88,27809,28649,27216,2,48,10,2,0,1,0,4,357,83,27312,28802,37350,1,-5,5,497,4,-153,-10134,-2,0,-1,0,4
EUW1_6872678080',2,48,20,0,0,1,0,7,0,341,85,30031,30855,36729,6,101,16,2,0,0,0,4,319,74,28119,29598,35529,1,22,11,1912,4,1257,1200,-2,0,1,0,3
EUW1_6871141280',1,39,14,0,0,0,0,9,0,319,58,26483,26399,30642,4,37,19,2,0,1,0,3,323,58,29124,27882,34683,0,-4,0,-2641,-5,-1483,-4041,-2,0,-1,0,6
EUW1_6871081880',1,43,19,1,0,1,0,9,0,317,72,29340,27228,38869,5,50,20,0,0,2,0,3,333,80,31132,28640,39408,0,-16,-8,-1792,-1,-1412,-539,1,0,-1,0,6
EUW1_6864603973',3,35,21,1,0,0,0,11,1,339,92,30083,32412,44004,5,26,7,0,0,2,0,3,344,108,25902,26738,28316,1,-5,-16,4181,14,5674,15688,1,0,-2,0,8
EUW1_6861995793',6,75,17,1,0,1,0,8,1,314,80,29152,29465,36236,4,55,12,0,0,0,0,5,317,92,27234,28586,31887,1,-3,-12,1918,5,879,4349,1,0,1,0,3
EUW1_6860817092',6,31,16,2,1,0,0,9,1,422,109,29997,32550,29824,0,260,8,0,0,0,0,6,370,81,24955,30605,28573,1,52,28,5042,8,1945,1251,2,1,0,0,3
EUW1_6859551867',3,30,15,1,0,3,0,8,1,356,91,31441,31003,33587,5,60,11,1,0,0,0,13,373,74,27418,29031,29924,1,-17,17,4023,4,1972,3663,0,0,3,0,-5
EUW1_6859511306',6,28,11,0,1,1,0,7,1,384,87,28649,30532,28397,5,45,8,1,0,1,0,6,353,91,25286,29523,23545,0,31,-4,3363,3,1009,4852,-1,1,0,0,1
EUW1_6859496855',1,21,10,0,0,0,0,15,0,296,100,25296,27648,24501,5,28,19,2,0,3,0,2,364,92,32609,30870,33236,0,-68,8,-7313,-9,-3222,-8735,-2,0,-3,0,13
EUW1_6882736714',5,38,11,1,0,0,0,11,1,358,86,25787,29438,28500,6,26,11,0,0,0,0,1,375,118,28362,31777,29345,1,-17,-32,-2575,0,-2339,-845,1,0,0,0,10
EUW1_6880002188',1,36,15,1,0,3,0,5,1,359,106,30506,30357,40548,6,31,7,1,0,0,0,5,312,86,23822,27680,28631,1,47,20,6684,8,2677,11917,0,0,3,0,0
EUW1_6883641620',2,23,13,1,0,0,0,12,1,365,73,26573,29798,31688,1,29,8,0,0,2,0,1,340,98,26293,29152,31759,1,25,-25,280,5,646,-71,1,0,-2,0,11
EUW1_6883626489',6,51,18,0,0,2,0,8,0,369,76,29934,30204,41094,1,39,8,1,0,1,0,5,331,84,24460,26653,28121,1,38,-8,5474,10,3551,12973,-1,0,1,0,3
EUW1_6883593306',5,32,17,2,0,1,0,9,1,337,88,30709,28994,32858,3,45,13,0,0,2,0,5,355,79,28266,27822,31486,0,-18,9,2443,4,1172,1372,2,0,-1,0,4
EUW1_6882353724',2,22,27,2,0,2,0,6,0,387,88,34987,33112,48213,4,28,11,0,0,1,0,12,311,64,25043,26434,37268,1,76,24,9944,16,6678,10945,2,0,1,0,-6
EUW1_6882340741',1,136,20,0,0,1,0,9,0,349,53,31173,29961,40271,3,27,15,2,0,2,0,7,328,109,30214,29896,30683,1,21,-56,959,5,65,9588,-2,0,-1,0,2
EUW1_6882323320',2,25,22,1,0,1,0,7,1,332,90,32554,29690,38467,1,345,15,0,0,1,0,9,291,72,28197,26696,39416,1,41,18,4357,7,2994,-949,1,0,0,0,-2
EUW1_6882251605',5,33,27,0,0,0,0,7,1,348,114,36422,33995,48149,1,164,12,1,0,1,0,5,353,77,26802,27626,38402,1,-5,37,9620,15,6369,9747,-1,0,-1,0,2
EUW1_6882231664',5,32,24,0,0,1,0,14,1,326,80,32446,30263,43457,5,28,17,1,0,0,0,3,285,66,27264,25955,35417,1,41,14,5182,7,4308,8040,-1,0,1,0,11
EUW1_6882204109',5,26,10,1,0,0,0,11,0,318,72,25775,24887,31553,3,30,26,0,0,2,0,4,345,102,33832,32351,44221,0,-27,-30,-8057,-16,-7464,-12668,1,0,-2,0,7
EUW1_6882164645',4,24,11,1,0,0,0,3,1,375,114,27240,31134,33351,4,40,7,0,0,0,0,2,360,102,23989,28058,31264,1,15,12,3251,4,3076,2087,1,0,0,0,1
EUW1_6880778317',7,29,16,0,0,1,0,5,1,347,92,30236,31388,43382,6,24,9,1,0,1,0,7,356,67,23648,26893,27181,1,-9,25,6588,7,4495,16201,-1,0,0,0,-2
EUW1_6880764891',0,26,2,0,0,0,0,12,0,365,86,22908,28869,23999,4,47,16,2,0,1,0,0,413,94,29735,32230,29555,0,-48,-8,-6827,-14,-3361,-5556,-2,0,-1,0,12
EUW1_6880747644',3,21,12,1,0,0,0,9,1,376,77,26527,28657,27897,2,26,6,1,0,1,0,4,373,97,25998,30036,29606,0,3,-20,529,6,-1379,-1709,0,0,-1,0,5
EUW1_6880720594',1,25,5,1,0,0,0,7,0,393,78,25529,29341,28243,10,37,11,1,0,1,0,5,388,86,26658,29909,24873,0,5,-8,-1129,-6,-568,3370,0,0,-1,0,2
EUW1_6880638159',2,36,15,0,0,0,0,7,0,366,114,30975,32933,36398,4,20,17,2,0,3,0,6,345,102,28849,30221,39925,0,21,12,2126,-2,2712,-3527,-2,0,-3,0,1
EUW1_6880607594',2,23,17,2,0,1,0,7,0,396,84,28648,31722,36221,1,29,6,0,0,0,0,3,332,110,24639,29801,26925,1,64,-26,4009,11,1921,9296,2,0,1,0,4
EUW1_6883618693',4,26,17,2,0,2,0,5,0,368,100,30597,30072,37854,6,25,14,0,0,0,0,8,344,64,26772,29606,34459,1,24,36,3825,3,466,3395,2,0,2,0,-3
EUW1_6883588153',5,49,10,0,1,0,0,9,1,335,81,25787,28520,23210,4,25,16,1,0,1,0,2,363,87,29646,30209,28375,0,-28,-6,-3859,-6,-1689,-5165,-1,1,-1,0,7
EUW1_6883519631',2,22,12,2,0,1,0,9,1,357,94,28365,29247,29306,5,25,9,0,1,1,0,5,331,102,25719,27624,28419,1,26,-8,2646,3,1623,887,2,-1,0,0,4
EUW1_6877460490',5,31,17,0,1,2,0,1,1,426,118,32475,32985,27513,3,25,6,1,0,0,0,6,347,89,23494,29212,19783,1,79,29,8981,11,3773,7730,-1,1,2,0,-5
EUW1_6874837184',4,31,12,1,0,2,0,10,1,364,120,29390,29785,26579,2,103,7,1,0,2,0,6,344,92,26151,28394,20059,1,20,28,3239,5,1391,6520,0,0,0,0,4
EUW1_6874809100',1,22,6,1,0,0,0,16,0,332,86,23621,27646,21781,3,28,15,1,1,3,0,5,376,110,31393,30490,29963,0,-44,-24,-7772,-9,-2844,-8182,0,-1,-3,0,11
EUW1_6874734396',3,43,8,0,0,1,0,7,0,368,102,25969,30116,28116,3,70,9,2,0,1,0,0,378,106,25965,31796,22752,0,-10,-4,4,-1,-1680,5364,-2,0,0,0,7
EUW1_6857354915',1,28,19,2,0,2,0,8,1,361,92,33543,29583,41396,5,29,16,0,1,2,0,10,287,70,28643,27444,33241,0,74,22,4900,3,2139,8155,2,-1,0,0,-2
EUW1_6856712511',0,22,15,1,0,0,0,13,1,350,94,30076,30389,32093,6,27,14,1,0,1,0,3,368,92,29282,29973,37623,1,-18,2,794,1,416,-5530,0,0,-1,0,10
EUW1_6856704472',8,37,17,1,1,0,0,5,0,343,101,29575,33520,46008,1,24,10,0,0,0,0,2,316,82,25232,28103,31199,1,27,19,4343,7,5417,14809,1,1,0,0,3
EUW1_6856689798',1,25,18,0,0,0,0,13,0,332,90,30617,28029,45096,4,21,18,1,0,2,0,4,362,98,31600,30634,39526,0,-30,-8,-983,0,-2605,5570,-1,0,-2,0,9
EUW1_6856677930',3,33,18,1,0,3,0,14,1,309,80,33014,28828,41348,3,169,14,0,0,0,0,4,315,84,27159,27427,32633,0,-6,-4,5855,4,1401,8715,1,0,3,0,10
EUW1_6856673566',4,24,19,2,0,2,0,3,1,357,129,32458,32063,36830,5,33,6,0,0,0,0,9,365,79,24673,28396,30890,1,-8,50,7785,13,3667,5940,2,0,2,0,-6
EUW1_6856663499',1,49,14,1,1,1,0,11,0,279,84,29068,26938,32938,5,34,26,1,0,1,0,3,309,72,32841,28105,43445,1,-30,12,-3773,-12,-1167,-10507,0,1,0,0,8
EUW1_6856640351',5,36,21,2,0,0,0,8,1,392,87,32658,32960,40208,4,105,10,0,0,1,0,6,358,100,26232,29399,28537,1,34,-13,6426,11,3561,11671,2,0,-1,0,2
EUW1_6856634702',2,27,13,1,0,0,0,14,1,321,81,28314,29187,34240,3,32,16,0,0,2,0,2,347,94,29871,30753,35857,1,-26,-13,-1557,-3,-1566,-1617,1,0,-2,0,12
EUW1_6856616982',1,14,17,0,0,5,1,7,1,280,88,32268,25643,38796,0,23,18,0,0,3,0,8,288,12,28734,26506,40818,1,-8,76,3534,-1,-863,-2022,0,0,2,1,-1
EUW1_6880724180',3,26,6,0,0,0,0,10,0,351,101,25035,29273,25403,5,31,13,1,0,2,0,3,365,81,28129,30546,32618,0,-14,20,-3094,-7,-1273,-7215,-1,0,-2,0,7
EUW1_6880612152',7,33,5,1,0,0,0,10,0,308,101,22747,26011,28674,2,41,15,1,0,1,0,0,418,109,30134,31822,25371,0,-110,-8,-7387,-10,-5811,3303,0,0,-1,0,10
EUW1_6880516857',5,44,15,1,0,1,0,7,1,421,95,32614,31437,32477,9,30,11,1,0,2,0,9,371,80,26135,28217,30356,1,50,15,6479,4,3220,2121,0,0,-1,0,-2
EUW1_6880450055',8,34,17,1,0,1,0,7,0,374,64,29385,30043,32835,5,31,8,1,0,0,0,3,392,94,26260,29793,24553,1,-18,-30,3125,9,250,8282,0,0,1,0,4
EUW1_6876334823',7,34,9,1,0,0,0,2,0,372,100,26123,30070,23565,7,34,9,1,0,0,0,5,381,104,26066,29888,23144,0,-9,-4,57,0,182,421,0,0,0,0,-3
EUW1_6875915803',5,25,8,1,0,0,0,7,0,395,92,25683,29697,39877,5,30,13,0,0,0,0,1,381,91,27717,30639,32162,1,14,1,-2034,-5,-942,7715,1,0,0,0,6
EUW1_6875861104',7,29,22,1,0,3,0,7,1,361,94,33194,31440,38415,3,21,7,1,0,1,0,8,311,90,24461,25645,23660,1,50,4,8733,15,5795,14755,0,0,2,0,-1
EUW1_6875646431',7,31,15,0,0,1,0,10,1,420,96,29089,32407,29358,2,31,4,1,0,1,0,4,396,84,25026,30016,25395,0,24,12,4063,11,2391,3963,-1,0,0,0,6
EUW1_6875607999',6,36,11,2,0,1,0,14,1,332,88,25021,26945,38563,0,20,9,0,0,2,0,2,366,80,26576,27551,32774,0,-34,8,-1555,2,-606,5789,2,0,-1,0,12
EUW1_6875559388',5,30,12,0,0,1,0,13,0,359,76,28887,28103,28136,3,33,19,1,0,3,0,4,428,100,33870,32516,39287,0,-69,-24,-4983,-7,-4413,-11151,-1,0,-2,0,9
EUW1_6875526338',0,43,15,2,0,2,0,9,1,399,87,30194,32413,32248,6,24,4,0,0,2,0,7,325,120,24791,28068,19822,1,74,-33,5403,11,4345,12426,2,0,0,0,2
EUW1_6875409711',2,27,20,1,0,1,0,13,1,365,84,30301,30803,44576,3,43,12,0,0,1,0,2,325,76,27040,28367,28033,1,40,8,3261,8,2436,16543,1,0,0,0,11
EUW1_6875360731',6,32,22,0,0,3,0,8,1,357,57,32706,30147,45772,5,144,21,1,0,0,0,7,300,76,29582,28294,39700,0,57,-19,3124,1,1853,6072,-1,0,3,0,1
EUW1_6875044699',4,23,15,0,0,0,0,10,0,313,74,26763,26501,33031,5,33,19,1,0,2,0,1,327,70,32188,27017,37915,0,-14,4,-5425,-4,-516,-4884,-1,0,-2,0,9
EUW1_6875031700',5,212,16,0,1,1,0,15,0,374,90,30284,31722,30231,7,36,18,2,0,1,0,4,356,104,30364,30434,36351,0,18,-14,-80,-2,1288,-6120,-2,1,0,0,11
EUW1_6875014316',4,25,18,1,0,2,0,2,1,418,129,32495,32617,30587,1,22,4,0,0,0,0,8,392,41,22402,25894,17866,1,26,88,10093,14,6723,12721,1,0,2,0,-6
EUW1_6874995409',5,26,10,0,0,0,0,14,0,345,64,26239,27727,24233,3,23,18,2,0,2,0,2,394,91,31125,33195,34435,0,-49,-27,-4886,-8,-5468,-10202,-2,0,-2,0,12
EUW1_6874974423',6,31,13,2,0,1,0,10,1,350,100,27708,30363,26147,4,23,11,0,0,1,0,6,308,80,27299,28307,28480,0,42,20,409,2,2056,-2333,2,0,0,0,4
EUW1_6859985630',5,30,5,0,0,0,0,10,0,385,86,24697,28513,19061,8,30,16,1,0,2,0,1,391,86,30464,30447,28573,0,-6,0,-5767,-11,-1934,-9512,-1,0,-2,0,9
EUW1_6858637178',3,25,9,0,0,0,0,13,0,333,78,25234,27925,23819,2,23,19,1,0,3,0,1,399,112,33786,31523,34040,0,-66,-34,-8552,-10,-3598,-10221,-1,0,-3,0,12
EUW1_6858604191',2,25,3,0,0,0,0,15,0,292,71,22230,24642,26159,2,26,25,1,0,4,0,2,384,124,37457,35654,41607,0,-92,-53,-15227,-22,-11012,-15448,-1,0,-4,0,13
EUW1_6858554005',3,48,13,0,0,0,0,9,1,348,100,27453,29040,29244,3,25,9,1,0,0,0,2,356,87,25950,29577,34625,0,-8,13,1503,4,-537,-5381,-1,0,0,0,7
EUW1_6858509519',8,184,15,0,0,1,0,10,1,347,73,30582,29316,31945,2,32,14,2,0,0,0,4,371,82,28417,28356,33156,0,-24,-9,2165,1,960,-1211,-2,0,1,0,6
EUW1_6858469958',5,19,22,1,0,4,0,3,1,364,100,34507,33343,36479,2,29,8,1,0,0,0,8,305,84,23858,26417,28529,1,59,16,10649,14,6926,7950,0,0,4,0,-5
EUW1_6858389238',2,20,9,0,0,0,0,7,0,351,99,25291,29198,22525,3,31,11,0,0,2,0,1,392,96,28263,30339,29381,0,-41,3,-2972,-2,-1141,-6856,0,0,-2,0,6
EUW1_6858215598',2,26,16,0,0,1,0,9,1,337,118,29458,30269,31415,2,24,11,1,0,1,0,2,319,81,26589,27489,29874,0,18,37,2869,5,2780,1541,-1,0,0,0,7
EUW1_6857718408',3,30,24,1,0,0,0,9,0,362,96,33326,32250,40805,1,26,11,0,0,0,0,4,325,87,26966,29552,32788,1,37,9,6360,13,2698,8017,1,0,0,0,5
EUW1_6857645673',8,23,13,0,0,0,0,13,0,333,96,26929,30472,33498,2,24,18,2,0,2,0,2,369,72,29803,29166,33815,0,-36,24,-2874,-5,1306,-317,-2,0,-2,0,11
EUW1_6857567159',4,27,6,1,0,0,0,6,1,391,74,25043,28506,20482,4,31,6,1,0,1,0,2,364,122,25475,30874,18641,0,27,-48,-432,0,-2368,1841,0,0,-1,0,4
EUW1_6857502416',1,241,13,0,0,0,0,11,0,352,78,28761,30310,31374,1,25,17,1,0,1,0,4,356,65,29276,29786,37952,0,-4,13,-515,-4,524,-6578,-1,0,-1,0,7
EUW1_6857267964',2,34,18,1,0,0,0,13,0,319,80,29276,28770,41266,6,26,17,0,0,3,0,3,374,92,31245,31069,37977,0,-55,-12,-1969,1,-2299,3289,1,0,-3,0,10
EUW1_6857226944',8,139,16,2,0,0,0,13,1,318,88,29100,27871,33202,4,26,13,0,0,0,0,6,343,77,27338,27301,32090,1,-25,11,1762,3,570,1112,2,0,0,0,7
EUW1_6857190578',4,27,11,2,0,1,0,12,0,395,88,28110,31401,34144,2,24,12,0,0,1,0,5,356,103,28304,29672,28168,1,39,-15,-194,-1,1729,5976,2,0,0,0,7
EUW1_6857136648',1,28,11,0,0,1,0,6,0,395,104,28625,32071,33566,2,21,11,2,0,0,0,6,362,88,26035,29632,32098,0,33,16,2590,0,2439,1468,-2,0,1,0,0
EUW1_6857075116',3,38,17,1,1,0,0,5,1,385,94,31041,31466,33350,5,35,16,0,0,1,0,4,354,86,28295,30139,32961,1,31,8,2746,1,1327,389,1,1,-1,0,1
EUW1_6857039561',7,72,16,1,1,1,0,8,1,430,87,30236,33340,32994,5,100,2,0,0,1,0,2,358,107,23248,28876,18021,1,72,-20,6988,14,4464,14973,1,1,0,0,6
EUW1_6856383851',2,39,11,0,0,0,0,11,1,360,96,28166,29538,25896,2,28,25,1,1,4,0,3,397,104,34920,31971,40677,0,-37,-8,-6754,-14,-2433,-14781,-1,-1,-4,0,8
EUW1_6856319273',3,83,10,0,0,0,0,11,1,307,104,24609,27427,26127,4,32,14,1,0,1,0,0,404,84,32374,30913,35781,0,-97,20,-7765,-4,-3486,-9654,-1,0,-1,0,11
EUW1_6883219870',7,72,9,1,0,1,0,10,0,398,84,27271,29455,31210,6,32,12,1,0,0,0,4,348,88,27755,29438,30686,1,50,-4,-484,-3,17,524,0,0,1,0,6
EUW1_6883144690',3,29,20,1,0,0,0,7,1,320,109,29319,31241,38617,4,33,10,0,0,0,0,3,372,78,27435,29423,33299,1,-52,31,1884,10,1818,5318,1,0,0,0,4
EUW1_6883093735',5,39,7,1,0,0,0,7,0,375,96,24780,29599,28155,3,26,9,1,0,0,0,3,397,76,25978,29437,34505,0,-22,20,-1198,-2,162,-6350,0,0,0,0,4
EUW1_6873500935',5,38,12,1,0,1,0,8,0,392,102,28830,30909,33776,8,30,12,1,1,1,0,4,390,79,29187,30875,27465,0,2,23,-357,0,34,6311,0,-1,0,0,4
EUW1_6873461686',6,28,20,1,0,1,0,7,1,346,92,30579,31262,32384,4,29,10,0,0,1,0,7,343,88,25016,27959,33294,1,3,4,5563,10,3303,-910,1,0,0,0,0
EUW1_6873392342',5,25,13,2,0,1,0,4,1,398,104,28303,31172,28738,3,28,7,0,0,0,0,3,380,104,25753,29875,27853,1,18,0,2550,6,1297,885,2,0,1,0,1
EUW1_6873343039',4,284,18,2,1,3,0,6,1,388,110,32313,32032,45142,5,27,9,0,0,1,0,12,304,70,24552,26718,29416,1,84,40,7761,9,5314,15726,2,1,2,0,-6
EUW1_6873289325',2,29,18,1,0,1,0,9,1,349,108,32840,31070,36840,5,136,7,1,0,1,0,7,296,81,23986,26806,37366,1,53,27,8854,11,4264,-526,0,0,0,0,2
EUW1_6873173543',2,20,17,2,1,1,0,9,1,377,80,31018,31167,31876,1,152,14,0,0,2,0,9,382,81,29469,28871,32233,1,-5,-1,1549,3,2296,-357,2,1,-1,0,0
EUW1_6873104401',5,39,18,0,0,0,0,7,1,367,112,31389,32471,42457,4,28,16,2,0,1,0,3,352,92,29557,31658,35140,0,15,20,1832,2,813,7317,-2,0,-1,0,4
EUW1_6871924757',4,35,11,1,1,0,0,8,0,392,79,27112,29124,31473,4,28,11,1,0,1,0,4,336,79,26590,26939,23659,1,56,0,522,0,2185,7814,0,1,-1,0,4
EUW1_6871856349',3,214,18,1,0,1,0,3,0,396,71,30617,32336,38041,0,24,8,1,0,0,0,10,332,94,24791,27080,33573,1,64,-23,5826,10,5256,4468,0,0,1,0,-7
EUW1_6870360495',4,24,11,2,0,0,0,6,1,390,98,26701,31016,23457,5,35,8,0,0,0,0,2,375,114,26045,30369,28522,1,15,-16,656,3,647,-5065,2,0,0,0,4
EUW1_6881355480',5,31,17,0,0,1,0,5,1,367,96,31035,30563,38370,1,20,12,2,0,2,0,0,359,74,27580,27437,33856,1,8,22,3455,5,3126,4514,-2,0,-1,0,5
EUW1_6880324844',4,28,8,1,0,0,0,8,1,350,91,25181,29578,24532,4,27,9,1,0,1,0,5,378,92,27643,29539,26081,1,-28,-1,-2462,-1,39,-1549,0,0,-1,0,3
EUW1_6880105458',4,28,14,1,0,0,0,6,1,359,81,28275,29583,28478,9,199,14,0,1,0,0,3,321,74,26401,27176,33465,1,38,7,1874,0,2407,-4987,1,-1,0,0,3
EUW1_6878441858',3,30,7,1,0,0,0,6,1,327,96,24723,27508,35889,2,23,15,0,0,0,0,5,352,99,27623,30299,33331,0,-25,-3,-2900,-8,-2791,2558,1,0,0,0,1
EUW1_6878380375',4,68,16,0,0,2,0,11,0,386,76,30250,33091,40825,3,21,10,2,0,0,0,5,342,89,26389,28600,32300,1,44,-13,3861,6,4491,8525,-2,0,2,0,6
EUW1_6878270632',1,27,9,0,0,1,0,10,0,298,88,25012,25851,27315,2,23,13,2,0,0,0,1,364,95,26298,29344,27196,0,-66,-7,-1286,-4,-3493,119,-2,0,1,0,9
EUW1_6877611606',5,21,19,2,0,4,0,6,1,389,94,32785,32672,41231,1,24,2,0,0,0,0,10,308,60,20432,24711,23276,1,81,34,12353,17,7961,17955,2,0,4,0,-4
EUW1_6877534772',4,27,9,0,0,0,0,10,0,330,78,24637,27476,27473,3,29,18,2,0,1,0,3,362,98,30215,31449,39377,0,-32,-20,-5578,-9,-3973,-11904,-2,0,-1,0,7
EUW1_6874744809',5,24,17,1,0,0,0,6,1,367,85,28430,31080,29090,1,23,8,1,0,0,0,6,376,90,25695,29933,29361,1,-9,-5,2735,9,1147,-271,0,0,0,0,0
EUW1_6872148746',2,26,11,2,0,1,0,11,1,409,109,30335,30713,31843,2,30,11,0,0,1,0,5,352,74,26882,29198,32538,1,57,35,3453,0,1515,-695,2,0,0,0,6
EUW1_6871884345',2,27,8,2,0,0,0,7,1,378,109,26591,31210,29310,1,38,5,0,0,1,0,1,340,79,23187,28620,22349,1,38,30,3404,3,2590,6961,2,0,-1,0,6
EUW1_6869833650',4,24,11,1,0,0,0,9,1,317,96,27217,28857,35858,4,27,18,1,0,1,0,4,382,84,30103,31909,41400,0,-65,12,-2886,-7,-3052,-5542,0,0,-1,0,5
EUW1_6869776476',5,27,12,0,1,1,0,8,1,382,104,28876,33246,33134,5,28,9,2,0,0,0,5,404,100,26182,31259,27411,1,-22,4,2694,3,1987,5723,-2,1,1,0,3
EUW1_6868966603',3,22,18,1,1,1,0,5,1,339,89,29562,30650,39510,2,21,10,0,0,0,0,6,347,70,25304,28513,33454,1,-8,19,4258,8,2137,6056,1,1,1,0,-1
EUW1_6868857094',6,34,9,0,0,0,0,15,0,376,79,26002,29239,25517,2,22,13,2,0,2,0,3,377,108,29887,30575,27734,0,-1,-29,-3885,-4,-1336,-2217,-2,0,-2,0,12
EUW1_6868686625',6,31,15,1,0,1,0,13,0,348,95,29659,30079,25496,5,27,17,1,1,2,0,1,332,91,30449,30021,35385,1,16,4,-790,-2,58,-9889,0,-1,-1,0,12
EUW1_6864484076',0,24,7,0,0,1,0,14,0,418,92,26576,29842,24080,5,32,13,2,0,2,0,3,382,93,30399,30787,30330,0,36,-1,-3823,-6,-945,-6250,-2,0,-1,0,11
EUW1_6864454444',3,38,15,0,0,0,0,6,0,386,84,28128,31219,33262,2,32,11,2,0,0,0,5,349,76,25637,27018,26490,1,37,8,2491,4,4201,6772,-2,0,0,0,1
EUW1_6864428019',5,31,18,1,1,2,0,7,0,392,116,32931,35185,36644,3,30,7,0,0,1,0,8,331,66,23043,27037,27638,1,61,50,9888,11,8148,9006,1,1,1,0,-1
EUW1_6863914953',4,44,17,2,0,1,0,8,0,380,102,30328,31353,29850,6,30,11,0,0,1,0,3,382,89,27926,29533,27993,0,-2,13,2402,6,1820,1857,2,0,0,0,5
EUW1_6863066190',4,29,13,2,0,0,0,10,1,362,80,27439,27976,34606,4,30,17,0,1,0,0,1,352,116,29837,31905,31738,0,10,-36,-2398,-4,-3929,2868,2,-1,0,0,9
EUW1_6863008251',10,98,13,0,0,0,0,8,0,357,96,27901,30194,35110,3,27,8,1,0,0,0,2,348,75,26195,28882,21822,1,9,21,1706,5,1312,13288,-1,0,0,0,6
EUW1_6862676638',2,27,18,0,1,1,0,11,1,330,90,31450,32706,33429,4,29,13,2,0,1,0,6,326,106,27699,30065,33691,1,4,-16,3751,5,2641,-262,-2,1,0,0,5
EUW1_6862297253',4,26,10,0,0,0,0,15,0,350,84,27609,28460,37998,5,31,21,2,0,2,0,3,355,80,32893,31965,37304,0,-5,4,-5284,-11,-3505,694,-2,0,-2,0,12
EUW1_6862241017',6,34,9,0,1,0,0,7,0,391,87,26211,29603,25221,1,26,8,1,0,1,0,3,405,93,27823,29551,23624,0,-14,-6,-1612,1,52,1597,-1,1,-1,0,4
EUW1_6862205317',5,35,18,1,0,2,0,6,1,400,66,32700,31765,34647,3,29,12,1,0,0,0,11,343,78,26827,26948,34762,1,57,-12,5873,6,4817,-115,0,0,2,0,-5
EUW1_6861950435',1,22,5,0,0,1,0,9,1,366,69,23818,26537,26970,3,25,16,2,0,2,0,5,401,88,30368,32273,39072,0,-35,-19,-6550,-11,-5736,-12102,-2,0,-1,0,4
EUW1_6861929986',8,53,10,0,1,0,0,9,1,339,58,25195,28519,24909,4,29,9,1,0,2,0,4,399,99,28273,29902,33251,0,-60,-41,-3078,1,-1383,-8342,-1,1,-2,0,5
EUW1_6861898722',1,23,5,0,0,1,0,5,0,396,94,25215,29806,29858,2,96,13,1,0,0,0,2,375,85,26955,30215,30600,0,21,9,-1740,-8,-409,-742,-1,0,1,0,3
EUW1_6861854898',8,31,9,1,0,0,0,10,0,347,77,25372,28763,31310,3,33,12,1,0,0,0,1,362,93,27529,28952,31447,0,-15,-16,-2157,-3,-189,-137,0,0,0,0,9
EUW1_6861597438',1,26,6,0,0,0,0,8,1,320,79,23132,26572,25456,5,32,8,1,0,1,0,1,386,106,28243,30573,33182,0,-66,-27,-5111,-2,-4001,-7726,-1,0,-1,0,7
EUW1_6860731013',4,57,13,0,0,1,0,7,1,365,67,28049,28739,33783,1,21,12,2,0,1,0,3,367,98,28506,30421,32623,0,-2,-31,-457,1,-1682,1160,-2,0,0,0,4
EUW1_6860708312',7,29,21,2,0,1,0,12,0,301,61,32654,29383,38886,2,49,21,0,0,1,0,10,291,50,29012,26891,43919,1,10,11,3642,0,2492,-5033,2,0,0,0,2
EUW1_6860694553',4,30,10,0,0,0,0,13,0,345,74,27269,30279,31405,4,30,17,2,0,2,0,1,366,114,31931,33326,40876,0,-21,-40,-4662,-7,-3047,-9471,-2,0,-2,0,12
EUW1_6860667040',0,31,5,0,0,0,0,13,0,351,94,23650,27158,26905,3,39,19,2,0,4,0,2,392,98,33842,32336,40084,0,-41,-4,-10192,-14,-5178,-13179,-2,0,-4,0,11
EUW1_6883583517',2,61,16,1,0,0,0,14,0,267,85,27745,27351,32495,0,29,19,0,0,3,0,5,384,80,33426,31472,47396,0,-117,5,-5681,-3,-4121,-14901,1,0,-3,0,9
EUW1_6883152460',5,68,19,1,0,3,0,7,0,411,108,34427,33720,46095,3,25,7,0,0,1,0,10,336,75,25117,27044,31280,1,75,33,9310,12,6676,14815,1,0,2,0,-3
EUW1_6882358150',3,62,15,1,0,1,0,5,1,370,105,29164,32109,35614,4,79,10,0,0,1,0,4,351,76,26094,27687,39707,1,19,29,3070,5,4422,-4093,1,0,0,0,1
EUW1_6882149515',2,30,10,1,0,0,0,12,0,342,98,25778,27570,28088,5,66,15,1,0,2,0,2,359,90,30208,30615,33528,0,-17,8,-4430,-5,-3045,-5440,0,0,-2,0,10
EUW1_6882102863',4,31,16,1,0,0,0,8,1,364,78,29277,30871,37371,3,64,16,1,0,0,0,4,344,94,28741,30547,30329,1,20,-16,536,0,324,7042,0,0,0,0,4
EUW1_6882051775',8,74,13,1,1,1,0,10,1,356,64,28772,29564,36894,4,21,16,0,0,0,0,1,285,99,26961,27905,31239,1,71,-35,1811,-3,1659,5655,1,1,1,0,9
EUW1_6881919310',2,27,9,2,0,0,0,7,0,347,86,24487,27325,25421,3,73,9,0,0,0,0,1,368,108,26158,27476,24344,1,-21,-22,-1671,0,-151,1077,2,0,0,0,6
EUW1_6881863564',4,60,14,1,0,0,0,8,0,358,93,26709,31572,25190,4,32,10,1,0,1,0,2,380,106,28472,31272,31999,0,-22,-13,-1763,4,300,-6809,0,0,-1,0,6
EUW1_6880842483',1,46,10,0,0,1,0,13,0,362,89,27724,28230,35468,4,26,23,2,1,1,0,5,336,94,32347,31815,36693,0,26,-5,-4623,-13,-3585,-1225,-2,-1,0,0,8
EUW1_6880370224',0,60,26,0,0,1,0,9,1,307,77,31910,28057,46889,6,32,15,1,0,1,0,3,329,65,28452,26999,33007,1,-22,12,3458,11,1058,13882,-1,0,0,0,6
EUW1_6878914127',3,27,13,2,0,1,0,7,0,379,88,28337,30708,35976,2,52,14,0,1,0,0,4,359,95,27550,28934,34630,1,20,-7,787,-1,1774,1346,2,-1,1,0,3
EUW1_6878868238',5,63,20,1,1,2,0,10,1,385,101,32734,32345,40491,4,37,9,0,0,1,0,7,350,73,25259,28101,26967,1,35,28,7475,11,4244,13524,1,1,1,0,3
EUW1_6878827790',2,61,15,1,1,1,0,5,0,401,90,30785,32832,29244,4,28,7,1,0,2,0,4,335,90,24276,28138,24828,1,66,0,6509,8,4694,4416,0,1,-1,0,1
EUW1_6878752265',4,25,11,0,0,0,0,11,0,355,71,25617,28480,31111,3,58,14,1,0,2,0,1,387,111,29722,31903,28833,0,-32,-40,-4105,-3,-3423,2278,-1,0,-2,0,10
EUW1_6878694402',6,30,18,1,0,1,0,3,0,342,92,30379,28648,35436,0,63,9,1,0,1,0,11,339,79,23904,26406,26343,1,3,13,6475,9,2242,9093,0,0,0,0,-8
EUW1_6877670624',0,48,25,1,0,2,0,10,1,393,80,35635,33116,48299,6,209,10,0,0,1,0,5,288,79,25285,25006,29854,1,105,1,10350,15,8110,18445,1,0,1,0,5
EUW1_6877282466',3,47,8,0,0,0,0,8,0,363,70,25291,27819,27965,2,57,13,2,0,2,0,1,353,106,28020,29466,28935,1,10,-36,-2729,-5,-1647,-970,-2,0,-2,0,7
EUW1_6877193442',6,24,10,2,0,0,0,11,0,347,78,25472,29897,28695,6,63,13,0,0,0,0,5,369,97,27677,30385,34966,0,-22,-19,-2205,-3,-488,-6271,2,0,0,0,6
EUW1_6872604213',7,34,13,1,0,0,0,9,0,361,80,27289,30017,29158,4,27,10,1,0,1,0,2,357,89,25826,28131,29922,0,4,-9,1463,3,1886,-764,0,0,-1,0,7
EUW1_6872095171',7,37,18,2,1,1,0,6,1,368,95,31412,31779,37719,1,25,11,0,0,0,0,7,353,75,27142,29432,32876,1,15,20,4270,7,2347,4843,2,1,1,0,-1
EUW1_6872037527',5,28,13,0,0,1,0,7,1,378,91,28737,30823,36628,5,60,12,2,0,1,0,5,351,108,27498,29859,34683,1,27,-17,1239,1,964,1945,-2,0,0,0,2
EUW1_6871813710',1,31,6,0,1,0,0,7,0,361,88,25049,28140,25796,5,31,10,2,0,0,0,3,373,126,26343,30573,27227,0,-12,-38,-1294,-4,-2433,-1431,-2,1,0,0,4
EUW1_6871748252',2,47,15,1,0,1,0,11,0,383,102,29206,30994,33049,3,24,12,1,0,1,0,3,396,94,28897,32166,33170,0,-13,8,309,3,-1172,-121,0,0,0,0,8
EUW1_6871689691',6,102,14,1,0,1,0,6,0,378,106,29313,31720,40838,2,49,15,1,0,0,0,7,347,78,28527,30403,34318,1,31,28,786,-1,1317,6520,0,0,1,0,-1
EUW1_6871638903',3,24,11,0,0,0,0,13,0,293,96,26725,27169,37275,3,22,26,1,0,2,0,1,392,80,34281,33307,54083,0,-99,16,-7556,-15,-6138,-16808,-1,0,-2,0,12
EUW1_6871585201',4,26,26,1,1,1,0,7,1,423,83,35099,34759,40887,0,19,9,1,0,1,0,8,352,112,26617,28864,29191,1,71,-29,8482,17,5895,11696,0,1,0,0,-1
EUW1_6871534886',4,31,11,0,1,0,0,15,0,338,76,27059,28209,25387,4,36,10,1,0,2,0,3,373,92,28198,29178,25421,0,-35,-16,-1139,1,-969,-34,-1,1,-2,0,12
EUW1_6870661008',3,27,16,0,1,2,0,6,1,384,88,31747,32124,40051,3,25,14,1,0,1,0,6,369,85,28011,30067,30068,1,15,3,3736,2,2057,9983,-1,1,1,0,0
EUW1_6870602865',2,27,16,0,0,1,0,6,0,344,92,29360,29454,26871,5,29,9,2,0,0,0,7,357,84,26434,27467,28514,0,-13,8,2926,7,1987,-1643,-2,0,1,0,-1
EUW1_6879733543',7,32,12,1,0,1,0,10,0,361,72,27001,28861,26926,2,24,9,1,0,1,0,1,357,104,25996,29109,27209,1,4,-32,1005,3,-248,-283,0,0,0,0,9
EUW1_6876932922',7,61,20,0,0,0,0,6,1,409,78,30905,32826,35751,2,29,9,1,0,1,0,5,371,76,26364,28625,31174,1,38,2,4541,11,4201,4577,-1,0,-1,0,1
EUW1_6876882554',4,23,19,0,0,1,0,11,0,313,80,29655,29508,31489,4,33,8,2,0,1,0,5,367,83,26471,28084,30516,1,-54,-3,3184,11,1424,973,-2,0,0,0,6
EUW1_6876830134',5,30,12,2,0,1,0,5,1,318,88,25994,28958,30697,5,30,11,0,0,0,0,2,346,99,26007,30364,35174,0,-28,-11,-13,1,-1406,-4477,2,0,1,0,3
EUW1_6876789832',2,23,6,0,0,0,0,3,0,355,102,24512,27223,26354,4,97,17,2,0,0,0,5,330,106,28554,30084,30393,0,25,-4,-4042,-11,-2861,-4039,-2,0,0,0,-2
EUW1_6876339931',6,34,17,1,1,2,0,10,1,347,102,29913,29987,29315,8,31,9,1,0,2,0,4,387,90,28269,28936,24666,1,-40,12,1644,8,1051,4649,0,1,0,0,6
EUW1_6876310390',5,29,10,0,0,1,0,10,0,356,73,27297,29082,27798,5,34,16,2,0,1,0,3,389,110,30294,33170,35850,0,-33,-37,-2997,-6,-4088,-8052,-2,0,0,0,7
EUW1_6875628347',5,24,6,2,0,1,0,10,0,370,85,25846,29127,26649,4,159,11,0,0,1,0,6,401,98,28185,31051,27271,1,-31,-13,-2339,-5,-1924,-622,2,0,0,0,4
EUW1_6875570328',5,30,9,1,0,0,0,8,1,370,111,25838,30059,28484,6,31,9,1,0,1,0,2,371,88,26162,29743,26491,1,-1,23,-324,0,316,1993,0,0,-1,0,6
EUW1_6875516762',3,38,5,0,0,0,0,8,0,385,61,24588,27714,25830,3,28,8,1,0,0,0,1,351,102,25473,30209,28660,0,34,-41,-885,-3,-2495,-2830,-1,0,0,0,7
EUW1_6882088714',5,33,14,1,0,0,0,8,1,391,92,30030,31492,33933,5,26,16,1,0,0,0,2,357,80,28451,30789,33445,1,34,12,1579,-2,703,488,0,0,0,0,6
EUW1_6881403013',8,57,26,1,0,1,0,12,1,363,70,33949,29295,48586,6,71,13,0,0,2,0,6,271,49,25771,25718,31726,1,92,21,8178,13,3577,16860,1,0,-1,0,6
EUW1_6881355201',2,28,9,0,0,1,0,9,1,407,95,28372,30961,29221,2,21,15,2,0,1,0,6,376,108,28376,32325,31414,0,31,-13,-4,-6,-1364,-2193,-2,0,0,0,3
EUW1_6881312868',5,33,5,1,0,0,0,11,0,344,64,22954,26091,25629,1,28,19,1,0,0,0,1,376,100,30696,32074,32505,0,-32,-36,-7742,-14,-5983,-6876,0,0,0,0,10
EUW1_6881235842',5,31,10,1,0,0,0,9,1,379,98,26036,31095,27625,3,152,6,0,0,0,0,1,357,98,24501,29718,24213,0,22,0,1535,4,1377,3412,1,0,0,0,8
EUW1_6881153357',3,35,14,0,0,1,0,13,1,351,76,27151,31314,38233,3,148,7,2,0,2,0,3,364,112,27271,30106,35626,1,-13,-36,-120,7,1208,2607,-2,0,-1,0,10
EUW1_6880359817',3,25,11,0,0,0,0,5,1,380,86,25888,28800,29460,5,28,12,1,0,0,0,0,385,88,27429,30825,33390,0,-5,-2,-1541,-1,-2025,-3930,-1,0,0,0,5
EUW1_6880297548',6,33,19,1,1,0,0,9,0,349,86,29646,32880,34473,5,27,10,0,0,2,0,4,347,94,27176,29216,32625,1,2,-8,2470,9,3664,1848,1,1,-2,0,5
EUW1_6879926139',3,40,17,1,0,8,2,5,0,361,95,34578,29019,30099,0,32,3,1,0,1,0,13,307,84,21907,24351,17593,1,54,11,12671,14,4668,12506,0,0,7,2,-8
EUW1_6883562297',3,26,7,0,0,0,0,16,0,263,65,22306,23506,28512,5,25,24,1,1,4,0,1,389,78,35964,31309,49846,0,-126,-13,-13658,-17,-7803,-21334,-1,-1,-4,0,15
EUW1_6883532820',3,27,17,1,0,0,0,10,0,347,84,27653,28243,40860,3,155,17,0,0,0,0,0,329,84,29279,28492,41233,0,18,0,-1626,0,-249,-373,1,0,0,0,10
EUW1_6883440166',1,32,16,0,0,1,0,10,1,373,75,29950,29355,32358,4,29,16,2,0,1,0,3,411,104,30139,32250,31880,1,-38,-29,-189,0,-2895,478,-2,0,0,0,7
EUW1_6883386858',7,33,10,0,1,0,0,7,1,386,86,26781,29909,26225,5,31,11,2,0,2,0,4,367,112,29643,31714,27523,0,19,-26,-2862,-1,-1805,-1298,-2,1,-2,0,3
EUW1_6883329595',10,95,21,1,0,1,0,16,0,334,89,32144,29143,39445,3,64,19,1,0,3,0,8,340,77,31584,29629,38854,0,-6,12,560,2,-486,591,0,0,-2,0,8
EUW1_6883265716',8,39,15,0,0,0,0,7,1,331,92,28936,29164,27566,4,173,11,1,0,1,0,4,361,74,26836,29795,26937,0,-30,18,2100,4,-631,629,-1,0,-1,0,3
EUW1_6883199974',4,35,8,0,0,1,0,9,0,382,86,26094,28255,26318,3,28,11,2,0,1,0,3,379,96,27899,29019,33504,0,3,-10,-1805,-3,-764,-7186,-2,0,0,0,6
EUW1_6882309073',5,32,18,1,0,1,0,5,1,280,78,29241,25886,36925,4,46,13,0,0,0,0,6,332,90,28068,27452,34493,1,-52,-12,1173,5,-1566,2432,1,0,1,0,-1
EUW1_6882293715',4,29,8,0,0,0,0,11,0,418,64,26166,31800,26659,2,26,17,2,0,1,0,3,418,108,32638,33489,36428,0,0,-44,-6472,-9,-1689,-9769,-2,0,-1,0,8
EUW1_6882270263',2,55,8,1,0,0,0,8,0,394,68,25888,28493,31273,5,33,13,1,0,1,0,2,387,111,29290,32100,38733,0,7,-43,-3402,-5,-3607,-7460,0,0,-1,0,6
EUW1_6882244061',3,24,30,2,0,3,0,6,1,376,90,35931,33094,50237,0,29,10,0,0,0,0,8,261,90,24567,25386,27285,1,115,0,11364,20,7708,22952,2,0,3,0,-2
EUW1_6882182903',3,24,22,0,0,2,0,4,1,359,82,32337,28909,41415,2,97,11,1,0,0,0,8,243,69,25501,24675,28629,1,116,13,6836,11,4234,12786,-1,0,2,0,-4
EUW1_6882139413',4,29,16,1,0,0,0,9,1,391,114,29527,32306,33885,6,103,5,0,0,0,0,4,339,54,23033,26891,29838,1,52,60,6494,11,5415,4047,1,0,0,0,5
EUW1_6881721235',3,25,11,0,0,0,0,13,0,340,84,27315,28730,27609,6,117,21,1,0,3,0,3,359,84,32733,30025,36810,0,-19,0,-5418,-10,-1295,-9201,-1,0,-3,0,10
EUW1_6881678220',1,37,7,1,0,0,0,12,0,325,64,22700,26452,28016,4,27,15,1,0,1,0,1,401,108,31156,32786,39692,0,-76,-44,-8456,-8,-6334,-11676,0,0,-1,0,11
EUW1_6881640342',2,26,21,1,0,4,2,9,1,439,116,35613,33581,41340,1,24,5,0,0,3,0,5,229,65,20285,23522,17843,1,210,51,15328,16,10059,23497,1,0,1,2,4
EUW1_6881603816',4,32,14,1,0,0,0,18,1,295,72,26788,24905,26425,6,39,18,0,1,3,0,2,399,95,33902,29600,31180,0,-104,-23,-7114,-4,-4695,-4755,1,-1,-3,0,16
EUW1_6883596551',3,29,13,1,0,0,0,8,1,348,104,27664,30119,34526,3,25,21,1,1,0,0,5,324,100,30289,32199,40625,0,24,4,-2625,-8,-2080,-6099,0,-1,0,0,3
EUW1_6883529872',0,19,15,2,0,1,0,18,0,295,81,29251,29157,31022,5,28,18,0,0,2,0,2,355,112,31536,32135,35527,1,-60,-31,-2285,-3,-2978,-4505,2,0,-1,0,16
EUW1_6883488475',3,26,16,0,0,2,0,9,1,367,72,30879,31111,33400,6,143,10,1,0,0,0,6,341,98,25406,29555,28682,1,26,-26,5473,6,1556,4718,-1,0,2,0,3
EUW1_6883441806',3,29,15,2,0,2,0,5,0,367,104,29144,31194,37602,1,34,7,0,0,0,0,8,359,80,25142,28392,25912,1,8,24,4002,8,2802,11690,2,0,2,0,-3
EUW1_6883385055',4,22,9,0,0,0,0,5,1,343,79,25104,28866,28169,4,31,11,1,0,1,0,0,339,84,25729,29479,32634,0,4,-5,-625,-2,-613,-4465,-1,0,-1,0,5
EUW1_6883320031',1,23,18,0,0,0,0,4,0,354,83,30520,31245,38953,6,31,11,2,1,1,0,4,355,88,27319,29538,24370,1,-1,-5,3201,7,1707,14583,-2,-1,-1,0,0
EUW1_6883281596',3,22,5,0,0,0,0,16,0,297,90,23363,26391,22782,2,66,17,2,0,3,0,0,377,84,31422,33224,35822,0,-80,6,-8059,-12,-6833,-13040,-2,0,-3,0,16
EUW1_6883058587',2,26,15,0,0,0,0,11,0,320,77,27413,29764,31893,6,25,16,2,0,1,0,1,372,78,30866,31040,33031,1,-52,-1,-3453,-1,-1276,-1138,-2,0,-1,0,10
EUW1_6882999091',9,77,9,0,0,0,0,5,0,331,75,25015,28052,22543,4,69,12,2,0,1,0,3,308,67,26359,28676,33067,0,23,8,-1344,-3,-624,-10524,-2,0,-1,0,2
EUW1_6882161439',3,36,11,0,0,0,0,10,1,306,77,25585,28024,28674,3,23,21,2,0,2,0,1,384,105,31716,32153,38597,0,-78,-28,-6131,-10,-4129,-9923,-2,0,-2,0,9
EUW1_6882053947',3,159,19,1,0,0,0,5,0,370,79,29935,32270,34729,1,25,16,0,0,1,0,4,375,96,29672,32109,37791,0,-5,-17,263,3,161,-3062,1,0,-1,0,1
EUW1_6881969399',2,29,8,1,0,0,0,6,1,395,124,26092,32412,22442,4,18,6,0,0,0,0,2,366,96,23839,29485,21642,1,29,28,2253,2,2927,800,1,0,0,0,4
EUW1_6881916005',4,28,11,1,0,0,0,10,0,348,64,25938,28317,34879,7,31,20,1,1,0,0,2,327,108,30675,31343,43563,0,21,-44,-4737,-9,-3026,-8684,0,-1,0,0,8
EUW1_6881836083',1,25,13,2,0,0,0,13,0,354,83,28194,30820,35762,4,23,13,0,1,1,0,2,336,75,26846,29367,25624,1,18,8,1348,0,1453,10138,2,-1,-1,0,11
EUW1_6881776776',5,20,7,0,0,0,0,9,1,328,92,24019,26842,40093,3,28,8,1,0,0,0,3,353,68,24428,29561,35714,0,-25,24,-409,-1,-2719,4379,-1,0,0,0,6
EUW1_6881707663',2,25,11,0,0,0,0,10,0,308,70,24648,25827,29345,4,37,16,2,0,1,0,1,377,88,28583,29578,37923,0,-69,-18,-3935,-5,-3751,-8578,-2,0,-1,0,9
EUW1_6881641892',1,27,15,1,0,0,0,9,1,343,80,28724,29755,30726,2,36,9,1,0,2,0,5,348,76,25700,27767,27790,1,-5,4,3024,6,1988,2936,0,0,-2,0,4
EUW1_6880651634',2,27,14,0,0,1,0,9,1,298,55,26190,27423,35459,4,29,12,1,0,0,0,2,332,88,26933,27954,29836,0,-34,-33,-743,2,-531,5623,-1,0,1,0,7
EUW1_6880626686',6,30,19,1,0,1,0,11,1,368,87,31252,30120,39588,1,24,5,1,0,1,0,6,312,56,23289,25761,22794,1,56,31,7963,14,4359,16794,0,0,0,0,5
EUW1_6881794404',4,37,5,0,0,0,0,11,0,338,93,23650,27197,25387,4,24,14,2,0,1,0,2,412,84,30507,30080,25866,0,-74,9,-6857,-9,-2883,-479,-2,0,-1,0,9
EUW1_6879947280',3,27,15,1,0,1,0,7,1,393,100,29316,33016,28730,5,30,8,0,0,0,0,3,397,70,25326,29038,30384,0,-4,30,3990,7,3978,-1654,1,0,1,0,4
EUW1_6879879989',6,35,19,1,0,0,0,8,1,371,78,31725,31452,39799,7,33,15,1,0,2,0,5,362,90,28209,29627,30476,1,9,-12,3516,4,1825,9323,0,0,-2,0,3
EUW1_6879827098',5,46,13,0,0,0,0,7,0,337,73,27242,27967,39466,7,67,19,1,0,0,0,4,328,105,30244,29658,35734,0,9,-32,-3002,-6,-1691,3732,-1,0,0,0,3
EUW1_6876811282',5,32,14,1,0,0,0,14,1,351,56,28382,28738,28344,1,21,11,1,0,1,0,3,361,99,27516,28487,33003,0,-10,-43,866,3,251,-4659,0,0,-1,0,11
EUW1_6876752275',4,47,10,1,0,0,0,7,0,327,91,25950,27409,29665,5,111,13,1,0,1,0,4,358,76,27106,27911,31530,0,-31,15,-1156,-3,-502,-1865,0,0,-1,0,3
EUW1_6876710252',5,45,9,0,0,0,0,9,0,410,96,26332,29195,26669,4,35,16,2,0,0,0,2,402,90,31194,30839,30612,0,8,6,-4862,-7,-1644,-3943,-2,0,0,0,7
EUW1_6875722082',3,28,7,1,0,3,0,3,0,415,103,29407,31001,20974,5,19,12,1,0,0,0,15,354,92,26650,31115,29262,1,61,11,2757,-5,-114,-8288,0,0,3,0,-12
EUW1_6873340168',2,80,13,1,0,0,0,6,1,336,89,26667,27520,32389,4,32,22,1,0,1,0,1,377,94,34194,33791,46676,0,-41,-5,-7527,-9,-6271,-14287,0,0,-1,0,5
EUW1_6869955732',8,32,19,2,0,1,0,6,1,394,88,30830,32216,41800,5,31,11,0,0,0,0,5,356,85,26050,30175,35552,1,38,3,4780,8,2041,6248,2,0,1,0,1
EUW1_6869888860',0,43,13,1,0,0,0,10,1,369,72,28321,30119,37963,3,38,11,1,0,0,0,4,355,108,26724,28602,34543,0,14,-36,1597,2,1517,3420,0,0,0,0,6
EUW1_6869771611',4,32,11,0,0,0,0,9,0,355,84,26582,28060,31371,6,271,19,1,0,1,0,1,388,80,30831,32303,35265,0,-33,4,-4249,-8,-4243,-3894,-1,0,-1,0,8
EUW1_6869717650',3,35,6,1,0,0,0,5,1,385,89,25343,29886,26382,4,35,7,1,0,0,0,2,378,114,25070,30927,26331,0,7,-25,273,-1,-1041,51,0,0,0,0,3
EUW1_6869678862',4,39,18,0,0,2,0,5,1,383,86,31813,31533,35345,4,28,7,2,0,0,0,11,362,105,24225,28398,30854,1,21,-19,7588,11,3135,4491,-2,0,2,0,-6
EUW1_6868539544',3,25,18,0,1,0,0,13,1,266,80,29323,26363,29056,2,35,15,2,0,3,0,0,327,100,31175,28816,36570,1,-61,-20,-1852,3,-2453,-7514,-2,1,-3,0,13
EUW1_6868468983',3,24,14,0,0,1,0,9,0,348,79,28440,30353,42439,8,42,17,2,0,1,0,4,394,107,30738,33237,38257,0,-46,-28,-2298,-3,-2884,4182,-2,0,0,0,5
EUW1_6881584674',1,27,6,0,0,0,0,3,0,321,78,23493,26435,23433,5,25,13,1,0,1,0,7,309,114,26741,27785,31156,0,12,-36,-3248,-7,-1350,-7723,-1,0,-1,0,-4
EUW1_6878878987',1,22,12,2,0,1,0,10,0,369,106,27744,31823,35995,4,32,12,0,0,0,0,2,350,98,27800,31094,30506,0,19,8,-56,0,729,5489,2,0,1,0,8
EUW1_6876118330',4,32,13,1,0,0,0,5,1,368,93,28317,29875,33593,7,32,11,1,0,0,0,3,383,73,26432,30021,31178,1,-15,20,1885,2,-146,2415,0,0,0,0,2
EUW1_6866026189',6,38,22,0,1,0,0,11,0,264,61,29470,25737,37814,3,22,17,2,0,0,0,3,360,86,30750,27423,38347,0,-96,-25,-1280,5,-1686,-533,-2,1,0,0,8
EUW1_6865996938',3,25,11,1,0,0,0,10,1,364,100,27667,30699,31879,5,39,12,1,0,1,0,5,375,86,29298,31201,31566,0,-11,14,-1631,-1,-502,313,0,0,-1,0,5
EUW1_6863508523',3,28,10,2,0,0,0,6,0,329,82,25618,26734,33733,3,29,17,0,1,1,0,2,302,85,27457,27623,33796,0,27,-3,-1839,-7,-889,-63,2,-1,-1,0,4
EUW1_6863483465',1,38,5,0,0,0,0,10,0,375,76,23827,27615,26530,4,32,17,1,0,0,0,1,393,60,29672,31210,37259,0,-18,16,-5845,-12,-3595,-10729,-1,0,0,0,9
EUW1_6863406412',1,183,6,0,0,1,0,13,1,294,79,23960,25313,25670,4,27,23,1,1,2,0,5,396,79,33218,33111,36886,0,-102,0,-9258,-17,-7798,-11216,-1,-1,-1,0,8
EUW1_6863404883',2,28,18,1,0,1,0,7,1,340,124,32015,29978,40960,5,27,9,0,0,1,0,7,330,60,24285,27514,27146,1,10,64,7730,9,2464,13814,1,0,0,0,0
EUW1_6863376080',4,33,6,0,0,0,0,9,1,378,72,23822,29695,28633,3,54,14,2,0,0,0,1,364,102,27957,30574,33248,0,14,-30,-4135,-8,-879,-4615,-2,0,0,0,8
EUW1_6857963371',1,23,16,1,0,0,0,15,0,243,106,27609,25167,33424,1,26,23,1,0,2,0,1,393,85,34418,30945,41768,0,-150,21,-6809,-7,-5778,-8344,0,0,-2,0,14
EUW1_6857945966',3,28,11,0,0,0,0,8,1,415,86,27918,30511,23865,3,47,18,2,0,1,0,1,409,99,29645,31899,29516,0,6,-13,-1727,-7,-1388,-5651,-2,0,-1,0,7
EUW1_6857918298',6,38,16,0,0,1,0,7,1,331,72,28794,28065,31818,2,30,11,1,1,1,0,5,298,96,25613,27029,30737,1,33,-24,3181,5,1036,1081,-1,-1,0,0,2
EUW1_6857902968',4,55,12,1,0,1,0,7,1,372,106,27883,31695,28792,2,29,4,0,0,0,0,4,369,86,23604,27864,24395,1,3,20,4279,8,3831,4397,1,0,1,0,3
EUW1_6857869762',3,22,12,1,0,2,0,18,1,348,72,27250,26907,31676,4,28,13,0,0,2,0,4,332,84,28970,29172,34560,1,16,-12,-1720,-1,-2265,-2884,1,0,0,0,14
EUW1_6857828713',2,28,6,0,0,0,0,7,0,348,100,24333,28189,28923,5,25,15,2,0,0,0,2,369,98,28208,31871,35622,0,-21,2,-3875,-9,-3682,-6699,-2,0,0,0,5
EUW1_6857781079',2,23,11,0,0,0,0,12,0,356,82,27825,29583,23304,5,72,20,1,0,1,0,3,379,102,31950,31426,38462,0,-23,-20,-4125,-9,-1843,-15158,-1,0,-1,0,9
EUW1_6857733659',0,19,11,0,0,0,0,7,1,347,95,26832,28427,33133,4,33,15,1,0,0,0,2,389,83,29440,30669,38494,0,-42,12,-2608,-4,-2242,-5361,-1,0,0,0,5
EUW1_6857665377',4,25,11,0,0,0,0,12,1,387,79,26673,29464,30140,1,31,11,2,0,3,0,2,352,96,27276,29945,29503,0,35,-17,-603,0,-481,637,-2,0,-3,0,10
EUW1_6883335388',5,31,19,1,0,0,0,7,1,322,78,29872,30527,41683,6,33,13,1,0,0,0,4,356,70,28448,28788,30451,0,-34,8,1424,6,1739,11232,0,0,0,0,3
EUW1_6883212590',7,40,11,1,0,0,0,12,1,349,78,25779,27665,28241,6,29,19,1,0,2,0,1,391,95,32046,34527,35488,0,-42,-17,-6267,-8,-6862,-7247,0,0,-2,0,11
EUW1_6883023764',1,27,6,0,0,1,0,13,0,389,87,25649,29413,21420,6,28,10,2,0,2,0,4,423,108,29769,31616,28345,0,-34,-21,-4120,-4,-2203,-6925,-2,0,-1,0,9
EUW1_6882828482',5,29,7,0,0,0,0,14,0,342,74,24404,28295,26415,5,29,10,2,1,1,0,4,374,126,28906,30682,29619,0,-32,-52,-4502,-3,-2387,-3204,-2,-1,-1,0,10
EUW1_6882786714',2,28,9,0,0,1,0,10,1,367,118,26359,29689,26751,2,21,9,2,0,1,0,5,331,82,24863,27189,19911,0,36,36,1496,0,2500,6840,-2,0,0,0,5
EUW1_6882748893',1,22,17,0,0,2,0,7,0,382,100,31805,32816,45654,3,28,13,2,0,0,0,10,306,88,26524,27878,29637,1,76,12,5281,4,4938,16017,-2,0,2,0,-3
EUW1_6882710733',6,25,28,1,0,3,0,6,1,341,83,36652,29396,49581,0,257,14,1,0,0,0,7,256,96,26504,27367,29815,1,85,-13,10148,14,2029,19766,0,0,3,0,-1
EUW1_6881420661',3,42,17,0,0,0,0,9,1,337,76,29723,29811,33682,1,27,9,1,0,1,0,5,313,104,24725,27770,28711,1,24,-28,4998,8,2041,4971,-1,0,-1,0,4
EUW1_6881358263',4,94,12,0,0,0,0,13,0,330,87,28035,27580,34517,8,36,24,1,0,2,0,1,329,87,32960,30517,39426,0,1,0,-4925,-12,-2937,-4909,-1,0,-2,0,12
EUW1_6881315746',7,32,6,1,0,0,0,10,0,399,103,25004,29715,26924,3,30,14,1,0,2,0,4,367,84,28584,30271,33467,0,32,19,-3580,-8,-556,-6543,0,0,-2,0,6
EUW1_6881233254',7,31,19,1,0,0,0,8,1,358,126,30016,32505,32893,4,25,10,1,0,1,0,3,374,82,27671,28242,33558,1,-16,44,2345,9,4263,-665,0,0,-1,0,5
EUW1_6881193263',0,33,2,0,0,0,0,8,0,405,110,23543,30289,21583,5,115,6,2,0,0,0,4,416,110,25909,31553,25468,0,-11,0,-2366,-4,-1264,-3885,-2,0,0,0,4
EUW1_6881143073',3,26,12,1,0,1,0,15,0,344,90,27504,29620,26674,3,33,13,1,0,2,0,1,389,111,28969,32098,27883,1,-45,-21,-1465,-1,-2478,-1209,0,0,-1,0,14
EUW1_6856317219',5,38,10,1,1,1,0,10,1,396,80,28480,29213,28287,1,210,8,1,0,1,0,3,349,100,25312,28752,23200,1,47,-20,3168,2,461,5087,0,1,0,0,7
EUW1_6850474674',4,25,12,1,0,1,0,10,0,367,102,29193,30167,32765,5,35,12,1,1,1,0,7,338,82,27837,30807,28501,0,29,20,1356,0,-640,4264,0,-1,0,0,3
EUW1_6843123363',1,35,13,1,0,0,0,12,1,361,94,27956,31209,35874,2,21,13,0,0,1,0,2,373,64,28222,30357,31381,1,-12,30,-266,0,852,4493,1,0,-1,0,10
EUW1_6841304342',5,31,10,0,0,1,0,13,1,297,78,24833,26059,33591,3,62,21,1,0,2,0,1,333,81,31360,30501,40644,0,-36,-3,-6527,-11,-4442,-7053,-1,0,-1,0,12
EUW1_6838489525',3,28,11,0,1,0,0,9,1,320,72,26012,28135,29151,1,24,12,1,0,0,0,2,355,110,26932,29268,34499,0,-35,-38,-920,-1,-1133,-5348,-1,1,0,0,7
EUW1_6838016040',5,29,13,1,1,1,0,10,1,297,106,28287,31106,41355,4,25,12,1,0,1,0,6,321,78,26627,28745,33669,1,-24,28,1660,1,2361,7686,0,1,0,0,4
EUW1_6836791933',3,27,8,0,0,0,0,13,0,297,69,23571,26299,21259,6,273,22,1,0,3,0,0,397,98,34846,32178,39050,0,-100,-29,-11275,-14,-5879,-17791,-1,0,-3,0,13
EUW1_6836746202',5,30,8,0,0,0,0,10,1,328,82,24606,27394,22574,3,87,18,1,0,1,0,3,379,96,30853,32129,35085,0,-51,-14,-6247,-10,-4735,-12511,-1,0,-1,0,7
EUW1_6834560724',6,29,14,0,0,1,0,8,0,366,78,29921,30161,42627,1,27,20,2,0,2,0,3,304,89,30815,29444,39615,0,62,-11,-894,-6,717,3012,-2,0,-1,0,5
EUW1_6834487484',3,31,17,1,0,2,0,6,1,379,130,32147,33411,44195,1,38,7,0,0,1,0,11,302,67,23241,26885,26323,1,77,63,8906,10,6526,17872,1,0,1,0,-5
EUW1_6834338640',3,25,8,0,0,0,0,5,0,413,107,26804,32721,22888,3,172,8,2,0,0,0,2,398,104,26064,30075,31790,1,15,3,740,0,2646,-8902,-2,0,0,0,3
EUW1_6834254117',6,51,9,0,0,1,0,11,0,372,104,27956,29945,29266,5,31,14,2,0,0,0,3,358,70,27502,30849,31156,1,14,34,454,-5,-904,-1890,-2,0,1,0,8
EUW1_6858087228',7,28,14,1,0,0,0,11,1,373,72,27990,30294,40619,5,43,6,0,0,0,0,3,357,94,26279,28962,30269,0,16,-22,1711,8,1332,10350,1,0,0,0,8
EUW1_6856759137',3,31,4,0,0,0,0,7,0,396,94,23810,28244,24335,2,25,12,1,0,1,0,2,398,99,27178,33288,29066,0,-2,-5,-3368,-8,-5044,-4731,-1,0,-1,0,5
EUW1_6856739363',5,29,14,0,0,0,0,6,1,348,76,26520,29749,33810,10,31,10,1,0,0,0,2,324,72,25485,27545,32026,1,24,4,1035,4,2204,1784,-1,0,0,0,4
EUW1_6856730749',5,27,14,1,0,0,0,11,1,335,64,27604,27071,32575,4,59,13,1,0,2,0,6,366,93,29039,29985,35533,1,-31,-29,-1435,1,-2914,-2958,0,0,-2,0,5
EUW1_6856716736',5,33,15,1,0,1,0,13,1,293,104,27881,27722,29589,4,28,15,1,0,2,0,5,322,94,30317,28906,36280,1,-29,10,-2436,0,-1184,-6691,0,0,-1,0,8
EUW1_6856707880',0,27,5,0,0,0,0,7,0,396,130,26074,32273,29801,5,50,12,2,1,0,0,4,380,79,26594,32224,30531,0,16,51,-520,-7,49,-730,-2,-1,0,0,3
EUW1_6856698649',4,131,13,1,0,0,0,7,1,333,84,27131,28626,34965,3,40,19,0,0,1,0,4,395,83,31769,33601,38079,0,-62,1,-4638,-6,-4975,-3114,1,0,-1,0,3
EUW1_6856684744',5,22,17,0,0,1,0,9,1,356,88,29855,31520,37052,1,22,5,2,1,1,0,9,345,96,25164,29228,28604,0,11,-8,4691,12,2292,8448,-2,-1,0,0,0
EUW1_6856672870',5,34,14,1,0,0,0,11,0,303,86,26359,27772,32459,4,26,22,1,0,1,0,2,320,82,31363,30681,38009,0,-17,4,-5004,-8,-2909,-5550,0,0,-1,0,9
EUW1_6856648931',1,48,15,1,0,0,0,7,1,352,82,28607,30336,31754,3,23,17,1,0,1,0,5,345,101,30755,30850,33308,0,7,-19,-2148,-2,-514,-1554,0,0,-1,0,2
EUW1_6856628379',1,16,14,0,0,1,0,12,0,316,86,29031,29159,38732,5,24,17,2,0,1,0,7,362,82,29898,30247,35488,0,-46,4,-867,-3,-1088,3244,-2,0,0,0,5
EUW1_6856612405',2,25,14,2,0,1,0,15,0,344,70,28187,29694,30750,1,18,11,0,0,1,0,7,370,106,28912,29954,34222,0,-26,-36,-725,3,-260,-3472,2,0,0,0,8
EUW1_6855503260',2,29,15,1,0,0,0,8,1,379,79,28666,30580,41710,4,26,9,0,0,1,0,4,336,70,25139,28236,27925,1,43,9,3527,6,2344,13785,1,0,-1,0,4
EUW1_6855489333',5,30,15,1,0,1,0,7,0,389,74,29065,32462,37169,7,420,12,1,0,0,0,3,393,118,28570,31766,32704,1,-4,-44,495,3,696,4465,0,0,1,0,4
EUW1_6855484065',5,36,16,1,0,2,0,10,1,386,100,31659,32617,32584,5,29,7,0,0,1,0,8,389,80,26693,29569,26396,1,-3,20,4966,9,3048,6188,1,0,1,0,2
EUW1_6855470314',2,32,10,0,0,1,0,13,0,349,78,27668,28127,28969,1,23,19,1,0,2,0,5,357,84,31537,31650,41235,0,-8,-6,-3869,-9,-3523,-12266,-1,0,-1,0,8
EUW1_6855465572',8,26,9,0,0,2,0,13,0,359,88,28365,29295,29857,4,23,9,2,0,1,0,7,359,90,25342,28772,28899,0,0,-2,3023,0,523,958,-2,0,1,0,6
EUW1_6875138163',4,21,19,2,0,1,0,2,1,321,79,28101,29347,38956,6,28,13,0,0,0,0,5,292,92,27873,29080,43695,1,29,-13,228,6,267,-4739,2,0,1,0,-3
EUW1_6864868098',6,26,4,0,0,0,0,7,1,364,80,23328,28060,24995,6,29,8,1,0,1,0,0,369,76,25630,29288,30922,1,-5,4,-2302,-4,-1228,-5927,-1,0,-1,0,7
EUW1_6858636743',2,27,15,2,0,1,0,11,1,345,116,29816,31087,28875,2,28,5,0,0,2,0,7,337,71,24066,27470,24343,1,8,45,5750,10,3617,4532,2,0,-1,0,4
EUW1_6856719173',2,27,11,0,1,1,0,11,0,333,89,27418,28067,32403,5,35,12,1,0,2,0,6,349,78,29007,30080,29309,0,-16,11,-1589,-1,-2013,3094,-1,1,-1,0,5
EUW1_6856710019',8,33,18,2,0,0,0,5,1,410,107,31823,34176,34155,5,28,5,0,0,1,0,4,371,68,24687,28490,18731,1,39,39,7136,13,5686,15424,2,0,-1,0,1
EUW1_6854260264',4,23,10,1,1,0,0,16,1,285,88,23881,23903,24504,7,42,14,1,0,2,0,3,310,100,28437,26657,29282,0,-25,-12,-4556,-4,-2754,-4778,0,1,-2,0,13
EUW1_6854239691',2,30,4,0,0,0,0,13,0,317,106,22627,27616,22247,0,24,13,2,0,3,0,0,394,113,30585,32552,25951,0,-77,-7,-7958,-9,-4936,-3704,-2,0,-3,0,13
EUW1_6853232865',5,33,11,0,0,0,0,5,0,348,92,26282,28776,26065,2,26,6,1,0,0,0,2,344,78,23857,25819,30064,0,4,14,2425,5,2957,-3999,-1,0,0,0,3
EUW1_6853116756',5,28,13,2,0,0,0,5,1,412,90,28694,32388,28225,7,30,5,0,0,0,0,3,399,92,24571,30988,20757,1,13,-2,4123,8,1400,7468,2,0,0,0,2
EUW1_6852057785',4,27,8,2,0,0,0,4,1,380,80,25281,27616,32988,7,206,12,0,0,0,0,2,337,79,26861,29341,35637,0,43,1,-1580,-4,-1725,-2649,2,0,0,0,2
EUW1_6851915826',4,28,10,0,0,1,0,6,0,358,82,27762,29016,31395,7,101,14,1,0,1,0,5,346,100,28981,29418,33207,1,12,-18,-1219,-4,-402,-1812,-1,0,0,0,1
EUW1_6851873065',3,35,14,1,0,0,0,8,0,316,106,28104,29307,31170,3,40,10,1,0,2,0,4,315,80,25716,28244,32815,0,1,26,2388,4,1063,-1645,0,0,-2,0,4
EUW1_6851687683',4,31,18,1,1,3,0,3,1,427,116,33297,32362,27389,2,23,6,0,0,0,0,8,366,67,24145,29007,25403,1,61,49,9152,12,3355,1986,1,1,3,0,-5
EUW1_6851668928',5,27,12,2,1,0,0,7,1,387,84,28758,31575,30592,5,222,3,0,0,1,0,3,321,114,22270,27642,19623,1,66,-30,6488,9,3933,10969,2,1,-1,0,4
EUW1_6850699376',3,29,5,1,0,2,0,10,1,352,94,25053,28381,23884,5,30,10,1,1,1,0,2,368,81,26552,28676,25816,1,-16,13,-1499,-5,-295,-1932,0,-1,1,0,8
EUW1_6850162333',5,26,13,0,1,1,0,8,0,356,74,27998,29248,31063,4,29,13,2,0,0,0,4,318,126,27641,29794,33059,1,38,-52,357,0,-546,-1996,-2,1,1,0,4
EUW1_6883254369',2,27,13,0,0,2,0,4,1,392,104,30490,30899,27828,10,40,5,2,0,0,0,7,297,79,21977,25826,25717,1,95,25,8513,8,5073,2111,-2,0,2,0,-3
EUW1_6883189272',3,25,10,0,1,1,0,7,0,339,107,26142,29005,25106,5,21,11,2,0,1,0,2,347,76,27231,27191,32791,0,-8,31,-1089,-1,1814,-7685,-2,1,0,0,5
EUW1_6883055788',2,24,12,1,0,1,0,7,1,436,112,29939,32253,32151,2,150,9,1,0,0,0,5,371,90,26449,29493,31122,1,65,22,3490,3,2760,1029,0,0,1,0,2
EUW1_6882898400',5,31,15,0,0,2,0,7,0,377,72,29995,29893,36346,6,31,10,2,0,0,0,8,377,81,26073,28457,29433,1,0,-9,3922,5,1436,6913,-2,0,2,0,-1
EUW1_6882839361',1,28,5,1,0,0,0,7,1,315,112,22971,27450,21211,4,43,13,1,0,0,0,2,359,75,27256,28778,27735,0,-44,37,-4285,-8,-1328,-6524,0,0,0,0,5
EUW1_6882803510',2,18,8,1,0,0,0,12,0,358,74,25505,28820,25410,3,20,15,0,0,2,0,4,373,110,30886,32196,35730,0,-15,-36,-5381,-7,-3376,-10320,1,0,-2,0,8
EUW1_6882606268',6,28,10,1,0,0,0,9,1,393,77,26371,29208,32697,5,25,15,1,1,1,0,2,395,83,30018,32226,37698,0,-2,-6,-3647,-5,-3018,-5001,0,-1,-1,0,7
EUW1_6882583572',3,31,13,0,1,1,0,7,0,357,87,28659,29596,37127,7,27,14,2,0,1,0,4,342,88,27349,28346,32601,1,15,-1,1310,-1,1250,4526,-2,1,0,0,3
EUW1_6882176921',3,29,19,0,0,0,0,11,0,337,77,30802,30091,47078,3,20,22,1,0,2,0,2,319,82,31585,28580,43322,0,18,-5,-783,-3,1511,3756,-1,0,-2,0,9
EUW1_6881888197',5,28,14,1,0,2,0,4,1,362,120,32291,31728,31830,7,34,5,0,0,2,0,14,322,72,22792,26300,26401,1,40,48,9499,9,5428,5429,1,0,0,0,-10
EUW1_6881710170',0,23,9,0,0,0,0,14,0,330,72,25754,27608,24632,6,351,21,2,0,3,0,1,404,66,33143,31529,40352,0,-74,6,-7389,-12,-3921,-15720,-2,0,-3,0,13
EUW1_6881646813',6,26,8,1,0,0,0,11,0,345,106,25740,30473,33115,7,35,13,1,0,0,0,3,381,101,28133,31331,29378,0,-36,5,-2393,-5,-858,3737,0,0,0,0,8
EUW1_6881484016',5,42,13,0,0,2,0,8,0,344,90,29442,28333,36369,5,24,16,1,0,0,0,7,347,85,29287,31187,35745,1,-3,5,155,-3,-2854,624,-1,0,2,0,1
EUW1_6881431261',1,24,10,1,0,2,0,9,1,361,90,28260,30922,29363,3,22,5,1,0,1,0,5,376,98,23599,28328,21291,1,-15,-8,4661,5,2594,8072,0,0,1,0,4
EUW1_6855457337',4,68,13,0,0,0,0,11,0,248,74,24736,26017,32169,4,80,21,2,0,2,0,2,328,91,32841,29951,44170,0,-80,-17,-8105,-8,-3934,-12001,-2,0,-2,0,9
EUW1_6825657978',3,26,8,0,0,0,0,13,0,328,107,25974,28809,22003,4,25,17,2,0,2,0,1,345,96,30532,30398,40593,0,-17,11,-4558,-9,-1589,-18590,-2,0,-2,0,12
EUW1_6825542393',5,29,25,0,1,3,0,11,0,296,119,33199,29240,37095,4,26,17,2,0,1,0,3,292,84,30256,25092,37312,1,4,35,2943,8,4148,-217,-2,1,2,0,8
EUW1_6825497262',8,26,18,0,1,1,0,8,1,323,106,30794,29680,37433,3,139,21,2,0,0,0,2,324,106,30074,31242,42805,0,-1,0,720,-3,-1562,-5372,-2,1,1,0,6
EUW1_6813112166',2,20,17,1,0,1,0,6,0,356,83,29438,30548,34826,3,27,13,1,0,0,0,4,307,96,26481,27010,36224,1,49,-13,2957,4,3538,-1398,0,0,1,0,2
EUW1_6813092558',3,38,12,0,0,1,0,6,0,336,78,27883,27914,29463,5,27,17,2,0,1,0,3,372,113,31044,33523,34197,0,-36,-35,-3161,-5,-5609,-4734,-2,0,0,0,3
EUW1_6813056663',5,29,7,0,0,0,0,12,0,358,75,24822,26969,25666,7,33,16,2,0,2,0,0,400,100,31329,32035,38550,0,-42,-25,-6507,-9,-5066,-12884,-2,0,-2,0,12
EUW1_6813018282',1,35,24,1,0,1,0,6,1,379,98,33494,31362,43709,3,27,13,1,0,1,0,5,317,82,27896,28525,31480,1,62,16,5598,11,2837,12229,0,0,0,0,1
EUW1_6811521954',6,67,15,1,0,1,0,7,1,363,84,29950,30897,41744,7,25,12,1,0,1,0,3,378,72,28027,29378,35514,0,-15,12,1923,3,1519,6230,0,0,0,0,4
EUW1_6811484634',0,19,14,0,0,1,0,7,0,354,92,29667,30206,36416,3,235,24,1,0,1,0,8,331,92,32748,31913,42385,0,23,0,-3081,-10,-1707,-5969,-1,0,0,0,-1
EUW1_6811430461',5,30,11,0,0,0,0,12,1,334,102,27539,28256,23843,9,35,20,2,0,1,0,0,343,108,33427,31617,36528,0,-9,-6,-5888,-9,-3361,-12685,-2,0,-1,0,12
EUW1_6811373289',2,37,12,2,0,1,0,4,1,388,116,28788,33133,26432,2,25,4,0,0,0,0,4,316,80,21677,26749,19220,1,72,36,7111,8,6384,7212,2,0,1,0,0
EUW1_6811138709',1,57,25,1,0,0,0,7,1,365,80,31403,32057,40204,2,55,4,0,0,0,0,5,334,118,24514,27773,29542,1,31,-38,6889,21,4284,10662,1,0,0,0,2
EUW1_6811064221',2,23,16,0,0,0,0,9,1,342,116,28783,31412,34385,3,135,10,2,0,1,0,3,393,76,27582,31409,32943,1,-51,40,1201,6,3,1442,-2,0,-1,0,6
EUW1_6809996094',2,62,14,0,0,0,0,9,0,309,74,26946,28067,34591,2,65,17,1,0,1,0,6,354,64,30006,30423,42581,0,-45,10,-3060,-3,-2356,-7990,-1,0,-1,0,3
EUW1_6809977856',2,30,13,0,0,0,0,9,0,298,66,25712,26776,35940,4,24,19,2,0,1,0,0,343,102,30801,30694,34429,0,-45,-36,-5089,-6,-3918,1511,-2,0,-1,0,9
EUW1_6809955098',6,31,4,1,0,0,0,6,0,320,89,23025,26471,24555,5,99,12,0,0,0,0,1,375,90,28252,30730,33043,0,-55,-1,-5227,-8,-4259,-8488,1,0,0,0,5
EUW1_6809927117',3,37,17,1,0,1,0,9,1,364,66,30348,29569,37477,5,140,14,0,0,0,0,4,314,108,28167,29545,33185,1,50,-42,2181,3,24,4292,1,0,1,0,5
EUW1_6809888685',2,25,9,1,0,1,0,13,0,368,97,26444,29580,28233,5,25,17,0,1,1,0,3,359,98,31226,30933,33437,0,9,-1,-4782,-8,-1353,-5204,1,-1,0,0,10
EUW1_6878663206',8,33,20,0,0,2,0,8,1,382,98,33074,32496,44098,1,35,9,1,0,1,0,11,359,86,26177,28802,30184,1,23,12,6897,11,3694,13914,-1,0,1,0,-3
EUW1_6878628409',2,21,7,0,0,0,0,8,0,355,51,23462,27159,28591,3,311,13,1,0,0,0,1,372,118,28393,31944,35113,0,-17,-67,-4931,-6,-4785,-6522,-1,0,0,0,7
EUW1_6863372866',5,106,13,1,1,0,0,5,1,367,104,28610,31433,31952,2,40,7,0,0,1,0,6,349,97,24378,27515,27343,1,18,7,4232,6,3918,4609,1,1,-1,0,-1
EUW1_6863338070',4,26,8,1,0,0,0,10,1,366,98,26175,29471,27312,6,30,9,1,0,1,0,4,411,86,27321,31527,33728,0,-45,12,-1146,-1,-2056,-6416,0,0,-1,0,6
EUW1_6863331796',2,28,11,1,0,0,0,7,1,331,86,26418,31514,26371,1,139,4,1,0,0,0,5,359,80,23033,28394,31359,1,-28,6,3385,7,3120,-4988,0,0,0,0,2
EUW1_6863315468',4,37,8,0,0,1,0,11,1,351,90,26747,27442,27625,4,27,22,2,1,1,0,4,357,92,32647,31048,40226,0,-6,-2,-5900,-14,-3606,-12601,-2,-1,0,0,7
EUW1_6863292336',3,32,19,0,0,1,0,7,1,362,87,31164,30134,45093,2,21,12,2,0,0,0,6,355,88,28304,30961,42039,1,7,-1,2860,7,-827,3054,-2,0,1,0,1
EUW1_6862402928',5,30,10,0,1,0,0,10,0,345,78,26775,28498,31480,3,22,13,1,0,1,0,2,346,114,27391,30369,35412,0,-1,-36,-616,-3,-1871,-3932,-1,1,-1,0,8
EUW1_6879306622',2,26,4,2,0,1,0,5,0,413,102,25868,29305,18994,4,26,14,0,1,1,0,10,390,73,28065,32194,27840,0,23,29,-2197,-10,-2889,-8846,2,-1,0,0,-5
EUW1_6879273619',3,28,14,1,0,0,0,9,0,378,88,27992,30496,32325,4,30,8,0,0,0,0,5,365,84,24398,29388,24403,1,13,4,3594,6,1108,7922,1,0,0,0,4
EUW1_6879207594',6,28,13,2,0,0,0,5,0,377,78,27617,30513,29090,1,25,10,0,0,2,0,3,385,90,26259,29830,32726,1,-8,-12,1358,3,683,-3636,2,0,-2,0,2
EUW1_6879171532',6,29,9,0,0,0,0,12,0,337,84,24968,28051,32788,0,25,13,2,1,1,0,1,410,96,30002,32293,35366,0,-73,-12,-5034,-4,-4242,-2578,-2,-1,-1,0,11
EUW1_6879120041',3,158,9,1,0,1,0,11,1,423,104,28892,31757,26298,6,31,7,1,0,1,0,3,402,84,25891,29899,20035,1,21,20,3001,2,1858,6263,0,0,0,0,8
EUW1_6879089141',3,148,18,2,1,1,0,8,1,422,123,35002,33213,33187,3,21,6,0,0,2,0,8,331,74,23284,25005,21194,1,91,49,11718,12,8208,11993,2,1,-1,0,0
EUW1_6879005061',2,41,16,1,0,0,0,8,1,372,94,28390,31470,29180,8,36,8,1,0,0,0,4,359,93,24972,28821,28377,1,13,1,3418,8,2649,803,0,0,0,0,4
EUW1_6878942856',1,23,9,0,1,0,0,7,0,369,98,27105,30029,30216,6,29,12,2,0,1,0,6,385,90,28034,32055,30632,0,-16,8,-929,-3,-2026,-416,-2,1,-1,0,1
EUW1_6877851524',0,24,12,0,1,1,0,12,0,358,96,28328,30485,32909,2,128,19,2,0,2,0,5,355,104,31404,32286,40587,1,3,-8,-3076,-7,-1801,-7678,-2,1,-1,0,7
EUW1_6877828704',2,24,13,1,0,1,0,8,1,358,76,28376,28497,33566,3,32,18,1,1,0,0,4,339,112,29762,30592,38642,0,19,-36,-1386,-5,-2095,-5076,0,-1,1,0,4
EUW1_6877798032',4,29,8,0,0,0,0,10,0,381,78,26198,29525,29760,6,157,15,2,1,1,0,2,395,106,30253,31451,34332,0,-14,-28,-4055,-7,-1926,-4572,-2,-1,-1,0,8
EUW1_6877756703',2,26,11,1,0,1,0,8,1,362,103,27746,29723,29670,0,26,9,1,0,0,0,3,360,96,25902,29850,28252,0,2,7,1844,2,-127,1418,0,0,1,0,5
EUW1_6877722630',4,23,8,1,0,1,0,5,1,379,98,27132,30534,31733,1,39,9,0,0,1,0,8,355,85,26380,29679,31971,1,24,13,752,-1,855,-238,1,0,0,0,-3
EUW1_6877679663',2,30,17,1,0,0,0,5,1,299,83,28256,26114,36343,3,96,15,0,0,0,0,4,271,64,25801,24256,45405,1,28,19,2455,2,1858,-9062,1,0,0,0,1
EUW1_6877625041',1,22,10,1,0,2,0,10,0,347,103,28604,30385,29033,4,25,10,0,0,0,0,6,380,80,27336,29121,31257,1,-33,23,1268,0,1264,-2224,1,0,2,0,4
EUW1_6877573376',2,28,21,2,0,1,0,8,1,386,100,33245,32873,44762,2,176,12,0,0,0,0,3,317,88,26770,28523,31837,1,69,12,6475,9,4350,12925,2,0,1,0,5
EUW1_6867288158',7,33,9,0,0,0,0,9,1,370,64,24993,27893,23441,3,28,16,2,0,1,0,3,367,84,28794,29694,29780,0,3,-20,-3801,-7,-1801,-6339,-2,0,-1,0,6
EUW1_6864491226',1,24,22,0,0,1,0,9,1,365,80,32402,29494,40664,3,20,10,2,0,0,0,9,326,92,26995,28632,33286,1,39,-12,5407,12,862,7378,-2,0,1,0,0
EUW1_6864476273',3,29,27,2,0,2,0,5,1,324,100,34073,33033,49283,3,33,3,0,0,1,0,9,300,75,21699,24401,27227,1,24,25,12374,24,8632,22056,2,0,1,0,-4
EUW1_6861878806',3,50,14,0,0,0,0,12,1,337,52,27848,27671,36065,4,30,21,1,0,1,0,2,349,91,30601,30247,39984,0,-12,-39,-2753,-7,-2576,-3919,-1,0,-1,0,10
EUW1_6861841209',3,28,21,0,0,1,0,9,0,325,98,31979,31982,36212,4,28,17,2,0,0,0,3,365,104,29123,30286,38486,1,-40,-6,2856,4,1696,-2274,-2,0,1,0,6
EUW1_6861804232',3,26,7,0,0,0,0,13,0,281,82,24627,24596,29609,4,37,16,2,0,2,0,2,365,94,30446,28967,38463,0,-84,-12,-5819,-9,-4371,-8854,-2,0,-2,0,11
EUW1_6861763286',3,39,21,1,0,3,0,10,1,330,71,31690,28351,38048,3,45,9,0,0,0,0,6,280,69,25152,25216,25729,1,50,2,6538,12,3135,12319,1,0,3,0,4
EUW1_6861714845',3,27,9,1,0,1,0,4,1,385,73,25860,27646,20163,3,38,5,0,0,0,0,4,387,99,24273,29033,22949,0,-2,-26,1587,4,-1387,-2786,1,0,1,0,0
EUW1_6861653756',2,32,8,0,0,0,0,11,0,364,82,25815,29220,24309,2,18,12,2,0,1,0,3,388,78,27039,29313,26854,0,-24,4,-1224,-4,-93,-2545,-2,0,-1,0,8
EUW1_6861585012',1,106,4,0,0,0,0,7,0,374,80,23008,28749,18749,9,31,12,2,0,1,0,0,424,80,27854,31330,28322,0,-50,0,-4846,-8,-2581,-9573,-2,0,-1,0,7
EUW1_6861440610',2,26,8,1,0,0,0,9,0,358,81,25960,28675,27604,6,156,13,1,0,1,0,4,352,84,27817,28067,36777,0,6,-3,-1857,-5,608,-9173,0,0,-1,0,5
EUW1_6860741545',3,25,14,1,0,1,0,12,0,294,50,27227,25331,38035,3,29,16,1,0,1,0,2,343,88,29561,27317,32394,0,-49,-38,-2334,-2,-1986,5641,0,0,0,0,10
EUW1_6860712395',2,25,10,1,0,0,0,14,1,303,72,25644,26488,28683,3,30,11,0,0,1,0,1,376,79,27902,29345,36211,1,-73,-7,-2258,-1,-2857,-7528,1,0,-1,0,13
EUW1_6860687668',3,34,20,2,0,1,0,8,1,359,104,32537,30804,31663,4,26,8,0,0,1,0,10,362,84,24259,27650,28469,1,-3,20,8278,12,3154,3194,2,0,0,0,-2
EUW1_6860654914',5,30,12,1,0,1,0,10,0,335,88,28039,28402,28045,6,26,12,0,1,1,0,8,406,90,27950,30659,30589,1,-71,-2,89,0,-2257,-2544,1,-1,0,0,2
EUW1_6860627696',3,32,14,1,0,2,0,15,0,321,79,29071,27728,31888,5,26,16,1,0,1,0,3,354,73,29350,27754,34210,1,-33,6,-279,-2,-26,-2322,0,0,1,0,12
EUW1_6883701657',5,35,8,0,0,0,0,7,1,405,74,26264,28912,22139,0,23,12,0,0,0,0,2,348,82,26500,29377,27960,0,57,-8,-236,-4,-465,-5821,0,0,0,0,5
EUW1_6882998711',4,62,10,0,0,0,0,8,0,310,86,24749,27408,30972,6,63,9,1,0,0,0,2,322,96,25654,28173,34958,0,-12,-10,-905,1,-765,-3986,-1,0,0,0,6
EUW1_6882894997',5,27,15,2,0,1,0,3,0,403,119,29497,31952,32375,1,22,8,0,0,0,0,5,374,96,25856,29168,30428,1,29,23,3641,7,2784,1947,2,0,1,0,-2
EUW1_6882775775',8,36,9,0,0,0,0,8,0,373,88,26376,27918,30250,6,34,13,2,1,1,0,2,379,75,28490,29987,27534,1,-6,13,-2114,-4,-2069,2716,-2,-1,-1,0,6
EUW1_6882465814',4,52,12,1,0,2,0,10,0,355,79,27680,29423,25945,4,35,10,1,0,1,0,6,401,96,28841,30569,25332,1,-46,-17,-1161,2,-1146,613,0,0,1,0,4
EUW1_6882388544',1,26,7,1,0,0,0,9,0,316,61,24284,26519,28585,7,31,20,1,0,2,0,4,352,92,30348,29763,39151,0,-36,-31,-6064,-13,-3244,-10566,0,0,-2,0,5
EUW1_6882372582',1,30,14,0,0,1,0,13,0,333,106,28240,29259,31738,3,26,11,0,0,3,0,2,319,86,26950,26230,24972,1,14,20,1290,3,3029,6766,0,0,-2,0,11
EUW1_6881625703',7,28,9,1,1,0,0,11,0,361,89,25310,28699,20963,2,32,10,1,0,1,0,1,418,80,28358,29849,29756,0,-57,9,-3048,-1,-1150,-8793,0,1,-1,0,10
EUW1_6881429772',2,39,9,1,0,0,0,10,0,415,84,28054,31019,33265,3,26,15,1,0,1,0,2,403,113,28720,32725,32777,1,12,-29,-666,-6,-1706,488,0,0,-1,0,8
EUW1_6881217676',0,28,19,0,0,1,0,10,0,384,101,31954,33406,32776,4,26,12,0,0,0,0,1,326,97,26754,28297,30703,1,58,4,5200,7,5109,2073,0,0,1,0,9
EUW1_6864463633',4,57,5,2,0,0,0,4,1,360,98,23864,28731,24720,5,38,6,0,1,1,0,2,399,90,25417,30531,19423,1,-39,8,-1553,-1,-1800,5297,2,-1,-1,0,2
EUW1_6861384722',1,24,10,1,0,1,0,7,1,332,62,26231,26850,32106,6,47,19,0,0,1,0,1,381,106,30651,31484,39756,0,-49,-44,-4420,-9,-4634,-7650,1,0,0,0,6
EUW1_6860127198',5,34,17,0,0,1,0,4,1,379,56,31029,29642,34273,4,23,14,1,0,0,0,5,356,111,28097,28384,33218,0,23,-55,2932,3,1258,1055,-1,0,1,0,-1
EUW1_6860076811',4,48,16,0,0,1,0,17,0,381,80,30304,30745,38405,1,52,8,1,1,2,0,4,355,81,25978,29065,34773,0,26,-1,4326,8,1680,3632,-1,-1,-1,0,13
EUW1_6860034352',4,29,18,2,1,2,0,9,1,390,112,32961,32066,35554,5,30,6,0,0,1,0,8,330,72,24180,25159,20903,1,60,40,8781,12,6907,14651,2,1,1,0,1
EUW1_6859979398',6,27,11,1,0,1,0,6,0,371,83,27521,30458,26099,4,37,9,0,0,0,0,1,362,89,24698,27940,24544,1,9,-6,2823,2,2518,1555,1,0,1,0,5
EUW1_6859912194',1,30,10,0,0,0,0,4,0,358,112,26751,29924,27875,2,23,10,1,0,0,0,3,367,92,26157,28904,29798,1,-9,20,594,0,1020,-1923,-1,0,0,0,1
EUW1_6859315438',2,22,7,1,0,0,0,10,0,324,108,23676,28212,23447,7,31,14,1,0,2,0,1,401,92,29922,32149,35169,0,-77,16,-6246,-7,-3937,-11722,0,0,-2,0,9
EUW1_6858464801',5,26,20,1,0,2,0,9,1,414,82,32700,32332,46259,4,29,4,1,0,1,0,9,323,90,21952,26133,25778,1,91,-8,10748,16,6199,20481,0,0,1,0,0
EUW1_6857926894',5,30,15,2,0,1,0,10,0,340,94,29100,29294,34475,7,26,10,0,0,0,0,6,337,72,25815,28034,28619,1,3,22,3285,5,1260,5856,2,0,1,0,4
EUW1_6857752727',3,29,8,0,0,0,0,10,1,355,94,25381,28985,22473,6,29,5,1,0,1,0,2,380,85,25239,28633,19258,1,-25,9,142,3,352,3215,-1,0,-1,0,8
EUW1_6857493792',1,33,11,0,0,0,0,6,0,385,82,26397,29304,24630,3,32,8,0,1,0,0,1,412,100,26286,29558,20834,0,-27,-18,111,3,-254,3796,0,-1,0,0,5
EUW1_6863343984',10,32,14,2,0,1,0,6,1,351,84,27721,28962,36366,2,26,3,0,0,0,0,2,338,68,22001,25516,24959,1,13,16,5720,11,3446,11407,2,0,1,0,4
EUW1_6863321555',5,32,14,1,1,2,0,11,1,358,99,29876,31640,34601,3,27,10,1,0,1,0,9,385,104,26821,30174,26162,1,-27,-5,3055,4,1466,8439,0,1,1,0,2
EUW1_6871694590',3,22,1,1,0,0,0,10,0,370,80,21879,28295,21346,2,36,12,1,0,1,0,1,406,96,28080,31938,34925,0,-36,-16,-6201,-11,-3643,-13579,0,0,-1,0,9
EUW1_6864623540',1,26,11,1,0,0,0,12,0,346,110,26656,28678,28048,4,35,14,1,1,1,0,1,355,105,28691,29701,28395,1,-9,5,-2035,-3,-1023,-347,0,-1,-1,0,11
EUW1_6864608871',6,30,15,2,0,1,0,16,1,326,81,30031,29894,29701,6,27,20,0,0,2,0,4,334,105,31127,29110,39710,1,-8,-24,-1096,-5,784,-10009,2,0,-1,0,12
EUW1_6864592211',4,60,8,1,0,0,0,8,1,366,98,25456,29598,24053,5,194,15,1,1,0,0,2,400,117,29053,33990,37405,0,-34,-19,-3597,-7,-4392,-13352,0,-1,0,0,6
EUW1_6863865624',4,31,11,1,0,1,0,10,1,388,100,28531,31067,28222,2,30,10,0,0,1,0,5,366,90,27387,30112,29297,1,22,10,1144,1,955,-1075,1,0,0,0,5
EUW1_6863438162',5,26,11,1,1,1,0,12,0,367,110,28180,31158,33350,5,22,13,1,0,2,0,7,336,91,28811,29591,34009,0,31,19,-631,-2,1567,-659,0,1,-1,0,5
EUW1_6863392027',4,27,15,0,0,2,0,15,0,354,79,30504,29141,34721,3,25,15,1,0,1,0,6,344,93,29966,29222,39732,0,10,-14,538,0,-81,-5011,-1,0,1,0,9
EUW1_6863382589',2,18,11,1,0,3,0,5,0,409,111,32649,31185,32485,1,108,10,1,1,2,0,10,288,65,24372,25148,25334,1,121,46,8277,1,6037,7151,0,-1,1,0,-5
EUW1_6863295299',4,28,17,0,1,1,0,7,1,314,99,30319,28019,50573,0,24,19,2,0,1,0,6,358,76,29548,30041,40726,0,-44,23,771,-2,-2022,9847,-2,1,0,0,1
EUW1_6863292202',5,32,17,0,0,1,0,9,0,333,113,31491,29933,32156,1,29,16,2,0,3,0,9,322,85,29148,28977,34465,1,11,28,2343,1,956,-2309,-2,0,-2,0,0
EUW1_6863268305',2,35,11,1,0,0,0,12,0,335,85,25879,27534,33761,6,27,13,1,0,2,0,1,383,94,30349,30205,33003,0,-48,-9,-4470,-2,-2671,758,0,0,-2,0,11
EUW1_6881303622',7,32,13,2,0,1,0,6,1,370,96,28530,31474,27636,6,144,9,0,1,1,0,3,379,75,25301,30101,28430,1,-9,21,3229,4,1373,-794,2,-1,0,0,3
EUW1_6879369895',0,20,7,0,0,0,0,8,1,352,87,24186,27821,24328,8,45,12,1,0,1,0,2,339,96,27584,29826,33925,0,13,-9,-3398,-5,-2005,-9597,-1,0,-1,0,6
EUW1_6879357809',4,30,20,0,0,0,0,7,1,340,108,31122,30825,31332,4,62,12,1,0,1,0,4,337,82,26391,28089,30781,0,3,26,4731,8,2736,551,-1,0,-1,0,3
EUW1_6878389542',7,26,7,0,0,1,0,3,0,385,104,26307,29099,22758,5,26,9,2,0,0,0,5,404,81,25180,29711,24346,0,-19,23,1127,-2,-612,-1588,-2,0,1,0,-2
EUW1_6877935533',4,31,15,1,0,0,0,7,0,352,82,27857,31469,33990,2,49,11,0,0,0,0,1,357,105,26880,30339,31013,1,-5,-23,977,4,1130,2977,1,0,0,0,6
EUW1_6877916124',2,38,11,1,0,0,0,7,0,358,88,26423,29468,32562,5,26,15,1,0,2,0,4,400,83,30645,33757,33509,0,-42,5,-4222,-4,-4289,-947,0,0,-2,0,3
EUW1_6877899267',4,27,15,0,0,0,0,6,1,322,81,27670,27248,34721,6,25,14,2,0,0,0,0,299,78,25734,27415,35092,0,23,3,1936,1,-167,-371,-2,0,0,0,6
EUW1_6876435537',5,28,17,0,0,1,0,14,1,364,82,29218,30922,33308,1,29,8,2,0,1,0,5,384,79,27435,29187,30041,0,-20,3,1783,9,1735,3267,-2,0,0,0,9
EUW1_6876423527',3,24,12,2,1,1,0,8,1,307,86,25731,28507,30244,8,37,12,0,0,1,0,2,332,103,27542,28239,29581,0,-25,-17,-1811,0,268,663,2,1,0,0,6
EUW1_6876402290',7,155,11,1,0,0,0,8,0,343,62,26335,28503,28612,3,22,18,1,0,0,0,3,395,130,31708,32134,34367,0,-52,-68,-5373,-7,-3631,-5755,0,0,0,0,5
EUW1_6873810678',3,41,11,1,0,1,0,3,1,408,100,29352,31493,29424,3,98,3,1,0,0,0,9,331,84,21997,27677,29175,0,77,16,7355,8,3816,249,0,0,1,0,-6
EUW1_6872442009',6,40,7,0,0,0,0,8,0,334,90,24075,28938,24852,1,25,7,2,0,1,0,1,379,90,24781,28987,22268,0,-45,0,-706,0,-49,2584,-2,0,-1,0,7
EUW1_6867938468',6,50,20,2,0,0,0,11,1,391,115,32235,33089,39133,0,92,8,0,0,3,0,5,311,63,23669,26924,26851,1,80,52,8566,12,6165,12282,2,0,-3,0,6
EUW1_6867859976',4,43,14,1,0,2,0,7,1,309,110,29603,29050,40410,6,428,14,0,0,0,0,9,306,72,27746,26653,44524,1,3,38,1857,0,2397,-4114,1,0,2,0,-2
EUW1_6867818976',6,28,10,1,0,0,0,7,0,354,81,26083,28937,32285,7,26,6,1,1,1,0,2,363,85,24013,27123,24566,1,-9,-4,2070,4,1814,7719,0,-1,-1,0,5
EUW1_6866373790',2,24,9,1,0,1,0,6,1,402,106,27904,31888,29572,1,26,8,1,0,0,0,6,386,96,25799,30515,28118,1,16,10,2105,1,1373,1454,0,0,1,0,0
EUW1_6866321702',3,27,15,0,0,1,0,6,1,350,90,30051,29936,34027,2,28,10,1,0,0,0,5,333,86,26148,28970,28167,0,17,4,3903,5,966,5860,-1,0,1,0,1
EUW1_6883638980',6,27,10,1,1,3,0,5,0,372,97,28538,29810,26971,2,23,8,1,0,0,0,10,327,90,24587,27492,20017,1,45,7,3951,2,2318,6954,0,1,3,0,-5
EUW1_6883635586',3,16,19,1,1,2,0,6,1,352,96,30866,31506,45576,5,30,8,1,0,0,0,4,282,80,23860,25506,28693,1,70,16,7006,11,6000,16883,0,1,2,0,2
EUW1_6882827676',0,20,18,0,0,1,0,11,1,350,82,29978,29936,41840,1,24,14,1,0,2,0,4,372,118,29524,31170,33854,0,-22,-36,454,4,-1234,7986,-1,0,-1,0,7
EUW1_6882798877',4,27,18,2,0,0,0,7,0,421,92,31680,33915,37782,1,53,5,0,0,1,0,5,343,78,23589,27674,17564,1,78,14,8091,13,6241,20218,2,0,-1,0,2
EUW1_6882741922',3,28,7,2,0,0,0,8,1,380,98,25237,28557,27091,1,90,9,0,0,1,0,5,350,90,25280,28771,21569,1,30,8,-43,-2,-214,5522,2,0,-1,0,3
EUW1_6882702075',7,47,9,2,0,0,0,7,0,403,112,26950,32149,31479,2,22,10,0,0,1,0,2,402,91,27042,30193,31010,1,1,21,-92,-1,1956,469,2,0,-1,0,5
EUW1_6882672488',2,26,11,2,0,0,0,8,0,394,87,27708,30618,24426,5,35,9,0,1,1,0,3,356,106,25751,28123,24207,1,38,-19,1957,2,2495,219,2,-1,-1,0,5
EUW1_6882628354',3,31,11,1,0,0,0,8,1,366,102,27086,30974,32819,4,27,9,0,0,0,0,5,354,86,26247,30277,26607,1,12,16,839,2,697,6212,1,0,0,0,3
EUW1_6882607700',3,30,10,1,0,0,0,7,0,351,100,25888,29446,29195,2,26,11,0,0,0,0,1,399,82,27566,29984,30755,1,-48,18,-1678,-1,-538,-1560,1,0,0,0,6
EUW1_6871750399',6,69,13,1,0,0,0,7,1,397,115,28663,32156,28717,2,35,6,0,0,0,0,3,373,72,23939,28271,21332,1,24,43,4724,7,3885,7385,1,0,0,0,4
EUW1_6869782187',6,26,16,1,0,0,0,13,1,331,80,29182,29342,39813,7,30,9,1,0,2,0,3,350,107,26995,29048,32820,1,-19,-27,2187,7,294,6993,0,0,-2,0,10
EUW1_6869715641',3,20,16,2,0,1,0,8,1,377,104,30239,30644,38228,4,30,10,0,0,0,0,6,368,76,26152,28944,27848,1,9,28,4087,6,1700,10380,2,0,1,0,2
EUW1_6869644413',4,20,15,0,0,1,0,5,1,383,80,29952,30793,36118,2,99,9,1,0,0,0,5,346,112,25498,29589,30370,1,37,-32,4454,6,1204,5748,-1,0,1,0,0
EUW1_6869587158',1,28,7,0,0,0,0,8,0,389,98,24403,29407,25868,3,26,14,1,0,1,0,0,398,105,29398,30370,37460,0,-9,-7,-4995,-7,-963,-11592,-1,0,-1,0,8
EUW1_6869178986',7,28,15,1,0,0,0,11,0,336,82,28107,27668,37206,9,28,19,1,0,1,0,3,344,69,31228,30045,39095,0,-8,13,-3121,-4,-2377,-1889,0,0,-1,0,8
EUW1_6869127830',4,24,11,1,0,0,0,10,0,352,75,25076,27786,31829,4,44,18,1,0,2,0,2,382,110,30873,31709,34105,1,-30,-35,-5797,-7,-3923,-2276,0,0,-2,0,8
EUW1_6869098591',4,27,12,1,1,0,0,7,0,332,90,26789,30382,32877,3,29,10,1,0,0,0,2,384,98,27374,29914,33565,1,-52,-8,-585,2,468,-688,0,1,0,0,5
EUW1_6883765972',3,97,13,0,0,0,0,12,0,270,84,25362,27271,40758,8,29,13,2,0,3,0,0,371,103,30234,30706,38091,0,-101,-19,-4872,0,-3435,2667,-2,0,-3,0,12
EUW1_6883740320',3,23,5,2,0,0,0,11,1,388,84,23573,28428,24337,4,31,11,0,0,0,0,1,358,108,26360,31427,26168,1,30,-24,-2787,-6,-2999,-1831,2,0,0,0,10
EUW1_6883704219',3,26,8,0,1,0,0,7,0,332,91,25367,27010,28599,4,34,13,2,0,2,0,5,352,96,28376,28892,28734,0,-20,-5,-3009,-5,-1882,-135,-2,1,-2,0,2
EUW1_6883707825',6,34,13,1,0,0,0,13,0,327,93,26779,28421,25231,2,30,21,1,1,1,0,1,400,98,33566,33287,40125,0,-73,-5,-6787,-8,-4866,-14894,0,-1,-1,0,12
EUW1_6883673468',1,23,23,1,0,6,0,6,1,385,118,36044,32167,39882,1,19,4,0,0,0,0,9,279,76,20774,24452,25206,1,106,42,15270,19,7715,14676,1,0,6,0,-3
EUW1_6883637212',2,26,14,0,0,2,0,9,1,387,86,29120,30989,27636,3,20,10,2,0,1,0,3,364,94,26770,28699,22035,1,23,-8,2350,4,2290,5601,-2,0,1,0,6
EUW1_6882762107',3,24,16,0,0,1,0,12,1,383,90,30016,31442,44302,1,26,12,2,1,1,0,6,390,106,28660,30717,39139,0,-7,-16,1356,4,725,5163,-2,-1,0,0,6
EUW1_6882646944',3,27,22,1,0,2,0,6,1,360,95,31973,33341,41081,0,20,9,0,0,0,0,6,362,94,25943,27873,32576,1,-2,1,6030,13,5468,8505,1,0,2,0,0
EUW1_6882612952',1,40,14,1,0,1,0,17,0,344,86,29577,30531,33373,4,32,18,1,0,2,0,3,381,84,31719,31261,35846,0,-37,2,-2142,-4,-730,-2473,0,0,-1,0,14
EUW1_6882562709',6,27,13,0,0,1,0,12,1,379,65,27822,27655,32283,2,180,18,0,1,2,0,4,403,106,31907,32181,29969,1,-24,-41,-4085,-5,-4526,2314,0,-1,-1,0,8
EUW1_6882467703',4,25,10,0,0,1,0,9,0,373,84,27685,29402,38512,4,29,19,2,0,1,0,1,323,76,28365,29132,37100,1,50,8,-680,-9,270,1412,-2,0,0,0,8
EUW1_6882398543',6,26,19,0,0,1,0,15,1,304,96,32521,27246,41096,2,26,25,1,0,1,0,3,327,68,33174,27521,43990,1,-23,28,-653,-6,-275,-2894,-1,0,0,0,12
EUW1_6882346979',3,34,12,1,0,0,0,9,0,345,62,25975,28942,26522,3,29,13,0,0,1,0,1,359,106,27977,30571,29333,1,-14,-44,-2002,-1,-1629,-2811,1,0,-1,0,8
EUW1_6881395524',3,187,11,0,1,1,0,8,1,379,85,28039,29018,29394,2,34,9,2,0,0,0,4,350,90,24979,28363,26351,1,29,-5,3060,2,655,3043,-2,1,1,0,4
EUW1_6881317970',3,24,9,0,0,0,0,8,0,345,96,26845,28983,28864,3,118,17,1,0,3,0,6,396,72,30711,31754,43021,0,-51,24,-3866,-8,-2771,-14157,-1,0,-3,0,2
EUW1_6881075846',2,25,15,0,0,1,0,13,1,322,52,29089,26994,39839,7,30,20,0,0,2,0,5,374,81,31488,30657,35674,1,-52,-29,-2399,-5,-3663,4165,0,0,-1,0,8
EUW1_6882877315',8,41,20,1,0,1,0,2,1,375,84,30923,33187,31748,5,27,6,1,0,0,0,5,328,76,22293,26795,31525,1,47,8,8630,14,6392,223,0,0,1,0,-3
EUW1_6882833212',3,29,16,1,0,3,0,7,1,380,112,30759,31933,35546,5,33,7,1,0,0,0,8,326,76,23513,26091,23358,1,54,36,7246,9,5842,12188,0,0,3,0,-1
EUW1_6880758406',5,26,20,1,0,0,0,6,1,358,74,29760,32035,41176,1,21,11,0,0,0,0,4,372,66,26975,30424,40636,1,-14,8,2785,9,1611,540,1,0,0,0,2
EUW1_6880733177',3,28,7,0,1,0,0,7,0,355,90,24579,30035,24288,2,33,10,1,0,0,0,2,375,86,26256,30089,26266,0,-20,4,-1677,-3,-54,-1978,-1,1,0,0,5
EUW1_6880708216',3,25,8,0,0,1,0,11,0,323,116,24925,29474,17115,2,29,15,1,0,2,0,2,385,95,29776,32402,31270,0,-62,21,-4851,-7,-2928,-14155,-1,0,-1,0,9
EUW1_6880649747',3,28,6,0,0,0,0,12,0,330,71,24684,26196,27064,3,42,12,1,1,4,0,6,366,100,29194,30753,34728,0,-36,-29,-4510,-6,-4557,-7664,-1,-1,-4,0,6
EUW1_6880603867',5,26,12,0,1,0,0,8,0,319,91,27853,26576,27752,7,36,18,1,0,1,0,2,350,62,28866,28782,32823,0,-31,29,-1013,-6,-2206,-5071,-1,1,-1,0,6
EUW1_6880507819',3,241,4,0,0,0,0,6,0,379,89,22763,29343,12346,3,28,7,2,0,0,0,0,441,130,26613,32220,23044,0,-62,-41,-3850,-3,-2877,-10698,-2,0,0,0,6
EUW1_6880435872',2,30,10,0,0,0,0,5,1,397,85,26690,29474,25428,5,21,6,2,0,1,0,4,324,80,23376,28234,28049,1,73,5,3314,4,1240,-2621,-2,0,-1,0,1
EUW1_6877792769',3,346,14,2,0,0,0,9,0,314,101,26844,29932,36171,3,31,15,0,0,0,0,3,351,75,27881,27497,35056,1,-37,26,-1037,-1,2435,1115,2,0,0,0,6
EUW1_6877754736',4,30,11,1,0,0,0,10,0,369,92,26656,29868,34954,6,54,17,0,0,1,0,5,363,95,30473,31611,36694,0,6,-3,-3817,-6,-1743,-1740,1,0,-1,0,5
EUW1_6877697096',4,44,7,0,0,0,0,9,0,335,70,23746,26236,22896,7,31,9,2,1,1,0,0,410,123,27589,31455,23547,0,-75,-53,-3843,-2,-5219,-651,-2,-1,-1,0,9
EUW1_6877653437',3,25,17,1,0,0,0,11,0,394,105,30648,32132,38293,3,28,13,1,0,2,0,2,334,76,27491,28249,28129,1,60,29,3157,4,3883,10164,0,0,-2,0,9
EUW1_6877595117',2,58,11,1,0,0,0,10,0,345,92,26304,29560,28068,3,66,17,1,1,2,0,4,388,92,31585,32167,40759,1,-43,0,-5281,-6,-2607,-12691,0,-1,-2,0,6
EUW1_6875665301',4,27,16,1,0,0,0,6,0,302,79,28516,28126,36139,4,25,13,0,0,0,0,6,310,31,25853,26317,35829,1,-8,48,2663,3,1809,310,1,0,0,0,0
EUW1_6875599093',10,31,15,1,0,2,0,13,1,358,77,29851,29718,32052,3,23,6,0,0,2,0,10,367,107,26877,30019,23365,0,-9,-30,2974,9,-301,8687,1,0,0,0,3
EUW1_6875541125',4,25,9,1,0,1,0,4,0,380,90,27252,31382,25376,8,85,10,1,0,0,0,5,331,85,25284,28360,29893,1,49,5,1968,-1,3022,-4517,0,0,1,0,-1
EUW1_6875494339',5,34,11,0,0,3,0,5,1,373,112,28625,31286,30059,4,30,8,0,0,0,0,8,334,84,24964,27345,24426,1,39,28,3661,3,3941,5633,0,0,3,0,-3
EUW1_6870955588',1,22,4,0,0,0,0,14,0,344,91,22835,26887,19242,4,26,17,1,0,8,1,1,375,103,33257,32156,29651,0,-31,-12,-10422,-13,-5269,-10409,-1,0,-8,-1,13
EUW1_6867644833',2,23,10,0,0,1,0,10,0,401,100,27527,31543,29338,7,31,19,2,0,1,0,5,424,84,32342,33139,42959,0,-23,16,-4815,-9,-1596,-13621,-2,0,0,0,5
EUW1_6867635860',4,47,11,0,0,0,0,13,0,286,90,26439,28346,27728,1,24,23,2,0,2,0,1,383,117,32365,32733,39064,0,-97,-27,-5926,-12,-4387,-11336,-2,0,-2,0,12
EUW1_6863390350',4,31,11,2,0,1,0,8,1,369,111,29371,32166,33041,6,34,4,0,0,1,0,2,352,88,22824,26969,20068,1,17,23,6547,7,5197,12973,2,0,0,0,6
EUW1_6863374740',2,20,3,1,0,1,0,17,0,391,79,24561,29161,28364,4,33,23,0,1,5,0,1,427,107,34720,34595,41691,0,-36,-28,-10159,-20,-5434,-13327,1,-1,-4,0,16
EUW1_6863346275',2,179,7,0,0,0,0,10,0,364,100,25310,29424,23281,6,27,16,2,0,2,0,1,416,124,31746,33220,30552,0,-52,-24,-6436,-9,-3796,-7271,-2,0,-2,0,9
EUW1_6862179564',8,41,22,1,0,1,0,11,1,362,78,32289,31931,43444,2,224,7,1,0,1,0,5,356,90,26565,29155,29590,1,6,-12,5724,15,2776,13854,0,0,0,0,6
EUW1_6862065129',6,26,15,0,0,1,0,9,1,349,103,30252,30001,38088,5,29,10,2,0,0,0,7,337,80,26636,28595,31421,1,12,23,3616,5,1406,6667,-2,0,1,0,2
EUW1_6861473771',8,35,15,1,0,1,0,5,1,363,84,29003,30499,31362,5,44,11,0,0,0,0,4,366,78,27463,30817,34637,0,-3,6,1540,4,-318,-3275,1,0,1,0,1
EUW1_6861437508',4,34,22,1,0,1,0,9,1,306,82,30102,32189,40537,2,332,10,1,0,1,0,5,314,78,25105,26531,30549,1,-8,4,4997,12,5658,9988,0,0,0,0,4
EUW1_6861364486',8,36,12,0,0,0,0,10,0,355,85,27729,27949,29224,1,23,9,1,1,1,0,3,411,84,28077,29817,27288,0,-56,1,-348,3,-1868,1936,-1,-1,-1,0,7
EUW1_6861266971',1,35,8,2,0,1,0,11,0,381,116,27334,29802,31569,6,25,15,0,0,1,0,6,375,106,28389,31786,31044,0,6,10,-1055,-7,-1984,525,2,0,0,0,5
EUW1_6861193062',3,54,27,1,0,1,0,9,1,373,92,33942,32098,41503,2,50,9,0,0,2,0,5,331,67,26700,29075,30908,1,42,25,7242,18,3023,10595,1,0,-1,0,4
EUW1_6861158493',8,30,11,0,0,0,0,7,1,450,99,29376,31911,32962,7,37,7,2,0,1,0,4,333,114,24855,28865,22361,1,117,-15,4521,4,3046,10601,-2,0,-1,0,3
EUW1_6861116646',4,24,13,0,0,0,0,11,0,332,85,29349,27739,34332,7,86,23,2,0,2,0,4,303,80,32074,28363,38252,1,29,5,-2725,-10,-624,-3920,-2,0,-2,0,7
EUW1_6861072647',4,175,21,2,0,2,0,9,1,371,104,35578,31083,40476,3,116,8,0,0,1,0,8,342,72,24947,28081,22213,1,29,32,10631,13,3002,18263,2,0,1,0,1
EUW1_6861034845',4,23,11,1,0,1,0,4,1,391,108,28527,30893,37031,1,41,8,1,0,0,0,4,349,68,24184,27129,27512,1,42,40,4343,3,3764,9519,0,0,1,0,0
EUW1_6878315542',7,40,7,0,0,1,0,8,0,383,92,26826,28390,23500,11,47,11,2,0,1,0,6,351,88,26499,28895,28078,1,32,4,327,-4,-505,-4578,-2,0,0,0,2
EUW1_6869179600',2,23,16,2,0,0,0,10,1,337,102,30120,30117,33385,5,62,12,0,1,3,0,5,299,114,26919,29086,31790,0,38,-12,3201,4,1031,1595,2,-1,-3,0,5
EUW1_6860741726',1,23,15,1,0,1,0,7,1,356,103,29447,28336,34477,4,27,14,1,0,0,0,4,337,88,27684,28117,30724,0,19,15,1763,1,219,3753,0,0,1,0,3
EUW1_6860687339',0,59,4,0,0,0,0,5,1,396,99,24569,29809,21162,1,59,12,2,0,0,0,1,353,76,27285,29140,29427,0,43,23,-2716,-8,669,-8265,-2,0,0,0,4
EUW1_6855429420',7,29,14,1,0,0,0,9,0,345,87,28528,29073,29322,8,32,15,1,0,1,0,4,370,108,30159,30720,28843,1,-25,-21,-1631,-1,-1647,479,0,0,-1,0,5
EUW1_6855426799',4,32,19,2,0,1,0,17,0,335,94,30935,31624,29216,2,45,8,0,0,1,0,5,362,110,26366,28631,30431,1,-27,-16,4569,11,2993,-1215,2,0,0,0,12
EUW1_6853344200',3,24,5,0,1,0,0,9,0,347,102,24238,28082,17212,0,26,11,2,0,1,0,3,346,106,28710,29204,23312,0,1,-4,-4472,-6,-1122,-6100,-2,1,-1,0,6
EUW1_6852887037',2,64,15,2,0,0,0,7,0,308,80,27657,28713,32552,7,84,14,0,0,0,0,1,293,98,26948,27569,36032,1,15,-18,709,1,1144,-3480,2,0,0,0,6
EUW1_6852862966',0,23,10,0,0,1,0,15,0,319,106,28019,31069,30003,3,29,19,1,0,2,0,2,360,90,31207,30830,39845,0,-41,16,-3188,-9,239,-9842,-1,0,-1,0,13
EUW1_6852839190',3,70,15,2,0,1,0,7,1,342,90,29763,29306,36859,4,31,9,0,1,1,0,7,321,84,24956,28035,29393,1,21,6,4807,6,1271,7466,2,-1,0,0,0
EUW1_6852697823',4,34,8,1,1,2,0,2,1,403,112,28007,31019,20145,1,96,2,1,0,0,0,9,341,96,21996,25976,16324,1,62,16,6011,6,5043,3821,0,1,2,0,-7
EUW1_6852637173',6,28,21,2,1,1,0,12,0,348,105,31289,32079,35163,5,33,6,0,0,1,0,1,348,70,24649,26373,21846,1,0,35,6640,15,5706,13317,2,1,0,0,11
EUW1_6852474034',7,35,11,1,0,0,0,11,0,346,100,26400,30374,31731,2,23,12,1,0,2,0,1,365,88,27861,31820,28337,1,-19,12,-1461,-1,-1446,3394,0,0,-2,0,10
EUW1_6852420556',2,25,9,0,0,0,0,10,0,354,85,26572,27639,21833,2,137,14,2,0,0,0,4,362,114,29124,30840,34557,0,-8,-29,-2552,-5,-3201,-12724,-2,0,0,0,6
EUW1_6852296237',3,35,8,1,0,1,0,5,1,341,98,25694,29046,28127,2,21,6,1,0,0,0,1,349,90,23747,28191,31843,1,-8,8,1947,2,855,-3716,0,0,1,0,4
EUW1_6852241793',6,61,8,0,0,0,0,9,0,344,95,25139,29899,27283,2,55,9,2,0,0,0,3,365,103,25844,31924,29397,0,-21,-8,-705,-1,-2025,-2114,-2,0,0,0,6
EUW1_6851562057',4,50,18,1,0,3,0,5,0,397,91,32517,30898,33200,4,29,8,1,0,0,0,12,351,88,25639,27895,26927,1,46,3,6878,10,3003,6273,0,0,3,0,-7
EUW1_6883256310',5,36,10,1,0,1,0,8,0,337,72,26978,28358,31934,5,32,9,1,0,0,0,7,374,73,25562,27755,29751,0,-37,-1,1416,1,603,2183,0,0,1,0,1
EUW1_6883204100',3,31,5,1,0,1,0,8,1,347,108,24077,27462,23147,5,33,16,0,0,2,0,2,412,84,30305,31749,27329,0,-65,24,-6228,-11,-4287,-4182,1,0,-1,0,6
EUW1_6882958103',4,23,18,0,0,2,0,9,1,293,66,29893,26664,31878,2,27,15,1,0,2,0,8,325,101,29488,29385,36964,0,-32,-35,405,3,-2721,-5086,-1,0,0,0,1
EUW1_6882115880',3,26,13,0,0,1,0,13,0,369,84,29529,29255,31603,3,31,20,1,0,0,0,3,404,92,31792,31827,31129,1,-35,-8,-2263,-7,-2572,474,-1,0,1,0,10
EUW1_6878029197',4,32,13,1,0,0,0,10,0,367,76,27567,29727,33686,5,42,14,1,0,0,0,3,356,95,28203,29757,31044,1,11,-19,-636,-1,-30,2642,0,0,0,0,7
EUW1_6877994203',6,31,13,0,0,1,0,9,1,358,90,27834,29750,27508,9,41,10,1,0,1,0,4,356,89,26096,29361,34504,0,2,1,1738,3,389,-6996,-1,0,0,0,5
EUW1_6877985456',4,34,22,2,0,1,0,10,1,401,84,33744,32733,45686,3,23,12,0,0,0,0,6,352,83,27764,28710,34224,1,49,1,5980,10,4023,11462,2,0,1,0,4
EUW1_6877483755',5,67,16,0,0,0,0,3,0,320,91,28382,29725,44092,3,32,12,0,0,0,0,4,342,64,26882,30169,40550,0,-22,27,1500,4,-444,3542,0,0,0,0,-1
EUW1_6877443817',3,256,12,0,0,0,0,13,0,312,82,26259,27630,29749,1,41,22,1,0,2,0,3,359,87,31841,30000,47530,0,-47,-5,-5582,-10,-2370,-17781,-1,0,-2,0,10
EUW1_6874153585',3,19,22,1,1,2,0,4,1,429,86,32634,31599,38037,5,33,5,0,0,0,0,9,311,85,21960,24319,31687,1,118,1,10674,17,7280,6350,1,1,2,0,-5
EUW1_6874088068',5,47,16,0,0,1,0,7,0,398,95,30471,31848,32449,4,30,9,1,0,1,0,4,371,87,25852,28300,26030,1,27,8,4619,7,3548,6419,-1,0,0,0,3
EUW1_6873916619',5,29,12,0,0,0,0,3,0,434,88,27593,31862,31065,3,27,9,1,0,0,0,2,369,108,24985,29105,28803,1,65,-20,2608,3,2757,2262,-1,0,0,0,1
EUW1_6873879424',3,24,10,1,0,0,0,8,1,361,90,26086,28383,32186,7,130,9,0,0,0,0,3,337,73,25793,28550,29920,0,24,17,293,1,-167,2266,1,0,0,0,5
EUW1_6873647625',3,32,3,0,0,0,0,10,1,358,81,23012,26569,14407,1,33,9,2,0,2,0,4,384,97,26940,31526,29779,0,-26,-16,-3928,-6,-4957,-15372,-2,0,-2,0,6
EUW1_6873570298',2,28,11,0,0,1,0,16,0,386,83,28404,29869,29301,3,34,14,2,0,2,0,5,379,76,30056,30787,34678,0,7,7,-1652,-3,-918,-5377,-2,0,-1,0,11
EUW1_6873471604',5,34,11,0,0,0,0,13,0,339,76,26138,27052,34919,1,25,17,2,0,1,0,2,386,84,30938,30062,38759,0,-47,-8,-4800,-6,-3010,-3840,-2,0,-1,0,11
EUW1_6873372024',4,27,13,1,0,1,0,5,1,384,82,28933,28421,29456,3,33,10,0,0,1,0,10,359,104,26545,29870,26617,0,25,-22,2388,3,-1449,2839,1,0,0,0,-5
EUW1_6873159708',2,27,11,0,0,0,0,13,1,327,80,26801,26645,42896,4,23,28,1,0,1,0,1,381,74,34023,32839,46610,0,-54,6,-7222,-17,-6194,-3714,-1,0,-1,0,12
EUW1_6873082065',1,31,21,0,0,2,0,7,1,386,114,35490,32431,44425,3,32,11,1,0,1,0,10,303,98,25695,28924,31471,1,83,16,9795,10,3507,12954,-1,0,1,0,-3
EUW1_6873010296',2,26,10,1,0,0,0,8,1,366,78,26223,29345,28924,6,33,12,0,0,1,0,2,355,102,28499,30536,32263,1,11,-24,-2276,-2,-1191,-3339,1,0,-1,0,6
EUW1_6883654118',4,35,14,2,0,0,0,8,1,444,121,30845,34666,35048,2,38,4,0,0,0,0,2,354,80,23104,27538,25022,1,90,41,7741,10,7128,10026,2,0,0,0,6
EUW1_6882853786',1,22,2,0,0,0,0,6,0,364,110,23064,29524,20065,1,30,11,2,0,1,0,2,423,98,28390,32979,32202,0,-59,12,-5326,-9,-3455,-12137,-2,0,-1,0,4
EUW1_6882585619',6,33,17,2,0,0,0,8,1,323,88,29176,30576,47271,1,21,8,0,0,2,0,5,324,59,25193,28755,25549,1,-1,29,3983,9,1821,21722,2,0,-2,0,3
EUW1_6882524902',7,57,11,2,0,0,0,7,0,336,92,27252,28967,28118,6,39,6,0,0,2,0,4,366,91,25608,28664,27546,0,-30,1,1644,5,303,572,2,0,-2,0,3
EUW1_6882490607',5,97,13,0,0,0,0,8,1,328,80,26476,26476,34583,2,45,14,2,0,0,0,2,343,84,27795,29980,38413,0,-15,-4,-1319,-1,-3504,-3830,-2,0,0,0,6
EUW1_6881992451',1,291,15,1,0,0,0,9,0,361,96,31307,31123,30831,2,28,17,0,1,1,0,5,356,91,29072,30836,30153,0,5,5,2235,-2,287,678,1,-1,-1,0,4
EUW1_6881881740',2,37,6,0,0,1,0,5,0,396,77,25646,28391,27582,2,26,13,1,0,1,0,4,339,82,27662,30583,32213,0,57,-5,-2016,-7,-2192,-4631,-1,0,0,0,1
EUW1_6881518659',6,32,17,1,0,1,0,13,1,379,79,30768,31729,35837,3,28,9,1,1,3,0,4,388,93,28370,29979,27943,0,-9,-14,2398,8,1750,7894,0,-1,-2,0,9
EUW1_6880769202',3,35,19,1,0,2,0,6,1,402,111,30816,32625,38301,4,31,11,1,0,0,0,6,334,100,27431,27875,33154,1,68,11,3385,8,4750,5147,0,0,2,0,0
EUW1_6880765563',2,26,12,0,0,0,0,12,0,342,76,26732,27521,29507,5,30,19,1,0,0,0,2,390,103,30083,34065,40092,0,-48,-27,-3351,-7,-6544,-10585,-1,0,0,0,10
EUW1_6872653315',2,130,12,0,0,0,0,12,1,313,90,26373,25992,32586,5,35,17,1,0,1,0,2,313,82,29036,27973,32029,1,0,8,-2663,-5,-1981,557,-1,0,-1,0,10
EUW1_6858139469',7,30,16,2,1,2,0,6,0,361,98,32410,30394,34073,7,33,7,0,0,1,0,8,371,94,25908,27698,23804,1,-10,4,6502,9,2696,10269,2,1,1,0,-2
EUW1_6857171321',2,30,16,1,0,2,0,14,0,400,82,31748,30631,37728,3,29,12,1,0,2,0,3,351,93,27853,30033,29239,0,49,-11,3895,4,598,8489,0,0,0,0,11
EUW1_6857126796',5,27,16,0,1,1,0,9,0,354,94,29730,31171,42438,1,78,13,1,0,0,0,1,324,69,26897,27398,35339,1,30,25,2833,3,3773,7099,-1,1,1,0,8
EUW1_6855782382',1,28,8,0,0,0,0,13,0,313,78,25465,27162,22176,1,19,27,2,1,2,0,3,414,109,35967,33972,50270,0,-101,-31,-10502,-19,-6810,-28094,-2,-1,-2,0,10
EUW1_6855752212',3,22,17,1,0,1,0,8,1,368,112,30298,31454,33541,2,32,12,0,0,1,0,8,350,86,27494,29755,36276,1,18,26,2804,5,1699,-2735,1,0,0,0,0
EUW1_6855725089',4,33,8,0,0,1,0,6,1,368,87,26818,30020,33943,3,32,14,2,0,1,0,6,379,103,29293,29759,31656,0,-11,-16,-2475,-6,261,2287,-2,0,0,0,0
EUW1_6855699709',5,27,9,0,0,0,0,9,0,343,74,25181,28644,27117,2,33,19,2,0,0,0,4,356,130,30482,34965,36042,0,-13,-56,-5301,-10,-6321,-8925,-2,0,0,0,5
EUW1_6855669492',2,32,8,1,0,0,0,5,0,359,116,25775,30167,39464,3,37,16,1,0,1,0,2,353,89,29194,31664,40975,0,6,27,-3419,-8,-1497,-1511,0,0,-1,0,3
EUW1_6855481601',5,26,7,0,0,0,0,11,0,349,95,24579,28109,29500,5,26,14,0,0,1,0,1,315,100,28461,30223,31311,0,34,-5,-3882,-7,-2114,-1811,0,0,-1,0,10
EUW1_6855462263',5,27,17,0,1,1,0,9,1,303,84,28714,28991,38566,3,25,16,1,0,1,0,9,324,96,29177,28951,35370,1,-21,-12,-463,1,40,3196,-1,1,0,0,0
EUW1_6855463487',1,21,22,1,0,1,0,9,1,360,113,31459,31868,39284,2,32,9,0,0,0,0,5,329,68,25640,28197,34015,1,31,45,5819,13,3671,5269,1,0,1,0,4
EUW1_6855449897',3,30,22,2,1,1,0,11,1,361,91,31554,30736,37073,2,22,6,0,0,1,0,5,351,85,23656,26496,23633,1,10,6,7898,16,4240,13440,2,1,0,0,6
EUW1_6855415324',6,32,13,1,0,0,0,10,1,339,96,27786,29295,27891,3,39,12,0,1,0,0,0,365,95,26741,28715,34556,0,-26,1,1045,1,580,-6665,1,-1,0,0,10
EUW1_6854398754',2,29,8,0,0,0,0,10,0,320,80,24260,26800,26623,3,74,16,1,0,2,0,0,362,97,30368,29671,41289,0,-42,-17,-6108,-8,-2871,-14666,-1,0,-2,0,10
EUW1_6854371939',2,41,8,1,0,0,0,6,0,368,94,26229,29987,24360,5,38,14,0,0,1,0,5,366,105,29515,30576,31982,0,2,-11,-3286,-6,-589,-7622,1,0,-1,0,1
EUW1_6854345358',3,34,15,2,1,1,0,8,1,358,101,29654,33234,34810,3,29,9,0,0,0,0,3,400,81,26276,32859,33076,1,-42,20,3378,6,375,1734,2,1,1,0,5
EUW1_6851621128',4,31,18,1,1,0,0,7,0,333,108,31681,31584,38719,5,29,17,0,0,1,0,5,331,82,28941,27799,34225,1,2,26,2740,1,3785,4494,1,1,-1,0,2
EUW1_6851604240',4,27,13,0,0,1,0,9,0,348,84,28369,29970,36872,5,31,12,2,0,0,0,1,327,83,25911,29087,32055,0,21,1,2458,1,883,4817,-2,0,1,0,8
EUW1_6851591909',2,34,12,0,0,0,0,7,0,347,78,27183,28283,32611,3,26,13,2,0,0,0,1,347,113,28173,31587,35993,0,0,-35,-990,-1,-3304,-3382,-2,0,0,0,6
EUW1_6883648760',2,23,12,0,0,1,0,8,1,361,74,28067,29410,30283,7,38,13,1,0,1,0,5,390,98,28704,31062,33829,0,-29,-24,-637,-1,-1652,-3546,-1,0,0,0,3
EUW1_6883608771',1,30,15,0,0,0,0,10,1,332,88,28593,29623,40031,6,30,21,0,0,3,0,5,353,79,31570,31594,36842,1,-21,9,-2977,-6,-1971,3189,0,0,-3,0,5
EUW1_6883579906',6,72,6,1,0,0,0,4,1,402,108,26136,30774,22650,5,64,5,1,0,0,0,3,422,88,25210,29365,19514,1,-20,20,926,1,1409,3136,0,0,0,0,1
EUW1_6883553997',3,29,15,1,0,2,0,5,1,431,103,31461,32954,31263,4,47,9,0,0,0,0,3,394,75,26168,29819,29587,1,37,28,5293,6,3135,1676,1,0,2,0,2
EUW1_6883526681',2,24,11,2,1,0,0,11,0,357,102,27434,31227,28847,3,25,9,0,0,0,0,1,376,86,27257,29528,30660,1,-19,16,177,2,1699,-1813,2,1,0,0,10
EUW1_6883479931',4,43,14,0,1,0,0,5,1,339,114,28612,32137,34666,3,28,6,1,0,1,0,5,360,90,23745,28313,31611,1,-21,24,4867,8,3824,3055,-1,1,-1,0,0
EUW1_6882214276',2,35,14,0,1,0,0,12,1,346,108,28922,32696,32654,5,26,16,2,0,2,0,5,378,80,29765,30065,33221,0,-32,28,-843,-2,2631,-567,-2,1,-2,0,7
EUW1_6881575703',3,31,9,1,0,1,0,8,0,391,102,27058,29178,28633,1,21,14,0,0,0,0,1,324,65,26781,26954,31105,0,67,37,277,-5,2224,-2472,1,0,1,0,7
EUW1_6881470767',2,23,8,1,0,0,0,8,0,412,98,26385,30432,25159,4,26,7,1,0,1,0,1,413,106,26400,29678,24932,0,-1,-8,-15,1,754,227,0,0,-1,0,7
EUW1_6881405012',3,22,14,1,0,1,0,9,1,377,100,29795,30254,35726,5,29,19,0,0,0,0,4,355,103,30201,32282,39119,0,22,-3,-406,-5,-2028,-3393,1,0,1,0,5
EUW1_6880661472',1,27,4,0,0,0,0,16,1,239,60,20998,20976,22529,7,29,21,1,0,9,2,1,406,93,35961,31178,38168,0,-167,-33,-14963,-17,-10202,-15639,-1,0,-9,-2,15
EUW1_6880613908',4,28,20,2,0,0,0,13,1,362,108,30663,31727,35879,4,29,11,0,0,3,0,4,349,60,26429,29254,27656,1,13,48,4234,9,2473,8223,2,0,-3,0,9
EUW1_6880575467',1,19,15,1,1,1,0,6,1,355,75,28504,29036,35627,5,61,13,0,0,0,0,1,363,94,27916,28624,29501,0,-8,-19,588,2,412,6126,1,1,1,0,5
EUW1_6880524499',3,33,11,1,0,0,0,13,0,313,84,26047,28069,27236,4,26,16,1,0,3,0,1,353,104,31581,31397,29222,0,-40,-20,-5534,-5,-3328,-1986,0,0,-3,0,12
EUW1_6880452305',3,25,9,0,0,1,0,6,0,360,92,27199,29953,33232,2,30,8,2,0,0,0,5,392,96,25327,30344,27238,1,-32,-4,1872,1,-391,5994,-2,0,1,0,1
EUW1_6880402739',5,29,3,0,0,1,0,11,1,420,98,25286,29085,21817,5,31,11,2,0,2,0,3,417,106,28728,31680,27053,0,3,-8,-3442,-8,-2595,-5236,-2,0,-1,0,8
EUW1_6878784107',5,30,18,0,0,1,0,4,0,363,94,32532,31318,40723,3,24,15,1,0,1,0,8,355,80,28711,29717,34321,0,8,14,3821,3,1601,6402,-1,0,0,0,-4
EUW1_6857934647',0,16,6,0,0,0,0,8,0,329,66,22163,26925,22496,2,32,20,2,0,1,0,0,378,113,31804,33324,38743,0,-49,-47,-9641,-14,-6399,-16247,-2,0,-1,0,8
EUW1_6855449485',0,24,10,1,0,0,0,7,1,392,120,28413,32714,32365,4,23,11,1,0,1,0,6,374,95,26570,30842,35377,1,18,25,1843,-1,1872,-3012,0,0,-1,0,1
EUW1_6855404715',3,24,15,1,0,1,0,6,1,408,86,29864,31112,31711,3,22,11,0,0,0,0,5,365,76,26186,29017,28886,1,43,10,3678,4,2095,2825,1,0,1,0,1
EUW1_6855379975',3,30,10,1,0,1,0,9,1,379,76,27976,29177,26826,5,32,9,0,0,1,0,4,330,86,25886,27381,28839,1,49,-10,2090,1,1796,-2013,1,0,0,0,5
EUW1_6847762236',3,27,9,0,0,0,0,6,0,389,97,26563,31697,34077,5,24,10,2,0,0,0,5,364,92,26172,30047,29086,0,25,5,391,-1,1650,4991,-2,0,0,0,1
EUW1_6847719975',5,28,13,1,0,0,0,7,1,402,88,28998,30896,35063,4,35,14,1,0,1,0,0,360,80,27357,28469,33186,1,42,8,1641,-1,2427,1877,0,0,-1,0,7
EUW1_6847670850',4,25,18,0,0,1,0,9,1,336,71,30032,28327,35960,3,44,18,2,0,0,0,2,364,102,30458,29377,39657,0,-28,-31,-426,0,-1050,-3697,-2,0,1,0,7
EUW1_6847222400',3,28,19,2,1,2,0,9,1,378,96,33659,31202,39350,5,31,13,0,0,1,0,6,277,94,26253,27582,31068,1,101,2,7406,6,3620,8282,2,1,1,0,3
EUW1_6847207032',4,31,11,0,0,0,0,6,1,338,69,25955,27987,27577,6,32,5,2,0,0,0,2,362,77,23908,27243,27751,1,-24,-8,2047,6,744,-174,-2,0,0,0,4
EUW1_6847194050',3,29,18,0,0,1,0,8,0,350,70,29998,28394,35048,1,23,18,1,0,0,0,5,305,69,28084,29515,37325,0,45,1,1914,0,-1121,-2277,-1,0,1,0,3
EUW1_6847180731',1,276,12,1,0,1,0,9,1,389,98,30130,31035,34698,2,26,16,0,0,1,0,5,361,85,28459,30369,32021,1,28,13,1671,-4,666,2677,1,0,0,0,4
EUW1_6847154286',3,28,24,1,0,2,0,6,1,358,93,34198,32857,41649,4,27,10,0,0,0,0,6,313,82,26017,26804,31485,1,45,11,8181,14,6053,10164,1,0,2,0,0
EUW1_6847123105',1,55,7,0,0,0,0,7,0,339,74,24618,27954,29170,2,60,16,2,0,1,0,4,374,100,29680,31680,41370,0,-35,-26,-5062,-9,-3726,-12200,-2,0,-1,0,3
EUW1_6847094232',4,27,7,0,0,1,0,9,1,330,84,24191,27754,24012,5,28,12,2,0,1,0,5,363,91,27197,27664,28661,0,-33,-7,-3006,-5,90,-4649,-2,0,0,0,4
EUW1_6847035699',6,41,10,1,0,0,0,13,1,382,78,27598,29893,30553,5,28,12,1,0,2,0,4,368,86,28944,28771,31848,1,14,-8,-1346,-2,1122,-1295,0,0,-2,0,9
EUW1_6846552200',2,29,10,0,0,2,0,6,1,350,68,27533,27585,25869,1,76,9,2,0,0,0,8,349,91,25183,27947,28364,0,1,-23,2350,1,-362,-2495,-2,0,2,0,-2
EUW1_6846506164',4,25,15,0,0,1,0,11,1,356,72,28690,29456,34581,4,75,18,1,0,2,0,2,374,80,30877,31025,35565,0,-18,-8,-2187,-3,-1569,-984,-1,0,-1,0,9
EUW1_6843507609',3,60,15,2,0,2,0,8,0,336,104,29310,29591,34116,6,28,13,0,0,0,0,8,260,82,26731,26451,30065,1,76,22,2579,2,3140,4051,2,0,2,0,0
EUW1_6843482507',5,18,18,1,0,2,0,13,1,345,74,32044,28832,40179,2,49,16,1,0,2,0,10,284,76,29507,27362,42034,0,61,-2,2537,2,1470,-1855,0,0,0,0,3
EUW1_6860830655',5,40,19,1,0,0,0,7,1,351,70,31147,28310,35602,6,28,15,0,0,2,0,6,314,85,27876,26395,28689,1,37,-15,3271,4,1915,6913,1,0,-2,0,1
EUW1_6860753212',2,19,6,0,0,1,0,4,0,355,87,24268,27539,28168,1,22,12,1,0,0,0,3,344,84,25930,30659,37682,0,11,3,-1662,-6,-3120,-9514,-1,0,1,0,1
EUW1_6859215210',6,32,12,1,0,2,0,10,0,338,82,28521,29177,39661,5,21,16,1,0,2,0,8,344,98,30301,30549,33584,1,-6,-16,-1780,-4,-1372,6077,0,0,0,0,2
EUW1_6858120206',6,38,20,0,1,3,0,11,0,344,104,34076,30006,51315,3,23,21,1,0,1,0,8,303,71,30969,26478,41970,1,41,33,3107,-1,3528,9345,-1,1,2,0,3
EUW1_6858090221',3,31,7,0,0,1,0,8,1,348,80,25934,28600,25267,10,71,9,1,0,1,0,2,384,78,25590,29124,24253,1,-36,2,344,-2,-524,1014,-1,0,0,0,6
EUW1_6857973377',2,19,15,1,0,0,0,6,1,342,83,29368,29179,36556,3,45,14,1,0,0,0,5,352,89,27270,29136,28870,1,-10,-6,2098,1,43,7686,0,0,0,0,1
EUW1_6855474979',1,21,7,1,0,0,0,9,0,287,58,22362,26517,22477,2,24,18,1,0,1,0,0,343,142,31014,32862,32625,0,-56,-84,-8652,-11,-6345,-10148,0,0,-1,0,9
EUW1_6855447971',2,22,16,2,0,0,0,12,0,338,98,29460,32101,40290,6,31,18,0,0,1,0,1,381,114,31767,31148,45470,0,-43,-16,-2307,-2,953,-5180,2,0,-1,0,11
EUW1_6855375319',1,27,13,1,0,0,0,11,0,349,76,27647,28777,28287,11,30,23,1,0,0,0,1,371,91,31514,32529,44023,0,-22,-15,-3867,-10,-3752,-15736,0,0,0,0,10
EUW1_6883428906',5,24,12,2,0,0,0,5,0,388,120,28615,32684,33305,3,24,9,0,0,0,0,6,386,84,25067,28810,22295,1,2,36,3548,3,3874,11010,2,0,0,0,-1
EUW1_6883383084',3,38,18,1,0,1,0,8,0,358,94,29522,29902,34860,1,21,9,1,0,0,0,9,323,78,24741,26532,26489,1,35,16,4781,9,3370,8371,0,0,1,0,-1
EUW1_6883198650',4,22,11,0,0,1,0,8,1,358,68,27393,28271,40213,3,26,15,1,0,0,0,8,344,100,28490,29451,31983,0,14,-32,-1097,-4,-1180,8230,-1,0,1,0,0
EUW1_6883132081',2,27,7,1,0,0,0,5,1,388,95,25434,29856,25256,2,92,6,1,0,0,0,2,377,84,24529,28711,23416,0,11,11,905,1,1145,1840,0,0,0,0,3
EUW1_6882373941',6,25,19,1,0,2,0,4,1,391,103,32363,32715,33637,3,33,7,1,0,0,0,8,313,75,23920,25342,28174,1,78,28,8443,12,7373,5463,0,0,2,0,-4
EUW1_6882341672',2,24,15,1,0,0,0,9,0,316,74,27458,30279,35968,3,22,17,1,0,1,0,0,363,103,30048,31355,38860,1,-47,-29,-2590,-2,-1076,-2892,0,0,-1,0,9
EUW1_6882331545',3,53,11,0,0,0,0,9,1,325,70,26676,25940,29878,2,28,13,2,0,2,0,5,324,87,28319,27879,32092,0,1,-17,-1643,-2,-1939,-2214,-2,0,-2,0,4
EUW1_6882314964',3,23,15,0,0,2,0,6,0,398,107,31146,31270,31579,1,25,12,1,0,0,0,7,309,60,26836,28194,26924,1,89,47,4310,3,3076,4655,-1,0,2,0,-1
EUW1_6882306761',3,23,6,0,1,0,0,12,0,292,108,24113,28203,23161,4,110,17,2,0,3,0,3,388,75,29949,30338,32540,0,-96,33,-5836,-11,-2135,-9379,-2,1,-3,0,9
EUW1_6882075052',5,27,6,0,0,0,0,13,0,302,76,22536,23616,26377,3,36,25,2,1,2,0,1,359,128,34084,34440,39826,0,-57,-52,-11548,-19,-10824,-13449,-2,-1,-2,0,12
EUW1_6845917992',2,25,22,0,1,1,0,11,1,325,78,32399,29817,41717,3,28,14,2,0,0,0,2,311,100,28558,28127,35645,1,14,-22,3841,8,1690,6072,-2,1,1,0,9
EUW1_6837827065',8,26,22,1,0,2,0,9,1,352,111,34552,29419,35067,7,44,13,1,0,1,0,10,288,80,27588,26875,38003,1,64,31,6964,9,2544,-2936,0,0,1,0,-1
EUW1_6809369914',6,48,26,1,0,1,0,7,1,340,97,33572,30855,48300,5,21,12,1,0,0,0,8,281,66,25303,25824,35746,1,59,31,8269,14,5031,12554,0,0,1,0,-1
EUW1_6807869936',1,18,13,0,0,0,0,19,0,335,61,27045,27849,28931,1,29,24,2,0,3,0,0,413,132,35967,33632,43669,0,-78,-71,-8922,-11,-5783,-14738,-2,0,-3,0,19
EUW1_6807794302',3,24,10,0,0,0,0,11,1,346,86,26153,27246,32652,2,27,10,1,0,1,0,2,346,80,26802,28009,35405,0,0,6,-649,0,-763,-2753,-1,0,-1,0,9
EUW1_6762860827',4,64,16,1,0,1,0,7,1,350,86,30241,28652,35829,3,28,13,0,0,0,0,4,305,62,25358,25867,25750,1,45,24,4883,3,2785,10079,1,0,1,0,3
EUW1_6762797107',2,26,9,0,0,0,0,10,1,334,93,26772,26636,23865,5,25,18,0,0,1,0,2,370,82,30960,30466,32511,0,-36,11,-4188,-9,-3830,-8646,0,0,-1,0,8
EUW1_6762704275',4,27,12,0,0,1,0,11,1,330,54,27097,26666,32061,3,35,18,2,0,1,0,2,318,60,30648,27928,32859,1,12,-6,-3551,-6,-1262,-798,-2,0,0,0,9
EUW1_6762620276',1,27,8,0,0,0,0,14,0,340,78,26475,26695,29158,4,32,21,2,0,3,0,3,300,102,31321,29766,39723,0,40,-24,-4846,-13,-3071,-10565,-2,0,-3,0,11
EUW1_6762527190',2,24,13,0,0,0,0,7,1,391,96,28907,30911,28769,3,89,8,1,0,1,0,2,353,102,25766,29250,26340,0,38,-6,3141,5,1661,2429,-1,0,-1,0,5
EUW1_6762383534',2,25,12,1,0,0,0,13,0,287,92,26537,26706,32801,7,28,23,0,1,2,0,1,380,119,35911,34550,42864,0,-93,-27,-9374,-11,-7844,-10063,1,-1,-2,0,12
EUW1_6762318390',3,23,17,1,0,2,0,6,1,380,97,32837,32373,43100,6,39,7,0,0,2,0,9,273,94,23794,26766,19170,1,107,3,9043,10,5607,23930,1,0,0,0,-3
EUW1_6734048411',4,21,22,1,1,4,0,7,1,374,80,34081,31382,41070,1,16,5,0,0,1,0,9,276,76,21274,23787,23760,1,98,4,12807,17,7595,17310,1,1,3,0,-2
EUW1_6724566773',6,31,11,1,0,0,0,15,0,322,88,26955,28221,34141,3,31,20,0,1,3,0,4,348,80,31247,30003,41483,0,-26,8,-4292,-9,-1782,-7342,1,-1,-3,0,11
EUW1_6724507101',3,73,11,0,0,1,0,10,0,398,43,26279,29026,26291,8,34,24,1,1,3,0,6,357,112,33557,31042,38180,0,41,-69,-7278,-13,-2016,-11889,-1,-1,-2,0,4
EUW1_6724438945',5,25,20,1,1,2,0,4,1,355,95,31669,31595,39869,4,23,5,1,0,1,0,8,267,73,21746,25185,30969,1,88,22,9923,15,6410,8900,0,1,1,0,-4
EUW1_6724384729',2,24,17,1,0,2,0,8,1,317,64,29351,28260,38463,5,31,10,0,1,1,0,6,300,96,27333,29183,33831,1,17,-32,2018,7,-923,4632,1,-1,1,0,2
EUW1_6635867228',5,39,9,0,1,0,0,16,0,334,96,25234,29482,25810,6,79,14,2,0,3,0,3,408,74,29862,31272,30439,0,-74,22,-4628,-5,-1790,-4629,-2,1,-3,0,13
EUW1_6534763982',4,30,17,1,1,2,0,8,1,426,86,34313,31239,31820,4,28,14,0,0,0,0,9,311,60,27141,27540,23685,1,115,26,7172,3,3699,8135,1,1,2,0,-1
EUW1_6865540514',8,31,16,1,0,2,0,6,1,394,112,30636,31958,34467,7,25,10,1,0,0,0,6,354,108,25990,31612,27115,1,40,4,4646,6,346,7352,0,0,2,0,0
EUW1_6865471687',4,210,19,2,0,1,0,9,0,338,58,30031,27842,39537,0,70,14,0,0,1,0,6,322,108,29086,28447,35803,1,16,-50,945,5,-605,3734,2,0,0,0,3
EUW1_6864218830',9,27,22,0,0,0,0,11,1,347,92,31841,31832,39575,2,27,18,1,0,2,0,2,335,99,30559,30402,43583,1,12,-7,1282,4,1430,-4008,-1,0,-2,0,9
EUW1_6863031586',3,29,14,1,0,0,0,11,0,375,90,28592,30436,31804,3,141,16,0,0,0,0,4,376,81,29147,31175,38505,0,-1,9,-555,-2,-739,-6701,1,0,0,0,7
EUW1_6862619356',3,18,14,0,1,0,0,4,1,332,92,27505,30024,29322,5,32,13,2,0,0,0,2,319,96,25566,27839,28980,0,13,-4,1939,1,2185,342,-2,1,0,0,2
EUW1_6862531247',3,24,11,1,1,1,0,10,1,340,100,27293,26882,34838,2,28,14,1,0,0,0,2,333,106,28213,29049,31711,1,7,-6,-920,-3,-2167,3127,0,1,1,0,8
EUW1_6861801482',4,26,7,0,1,0,0,9,0,342,86,25382,27103,24758,4,36,16,2,0,2,0,1,409,98,31917,32465,40120,0,-67,-12,-6535,-9,-5362,-15362,-2,1,-2,0,8
EUW1_6861492560',2,36,13,1,0,0,0,2,1,373,92,28072,30584,33716,2,21,7,1,1,0,0,5,370,76,25073,29150,29594,1,3,16,2999,6,1434,4122,0,-1,0,0,-3
EUW1_6861429909',3,24,8,0,0,1,0,11,1,346,92,25764,26578,24606,5,78,17,1,0,1,0,4,338,100,29299,30513,32299,0,8,-8,-3535,-9,-3935,-7693,-1,0,0,0,7
EUW1_6861320812',3,54,14,0,0,0,0,15,1,348,84,28007,29086,31390,3,39,20,2,1,3,0,1,356,84,33288,31707,44518,0,-8,0,-5281,-6,-2621,-13128,-2,-1,-3,0,14
EUW1_6861275510',5,22,12,0,0,1,0,5,1,347,68,27648,29614,33019,2,24,13,1,1,0,0,3,347,108,27688,30076,29320,0,0,-40,-40,-1,-462,3699,-1,-1,1,0,2
EUW1_6861220088',3,22,11,0,0,0,0,13,1,341,106,27463,30557,28557,4,32,6,2,0,2,0,1,337,88,24446,27414,25199,1,4,18,3017,5,3143,3358,-2,0,-2,0,12
EUW1_6860769274',4,32,22,1,0,0,0,8,0,379,102,32863,32593,44209,3,23,11,0,0,1,0,8,305,86,25731,27738,28445,1,74,16,7132,11,4855,15764,1,0,-1,0,0
EUW1_6860756221',2,28,11,1,0,0,0,8,1,377,115,27789,30963,26545,3,26,3,0,0,1,0,6,347,85,23004,27300,18492,1,30,30,4785,8,3663,8053,1,0,-1,0,2
EUW1_6860754742',1,60,7,0,0,0,0,14,0,302,75,23469,25869,32008,7,31,18,2,0,2,0,2,388,110,33543,30891,43392,0,-86,-35,-10074,-11,-5022,-11384,-2,0,-2,0,12
EUW1_6860737140',4,26,12,0,0,0,0,9,0,268,88,27922,27615,34470,3,26,24,1,0,2,0,1,379,91,33086,31866,49269,0,-111,-3,-5164,-12,-4251,-14799,-1,0,-2,0,8
EUW1_6860728174',6,29,1,0,0,0,0,10,0,357,64,20853,24650,16066,7,30,17,1,0,3,0,2,371,116,32135,31459,33182,0,-14,-52,-11282,-16,-6809,-17116,-1,0,-3,0,8
EUW1_6860003387',2,26,13,2,0,1,0,7,1,378,101,28782,30884,32874,3,28,4,0,0,0,0,3,346,85,23857,28422,26159,1,32,16,4925,9,2462,6715,2,0,1,0,4
EUW1_6859965638',2,31,19,1,0,1,0,6,1,370,102,31262,33317,36668,5,18,11,1,0,0,0,7,374,106,26793,30852,29677,0,-4,-4,4469,8,2465,6991,0,0,1,0,-1
EUW1_6859920365',4,30,17,2,0,1,0,11,1,359,93,29986,30546,33814,2,27,6,0,0,2,0,6,335,88,25325,28984,28976,1,24,5,4661,11,1562,4838,2,0,-1,0,5
EUW1_6858538496',3,29,23,1,0,2,0,4,1,384,73,34278,32987,43414,3,55,14,1,0,0,0,6,355,106,30010,29641,31379,1,29,-33,4268,9,3346,12035,0,0,2,0,-2
EUW1_6858492691',3,44,12,1,1,1,0,11,1,366,86,27916,28745,31734,6,29,13,1,0,1,0,6,342,81,27480,27991,28572,0,24,5,436,-1,754,3162,0,1,0,0,5
EUW1_6858442599',6,35,13,0,0,0,0,14,1,345,78,27182,30997,29763,1,26,12,2,0,2,0,0,400,114,30220,34761,35796,0,-55,-36,-3038,1,-3764,-6033,-2,0,-2,0,14
EUW1_6858381722',6,42,7,0,0,0,0,9,0,344,69,25361,27142,21423,5,37,10,1,0,0,0,3,359,84,26043,29674,34096,0,-15,-15,-682,-3,-2532,-12673,-1,0,0,0,6
EUW1_6855697659',2,34,7,0,1,0,0,8,0,356,94,24260,27079,30698,5,29,18,2,0,1,0,3,365,74,29924,30493,30553,0,-9,20,-5664,-11,-3414,145,-2,1,-1,0,5
EUW1_6855608840',6,29,21,1,0,0,0,11,1,321,95,30231,30604,36297,3,44,18,1,0,1,0,3,321,108,30933,30382,35677,1,0,-13,-702,3,222,620,0,0,-1,0,8
EUW1_6855465394',1,42,12,1,0,0,0,9,0,337,76,26952,27211,30687,2,25,17,0,0,0,0,1,331,80,29230,29834,33421,0,6,-4,-2278,-5,-2623,-2734,1,0,0,0,8
EUW1_6855455221',3,59,10,0,0,0,0,8,0,342,88,27064,28987,29540,4,123,18,1,1,0,0,4,347,110,29380,30588,36911,0,-5,-22,-2316,-8,-1601,-7371,-1,-1,0,0,4
EUW1_6855405375',3,27,21,1,0,0,0,10,0,293,66,28489,26452,30816,9,57,16,1,0,1,0,2,371,67,31026,28706,38718,0,-78,-1,-2537,5,-2254,-7902,0,0,-1,0,8
EUW1_6854185566',6,19,8,0,0,1,0,13,0,305,78,24929,27092,27064,1,38,12,2,0,0,0,2,337,101,27371,29422,31111,0,-32,-23,-2442,-4,-2330,-4047,-2,0,1,0,11
EUW1_6854171595',3,64,17,1,1,1,0,7,1,377,88,30493,30168,33526,5,41,10,0,0,0,0,4,337,88,25536,28913,28780,1,40,0,4957,7,1255,4746,1,1,1,0,3
EUW1_6854156695',5,65,17,0,0,2,0,6,1,376,102,32332,31722,31451,4,205,9,2,0,1,0,6,317,85,26049,28809,29159,1,59,17,6283,8,2913,2292,-2,0,1,0,0
EUW1_6854136868',3,26,11,0,0,0,0,4,1,335,76,27942,27509,35596,2,35,15,0,0,1,0,4,330,76,25884,28864,33812,0,5,0,2058,-4,-1355,1784,0,0,-1,0,0
EUW1_6854120683',2,71,20,1,0,1,0,11,1,339,87,32037,31928,38745,5,61,14,1,0,1,0,3,359,83,30280,30660,39054,1,-20,4,1757,6,1268,-309,0,0,0,0,8
EUW1_6854036600',8,39,20,0,0,1,0,9,0,326,80,31109,30392,40311,2,44,18,1,0,1,0,4,327,72,29211,29267,36547,0,-1,8,1898,2,1125,3764,-1,0,0,0,5
EUW1_6849558482',4,38,13,0,0,1,0,6,1,348,85,28535,29078,36653,0,24,17,2,0,0,0,8,352,86,30246,31388,34222,0,-4,-1,-1711,-4,-2310,2431,-2,0,1,0,-2
EUW1_6847565352',2,21,16,1,0,1,0,9,1,305,83,30864,30766,33931,3,33,19,1,0,1,0,7,334,69,30341,29478,46297,1,-29,14,523,-3,1288,-12366,0,0,0,0,2
EUW1_6846174217',4,58,24,0,0,0,0,10,1,316,94,29606,32625,42171,3,46,4,1,0,0,0,3,347,86,24258,27002,27716,1,-31,8,5348,20,5623,14455,-1,0,0,0,7
EUW1_6860809070',4,25,18,2,0,2,0,5,1,388,92,31411,32649,35136,2,25,11,0,0,0,0,4,288,90,25224,28547,29739,0,100,2,6187,7,4102,5397,2,0,2,0,1
EUW1_6859856005',2,28,13,1,1,1,0,10,1,360,88,28406,30662,26191,5,34,10,0,0,0,0,5,348,108,26564,30417,29391,0,12,-20,1842,3,245,-3200,1,1,1,0,5
EUW1_6859796159',5,26,9,1,0,0,0,5,0,399,68,26442,28660,30904,2,31,15,0,0,0,0,3,368,96,28726,29380,29297,0,31,-28,-2284,-6,-720,1607,1,0,0,0,2
EUW1_6859748730',4,29,13,1,1,1,0,8,1,388,86,29323,31039,29256,4,20,7,1,0,0,0,1,364,82,24505,28753,25676,1,24,4,4818,6,2286,3580,0,1,1,0,7
EUW1_6859704640',7,28,21,1,1,2,0,13,1,362,74,32971,29855,41131,2,30,17,0,0,0,0,5,328,74,29085,28550,34476,1,34,0,3886,4,1305,6655,1,1,2,0,8
EUW1_6855431355',0,27,13,1,1,0,0,5,0,309,78,26809,28767,33592,2,25,17,1,0,2,0,4,360,94,31006,31448,44085,0,-51,-16,-4197,-4,-2681,-10493,0,1,-2,0,1
EUW1_6855412757',6,31,6,0,0,0,0,11,1,385,76,25022,28030,24650,5,32,13,2,0,1,0,1,407,96,29469,31838,31986,0,-22,-20,-4447,-7,-3808,-7336,-2,0,-1,0,10
EUW1_6855387481',4,26,9,0,0,1,0,6,0,346,96,27667,29170,30806,4,31,13,2,0,0,0,5,377,100,28172,30474,28697,0,-31,-4,-505,-4,-1304,2109,-2,0,1,0,1
EUW1_6855367479',2,29,10,0,0,0,0,13,0,334,93,26194,28086,27904,2,23,18,2,0,2,0,0,375,82,31518,29104,33851,0,-41,11,-5324,-8,-1018,-5947,-2,0,-2,0,13
EUW1_6854412308',5,29,14,2,0,2,0,8,0,356,86,28880,30036,35178,3,24,12,0,0,0,0,2,307,81,27078,26895,32359,1,49,5,1802,2,3141,2819,2,0,2,0,6
EUW1_6854391041',2,87,14,2,0,0,0,9,0,286,87,27398,27897,29214,5,30,14,0,1,2,0,4,355,99,30661,28990,38060,1,-69,-12,-3263,0,-1093,-8846,2,-1,-2,0,5
EUW1_6854360823',6,30,11,1,0,0,0,12,0,343,96,27257,28753,24941,3,29,12,1,0,1,0,2,354,83,28597,28980,30595,1,-11,13,-1340,-1,-227,-5654,0,0,-1,0,10
EUW1_6854302696',5,26,12,0,0,0,0,13,1,338,72,26418,28155,34610,2,26,15,2,1,2,0,3,371,96,30589,30455,33861,0,-33,-24,-4171,-3,-2300,749,-2,-1,-2,0,10
EUW1_6854281691',9,34,14,1,0,0,0,8,1,334,89,28325,28452,35209,3,22,11,1,0,0,0,3,331,86,26379,27717,36721,1,3,3,1946,3,735,-1512,0,0,0,0,5
EUW1_6881028336',3,39,7,0,1,0,0,6,1,363,101,25144,29057,24033,2,25,14,2,0,0,0,2,355,98,26880,32228,21970,0,8,3,-1736,-7,-3171,2063,-2,1,0,0,4
EUW1_6879598936',4,29,12,1,0,2,0,12,0,348,72,27763,28434,26245,6,70,15,0,0,0,0,2,382,102,27823,30667,34279,1,-34,-30,-60,-3,-2233,-8034,1,0,2,0,10
EUW1_6879518880',2,29,17,0,1,0,0,12,0,290,101,29001,27854,29728,7,34,22,2,0,1,0,3,317,74,30948,29604,34527,0,-27,27,-1947,-5,-1750,-4799,-2,1,-1,0,9
EUW1_6879484271',2,27,17,1,0,1,0,10,0,362,102,30410,30244,33264,7,27,15,1,0,1,0,5,343,67,28992,28197,38747,1,19,35,1418,2,2047,-5483,0,0,0,0,5
EUW1_6879454361',7,34,8,1,0,0,0,2,1,418,116,26523,31260,24303,1,24,8,0,0,0,0,5,394,96,25213,29302,19095,1,24,20,1310,0,1958,5208,1,0,0,0,-3
EUW1_6879058475',1,132,12,1,0,1,0,6,1,318,78,26456,29064,23293,6,35,15,1,0,0,0,5,338,85,27128,29650,29236,0,-20,-7,-672,-3,-586,-5943,0,0,1,0,1
EUW1_6878997548',3,47,9,1,0,0,0,6,1,327,92,24918,25871,24568,4,30,18,0,0,0,0,2,360,92,29262,30704,31142,1,-33,0,-4344,-9,-4833,-6574,1,0,0,0,4
EUW1_6878332807',3,28,7,0,0,0,0,8,1,317,80,23235,27711,25133,4,30,15,2,1,1,0,0,376,104,29013,32043,33582,0,-59,-24,-5778,-8,-4332,-8449,-2,-1,-1,0,8
EUW1_6878288637',8,33,12,2,1,1,0,10,1,364,86,27003,29016,31680,3,33,6,0,0,1,0,4,349,117,26702,29476,20162,1,15,-31,301,6,-460,11518,2,1,0,0,6
EUW1_6878224574',0,26,11,0,0,0,0,9,1,348,90,28118,28203,32427,7,31,23,1,0,1,0,5,365,62,31505,31503,36961,1,-17,28,-3387,-12,-3300,-4534,-1,0,-1,0,4
EUW1_6878192487',1,103,6,0,0,0,0,12,0,317,86,23060,26568,30825,2,24,16,1,1,2,0,0,396,113,32910,33580,36308,0,-79,-27,-9850,-10,-7012,-5483,-1,-1,-2,0,12
EUW1_6878149533',3,27,6,1,0,0,0,5,0,371,80,23421,28350,26932,5,33,12,1,0,1,0,1,363,73,27205,29129,28319,0,8,7,-3784,-6,-779,-1387,0,0,-1,0,4
EUW1_6878109916',4,24,16,1,0,0,0,9,1,350,70,26454,28386,34991,4,34,9,0,0,1,0,2,350,109,28581,27430,28586,1,0,-39,-2127,7,956,6405,1,0,-1,0,7
EUW1_6878063942',3,30,6,0,0,0,0,10,0,367,64,23533,27612,20557,3,30,9,1,1,2,0,0,351,104,28237,29251,28300,1,16,-40,-4704,-3,-1639,-7743,-1,-1,-2,0,10
EUW1_6877184721',4,28,9,1,0,0,0,9,1,384,97,27652,28150,27405,3,298,9,1,1,3,0,4,337,93,25824,29722,27026,0,47,4,1828,0,-1572,379,0,-1,-3,0,5
EUW1_6877017449',5,28,18,2,0,0,0,9,0,349,86,28532,29279,35114,4,30,11,0,0,0,0,3,358,72,26421,28600,27496,1,-9,14,2111,7,679,7618,2,0,0,0,6
EUW1_6876958085',2,25,12,1,0,0,0,10,1,398,82,27432,29647,34781,3,36,12,1,0,0,0,1,348,92,26382,29780,29832,1,50,-10,1050,0,-133,4949,0,0,0,0,9
EUW1_6876931668',2,25,21,2,0,3,0,8,1,376,104,33868,32373,38821,6,34,9,0,0,1,0,10,353,77,26703,29062,26531,1,23,27,7165,12,3311,12290,2,0,2,0,-2
EUW1_6876876069',4,48,13,1,1,0,0,12,1,355,110,28702,30839,31898,5,32,10,0,0,1,0,3,382,90,28147,30152,33803,1,-27,20,555,3,687,-1905,1,1,-1,0,9
EUW1_6874349564',2,25,12,2,0,2,0,5,0,411,114,30170,34061,35771,2,38,8,0,0,0,0,5,384,84,24782,28967,26475,1,27,30,5388,4,5094,9296,2,0,2,0,0
EUW1_6873513631',4,141,15,1,0,0,0,7,0,352,108,28895,32726,35225,2,42,9,1,0,1,0,4,344,104,24822,29371,26254,0,8,4,4073,6,3355,8971,0,0,-1,0,3
EUW1_6873421173',3,35,17,1,0,3,0,5,0,384,101,32285,33784,35510,4,26,8,1,0,0,0,15,332,89,24944,26634,29963,1,52,12,7341,9,7150,5547,0,0,3,0,-10
EUW1_6873355773',4,25,15,1,0,0,0,8,1,292,102,28702,25101,26944,3,33,18,1,0,2,0,4,391,86,29754,30502,34860,1,-99,16,-1052,-3,-5401,-7916,0,0,-2,0,4
EUW1_6872973129',1,23,14,0,0,0,0,8,0,327,78,26316,26949,35078,3,28,19,2,0,0,0,4,354,104,29918,30353,37334,0,-27,-26,-3602,-5,-3404,-2256,-2,0,0,0,4
EUW1_6863108770',2,30,12,1,0,1,0,8,1,380,113,28762,30300,33613,2,43,8,0,0,1,0,3,350,66,25160,26900,29522,1,30,47,3602,4,3400,4091,1,0,0,0,5
EUW1_6863075770',5,34,18,1,0,1,0,12,0,372,80,31143,30444,40292,5,29,17,1,0,2,0,2,316,88,29109,30267,37404,1,56,-8,2034,1,177,2888,0,0,-1,0,10
EUW1_6863021052',3,19,9,1,0,1,0,7,1,395,104,27832,30182,29360,4,26,7,0,0,0,0,1,350,38,22876,25024,25624,1,45,66,4956,2,5158,3736,1,0,1,0,6
EUW1_6862960273',5,30,20,1,0,1,0,8,1,336,84,33030,29387,37918,6,24,16,1,0,2,0,3,346,75,29629,27823,36165,1,-10,9,3401,4,1564,1753,0,0,-1,0,5
EUW1_6862912549',4,144,20,1,0,0,0,11,0,310,107,30111,28398,41319,6,42,17,1,0,2,0,4,349,57,30963,29278,30834,0,-39,50,-852,3,-880,10485,0,0,-2,0,7
EUW1_6861829057',4,29,12,1,0,0,0,17,0,300,82,26079,28526,29451,3,40,16,0,0,3,0,2,362,78,31884,31259,33786,0,-62,4,-5805,-4,-2733,-4335,1,0,-3,0,15
EUW1_6861787942',3,25,9,0,0,0,0,7,1,331,86,24209,28091,23239,4,32,8,1,0,0,0,1,376,90,25989,29264,31328,0,-45,-4,-1780,1,-1173,-8089,-1,0,0,0,6
EUW1_6861750138',2,25,10,1,0,0,0,17,0,324,98,26614,28987,26993,2,25,21,1,1,3,0,2,358,105,33811,33369,40391,0,-34,-7,-7197,-11,-4382,-13398,0,-1,-3,0,15
EUW1_6861246189',3,25,13,1,0,0,0,11,0,347,68,26917,29411,38341,1,39,11,0,0,1,0,3,380,104,28118,31566,35885,1,-33,-36,-1201,2,-2155,2456,1,0,-1,0,8
EUW1_6861200135',4,24,17,1,1,0,0,10,1,369,103,30061,31797,35034,4,26,8,1,0,0,0,4,376,80,26764,29406,28481,0,-7,23,3297,9,2391,6553,0,1,0,0,6
EUW1_6861168511',5,32,12,0,0,0,0,7,0,317,107,26064,29015,29669,2,31,16,1,0,2,0,2,420,88,30977,31802,31363,0,-103,19,-4913,-4,-2787,-1694,-1,0,-2,0,5
EUW1_6883615888',3,26,10,0,0,1,0,6,1,390,71,27324,31522,34930,2,27,12,2,0,1,0,4,381,89,27676,31995,33445,0,9,-18,-352,-2,-473,1485,-2,0,0,0,2
EUW1_6883595684',9,38,17,0,0,1,0,10,1,357,79,29039,29839,34688,6,40,11,1,0,1,0,4,370,70,27035,27380,33144,0,-13,9,2004,6,2459,1544,-1,0,0,0,6
EUW1_6883460547',4,24,9,1,0,0,0,14,1,370,78,26025,30094,29067,5,33,12,1,0,2,0,2,378,102,28938,30930,35141,0,-8,-24,-2913,-3,-836,-6074,0,0,-2,0,12
EUW1_6883402928',10,32,19,1,0,0,0,15,1,377,62,30134,30413,44550,7,35,10,0,0,2,0,2,412,94,29415,31251,35085,1,-35,-32,719,9,-838,9465,1,0,-2,0,13
EUW1_6883353989',4,104,9,0,0,0,0,14,0,322,93,25598,29011,29279,7,29,17,2,0,2,0,0,386,100,30773,30609,40225,0,-64,-7,-5175,-8,-1598,-10946,-2,0,-2,0,14
EUW1_6883218481',3,26,14,1,0,1,0,5,1,352,88,29116,28877,29396,3,23,15,0,0,0,0,7,364,68,28347,29370,31268,1,-12,20,769,-1,-493,-1872,1,0,1,0,-2
EUW1_6883150097',2,43,19,2,1,1,0,8,1,363,99,32690,32222,36077,5,30,8,0,0,3,0,7,375,108,27109,29089,30899,1,-12,-9,5581,11,3133,5178,2,1,-2,0,1
EUW1_6882323098',4,26,9,1,0,0,0,7,0,342,69,25430,29600,26021,5,37,11,1,0,0,0,5,371,70,27475,28866,33278,1,-29,-1,-2045,-2,734,-7257,0,0,0,0,2
EUW1_6882307329',5,45,14,1,0,0,0,8,1,401,80,29712,30824,30084,4,25,8,1,0,1,0,1,340,84,24239,27894,30494,1,61,-4,5473,6,2930,-410,0,0,-1,0,7
EUW1_6882301669',2,23,29,1,0,4,0,11,1,321,103,36465,32337,44434,6,34,11,0,0,1,0,8,334,56,27980,27210,33435,1,-13,47,8485,18,5127,10999,1,0,3,0,3
EUW1_6882280940',7,31,14,0,0,1,0,10,1,381,88,28972,30367,31276,3,26,9,1,0,1,0,6,333,79,25840,27023,27666,0,48,9,3132,5,3344,3610,-1,0,0,0,4
EUW1_6882256647',1,22,12,0,0,2,0,14,1,374,74,28150,29504,33722,2,26,9,1,0,0,0,6,376,88,27032,30551,33211,0,-2,-14,1118,3,-1047,511,-1,0,2,0,8
EUW1_6882229444',2,21,15,0,0,0,0,14,0,316,76,28345,27738,33320,7,27,26,1,1,3,0,1,368,92,36385,31295,47112,0,-52,-16,-8040,-11,-3557,-13792,-1,-1,-3,0,13
EUW1_6882207845',9,35,19,1,1,4,0,2,1,420,114,34764,33884,35438,1,24,8,0,0,0,0,11,370,61,25085,29070,31673,1,50,53,9679,11,4814,3765,1,1,4,0,-9
EUW1_6881104317',6,27,15,2,0,0,0,10,1,325,84,26887,27518,33813,6,64,10,0,0,1,0,1,370,91,27770,29585,29679,1,-45,-7,-883,5,-2067,4134,2,0,-1,0,9
EUW1_6877861458',3,22,21,1,0,1,0,7,1,299,107,31207,29861,35850,1,26,12,1,0,2,0,8,361,67,28260,28146,36507,1,-62,40,2947,9,1715,-657,0,0,-1,0,-1
EUW1_6877511315',1,24,16,0,0,0,0,10,0,347,92,27957,30395,35163,4,33,16,1,0,1,0,3,336,80,28663,28940,48593,0,11,12,-706,0,1455,-13430,-1,0,-1,0,7
EUW1_6877421393',3,36,14,0,0,2,0,7,1,347,92,28279,29952,37675,3,273,9,1,0,0,0,5,318,80,24505,26358,26778,1,29,12,3774,5,3594,10897,-1,0,2,0,2
EUW1_6877348376',3,27,17,1,0,2,0,8,1,356,96,30461,31883,33478,9,32,9,1,0,0,0,9,348,92,26754,27446,33393,1,8,4,3707,8,4437,85,0,0,2,0,-1
EUW1_6877150320',6,33,11,0,0,0,0,7,1,413,90,28044,30205,31998,7,31,20,2,0,0,0,4,348,118,30068,32211,33335,1,65,-28,-2024,-9,-2006,-1337,-2,0,0,0,3
EUW1_6877055453',8,30,15,0,0,3,0,3,1,414,112,31014,32661,37525,2,22,3,2,0,0,0,4,356,71,21904,27280,28425,1,58,41,9110,12,5381,9100,-2,0,3,0,-1
EUW1_6876987537',3,70,18,0,1,0,0,14,0,306,86,28437,30197,42953,3,61,10,1,0,0,0,2,372,91,26973,29448,32263,0,-66,-5,1464,8,749,10690,-1,1,0,0,12
EUW1_6876714865',6,31,7,0,0,1,0,13,0,369,57,25893,28201,29613,4,28,9,2,0,1,0,4,381,102,28012,30356,29223,1,-12,-45,-2119,-2,-2155,390,-2,0,0,0,9
EUW1_6875846989',5,92,15,1,0,0,0,7,0,335,91,27573,28661,32555,6,32,8,1,0,1,0,1,328,72,25403,26618,29930,0,7,19,2170,7,2043,2625,0,0,-1,0,6
EUW1_6875792169',4,33,17,1,0,0,0,15,1,355,81,28947,29934,33039,2,26,15,1,0,3,0,3,358,108,31361,31112,35338,0,-3,-27,-2414,2,-1178,-2299,0,0,-3,0,12
EUW1_6875698712',5,39,16,1,0,0,0,11,0,341,84,28081,29268,33024,1,24,12,0,0,1,0,4,408,90,30122,31199,29042,1,-67,-6,-2041,4,-1931,3982,1,0,-1,0,7
EUW1_6875638312',7,32,22,0,0,0,0,9,1,323,72,31135,30086,38442,5,82,14,2,0,1,0,3,360,82,28563,29798,33023,0,-37,-10,2572,8,288,5419,-2,0,-1,0,6
EUW1_6863326886',2,190,10,0,1,0,0,9,1,355,91,25449,28938,25916,2,51,11,2,0,0,0,1,308,92,25413,27312,26803,1,47,-1,36,-1,1626,-887,-2,1,0,0,8
EUW1_6863163008',1,20,11,0,1,1,0,7,0,388,102,28307,31357,30812,4,30,9,2,0,0,0,4,346,80,25938,29569,38963,1,42,22,2369,2,1788,-8151,-2,1,1,0,3
EUW1_6862125109',4,43,13,1,0,0,0,6,0,397,96,28099,30877,42255,7,30,9,1,0,0,0,4,360,83,26208,28751,29582,1,37,13,1891,4,2126,12673,0,0,0,0,2
EUW1_6861046648',3,23,10,0,1,0,0,8,0,325,81,26462,28929,29540,2,79,13,2,0,2,0,0,374,114,29667,30765,34126,1,-49,-33,-3205,-3,-1836,-4586,-2,1,-2,0,8
EUW1_6883440490',1,22,24,1,0,2,0,10,1,386,96,32899,34686,51156,3,22,11,0,0,0,0,7,305,82,25962,26337,36365,1,81,14,6937,13,8349,14791,1,0,2,0,3
EUW1_6880031489',3,25,7,0,0,0,0,12,0,352,92,25591,28909,35068,6,30,17,2,0,0,0,2,347,88,28999,30887,34742,0,5,4,-3408,-10,-1978,326,-2,0,0,0,10
EUW1_6879957921',6,32,20,1,0,1,0,11,1,341,110,31883,31544,46703,3,21,14,1,0,0,0,4,291,79,27602,28306,38034,1,50,31,4281,6,3238,8669,0,0,1,0,7
EUW1_6879308202',1,26,22,1,0,2,0,7,1,383,105,34869,33861,43949,2,27,8,0,0,1,0,9,337,73,24461,27131,23754,1,46,32,10408,14,6730,20195,1,0,1,0,-2
EUW1_6878574642',8,46,9,1,0,0,0,3,0,326,85,24000,26679,28931,4,20,14,1,0,0,0,1,356,76,26855,27007,28214,0,-30,9,-2855,-5,-328,717,0,0,0,0,2
EUW1_6878441515',1,20,4,0,0,0,0,11,0,374,79,22747,27691,17861,6,34,9,2,1,1,0,0,383,112,27777,29916,23578,0,-9,-33,-5030,-5,-2225,-5717,-2,-1,-1,0,11
EUW1_6877897343',0,29,14,1,0,0,0,5,1,343,88,29096,28368,42185,2,26,15,0,0,2,0,5,299,80,27537,27322,36926,0,44,8,1559,-1,1046,5259,1,0,-2,0,0
EUW1_6877889382',7,29,10,1,0,2,0,12,1,358,130,28525,30145,25987,4,65,16,1,1,1,0,4,308,77,29750,29069,30478,0,50,53,-1225,-6,1076,-4491,0,-1,1,0,8
EUW1_6877885584',0,29,13,1,0,3,0,2,0,369,93,29563,30657,35031,5,88,9,1,0,0,0,11,290,86,23482,26266,27948,1,79,7,6081,4,4391,7083,0,0,3,0,-9
EUW1_6874857731',2,40,17,1,0,0,0,18,0,337,116,29918,32093,41145,0,22,13,1,0,3,0,5,349,88,29350,28747,34764,1,-12,28,568,4,3346,6381,0,0,-3,0,13
EUW1_6874805902',7,28,21,2,1,0,0,5,1,342,101,31696,31858,37246,4,25,9,0,0,1,0,4,330,91,25723,28368,27780,0,12,10,5973,12,3490,9466,2,1,-1,0,1
EUW1_6870908410',2,26,23,2,0,2,0,8,1,310,118,32312,30582,42179,4,27,15,0,0,0,0,9,287,75,25800,27062,24796,1,23,43,6512,8,3520,17383,2,0,2,0,-1
EUW1_6870899965',6,28,9,0,0,0,0,10,1,324,84,24897,26283,26511,5,22,15,2,1,3,0,2,376,91,31639,32344,31969,0,-52,-7,-6742,-6,-6061,-5458,-2,-1,-3,0,8
EUW1_6869250628',1,22,8,1,0,0,0,15,1,334,95,25614,27998,27424,2,29,19,1,0,3,0,2,366,107,33862,31122,36056,0,-32,-12,-8248,-11,-3124,-8632,0,0,-3,0,13
EUW1_6869231789',1,62,12,2,0,1,0,11,0,372,81,27904,30893,35077,0,55,11,0,0,1,0,5,365,109,27603,29787,34615,1,7,-28,301,1,1106,462,2,0,0,0,6
EUW1_6869211646',5,27,13,1,0,1,0,8,0,375,98,28817,30862,36964,4,31,7,1,0,0,0,0,345,109,24694,27443,30720,1,30,-11,4123,6,3419,6244,0,0,1,0,8
EUW1_6869112809',4,61,14,1,0,0,0,9,0,385,88,27628,32030,34434,0,16,13,0,0,0,0,4,378,108,28499,32958,29603,0,7,-20,-871,1,-928,4831,1,0,0,0,5
EUW1_6868832124',2,68,5,0,0,0,0,15,0,238,64,19691,20342,18134,5,26,20,1,0,7,1,0,334,104,33223,29145,36840,0,-96,-40,-13532,-15,-8803,-18706,-1,0,-7,-1,15
EUW1_6875353993',5,25,17,1,0,1,0,11,0,383,91,30415,32758,36116,9,30,6,1,0,1,0,4,359,76,25124,28501,26234,1,24,15,5291,11,4257,9882,0,0,0,0,7
EUW1_6875213469',7,44,5,0,0,0,0,10,1,375,92,24944,28507,26302,5,29,13,2,0,1,0,5,380,60,28393,29473,37008,0,-5,32,-3449,-8,-966,-10706,-2,0,-1,0,5
EUW1_6870286142',3,27,16,2,0,1,0,9,1,370,80,29357,29644,41358,1,23,12,0,0,0,0,3,338,88,27432,28751,32838,1,32,-8,1925,4,893,8520,2,0,1,0,6
EUW1_6870208174',3,31,4,0,0,0,0,11,1,324,98,22606,27342,27558,6,52,15,2,0,2,0,1,409,89,30921,33442,33375,0,-85,9,-8315,-11,-6100,-5817,-2,0,-2,0,10
EUW1_6870154804',3,22,8,0,0,0,0,15,1,320,86,24606,27766,23241,6,31,17,2,1,3,0,5,380,98,30596,31814,38589,0,-60,-12,-5990,-9,-4048,-15348,-2,-1,-3,0,10
EUW1_6870062632',9,209,12,1,0,0,0,12,1,340,84,26522,28188,29769,2,27,13,1,0,2,0,5,370,82,29632,29994,30410,0,-30,2,-3110,-1,-1806,-641,0,0,-2,0,7
EUW1_6869991503',6,59,8,1,0,0,0,10,0,355,101,25841,29251,22090,2,65,7,0,0,1,0,2,392,82,25878,29323,26935,0,-37,19,-37,1,-72,-4845,1,0,-1,0,8
EUW1_6869708424',3,31,9,1,0,1,0,12,0,369,83,25901,29706,29676,5,29,13,0,1,1,0,5,381,92,29484,30597,33046,0,-12,-9,-3583,-4,-891,-3370,1,-1,0,0,7
EUW1_6869110334',7,27,10,1,0,2,0,6,1,358,84,27252,28485,28885,1,21,14,1,0,0,0,10,323,82,26619,30194,32459,0,35,2,633,-4,-1709,-3574,0,0,2,0,-4
EUW1_6869072104',9,33,11,0,0,1,0,8,0,387,104,27582,32371,33930,9,39,11,2,0,1,0,5,378,88,27477,30453,34680,1,9,16,105,0,1918,-750,-2,0,0,0,3
EUW1_6869025042',1,22,15,1,1,1,0,8,1,370,91,29353,31589,28644,5,29,11,1,0,0,0,9,348,104,26944,29681,29101,1,22,-13,2409,4,1908,-457,0,1,1,0,-1
EUW1_6868972955',5,32,7,0,0,1,0,6,1,385,98,26192,30158,23567,4,27,4,1,0,0,0,3,364,80,23267,27829,19522,0,21,18,2925,3,2329,4045,-1,0,1,0,3
EUW1_6868900735',4,31,7,1,0,0,0,9,0,354,106,25396,29010,23594,6,30,19,0,0,1,0,4,389,70,30852,31520,37366,1,-35,36,-5456,-12,-2510,-13772,1,0,-1,0,5
EUW1_6868792212',2,27,12,1,0,0,0,16,0,356,91,27437,29268,31588,3,87,15,0,0,3,0,0,325,105,29223,30096,33915,1,31,-14,-1786,-3,-828,-2327,1,0,-3,0,16
EUW1_6868728080',3,28,10,1,0,0,0,9,0,368,85,27381,30498,29319,6,36,10,1,0,0,0,5,313,110,25999,28750,28469,1,55,-25,1382,0,1748,850,0,0,0,0,4
EUW1_6868670823',7,29,19,1,0,1,0,5,0,382,84,32211,31193,35133,6,37,8,1,0,1,0,9,344,81,24840,27367,28967,1,38,3,7371,11,3826,6166,0,0,0,0,-4
EUW1_6868608032',2,25,30,2,0,1,0,6,0,305,106,35210,31831,43106,11,45,14,0,0,1,0,8,310,94,26833,26896,37974,1,-5,12,8377,16,4935,5132,2,0,0,0,-2
EUW1_6861689954',1,26,17,1,0,0,0,9,0,302,96,27959,28717,47439,5,20,20,0,0,0,0,2,322,64,30502,28096,46985,0,-20,32,-2543,-3,621,454,1,0,0,0,7
EUW1_6861558031',5,34,12,2,0,1,0,7,1,390,95,29026,30641,41280,7,32,12,0,1,0,0,7,307,108,27401,29305,28104,1,83,-13,1625,0,1336,13176,2,-1,1,0,0
EUW1_6861224813',2,25,16,1,1,0,0,10,0,392,106,28481,34380,37422,4,26,14,1,0,1,0,3,370,110,28353,30808,32628,1,22,-4,128,2,3572,4794,0,1,-1,0,7
EUW1_6861185618',6,32,23,1,0,3,0,4,1,376,130,34941,34237,42007,3,26,9,0,0,0,0,9,327,77,25467,27760,29650,1,49,53,9474,14,6477,12357,1,0,3,0,-5
EUW1_6861136903',4,30,19,1,0,2,0,12,0,314,94,30774,29231,37852,2,21,19,1,0,2,0,7,359,90,31715,31458,43903,0,-45,4,-941,0,-2227,-6051,0,0,0,0,5
EUW1_6861101279',2,28,19,0,0,2,0,6,0,401,104,32868,32587,41928,6,97,11,2,0,0,0,5,324,76,25478,28018,40780,1,77,28,7390,8,4569,1148,-2,0,2,0,1
EUW1_6861049409',3,48,15,2,0,0,0,7,1,343,103,29333,31335,42860,3,90,8,0,0,1,0,6,296,76,23468,26783,31144,1,47,27,5865,7,4552,11716,2,0,-1,0,1
EUW1_6860734920',4,30,8,0,0,0,0,16,0,300,63,24502,27564,32341,5,36,19,2,0,4,0,3,367,108,34177,30413,46984,0,-67,-45,-9675,-11,-2849,-14643,-2,0,-4,0,13
EUW1_6860724596',7,30,9,0,0,2,0,4,0,397,80,27282,29638,31169,3,29,13,1,0,0,0,5,312,76,26150,28425,27543,1,85,4,1132,-4,1213,3626,-1,0,2,0,-1
EUW1_6860679898',2,29,19,1,0,1,0,10,1,370,92,32247,31529,41741,9,33,16,0,0,2,0,7,369,71,29268,31211,34705,1,1,21,2979,3,318,7036,1,0,-1,0,3
EUW1_6860659825',5,29,13,1,0,0,0,6,1,393,98,29160,30683,35832,5,27,14,0,0,0,0,4,353,85,27707,31019,43196,1,40,13,1453,-1,-336,-7364,1,0,0,0,2
EUW1_6859938559',4,28,9,0,0,0,0,10,0,298,71,24483,26437,27363,2,23,23,1,0,1,0,2,382,81,31039,33084,35131,0,-84,-10,-6556,-14,-6647,-7768,-1,0,-1,0,8
EUW1_6859889079',1,26,8,0,0,0,0,12,1,318,76,24462,27594,26159,6,29,12,1,0,2,0,0,392,113,30114,29997,28227,0,-74,-37,-5652,-4,-2403,-2068,-1,0,-2,0,12
EUW1_6859831194',3,23,12,0,0,2,0,9,0,394,106,30766,30898,38549,4,176,10,1,1,0,0,5,356,93,26953,28721,25727,0,38,13,3813,2,2177,12822,-1,-1,2,0,4
EUW1_6859780414',8,31,22,1,0,3,0,9,0,364,100,34374,30829,45539,6,28,13,1,0,0,0,5,271,78,26084,26633,34784,1,93,22,8290,9,4196,10755,0,0,3,0,4
EUW1_6859750012',4,22,22,0,0,3,0,10,1,347,88,32872,31436,38123,2,135,9,2,0,2,0,8,301,76,24775,25110,30946,1,46,12,8097,13,6326,7177,-2,0,1,0,2
EUW1_6857954316',0,136,9,0,0,0,0,15,0,355,100,26666,28179,29935,3,24,12,1,1,2,0,3,381,84,29831,29418,29880,0,-26,16,-3165,-3,-1239,55,-1,-1,-2,0,12
EUW1_6857944536',1,135,15,0,0,1,0,9,1,359,113,29233,32004,30081,4,41,7,2,0,1,0,4,375,92,25991,28233,28117,1,-16,21,3242,8,3771,1964,-2,0,0,0,5
EUW1_6857087278',4,27,7,2,0,0,0,6,1,350,80,23917,28148,27196,3,27,11,0,0,0,0,0,391,87,26673,29077,22203,0,-41,-7,-2756,-4,-929,4993,2,0,0,0,6
EUW1_6856516732',2,24,15,0,0,0,0,12,1,353,103,28847,31602,37176,1,22,18,1,0,2,0,1,343,96,32160,32689,42504,0,10,7,-3313,-3,-1087,-5328,-1,0,-2,0,11
EUW1_6859667929',2,323,12,1,0,2,0,8,1,365,81,29159,30802,31671,3,24,10,1,0,0,0,6,352,105,26158,30631,25299,1,13,-24,3001,2,171,6372,0,0,2,0,2
EUW1_6859252375',10,212,16,0,1,0,0,10,1,308,78,29093,28500,38621,4,24,12,1,0,1,0,5,369,61,27295,27982,34680,0,-61,17,1798,4,518,3941,-1,1,-1,0,5
EUW1_6859216339',1,21,12,1,0,1,0,6,1,361,80,28151,28877,28883,2,22,8,1,0,0,0,7,350,72,24985,27205,31233,1,11,8,3166,4,1672,-2350,0,0,1,0,-1
EUW1_6859163348',5,25,14,0,0,1,0,11,1,315,86,29305,27030,38218,3,36,17,0,0,1,0,4,309,82,29421,29782,39668,0,6,4,-116,-3,-2752,-1450,0,0,0,0,7
EUW1_6859066039',6,25,15,1,0,0,0,12,0,338,60,27558,27131,30726,3,20,15,0,0,2,0,2,345,82,29633,28416,35487,0,-7,-22,-2075,0,-1285,-4761,1,0,-2,0,10
EUW1_6859010968',5,27,13,0,0,0,0,6,0,353,87,27141,29729,32119,4,33,14,2,0,0,0,2,339,98,28925,30337,43557,1,14,-11,-1784,-1,-608,-11438,-2,0,0,0,4
EUW1_6858950990',1,35,7,0,0,1,0,10,0,329,82,25117,28341,27543,6,101,17,2,0,1,0,3,329,101,28654,31082,28107,0,0,-19,-3537,-10,-2741,-564,-2,0,0,0,7
EUW1_6858866893',3,28,8,2,0,1,0,9,1,352,90,25481,28633,27960,7,20,12,0,0,0,0,3,363,80,26600,30233,30604,1,-11,10,-1119,-4,-1600,-2644,2,0,1,0,6
EUW1_6858841620',2,27,9,0,0,0,0,17,1,292,86,25344,25495,24742,4,40,19,1,1,5,0,0,328,77,32790,28520,42079,0,-36,9,-7446,-10,-3025,-17337,-1,-1,-5,0,17
EUW1_6858786285',4,97,12,0,0,0,0,11,0,313,92,26197,27285,33081,5,30,22,2,0,2,0,1,389,91,34808,32095,42038,0,-76,1,-8611,-10,-4810,-8957,-2,0,-2,0,10
EUW1_6858726355',3,27,8,0,0,0,0,8,1,335,88,24858,28321,23421,1,26,13,1,0,0,0,1,347,92,27699,28755,30858,0,-12,-4,-2841,-5,-434,-7437,-1,0,0,0,7
EUW1_6877141518',5,27,12,0,0,0,0,7,0,377,72,29213,31057,28762,2,28,13,2,0,3,0,3,350,88,28248,29140,29703,1,27,-16,965,-1,1917,-941,-2,0,-3,0,4
EUW1_6876410327',3,26,16,0,0,0,0,8,0,381,86,30380,33085,32012,6,49,12,1,0,2,0,6,321,88,26345,29802,39038,1,60,-2,4035,4,3283,-7026,-1,0,-2,0,2
EUW1_6875914031',4,25,9,2,0,0,0,9,0,301,86,24289,29677,30588,2,24,10,0,0,1,0,1,403,95,26592,29590,33095,1,-102,-9,-2303,-1,87,-2507,2,0,-1,0,8
EUW1_6875765935',5,37,8,0,0,0,0,10,0,332,90,24613,27778,16663,1,24,19,2,0,2,0,2,385,86,31745,31326,37464,0,-53,4,-7132,-11,-3548,-20801,-2,0,-2,0,8
EUW1_6874398469',1,35,13,0,0,2,0,8,1,366,102,28965,30173,31362,4,26,7,2,0,0,0,7,360,65,23982,25647,26656,1,6,37,4983,6,4526,4706,-2,0,2,0,1
EUW1_6874338361',3,22,10,0,0,0,0,12,0,341,66,25430,29498,26513,1,59,14,2,0,2,0,3,388,117,30848,31667,28247,0,-47,-51,-5418,-4,-2169,-1734,-2,0,-2,0,9
EUW1_6874310151',6,25,22,1,0,1,0,4,1,374,82,32190,32877,40295,1,28,3,1,0,1,0,7,349,72,21663,26695,20417,1,25,10,10527,19,6182,19878,0,0,0,0,-3
EUW1_6873690713',3,158,9,0,0,1,0,7,1,414,91,28365,29899,27602,4,82,13,1,0,0,0,6,346,92,27484,29714,27499,0,68,-1,881,-4,185,103,-1,0,1,0,1
EUW1_6873665237',3,90,24,2,0,1,0,13,1,316,88,31631,30151,43966,1,25,13,0,1,2,0,2,339,76,28448,27841,36220,1,-23,12,3183,11,2310,7746,2,-1,-1,0,11
EUW1_6873408852',0,18,10,1,0,1,0,14,0,359,108,28101,30389,32668,2,24,11,1,0,4,0,5,382,96,29841,29795,37295,0,-23,12,-1740,-1,594,-4627,0,0,-3,0,9
EUW1_6873330915',3,33,18,2,0,2,0,6,1,386,92,31711,32690,36681,4,33,9,0,0,0,0,7,367,87,26519,29690,31629,1,19,5,5192,9,3000,5052,2,0,2,0,-1
EUW1_6873002402',4,25,15,1,0,1,0,8,1,355,92,28338,31373,43663,3,27,8,1,0,2,0,8,325,77,26136,27781,25698,1,30,15,2202,7,3592,17965,0,0,-1,0,0
EUW1_6872311468',3,31,14,0,1,1,0,5,1,350,73,28925,29574,31136,8,35,13,1,0,0,0,9,329,74,25752,29131,26440,0,21,-1,3173,1,443,4696,-1,1,1,0,-4
EUW1_6872283120',6,29,15,1,0,0,0,8,1,333,92,27436,28719,29604,2,39,14,0,0,2,0,2,350,108,29737,29646,32129,0,-17,-16,-2301,1,-927,-2525,1,0,-2,0,6
EUW1_6879224215',8,26,14,0,0,0,0,12,1,372,84,28674,29640,32860,3,24,12,1,1,2,0,3,390,92,29852,30026,32925,0,-18,-8,-1178,2,-386,-65,-1,-1,-2,0,9
EUW1_6857935678',2,17,13,2,0,2,0,8,1,329,96,29447,29932,33536,2,63,10,0,0,1,0,3,377,76,26340,30013,31750,1,-48,20,3107,3,-81,1786,2,0,1,0,5
EUW1_6855422929',4,24,17,1,1,0,0,8,1,339,105,29958,31699,53855,5,26,11,0,0,0,0,5,294,69,25386,27874,41653,1,45,36,4572,6,3825,12202,1,1,0,0,3
EUW1_6855400379',2,28,15,0,0,0,0,10,0,333,77,28688,28394,38355,6,26,18,2,1,1,0,3,282,94,30485,30747,36980,0,51,-17,-1797,-3,-2353,1375,-2,-1,-1,0,7
EUW1_6855389091',4,26,6,0,0,0,0,11,0,338,72,23278,24996,28978,4,29,22,2,0,2,0,1,349,118,33415,32767,45650,0,-11,-46,-10137,-16,-7771,-16672,-2,0,-2,0,10
EUW1_6854175513',0,18,11,0,0,0,0,14,0,319,90,25622,26851,25718,5,31,25,2,0,3,0,0,370,78,34170,32590,45710,0,-51,12,-8548,-14,-5739,-19992,-2,0,-3,0,14
EUW1_6854148327',5,31,10,2,0,0,0,13,0,347,90,26823,29497,31690,3,35,11,0,0,3,0,6,315,101,28429,29185,24108,1,32,-11,-1606,-1,312,7582,2,0,-3,0,7
EUW1_6852945173',3,56,11,1,0,0,0,12,1,313,76,26635,25633,33906,4,35,18,1,0,1,0,4,306,92,28331,29009,36121,0,7,-16,-1696,-7,-3376,-2215,0,0,-1,0,8
EUW1_6852929035',2,16,9,0,0,0,0,4,1,327,84,26266,27036,23647,5,28,20,0,0,1,0,3,350,72,30696,30479,36853,0,-23,12,-4430,-11,-3443,-13206,0,0,-1,0,1
EUW1_6851539794',3,28,16,1,1,2,0,7,1,366,69,30677,28365,37612,2,164,8,0,0,0,0,8,357,83,24574,27946,25848,1,9,-14,6103,8,419,11764,1,1,2,0,-1
EUW1_6851504061',1,24,6,0,0,1,0,9,0,337,96,24696,25987,21191,5,38,14,2,0,1,0,6,354,87,28168,30730,26858,0,-17,9,-3472,-8,-4743,-5667,-2,0,0,0,3
EUW1_6850077687',4,30,13,0,0,0,0,4,0,380,91,27508,29117,31411,3,93,7,1,0,0,0,1,293,68,22791,25500,31567,1,87,23,4717,6,3617,-156,-1,0,0,0,3
EUW1_6847128199',2,43,21,0,1,0,0,9,0,341,86,31887,28751,38256,1,26,18,1,0,0,0,5,323,80,29761,27026,36385,1,18,6,2126,3,1725,1871,-1,1,0,0,4
EUW1_6847092797',1,29,11,0,0,1,0,11,0,386,100,28321,31191,32979,0,22,23,1,0,3,0,2,412,96,35780,35801,37245,0,-26,4,-7459,-12,-4610,-4266,-1,0,-2,0,9
EUW1_6803532448',5,29,22,2,0,1,0,9,1,345,96,31659,31618,38889,4,30,12,0,0,0,0,8,341,95,28289,29051,28024,1,4,1,3370,10,2567,10865,2,0,1,0,1
EUW1_6803532639',3,41,3,0,0,0,0,18,0,277,61,20864,22075,21560,4,20,20,0,0,7,1,1,370,84,35588,30456,28012,0,-93,-23,-14724,-17,-8381,-6452,0,0,-7,-1,17
EUW1_6803498045',3,26,10,0,0,0,0,11,0,369,92,26407,29587,28823,8,29,12,2,0,2,0,1,376,96,29285,30452,31783,1,-7,-4,-2878,-2,-865,-2960,-2,0,-2,0,10
EUW1_6882907714',2,28,11,0,0,1,0,7,0,354,104,27156,28348,25299,3,25,15,2,0,1,0,3,365,87,29144,28657,33023,1,-11,17,-1988,-4,-309,-7724,-2,0,0,0,4
EUW1_6857202993',1,31,14,0,0,1,0,10,1,361,76,30941,29707,37718,7,37,21,2,0,1,0,7,336,79,30943,29197,41990,0,25,-3,-2,-7,510,-4272,-2,0,0,0,3
EUW1_6857159586',7,35,15,2,0,1,0,9,1,382,100,29568,31117,24486,1,25,7,0,0,0,0,2,366,76,25459,28035,22435,1,16,24,4109,8,3082,2051,2,0,1,0,7
EUW1_6857088081',4,29,17,0,0,1,0,9,1,363,100,29821,30771,43207,5,27,12,1,0,1,0,4,288,82,26709,28021,32830,1,75,18,3112,5,2750,10377,-1,0,0,0,5
EUW1_6857061795',1,25,2,0,0,0,0,13,0,338,66,21312,25346,15776,1,20,20,2,0,3,0,1,431,112,33768,33567,36227,0,-93,-46,-12456,-18,-8221,-20451,-2,0,-3,0,12
EUW1_6857024719',2,31,10,0,1,0,0,7,1,320,90,26680,28887,27129,4,19,21,2,0,1,0,2,328,113,30215,32499,38537,0,-8,-23,-3535,-11,-3612,-11408,-2,1,-1,0,5
EUW1_6855227498',4,139,8,1,1,1,0,7,0,385,83,26756,29396,22660,5,30,7,1,0,0,0,3,374,77,25597,28237,24878,1,11,6,1159,1,1159,-2218,0,1,1,0,4
EUW1_6854987962',1,23,5,0,0,0,0,7,0,398,96,25816,28925,29676,6,28,14,2,0,1,0,6,346,93,27174,31151,27425,1,52,3,-1358,-9,-2226,2251,-2,0,-1,0,1
EUW1_6854940467',2,31,15,0,0,3,0,5,1,378,100,31486,31620,35450,3,25,13,2,0,0,0,8,335,95,26497,29489,33975,1,43,5,4989,2,2131,1475,-2,0,3,0,-3
EUW1_6854512459',3,46,15,1,0,0,0,10,0,367,96,29672,31893,38110,3,31,20,1,0,0,0,4,351,100,30649,31393,38806,1,16,-4,-977,-5,500,-696,0,0,0,0,6
EUW1_6838037966',5,78,9,1,0,0,0,4,0,361,98,26984,30809,29704,7,67,12,1,0,1,0,1,351,106,27419,30558,34297,0,10,-8,-435,-3,251,-4593,0,0,-1,0,3
EUW1_6832456407',0,197,15,0,0,2,0,4,0,359,84,30114,31247,38258,2,18,15,1,0,0,0,10,324,80,27644,31305,39394,1,35,4,2470,0,-58,-1136,-1,0,2,0,-6
EUW1_6787691970',3,28,13,1,0,1,0,10,1,318,76,28697,27272,28618,4,400,16,0,0,1,0,8,340,68,29183,26751,39513,1,-22,8,-486,-3,521,-10895,1,0,0,0,2
EUW1_6781372824',5,25,13,1,0,3,0,4,1,424,90,31316,32229,36116,7,99,10,1,0,0,0,9,312,98,25191,29652,17641,1,112,-8,6125,3,2577,18475,0,0,3,0,-5
EUW1_6758480034',4,23,10,0,0,0,0,13,0,348,78,26788,29196,23079,5,31,12,2,1,0,0,3,333,84,26341,29039,30691,0,15,-6,447,-2,157,-7612,-2,-1,0,0,10
EUW1_6758474963',1,30,15,2,1,1,0,3,1,372,77,28818,30458,34158,6,25,9,0,0,0,0,8,319,79,23602,28368,27495,1,53,-2,5216,6,2090,6663,2,1,1,0,-5
EUW1_6758464970',3,32,16,0,0,1,0,11,0,299,69,27553,26143,33085,6,21,20,2,1,1,0,3,334,106,31259,31254,33526,0,-35,-37,-3706,-4,-5111,-441,-2,-1,0,0,8
EUW1_6758455848',2,28,11,0,0,0,0,16,0,306,78,24373,26310,28835,4,53,21,2,1,2,0,2,362,78,31886,31029,40521,0,-56,0,-7513,-10,-4719,-11686,-2,-1,-2,0,14
EUW1_6758436448',3,21,17,2,1,0,0,11,1,339,108,29466,31396,33965,3,25,10,0,0,1,0,4,288,56,24465,25989,33760,1,51,52,5001,7,5407,205,2,1,-1,0,7
EUW1_6883487346',3,32,19,0,0,2,0,10,0,288,75,30250,27540,33295,2,26,17,2,0,1,0,8,314,100,30146,28708,33384,1,-26,-25,104,2,-1168,-89,-2,0,1,0,2
EUW1_6883441734',5,99,15,0,1,2,0,12,1,322,77,29675,28959,40361,3,28,17,1,0,2,0,4,358,77,29421,29686,35280,1,-36,0,254,-2,-727,5081,-1,1,0,0,8
EUW1_6883390188',1,24,9,0,0,0,0,12,1,365,77,25945,30041,26127,4,21,14,2,0,0,0,2,404,114,29388,31992,36633,0,-39,-37,-3443,-5,-1951,-10506,-2,0,0,0,10
EUW1_6883336757',3,22,13,1,1,0,0,9,0,354,70,27059,29517,31741,6,29,17,0,0,1,0,5,344,76,30609,30700,37659,0,10,-6,-3550,-4,-1183,-5918,1,1,-1,0,4
EUW1_6883194987',8,27,15,0,0,0,0,8,0,363,62,27399,29379,33682,2,21,13,2,0,1,0,1,321,82,28167,28682,37108,0,42,-20,-768,2,697,-3426,-2,0,-1,0,7
EUW1_6883139658',4,28,22,2,0,1,0,7,1,382,84,30486,32235,35964,3,29,9,0,0,2,0,7,394,78,28199,31574,27293,1,-12,6,2287,13,661,8671,2,0,-1,0,0
EUW1_6883030365',7,29,12,0,0,0,0,13,1,345,81,26657,26602,24566,2,35,16,2,1,2,0,1,410,86,31831,29502,29545,1,-65,-5,-5174,-4,-2900,-4979,-2,-1,-2,0,12
EUW1_6882988102',5,30,16,2,0,2,0,6,1,386,85,30358,29012,32207,10,36,7,0,0,0,0,8,291,77,23904,26027,21209,1,95,8,6454,9,2985,10998,2,0,2,0,-2
EUW1_6882934142',1,24,11,0,0,1,0,9,0,330,81,29937,26829,32061,0,18,22,1,1,0,0,7,317,76,27937,28879,38798,1,13,5,2000,-11,-2050,-6737,-1,-1,1,0,2
EUW1_6882831018',6,39,16,1,0,1,0,6,0,341,100,27793,31425,29620,0,26,11,0,0,0,0,2,329,68,25465,27227,34217,1,12,32,2328,5,4198,-4597,1,0,1,0,4
EUW1_6882325640',3,30,13,2,0,1,0,10,1,356,82,27931,31179,30892,3,31,3,0,0,0,0,5,418,84,24553,28969,24568,1,-62,-2,3378,10,2210,6324,2,0,1,0,5
EUW1_6882310910',2,225,6,0,0,0,0,14,0,317,66,23104,25082,19292,2,25,14,1,1,4,0,2,381,98,31240,30684,29477,0,-64,-32,-8136,-8,-5602,-10185,-1,-1,-4,0,12
EUW1_6882300858',5,147,19,0,0,3,0,7,1,336,92,32013,31279,37495,2,16,8,0,0,0,0,6,354,67,24628,27079,23374,1,-18,25,7385,11,4200,14121,0,0,3,0,1
EUW1_6882286912',5,36,16,0,0,0,0,12,0,302,66,27186,26988,37800,5,31,18,1,1,3,0,0,349,91,31947,29144,44316,0,-47,-25,-4761,-2,-2156,-6516,-1,-1,-3,0,12
EUW1_6882275495',5,212,16,1,0,0,0,10,0,298,93,27898,27456,34559,1,23,14,0,0,1,0,0,323,62,27460,27840,33786,1,-25,31,438,2,-384,773,1,0,-1,0,10
EUW1_6882256495',5,119,12,2,0,0,0,9,1,394,80,28164,29674,23334,3,138,6,0,0,1,0,3,388,108,25224,30393,24894,1,6,-28,2940,6,-719,-1560,2,0,-1,0,6
EUW1_6882221252',6,27,12,1,0,0,0,7,0,314,84,25725,30829,36699,6,29,10,1,0,0,0,1,390,88,26538,31045,32237,1,-76,-4,-813,2,-216,4462,0,0,0,0,6
EUW1_6882191827',2,28,9,0,0,1,0,12,1,363,88,27126,28358,30621,6,113,16,2,0,1,0,3,324,103,28702,29671,27267,0,39,-15,-1576,-7,-1313,3354,-2,0,0,0,9
EUW1_6882162757',7,35,17,1,0,1,0,9,1,366,96,31822,30894,37491,4,27,15,1,0,1,0,8,413,88,30823,32779,33714,0,-47,8,999,2,-1885,3777,0,0,0,0,1
EUW1_6883671504',7,32,8,2,0,0,0,11,1,329,88,25537,27804,27979,1,25,13,0,0,2,0,3,370,99,29067,30312,33551,0,-41,-11,-3530,-5,-2508,-5572,2,0,-2,0,8
EUW1_6883656521',2,37,10,0,0,0,0,17,0,307,72,25677,27306,32552,3,133,22,0,1,4,0,2,370,96,32666,31854,42468,0,-63,-24,-6989,-12,-4548,-9916,0,-1,-4,0,15
EUW1_6883644727',3,24,18,2,0,1,0,8,1,343,83,29630,31181,39274,4,31,8,0,0,0,0,6,325,92,24649,28456,29077,1,18,-9,4981,10,2725,10197,2,0,1,0,2
EUW1_6883596352',3,39,16,1,0,0,0,5,1,372,86,27695,31498,37014,2,21,8,0,0,0,0,5,339,88,24792,26337,27618,1,33,-2,2903,8,5161,9396,1,0,0,0,0
EUW1_6883581637',3,23,13,1,0,2,0,11,0,360,94,29579,30384,31165,3,30,17,1,0,0,0,6,322,77,29462,28782,32923,1,38,17,117,-4,1602,-1758,0,0,2,0,5
EUW1_6883554026',2,26,19,1,0,2,0,8,1,322,84,31989,31098,35206,2,25,6,1,0,1,0,5,360,75,24053,27722,28480,1,-38,9,7936,13,3376,6726,0,0,1,0,3
EUW1_6883523044',3,34,22,2,0,1,0,10,1,308,66,32269,29138,38569,5,33,11,0,0,0,0,7,326,82,25456,26664,26093,1,-18,-16,6813,11,2474,12476,2,0,1,0,3
EUW1_6883461757',3,26,15,1,0,5,0,10,1,368,85,30970,29843,34830,7,26,11,1,0,1,0,8,308,88,27492,28954,30196,0,60,-3,3478,4,889,4634,0,0,4,0,2
EUW1_6882415132',7,39,12,1,0,1,0,8,0,367,84,28417,29431,31288,7,31,12,1,0,1,0,4,374,84,27381,29035,30674,1,-7,0,1036,0,396,614,0,0,0,0,4
EUW1_6882397272',4,28,12,1,0,0,0,10,0,369,88,26400,30475,31418,4,35,10,0,0,0,0,2,291,96,26195,27479,28753,1,78,-8,205,2,2996,2665,1,0,0,0,8
EUW1_6882390618',4,31,7,0,1,0,0,7,0,332,92,24557,28885,21298,2,26,11,2,0,0,0,3,393,120,28401,31311,27801,0,-61,-28,-3844,-4,-2426,-6503,-2,1,0,0,4
EUW1_6882378457',1,27,17,2,0,0,0,12,1,346,92,28762,31262,33778,2,27,6,0,0,0,0,2,374,93,24886,28938,33140,1,-28,-1,3876,11,2324,638,2,0,0,0,10
EUW1_6882352157',5,33,11,1,0,0,0,9,0,333,78,25868,26567,32211,2,27,20,1,1,1,0,1,329,109,31662,32227,35687,0,4,-31,-5794,-9,-5660,-3476,0,-1,-1,0,8
EUW1_6882344893',3,29,12,0,0,0,0,10,1,345,94,25651,30202,23246,3,30,13,1,0,1,0,4,385,74,28590,30333,23714,1,-40,20,-2939,-1,-131,-468,-1,0,-1,0,6
EUW1_6882328320',3,32,9,1,0,0,0,8,0,394,115,27644,31741,29162,5,31,12,1,0,2,0,5,371,88,27812,30268,27689,1,23,27,-168,-3,1473,1473,0,0,-2,0,3
EUW1_6882323710',4,27,17,1,0,3,0,16,1,329,74,31951,27265,32328,1,23,15,1,0,1,0,6,287,93,27359,27886,34523,1,42,-19,4592,2,-621,-2195,0,0,2,0,10
EUW1_6882306911',1,37,6,0,0,0,0,9,1,325,72,23185,23448,19348,1,33,4,1,1,2,0,2,400,106,26812,30216,20640,1,-75,-34,-3627,2,-6768,-1292,-1,-1,-2,0,7
EUW1_6882292111',3,33,14,0,0,2,0,10,0,338,72,29911,28278,39318,2,24,19,1,0,0,0,5,316,82,29045,27884,34600,1,22,-10,866,-5,394,4718,-1,0,2,0,5
EUW1_6882261044',8,30,25,2,0,2,0,10,0,334,101,32126,30880,42022,3,27,5,0,0,1,0,5,302,58,22327,21584,30141,1,32,43,9799,20,9296,11881,2,0,1,0,5
EUW1_6882934218',2,25,6,0,0,0,0,8,1,352,100,24568,27815,22068,3,24,8,2,1,0,0,2,346,115,25295,29209,23811,1,6,-15,-727,-2,-1394,-1743,-2,-1,0,0,6
EUW1_6882781415',4,154,9,0,0,0,0,11,1,321,59,24290,26907,30342,1,24,19,1,0,3,0,1,412,118,32735,32772,36505,0,-91,-59,-8445,-10,-5865,-6163,-1,0,-3,0,10
EUW1_6882754499',5,35,13,0,0,0,0,8,1,378,112,27672,31235,28736,3,27,13,1,0,1,0,1,392,96,29279,31882,29216,0,-14,16,-1607,0,-647,-480,-1,0,-1,0,7
EUW1_6882294310',4,30,24,0,0,2,0,5,1,335,102,33733,31760,48079,5,114,16,2,0,0,0,4,295,88,28416,28100,37638,1,40,14,5317,8,3660,10441,-2,0,2,0,1
EUW1_6882092933',2,23,9,0,0,1,0,14,0,338,82,25813,27713,35592,4,32,18,2,0,2,0,6,399,90,31202,32261,33976,0,-61,-8,-5389,-9,-4548,1616,-2,0,-1,0,8
EUW1_6882045085',6,34,16,0,1,1,0,6,1,378,72,30851,30005,39176,4,33,19,1,0,0,0,2,336,67,29168,29979,38805,1,42,5,1683,-3,26,371,-1,1,1,0,4
EUW1_6881993918',4,36,18,0,0,2,0,8,1,351,108,31774,31923,44288,6,35,9,2,0,0,0,5,363,80,25864,27229,37181,1,-12,28,5910,9,4694,7107,-2,0,2,0,3
EUW1_6881936228',2,23,23,1,1,2,0,7,1,331,90,33823,31246,43653,6,42,14,1,0,1,0,11,332,64,26769,30086,29987,1,-1,26,7054,9,1160,13666,0,1,1,0,-4
EUW1_6881803299',4,28,20,1,0,1,0,4,1,349,126,31352,31744,42468,5,35,15,0,0,0,0,5,329,81,27643,30338,38008,1,20,45,3709,5,1406,4460,1,0,1,0,-1
EUW1_6881746017',4,33,16,1,0,1,0,9,0,378,89,30555,30252,33108,4,37,14,1,0,2,0,6,374,101,29196,30820,35876,0,4,-12,1359,2,-568,-2768,0,0,-1,0,3
EUW1_6881681045',4,30,14,0,0,1,0,3,1,363,80,28809,28351,32945,7,32,12,2,0,0,0,6,332,68,26143,25991,26379,1,31,12,2666,2,2360,6566,-2,0,1,0,-3
EUW1_6880072684',7,31,10,0,0,0,0,17,1,305,75,24912,26543,28231,8,60,17,1,0,4,0,0,384,96,32142,30901,33859,0,-79,-21,-7230,-7,-4358,-5628,-1,0,-4,0,17
EUW1_6879999946',6,31,7,0,0,0,0,6,1,333,82,24337,26734,29086,8,33,11,2,0,0,0,2,373,99,26624,28780,24974,0,-40,-17,-2287,-4,-2046,4112,-2,0,0,0,4
EUW1_6878571723',4,31,23,1,1,2,0,9,1,391,82,33766,32713,39274,3,31,9,1,0,1,0,7,343,102,26662,29611,26039,1,48,-20,7104,14,3102,13235,0,1,1,0,2
EUW1_6878446530',7,34,6,0,0,0,0,10,0,361,92,24173,28452,21021,7,39,7,2,0,2,0,1,372,84,26289,29236,30647,0,-11,8,-2116,-1,-784,-9626,-2,0,-2,0,9
EUW1_6871896559',0,34,15,0,0,0,0,9,1,396,92,29929,31490,30617,5,34,15,1,1,1,0,5,360,79,30458,30195,41081,0,36,13,-529,0,1295,-10464,-1,-1,-1,0,4
EUW1_6871825296',4,30,8,1,0,0,0,5,0,357,62,25461,28154,33664,4,35,18,0,0,1,0,2,358,72,29194,31652,43906,0,-1,-10,-3733,-10,-3498,-10242,1,0,-1,0,3
EUW1_6870717308',7,29,11,0,1,1,0,6,0,348,80,26740,31116,32335,3,22,5,2,0,0,0,4,351,103,24067,29471,28901,1,-3,-23,2673,6,1645,3434,-2,1,1,0,2
EUW1_6870661845',1,32,17,1,1,2,0,9,0,332,108,30601,30293,24800,4,21,7,1,0,0,0,7,378,86,25093,26722,32368,1,-46,22,5508,10,3571,-7568,0,1,2,0,2
EUW1_6870601158',1,40,9,0,0,0,0,5,1,373,96,26507,29809,32446,4,32,6,1,0,0,0,3,400,79,24790,29212,22305,0,-27,17,1717,3,597,10141,-1,0,0,0,2
EUW1_6870524228',4,21,11,0,0,0,0,16,0,342,106,27632,29661,37941,6,30,16,2,0,2,0,1,343,99,30021,31884,31100,0,-1,7,-2389,-5,-2223,6841,-2,0,-2,0,15
EUW1_6869301219',3,30,17,0,0,1,0,12,0,359,72,29259,29343,35477,4,41,17,1,0,1,0,6,344,108,30781,30430,35234,1,15,-36,-1522,0,-1087,243,-1,0,0,0,6
EUW1_6869284261',4,38,9,1,1,0,0,11,0,377,82,25796,28370,22885,2,28,12,1,0,1,0,3,377,118,29178,32581,26386,0,0,-36,-3382,-3,-4211,-3501,0,1,-1,0,8
EUW1_6869282534',4,33,15,1,0,0,0,9,0,314,79,26946,28334,37317,4,29,22,0,0,1,0,1,366,103,32207,31551,43853,0,-52,-24,-5261,-7,-3217,-6536,1,0,-1,0,8
EUW1_6869259318',3,227,14,0,0,0,0,14,0,337,88,27514,29113,33970,2,44,21,1,0,3,0,4,333,96,32220,30970,40057,0,4,-8,-4706,-7,-1857,-6087,-1,0,-3,0,10
EUW1_6883401529',3,19,15,0,0,1,0,8,0,360,86,28959,30462,34902,0,93,9,1,0,0,0,4,337,100,25874,29027,27525,0,23,-14,3085,6,1435,7377,-1,0,1,0,4
EUW1_6882189296',3,30,9,0,1,0,0,7,1,375,92,27593,29961,30973,3,26,8,2,0,1,0,5,349,102,24908,29247,28426,1,26,-10,2685,1,714,2547,-2,1,-1,0,2
EUW1_6882159759',2,43,10,2,0,0,0,13,1,318,88,25480,26224,31768,1,56,12,0,0,1,0,0,386,81,28171,30076,38390,0,-68,7,-2691,-2,-3852,-6622,2,0,-1,0,13
EUW1_6882047377',5,33,16,1,0,0,0,10,0,316,89,27453,30822,31992,6,129,8,1,0,1,0,2,372,84,26100,29388,34562,1,-56,5,1353,8,1434,-2570,0,0,-1,0,8
EUW1_6882006719',3,31,13,1,0,0,0,14,0,332,96,26222,28669,26596,4,26,13,1,0,2,0,0,358,104,29893,30098,31756,0,-26,-8,-3671,0,-1429,-5160,0,0,-2,0,14
EUW1_6881950461',1,58,10,0,0,0,0,16,0,343,83,25937,29553,36736,5,60,18,2,0,2,0,0,352,103,30465,32999,44340,0,-9,-20,-4528,-8,-3446,-7604,-2,0,-2,0,16
EUW1_6881833733',1,21,12,1,0,1,0,9,0,337,104,27939,29560,36626,3,23,13,0,0,0,0,8,345,85,27024,29886,39620,1,-8,19,915,-1,-326,-2994,1,0,1,0,1
EUW1_6881306277',4,26,13,2,0,1,0,6,0,391,126,29664,32602,33384,4,24,11,0,0,1,0,6,351,72,27588,28554,30092,1,40,54,2076,2,4048,3292,2,0,0,0,0
EUW1_6881267411',7,26,13,1,0,3,0,8,0,387,110,30282,31952,33074,2,28,7,1,0,0,0,5,306,75,22851,25192,26286,1,81,35,7431,6,6760,6788,0,0,3,0,3
EUW1_6881194036',4,166,11,0,1,0,0,8,1,358,92,27201,29432,32704,3,29,19,1,0,1,0,1,383,56,30433,31462,38818,1,-25,36,-3232,-8,-2030,-6114,-1,1,-1,0,7
EUW1_6881140129',3,27,16,0,0,2,0,11,1,349,84,29682,30763,34000,1,27,8,2,0,1,0,7,362,95,26074,30294,26815,1,-13,-11,3608,8,469,7185,-2,0,1,0,4
EUW1_6881078462',3,206,10,1,0,0,0,11,0,294,72,24291,25025,32838,7,28,17,1,0,2,0,0,353,85,29901,29235,41544,0,-59,-13,-5610,-7,-4210,-8706,0,0,-2,0,11
EUW1_6880695609',3,24,18,0,0,0,0,8,1,293,82,28183,29413,35480,3,25,19,1,0,0,0,0,366,80,28735,30467,39597,1,-73,2,-552,-1,-1054,-4117,-1,0,0,0,8
EUW1_6880376023',5,21,13,0,0,0,0,10,0,355,94,27527,29960,23540,2,27,16,2,0,1,0,3,420,92,30291,32289,35851,1,-65,2,-2764,-3,-2329,-12311,-2,0,-1,0,7
EUW1_6880314067',1,33,10,0,0,1,0,16,0,309,81,25465,27466,30143,5,29,15,2,1,2,0,3,340,104,29768,29237,33080,0,-31,-23,-4303,-5,-1771,-2937,-2,-1,-1,0,13
EUW1_6880258802',6,29,15,2,0,0,0,6,1,360,90,28098,30138,35059,5,443,7,0,0,1,0,2,321,80,24046,26373,33381,1,39,10,4052,8,3765,1678,2,0,-1,0,4
EUW1_6864968671',3,25,9,0,0,2,0,12,1,346,103,26902,28847,24985,4,21,12,1,0,1,0,8,371,90,28311,31621,28839,1,-25,13,-1409,-3,-2774,-3854,-1,0,1,0,4
EUW1_6860172154',4,30,7,0,0,0,0,12,0,328,80,24676,28935,30605,2,35,13,1,0,1,0,2,341,103,28274,29726,26313,1,-13,-23,-3598,-6,-791,4292,-1,0,-1,0,10
EUW1_6860128795',3,26,11,1,0,0,0,8,0,349,78,25952,28985,35029,3,23,16,1,0,0,0,1,358,98,28897,32565,37539,0,-9,-20,-2945,-5,-3580,-2510,0,0,0,0,7
EUW1_6860080804',6,57,11,1,1,2,0,8,0,325,80,28357,28618,30691,6,27,11,0,0,0,0,6,357,75,27534,27906,30000,1,-32,5,823,0,712,691,1,1,2,0,2
EUW1_6860019881',5,30,11,2,0,0,0,8,0,362,97,27641,29723,33386,6,24,15,0,0,0,0,3,334,90,27913,28118,33488,1,28,7,-272,-4,1605,-102,2,0,0,0,5
EUW1_6859239958',3,36,14,0,1,3,0,5,1,390,100,31499,31994,37720,3,34,7,1,0,0,0,6,334,92,24799,27963,24964,1,56,8,6700,7,4031,12756,-1,1,3,0,-1
EUW1_6859198067',4,32,11,2,1,1,0,8,0,355,104,28116,30595,28757,4,39,8,0,0,1,0,4,376,88,26337,28990,24469,1,-21,16,1779,3,1605,4288,2,1,0,0,4
EUW1_6859164677',4,29,14,1,1,1,0,8,1,337,110,28928,30506,30399,5,35,7,1,0,1,0,7,323,80,24638,24909,24751,1,14,30,4290,7,5597,5648,0,1,0,0,1
EUW1_6857852883',6,36,21,2,0,1,0,10,1,312,75,30728,30499,43597,2,21,12,0,0,0,0,4,338,84,27687,28545,37668,1,-26,-9,3041,9,1954,5929,2,0,1,0,6
EUW1_6857805009',5,25,8,0,0,0,0,13,0,344,86,25589,28505,24909,3,26,20,2,0,2,0,1,378,100,33221,32445,34722,1,-34,-14,-7632,-12,-3940,-9813,-2,0,-2,0,12
EUW1_6857774145',7,29,9,0,0,0,0,7,1,324,83,25637,27550,32807,5,31,23,2,0,1,0,2,376,94,31391,33585,36928,0,-52,-11,-5754,-14,-6035,-4121,-2,0,-1,0,5
EUW1_6856500385',3,28,9,0,0,0,0,10,0,315,53,24062,27255,34431,11,36,14,1,0,0,0,1,341,68,27683,27941,37373,0,-26,-15,-3621,-5,-686,-2942,-1,0,0,0,9
EUW1_6855345489',4,23,25,1,0,7,1,5,1,409,99,36361,33197,44307,0,21,5,1,0,0,0,11,250,80,21222,25238,22684,1,159,19,15139,20,7959,21623,0,0,7,1,-6
EUW1_6855311777',3,28,8,1,0,0,0,10,0,333,88,26436,28228,34158,3,29,26,0,0,1,0,4,374,94,34511,33902,39606,0,-41,-6,-8075,-18,-5674,-5448,1,0,-1,0,6
EUW1_6852599192',3,28,9,1,0,0,0,5,1,394,85,25890,29699,30218,1,24,4,0,0,1,0,4,365,98,24512,28984,28785,1,29,-13,1378,5,715,1433,1,0,-1,0,1
EUW1_6852526914',6,42,13,1,0,1,0,15,0,361,90,29168,29763,36895,4,26,21,0,0,1,0,5,338,93,32114,31411,43348,1,23,-3,-2946,-8,-1648,-6453,1,0,0,0,10
EUW1_6852460653',7,35,6,0,0,0,0,7,0,380,81,25393,30036,25935,7,39,12,2,0,0,0,4,403,109,27925,31779,29109,0,-23,-28,-2532,-6,-1743,-3174,-2,0,0,0,3
EUW1_6851923617',3,49,16,0,0,1,0,10,1,377,86,31198,31481,33379,4,30,11,1,0,2,0,5,350,90,27389,29906,37696,1,27,-4,3809,5,1575,-4317,-1,0,-1,0,5
EUW1_6851887231',2,30,18,1,0,2,0,9,1,349,92,31489,31585,38096,3,26,11,1,0,0,0,4,328,80,25726,27605,30526,1,21,12,5763,7,3980,7570,0,0,2,0,5
EUW1_6883344441',7,31,13,0,0,0,0,7,0,379,84,28684,30195,36549,4,22,10,1,0,1,0,5,355,92,27001,28544,32157,0,24,-8,1683,3,1651,4392,-1,0,-1,0,2
EUW1_6883296583',1,28,9,0,0,0,0,11,0,321,88,23793,27908,29449,4,22,21,2,0,2,0,5,356,64,30963,31203,40005,0,-35,24,-7170,-12,-3295,-10556,-2,0,-2,0,6
EUW1_6882944269',5,32,12,2,1,1,0,9,0,380,87,28133,31179,26675,3,28,7,0,0,0,0,5,382,84,26076,28263,23042,1,-2,3,2057,5,2916,3633,2,1,1,0,4
EUW1_6882669512',1,25,22,1,0,3,0,7,1,360,69,33578,32406,37293,4,28,9,1,0,0,0,8,372,76,24876,27754,28498,1,-12,-7,8702,13,4652,8795,0,0,3,0,-1
EUW1_6882577547',1,28,13,1,0,1,0,12,0,351,98,28686,29637,33850,1,31,12,0,0,1,0,1,356,81,28304,28906,27334,0,-5,17,382,1,731,6516,1,0,0,0,11
EUW1_6882508130',9,54,8,0,0,0,0,8,0,360,83,25404,28080,23342,3,43,16,2,1,1,0,5,404,86,30317,31584,27978,0,-44,-3,-4913,-8,-3504,-4636,-2,-1,-1,0,3
EUW1_6882457252',3,28,11,1,1,0,0,8,0,361,102,26595,28641,27313,3,31,10,1,0,2,0,2,385,74,27827,29116,33376,0,-24,28,-1232,1,-475,-6063,0,1,-2,0,6
EUW1_6882130731',2,33,12,0,0,0,0,4,0,342,92,27434,27997,36328,8,32,18,1,0,0,0,1,352,62,29261,29190,41324,0,-10,30,-1827,-6,-1193,-4996,-1,0,0,0,3
EUW1_6882069197',6,33,11,1,1,0,0,15,0,367,96,26500,29519,25644,4,43,9,1,0,2,0,2,378,91,27812,30004,25426,0,-11,5,-1312,2,-485,218,0,1,-2,0,13
EUW1_6881869895',8,32,14,2,1,3,0,5,1,372,120,30614,29434,30351,0,16,3,0,0,1,0,9,275,80,20457,23372,17355,1,97,40,10157,11,6062,12996,2,1,2,0,-4
EUW1_6881822119',4,26,26,0,1,3,0,6,1,401,118,34954,34636,39878,2,20,4,0,0,0,0,9,289,33,20649,23259,26701,1,112,85,14305,22,11377,13177,0,1,3,0,-3
EUW1_6881772869',6,37,9,0,0,0,0,15,1,376,80,26046,30711,30317,3,23,12,2,0,2,0,0,414,99,30260,34254,33862,0,-38,-19,-4214,-3,-3543,-3545,-2,0,-2,0,15
EUW1_6881699334',3,47,10,1,1,1,0,10,1,385,90,27868,30945,31945,3,18,9,1,0,1,0,4,361,77,26514,30875,28350,1,24,13,1354,1,70,3595,0,1,0,0,6
EUW1_6862438173',1,29,11,0,0,1,0,14,0,349,88,27703,28426,21953,3,39,10,2,0,0,0,2,328,100,25674,28968,22947,0,21,-12,2029,1,-542,-994,-2,0,1,0,12
EUW1_6862327940',6,134,16,1,0,1,0,7,1,323,84,29507,29039,37170,1,23,19,1,0,0,0,5,329,82,29806,29713,33674,1,-6,2,-299,-3,-674,3496,0,0,1,0,2
EUW1_6862280906',2,26,14,1,0,2,0,7,1,334,108,30974,32431,37060,2,37,22,1,0,0,0,9,340,63,30403,29611,45920,0,-6,45,571,-8,2820,-8860,0,0,2,0,-2
EUW1_6883472662',5,27,9,1,0,0,0,14,0,341,93,26055,28327,33776,3,28,14,1,1,1,0,5,346,94,27604,29292,35272,0,-5,-1,-1549,-5,-965,-1496,0,-1,-1,0,9
EUW1_6883381053',2,28,8,0,0,0,0,8,1,337,93,25373,28895,26026,5,37,9,2,0,1,0,5,397,82,27254,31023,27069,0,-60,11,-1881,-1,-2128,-1043,-2,0,-1,0,3
EUW1_6882905157',4,31,8,1,1,2,0,9,1,396,103,27866,29118,27215,4,34,13,1,0,0,0,9,265,106,26434,25871,28201,1,131,-3,1432,-5,3247,-986,0,1,2,0,0
EUW1_6882808907',4,23,12,0,0,0,0,7,0,343,84,25510,29655,35583,3,25,13,0,0,0,0,1,348,90,27269,31403,38495,0,-5,-6,-1759,-1,-1748,-2912,0,0,0,0,6
EUW1_6882736041',8,247,11,0,0,1,0,6,0,376,100,28257,31728,27586,5,29,11,2,0,0,0,3,356,88,25563,29070,25077,0,20,12,2694,0,2658,2509,-2,0,1,0,3
EUW1_6882678435',4,28,13,1,0,0,0,8,1,358,82,26382,29085,36027,0,25,8,0,0,1,0,3,346,74,25414,27838,34012,1,12,8,968,5,1247,2015,1,0,-1,0,5
EUW1_6882298184',3,27,15,0,0,0,0,7,0,307,68,27367,28795,40235,3,31,14,1,0,0,0,3,359,96,27791,29165,39978,1,-52,-28,-424,1,-370,257,-1,0,0,0,4
EUW1_6882245615',2,27,11,0,0,0,0,12,0,316,75,25512,28020,30365,4,27,13,1,0,1,0,2,379,62,27663,28949,39921,1,-63,13,-2151,-2,-929,-9556,-1,0,-1,0,10
EUW1_6882220437',3,21,19,2,0,3,0,0,1,381,85,31863,30637,37878,1,32,10,0,0,0,0,7,328,66,25310,26341,32162,1,53,19,6553,9,4296,5716,2,0,3,0,-7
EUW1_6881923518',0,26,14,1,0,1,0,11,1,312,93,27417,26480,32750,5,29,18,0,0,0,0,1,325,76,29934,29063,34402,0,-13,17,-2517,-4,-2583,-1652,1,0,1,0,10
EUW1_6881855172',3,160,15,0,0,0,0,11,0,323,88,27466,30385,31701,10,34,8,2,0,1,0,1,368,84,25824,27932,28644,1,-45,4,1642,7,2453,3057,-2,0,-1,0,10
EUW1_6877518579',4,48,19,0,0,0,0,10,1,339,84,30375,30351,35689,3,26,12,2,0,2,0,3,373,82,28735,29248,33787,0,-34,2,1640,7,1103,1902,-2,0,-2,0,7
EUW1_6877449266',4,25,4,1,0,0,0,7,0,375,113,24616,29117,20678,5,50,6,0,0,2,0,3,421,95,26923,30414,21663,0,-46,18,-2307,-2,-1297,-985,1,0,-2,0,4
EUW1_6877080706',6,29,7,1,0,1,0,8,0,338,100,26263,28797,26924,3,91,15,0,0,0,0,5,365,80,27623,31889,31869,0,-27,20,-1360,-8,-3092,-4945,1,0,1,0,3
EUW1_6857401011',0,25,16,0,1,0,0,9,0,367,100,29153,31547,36679,3,25,14,2,0,0,0,3,337,99,27397,28467,38837,0,30,1,1756,2,3080,-2158,-2,1,0,0,6
EUW1_6856266988',2,30,7,1,0,0,0,12,0,363,92,24689,28988,23298,4,28,17,1,1,0,0,0,428,112,31296,34688,32523,0,-65,-20,-6607,-10,-5700,-9225,0,-1,0,0,12
EUW1_6856225519',3,32,15,1,0,3,0,10,1,386,94,31208,30248,28827,2,42,5,1,0,0,0,8,372,85,24569,28212,27988,1,14,9,6639,10,2036,839,0,0,3,0,2
EUW1_6855769729',1,27,9,1,0,0,0,8,1,369,79,25656,27706,25713,5,98,14,0,0,1,0,4,383,90,28059,31852,26587,1,-14,-11,-2403,-5,-4146,-874,1,0,-1,0,4
EUW1_6855722454',3,22,9,2,0,0,0,9,1,355,94,24734,28808,34927,1,24,16,0,1,2,0,2,354,114,31272,32221,30082,0,1,-20,-6538,-7,-3413,4845,2,-1,-2,0,7
EUW1_6855698480',8,36,20,1,0,1,0,9,0,399,98,32686,33013,44501,0,38,7,0,0,0,0,3,340,61,25443,26289,23685,1,59,37,7243,13,6724,20816,1,0,1,0,6
EUW1_6855665886',3,30,8,0,0,0,0,5,0,406,89,26318,30606,24648,3,32,10,2,0,1,0,4,379,104,27051,30828,27743,1,27,-15,-733,-2,-222,-3095,-2,0,-1,0,1
EUW1_6855647886',6,33,14,2,1,2,0,7,1,404,119,32830,32402,26613,0,23,2,0,0,1,0,8,337,52,20988,25156,13932,1,67,67,11842,12,7246,12681,2,1,1,0,-1
EUW1_6855608225',7,30,15,2,1,2,0,3,1,383,94,30441,30798,33751,5,30,5,0,0,0,0,6,330,70,22854,25538,23448,1,53,24,7587,10,5260,10303,2,1,2,0,-3
EUW1_6855377851',7,26,10,0,0,1,0,13,1,348,10,27467,25989,32829,1,25,17,1,0,2,0,6,396,95,30869,32380,42228,0,-48,-85,-3402,-7,-6391,-9399,-1,0,-1,0,7
EUW1_6855272905',5,143,18,1,1,0,0,9,0,319,95,29721,28767,42635,2,58,19,1,0,0,0,5,345,83,31022,30991,36727,0,-26,12,-1301,-1,-2224,5908,0,1,0,0,4
EUW1_6855159889',4,31,9,0,0,0,0,4,0,381,72,26477,27584,26889,5,28,12,1,0,1,0,5,388,102,28872,31714,28079,1,-7,-30,-2395,-3,-4130,-1190,-1,0,-1,0,-1
EUW1_6854093817',9,34,11,2,0,0,0,7,0,386,58,24991,29436,21782,3,32,9,0,0,1,0,2,420,88,27912,30277,24846,0,-34,-30,-2921,2,-841,-3064,2,0,-1,0,5
EUW1_6854072783',2,33,6,0,0,0,0,12,0,342,78,24449,26675,22463,3,32,19,1,0,3,0,0,421,100,32559,33069,42363,0,-79,-22,-8110,-13,-6394,-19900,-1,0,-3,0,12
EUW1_6854037525',1,28,16,2,1,0,0,7,1,398,110,31170,33137,37283,5,64,9,0,0,1,0,4,357,57,24465,26222,27858,1,41,53,6705,7,6915,9425,2,1,-1,0,3
EUW1_6853658048',2,22,16,0,0,1,0,10,1,381,80,30167,32167,37015,3,21,14,1,0,0,0,4,324,80,27570,29415,31812,1,57,0,2597,2,2752,5203,-1,0,1,0,6
EUW1_6853625900',4,20,24,2,0,3,0,6,1,425,112,36259,36473,49415,3,20,11,0,0,0,0,10,339,67,25448,27345,31500,1,86,45,10811,13,9128,17915,2,0,3,0,-4
EUW1_6853547846',3,138,8,0,0,2,0,8,0,359,67,26447,27587,33263,4,36,21,2,0,0,0,4,382,104,31129,32620,40762,0,-23,-37,-4682,-13,-5033,-7499,-2,0,2,0,4
EUW1_6881117644',2,24,7,1,0,0,0,12,0,336,113,24450,27334,23496,5,32,17,1,0,2,0,1,408,98,29405,31099,32132,0,-72,15,-4955,-10,-3765,-8636,0,0,-2,0,11
EUW1_6880769255',4,89,26,1,0,1,0,12,1,314,81,31889,31121,39743,3,30,13,0,0,1,0,3,281,94,27326,25934,39060,1,33,-13,4563,13,5187,683,1,0,0,0,9
EUW1_6880523756',3,29,5,0,0,1,0,4,1,399,90,25980,29405,21705,3,63,14,2,1,0,0,7,394,98,29934,31005,26657,0,5,-8,-3954,-9,-1600,-4952,-2,-1,1,0,-3
EUW1_6880439314',4,31,14,2,0,2,0,10,1,396,90,31586,29951,34809,3,39,9,0,0,2,0,8,365,86,26862,29937,28712,0,31,4,4724,5,14,6097,2,0,0,0,2
EUW1_6880283445',3,32,14,1,1,1,0,3,1,387,86,30038,30592,27877,2,25,6,0,0,0,0,9,354,78,23934,27315,24819,0,33,8,6104,8,3277,3058,1,1,1,0,-6
EUW1_6880228750',1,35,15,2,0,2,0,11,0,336,91,28716,29211,37492,0,22,14,0,1,1,0,8,313,91,28416,30663,33924,1,23,0,300,1,-1452,3568,2,-1,1,0,3
EUW1_6880019221',2,21,6,0,0,0,0,17,0,361,65,22969,25316,20066,3,44,8,1,0,5,0,1,420,105,32045,30362,21719,0,-59,-40,-9076,-2,-5046,-1653,-1,0,-5,0,16
EUW1_6879814165',4,22,26,0,0,2,0,11,1,346,91,34582,30823,43363,6,32,19,1,0,1,0,4,283,79,28022,27396,38758,0,63,12,6560,7,3427,4605,-1,0,1,0,7
EUW1_6871425433',1,19,11,1,0,8,0,4,1,383,113,31525,29346,18523,1,16,4,0,0,0,1,12,221,54,18247,19986,10383,1,162,59,13278,7,9360,8140,1,0,8,-1,-8
EUW1_6882866167',6,44,15,0,0,0,0,5,0,358,91,28304,31812,36104,3,28,15,1,0,0,0,4,354,69,29315,29563,46205,0,4,22,-1011,0,2249,-10101,-1,0,0,0,1
EUW1_6882713953',9,60,22,1,0,2,0,6,1,382,104,33732,33093,37762,5,38,8,1,0,1,0,10,334,76,25010,27856,21526,1,48,28,8722,14,5237,16236,0,0,1,0,-4
EUW1_6881360401',3,40,12,1,1,2,0,11,0,357,108,29550,30563,33824,4,26,11,1,0,1,0,6,323,82,26551,26770,26627,1,34,26,2999,1,3793,7197,0,1,1,0,5
EUW1_6878632935',4,30,17,2,0,1,0,4,1,378,88,29199,30512,41303,3,24,9,0,1,0,0,6,321,80,24547,29713,36711,1,57,8,4652,8,799,4592,2,-1,1,0,-2
EUW1_6868493731',5,27,19,2,0,1,0,7,0,371,101,30638,31004,36445,6,30,15,0,0,0,0,1,334,66,28457,29757,29788,0,37,35,2181,4,1247,6657,2,0,1,0,6
EUW1_6865768894',3,37,19,0,0,0,0,12,1,360,76,30143,30320,31906,7,30,15,1,0,0,0,2,387,106,30787,31275,36757,1,-27,-30,-644,4,-955,-4851,-1,0,0,0,10
EUW1_6865104359',4,39,13,0,0,0,0,7,0,335,79,27030,28728,34538,7,38,14,2,0,2,0,3,370,76,28863,30253,33457,0,-35,3,-1833,-1,-1525,1081,-2,0,-2,0,4
EUW1_6865056601',6,35,11,2,0,1,0,5,1,405,93,29240,31597,34657,3,355,7,0,0,1,0,11,329,94,25030,28957,30407,1,76,-1,4210,4,2640,4250,2,0,0,0,-6
EUW1_6863792812',9,36,13,0,0,0,0,11,0,314,82,28238,27737,32806,2,23,13,1,0,2,0,4,286,80,25457,27375,29803,0,28,2,2781,0,362,3003,-1,0,-2,0,7
EUW1_6863750013',2,38,5,0,0,0,0,10,0,341,75,22911,27658,21283,4,31,15,2,1,1,0,1,386,108,29857,31800,32066,0,-45,-33,-6946,-10,-4142,-10783,-2,-1,-1,0,9
EUW1_6863499151',4,298,9,0,0,0,0,9,0,386,100,26591,31102,26974,5,141,11,2,0,0,0,3,368,92,26409,28118,35601,0,18,8,182,-2,2984,-8627,-2,0,0,0,6
EUW1_6876836513',3,28,12,2,0,2,0,5,0,405,116,29562,33073,38361,3,26,6,0,0,0,0,5,386,87,25424,29668,26216,1,19,29,4138,6,3405,12145,2,0,2,0,0
EUW1_6876779347',2,28,4,1,0,0,0,12,1,312,81,22586,25873,34401,3,197,22,1,0,2,0,1,367,97,30961,32737,40496,0,-55,-16,-8375,-18,-6864,-6095,0,0,-2,0,11
EUW1_6876721616',4,27,24,2,0,3,0,6,1,428,87,34977,32637,39973,7,37,13,0,0,0,0,14,316,80,27247,28399,33822,1,112,7,7730,11,4238,6151,2,0,3,0,-8
EUW1_6876678301',3,28,14,2,0,1,0,10,1,395,84,29584,30303,32472,3,28,12,0,0,0,0,4,399,80,28813,30279,27064,0,-4,4,771,2,24,5408,2,0,1,0,6
EUW1_6875514067',3,58,20,1,0,2,0,5,1,384,83,32093,29786,31300,4,30,2,0,0,0,0,7,309,100,21321,24472,23836,1,75,-17,10772,18,5314,7464,1,0,2,0,-2
EUW1_6875386200',5,43,13,1,0,0,0,10,1,331,80,27275,28638,28495,6,48,14,1,0,1,0,2,353,82,28108,29356,33620,1,-22,-2,-833,-1,-718,-5125,0,0,-1,0,8
EUW1_6875361504',2,26,11,2,1,0,0,9,0,366,102,26845,30038,24860,4,27,12,0,0,1,0,1,412,92,29593,31957,38450,1,-46,10,-2748,-1,-1919,-13590,2,1,-1,0,8
EUW1_6875060110',4,104,19,0,0,2,0,9,1,334,96,31872,30503,36078,4,44,12,1,0,1,0,8,384,91,28301,29328,31714,1,-50,5,3571,7,1175,4364,-1,0,1,0,1
EUW1_6875034052',2,22,15,0,0,0,0,13,0,395,69,28506,28831,38630,10,38,14,2,0,1,0,4,329,97,29347,29402,33168,0,66,-28,-841,1,-571,5462,-2,0,-1,0,9
EUW1_6875022519',9,30,16,1,0,1,0,16,0,324,55,27733,26733,32566,2,28,10,0,0,2,0,4,349,90,28827,28338,33052,1,-25,-35,-1094,6,-1605,-486,1,0,-1,0,12
EUW1_6874994860',2,30,15,0,0,0,0,9,0,360,94,28558,30361,34753,1,29,11,1,1,1,0,0,391,78,27926,28358,29927,0,-31,16,632,4,2003,4826,-1,-1,-1,0,9
EUW1_6874967283',5,31,14,1,0,0,0,18,1,317,76,26802,27548,25726,5,33,16,1,0,3,0,0,404,112,32170,31024,36390,0,-87,-36,-5368,-2,-3476,-10664,0,0,-3,0,18
EUW1_6874927522',6,29,14,0,0,1,0,15,1,356,72,28826,28924,34655,5,25,14,2,0,3,0,4,351,103,30570,30267,35909,0,5,-31,-1744,0,-1343,-1254,-2,0,-2,0,11
EUW1_6874883027',3,35,17,0,1,3,0,7,0,380,73,31050,31620,31696,1,24,10,1,0,0,0,11,368,101,25999,29755,24801,1,12,-28,5051,7,1865,6895,-1,1,3,0,-4
EUW1_6873720080',1,21,5,1,0,0,0,10,0,296,93,23358,25792,22826,6,32,12,0,0,1,0,5,365,94,27975,28392,29322,1,-69,-1,-4617,-7,-2600,-6496,1,0,-1,0,5
EUW1_6873712731',5,26,8,1,0,0,0,9,1,342,101,24869,27993,26284,4,34,20,0,0,2,0,0,364,86,30272,30047,39175,0,-22,15,-5403,-12,-2054,-12891,1,0,-2,0,9
EUW1_6873687168',3,22,11,1,1,0,0,7,1,419,91,27172,29703,25946,2,33,9,0,0,0,0,1,362,67,25073,28768,25196,1,57,24,2099,2,935,750,1,1,0,0,6
EUW1_6873666999',3,29,16,2,0,1,0,10,1,353,68,29398,28800,27171,3,24,11,0,0,0,0,4,335,88,26466,28567,28983,0,18,-20,2932,5,233,-1812,2,0,1,0,6
EUW1_6869529932',1,23,12,0,0,1,0,7,1,351,78,27717,27977,31461,6,28,14,2,0,0,0,5,319,96,26774,28394,31201,1,32,-18,943,-2,-417,260,-2,0,1,0,2
EUW1_6869497488',3,27,11,0,0,1,0,11,1,346,98,27888,29651,34222,4,29,9,2,0,0,0,7,315,84,25257,28914,22089,1,31,14,2631,2,737,12133,-2,0,1,0,4
EUW1_6864262904',7,33,11,0,0,0,0,10,0,375,78,27221,30977,31851,7,40,13,1,0,1,0,4,371,72,28530,29681,29032,0,4,6,-1309,-2,1296,2819,-1,0,-1,0,6
EUW1_6864180333',4,119,11,1,0,2,0,9,0,411,78,28470,30290,28071,7,139,8,1,0,1,0,3,361,86,26392,28523,24134,0,50,-8,2078,3,1767,3937,0,0,1,0,6
EUW1_6864119428',5,22,8,0,1,1,0,12,0,380,80,27384,29908,30940,8,26,22,2,0,1,0,4,359,115,31788,31555,34416,0,21,-35,-4404,-14,-1647,-3476,-2,1,0,0,8
EUW1_6863130327',4,29,16,1,0,0,0,11,1,385,86,30386,30957,39837,4,27,19,0,0,0,0,6,326,79,28811,28960,37180,1,59,7,1575,-3,1997,2657,1,0,0,0,5
EUW1_6863106661',9,59,13,2,0,1,0,8,0,354,98,27975,30643,28659,5,28,8,0,0,1,0,5,363,97,25625,27691,21109,0,-9,1,2350,5,2952,7550,2,0,0,0,3
EUW1_6862672004',5,30,16,1,0,0,0,9,1,372,82,28642,30831,39999,4,22,9,1,0,0,0,4,348,96,25567,29325,34625,1,24,-14,3075,7,1506,5374,0,0,0,0,5
EUW1_6862619281',3,28,12,0,1,1,0,11,1,395,87,28631,31738,34641,5,27,9,2,0,0,0,7,336,96,25664,28720,31357,1,59,-9,2967,3,3018,3284,-2,1,1,0,4
EUW1_6862580686',2,20,15,1,0,4,0,7,1,392,102,32913,32675,40344,4,25,3,0,0,1,0,8,320,81,21047,24989,21392,1,72,21,11866,12,7686,18952,1,0,3,0,-1
EUW1_6861868519',4,26,4,0,0,0,0,9,0,320,98,22973,28377,23737,2,25,12,2,1,2,0,0,411,112,29813,33185,35374,0,-91,-14,-6840,-8,-4808,-11637,-2,-1,-2,0,9
EUW1_6861830181',4,27,18,1,0,2,0,7,1,390,116,33376,33634,30547,4,30,4,0,0,1,0,5,358,96,24116,28217,20342,1,32,20,9260,14,5417,10205,1,0,1,0,2
EUW1_6861791463',3,30,15,1,0,0,0,6,1,393,86,29318,31405,41650,1,29,14,1,0,0,0,2,350,81,26763,31855,31624,0,43,5,2555,1,-450,10026,0,0,0,0,4
EUW1_6861733631',5,40,12,1,0,0,0,8,0,336,81,26611,29168,29863,6,39,14,1,0,0,0,4,375,78,28162,30032,36667,0,-39,3,-1551,-2,-864,-6804,0,0,0,0,4
EUW1_6861682884',4,29,8,0,0,0,0,10,0,303,79,24537,27334,27103,5,39,17,1,1,1,0,3,333,120,30513,32731,32019,0,-30,-41,-5976,-9,-5397,-4916,-1,-1,-1,0,7
EUW1_6861591374',4,45,13,0,1,0,0,4,1,344,97,27484,28653,28332,4,52,13,1,0,0,0,3,354,86,27880,29534,33252,0,-10,11,-396,0,-881,-4920,-1,1,0,0,1
EUW1_6883433917',6,55,20,0,0,1,0,8,1,382,91,30992,31165,34574,0,28,8,0,0,1,0,1,357,83,25466,28237,30649,1,25,8,5526,12,2928,3925,0,0,0,0,7
EUW1_6880670477',2,27,9,0,0,0,0,6,1,381,102,27111,29601,30331,3,22,16,2,1,0,0,5,345,98,28965,32888,36181,0,36,4,-1854,-7,-3287,-5850,-2,-1,0,0,1
EUW1_6880603127',5,30,17,1,0,0,0,11,0,333,98,29983,31219,42678,3,22,17,1,0,1,0,0,332,74,29825,29716,39267,1,1,24,158,0,1503,3411,0,0,-1,0,11
EUW1_6877786401',2,31,13,1,0,1,0,5,1,393,88,29590,29505,26458,4,30,10,0,0,0,0,6,369,100,25945,30567,33866,1,24,-12,3645,3,-1062,-7408,1,0,1,0,-1
EUW1_6863067340',5,21,9,0,0,0,0,8,0,390,88,26639,30891,26881,4,28,10,2,0,0,0,2,395,103,27037,30811,29741,1,-5,-15,-398,-1,80,-2860,-2,0,0,0,6
EUW1_6857872082',1,24,19,1,0,1,0,14,1,324,85,31534,27305,39849,0,47,21,0,0,2,0,7,355,86,32747,29971,40064,0,-31,-1,-1213,-2,-2666,-215,1,0,-1,0,7
EUW1_6855306965',0,24,13,0,0,1,0,14,0,335,62,27010,27277,33120,1,56,23,2,0,2,0,2,362,105,33214,31252,45712,0,-27,-43,-6204,-10,-3975,-12592,-2,0,-1,0,12
EUW1_6855251330',5,49,9,0,0,1,0,7,0,388,90,26353,30387,34551,4,25,8,2,0,0,0,3,349,98,25109,28724,23578,1,39,-8,1244,1,1663,10973,-2,0,1,0,4
EUW1_6855214935',6,28,6,0,0,0,0,7,1,376,94,25551,27831,24871,2,34,11,2,0,0,0,1,368,89,26066,29366,24963,1,8,5,-515,-5,-1535,-92,-2,0,0,0,6
EUW1_6842066162',3,32,14,0,0,2,0,7,1,387,95,30767,31190,39545,4,31,11,2,0,0,0,8,354,96,26862,30781,24895,1,33,-1,3905,3,409,14650,-2,0,2,0,-1
EUW1_6842025251',2,40,13,1,0,2,0,9,0,397,106,30756,31887,30752,2,25,7,1,0,0,0,3,359,90,24775,26840,29135,1,38,16,5981,6,5047,1617,0,0,2,0,6
EUW1_6838493456',3,44,20,0,0,1,0,10,1,362,106,32247,32060,39797,2,23,16,1,0,0,0,3,362,71,28695,29360,32634,1,0,35,3552,4,2700,7163,-1,0,1,0,7
EUW1_6838437872',3,32,18,0,0,2,0,4,0,366,108,32100,32770,44868,5,26,12,1,0,0,0,8,299,60,25628,25632,35576,1,67,48,6472,6,7138,9292,-1,0,2,0,-4
EUW1_6838373209',6,33,9,0,0,0,0,9,0,352,79,25244,29877,32116,2,27,14,2,0,1,0,1,396,85,28731,30873,37702,0,-44,-6,-3487,-5,-996,-5586,-2,0,-1,0,8
EUW1_6837663435',5,29,14,1,0,3,0,8,1,387,83,30971,31260,35626,4,135,5,1,0,0,0,9,327,80,23442,27019,25014,1,60,3,7529,9,4241,10612,0,0,3,0,-1
EUW1_6837595308',1,24,18,2,0,0,0,4,0,356,102,29810,32194,31763,5,43,12,0,0,1,0,3,350,84,26165,27433,34045,1,6,18,3645,6,4761,-2282,2,0,-1,0,1
EUW1_6837540581',3,29,14,0,0,1,0,9,1,357,86,30178,30145,35405,3,25,16,2,0,0,0,5,356,84,29071,32133,34778,1,1,2,1107,-2,-1988,627,-2,0,1,0,4
EUW1_6837434897',1,24,10,1,0,0,0,5,0,352,74,26265,31297,28288,7,31,10,1,0,0,0,4,351,106,26936,29525,25891,1,1,-32,-671,0,1772,2397,0,0,0,0,1
EUW1_6837379640',3,27,12,2,0,0,0,6,0,345,80,26525,28979,33926,8,30,17,0,1,1,0,2,360,75,29053,31506,33531,0,-15,5,-2528,-5,-2527,395,2,-1,-1,0,4
EUW1_6880987170',6,33,16,0,0,0,0,5,1,377,90,28767,30997,36689,4,34,7,1,0,1,0,3,344,93,25117,27776,34799,1,33,-3,3650,9,3221,1890,-1,0,-1,0,2
EUW1_6880191409',7,153,5,0,0,0,0,5,0,375,89,25270,28503,29644,2,20,12,1,0,1,0,2,360,111,27091,31255,30877,0,15,-22,-1821,-7,-2752,-1233,-1,0,-1,0,3
EUW1_6879928336',1,29,6,0,0,0,0,10,1,331,61,24004,26501,26727,11,34,28,2,0,2,0,3,376,108,33155,34723,47644,0,-45,-47,-9151,-22,-8222,-20917,-2,0,-2,0,7
EUW1_6879744118',4,85,10,1,0,1,0,10,1,374,73,27190,28588,28268,5,25,4,1,0,2,0,5,353,90,22906,28324,18788,1,21,-17,4284,6,264,9480,0,0,-1,0,5
EUW1_6879701655',3,238,5,1,0,0,0,9,1,360,82,25095,29049,22593,4,27,18,1,0,1,0,2,384,118,30999,33109,35320,0,-24,-36,-5904,-13,-4060,-12727,0,0,-1,0,7
EUW1_6879558193',1,24,10,1,1,0,0,6,0,304,91,25697,29249,36012,6,23,13,1,0,0,0,2,345,86,26589,29354,39473,1,-41,5,-892,-3,-105,-3461,0,1,0,0,4
EUW1_6879531901',5,32,24,1,0,0,0,11,0,389,76,31460,32068,40850,4,28,11,0,0,1,0,3,368,86,30233,30552,34543,1,21,-10,1227,13,1516,6307,1,0,-1,0,8
EUW1_6879493157',4,27,12,1,0,0,0,11,1,321,87,25201,27403,31157,1,22,10,0,0,2,0,3,320,92,27557,28447,25953,0,1,-5,-2356,2,-1044,5204,1,0,-2,0,8
EUW1_6878314621',7,25,26,1,0,2,0,9,1,369,79,35303,33864,45069,1,22,18,1,0,1,0,6,297,118,29568,29978,35964,1,72,-39,5735,8,3886,9105,0,0,1,0,3
EUW1_6877009889',5,32,19,2,0,1,0,15,0,339,96,31183,30835,33608,2,28,15,0,0,2,0,3,340,78,30195,29222,32973,1,-1,18,988,4,1613,635,2,0,-1,0,12
EUW1_6883663319',4,39,16,1,0,0,0,8,1,308,118,27392,29560,31608,1,185,8,0,0,0,0,5,296,62,23712,23558,28761,1,12,56,3680,8,6002,2847,1,0,0,0,3
EUW1_6883661649',1,28,7,1,0,0,0,8,1,305,78,22927,26001,21979,1,37,15,1,0,2,0,3,381,102,29421,31488,29140,0,-76,-24,-6494,-8,-5487,-7161,0,0,-2,0,5
EUW1_6883593419',0,22,6,1,0,0,0,11,0,386,70,25199,28764,26368,4,26,12,1,0,0,0,3,352,100,26702,31979,30558,0,34,-30,-1503,-6,-3215,-4190,0,0,0,0,8
EUW1_6883559929',3,66,13,1,1,1,0,6,1,345,91,27828,30870,34983,4,24,5,0,0,0,0,1,346,84,22786,27428,28449,1,-1,7,5042,8,3442,6534,1,1,1,0,5
EUW1_6883525605',1,23,10,1,0,0,0,6,0,372,102,26176,31265,23637,1,22,7,1,0,0,0,1,380,82,25109,28875,29081,0,-8,20,1067,3,2390,-5444,0,0,0,0,5
EUW1_6883474825',8,34,9,0,0,0,0,8,0,383,68,24825,30434,30527,4,37,6,1,0,0,0,2,397,106,26046,29555,38529,0,-14,-38,-1221,3,879,-8002,-1,0,0,0,6
EUW1_6879009319',2,30,9,0,1,0,0,10,1,366,99,25374,29176,32238,1,25,11,2,0,1,0,3,340,96,26914,29698,28078,0,26,3,-1540,-2,-522,4160,-2,1,-1,0,7
EUW1_6878951439',1,23,22,1,0,0,0,5,1,343,96,31684,31866,39516,3,29,18,1,0,0,0,3,347,88,27470,27692,43666,1,-4,8,4214,4,4174,-4150,0,0,0,0,2
EUW1_6878884144',4,24,13,0,0,1,0,13,1,353,98,28581,29536,29181,1,25,10,1,0,3,0,8,373,72,29004,30164,30111,1,-20,26,-423,3,-628,-930,-1,0,-2,0,5
EUW1_6878832873',3,75,11,0,0,1,0,10,1,376,67,26847,27734,34349,9,29,14,1,0,1,0,2,371,106,28105,30648,36913,0,5,-39,-1258,-3,-2914,-2564,-1,0,0,0,8
EUW1_6878791054',4,32,16,1,0,1,0,5,1,435,98,33261,33541,35859,4,24,5,1,0,1,0,7,332,88,21950,27334,19700,1,103,10,11311,11,6207,16159,0,0,0,0,-2
EUW1_6877905170',0,25,8,0,0,0,0,13,0,292,85,23750,24199,32813,3,22,29,1,1,2,0,0,323,92,35070,32229,47699,1,-31,-7,-11320,-21,-8030,-14886,-1,-1,-2,0,13
EUW1_6853520664',7,35,12,2,0,1,0,11,1,395,62,27912,28425,26601,4,30,8,0,0,1,0,8,359,110,27418,30774,25587,0,36,-48,494,4,-2349,1014,2,0,0,0,3
EUW1_6818649044',6,26,16,1,0,1,0,10,1,350,86,29645,29934,32703,4,27,7,1,0,0,0,7,373,102,25733,27664,31550,1,-23,-16,3912,9,2270,1153,0,0,1,0,3
EUW1_6818592106',5,214,13,2,1,2,0,6,1,400,100,28613,31950,24495,5,28,1,0,0,0,0,2,354,83,21120,27277,21011,1,46,17,7493,12,4673,3484,2,1,2,0,4
EUW1_6815754847',6,43,20,1,0,0,0,9,0,346,80,30835,30141,42049,2,30,16,1,0,1,0,3,309,87,29768,27620,33483,1,37,-7,1067,4,2521,8566,0,0,-1,0,6
EUW1_6815632848',2,22,8,1,0,0,0,14,0,395,108,27857,30324,22856,4,30,10,1,1,2,0,0,423,100,28919,32104,30759,0,-28,8,-1062,-2,-1780,-7903,0,-1,-2,0,14
EUW1_6815449502',0,104,15,1,0,0,0,5,0,369,66,28318,29798,28812,4,63,9,0,0,0,0,5,309,101,25658,26742,27313,1,60,-35,2660,6,3056,1499,1,0,0,0,0
EUW1_6815366119',2,35,9,1,0,0,0,11,1,341,92,26688,29059,28967,2,24,10,1,1,2,0,3,401,104,28890,31416,30157,0,-60,-12,-2202,-1,-2357,-1190,0,-1,-2,0,8
EUW1_6815304727',3,29,2,1,0,0,0,6,0,403,80,22574,27570,16904,3,25,13,1,0,1,0,1,402,116,31159,33116,31062,0,1,-36,-8585,-11,-5546,-14158,0,0,-1,0,5
EUW1_6815236106',7,27,5,0,0,0,0,4,0,371,80,23287,27051,21962,5,30,14,2,0,0,0,3,353,102,27584,29348,30037,0,18,-22,-4297,-9,-2297,-8075,-2,0,0,0,1
EUW1_6813547904',4,64,7,2,0,1,0,12,0,329,88,25947,27274,23241,5,59,9,0,1,3,0,2,400,103,29682,29192,28624,0,-71,-15,-3735,-2,-1918,-5383,2,-1,-2,0,10
EUW1_6813507059',4,35,17,1,0,1,0,7,1,332,84,29657,27239,35347,3,27,11,0,0,0,0,6,355,78,26261,27344,29197,1,-23,6,3396,6,-105,6150,1,0,1,0,1
EUW1_6808098135',4,28,16,1,0,0,0,12,0,342,110,30737,31598,36589,2,27,17,0,0,1,0,5,324,86,30181,28534,31307,1,18,24,556,-1,3064,5282,1,0,-1,0,7
EUW1_6808036712',3,29,10,0,0,1,0,12,1,306,105,26211,26750,35699,3,38,11,1,0,0,0,4,322,80,25810,28424,36704,0,-16,25,401,-1,-1674,-1005,-1,0,1,0,8
EUW1_6807962218',2,32,14,1,0,1,0,6,1,368,98,29433,30415,31648,4,27,7,1,0,0,0,6,356,85,25020,26865,25392,1,12,13,4413,7,3550,6256,0,0,1,0,0
EUW1_6807883113',2,28,14,2,0,0,0,9,1,360,96,28827,30636,35346,0,30,8,0,1,2,0,6,357,80,25956,28022,22265,1,3,16,2871,6,2614,13081,2,-1,-2,0,3
EUW1_6802542905',0,50,9,0,0,0,0,5,1,410,87,26936,30556,32800,3,26,4,1,0,0,0,5,334,98,23811,27633,18621,1,76,-11,3125,5,2923,14179,-1,0,0,0,0
EUW1_6802513565',3,27,20,1,0,2,0,5,0,412,90,31119,34645,37967,2,92,4,0,0,0,0,11,327,89,23664,27864,28804,1,85,1,7455,16,6781,9163,1,0,2,0,-6
EUW1_6801827744',4,31,15,2,1,1,0,9,0,318,100,30686,29638,31841,3,31,8,0,0,2,0,4,374,100,26495,26763,22319,1,-56,0,4191,7,2875,9522,2,1,-1,0,5
EUW1_6883650113',2,24,17,0,0,2,0,9,1,340,112,31046,30235,31841,8,32,21,2,0,1,0,9,294,94,31249,29738,38850,0,46,18,-203,-4,497,-7009,-2,0,1,0,0
EUW1_6883633070',6,30,21,2,0,1,0,10,1,333,100,31494,33165,35138,2,26,8,0,0,1,0,8,394,67,27330,29514,25285,1,-61,33,4164,13,3651,9853,2,0,0,0,2
EUW1_6883418331',2,21,7,0,0,0,0,5,1,414,92,25975,31437,32760,4,28,10,1,0,0,0,3,371,105,25876,31101,30197,0,43,-13,99,-3,336,2563,-1,0,0,0,2
EUW1_6883355447',4,176,11,0,0,0,0,6,1,353,84,25853,30098,27543,5,29,11,2,0,0,0,0,375,98,27544,30331,30598,0,-22,-14,-1691,0,-233,-3055,-2,0,0,0,6
EUW1_6883257626',3,35,8,2,1,1,0,11,1,369,89,26423,30298,27538,2,27,9,0,0,1,0,5,355,98,25800,30842,31766,1,14,-9,623,-1,-544,-4228,2,1,0,0,6
EUW1_6883119773',4,36,10,0,0,0,0,7,1,358,90,25909,28770,31835,4,27,16,2,1,1,0,4,330,86,28684,31998,35577,0,28,4,-2775,-6,-3228,-3742,-2,-1,-1,0,3
EUW1_6882694435',2,72,7,0,0,1,0,4,0,391,72,25250,30082,25517,5,71,11,2,1,0,0,2,347,108,26278,30458,28166,1,44,-36,-1028,-4,-376,-2649,-2,-1,1,0,2
EUW1_6882523698',4,36,12,0,0,0,0,10,1,335,79,26405,29440,36981,3,28,14,1,0,1,0,1,348,84,27559,28439,37617,1,-13,-5,-1154,-2,1001,-636,-1,0,-1,0,9
EUW1_6882478259',1,26,7,0,0,1,0,12,0,302,92,22992,27480,20826,5,23,13,1,0,1,0,1,383,96,28838,31845,31361,0,-81,-4,-5846,-6,-4365,-10535,-1,0,0,0,11
EUW1_6882281290',2,21,7,1,0,0,0,8,1,387,70,25297,28282,27018,3,22,11,1,0,1,0,3,387,88,27684,32349,35137,0,0,-18,-2387,-4,-4067,-8119,0,0,-1,0,5
EUW1_6882268553',2,25,20,1,1,1,0,11,0,349,84,32288,30944,38290,5,24,15,0,0,2,0,8,271,83,27919,27626,32089,1,78,1,4369,5,3318,6201,1,1,-1,0,3
EUW1_6882249613',6,26,6,2,0,0,0,6,0,406,86,24658,30247,19581,2,47,3,0,0,0,0,0,404,107,23898,30445,20680,1,2,-21,760,3,-198,-1099,2,0,0,0,6
EUW1_6881976978',2,72,11,0,0,1,0,10,1,335,122,27537,30740,32521,4,37,15,2,0,0,0,7,318,66,28073,26847,33336,0,17,56,-536,-4,3893,-815,-2,0,1,0,3
EUW1_6881433986',6,31,6,0,0,0,0,8,0,357,101,24866,30142,23866,3,33,11,2,0,1,0,2,380,93,27263,31783,34391,0,-23,8,-2397,-5,-1641,-10525,-2,0,-1,0,6
EUW1_6881322318',8,34,10,0,0,0,0,9,1,382,132,27863,31104,35193,4,31,12,2,0,1,0,4,382,68,27722,30793,29589,0,0,64,141,-2,311,5604,-2,0,-1,0,5
EUW1_6881247831',3,32,8,0,0,0,0,8,1,419,100,26073,32239,29371,2,23,5,1,0,0,0,1,411,112,24998,32400,24354,1,8,-12,1075,3,-161,5017,-1,0,0,0,7
EUW1_6881141133',3,46,5,0,0,0,0,5,0,347,76,23134,25891,18995,7,97,9,1,0,0,0,1,332,80,24662,26990,27126,0,15,-4,-1528,-4,-1099,-8131,-1,0,0,0,4
EUW1_6881091344',3,22,9,1,0,0,0,11,0,356,113,26017,30256,27811,3,27,11,0,0,1,0,6,402,87,28187,32272,30984,0,-46,26,-2170,-2,-2016,-3173,1,0,-1,0,5
EUW1_6880952277',1,27,9,1,0,0,0,8,1,373,92,26069,27919,29732,4,29,16,1,0,1,0,4,370,80,27896,28623,26945,0,3,12,-1827,-7,-704,2787,0,0,-1,0,4
EUW1_6880388341',1,156,19,0,0,1,0,13,1,394,82,30598,31114,30590,2,31,9,1,0,0,0,4,351,96,26798,29064,22014,1,43,-14,3800,10,2050,8576,-1,0,1,0,9
EUW1_6875242330',4,31,12,0,0,0,0,9,1,305,76,26350,27327,32127,5,261,17,2,0,1,0,3,353,100,29441,30951,32840,0,-48,-24,-3091,-5,-3624,-713,-2,0,-1,0,6
EUW1_6875194465',2,25,8,0,0,0,0,10,0,372,84,25611,29730,22177,7,29,8,2,0,0,0,0,382,112,25524,32077,24325,0,-10,-28,87,0,-2347,-2148,-2,0,0,0,10
EUW1_6874662497',6,29,10,1,0,0,0,11,1,330,96,26069,29043,35543,1,27,17,1,0,3,0,4,367,80,29225,30674,39129,1,-37,16,-3156,-7,-1631,-3586,0,0,-3,0,7
EUW1_6874606762',1,39,7,0,0,0,0,14,0,330,114,24107,29344,25303,8,33,16,2,1,2,0,1,363,101,29397,30435,34478,0,-33,13,-5290,-9,-1091,-9175,-2,-1,-2,0,13
EUW1_6871880674',2,26,11,0,0,0,0,18,0,337,88,27284,30185,28695,0,19,21,2,1,3,0,1,375,116,34935,36059,42527,0,-38,-28,-7651,-10,-5874,-13832,-2,-1,-3,0,17
EUW1_6871757989',4,35,7,0,0,0,0,11,1,329,74,24887,27919,29122,9,43,19,2,0,1,0,4,398,85,30107,32437,36315,0,-69,-11,-5220,-12,-4518,-7193,-2,0,-1,0,7
EUW1_6871296711',8,40,4,0,0,0,0,9,0,386,82,23297,29078,24445,8,54,10,2,0,1,0,4,362,110,27012,30354,25600,1,24,-28,-3715,-6,-1276,-1155,-2,0,-1,0,5
EUW1_6871090566',4,21,9,0,0,0,0,12,0,315,96,24405,27610,31105,2,421,11,2,0,2,0,4,341,107,28865,30475,31469,0,-26,-11,-4460,-2,-2865,-364,-2,0,-2,0,8
EUW1_6870520720',5,21,8,1,0,1,0,3,1,338,98,25270,30015,28342,2,28,4,1,0,0,0,2,388,90,23122,30278,26361,0,-50,8,2148,4,-263,1981,0,0,1,0,1
EUW1_6870425348',4,28,16,1,1,1,0,5,0,377,77,27662,31134,36996,7,30,9,0,0,0,0,1,342,98,25239,29363,35145,0,35,-21,2423,7,1771,1851,1,1,1,0,4
EUW1_6868721572',1,30,15,0,0,0,0,9,1,314,91,26894,27772,32785,3,33,16,1,0,0,0,1,272,103,28555,27768,32762,0,42,-12,-1661,-1,4,23,-1,0,0,0,8
EUW1_6868661614',5,26,9,0,0,0,0,5,0,312,72,23784,28267,30604,5,30,19,1,1,0,0,2,299,104,29387,31809,29393,0,13,-32,-5603,-10,-3542,1211,-1,-1,0,0,3
EUW1_6868601740',3,33,11,0,1,1,0,3,0,399,104,28293,31133,31696,4,32,10,1,0,0,0,4,368,75,25294,28673,24697,0,31,29,2999,1,2460,6999,-1,1,1,0,-1
EUW1_6868540579',9,38,17,0,0,0,0,8,1,327,84,28777,29764,32452,0,31,11,2,0,0,0,5,341,102,26460,30937,30886,1,-14,-18,2317,6,-1173,1566,-2,0,0,0,3
EUW1_6868483239',1,28,12,0,0,2,0,6,1,393,78,28142,29886,27374,2,25,7,2,0,0,0,2,363,106,25625,29136,24244,1,30,-28,2517,5,750,3130,-2,0,2,0,4
EUW1_6868439702',7,29,9,0,0,1,0,9,0,342,74,26114,29023,29450,4,33,16,1,0,1,0,5,373,92,29111,31960,37883,0,-31,-18,-2997,-7,-2937,-8433,-1,0,0,0,4
EUW1_6868053560',5,26,11,1,0,2,0,9,0,393,92,29296,31438,24617,3,30,8,1,0,1,0,8,388,83,26365,28711,23555,0,5,9,2931,3,2727,1062,0,0,1,0,1
EUW1_6867980346',8,47,6,0,0,0,0,11,0,328,77,23641,25303,24160,4,95,14,1,0,2,0,1,352,104,29704,29866,31863,0,-24,-27,-6063,-8,-4563,-7703,-1,0,-2,0,10
EUW1_6866267548',3,29,9,0,0,0,0,8,0,376,76,26751,31087,25221,4,45,8,1,0,1,0,3,386,91,24833,29195,28188,0,-10,-15,1918,1,1892,-2967,-1,0,-1,0,5
EUW1_6881606799',4,41,17,1,0,1,0,10,0,367,78,29640,29640,30605,9,34,11,0,0,1,0,3,346,62,27051,27456,28333,0,21,16,2589,6,2184,2272,1,0,0,0,7
EUW1_6881545960',4,38,16,1,0,0,0,12,0,361,107,29910,30957,41315,2,30,12,1,0,2,0,3,364,58,27245,28900,33035,1,-3,49,2665,4,2057,8280,0,0,-2,0,9
EUW1_6881474935',5,21,7,0,0,1,0,9,1,358,68,25526,28649,27771,5,26,8,1,0,1,0,5,356,107,26524,30953,29390,0,2,-39,-998,-1,-2304,-1619,-1,0,0,0,4
EUW1_6881427985',2,29,22,1,0,2,0,4,1,365,95,33569,30640,39011,2,30,7,1,0,1,0,11,302,100,24351,27391,31753,1,63,-5,9218,15,3249,7258,0,0,1,0,-7
EUW1_6881381898',8,35,15,1,0,0,0,10,0,348,79,29372,30471,26701,6,26,9,0,0,2,0,4,356,94,26476,28752,28060,1,-8,-15,2896,6,1719,-1359,1,0,-2,0,6
EUW1_6881310282',3,26,8,0,1,0,0,11,0,336,72,26095,29047,26362,8,32,22,2,0,3,0,2,381,104,33384,30793,38266,0,-45,-32,-7289,-14,-1746,-11904,-2,1,-3,0,9
EUW1_6881254720',7,25,4,0,0,0,0,8,0,359,83,23461,28757,17360,3,44,10,1,0,0,0,2,375,130,26704,30171,22447,0,-16,-47,-3243,-6,-1414,-5087,-1,0,0,0,6
EUW1_6881200414',4,28,13,2,0,2,0,6,1,421,103,29386,31292,38154,2,37,4,0,0,0,0,6,366,83,23295,29039,24348,1,55,20,6091,9,2253,13806,2,0,2,0,0
EUW1_6881153100',5,26,13,0,0,1,0,1,1,390,78,29058,29258,33845,2,34,10,1,0,0,0,9,300,82,24874,27776,27545,1,90,-4,4184,3,1482,6300,-1,0,1,0,-8
EUW1_6880861573',5,26,20,2,0,4,0,4,1,352,111,33697,30989,41022,0,37,3,0,0,0,0,7,284,87,21817,23228,20208,1,68,24,11880,17,7761,20814,2,0,4,0,-3
EUW1_6880851462',4,31,12,0,0,1,0,8,0,298,72,27236,25917,33241,5,29,25,2,0,2,0,6,352,103,34768,33193,48172,1,-54,-31,-7532,-13,-7276,-14931,-2,0,-1,0,2
EUW1_6874479668',1,21,10,1,0,0,0,9,1,348,96,26297,29240,25196,5,30,12,1,0,1,0,2,394,84,28349,30773,27538,0,-46,12,-2052,-2,-1533,-2342,0,0,-1,0,7
EUW1_6883759837',6,35,9,0,0,1,0,9,1,423,102,28835,31930,34134,5,28,8,2,1,1,0,4,379,114,26609,30987,32065,0,44,-12,2226,1,943,2069,-2,-1,0,0,5
EUW1_6883739655',3,36,20,1,1,3,0,4,1,378,122,34014,32579,45314,7,42,10,1,0,0,0,12,352,81,25467,28716,25327,1,26,41,8547,10,3863,19987,0,1,3,0,-8
EUW1_6883724558',4,27,7,0,0,0,0,9,0,356,87,24693,28995,22517,5,116,12,2,0,1,0,4,397,95,27813,32477,27680,0,-41,-8,-3120,-5,-3482,-5163,-2,0,-1,0,5
EUW1_6883700291',0,61,15,1,1,2,0,6,0,362,90,29457,29615,35053,3,59,13,0,0,1,0,6,287,82,26780,27946,40082,1,75,8,2677,2,1669,-5029,1,1,1,0,0
EUW1_6882896310',3,29,13,0,0,0,0,6,1,307,79,26091,29125,34439,4,190,12,1,0,0,0,0,354,103,26567,29637,29648,0,-47,-24,-476,1,-512,4791,-1,0,0,0,6
EUW1_6882813683',2,38,3,1,0,1,0,9,1,401,99,24664,27702,28436,2,31,7,0,0,1,0,5,374,66,24867,27897,24652,0,27,33,-203,-4,-195,3784,1,0,0,0,4
EUW1_6882670105',6,28,15,0,0,1,0,7,1,366,116,29297,32410,33685,5,30,8,2,0,0,0,5,337,89,25056,27368,29726,1,29,27,4241,7,5042,3959,-2,0,1,0,2
EUW1_6882595786',1,29,15,0,0,1,0,12,0,342,89,28513,29681,30020,5,99,12,2,0,1,0,3,362,98,29855,29555,32248,0,-20,-9,-1342,3,126,-2228,-2,0,0,0,9
EUW1_6882563563',4,27,13,1,0,2,0,12,1,381,104,30335,31020,34383,1,24,10,1,0,3,0,9,325,98,27297,28575,25874,1,56,6,3038,3,2445,8509,0,0,-1,0,3
EUW1_6882527973',3,28,17,1,0,1,0,8,1,349,92,29697,29168,36846,2,25,13,1,1,0,0,7,356,81,27202,28701,37464,0,-7,11,2495,4,467,-618,0,-1,1,0,1
EUW1_6882489442',5,19,17,1,0,1,0,8,0,347,97,30128,30646,33813,4,27,12,0,0,1,0,7,362,90,27465,30002,32659,1,-15,7,2663,5,644,1154,1,0,0,0,1
EUW1_6882442911',4,28,6,2,0,2,0,5,1,396,82,25783,29549,31586,2,29,5,0,0,0,0,3,379,90,23993,28853,27466,1,17,-8,1790,1,696,4120,2,0,2,0,2
EUW1_6882395883',1,27,13,1,0,1,0,7,1,352,110,28123,30011,30629,1,32,9,0,0,0,0,3,363,102,26941,29816,28503,0,-11,8,1182,4,195,2126,1,0,1,0,4
EUW1_6882328723',9,31,13,0,0,0,0,13,0,327,76,27448,28998,32103,2,26,12,1,0,0,0,1,358,64,26648,26804,26687,0,-31,12,800,1,2194,5416,-1,0,0,0,12
EUW1_6882037391',3,24,11,1,0,0,0,6,0,350,98,26266,28974,27978,3,23,17,0,0,1,0,2,314,102,29725,30907,33807,0,36,-4,-3459,-6,-1933,-5829,1,0,-1,0,4
EUW1_6881975664',3,60,13,1,0,0,0,11,0,292,75,25833,27973,39248,4,62,20,1,0,1,0,0,395,101,31685,31819,43167,0,-103,-26,-5852,-7,-3846,-3919,0,0,-1,0,11
EUW1_6859724102',2,22,8,0,0,1,0,15,0,386,103,27695,30497,27802,2,23,15,2,0,2,0,2,350,112,30931,30917,28757,0,36,-9,-3236,-7,-420,-955,-2,0,-1,0,13
EUW1_6858130173',3,30,20,1,0,0,0,16,0,342,91,30701,31368,44319,6,51,19,1,0,2,0,5,316,88,32050,29600,51347,1,26,3,-1349,1,1768,-7028,0,0,-2,0,11
EUW1_6858109565',0,27,11,0,1,0,0,9,0,344,100,27004,29742,30433,3,36,14,1,0,0,0,3,384,68,27655,30296,30373,0,-40,32,-651,-3,-554,60,-1,1,0,0,6
EUW1_6858081176',3,24,12,0,0,0,0,15,1,289,79,25789,27809,31202,6,437,13,1,0,2,0,1,334,88,29136,28778,36940,0,-45,-9,-3347,-1,-969,-5738,-1,0,-2,0,14
EUW1_6857484913',1,20,17,0,0,1,0,8,0,353,80,30349,29943,33250,5,27,20,2,0,1,0,5,347,92,29827,31624,37678,0,6,-12,522,-3,-1681,-4428,-2,0,0,0,3
EUW1_6857427318',1,25,8,1,0,1,0,16,0,309,102,25963,28868,25331,8,30,18,1,0,2,0,3,371,90,31874,29632,36974,0,-62,12,-5911,-10,-764,-11643,0,0,-1,0,13
EUW1_6857381767',4,28,18,1,0,0,0,9,0,285,82,27967,27466,35812,6,31,17,0,0,1,0,1,352,82,30413,28455,33615,1,-67,0,-2446,1,-989,2197,1,0,-1,0,8
EUW1_6857298332',5,34,17,1,1,2,0,9,0,352,84,30931,31471,36174,5,22,13,1,0,0,0,4,306,108,27779,29447,34012,1,46,-24,3152,4,2024,2162,0,1,2,0,5
EUW1_6857197636',2,25,21,1,0,1,0,5,0,348,82,30868,29674,40381,0,30,16,1,0,0,0,4,323,98,30001,27554,38327,1,25,-16,867,5,2120,2054,0,0,1,0,1
EUW1_6857139433',1,24,11,1,0,0,0,10,1,313,69,25108,27834,32247,5,36,11,1,0,1,0,4,367,94,28219,30559,34392,0,-54,-25,-3111,0,-2725,-2145,0,0,-1,0,6
EUW1_6856733337',4,23,14,0,1,0,0,12,1,344,92,28178,29459,28569,2,27,15,2,0,1,0,3,350,80,29195,30851,37136,0,-6,12,-1017,-1,-1392,-8567,-2,1,-1,0,9
EUW1_6854296889',2,33,16,0,0,0,0,7,0,312,94,28465,30215,35717,3,29,11,1,0,0,0,0,341,76,25226,28282,35716,1,-29,18,3239,5,1933,1,-1,0,0,0,7
EUW1_6854280622',5,27,14,1,0,0,0,5,0,330,108,28479,29381,28839,3,35,17,1,1,0,0,4,315,96,28044,29984,29054,1,15,12,435,-3,-603,-215,0,-1,0,0,1
EUW1_6854262813',1,21,20,0,0,1,0,8,1,294,74,31273,28840,45599,4,337,16,1,0,0,0,3,389,74,30165,29195,36597,1,-95,0,1108,4,-355,9002,-1,0,1,0,5
EUW1_6854248785',1,28,10,0,0,0,0,6,1,357,66,26640,27983,36945,6,34,15,2,0,0,0,7,352,78,27401,28537,38078,1,5,-12,-761,-5,-554,-1133,-2,0,0,0,-1
EUW1_6854229326',3,19,13,0,0,1,0,6,1,347,104,29925,30092,39323,2,21,19,1,1,0,0,6,348,96,30205,31688,40727,0,-1,8,-280,-6,-1596,-1404,-1,-1,1,0,0
EUW1_6854222177',4,30,14,0,1,1,0,14,1,350,88,28025,30316,29003,2,23,9,2,0,2,0,8,355,124,28485,31824,30904,0,-5,-36,-460,5,-1508,-1901,-2,1,-1,0,6
EUW1_6854210362',6,40,14,1,0,0,0,10,1,386,89,28064,31423,31521,6,26,5,1,0,2,0,6,335,91,24006,28542,20480,1,51,-2,4058,9,2881,11041,0,0,-2,0,4
EUW1_6854209494',3,29,10,0,0,0,0,8,1,349,92,26306,30386,24188,3,30,12,2,0,0,0,3,356,124,26551,31787,31483,0,-7,-32,-245,-2,-1401,-7295,-2,0,0,0,5
EUW1_6802589360',2,32,12,0,0,1,0,10,1,345,88,27697,29343,34097,4,25,15,1,0,0,0,4,347,70,27753,30061,35985,0,-2,18,-56,-3,-718,-1888,-1,0,1,0,6
EUW1_6802545854',3,28,7,2,0,0,0,11,1,358,80,25263,29796,31218,1,138,12,0,0,2,0,2,308,118,26956,31796,30206,0,50,-38,-1693,-5,-2000,1012,2,0,-2,0,9
EUW1_6802177672',4,69,12,1,0,1,0,9,1,372,78,28024,29965,35034,5,62,13,1,0,1,0,5,345,88,28340,28297,36290,1,27,-10,-316,-1,1668,-1256,0,0,0,0,4
EUW1_6802159951',4,25,15,0,0,2,0,8,0,328,84,29792,30959,28292,3,151,14,1,0,0,0,8,346,84,29228,28856,36763,0,-18,0,564,1,2103,-8471,-1,0,2,0,0
EUW1_6801599533',2,20,12,0,0,0,0,9,1,381,74,26558,30542,32463,5,27,10,1,0,0,0,1,336,90,26749,29280,25840,1,45,-16,-191,2,1262,6623,-1,0,0,0,8
EUW1_6800890480',5,24,17,0,0,2,0,10,0,353,96,31594,29165,25347,3,27,16,2,0,3,0,5,313,107,30509,30007,32779,0,40,-11,1085,1,-842,-7432,-2,0,-1,0,5
EUW1_6800880544',5,37,11,0,0,0,0,10,0,358,73,26827,28544,38132,5,43,14,2,0,2,0,3,376,90,29246,30722,36040,0,-18,-17,-2419,-3,-2178,2092,-2,0,-2,0,7
EUW1_6800866036',4,30,10,1,0,0,0,9,1,322,94,25447,26355,28901,5,23,14,0,0,0,0,2,339,94,27639,29035,33874,0,-17,0,-2192,-4,-2680,-4973,1,0,0,0,7
EUW1_6800854238',3,36,18,2,0,2,0,11,0,367,88,30731,30995,34519,4,32,16,0,0,1,0,9,336,96,30509,29075,31658,1,31,-8,222,2,1920,2861,2,0,1,0,2
EUW1_6800844043',5,27,15,2,0,0,0,13,1,306,75,28296,29659,31351,2,24,17,0,0,2,0,4,316,88,29323,27565,39775,0,-10,-13,-1027,-2,2094,-8424,2,0,-2,0,9
EUW1_6800824187',2,19,18,0,0,0,0,17,0,339,101,30819,29161,41090,3,21,20,1,0,2,0,1,282,94,29968,29065,33466,0,57,7,851,-2,96,7624,-1,0,-2,0,16
EUW1_6800806414',6,32,5,0,1,0,0,6,1,335,101,23781,28388,23083,7,33,10,2,0,1,0,0,352,106,26649,30325,27066,0,-17,-5,-2868,-5,-1937,-3983,-2,1,-1,0,6
EUW1_6800785283',5,76,16,1,0,3,0,5,1,406,107,32030,33378,32491,1,26,4,0,0,0,0,5,310,79,21286,24740,20027,1,96,28,10744,12,8638,12464,1,0,3,0,0
EUW1_6800770788',6,37,11,1,0,0,0,10,1,413,76,27841,30123,22114,2,36,8,1,0,1,0,3,414,107,28129,30887,26165,0,-1,-31,-288,3,-764,-4051,0,0,-1,0,7
EUW1_6800733891',4,34,11,0,0,1,0,6,1,391,70,28188,29739,32602,2,27,9,2,0,0,0,7,377,125,27040,30944,26647,0,14,-55,1148,2,-1205,5955,-2,0,1,0,-1
EUW1_6882826804',5,39,5,0,0,0,0,11,1,319,80,23799,27412,22580,1,29,10,2,0,1,0,3,378,87,28009,30260,35445,0,-59,-7,-4210,-5,-2848,-12865,-2,0,-1,0,8
EUW1_6882786055',3,29,6,0,0,0,0,10,1,314,104,23425,26856,27416,4,27,17,2,0,1,0,3,357,91,29941,31582,33124,0,-43,13,-6516,-11,-4726,-5708,-2,0,-1,0,7
EUW1_6872239266',4,28,9,0,0,1,0,4,0,340,94,26320,29306,29592,1,22,10,1,0,0,0,2,390,94,26178,30227,32311,1,-50,0,142,-1,-921,-2719,-1,0,1,0,2
EUW1_6872184190',3,92,13,1,0,1,0,6,1,364,96,28316,29536,27815,6,30,6,1,0,0,0,6,330,64,23686,27264,27027,1,34,32,4630,7,2272,788,0,0,1,0,0
EUW1_6872136003',10,48,13,1,0,0,0,9,1,385,94,29072,29753,30330,9,41,11,1,0,2,0,5,365,82,26856,29107,29798,0,20,12,2216,2,646,532,0,0,-2,0,4
EUW1_6872083369',2,29,16,0,0,2,0,4,0,402,82,30134,30892,36882,7,33,13,1,1,0,0,6,296,84,26554,30196,29741,1,106,-2,3580,3,696,7141,-1,-1,2,0,-2
EUW1_6872027767',2,24,10,2,0,0,0,9,0,332,64,25539,29443,32561,8,49,18,0,0,2,0,2,364,95,30233,30964,40113,1,-32,-31,-4694,-8,-1521,-7552,2,0,-2,0,7
EUW1_6871955028',3,69,11,0,0,0,0,6,0,387,83,26417,30447,25807,9,39,10,2,0,0,0,1,363,81,25899,28549,26464,1,24,2,518,1,1898,-657,-2,0,0,0,5
EUW1_6871812826',4,21,14,0,0,1,0,13,1,361,100,29474,30891,32518,6,32,10,1,0,0,0,2,366,74,26656,27548,30082,1,-5,26,2818,4,3343,2436,-1,0,1,0,11
EUW1_6871545329',6,35,14,0,0,0,0,4,0,391,98,28288,32150,31557,3,27,10,1,0,0,0,2,332,82,24995,28758,29512,1,59,16,3293,4,3392,2045,-1,0,0,0,2
EUW1_6871507654',7,63,15,1,0,0,0,6,0,342,93,29397,30995,34957,5,66,11,1,0,1,0,3,372,66,25942,28984,32044,1,-30,27,3455,4,2011,2913,0,0,-1,0,3
EUW1_6871456549',4,27,13,1,0,0,0,8,1,352,79,27019,27471,30595,7,47,13,1,0,0,0,1,365,79,27238,31025,29401,0,-13,0,-219,0,-3554,1194,0,0,0,0,7
EUW1_6871182843',1,25,5,0,1,1,0,7,1,373,108,25970,28630,25270,3,26,11,2,0,0,0,4,380,88,26728,28800,26172,1,-7,20,-758,-6,-170,-902,-2,1,1,0,3
EUW1_6870888871',5,26,8,0,0,0,0,10,0,363,88,25567,29564,27287,2,38,11,2,0,0,0,4,304,104,25990,29378,23775,0,59,-16,-423,-3,186,3512,-2,0,0,0,6
EUW1_6870863266',4,25,8,1,0,0,0,14,1,344,77,25554,27095,29674,5,24,16,1,0,1,0,2,316,74,27295,29507,35549,0,28,3,-1741,-8,-2412,-5875,0,0,-1,0,12
EUW1_6870843986',6,42,12,2,0,1,0,8,1,347,124,28936,31917,33845,1,23,7,0,0,1,0,7,287,104,23447,28872,23610,1,60,20,5489,5,3045,10235,2,0,0,0,1
EUW1_6870814948',4,27,10,2,1,1,0,12,1,323,82,26915,26600,27421,6,28,13,0,0,1,0,5,323,96,28011,28161,33764,0,0,-14,-1096,-3,-1561,-6343,2,1,0,0,7
EUW1_6870765691',3,27,11,1,0,1,0,7,1,377,91,27553,28582,29614,3,36,9,1,0,0,0,4,309,92,23845,27911,21984,1,68,-1,3708,2,671,7630,0,0,1,0,3
EUW1_6862069487',5,24,17,2,0,1,0,8,1,398,86,29762,32585,30980,3,27,11,0,0,0,0,3,400,118,26912,31601,31135,1,-2,-32,2850,6,984,-155,2,0,1,0,5
EUW1_6861043936',3,39,11,1,0,1,0,13,0,374,84,28162,28597,31142,4,27,19,1,0,1,0,3,351,92,29938,30713,34943,1,23,-8,-1776,-8,-2116,-3801,0,0,0,0,10
EUW1_6861017250',9,27,27,1,1,3,0,16,1,385,98,35091,34772,43003,3,34,13,0,0,0,0,5,327,74,27234,29073,31350,1,58,24,7857,14,5699,11653,1,1,3,0,11
EUW1_6860993599',8,27,11,0,0,0,0,11,0,370,80,27092,29933,33426,4,32,16,2,0,2,0,4,342,124,29893,32814,35153,1,28,-44,-2801,-5,-2881,-1727,-2,0,-2,0,7
EUW1_6860962295',3,26,6,0,0,0,0,15,0,295,95,24307,26824,29330,5,29,26,1,0,3,0,4,364,88,34280,32279,49551,0,-69,7,-9973,-20,-5455,-20221,-1,0,-3,0,11
EUW1_6860942721',2,24,14,2,0,3,0,5,1,444,108,32599,34877,31334,6,21,2,0,0,1,0,10,278,84,19756,24924,16472,1,166,24,12843,12,9953,14862,2,0,2,0,-5
EUW1_6860919861',3,49,15,1,0,0,0,8,0,348,101,28988,29629,32918,3,91,12,1,0,1,0,1,331,74,26721,27867,36322,1,17,27,2267,3,1762,-3404,0,0,-1,0,7
EUW1_6860879155',3,28,21,2,0,1,0,2,0,344,93,30730,30906,41284,8,38,10,0,0,0,0,7,328,66,24678,25434,31114,1,16,27,6052,11,5472,10170,2,0,1,0,-5
EUW1_6860845322',3,64,11,0,0,0,0,10,1,372,74,27221,29497,35049,4,63,18,2,0,1,0,3,389,88,32441,32163,37999,0,-17,-14,-5220,-7,-2666,-2950,-2,0,-1,0,7
EUW1_6860832313',3,36,7,0,0,1,0,12,1,312,65,24438,26274,26868,0,28,20,2,0,2,0,3,380,107,32824,33581,40434,0,-68,-42,-8386,-13,-7307,-13566,-2,0,-1,0,9
EUW1_6860818102',1,63,8,0,0,2,0,8,1,360,80,27226,28534,32830,3,93,16,2,0,0,0,6,297,90,28260,30612,34042,1,63,-10,-1034,-8,-2078,-1212,-2,0,2,0,2
EUW1_6860807077',3,20,14,1,0,1,0,12,0,366,96,30736,30699,32512,6,34,14,1,0,1,0,7,348,96,29069,30110,31705,1,18,0,1667,0,589,807,0,0,0,0,5
EUW1_6860791044',4,131,12,0,0,1,0,15,0,353,86,28659,30589,35217,2,29,13,1,1,1,0,6,351,102,29849,30780,31355,0,2,-16,-1190,-1,-191,3862,-1,-1,0,0,9
EUW1_6860783919',1,23,14,2,0,0,0,7,1,379,74,29256,29553,32201,3,25,13,0,0,1,0,2,324,88,27565,29984,36438,1,55,-14,1691,1,-431,-4237,2,0,-1,0,5
EUW1_6860647099',3,23,18,1,0,1,0,5,1,400,80,29728,31749,33815,2,28,6,1,0,0,0,3,332,92,23490,28032,35181,1,68,-12,6238,12,3717,-1366,0,0,1,0,2
EUW1_6860605231',5,32,12,1,0,0,0,10,0,380,82,27678,30634,28487,2,66,11,0,0,0,0,2,369,90,26512,29699,26581,0,11,-8,1166,1,935,1906,1,0,0,0,8
EUW1_6860228959',5,26,19,2,0,2,0,2,0,366,96,31813,33667,40382,1,31,6,0,0,0,0,12,347,75,23246,28022,23519,1,19,21,8567,13,5645,16863,2,0,2,0,-10
EUW1_6860180691',2,26,8,1,0,0,0,5,1,350,92,24757,29058,23967,2,24,10,0,0,0,0,1,363,108,26432,31074,27595,0,-13,-16,-1675,-2,-2016,-3628,1,0,0,0,4
EUW1_6859620678',6,32,15,1,0,1,0,10,0,359,72,28293,29070,30820,3,26,14,1,0,0,0,6,371,108,29138,29855,25420,1,-12,-36,-845,1,-785,5400,0,0,1,0,4
EUW1_6856804564',2,22,11,2,0,0,0,4,1,386,83,27994,29732,29988,3,32,10,0,0,0,0,7,335,101,26759,29915,36626,1,51,-18,1235,1,-183,-6638,2,0,0,0,-3
EUW1_6856730285',2,27,11,0,0,1,0,7,0,301,84,27413,27851,31313,6,33,18,2,0,1,0,7,362,76,27988,28909,36969,0,-61,8,-575,-7,-1058,-5656,-2,0,0,0,0
EUW1_6855949979',3,28,9,1,0,1,0,13,1,359,112,26592,31434,32801,8,99,13,1,0,1,0,4,376,96,29118,31434,34284,0,-17,16,-2526,-4,0,-1483,0,0,0,0,9
EUW1_6855908058',1,27,15,2,0,0,0,5,0,355,112,29196,33016,34871,2,28,9,0,0,1,0,1,335,92,25430,28189,30586,1,20,20,3766,6,4827,4285,2,0,-1,0,4
EUW1_6855869088',2,28,25,1,0,1,0,6,0,361,93,33222,32990,49636,2,24,14,1,0,1,0,4,303,106,28827,29218,40127,1,58,-13,4395,11,3772,9509,0,0,0,0,2
EUW1_6855662261',0,28,10,0,0,0,0,9,0,383,110,26635,33367,30491,4,29,9,2,0,1,0,2,368,91,27144,31258,29329,1,15,19,-509,1,2109,1162,-2,0,-1,0,7
EUW1_6855638858',3,26,14,1,0,1,0,5,0,340,116,29042,29826,34835,3,24,16,1,0,0,0,5,302,86,27989,28808,38489,1,38,30,1053,-2,1018,-3654,0,0,1,0,0
EUW1_6855605896',3,27,14,0,0,1,0,13,1,338,84,28904,31285,39980,3,41,13,2,0,1,0,4,368,112,29533,31184,34377,0,-30,-28,-629,1,101,5603,-2,0,0,0,9
EUW1_6854335332',6,26,7,1,0,0,0,8,1,389,106,25885,30066,23406,3,39,12,1,1,0,0,3,380,89,27841,29254,30549,0,9,17,-1956,-5,812,-7143,0,-1,0,0,5
EUW1_6854315109',4,26,12,1,0,0,0,11,1,342,96,27222,29378,30123,1,22,13,1,1,2,0,4,367,99,29979,31391,39185,0,-25,-3,-2757,-1,-2013,-9062,0,-1,-2,0,7
EUW1_6854304918',3,40,10,2,0,0,0,12,0,339,120,27857,32106,32007,3,83,13,0,0,1,0,2,359,88,28857,30224,36146,1,-20,32,-1000,-3,1882,-4139,2,0,-1,0,10
EUW1_6854281009',5,26,9,1,0,1,0,9,1,367,98,27442,30403,31177,5,41,11,1,0,1,0,6,342,101,27473,31132,26699,1,25,-3,-31,-2,-729,4478,0,0,0,0,3
EUW1_6854263423',4,27,9,2,0,0,0,5,0,378,105,26795,30796,31755,3,25,10,0,0,0,0,3,367,116,26767,30015,28846,1,11,-11,28,-1,781,2909,2,0,0,0,2
EUW1_6854241798',4,25,10,1,0,1,0,9,1,392,96,27717,31602,36810,1,23,12,1,0,0,0,6,362,114,27977,31975,33405,1,30,-18,-260,-2,-373,3405,0,0,1,0,3
EUW1_6854230031',1,37,8,0,0,0,0,6,0,332,83,25000,26508,29877,3,25,15,2,0,1,0,3,377,120,30006,32618,34754,0,-45,-37,-5006,-7,-6110,-4877,-2,0,-1,0,3
EUW1_6854214787',5,26,16,2,0,2,0,7,1,358,106,30545,30487,37519,3,29,16,0,0,1,0,7,312,90,28484,30470,40016,0,46,16,2061,0,17,-2497,2,0,1,0,0
EUW1_6853116612',2,19,7,2,0,0,0,15,1,323,100,23942,30053,28666,4,29,13,0,0,2,0,2,336,88,28726,30986,28228,0,-13,12,-4784,-6,-933,438,2,0,-2,0,13
EUW1_6853093898',1,24,8,1,0,1,0,15,0,329,106,27057,28406,26956,4,27,12,1,0,2,0,6,356,76,28853,29290,28226,1,-27,30,-1796,-4,-884,-1270,0,0,-1,0,9
EUW1_6853079760',3,217,8,1,0,0,0,6,0,365,101,26607,29849,25588,2,54,7,1,0,0,0,8,358,130,24289,30595,26810,1,7,-29,2318,1,-746,-1222,0,0,0,0,-2
EUW1_6856688530',4,25,10,1,0,0,0,4,1,353,83,27054,29256,23316,3,28,9,1,0,0,0,5,362,100,25919,30385,31840,1,-9,-17,1135,1,-1129,-8524,0,0,0,0,-1
EUW1_6855903044',1,18,12,0,0,0,0,9,0,326,94,27084,28524,33068,6,27,22,2,0,1,0,3,334,90,31453,33093,38406,0,-8,4,-4369,-10,-4569,-5338,-2,0,-1,0,6
EUW1_6855868117',2,22,13,1,0,2,0,5,1,381,105,29508,30352,34925,2,29,6,0,0,0,0,5,347,78,23503,27903,25585,1,34,27,6005,7,2449,9340,1,0,2,0,0
EUW1_6855677825',3,23,13,1,0,1,0,10,1,322,114,30342,30414,32756,2,26,15,0,1,2,0,6,300,74,27987,30552,30551,1,22,40,2355,-2,-138,2205,1,-1,-1,0,4
EUW1_6855640833',1,22,10,0,0,0,0,11,1,311,76,25999,26985,29546,1,26,22,1,0,3,0,6,329,84,31798,31369,40486,0,-18,-8,-5799,-12,-4384,-10940,-1,0,-3,0,5
EUW1_6855616612',3,66,8,0,0,1,0,9,0,367,73,26309,28548,28804,3,26,11,2,0,0,0,5,312,94,25349,28750,32529,1,55,-21,960,-3,-202,-3725,-2,0,1,0,4
EUW1_6855496293',4,24,11,0,0,0,0,15,1,327,78,27429,27475,32497,4,31,22,2,0,2,0,2,368,86,32080,30965,40923,0,-41,-8,-4651,-11,-3490,-8426,-2,0,-2,0,13
EUW1_6855484177',1,21,16,0,0,1,0,12,0,337,76,29094,30872,42930,1,24,22,1,0,1,0,3,347,106,32511,32563,46441,0,-10,-30,-3417,-6,-1691,-3511,-1,0,0,0,9
EUW1_6855471273',8,42,8,1,0,1,0,10,1,327,100,26638,26446,27908,4,25,16,0,0,1,0,6,321,100,28611,29222,34903,0,6,0,-1973,-8,-2776,-6995,1,0,0,0,4
EUW1_6855470603',4,29,13,1,0,0,0,14,0,316,75,27527,27957,30192,3,29,20,1,0,3,0,2,355,81,33049,31209,39091,0,-39,-6,-5522,-7,-3252,-8899,0,0,-3,0,12
EUW1_6854641767',2,19,10,0,0,1,0,11,0,305,74,26369,26552,30815,0,30,22,2,0,2,0,2,362,122,33129,33737,40007,0,-57,-48,-6760,-12,-7185,-9192,-2,0,-1,0,9
EUW1_6854544839',3,20,12,1,0,1,0,10,0,378,80,27263,29567,30263,0,20,11,0,0,1,0,4,345,74,27079,29871,26233,0,33,6,184,1,-304,4030,1,0,0,0,6
EUW1_6854513414',0,28,20,1,0,5,0,2,1,369,95,34792,31096,47607,0,11,11,0,0,1,0,12,213,66,24104,22102,32498,1,156,29,10688,9,8994,15109,1,0,4,0,-10
EUW1_6854475373',4,24,16,1,0,1,0,9,1,368,98,28696,30888,26710,5,136,8,1,0,1,0,4,380,70,26041,27503,37867,0,-12,28,2655,8,3385,-11157,0,0,0,0,5
EUW1_6854446169',2,22,12,0,1,1,0,12,0,274,82,25867,27318,26979,1,23,9,2,0,3,0,5,363,93,28099,28463,29585,1,-89,-11,-2232,3,-1145,-2606,-2,1,-2,0,7
EUW1_6854406038',1,81,15,0,0,0,0,12,0,330,82,28176,30011,37736,2,26,18,2,0,0,0,3,333,114,29174,32531,39472,0,-3,-32,-998,-3,-2520,-1736,-2,0,0,0,9
EUW1_6854386202',1,30,26,2,0,2,0,7,1,369,112,35688,32689,43327,2,24,7,0,0,1,0,10,294,86,23898,25522,27348,1,75,26,11790,19,7167,15979,2,0,1,0,-3
EUW1_6854375694',4,30,21,2,0,2,0,6,1,331,84,31664,30416,45646,3,33,8,0,0,2,0,7,276,80,23645,23184,32124,1,55,4,8019,13,7232,13522,2,0,0,0,-1
EUW1_6854316586',3,29,19,1,0,0,0,8,1,372,70,30098,31790,38613,0,22,9,0,0,0,0,6,311,100,26425,28541,35392,1,61,-30,3673,10,3249,3221,1,0,0,0,2
EUW1_6854288275',2,23,14,2,0,1,0,7,1,347,70,28304,29998,32154,0,35,14,0,0,0,0,7,317,82,27665,29964,33959,1,30,-12,639,0,34,-1805,2,0,1,0,0
EUW1_6883762416',1,29,11,1,0,0,0,5,1,329,76,25923,28614,33038,3,24,18,1,0,0,0,6,324,96,29494,30991,36124,1,5,-20,-3571,-7,-2377,-3086,0,0,0,0,-1
EUW1_6883748810',3,24,7,0,1,0,0,8,1,341,106,24106,29850,21171,3,23,4,2,0,1,0,2,391,92,24474,29754,25171,0,-50,14,-368,3,96,-4000,-2,1,-1,0,6
EUW1_6883491137',5,28,14,2,0,1,0,7,1,371,101,28867,31178,36374,3,35,7,0,0,1,0,6,380,69,25290,29864,24237,1,-9,32,3577,7,1314,12137,2,0,0,0,1
EUW1_6883449462',5,29,13,0,0,0,0,17,0,327,70,28044,29025,34345,5,31,35,1,0,3,0,3,364,90,37877,32414,54293,0,-37,-20,-9833,-22,-3389,-19948,-1,0,-3,0,14
EUW1_6883340492',2,26,8,0,1,0,0,14,0,368,96,26711,29913,25226,6,31,12,2,0,1,0,1,380,80,27580,29735,40586,0,-12,16,-869,-4,178,-15360,-2,1,-1,0,13
EUW1_6883247935',2,31,10,1,0,2,0,8,1,386,98,27519,30938,25789,2,32,6,0,0,0,0,7,373,70,23181,29199,26930,1,13,28,4338,4,1739,-1141,1,0,2,0,1
EUW1_6883156024',2,23,10,0,0,0,0,9,0,306,96,25014,28816,33049,4,363,13,2,0,1,0,1,380,75,27518,30523,31973,0,-74,21,-2504,-3,-1707,1076,-2,0,-1,0,8
EUW1_6883094834',4,69,11,1,0,1,0,10,0,347,87,26282,30839,26189,4,63,6,1,0,0,0,0,359,96,24356,28982,28773,1,-12,-9,1926,5,1857,-2584,0,0,1,0,10
EUW1_6882003191',1,21,16,2,0,0,0,13,1,371,109,29573,31637,36119,2,21,15,0,0,0,0,2,294,86,27169,30606,31919,1,77,23,2404,1,1031,4200,2,0,0,0,11
EUW1_6881869248',3,25,6,1,0,0,0,12,0,292,77,22876,26365,27798,3,99,18,1,0,2,0,3,367,94,30810,31568,40344,0,-75,-17,-7934,-12,-5203,-12546,0,0,-2,0,9
EUW1_6881797964',8,24,19,0,0,1,0,12,1,327,76,29579,28242,35456,6,28,19,2,0,1,0,9,332,89,30222,30354,33548,1,-5,-13,-643,0,-2112,1908,-2,0,0,0,3
EUW1_6881614420',4,29,14,1,1,1,0,5,1,393,76,29427,30139,31963,4,32,13,1,0,0,0,5,366,90,27395,30121,34439,0,27,-14,2032,1,18,-2476,0,1,1,0,0
EUW1_6881546876',6,29,7,1,0,0,0,13,1,363,73,25593,27877,30266,4,25,15,0,0,2,0,3,375,94,30317,32141,47470,0,-12,-21,-4724,-8,-4264,-17204,1,0,-2,0,10
EUW1_6881367333',3,44,11,1,0,0,0,8,0,328,92,26980,28421,35341,1,25,15,1,0,1,0,3,367,104,29480,31765,35327,0,-39,-12,-2500,-4,-3344,14,0,0,-1,0,5
EUW1_6881272627',0,28,12,0,0,1,0,13,1,347,69,26643,30229,34478,7,30,11,2,0,2,0,3,335,109,28150,29852,34486,1,12,-40,-1507,1,377,-8,-2,0,-1,0,10
EUW1_6881192945',2,21,14,2,0,2,0,10,0,357,100,30109,31267,37121,2,204,8,0,0,1,0,9,320,66,23808,26719,26982,1,37,34,6301,6,4548,10139,2,0,1,0,1
EUW1_6881097261',6,28,15,2,0,0,0,11,1,320,84,26753,28371,31439,3,27,10,0,0,0,0,2,385,70,25953,28882,29550,1,-65,14,800,5,-511,1889,2,0,0,0,9
EUW1_6853843159',3,57,19,2,0,0,0,7,1,321,57,29035,28220,34882,3,26,15,0,0,2,0,5,319,84,28714,29296,35220,1,2,-27,321,4,-1076,-338,2,0,-2,0,2
EUW1_6853794353',4,23,7,0,0,0,0,16,0,362,61,25765,28298,23775,5,25,16,1,0,4,0,1,414,114,33679,31632,34297,0,-52,-53,-7914,-9,-3334,-10522,-1,0,-4,0,15
EUW1_6853731207',3,51,14,0,0,1,0,11,1,351,67,28513,30909,37438,2,28,16,1,0,1,0,2,354,93,28982,31533,33141,0,-3,-26,-469,-2,-624,4297,-1,0,0,0,9
EUW1_6836887510',4,56,22,2,0,2,0,6,1,372,71,33090,32613,35603,6,138,7,0,0,0,0,5,324,86,23626,27003,25129,1,48,-15,9464,15,5610,10474,2,0,2,0,1
EUW1_6836293862',5,31,11,1,0,1,0,13,1,368,104,28530,29822,26508,3,37,9,1,0,2,0,5,344,83,26346,27717,31584,1,24,21,2184,2,2105,-5076,0,0,-1,0,8
EUW1_6836235866',6,38,15,2,0,0,0,10,1,339,89,27536,30154,30941,3,125,8,0,0,1,0,1,414,102,28831,30520,30684,1,-75,-13,-1295,7,-366,257,2,0,-1,0,9
EUW1_6836178493',2,49,13,0,0,0,0,11,1,373,88,28183,31102,27863,4,28,9,1,0,1,0,3,368,60,26309,29396,39143,1,5,28,1874,4,1706,-11280,-1,0,-1,0,8
EUW1_6836100730',3,156,5,1,0,1,0,6,0,385,81,26628,30268,27452,5,67,15,0,0,1,0,10,399,91,28329,31673,28583,0,-14,-10,-1701,-10,-1405,-1131,1,0,0,0,-4
EUW1_6836030608',6,27,9,1,0,1,0,6,1,377,84,26855,31325,28402,8,67,8,0,0,0,0,7,357,68,25262,28517,29059,1,20,16,1593,1,2808,-657,1,0,1,0,-1
EUW1_6833653462',3,28,10,1,0,0,0,12,0,380,61,26492,27905,29454,0,18,6,0,0,1,0,3,354,94,25031,28902,27963,0,26,-33,1461,4,-997,1491,1,0,-1,0,9
EUW1_6833611956',2,57,6,1,0,1,0,11,1,391,71,26355,30307,29690,4,41,8,1,0,0,0,4,316,119,25377,28408,30455,0,75,-48,978,-2,1899,-765,0,0,1,0,7
EUW1_6827344877',5,25,13,1,0,0,0,11,0,370,91,29435,31488,32654,4,52,17,1,0,2,0,4,385,72,30133,31285,36947,0,-15,19,-698,-4,203,-4293,0,0,-2,0,7
EUW1_6827265960',8,52,14,0,1,1,0,11,0,341,67,28556,28249,29800,3,27,13,2,0,2,0,5,322,93,28879,28549,33584,0,19,-26,-323,1,-300,-3784,-2,1,-1,0,6
EUW1_6824523773',3,83,21,0,0,0,0,7,0,342,75,31820,31951,38769,7,64,17,2,0,1,0,6,303,86,28370,27054,38759,1,39,-11,3450,4,4897,10,-2,0,-1,0,1
EUW1_6823270229',4,64,9,1,0,1,0,4,1,398,69,27847,29438,23727,6,30,3,0,1,0,0,4,367,87,23777,28839,22013,1,31,-18,4070,6,599,1714,1,-1,1,0,0
EUW1_6880847261',5,50,10,0,0,0,0,6,0,349,98,25135,30094,36285,2,34,7,1,0,0,0,1,374,93,24750,30297,26998,0,-25,5,385,3,-203,9287,-1,0,0,0,5
EUW1_6880841820',3,20,18,0,0,0,0,15,1,312,52,28490,28123,39839,3,151,30,1,0,6,0,0,394,83,39258,32338,50193,0,-82,-31,-10768,-12,-4215,-10354,-1,0,-6,0,15
EUW1_6880815436',0,35,13,0,0,1,0,7,1,320,76,26848,27149,38122,5,30,13,1,0,0,0,2,303,88,26298,27514,33958,0,17,-12,550,0,-365,4164,-1,0,1,0,5
EUW1_6880766043',1,24,12,0,0,0,0,10,0,336,82,26300,28133,25073,5,45,15,1,0,1,0,3,351,82,28711,28538,39433,0,-15,0,-2411,-3,-405,-14360,-1,0,-1,0,7
EUW1_6880726447',1,19,17,1,0,0,0,14,0,321,84,29877,30413,38023,1,17,16,1,0,1,0,1,380,89,29942,31243,43577,0,-59,-5,-65,1,-830,-5554,0,0,-1,0,13
EUW1_6875678602',2,63,6,0,1,0,0,4,0,394,89,25479,28420,23795,6,25,5,1,0,1,0,2,408,85,23838,27911,20647,1,-14,4,1641,1,509,3148,-1,1,-1,0,2
EUW1_6875611449',3,34,10,1,0,1,0,9,1,371,92,27282,28389,34564,1,20,15,0,0,0,0,5,353,94,28977,30759,33158,0,18,-2,-1695,-5,-2370,1406,1,0,1,0,4
EUW1_6874880933',2,27,12,1,0,0,0,8,0,344,86,26466,27764,32838,4,30,17,1,0,2,0,1,382,88,30983,31085,38181,0,-38,-2,-4517,-5,-3321,-5343,0,0,-2,0,7
EUW1_6874835358',3,29,14,2,1,2,0,6,1,374,102,29369,32210,31412,4,33,5,0,0,0,0,6,396,78,24198,27980,23236,1,-22,24,5171,9,4230,8176,2,1,2,0,0
EUW1_6874696987',7,25,16,1,0,0,0,8,1,347,96,28428,29795,33136,5,32,11,1,0,1,0,2,364,84,26613,29439,30426,0,-17,12,1815,5,356,2710,0,0,-1,0,6
EUW1_6874619955',4,34,12,0,0,1,0,11,0,381,70,28167,30249,28823,3,24,16,1,0,1,0,5,355,100,28642,28878,27543,1,26,-30,-475,-4,1371,1280,-1,0,0,0,6
EUW1_6873216676',3,28,18,2,0,1,0,8,1,331,88,30630,29362,39228,1,24,15,0,0,1,0,9,352,72,28565,30513,32782,1,-21,16,2065,3,-1151,6446,2,0,0,0,-1
EUW1_6873144351',5,26,13,1,0,0,0,4,0,337,94,27540,30752,35060,0,26,10,1,0,0,0,4,304,79,24967,27302,36088,1,33,15,2573,3,3450,-1028,0,0,0,0,0
EUW1_6873046337',4,26,11,1,0,0,0,9,1,333,79,25375,27443,26496,6,45,6,1,0,1,0,0,371,88,25802,28751,25117,1,-38,-9,-427,5,-1308,1379,0,0,-1,0,9
EUW1_6872998359',5,25,15,0,0,0,0,12,1,302,68,26792,28455,38201,4,32,17,1,0,1,0,0,364,76,28825,28226,40993,0,-62,-8,-2033,-2,229,-2792,-1,0,-1,0,12
EUW1_6873130811',3,37,5,1,0,0,0,12,0,354,100,23874,29002,27735,5,28,15,1,0,1,0,0,380,103,29370,32509,35669,0,-26,-3,-5496,-10,-3507,-7934,0,0,-1,0,12
EUW1_6835962671',2,243,12,1,1,1,0,8,0,384,80,28576,29893,36515,7,56,16,1,0,1,0,6,330,83,28974,29406,31782,1,54,-3,-398,-4,487,4733,0,1,0,0,2
EUW1_6835912841',4,28,7,0,0,0,0,12,0,276,89,24305,26504,30710,3,48,18,1,0,2,0,1,375,72,30568,30659,36809,0,-99,17,-6263,-11,-4155,-6099,-1,0,-2,0,11
EUW1_6833552432',8,33,22,2,0,2,0,10,0,368,84,32685,30298,46567,7,212,12,0,0,2,0,8,304,60,27412,24825,38997,1,64,24,5273,10,5473,7570,2,0,0,0,2
EUW1_6831592954',5,25,13,1,1,0,0,7,0,361,73,27078,29496,28321,5,28,8,0,0,1,0,4,404,73,27309,28891,25467,0,-43,0,-231,5,605,2854,1,1,-1,0,3
EUW1_6831537630',6,34,9,0,0,1,0,9,0,390,87,27419,30031,26652,4,51,8,1,0,1,0,3,374,82,25242,29742,29611,0,16,5,2177,1,289,-2959,-1,0,0,0,6
EUW1_6826099748',3,30,23,2,1,2,0,10,1,368,106,33828,32796,48503,6,40,5,0,0,0,0,8,322,71,22709,26588,24424,1,46,35,11119,18,6208,24079,2,1,2,0,2
EUW1_6826012392',2,50,15,1,0,1,0,10,1,341,79,28274,31525,33182,2,132,7,1,0,0,0,3,320,86,24509,28190,28194,1,21,-7,3765,8,3335,4988,0,0,1,0,7
EUW1_6825961474',2,24,14,1,0,1,0,10,0,337,83,28221,28756,33868,3,46,14,1,0,0,0,2,364,83,27518,29000,26133,1,-27,0,703,0,-244,7735,0,0,1,0,8
EUW1_6824577049',2,247,8,1,0,0,0,4,0,387,109,27564,30951,33695,5,55,11,1,0,0,0,7,397,60,26475,29629,27919,1,-10,49,1089,-3,1322,5776,0,0,0,0,-3
EUW1_6823147984',9,63,9,1,0,1,0,5,1,407,78,27809,28772,28801,0,36,9,0,0,0,0,6,361,88,26802,29092,22571,1,46,-10,1007,0,-320,6230,1,0,1,0,-1
EUW1_6821118932',4,26,8,0,0,0,0,10,1,341,114,25648,27981,26899,2,32,12,1,0,2,0,1,416,78,29587,31266,29024,0,-75,36,-3939,-4,-3285,-2125,-1,0,-2,0,9
EUW1_6821054088',2,30,16,1,0,0,0,12,0,375,108,30034,30100,38657,6,31,20,1,0,1,0,4,339,80,32159,30463,35043,1,36,28,-2125,-4,-363,3614,0,0,-1,0,8
EUW1_6867637364',0,26,12,0,0,1,0,10,0,379,96,28149,32429,32071,3,25,11,1,0,0,0,2,388,83,27401,33031,29655,0,-9,13,748,1,-602,2416,-1,0,1,0,8
EUW1_6857130845',2,41,13,2,0,0,0,6,0,324,82,27799,29825,31589,5,34,14,0,0,0,0,4,344,76,27063,27858,32268,1,-20,6,736,-1,1967,-679,2,0,0,0,2
EUW1_6854098222',3,24,21,1,1,1,0,10,1,357,102,31621,32741,38728,4,131,7,0,0,1,0,2,371,62,24258,27242,27885,1,-14,40,7363,14,5499,10843,1,1,0,0,8
EUW1_6853949897',3,30,14,2,0,1,0,7,0,364,92,28503,28829,29415,4,28,17,0,0,1,0,4,343,71,29242,28498,39604,0,21,21,-739,-3,331,-10189,2,0,0,0,3
EUW1_6853655203',2,40,21,0,0,4,0,7,1,389,79,33843,32936,42780,1,51,7,0,0,0,0,8,317,83,24314,27625,26438,1,72,-4,9529,14,5311,16342,0,0,4,0,-1
EUW1_6853474371',3,27,7,1,0,1,0,7,1,383,94,26711,28693,31223,3,26,12,0,0,0,0,5,340,97,27217,29412,25550,1,43,-3,-506,-5,-719,5673,1,0,1,0,2
EUW1_6853420132',4,30,8,1,0,0,0,14,0,354,80,24778,27988,29774,4,48,9,1,0,2,0,1,342,84,26661,29078,26475,1,12,-4,-1883,-1,-1090,3299,0,0,-2,0,13
EUW1_6850005090',5,62,17,1,0,1,0,11,0,303,108,29368,30652,37836,3,58,8,0,0,1,0,5,388,68,26470,27910,37393,1,-85,40,2898,9,2742,443,1,0,0,0,6
EUW1_6849398952',3,376,3,0,0,0,0,8,0,345,86,22608,27441,25259,1,31,16,1,0,1,0,2,374,109,29857,31950,35807,0,-29,-23,-7249,-13,-4509,-10548,-1,0,-1,0,6
EUW1_6849176635',5,203,18,1,0,1,0,12,0,315,112,31078,30196,32153,5,36,19,1,0,1,0,4,355,84,30492,30838,41083,0,-40,28,586,-1,-642,-8930,0,0,0,0,8
EUW1_6849115667',2,44,13,0,0,1,0,5,1,423,98,30421,32005,35856,5,38,9,1,0,0,0,6,344,78,25571,27501,25248,1,79,20,4850,4,4504,10608,-1,0,1,0,-1
EUW1_6848581933',3,30,11,1,0,1,0,4,1,400,90,28142,29734,29831,8,121,8,0,0,0,0,4,391,74,24460,28618,21605,0,9,16,3682,3,1116,8226,1,0,1,0,0
EUW1_6848388301',4,27,18,0,0,4,0,5,1,378,100,32931,32451,42678,2,86,11,2,0,0,0,10,317,82,25525,29652,34821,0,61,18,7406,7,2799,7857,-2,0,4,0,-5
EUW1_6848262418',1,33,8,0,0,0,0,9,0,396,88,25870,28744,30757,4,29,11,1,0,1,0,4,416,100,28244,32405,30372,0,-20,-12,-2374,-3,-3661,385,-1,0,-1,0,5
EUW1_6847615562',5,28,16,0,0,0,0,4,0,377,96,29359,30956,39619,5,135,14,1,0,0,0,1,318,76,26664,28966,34322,1,59,20,2695,2,1990,5297,-1,0,0,0,3
EUW1_6847567645',4,29,13,2,0,1,0,11,0,342,84,28807,30314,36731,4,486,12,0,0,2,0,7,344,80,28709,30034,32059,1,-2,4,98,1,280,4672,2,0,-1,0,4
EUW1_6847195601',5,28,8,0,1,0,0,8,0,404,84,25879,31537,23552,3,20,4,1,0,0,0,3,387,91,24230,30756,22176,1,17,-7,1649,4,781,1376,-1,1,0,0,5
EUW1_6836728037',1,26,13,1,0,1,0,11,0,369,86,29011,29307,31669,3,24,15,1,0,0,0,5,348,93,27416,30125,32561,1,21,-7,1595,-2,-818,-892,0,0,1,0,6
EUW1_6836391453',7,29,10,0,0,0,0,8,0,288,82,24117,25111,32079,5,27,16,1,0,1,0,3,364,106,30094,29441,35905,0,-76,-24,-5977,-6,-4330,-3826,-1,0,-1,0,5
EUW1_6881828153',3,28,16,1,0,1,0,13,0,310,96,28752,28985,41692,4,26,19,1,0,1,0,3,395,78,31695,30494,41221,0,-85,18,-2943,-3,-1509,471,0,0,0,0,10
EUW1_6881528316',2,23,7,2,0,1,0,5,0,405,89,26371,29819,30032,5,32,11,0,0,0,0,3,342,98,26373,29511,32393,1,63,-9,-2,-4,308,-2361,2,0,1,0,2
EUW1_6881389505',3,192,10,0,0,0,0,12,1,352,91,26227,29273,28752,1,25,19,2,0,2,0,2,398,112,33263,33830,37512,0,-46,-21,-7036,-9,-4557,-8760,-2,0,-2,0,10
EUW1_6881321171',1,27,9,1,0,1,0,10,1,381,110,27521,31035,39010,6,100,14,1,0,1,0,4,343,86,27050,30277,33830,0,38,24,471,-5,758,5180,0,0,0,0,6
EUW1_6881293727',4,26,18,2,1,1,0,10,1,384,87,31108,32298,37135,1,25,4,0,0,1,0,8,374,93,24417,28016,27694,1,10,-6,6691,14,4282,9441,2,1,0,0,2
EUW1_6881256462',2,30,9,2,0,1,0,9,0,373,116,27790,29048,34557,3,38,13,0,0,1,0,4,320,86,26561,28890,31233,0,53,30,1229,-4,158,3324,2,0,0,0,5
EUW1_6881102054',5,36,7,1,0,0,0,4,0,398,92,25277,30505,29199,5,49,6,1,0,0,0,4,374,80,24222,29021,25316,1,24,12,1055,1,1484,3883,0,0,0,0,0
EUW1_6867123645',3,90,15,1,0,1,0,8,0,369,92,28415,30788,39613,3,29,18,1,0,2,0,3,339,112,30163,31268,35957,0,30,-20,-1748,-3,-480,3656,0,0,-1,0,5
EUW1_6867052781',2,122,16,0,0,1,0,10,0,319,98,28019,29099,37165,6,34,11,1,0,1,0,3,326,120,28175,30042,38576,0,-7,-22,-156,5,-943,-1411,-1,0,0,0,7
EUW1_6865764673',2,25,13,0,0,0,0,11,0,351,66,27870,28730,37176,4,219,15,2,0,0,0,3,363,103,29384,32403,39879,0,-12,-37,-1514,-2,-3673,-2703,-2,0,0,0,8
EUW1_6864241004',3,26,18,1,0,1,0,10,0,381,68,29555,31926,32050,0,26,10,0,0,1,0,5,370,110,28147,30376,28716,0,11,-42,1408,8,1550,3334,1,0,0,0,5
EUW1_6863099915',4,31,17,0,0,2,0,6,1,379,100,32692,32802,36187,0,27,9,2,0,1,0,12,348,76,25693,28602,31281,1,31,24,6999,8,4200,4906,-2,0,1,0,-6
EUW1_6858774848',6,26,20,2,0,1,0,10,1,359,113,31526,31581,33827,0,36,13,0,0,1,0,2,300,102,27194,27613,37323,0,59,11,4332,7,3968,-3496,2,0,0,0,8
EUW1_6858745154',5,30,8,2,1,1,0,4,1,413,114,27453,31022,24260,3,24,1,0,0,0,0,5,378,80,22185,26590,15554,1,35,34,5268,7,4432,8706,2,1,1,0,-1
EUW1_6865083114',2,59,21,0,0,1,0,10,1,358,72,31972,31254,51386,6,27,15,2,0,1,0,3,354,70,28716,29654,37980,1,4,2,3256,6,1600,13406,-2,0,0,0,7
EUW1_6864989056',2,30,7,1,0,0,0,11,0,322,78,25228,25700,32636,7,32,20,1,1,2,0,1,371,86,32449,30665,42280,0,-49,-8,-7221,-13,-4965,-9644,0,-1,-2,0,10
EUW1_6864946048',4,29,5,1,0,0,0,15,0,285,82,23157,25834,21286,8,34,22,1,0,4,0,0,377,86,33803,32585,39818,0,-92,-4,-10646,-17,-6751,-18532,0,0,-4,0,15
EUW1_6883758186',2,58,12,0,1,1,0,7,1,329,73,27475,27922,29849,4,29,11,1,0,1,0,3,364,88,28235,29311,31198,0,-35,-15,-760,1,-1389,-1349,-1,1,0,0,4
EUW1_6882937273',0,47,9,0,0,0,0,8,1,365,72,25361,28078,24739,3,32,10,2,1,2,0,4,357,96,27052,29493,28903,0,8,-24,-1691,-1,-1415,-4164,-2,-1,-2,0,4
EUW1_6882893873',3,24,18,0,0,2,0,7,0,430,100,32152,33589,35890,3,28,11,2,0,0,0,4,324,96,26258,28155,29420,1,106,4,5894,7,5434,6470,-2,0,2,0,3
EUW1_6882840802',4,26,12,0,1,0,0,7,1,360,98,27923,29682,26419,6,25,8,1,0,0,0,0,346,70,24945,27195,23712,0,14,28,2978,4,2487,2707,-1,1,0,0,7
EUW1_6882790433',2,23,12,0,0,1,0,9,1,355,117,28423,30964,30985,10,31,12,2,0,0,0,9,349,85,27094,29156,30996,1,6,32,1329,0,1808,-11,-2,0,1,0,0
EUW1_6882761465',6,31,13,0,0,0,0,12,0,355,90,28614,30135,36878,4,43,20,2,0,3,0,2,363,77,32343,29713,37224,1,-8,13,-3729,-7,422,-346,-2,0,-3,0,10
EUW1_6882658580',5,210,5,1,0,0,0,10,0,372,91,24409,29372,22896,7,36,13,1,0,1,0,2,422,100,29147,31946,27278,1,-50,-9,-4738,-8,-2574,-4382,0,0,-1,0,8
EUW1_6882607937',2,24,5,0,0,0,0,13,0,282,41,21919,23967,22274,8,32,19,1,1,2,0,0,352,109,31612,28317,36428,0,-70,-68,-9693,-14,-4350,-14154,-1,-1,-2,0,13
EUW1_6882480516',5,30,17,1,0,1,0,3,1,411,91,29327,30618,35772,1,27,10,0,0,0,0,6,340,75,25188,28786,28302,1,71,16,4139,7,1832,7470,1,0,1,0,-3
EUW1_6882452959',4,27,14,0,1,0,0,5,1,381,91,29567,29599,37049,9,30,14,2,0,0,0,5,339,75,26773,28048,29858,1,42,16,2794,0,1551,7191,-2,1,0,0,0
EUW1_6882430206',4,28,8,1,0,0,0,10,1,351,91,24904,28625,25389,2,295,8,1,0,2,0,2,415,96,27347,30966,29627,1,-64,-5,-2443,0,-2341,-4238,0,0,-2,0,8
EUW1_6881430074',7,40,7,1,1,0,0,4,1,397,100,25914,30131,36977,3,33,4,1,0,0,0,2,351,96,22994,29944,23400,0,46,4,2920,3,187,13577,0,1,0,0,2
EUW1_6881381741',3,26,13,1,0,0,0,6,1,400,71,27154,28602,29666,2,25,11,1,0,0,0,2,383,89,27310,31648,29533,1,17,-18,-156,2,-3046,133,0,0,0,0,4
EUW1_6881658315',3,27,13,0,0,2,0,6,0,344,96,29113,31117,33415,7,32,12,2,0,1,0,7,384,84,27612,30639,34209,0,-40,12,1501,1,478,-794,-2,0,1,0,-1
EUW1_6881589437',2,29,15,1,0,1,0,7,1,339,108,29160,31340,28344,3,22,13,0,0,0,0,7,398,80,29192,31920,29236,0,-59,28,-32,2,-580,-892,1,0,1,0,0
EUW1_6881530788',3,18,15,0,0,1,0,10,1,331,84,28561,27834,37231,1,40,15,1,0,1,0,5,288,91,28460,27951,34490,0,43,-7,101,0,-117,2741,-1,0,0,0,5
EUW1_6881480290',1,25,16,1,0,1,0,6,1,374,86,28914,30869,34707,2,22,10,0,0,0,0,5,311,74,24622,28374,29018,1,63,12,4292,6,2495,5689,1,0,1,0,1
EUW1_6878742230',8,34,6,2,0,0,0,12,1,375,70,24361,28696,22342,1,28,12,0,0,1,0,1,352,120,29401,31700,32386,0,23,-50,-5040,-6,-3004,-10044,2,0,-1,0,11
EUW1_6878691234',5,32,9,1,0,0,0,12,1,339,96,26241,26090,42504,1,22,17,0,1,1,0,4,341,80,28933,28973,36733,0,-2,16,-2692,-8,-2883,5771,1,-1,-1,0,8
EUW1_6878657742',3,31,7,0,0,0,0,16,0,330,64,23902,26141,22985,4,32,17,2,1,2,0,1,434,112,31710,33230,33481,0,-104,-48,-7808,-10,-7089,-10496,-2,-1,-2,0,15
EUW1_6878604882',10,33,12,0,0,1,0,16,1,349,84,27037,28409,30096,1,48,16,1,0,2,0,2,371,77,29815,29475,31806,0,-22,7,-2778,-4,-1066,-1710,-1,0,-1,0,14
EUW1_6874379197',2,25,18,1,0,1,0,10,1,331,116,29837,30304,36868,6,34,14,1,0,0,0,5,304,95,26899,29734,31728,0,27,21,2938,4,570,5140,0,0,1,0,5
EUW1_6874347518',2,27,15,0,0,1,0,8,0,346,72,28333,29250,34639,4,29,13,1,0,1,0,3,315,76,27403,26971,28002,1,31,-4,930,2,2279,6637,-1,0,0,0,5
EUW1_6874282510',3,31,13,1,0,1,0,9,0,356,76,29445,28825,36603,1,20,17,1,0,1,0,5,365,91,31282,31958,40059,0,-9,-15,-1837,-4,-3133,-3456,0,0,0,0,4
EUW1_6852879757',1,27,6,2,0,1,0,6,1,369,99,25907,28819,22849,6,34,9,0,0,1,0,4,377,100,26530,30771,31329,0,-8,-1,-623,-3,-1952,-8480,2,0,0,0,2
EUW1_6852850637',1,23,10,1,0,1,0,7,1,345,91,26905,27888,29477,4,26,13,1,0,1,0,4,317,96,27577,27247,30130,0,28,-5,-672,-3,641,-653,0,0,0,0,3
EUW1_6852814718',6,62,8,0,0,2,0,12,0,382,76,27377,29555,35640,3,57,15,2,0,0,0,5,340,85,29967,30851,30659,0,42,-9,-2590,-7,-1296,4981,-2,0,2,0,7
EUW1_6852765731',2,27,8,1,0,0,0,6,1,402,94,26658,30492,29462,7,31,13,1,0,0,0,2,370,89,27578,30658,23050,0,32,5,-920,-5,-166,6412,0,0,0,0,4
EUW1_6852719350',7,82,25,0,0,1,0,12,1,379,72,34664,32149,45066,4,99,13,1,0,2,0,7,347,76,28475,27861,37066,1,32,-4,6189,12,4288,8000,-1,0,-1,0,5
EUW1_6852663773',4,147,7,0,0,0,0,11,1,394,104,24843,29405,28115,4,34,12,1,0,3,0,0,389,96,29950,32435,28429,0,5,8,-5107,-5,-3030,-314,-1,0,-3,0,11
EUW1_6852623050',8,73,6,0,0,0,0,12,0,356,64,24855,27520,35378,3,26,17,1,0,2,0,1,403,110,32754,32623,41098,0,-47,-46,-7899,-11,-5103,-5720,-1,0,-2,0,11
EUW1_6852544871',4,32,6,0,1,0,0,8,0,390,93,25318,28743,20068,1,39,11,2,0,0,0,2,375,100,27282,29299,22772,0,15,-7,-1964,-5,-556,-2704,-2,1,0,0,6
EUW1_6852470046',5,28,10,0,0,0,0,14,0,330,80,26380,27609,33907,1,46,29,1,0,1,0,1,313,83,32969,32563,45963,0,17,-3,-6589,-19,-4954,-12056,-1,0,-1,0,13
EUW1_6852404002',6,155,16,1,0,0,0,6,0,397,98,31003,33887,44236,3,134,11,0,0,1,0,4,384,92,27301,29950,31007,1,13,6,3702,5,3937,13229,1,0,-1,0,2
EUW1_6852242513',3,22,4,0,0,0,0,6,0,345,74,22767,26158,26648,7,32,19,1,0,2,0,2,363,112,31901,33730,39724,0,-18,-38,-9134,-15,-7572,-13076,-1,0,-2,0,4
EUW1_6852036681',4,80,13,2,0,0,0,6,1,358,69,27701,28555,36393,4,26,15,0,1,0,0,3,368,78,28514,28885,31245,1,-10,-9,-813,-2,-330,5148,2,-1,0,0,3
EUW1_6851988150',4,70,11,2,0,0,0,7,1,308,68,25664,26409,25622,0,95,16,0,0,0,0,0,380,91,29025,31149,35990,0,-72,-23,-3361,-5,-4740,-10368,2,0,0,0,7
EUW1_6851951131',3,28,8,1,0,1,0,9,1,350,96,27030,29310,32530,8,79,11,0,0,0,0,7,361,67,27251,29270,30370,0,-11,29,-221,-3,40,2160,1,0,1,0,2
EUW1_6851359357',3,29,7,0,0,0,0,9,1,342,91,24370,28171,20750,5,80,12,2,0,1,0,0,393,84,28326,30336,27718,0,-51,7,-3956,-5,-2165,-6968,-2,0,-1,0,9
EUW1_6851311115',1,88,8,1,0,0,0,10,1,334,94,24588,28883,25217,1,19,6,1,0,0,0,1,390,112,26132,30250,28097,0,-56,-18,-1544,2,-1367,-2880,0,0,0,0,9
EUW1_6851233035',2,68,10,1,0,0,0,10,1,343,99,25224,29492,33771,4,26,8,1,0,2,0,3,370,96,26874,29871,38294,0,-27,3,-1650,2,-379,-4523,0,0,-2,0,7
EUW1_6851197637',4,71,8,0,0,0,0,9,0,317,106,25406,28449,27205,3,24,14,2,0,1,0,1,380,102,29575,32443,39924,0,-63,4,-4169,-6,-3994,-12719,-2,0,-1,0,8
EUW1_6851112198',4,77,18,1,0,0,0,6,1,352,91,31072,29689,37297,2,27,16,1,0,1,0,2,359,89,29418,30701,31459,1,-7,2,1654,2,-1012,5838,0,0,-1,0,4
EUW1_6850947741',6,69,7,2,0,2,0,4,1,393,88,26505,28597,24517,6,37,11,0,0,0,0,3,359,70,26255,29399,26899,1,34,18,250,-4,-802,-2382,2,0,2,0,1
EUW1_6881268870',4,30,7,1,1,1,0,3,1,396,103,26755,29811,23039,3,26,6,1,0,0,0,6,380,104,24343,31310,25798,1,16,-1,2412,1,-1499,-2759,0,1,1,0,-3
EUW1_6881168775',2,22,10,0,0,0,0,8,1,341,87,25245,28080,29916,3,24,12,1,0,0,0,2,373,120,28021,31354,29000,1,-32,-33,-2776,-2,-3274,916,-1,0,0,0,6
EUW1_6863994870',2,49,24,0,0,2,0,5,1,315,95,33144,29985,41195,0,25,12,1,0,0,0,6,309,84,25886,25794,34369,0,6,11,7258,12,4191,6826,-1,0,2,0,-1
EUW1_6854935872',7,34,10,0,0,0,0,17,0,301,88,25198,26459,35791,2,86,21,2,0,3,0,0,371,113,34035,31792,43261,0,-70,-25,-8837,-11,-5333,-7470,-2,0,-3,0,17
EUW1_6854863878',3,26,7,0,0,0,0,15,1,357,102,25760,27898,28999,4,24,13,1,0,2,0,3,409,122,30433,32504,26689,1,-52,-20,-4673,-6,-4606,2310,-1,0,-2,0,12
EUW1_6854795891',2,23,11,1,1,0,0,16,0,334,76,27400,28670,28739,4,29,15,1,0,2,0,4,341,83,30478,29575,37825,1,-7,-7,-3078,-4,-905,-9086,0,1,-2,0,12
EUW1_6854749679',2,40,12,0,0,0,0,14,0,338,96,28111,29231,26022,2,33,18,2,0,2,0,3,378,99,33021,31457,37658,0,-40,-3,-4910,-6,-2226,-11636,-2,0,-2,0,11
EUW1_6852535448',3,230,9,2,0,1,0,2,0,359,93,26549,30883,27217,2,25,6,0,0,0,0,4,363,94,24237,29761,23305,0,-4,-1,2312,3,1122,3912,2,0,1,0,-2
EUW1_6851031250',5,26,26,1,0,3,0,8,1,334,94,34335,31643,42324,1,26,12,1,0,2,0,6,311,86,27929,29908,40350,1,23,8,6406,14,1735,1974,0,0,1,0,2
EUW1_6850972320',2,24,19,1,0,0,0,8,0,340,90,30475,31715,42328,1,21,17,1,0,0,0,2,359,94,28994,29340,39144,1,-19,-4,1481,2,2375,3184,0,0,0,0,6
EUW1_6850924142',3,37,12,1,0,0,0,8,1,349,103,26513,30162,38908,4,22,7,0,0,0,0,2,365,91,25542,29694,27916,1,-16,12,971,5,468,10992,1,0,0,0,6
EUW1_6852539096',4,43,11,0,0,2,0,14,1,351,92,28978,28200,33474,5,35,22,2,0,1,0,3,312,72,29870,27750,40031,0,39,20,-892,-11,450,-6557,-2,0,1,0,11
EUW1_6852411277',5,26,14,0,0,0,0,10,1,327,94,27467,28395,35366,5,32,15,2,1,2,0,2,336,90,29851,30263,34756,0,-9,4,-2384,-1,-1868,610,-2,-1,-2,0,8
EUW1_6852201513',2,23,20,1,0,3,0,12,1,336,72,32714,31583,37985,5,31,16,1,0,2,0,8,339,96,30797,29105,35205,0,-3,-24,1917,4,2478,2780,0,0,1,0,4
EUW1_6851367247',2,26,10,1,0,0,0,10,0,314,76,26925,28173,30476,5,97,21,1,0,0,0,2,334,74,29866,28391,38971,0,-20,2,-2941,-11,-218,-8495,0,0,0,0,8
EUW1_6851334487',11,36,24,2,0,2,0,6,1,340,76,32529,31861,44456,1,27,7,0,0,1,0,10,341,92,25128,27265,32633,1,-1,-16,7401,17,4596,11823,2,0,1,0,-4
EUW1_6851281664',1,27,19,1,0,1,0,4,0,376,88,31707,32248,39652,6,57,10,1,0,0,0,7,345,78,26231,27624,29719,1,31,10,5476,9,4624,9933,0,0,1,0,-3
EUW1_6851222446',2,25,17,2,0,0,0,4,1,387,102,29774,33547,32755,3,26,6,0,0,1,0,5,368,102,24886,28647,31340,1,19,0,4888,11,4900,1415,2,0,-1,0,-1
EUW1_6851148313',6,283,11,0,1,0,0,8,0,319,103,27429,29218,32854,7,36,10,2,0,1,0,5,354,56,25726,27141,33334,0,-35,47,1703,1,2077,-480,-2,1,-1,0,3
EUW1_6851119513',7,33,6,1,0,0,0,10,0,353,94,25222,28258,28855,4,34,22,1,1,2,0,1,340,86,31894,32136,40391,0,13,8,-6672,-16,-3878,-11536,0,-1,-2,0,9
EUW1_6850992898',5,59,15,0,0,1,0,7,1,322,100,29351,29934,38440,2,29,25,2,0,1,0,6,295,92,31858,32193,39684,1,27,8,-2507,-10,-2259,-1244,-2,0,0,0,1
EUW1_6850947489',4,36,17,1,0,0,0,11,0,366,86,29148,30724,36095,3,30,12,1,0,0,0,2,318,89,26494,28949,32154,1,48,-3,2654,5,1775,3941,0,0,0,0,9
EUW1_6850878012',2,24,4,0,0,1,0,10,1,380,87,26673,27411,24332,8,29,15,1,0,2,0,5,327,71,27158,27697,27001,1,53,16,-485,-11,-286,-2669,-1,0,-1,0,5
EUW1_6848914150',6,29,12,1,0,0,0,12,0,343,72,27081,27339,31389,7,38,27,1,1,3,0,0,380,112,37847,34356,47796,0,-37,-40,-10766,-15,-7017,-16407,0,-1,-3,0,12
EUW1_6882668622',7,34,22,0,0,1,0,9,0,310,112,31112,30735,38641,1,73,14,2,0,2,0,5,353,72,29653,28275,31944,0,-43,40,1459,8,2460,6697,-2,0,-1,0,4
EUW1_6881982241',3,25,6,0,0,0,0,10,0,379,96,24827,28672,30210,2,27,20,2,0,2,0,3,350,88,30534,33310,37044,0,29,8,-5707,-14,-4638,-6834,-2,0,-2,0,7
EUW1_6881904040',2,42,19,1,0,0,0,8,0,340,38,29250,26816,40514,4,21,22,1,0,1,0,1,354,95,31808,32897,47794,1,-14,-57,-2558,-3,-6081,-7280,0,0,-1,0,7
EUW1_6881850613',7,57,9,0,0,0,0,7,0,379,85,26070,27802,29283,6,31,21,2,0,2,0,2,377,70,31779,32083,38338,0,2,15,-5709,-12,-4281,-9055,-2,0,-2,0,5
EUW1_6881360113',3,27,22,0,0,1,0,9,1,315,82,31713,31044,40636,3,27,8,2,0,0,0,6,330,74,23224,25679,30566,1,-15,8,8489,14,5365,10070,-2,0,1,0,3
EUW1_6881312020',3,29,12,0,1,4,0,6,1,427,131,33919,32689,29729,2,33,6,1,0,1,0,11,333,69,22422,23932,18986,1,94,62,11497,6,8757,10743,-1,1,3,0,-5
EUW1_6879871437',6,28,13,0,0,1,0,10,0,336,84,27577,27294,29139,3,38,16,1,0,1,0,6,324,80,29185,28260,31157,0,12,4,-1608,-3,-966,-2018,-1,0,0,0,4
EUW1_6879831523',6,26,17,1,0,1,0,9,0,368,90,29858,30680,33154,6,35,11,1,0,0,0,3,351,96,26727,28631,32659,1,17,-6,3131,6,2049,495,0,0,1,0,6
EUW1_6879767289',3,27,19,2,0,0,0,13,1,323,86,29715,29691,38273,2,30,21,0,1,2,0,2,320,109,33357,30905,43063,1,3,-23,-3642,-2,-1214,-4790,2,-1,-2,0,11
EUW1_6879730933',2,27,17,1,0,1,0,7,0,344,82,29947,30383,34142,2,24,11,1,0,1,0,4,387,85,27688,29129,31514,1,-43,-3,2259,6,1254,2628,0,0,0,0,3
EUW1_6879677421',3,25,9,0,0,0,0,7,1,323,76,25643,26327,32590,6,29,11,2,0,1,0,6,358,72,27230,29028,36701,0,-35,4,-1587,-2,-2701,-4111,-2,0,-1,0,1
EUW1_6881874995',5,45,20,1,0,1,0,10,1,352,98,30039,30535,33687,6,26,9,1,0,1,0,5,347,96,25884,28496,27120,1,5,2,4155,11,2039,6567,0,0,0,0,5
EUW1_6881815259',1,24,17,1,1,4,0,10,1,382,99,34285,32342,34277,0,23,6,1,0,0,0,10,344,75,24705,26711,23903,1,38,24,9580,11,5631,10374,0,1,4,0,0
EUW1_6881689731',2,23,5,1,0,1,0,10,1,324,114,24548,28326,24963,3,32,13,1,0,2,0,5,364,102,28740,31904,29796,0,-40,12,-4192,-8,-3578,-4833,0,0,-1,0,5
EUW1_6881630078',1,24,14,0,0,0,0,7,1,310,72,28285,27857,39409,5,26,16,2,0,1,0,3,354,80,28884,28404,38471,0,-44,-8,-599,-2,-547,938,-2,0,-1,0,4
EUW1_6854847386',3,36,10,0,0,0,0,8,1,365,76,27280,28878,27576,2,24,14,2,1,0,0,1,376,107,29482,32158,32506,0,-11,-31,-2202,-4,-3280,-4930,-2,-1,0,0,7
EUW1_6854743089',1,27,20,2,0,0,0,11,1,350,106,32249,29845,43917,3,27,23,0,0,3,0,3,361,69,33683,30745,40953,0,-11,37,-1434,-3,-900,2964,2,0,-3,0,8
EUW1_6854707698',2,56,19,0,0,0,0,6,1,347,74,29888,32462,40634,3,83,5,2,0,1,0,3,360,86,24494,27906,32494,1,-13,-12,5394,14,4556,8140,-2,0,-1,0,3
EUW1_6854660683',2,23,10,2,0,0,0,13,0,337,77,26022,28568,31527,5,29,15,0,0,3,0,2,369,109,31232,30054,35440,1,-32,-32,-5210,-5,-1486,-3913,2,0,-3,0,11
EUW1_6854621897',8,30,10,0,1,0,0,9,0,341,116,26337,31477,32529,3,20,20,2,0,1,0,3,346,63,29638,31584,39321,0,-5,53,-3301,-10,-107,-6792,-2,1,-1,0,6
EUW1_6854576699',4,32,9,1,0,0,0,8,0,390,88,26935,30453,35706,4,19,10,1,1,0,0,1,372,104,25672,30903,32168,1,18,-16,1263,-1,-450,3538,0,-1,0,0,7
EUW1_6844425940',3,33,15,1,0,1,0,8,0,369,88,29168,29813,33203,6,36,15,1,0,0,0,2,333,99,27972,29228,42810,1,36,-11,1196,0,585,-9607,0,0,1,0,6
EUW1_6843061504',1,23,20,0,0,1,0,10,0,319,94,32754,31706,47988,2,20,25,1,1,5,0,4,368,90,34719,33167,47226,0,-49,4,-1965,-5,-1461,762,-1,-1,-4,0,6
EUW1_6843002590',5,64,22,1,0,3,0,10,0,392,117,34090,34741,44042,3,62,15,0,0,0,0,6,338,85,29189,30693,36848,1,54,32,4901,7,4048,7194,1,0,3,0,4
EUW1_6881397838',5,24,13,0,0,3,0,10,1,400,95,31355,30916,33264,2,29,10,2,0,1,0,7,321,96,26251,28386,28935,1,79,-1,5104,3,2530,4329,-2,0,2,0,3
EUW1_6875710695',3,23,14,1,0,0,0,8,1,381,109,29033,32030,37799,1,27,4,0,0,2,0,4,340,69,24106,25919,26149,1,41,40,4927,10,6111,11650,1,0,-2,0,4
EUW1_6874384589',9,40,17,1,0,2,0,10,0,384,84,30155,31081,34492,4,28,8,0,0,0,0,1,357,92,24431,28585,20909,0,27,-8,5724,9,2496,13583,1,0,2,0,9
EUW1_6874318183',1,93,7,1,0,0,0,4,0,371,83,24934,28290,30627,5,33,13,1,0,1,0,2,375,89,26839,30833,30933,1,-4,-6,-1905,-6,-2543,-306,0,0,-1,0,2
EUW1_6874263066',2,27,9,0,0,1,0,11,0,392,104,27923,32981,31976,6,27,6,2,1,2,0,3,415,107,27414,31799,24312,0,-23,-3,509,3,1182,7664,-2,-1,-1,0,8
EUW1_6874214761',2,58,11,1,1,1,0,7,0,403,105,28879,30432,26681,5,63,10,1,0,1,0,7,392,102,28379,30976,27653,1,11,3,500,1,-544,-972,0,1,0,0,0
EUW1_6874109471',4,36,9,1,0,1,0,4,1,400,72,27313,28951,30860,1,29,7,0,0,0,0,3,375,71,23626,27680,19803,0,25,1,3687,2,1271,11057,1,0,1,0,1
EUW1_6874047120',5,27,11,0,0,1,0,6,0,400,63,28396,30322,26360,4,26,11,1,0,1,0,6,364,100,28021,29103,33816,1,36,-37,375,0,1219,-7456,-1,0,0,0,0
EUW1_6873992221',2,24,12,1,0,1,0,13,0,367,101,27378,30391,27966,0,24,9,1,0,1,0,3,366,117,28017,30124,22311,1,1,-16,-639,3,267,5655,0,0,0,0,10
EUW1_6873120510',2,27,12,0,0,0,0,12,0,352,77,27422,28990,28917,4,53,19,0,0,2,0,3,358,86,32017,30392,37566,0,-6,-9,-4595,-7,-1402,-8649,0,0,-2,0,9
EUW1_6873056149',4,24,8,1,0,0,0,14,0,374,68,24793,28178,28670,6,32,12,1,0,3,0,2,404,112,30311,32129,27355,0,-30,-44,-5518,-4,-3951,1315,0,0,-3,0,12
EUW1_6872950968',6,23,4,0,0,0,0,8,0,370,103,23788,28800,18519,5,100,12,2,0,1,0,1,362,99,27463,30263,19836,0,8,4,-3675,-8,-1463,-1317,-2,0,-1,0,7
EUW1_6872835617',2,25,12,0,0,2,0,8,0,318,66,27949,27358,28207,5,48,12,2,0,1,0,5,373,93,28183,27834,27622,1,-55,-27,-234,0,-476,585,-2,0,1,0,3
EUW1_6872736964',8,25,15,0,0,2,0,8,1,330,100,28719,29230,28463,2,34,11,1,1,0,0,4,340,79,25923,27793,26125,1,-10,21,2796,4,1437,2338,-1,-1,2,0,4
EUW1_6872697745',7,33,10,0,0,1,0,10,1,372,54,26181,27544,35708,6,33,20,2,0,1,0,4,356,77,30165,29582,36190,0,16,-23,-3984,-10,-2038,-482,-2,0,0,0,6
EUW1_6856338936',7,39,14,1,0,0,0,7,1,375,80,28060,30207,38040,5,26,7,1,1,0,0,2,336,100,24231,28954,26020,1,39,-20,3829,7,1253,12020,0,-1,0,0,5
EUW1_6856297448',3,26,38,2,1,4,0,6,1,361,123,40858,35344,55078,4,40,7,0,0,2,0,11,310,63,24533,25945,28026,1,51,60,16325,31,9399,27052,2,1,2,0,-5
EUW1_6856243834',5,30,6,0,0,0,0,8,0,357,101,24274,29846,22875,5,89,11,2,0,1,0,2,373,90,28936,30339,27969,0,-16,11,-4662,-5,-493,-5094,-2,0,-1,0,6
EUW1_6874663816',5,28,6,0,0,0,0,14,0,354,91,24918,28494,32115,5,29,17,2,0,1,0,2,382,96,30069,32678,33220,0,-28,-5,-5151,-11,-4184,-1105,-2,0,-1,0,12
EUW1_6874611522',2,19,9,0,0,0,0,14,0,354,74,26466,26390,34716,2,24,24,2,1,2,0,4,369,122,34117,34441,42609,0,-15,-48,-7651,-15,-8051,-7893,-2,-1,-2,0,10
EUW1_6874101590',4,25,21,1,0,0,0,10,0,378,63,31102,32034,40826,0,22,10,1,0,0,0,7,325,86,25640,27996,31575,1,53,-23,5462,11,4038,9251,0,0,0,0,3
EUW1_6874050981',4,26,28,2,0,2,0,12,1,372,92,36365,32450,52469,3,140,11,0,0,1,0,4,273,55,24315,23668,39705,1,99,37,12050,17,8782,12764,2,0,1,0,8
EUW1_6874024708',1,23,7,0,0,0,0,7,0,395,128,25992,32729,24383,2,27,9,2,0,0,0,4,370,83,25494,29527,29726,1,25,45,498,-2,3202,-5343,-2,0,0,0,3
EUW1_6873059222',1,18,12,0,0,0,0,9,0,385,75,27674,30570,30840,2,30,23,1,0,1,0,2,359,67,30538,31598,40442,0,26,8,-2864,-11,-1028,-9602,-1,0,-1,0,7
EUW1_6863645946',9,34,9,0,0,0,0,5,0,306,82,25139,24777,32647,0,24,27,2,0,0,0,3,338,80,31721,30851,45779,0,-32,2,-6582,-18,-6074,-13132,-2,0,0,0,2
EUW1_6863608610',6,27,17,1,1,2,0,12,1,393,86,30362,30937,31480,2,147,10,1,0,0,0,5,411,96,27084,30999,29047,1,-18,-10,3278,7,-62,2433,0,1,2,0,7
EUW1_6863555517',3,35,23,1,0,1,0,8,1,352,80,33177,32002,44009,9,35,16,1,0,0,0,7,319,84,28314,27527,35307,1,33,-4,4863,7,4475,8702,0,0,1,0,1
EUW1_6862641800',4,27,23,1,0,2,0,15,1,383,104,35259,33461,41846,0,26,1,0,0,2,0,5,323,76,21408,24324,21995,1,60,28,13851,22,9137,19851,1,0,0,0,10
EUW1_6862371020',4,21,11,1,0,1,0,11,1,339,98,27503,30111,27428,3,43,9,1,1,2,0,1,387,112,28277,31092,27748,1,-48,-14,-774,2,-981,-320,0,-1,-1,0,10
EUW1_6862332206',5,32,18,2,0,1,0,7,0,380,105,31629,30198,34513,2,26,12,0,0,2,0,7,315,78,27190,26902,29594,1,65,27,4439,6,3296,4919,2,0,-1,0,0
EUW1_6862306430',1,15,4,1,0,0,0,14,0,276,96,21871,25080,20910,3,30,21,1,0,5,0,0,413,108,35755,33018,38251,0,-137,-12,-13884,-17,-7938,-17341,0,0,-5,0,14
EUW1_6861918553',4,31,6,0,0,0,0,9,0,357,76,23797,28319,22421,5,32,14,1,0,1,0,2,412,84,30104,31979,37313,0,-55,-8,-6307,-8,-3660,-14892,-1,0,-1,0,7
EUW1_6861885008',6,78,12,2,0,1,0,8,1,409,101,28938,32850,33558,0,53,5,0,0,0,0,5,380,90,24596,28854,23021,0,29,11,4342,7,3996,10537,2,0,1,0,3
EUW1_6861853196',1,19,10,0,0,0,0,7,0,383,120,27600,32663,27933,1,23,12,1,0,1,0,2,350,92,27825,29600,36267,1,33,28,-225,-2,3063,-8334,-1,0,-1,0,5
EUW1_6861809359',4,49,18,1,0,0,0,10,1,344,68,28544,30260,37148,3,25,11,1,0,1,0,0,375,92,27459,28457,40785,1,-31,-24,1085,7,1803,-3637,0,0,-1,0,10
EUW1_6861703124',3,33,6,1,0,1,0,10,0,326,79,23639,27730,32185,2,41,17,1,0,1,0,1,378,84,29285,30827,32760,0,-52,-5,-5646,-11,-3097,-575,0,0,0,0,9
EUW1_6880139126',3,28,9,1,0,1,0,8,0,343,94,26485,30245,21561,10,96,13,1,0,1,0,1,360,72,26945,30071,34831,0,-17,22,-460,-4,174,-13270,0,0,0,0,7
EUW1_6880083049',2,20,18,1,0,1,0,6,1,373,94,32481,30180,36896,3,22,15,1,0,1,0,7,304,102,27753,27962,36818,1,69,-8,4728,3,2218,78,0,0,0,0,-1
EUW1_6880022269',9,61,21,0,0,1,0,8,1,335,83,30659,29466,41064,4,60,16,2,0,0,0,7,281,84,26588,26769,34022,0,54,-1,4071,5,2697,7042,-2,0,1,0,1
EUW1_6879967326',5,27,12,0,1,0,0,13,1,367,84,26345,30244,25624,3,93,8,2,0,2,0,1,348,102,26519,28493,30850,0,19,-18,-174,4,1751,-5226,-2,1,-2,0,12
EUW1_6879836018',4,65,8,0,0,0,0,13,1,329,85,24609,27520,27273,7,39,19,1,0,1,0,1,385,86,31148,32795,39999,0,-56,-1,-6539,-11,-5275,-12726,-1,0,-1,0,12
EUW1_6869800343',7,29,26,1,0,0,0,5,1,295,75,31554,27925,43050,3,19,16,0,0,1,0,4,265,74,28673,25768,33281,1,30,1,2881,10,2157,9769,1,0,-1,0,1
EUW1_6869736447',2,25,15,0,1,1,0,7,1,386,94,29797,31109,33363,6,143,9,1,0,0,0,4,356,78,25858,29313,32548,0,30,16,3939,6,1796,815,-1,1,1,0,3
EUW1_6858131056',4,27,22,1,1,3,0,3,1,392,100,34722,33128,49363,3,23,11,1,0,0,0,11,314,92,27105,29418,28393,1,78,8,7617,11,3710,20970,0,1,3,0,-8
EUW1_6882583296',1,28,12,0,0,0,0,9,1,382,96,29768,31147,34575,5,29,11,1,0,1,0,5,341,80,25802,28938,29725,1,41,16,3966,1,2209,4850,-1,0,-1,0,4
EUW1_6882550541',4,32,7,0,0,0,0,7,0,374,112,26256,31026,24799,5,34,16,2,0,0,0,2,343,104,28449,33829,25299,0,31,8,-2193,-9,-2803,-500,-2,0,0,0,5
EUW1_6881511833',7,32,9,0,0,0,0,13,1,315,79,24676,27107,23711,4,23,15,2,0,2,0,0,381,84,30447,31148,35488,0,-66,-5,-5771,-6,-4041,-11777,-2,0,-2,0,13
EUW1_6881104644',3,30,16,1,0,1,0,10,1,349,75,29190,30686,37634,4,32,12,1,0,0,0,3,347,79,26561,28339,36262,1,2,-4,2629,4,2347,1372,0,0,1,0,7
EUW1_6879191252',0,22,6,0,0,0,0,12,0,340,74,23393,28010,30822,1,42,13,1,0,2,0,2,360,93,28706,30120,31768,0,-20,-19,-5313,-7,-2110,-946,-1,0,-2,0,10
EUW1_6879140926',4,99,14,0,0,0,0,17,0,361,67,27378,28382,29577,2,32,16,1,0,3,0,1,378,93,31684,31817,37346,0,-17,-26,-4306,-2,-3435,-7769,-1,0,-3,0,16
EUW1_6879087428',3,37,23,0,0,1,0,13,0,351,73,32771,30202,42122,4,38,11,0,0,1,0,8,320,74,26482,26348,29092,0,31,-1,6289,12,3854,13030,0,0,0,0,5
EUW1_6879033810',3,45,16,0,0,0,0,8,1,369,90,27578,30227,35622,2,28,14,1,0,1,0,2,347,78,27889,29432,33305,0,22,12,-311,2,795,2317,-1,0,-1,0,6
EUW1_6878990531',6,31,13,0,0,1,0,11,1,359,71,27933,29838,29147,6,24,19,2,0,1,0,3,339,91,29582,31439,40116,0,20,-20,-1649,-6,-1601,-10969,-2,0,0,0,8
EUW1_6878889944',2,25,19,0,1,2,0,12,1,352,64,30864,28084,33009,6,32,17,2,0,2,0,7,323,107,30399,30815,36594,0,29,-43,465,2,-2731,-3585,-2,1,0,0,5
EUW1_6878824034',3,31,14,0,0,1,0,10,1,298,82,27259,27838,31572,2,29,18,2,0,1,0,2,341,102,30302,28678,36659,1,-43,-20,-3043,-4,-840,-5087,-2,0,0,0,8
EUW1_6878299607',4,33,13,1,0,0,0,10,1,383,106,29769,31746,27798,8,28,19,1,0,1,0,2,375,84,30118,30885,33420,1,8,22,-349,-6,861,-5622,0,0,-1,0,8
EUW1_6878238049',3,24,8,1,0,0,0,10,0,376,104,25681,30359,26598,4,33,11,0,1,1,0,1,382,84,28217,30846,34965,1,-6,20,-2536,-3,-487,-8367,1,-1,-1,0,9
EUW1_6878191107',4,25,14,1,0,0,0,5,1,359,114,28638,29929,27468,5,46,13,0,1,0,0,3,350,84,28052,29897,36105,1,9,30,586,1,32,-8637,1,-1,0,0,2
EUW1_6878152923',6,29,10,0,0,0,0,8,0,334,90,25808,30336,29756,1,23,5,1,0,1,0,4,410,86,25746,29727,30483,0,-76,4,62,5,609,-727,-1,0,-1,0,4
EUW1_6877754061',3,27,26,1,0,3,0,6,1,376,89,36694,31364,38162,3,23,8,1,0,2,1,8,313,72,23478,25423,28471,1,63,17,13216,18,5941,9691,0,0,1,-1,-2
EUW1_6877726183',7,85,16,2,0,1,0,8,0,349,80,28659,28379,35328,1,206,15,0,0,1,0,6,376,66,29953,28997,30993,0,-27,14,-1294,1,-618,4335,2,0,0,0,2
EUW1_6877169476',3,19,12,1,0,1,0,7,0,341,97,29219,31333,40232,2,22,10,1,0,1,0,3,334,106,25120,29653,33460,1,7,-9,4099,2,1680,6772,0,0,0,0,4
EUW1_6883049850',1,21,16,2,0,0,0,9,1,365,86,28779,29019,31468,6,27,14,0,0,2,0,3,386,114,30757,31748,32426,1,-21,-28,-1978,2,-2729,-958,2,0,-2,0,6
EUW1_6882784415',6,32,12,2,0,1,0,9,0,363,84,28363,29371,25982,7,27,9,0,0,1,0,7,344,104,25909,29130,25147,1,19,-20,2454,3,241,835,2,0,0,0,2
EUW1_6882734985',3,34,12,1,0,0,0,5,0,349,108,26465,31617,29434,8,34,8,0,0,0,0,2,351,80,24094,28542,21678,0,-2,28,2371,4,3075,7756,1,0,0,0,3
EUW1_6882696860',3,31,12,1,0,1,0,7,0,420,96,29292,31771,36849,9,39,10,1,0,0,0,4,337,90,25764,30673,29991,1,83,6,3528,2,1098,6858,0,0,1,0,3
EUW1_6882659759',4,28,7,0,0,0,0,7,0,396,84,25740,28518,26709,2,26,16,2,0,1,0,4,396,95,29970,31096,28779,0,0,-11,-4230,-9,-2578,-2070,-2,0,-1,0,3
EUW1_6882632761',2,27,6,0,0,0,0,7,0,297,89,22596,25918,29816,1,23,22,2,0,1,0,1,387,93,31788,33213,45312,0,-90,-4,-9192,-16,-7295,-15496,-2,0,-1,0,6
EUW1_6882539776',4,33,5,0,0,0,0,5,0,383,88,24054,28942,21009,7,33,11,2,0,1,0,4,414,100,27659,32526,27386,0,-31,-12,-3605,-6,-3584,-6377,-2,0,-1,0,1
EUW1_6881683789',4,29,12,0,0,2,0,10,1,345,106,28866,30398,26899,4,95,16,2,0,2,0,9,360,104,31931,31314,34625,0,-15,2,-3065,-4,-916,-7726,-2,0,0,0,1
EUW1_6881450232',2,24,13,1,0,2,0,10,0,385,96,29005,30884,36036,4,32,4,1,1,0,0,5,324,100,22939,26942,18780,1,61,-4,6066,9,3942,17256,0,-1,2,0,5
EUW1_6881413862',0,25,15,1,0,2,0,11,1,341,98,30294,30402,39064,3,102,14,1,0,2,0,9,294,82,27820,29274,35424,1,47,16,2474,1,1128,3640,0,0,0,0,2
EUW1_6881332205',3,32,19,0,0,1,0,6,1,366,104,29854,31035,38359,2,29,2,2,0,0,0,5,352,70,21982,26216,26583,0,14,34,7872,17,4819,11776,-2,0,1,0,1
EUW1_6881282641',2,298,10,0,0,0,0,10,1,358,84,27768,28810,29295,3,35,20,2,0,2,0,6,335,107,30931,30398,36737,1,23,-23,-3163,-10,-1588,-7442,-2,0,-2,0,4
EUW1_6881163912',5,33,21,2,0,0,0,5,1,334,94,30864,30521,37811,5,29,15,0,0,0,0,2,304,73,26775,27648,34203,1,30,21,4089,6,2873,3608,2,0,0,0,3
EUW1_6879934715',6,38,9,2,0,1,0,13,0,278,105,25984,27152,26029,2,24,12,0,0,2,0,3,345,70,27303,27397,25360,1,-67,35,-1319,-3,-245,669,2,0,-1,0,10
EUW1_6879892278',6,25,7,2,0,0,0,11,0,332,91,23701,26108,25307,2,39,20,0,0,1,0,2,372,72,31549,30509,37414,0,-40,19,-7848,-13,-4401,-12107,2,0,-1,0,9
EUW1_6879837646',2,26,9,0,0,0,0,6,0,386,92,26418,30635,29426,1,23,13,2,0,1,0,4,374,124,28780,32273,26342,0,12,-32,-2362,-4,-1638,3084,-2,0,-1,0,2
EUW1_6868014449',3,23,14,1,0,0,0,9,0,340,90,28404,30731,35182,3,28,14,1,1,1,0,5,387,98,30013,31427,34305,1,-47,-8,-1609,0,-696,877,0,-1,-1,0,4
EUW1_6867847617',5,37,15,1,1,2,0,7,1,401,100,30762,31312,31131,2,25,7,0,0,0,0,7,316,101,22772,26278,21318,1,85,-1,7990,8,5034,9813,1,1,2,0,0
EUW1_6866914150',4,26,18,1,1,1,0,9,1,355,92,29674,30434,35233,2,27,13,1,0,1,0,4,380,112,28960,31073,34680,1,-25,-20,714,5,-639,553,0,1,0,0,5
EUW1_6865342097',1,23,15,0,0,0,0,11,0,337,86,28093,28245,37635,3,29,24,1,0,3,0,2,374,95,35803,32432,47911,0,-37,-9,-7710,-9,-4187,-10276,-1,0,-3,0,9
EUW1_6862696687',3,20,13,2,0,1,0,9,0,381,72,29014,30568,33246,6,225,9,0,0,1,0,3,398,91,26815,30670,34759,1,-17,-19,2199,4,-102,-1513,2,0,0,0,6
EUW1_6862634721',3,29,11,1,1,1,0,7,0,387,94,28211,30733,31924,4,31,3,1,0,0,0,6,368,94,23086,27598,24362,1,19,0,5125,8,3135,7562,0,1,1,0,1
EUW1_6861660665',7,37,5,0,0,0,0,6,0,386,124,25826,29985,19869,7,30,8,2,0,0,0,4,377,84,25550,29613,17725,1,9,40,276,-3,372,2144,-2,0,0,0,2
EUW1_6861477512',1,20,15,1,0,1,0,5,1,385,116,30868,32070,36359,3,27,9,0,0,0,0,7,330,71,24914,28989,24066,1,55,45,5954,6,3081,12293,1,0,1,0,-2
EUW1_6861413319',2,31,13,1,0,0,0,6,1,366,101,27468,30718,33836,5,30,14,1,1,0,0,3,374,86,27531,30741,27531,1,-8,15,-63,-1,-23,6305,0,-1,0,0,3
EUW1_6861368111',2,18,9,0,0,0,0,9,0,353,92,25561,28430,31052,7,30,15,2,1,1,0,0,404,68,29894,30802,32383,0,-51,24,-4333,-6,-2372,-1331,-2,-1,-1,0,9
EUW1_6848874745',7,80,19,1,0,1,0,5,1,308,66,29380,26333,38603,3,28,9,0,0,0,0,4,257,80,24610,23768,38477,0,51,-14,4770,10,2565,126,1,0,1,0,1
EUW1_6841568522',2,23,19,2,0,3,0,12,1,353,92,33064,31468,40152,3,251,10,0,0,1,0,7,337,84,27033,27543,29493,1,16,8,6031,9,3925,10659,2,0,2,0,5
EUW1_6841302829',3,26,7,0,0,1,0,9,1,367,72,25542,28359,32623,3,24,13,2,0,0,0,3,378,118,28348,32342,33298,0,-11,-46,-2806,-6,-3983,-675,-2,0,1,0,6
EUW1_6841229856',3,21,19,2,0,1,0,9,1,347,86,29975,31615,35060,2,31,9,0,0,0,0,3,363,74,26257,28114,29322,1,-16,12,3718,10,3501,5738,2,0,1,0,6
EUW1_6839510383',3,23,11,0,0,1,0,13,0,366,72,28343,30000,30922,5,29,12,1,1,2,0,3,399,101,29689,31664,38484,1,-33,-29,-1346,-1,-1664,-7562,-1,-1,-1,0,10
EUW1_6839478209',5,237,13,1,1,2,0,11,1,373,99,29095,30800,32084,5,22,11,1,0,2,0,8,364,79,28497,30618,29708,0,9,20,598,2,182,2376,0,1,0,0,3
EUW1_6883639895',6,24,15,1,0,1,0,6,1,333,88,28821,29327,38040,4,19,17,0,0,1,0,1,338,84,29363,30489,34670,0,-5,4,-542,-2,-1162,3370,1,0,0,0,5
EUW1_6883613343',2,23,17,2,0,0,0,10,1,378,106,28464,32973,36290,2,32,7,0,0,0,0,2,363,76,24585,27622,29179,1,15,30,3879,10,5351,7111,2,0,0,0,8
EUW1_6883570765',3,30,23,2,0,1,0,9,1,310,118,32003,30179,47705,2,28,22,0,0,0,0,5,322,68,30652,29755,47606,1,-12,50,1351,1,424,99,2,0,1,0,4
EUW1_6883402396',7,34,10,1,0,0,0,7,0,351,100,26272,27585,27347,1,26,11,1,0,0,0,0,399,82,26336,29567,25256,1,-48,18,-64,-1,-1982,2091,0,0,0,0,7
EUW1_6883326960',2,36,10,0,0,0,0,9,0,371,77,25985,28665,25943,2,28,9,2,0,2,0,5,381,102,27693,29374,37860,0,-10,-25,-1708,1,-709,-11917,-2,0,-2,0,4
EUW1_6883258407',1,46,11,0,0,0,0,9,0,349,88,27954,28534,32614,4,100,19,1,0,0,0,3,306,77,27106,29074,33236,0,43,11,848,-8,-540,-622,-1,0,0,0,6
EUW1_6883215540',0,181,8,2,0,1,0,9,0,401,124,26925,32262,24479,3,39,7,0,0,1,0,5,403,100,26723,30242,25872,0,-2,24,202,1,2020,-1393,2,0,0,0,4
EUW1_6883140629',3,42,11,0,0,0,0,10,0,361,93,28231,30279,28313,4,27,22,1,0,3,0,6,340,74,30790,30435,40553,1,21,19,-2559,-11,-156,-12240,-1,0,-3,0,4
EUW1_6883015506',1,51,6,0,0,1,0,8,1,368,94,25380,29394,23014,3,59,11,2,0,0,0,3,335,114,25998,30231,33232,0,33,-20,-618,-5,-837,-10218,-2,0,1,0,5
EUW1_6882316344',2,26,11,0,0,0,0,7,1,373,92,27355,30793,27543,5,25,11,2,0,1,0,3,388,103,27682,30815,33037,1,-15,-11,-327,0,-22,-5494,-2,0,-1,0,4
EUW1_6882259721',5,59,14,2,1,0,0,10,0,334,101,27499,30963,31630,4,165,10,0,0,0,0,4,360,86,26421,30005,28768,1,-26,15,1078,4,958,2862,2,1,0,0,6
EUW1_6879823005',0,29,6,0,0,1,0,10,1,396,92,25588,28877,22340,5,37,8,2,0,1,0,4,366,88,25967,29594,20033,0,30,4,-379,-2,-717,2307,-2,0,0,0,6
EUW1_6879757028',8,35,15,2,0,0,0,9,1,320,73,28342,28508,30234,2,24,15,0,0,1,0,4,326,108,29535,29505,38418,0,-6,-35,-1193,0,-997,-8184,2,0,-1,0,5
EUW1_6879689416',9,28,19,0,0,0,0,8,1,357,88,29881,29869,34691,3,35,20,1,0,1,0,3,363,84,31462,30649,39362,1,-6,4,-1581,-1,-780,-4671,-1,0,-1,0,5
EUW1_6879626000',2,23,13,2,0,1,0,4,0,334,75,27996,29466,28362,4,97,16,0,0,0,0,3,331,90,27534,30279,34670,1,3,-15,462,-3,-813,-6308,2,0,1,0,1
EUW1_6878313140',1,21,10,0,1,1,0,5,1,352,101,26970,28900,26803,2,25,6,1,0,0,0,6,372,102,25591,27410,23187,1,-20,-1,1379,4,1490,3616,-1,1,1,0,-1
EUW1_6878273338',3,34,19,0,0,1,0,9,1,352,65,30401,29732,42322,1,91,19,1,0,0,0,1,294,91,29001,30312,36266,0,58,-26,1400,0,-580,6056,-1,0,1,0,8
EUW1_6878250729',4,23,21,2,0,3,0,5,0,352,90,31962,32294,37075,1,21,6,0,0,0,0,8,301,100,24147,27741,26381,1,51,-10,7815,15,4553,10694,2,0,3,0,-3
EUW1_6877306360',2,22,9,0,0,0,0,10,0,334,80,25570,26964,34722,3,27,13,1,0,2,0,2,393,103,30059,31838,37861,0,-59,-23,-4489,-4,-4874,-3139,-1,0,-2,0,8
EUW1_6877197378',3,29,10,0,0,0,0,4,1,380,90,26240,30443,25969,2,45,11,1,0,0,0,2,390,98,26387,30776,22665,1,-10,-8,-147,-1,-333,3304,-1,0,0,0,2
EUW1_6876778262',1,22,10,0,0,0,0,15,0,287,85,25430,27885,34444,4,24,21,2,1,2,0,3,353,145,33174,33110,38889,0,-66,-60,-7744,-11,-5225,-4445,-2,-1,-2,0,12
EUW1_6876576428',6,24,11,0,0,0,0,11,1,386,76,26937,30182,27071,4,28,9,2,0,1,0,0,395,88,27224,30353,31624,1,-9,-12,-287,2,-171,-4553,-2,0,-1,0,11
EUW1_6869821966',5,29,8,2,0,0,0,5,1,362,99,25830,29765,29263,4,25,9,0,0,0,0,2,370,84,26168,29883,34297,1,-8,15,-338,-1,-118,-5034,2,0,0,0,3
EUW1_6869696693',2,17,6,1,0,0,0,5,1,384,100,25558,29048,26819,3,40,10,1,0,0,0,5,365,102,26710,30864,27496,0,19,-2,-1152,-4,-1816,-677,0,0,0,0,0
EUW1_6869606656',0,19,5,0,0,0,0,9,0,317,78,22666,27867,26056,3,26,16,1,1,1,0,2,395,132,30520,32734,39450,0,-78,-54,-7854,-11,-4867,-13394,-1,-1,-1,0,7
EUW1_6869431858',1,29,20,0,0,0,0,14,1,334,102,30612,32271,38372,5,97,17,2,0,1,0,3,342,98,29606,30169,31395,0,-8,4,1006,3,2102,6977,-2,0,-1,0,11
EUW1_6868084899',3,24,17,1,0,2,0,3,1,372,104,31734,32945,36599,4,29,11,0,0,0,0,8,351,104,26683,30762,34393,1,21,0,5051,6,2183,2206,1,0,2,0,-5
EUW1_6841499908',2,31,11,0,0,0,0,12,1,324,90,25367,28027,24035,5,98,10,2,0,2,0,1,370,78,27875,29414,24828,0,-46,12,-2508,1,-1387,-793,-2,0,-2,0,11
EUW1_6841360204',3,30,13,0,0,1,0,13,0,365,78,28844,28852,41770,2,29,16,2,0,2,0,6,378,68,30272,29860,41043,0,-13,10,-1428,-3,-1008,727,-2,0,-1,0,7
EUW1_6839097687',4,28,20,1,0,1,0,13,0,316,74,30459,30222,40693,2,25,18,0,0,2,0,7,370,68,31968,30156,43954,1,-54,6,-1509,2,66,-3261,1,0,-1,0,6
EUW1_6839057177',3,22,5,0,0,0,0,18,1,322,61,23488,24789,20059,8,37,27,1,0,4,0,2,397,98,36525,33409,51434,0,-75,-37,-13037,-22,-8620,-31375,-1,0,-4,0,16
EUW1_6839006137',4,29,21,1,0,0,0,12,0,386,91,33947,32354,43575,4,23,22,1,0,1,0,4,308,74,30132,29980,47873,1,78,17,3815,-1,2374,-4298,0,0,-1,0,8
EUW1_6838948548',4,35,12,1,0,0,0,6,0,355,88,28332,29056,28370,4,29,12,1,0,1,0,5,380,99,28990,30717,37707,0,-25,-11,-658,0,-1661,-9337,0,0,-1,0,1
EUW1_6838817378',1,24,13,0,0,0,0,11,1,328,77,26592,28199,34478,1,33,15,0,0,1,0,2,308,86,29517,28285,40527,0,20,-9,-2925,-2,-86,-6049,0,0,-1,0,9
EUW1_6838763805',3,32,15,1,0,1,0,8,0,359,88,29800,29353,29603,7,37,14,1,0,1,0,7,362,62,27690,28261,30277,1,-3,26,2110,1,1092,-674,0,0,0,0,1
EUW1_6838694165',2,30,11,1,0,1,0,8,1,377,100,28180,29187,32794,5,36,11,1,0,1,0,1,282,89,24944,28490,28879,1,95,11,3236,0,697,3915,0,0,0,0,7
EUW1_6838647918',2,143,13,0,0,0,0,7,1,377,112,29916,30002,32313,3,63,8,2,0,1,0,7,304,92,24332,27951,30761,1,73,20,5584,5,2051,1552,-2,0,-1,0,0
EUW1_6837696071',5,22,6,0,0,0,0,10,1,393,115,25694,29279,22667,5,31,14,2,1,2,0,1,393,90,29190,31263,26242,0,0,25,-3496,-8,-1984,-3575,-2,-1,-2,0,9
EUW1_6837648967',3,66,18,0,1,1,0,6,1,327,82,30679,31154,34029,3,21,13,1,0,0,0,3,330,89,27668,29132,32718,1,-3,-7,3011,5,2022,1311,-1,1,1,0,3
EUW1_6837297619',1,161,14,0,0,0,0,6,1,400,78,28287,30471,34558,1,29,13,1,0,0,0,2,393,87,27224,30271,30429,0,7,-9,1063,1,200,4129,-1,0,0,0,4
EUW1_6883419894',1,86,12,0,0,2,0,3,0,394,123,30106,32774,32309,8,191,8,1,0,0,0,13,354,80,23861,28496,22849,1,40,43,6245,4,4278,9460,-1,0,2,0,-10
EUW1_6883363985',1,32,9,0,0,0,0,16,1,365,88,25962,28048,39917,4,27,17,2,0,2,0,1,394,96,31457,33048,32938,0,-29,-8,-5495,-8,-5000,6979,-2,0,-2,0,15
EUW1_6878768316',2,45,14,1,0,0,0,10,1,300,78,26296,28512,30156,4,27,19,1,1,1,0,0,381,82,29812,31828,37518,0,-81,-4,-3516,-5,-3316,-7362,0,-1,-1,0,10
EUW1_6855510058',6,26,13,0,0,1,0,9,1,315,86,28623,28151,33880,0,17,17,2,0,0,0,4,317,97,28332,28904,45999,0,-2,-11,291,-4,-753,-12119,-2,0,1,0,5
EUW1_6855502456',3,36,6,2,0,0,0,3,1,401,102,26932,29849,26342,3,26,5,0,1,1,0,1,353,74,22952,29829,22342,1,48,28,3980,1,20,4000,2,-1,-1,0,2
EUW1_6855485632',5,28,14,0,0,0,0,9,1,325,102,28085,30365,31681,4,26,10,2,0,1,0,3,347,84,26895,27974,28241,1,-22,18,1190,4,2391,3440,-2,0,-1,0,6
EUW1_6879754644',3,26,13,1,0,1,0,10,0,401,74,29907,30034,32803,3,79,12,1,0,2,0,5,361,109,26542,31125,28600,1,40,-35,3365,1,-1091,4203,0,0,-1,0,5
EUW1_6876542746',5,43,9,1,0,0,0,11,1,367,79,25327,28936,25165,2,95,14,1,1,1,0,0,389,89,28824,31699,36061,1,-22,-10,-3497,-5,-2763,-10896,0,-1,-1,0,11
EUW1_6874812798',1,25,9,0,1,1,0,5,0,347,105,26537,30263,30773,6,39,7,2,0,0,0,4,332,74,23786,27460,28362,1,15,31,2751,2,2803,2411,-2,1,1,0,1
EUW1_6869769516',5,65,20,2,0,1,0,8,0,340,95,30701,31537,39365,5,62,11,0,0,0,0,5,359,96,26279,28815,33187,1,-19,-1,4422,9,2722,6178,2,0,1,0,3
EUW1_6869648960',5,31,15,1,0,0,0,6,0,365,82,28166,30131,30344,5,29,12,1,0,1,0,2,385,102,28294,31146,31067,1,-20,-20,-128,3,-1015,-723,0,0,-1,0,4
EUW1_6868819953',6,26,18,2,0,2,0,9,1,393,99,30715,32356,37147,2,25,5,0,0,0,0,8,404,68,24897,27284,19885,1,-11,31,5818,13,5072,17262,2,0,2,0,1
EUW1_6876541667',2,23,13,0,0,0,0,12,0,347,68,25692,28556,29216,4,223,14,2,0,1,0,4,336,81,28532,28453,34225,1,11,-13,-2840,-1,103,-5009,-2,0,-1,0,8
EUW1_6876519885',1,19,10,0,0,0,0,8,0,355,76,25536,27536,30253,8,26,19,2,0,2,0,2,394,95,31100,32920,37835,0,-39,-19,-5564,-9,-5384,-7582,-2,0,-2,0,6
EUW1_6870538156',4,166,13,1,0,0,0,8,0,343,82,28381,28636,41299,6,27,18,1,0,1,0,5,357,74,30111,31085,40151,0,-14,8,-1730,-5,-2449,1148,0,0,-1,0,3
EUW1_6870454007',5,371,10,1,0,0,0,8,0,366,84,26241,27600,40520,0,29,20,1,0,1,0,1,316,67,29612,28811,42032,0,50,17,-3371,-10,-1211,-1512,0,0,-1,0,7
EUW1_6880910180',3,29,17,0,0,1,0,5,1,393,109,32081,33895,36012,3,23,8,1,0,1,0,9,345,104,24672,30324,21455,1,48,5,7409,9,3571,14557,-1,0,0,0,-4
EUW1_6880886034',3,29,18,1,0,1,0,11,1,317,76,31658,30112,48679,3,66,24,1,1,1,0,9,313,99,32758,30787,48343,0,4,-23,-1100,-6,-675,336,0,-1,0,0,2
EUW1_6880879680',2,19,10,0,0,0,0,14,0,332,76,24923,27883,30435,4,140,23,2,1,3,0,1,367,96,35685,32046,50071,0,-35,-20,-10762,-13,-4163,-19636,-2,-1,-3,0,13
EUW1_6879645915',1,20,7,1,0,0,0,13,0,366,78,24112,29058,25829,2,26,18,1,0,3,0,2,383,80,32242,33918,41589,0,-17,-2,-8130,-11,-4860,-15760,0,0,-3,0,11
EUW1_6879406111',3,26,16,1,0,0,0,9,1,386,58,28461,29309,32875,6,38,16,0,0,1,0,1,385,81,31082,31447,37828,1,1,-23,-2621,0,-2138,-4953,1,0,-1,0,8
EUW1_6878612148',5,44,6,0,0,0,0,11,0,385,82,24633,29087,26000,9,34,17,2,0,0,0,1,409,120,30664,33205,37851,0,-24,-38,-6031,-11,-4118,-11851,-2,0,0,0,10
EUW1_6878429468',1,143,23,2,0,1,0,11,1,334,92,31718,31262,38154,2,29,11,0,0,0,0,4,310,86,25909,27422,29312,1,24,6,5809,12,3840,8842,2,0,1,0,7
EUW1_6875903596',1,22,18,1,0,0,0,10,0,279,74,27748,27089,34111,7,31,22,1,0,2,0,3,342,90,31917,30136,47369,0,-63,-16,-4169,-4,-3047,-13258,0,0,-2,0,7
EUW1_6875126799',5,29,20,1,0,1,0,13,0,299,114,31051,28770,39171,4,31,27,0,0,2,0,4,325,68,33738,30039,45678,0,-26,46,-2687,-7,-1269,-6507,1,0,-1,0,9
EUW1_6875115928',3,28,28,2,0,2,0,13,0,320,116,34377,32421,39567,4,29,17,0,1,0,0,5,286,84,28380,27446,40223,1,34,32,5997,11,4975,-656,2,-1,2,0,8
EUW1_6875103864',2,31,19,1,0,1,0,8,0,352,74,31218,29479,37474,4,30,16,1,0,1,0,7,329,86,30231,30479,38738,0,23,-12,987,3,-1000,-1264,0,0,0,0,1
EUW1_6871271643',6,26,26,1,0,2,0,4,1,365,56,32697,31366,43620,2,21,7,0,0,0,0,8,300,52,22876,23380,32021,1,65,4,9821,19,7986,11599,1,0,2,0,-4
EUW1_6871233562',3,40,15,0,0,1,0,5,0,381,91,29534,30469,32578,2,28,11,1,0,0,0,2,350,88,26028,27330,31634,0,31,3,3506,4,3139,944,-1,0,1,0,3
EUW1_6868177620',1,28,9,1,0,0,0,10,0,351,98,25818,30012,24677,3,33,13,1,0,2,0,1,372,80,29022,30032,26961,0,-21,18,-3204,-4,-20,-2284,0,0,-2,0,9
EUW1_6868103334',2,30,13,1,0,0,0,11,1,393,73,27568,30546,35128,2,32,14,1,0,1,0,5,362,102,29557,32622,31700,0,31,-29,-1989,-1,-2076,3428,0,0,-1,0,6
EUW1_6868054189',3,56,11,0,1,0,0,7,1,377,74,27010,30275,30546,2,25,13,2,0,1,0,6,333,102,26508,29855,30051,0,44,-28,502,-2,420,495,-2,1,-1,0,1
EUW1_6868002282',2,23,12,0,0,0,0,17,1,268,75,26679,25109,31111,2,27,31,1,1,2,0,0,313,100,35380,31315,46152,0,-45,-25,-8701,-19,-6206,-15041,-1,-1,-2,0,17
EUW1_6859480909',4,29,11,1,0,1,0,10,1,331,84,26323,30240,29779,1,19,7,1,0,0,0,5,369,104,25139,30210,29749,1,-38,-20,1184,4,30,30,0,0,1,0,5
EUW1_6859454234',8,32,16,0,0,1,0,9,0,369,80,29305,31073,38303,0,25,5,2,1,1,0,5,360,90,25084,27928,29180,0,9,-10,4221,11,3145,9123,-2,-1,0,0,4
EUW1_6854365325',3,30,12,1,0,1,0,9,0,385,94,29476,29243,28191,0,75,9,1,0,2,0,8,402,102,28231,30737,25743,0,-17,-8,1245,3,-1494,2448,0,0,-1,0,1
EUW1_6854342713',5,19,23,2,1,4,0,3,0,388,113,34776,35124,46259,6,23,6,0,0,0,0,11,287,98,24165,27572,34771,1,101,15,10611,17,7552,11488,2,1,4,0,-8
EUW1_6853057195',1,23,19,1,1,1,0,10,0,360,94,31421,32542,35631,3,27,10,1,0,0,0,8,362,80,26765,29934,32430,1,-2,14,4656,9,2608,3201,0,1,1,0,2
EUW1_6853049685',4,22,10,0,0,2,0,12,0,343,76,26970,29381,27509,3,30,14,1,0,2,0,7,387,98,29701,30131,31008,1,-44,-22,-2731,-4,-750,-3499,-1,0,0,0,5
EUW1_6851925532',1,56,25,0,1,2,0,6,0,329,94,32722,32861,42546,3,62,8,1,0,0,0,5,286,74,23306,25138,26691,1,43,20,9416,17,7723,15855,-1,1,2,0,1
EUW1_6851874359',7,25,17,1,0,0,0,10,0,321,84,27821,28194,40399,3,26,15,0,0,1,0,0,378,75,29570,29829,43950,0,-57,9,-1749,2,-1635,-3551,1,0,-1,0,10
EUW1_6850573403',3,34,14,0,0,1,0,10,0,371,82,28660,29091,31523,3,28,11,2,0,1,0,6,350,106,27982,29398,20989,1,21,-24,678,3,-307,10534,-2,0,0,0,4
EUW1_6850533008',7,189,9,1,0,0,0,8,1,376,85,26068,27554,25478,2,20,14,1,0,1,0,4,364,90,29191,30515,34080,0,12,-5,-3123,-5,-2961,-8602,0,0,-1,0,4
EUW1_6850309848',0,23,5,1,0,0,0,10,1,358,91,24410,28407,25798,8,47,13,1,1,1,0,0,376,112,29663,32912,32210,0,-18,-21,-5253,-8,-4505,-6412,0,-1,-1,0,10
EUW1_6850280296',5,29,16,1,0,2,0,12,1,421,122,35036,33103,31111,1,25,4,0,0,3,0,6,350,57,23917,25629,19417,1,71,65,11119,12,7474,11694,1,0,-1,0,6
EUW1_6850260944',4,50,11,0,0,1,0,7,0,355,82,26889,29704,26044,8,34,14,2,0,0,0,3,322,81,27714,29028,33149,0,33,1,-825,-3,676,-7105,-2,0,1,0,4
EUW1_6850198978',5,63,10,0,0,0,0,7,0,314,90,25987,27888,28220,5,58,14,1,0,1,0,2,376,69,28427,29099,30558,0,-62,21,-2440,-4,-1211,-2338,-1,0,-1,0,5
EUW1_6849833736',4,28,21,2,0,0,0,9,1,367,86,30951,31276,42310,5,29,14,0,0,0,0,1,354,92,29536,29999,36443,1,13,-6,1415,7,1277,5867,2,0,0,0,8
EUW1_6849786230',4,32,19,2,0,1,0,7,1,345,62,30455,30143,41022,4,36,10,0,0,0,0,5,336,81,26243,29452,34362,1,9,-19,4212,9,691,6660,2,0,1,0,2
EUW1_6849733953',5,28,8,0,0,1,0,4,0,381,102,26943,30081,27578,5,27,9,1,0,0,0,3,345,70,24885,28760,34090,1,36,32,2058,-1,1321,-6512,-1,0,1,0,1
EUW1_6849680252',2,22,6,0,0,0,0,13,0,294,45,22217,26302,21478,7,93,21,1,0,3,0,0,403,88,33117,30817,34719,0,-109,-43,-10900,-15,-4515,-13241,-1,0,-3,0,13
EUW1_6849409452',3,71,12,0,0,0,0,5,1,290,77,25368,26399,32779,7,30,16,1,0,0,0,3,326,74,27480,28923,36329,1,-36,3,-2112,-4,-2524,-3550,-1,0,0,0,2
EUW1_6849362931',2,27,11,0,0,0,0,11,1,254,82,25324,27260,24048,2,28,12,1,0,1,0,4,363,93,28667,29613,35368,0,-109,-11,-3343,-1,-2353,-11320,-1,0,-1,0,7
EUW1_6880046231',2,21,14,0,0,1,0,9,1,351,72,28980,30137,36429,3,22,14,1,1,1,0,4,302,112,27114,31308,41574,1,49,-40,1866,0,-1171,-5145,-1,-1,0,0,5
EUW1_6879161047',1,18,16,0,0,0,0,11,0,353,111,28621,30719,39270,3,31,18,1,0,0,0,3,359,88,29765,31283,37637,1,-6,23,-1144,-2,-564,1633,-1,0,0,0,8
EUW1_6878394369',3,52,11,0,0,0,0,7,0,368,93,26502,30744,27225,6,61,11,1,0,0,0,3,370,96,27232,29712,34771,0,-2,-3,-730,0,1032,-7546,-1,0,0,0,4
EUW1_6878194758',4,26,21,0,0,0,0,8,0,378,95,30338,32493,35030,2,36,11,2,0,1,0,7,375,76,27510,28575,38279,0,3,19,2828,10,3918,-3249,-2,0,-1,0,1
EUW1_6878154177',5,39,9,1,0,0,0,11,1,345,74,24610,29552,24538,6,33,9,1,1,0,0,0,424,114,27486,31950,29898,0,-79,-40,-2876,0,-2398,-5360,0,-1,0,0,11
EUW1_6878120764',6,30,19,0,1,1,0,7,1,338,94,29001,29772,38234,6,34,16,2,0,1,0,5,351,102,29719,29956,35952,0,-13,-8,-718,3,-184,2282,-2,1,0,0,2
EUW1_6877633719',3,230,9,0,0,0,0,4,0,352,60,24985,27660,26168,2,30,14,1,0,0,0,3,373,104,27837,29749,35243,1,-21,-44,-2852,-5,-2089,-9075,-1,0,0,0,1
EUW1_6877569280',2,32,13,0,1,2,0,6,1,364,109,29759,29763,31702,3,79,10,1,0,1,0,7,351,74,26193,28391,29539,0,13,35,3566,3,1372,2163,-1,1,1,0,-1
EUW1_6877499208',4,24,18,0,0,1,0,6,1,296,80,29416,27309,36833,3,31,13,2,0,0,0,4,324,73,26188,28639,36676,0,-28,7,3228,5,-1330,157,-2,0,1,0,2
EUW1_6877460551',4,28,3,0,0,0,0,11,0,358,74,22388,27068,22364,9,39,17,1,0,2,0,3,400,101,31307,31905,36230,0,-42,-27,-8919,-14,-4837,-13866,-1,0,-2,0,8
EUW1_6875992918',3,25,13,0,0,0,0,11,1,335,82,26396,28245,26859,5,31,21,2,1,1,0,1,351,94,31125,32195,46201,0,-16,-12,-4729,-8,-3950,-19342,-2,-1,-1,0,10
EUW1_6875951539',1,25,3,0,0,0,0,12,0,304,81,21751,24915,36478,6,62,20,1,0,2,0,0,386,100,31332,33269,43137,0,-82,-19,-9581,-17,-8354,-6659,-1,0,-2,0,12
EUW1_6875806775',3,28,7,1,0,0,0,9,0,383,133,25371,31730,28830,4,27,12,1,0,2,0,1,382,82,28363,30818,38587,0,1,51,-2992,-5,912,-9757,0,0,-2,0,8
EUW1_6875760396',5,30,15,2,0,0,0,4,0,359,129,28931,32815,32439,3,32,10,0,0,0,0,4,351,89,25881,26906,31029,1,8,40,3050,5,5909,1410,2,0,0,0,0
EUW1_6875700392',0,24,10,0,0,0,0,9,1,377,96,28052,29724,33158,1,31,14,2,0,2,0,6,338,75,26363,28705,39233,0,39,21,1689,-4,1019,-6075,-2,0,-2,0,3
EUW1_6875593983',3,28,9,0,0,0,0,9,1,349,90,24769,30257,26340,4,33,12,1,0,1,0,6,375,97,28258,32865,28633,0,-26,-7,-3489,-3,-2608,-2293,-1,0,-1,0,3
EUW1_6875541620',6,46,20,0,1,1,0,11,1,373,79,30685,32239,35808,0,26,7,1,0,0,0,2,358,88,26069,28480,31236,1,15,-9,4616,13,3759,4572,-1,1,1,0,9
EUW1_6875497247',3,27,12,1,0,1,0,10,0,337,82,27877,27438,30260,7,31,19,1,0,1,0,7,368,68,30579,29523,38921,0,-31,14,-2702,-7,-2085,-8661,0,0,0,0,3
EUW1_6883703101',2,23,15,0,0,2,0,10,0,363,76,31195,31444,40525,2,23,17,1,0,0,0,7,370,79,28651,30106,40852,1,-7,-3,2544,-2,1338,-327,-1,0,2,0,3
EUW1_6841656799',0,216,19,0,1,2,0,7,1,364,105,32741,31227,36652,7,28,17,2,0,1,0,8,296,72,28464,27933,41564,0,68,33,4277,2,3294,-4912,-2,1,1,0,-1
EUW1_6841573985',6,205,18,0,0,1,0,7,1,349,86,29023,28963,34078,2,31,14,1,0,0,0,4,308,62,26348,27612,36009,1,41,24,2675,4,1351,-1931,-1,0,1,0,3
EUW1_6841507022',5,26,13,0,0,1,0,7,1,374,100,29755,30024,39263,5,48,14,2,0,0,0,5,331,73,27590,29195,36645,0,43,27,2165,-1,829,2618,-2,0,1,0,2
EUW1_6841459674',3,25,5,0,0,2,0,8,0,389,83,26293,28662,20917,5,27,8,1,0,1,0,9,380,84,26113,29733,24933,1,9,-1,180,-3,-1071,-4016,-1,0,1,0,-1
EUW1_6840658779',2,25,15,0,0,1,0,10,0,356,92,29630,30171,33874,3,32,21,1,0,1,0,3,322,88,30360,29855,39481,1,34,4,-730,-6,316,-5607,-1,0,0,0,7
EUW1_6838559185',5,50,18,1,0,1,0,7,1,342,69,29397,31390,32509,5,29,10,1,0,2,0,0,366,102,28106,30440,34428,1,-24,-33,1291,8,950,-1919,0,0,-1,0,7
EUW1_6838437994',3,28,11,1,0,1,0,8,1,366,96,28369,29265,36847,4,28,16,1,1,0,0,3,362,68,29217,31654,36898,1,4,28,-848,-5,-2389,-51,0,-1,1,0,5
EUW1_6837526868',0,23,6,0,0,0,0,8,0,323,79,25101,27577,32705,4,119,21,2,0,3,0,2,356,88,31927,33555,35586,0,-33,-9,-6826,-15,-5978,-2881,-2,0,-3,0,6
EUW1_6837170486',5,70,16,2,0,1,0,9,1,364,83,30189,31374,33332,3,22,11,0,0,1,0,7,370,87,26673,29561,36960,1,-6,-4,3516,5,1813,-3628,2,0,0,0,2
EUW1_6837105232',2,36,17,2,0,0,0,8,0,396,86,28952,29936,33707,5,34,10,0,0,0,0,5,386,81,27464,28851,29050,1,10,5,1488,7,1085,4657,2,0,0,0,3
EUW1_6837057091',5,31,13,1,0,0,0,7,1,323,85,28069,28706,30613,2,26,18,1,1,1,0,1,384,90,30205,31132,31756,1,-61,-5,-2136,-5,-2426,-1143,0,-1,-1,0,6
EUW1_6837021840',8,41,14,2,0,1,0,8,1,357,110,29802,32046,34513,3,29,9,0,0,0,0,4,359,82,25405,27076,28954,1,-2,28,4397,5,4970,5559,2,0,1,0,4
EUW1_6836977633',3,35,7,0,0,0,0,10,1,344,90,24763,27448,23844,2,300,11,2,0,0,0,1,415,86,27856,31144,38647,0,-71,4,-3093,-4,-3696,-14803,-2,0,0,0,9
EUW1_6836827811',1,155,18,0,0,1,0,13,1,325,68,30284,27798,38527,7,33,23,1,0,1,0,4,308,84,31467,28569,46127,0,17,-16,-1183,-5,-771,-7600,-1,0,0,0,9
EUW1_6836707073',5,26,9,0,0,0,0,10,0,374,74,24747,27319,30151,2,27,17,2,0,1,0,4,390,92,30712,32557,33213,0,-16,-18,-5965,-8,-5238,-3062,-2,0,-1,0,6
EUW1_6833438575',5,27,12,0,0,0,0,6,1,377,77,28116,29953,35974,4,121,9,2,0,0,0,2,370,84,26230,29784,31874,1,7,-7,1886,3,169,4100,-2,0,0,0,4
EUW1_6833341220',3,55,16,0,1,0,0,13,0,319,76,29864,26973,29872,6,29,14,1,0,3,0,5,385,76,30112,29376,28327,1,-66,0,-248,2,-2403,1545,-1,1,-3,0,8
EUW1_6833259385',8,31,12,1,1,0,0,14,0,375,98,27229,30088,27716,3,30,12,1,0,1,0,3,406,90,28434,30536,30880,0,-31,8,-1205,0,-448,-3164,0,1,-1,0,11
EUW1_6833208186',3,25,3,1,0,0,0,11,0,351,75,22636,25576,21709,5,25,16,1,0,2,0,0,424,97,31615,32031,34151,0,-73,-22,-8979,-13,-6455,-12442,0,0,-2,0,11
EUW1_6882498258',1,19,13,1,0,2,0,13,1,369,127,30395,30517,31851,9,35,14,1,1,1,0,7,377,63,29781,29087,31949,1,-8,64,614,-1,1430,-98,0,-1,1,0,6
EUW1_6881015294',5,29,8,0,1,1,0,3,1,430,109,27908,31911,26109,3,32,4,1,0,0,0,4,405,86,23538,30800,18163,1,25,23,4370,4,1111,7946,-1,1,1,0,-1
EUW1_6882034706',4,34,20,1,1,1,0,11,0,408,114,34279,33583,41151,7,26,4,0,0,2,0,6,281,72,21382,23873,20294,1,127,42,12897,16,9710,20857,1,1,-1,0,5
EUW1_6881304962',6,43,17,1,0,0,0,10,1,371,78,30801,29915,33546,5,26,13,0,0,2,0,9,331,69,26513,27741,27203,1,40,9,4288,4,2174,6343,1,0,-2,0,1
EUW1_6880279074',8,39,14,1,0,1,0,8,0,373,84,29581,29679,34241,4,38,11,1,0,2,0,6,358,75,27811,29377,29223,0,15,9,1770,3,302,5018,0,0,-1,0,2
EUW1_6878519890',4,28,12,0,0,1,0,10,0,316,76,26966,28855,31400,7,26,18,2,0,1,0,4,332,76,30265,29017,33566,0,-16,0,-3299,-6,-162,-2166,-2,0,0,0,6
EUW1_6878470621',4,42,11,1,0,0,0,10,1,345,82,26570,28020,28270,11,33,18,0,0,2,0,0,350,77,29954,30206,34176,0,-5,5,-3384,-7,-2186,-5906,1,0,-2,0,10
EUW1_6877448106',8,30,7,0,0,0,0,8,0,403,69,25832,30305,25418,5,98,8,2,0,0,0,3,389,102,26391,30428,21301,0,14,-33,-559,-1,-123,4117,-2,0,0,0,5
EUW1_6877328240',2,20,7,1,0,0,0,14,0,330,84,24425,27508,23613,6,32,17,1,0,3,0,1,389,112,30642,33188,25071,0,-59,-28,-6217,-10,-5680,-1458,0,0,-3,0,13
EUW1_6874493628',4,25,14,0,1,0,0,8,1,347,94,28129,29747,31315,8,31,14,2,0,1,0,4,354,95,28372,30302,35292,0,-7,-1,-243,0,-555,-3977,-2,1,-1,0,4
EUW1_6874421670',3,31,14,0,1,1,0,11,1,346,88,28549,29184,31734,7,34,15,2,0,1,0,5,348,88,29184,29175,34471,1,-2,0,-635,-1,9,-2737,-2,1,0,0,6
EUW1_6874325872',0,23,22,1,0,1,0,4,0,347,114,32587,32398,38171,5,47,16,0,0,0,0,6,274,70,26029,26956,32765,1,73,44,6558,6,5442,5406,1,0,1,0,-2
EUW1_6874294090',1,22,5,0,0,0,0,15,0,284,81,21288,23141,28120,5,29,25,1,0,4,0,2,356,102,34016,32570,43503,0,-72,-21,-12728,-20,-9429,-15383,-1,0,-4,0,13
EUW1_6874191362',3,29,15,0,0,0,0,7,1,364,73,30132,28660,33303,4,36,13,1,0,2,0,5,348,64,25740,28320,29569,0,16,9,4392,2,340,3734,-1,0,-2,0,2
EUW1_6874161299',2,48,10,0,0,0,0,10,1,339,76,25142,27408,26915,5,27,15,1,0,1,0,0,374,120,30828,31067,32722,0,-35,-44,-5686,-5,-3659,-5807,-1,0,-1,0,10
EUW1_6874077954',6,28,9,1,0,0,0,9,0,311,103,25408,28088,28176,4,30,19,1,0,0,0,1,382,68,29237,32858,35253,1,-71,35,-3829,-10,-4770,-7077,0,0,0,0,8
EUW1_6874032461',5,28,16,0,0,0,0,10,1,332,94,28424,31180,36133,3,44,15,1,0,0,0,2,326,90,27908,28808,35885,0,6,4,516,1,2372,248,-1,0,0,0,8
EUW1_6881433327',4,31,16,0,0,1,0,12,1,352,84,28338,30689,32288,6,35,15,1,0,0,0,4,304,91,27969,29832,31248,0,48,-7,369,1,857,1040,-1,0,1,0,8
EUW1_6873207926',5,25,9,1,0,0,0,12,0,322,112,26466,29790,31484,5,33,8,1,1,1,0,4,381,80,26344,28675,20999,1,-59,32,122,1,1115,10485,0,-1,-1,0,8
EUW1_6871789863',4,22,11,0,1,0,0,7,0,358,84,27183,28543,29442,5,44,8,2,0,2,0,5,356,107,25274,29091,24689,1,2,-23,1909,3,-548,4753,-2,1,-2,0,2
EUW1_6863637404',5,24,20,2,0,2,0,5,0,387,104,32097,33075,39969,1,25,10,0,0,0,0,9,355,100,26683,29039,35695,1,32,4,5414,10,4036,4274,2,0,2,0,-4
EUW1_6855100532',5,182,23,0,0,0,0,8,0,313,88,31054,28897,40049,4,40,19,2,0,0,0,2,356,72,29142,27802,38374,1,-43,16,1912,4,1095,1675,-2,0,0,0,6
EUW1_6844035141',7,31,6,0,0,1,0,11,1,411,85,25900,29095,26657,4,26,8,2,0,1,0,3,384,97,26422,30207,23385,0,27,-12,-522,-2,-1112,3272,-2,0,0,0,8
EUW1_6843990026',3,58,9,0,0,0,0,10,0,310,72,24606,26706,29677,4,59,12,2,0,1,0,1,373,75,27396,28381,37223,0,-63,-3,-2790,-3,-1675,-7546,-2,0,-1,0,9
EUW1_6843929404',2,30,20,2,0,1,0,8,1,359,80,31538,30792,45118,3,25,11,0,0,1,0,4,334,106,27134,28790,33727,1,25,-26,4404,9,2002,11391,2,0,0,0,4
EUW1_6843858466',4,213,11,0,0,0,0,8,0,354,81,26712,30351,31695,2,25,11,1,0,1,0,1,360,89,27391,30465,34541,0,-6,-8,-679,0,-114,-2846,-1,0,-1,0,7
EUW1_6843819433',4,61,18,2,0,3,0,5,0,376,104,32761,31377,32989,1,18,12,0,0,0,0,10,275,88,25778,26360,27879,1,101,16,6983,6,5017,5110,2,0,3,0,-5
EUW1_6843788857',5,31,12,0,0,0,0,14,0,351,88,28448,28844,29363,1,17,25,1,0,1,0,1,379,90,31725,32771,38211,0,-28,-2,-3277,-13,-3927,-8848,-1,0,-1,0,13
EUW1_6843759584',2,20,6,0,0,0,0,12,1,357,63,23454,28160,18278,4,27,10,2,0,3,0,0,384,126,29481,32354,25261,0,-27,-63,-6027,-4,-4194,-6983,-2,0,-3,0,12
EUW1_6843732048',3,42,10,0,0,0,0,15,0,270,82,24727,26940,28851,4,33,12,2,1,4,0,0,394,103,31044,29483,28924,0,-124,-21,-6317,-2,-2543,-73,-2,-1,-4,0,15
EUW1_6843698403',4,33,12,1,1,2,0,6,0,308,86,27463,27755,31550,4,25,13,1,0,0,0,5,357,92,27605,29717,34639,0,-49,-6,-142,-1,-1962,-3089,0,1,2,0,1
EUW1_6843681926',1,129,8,2,0,0,0,7,0,346,132,26021,30199,28359,3,22,15,0,0,0,0,2,331,99,27066,29316,30149,1,15,33,-1045,-7,883,-1790,2,0,0,0,5
EUW1_6843241232',4,19,14,2,1,0,0,12,0,376,92,29408,31178,35931,4,32,12,0,0,1,0,2,361,82,27316,30163,25139,0,15,10,2092,2,1015,10792,2,1,-1,0,10
EUW1_6843178670',5,26,6,0,0,0,0,9,0,374,78,24353,28017,24098,4,34,9,2,0,1,0,1,368,114,27672,29339,25755,0,6,-36,-3319,-3,-1322,-1657,-2,0,-1,0,8
EUW1_6843112016',2,28,10,0,0,1,0,12,0,353,102,28891,29293,36676,3,19,19,2,0,1,0,6,349,78,29742,30775,40289,1,4,24,-851,-9,-1482,-3613,-2,0,0,0,6
EUW1_6843025977',3,24,8,0,0,1,0,5,0,337,102,26284,28822,26869,1,22,18,1,0,1,0,5,373,86,29591,30823,42188,0,-36,16,-3307,-10,-2001,-15319,-1,0,0,0,0
EUW1_6842954652',3,26,10,1,1,1,0,5,1,366,106,27210,30531,25286,2,100,7,1,0,1,0,3,367,96,25823,30152,30308,1,-1,10,1387,3,379,-5022,0,1,0,0,2
EUW1_6842873088',6,28,14,2,0,0,0,13,0,358,116,28009,30597,31012,5,122,12,0,1,1,0,1,380,99,30285,32464,31843,1,-22,17,-2276,2,-1867,-831,2,-1,-1,0,12
EUW1_6841990288',4,25,17,2,0,1,0,6,1,373,118,30689,31785,32366,2,32,6,0,0,1,0,5,345,94,24753,26895,25680,1,28,24,5936,11,4890,6686,2,0,0,0,1
EUW1_6841930429',2,27,21,1,0,2,0,12,1,398,90,32526,32819,39611,4,28,9,0,0,0,0,6,325,89,27022,28799,23162,1,73,1,5504,12,4020,16449,1,0,2,0,6
EUW1_6854451202',3,28,9,0,0,0,0,8,1,322,80,24764,25082,30275,3,46,16,2,0,1,0,1,326,92,28662,30692,35096,0,-4,-12,-3898,-7,-5610,-4821,-2,0,-1,0,7
EUW1_6854428539',5,31,13,1,0,0,0,5,1,322,89,27677,28669,32502,2,22,11,1,0,0,0,3,371,80,25477,29148,28943,1,-49,9,2200,2,-479,3559,0,0,0,0,2
EUW1_6853572748',5,25,6,0,0,0,0,12,0,321,88,24610,27687,26393,4,26,22,1,0,2,0,4,347,96,33710,31069,42010,1,-26,-8,-9100,-16,-3382,-15617,-1,0,-2,0,8
EUW1_6853522112',6,32,15,2,0,1,0,12,1,325,90,29083,28849,34915,4,32,13,0,0,1,0,0,315,66,27229,28166,39018,0,10,24,1854,2,683,-4103,2,0,0,0,12
EUW1_6853456197',13,38,10,1,0,0,0,11,0,289,74,24142,26698,24586,2,28,14,0,0,1,0,2,361,92,29460,29304,32395,0,-72,-18,-5318,-4,-2606,-7809,1,0,-1,0,9
EUW1_6853419842',9,32,11,1,0,1,0,3,1,356,72,28121,27801,36310,6,33,8,1,0,1,0,5,305,90,24501,26593,30787,1,51,-18,3620,3,1208,5523,0,0,0,0,-2
EUW1_6853383845',9,36,17,1,0,0,0,7,0,318,84,29377,30133,33823,3,25,10,1,0,1,0,2,338,90,25881,28220,25300,1,-20,-6,3496,7,1913,8523,0,0,-1,0,5
EUW1_6853345776',9,30,8,0,0,0,0,8,1,354,63,24547,27365,25141,3,23,9,2,0,1,0,0,340,90,25888,29008,26643,0,14,-27,-1341,-1,-1643,-1502,-2,0,-1,0,8
EUW1_6846650412',5,39,12,0,0,0,0,10,0,329,82,27035,28845,30858,4,31,15,1,0,1,0,3,342,84,28706,29363,38525,1,-13,-2,-1671,-3,-518,-7667,-1,0,-1,0,7
EUW1_6846609472',2,66,4,0,0,0,0,8,0,351,72,22814,26388,27641,5,27,13,2,0,1,0,2,370,98,28148,30711,32070,0,-19,-26,-5334,-9,-4323,-4429,-2,0,-1,0,6
EUW1_6846354094',3,27,8,0,0,0,0,8,0,340,104,25344,29653,21569,3,28,9,2,1,0,0,3,382,104,26463,31136,22087,0,-42,0,-1119,-1,-1483,-518,-2,-1,0,0,5
EUW1_6846312029',2,36,12,2,1,0,0,14,0,331,88,28729,27417,30831,8,144,22,0,0,1,0,5,317,91,31518,31273,38910,0,14,-3,-2789,-10,-3856,-8079,2,1,-1,0,9
EUW1_6846245053',4,28,15,1,0,0,0,4,0,327,87,27805,31677,36163,4,94,12,1,0,0,0,2,332,84,26662,29246,29456,1,-5,3,1143,3,2431,6707,0,0,0,0,2
EUW1_6846212271',5,26,18,0,0,2,0,6,1,354,80,31623,31441,46543,0,184,10,2,0,1,0,8,300,66,24852,27033,30600,1,54,14,6771,8,4408,15943,-2,0,1,0,-2
EUW1_6846118723',3,28,10,1,0,0,0,11,0,308,83,25862,28949,26959,3,21,10,0,0,2,0,4,376,84,26188,29518,23995,0,-68,-1,-326,0,-569,2964,1,0,-2,0,7
EUW1_6862027104',1,30,13,2,0,1,0,6,0,369,104,28630,30730,31774,2,25,15,0,0,1,0,3,358,94,29528,30445,33826,1,11,10,-898,-2,285,-2052,2,0,0,0,3
EUW1_6862012381',6,31,6,0,0,0,0,11,1,327,102,24263,28626,23958,2,181,10,2,0,0,0,1,402,98,27229,31254,24627,1,-75,4,-2966,-4,-2628,-669,-2,0,0,0,10
EUW1_6861794402',3,22,17,0,0,0,0,8,1,344,82,29916,30162,36638,5,28,17,1,1,1,0,1,386,82,31009,31308,37735,1,-42,0,-1093,0,-1146,-1097,-1,-1,-1,0,7
EUW1_6861574611',4,28,20,1,0,0,0,15,0,323,72,30644,28665,37512,3,25,17,1,0,2,0,3,294,90,31154,26692,40615,1,29,-18,-510,3,1973,-3103,0,0,-2,0,12
EUW1_6857251620',6,30,24,2,0,2,0,7,1,326,80,32614,30225,39777,3,28,14,0,0,0,0,7,280,80,27187,27601,35737,1,46,0,5427,10,2624,4040,2,0,2,0,0
EUW1_6854779173',4,23,12,0,0,0,0,8,0,314,88,26799,30504,33571,3,36,21,2,0,1,0,1,353,104,31797,31192,40593,0,-39,-16,-4998,-9,-688,-7022,-2,0,-1,0,7
EUW1_6841229846',3,26,8,1,0,0,0,4,1,349,106,25458,27677,34909,7,35,7,0,0,1,0,0,344,86,25087,28150,28004,0,5,20,371,1,-473,6905,1,0,-1,0,4
EUW1_6841166990',3,89,8,1,0,1,0,9,1,396,96,27470,30028,29115,6,37,8,1,0,0,0,6,379,79,25542,29884,27533,1,17,17,1928,0,144,1582,0,0,1,0,3
EUW1_6838261924',4,22,10,0,0,0,0,9,0,373,80,27117,30182,30867,3,23,16,2,0,1,0,0,396,114,30821,33101,38280,1,-23,-34,-3704,-6,-2919,-7413,-2,0,-1,0,9
EUW1_6836840490',4,81,18,0,0,0,0,7,1,359,80,29402,30184,39514,7,84,10,1,0,0,0,3,339,84,26246,28025,31355,1,20,-4,3156,8,2159,8159,-1,0,0,0,4
EUW1_6835387350',2,32,10,1,0,0,0,12,1,362,84,27005,27915,24821,5,82,14,0,0,3,0,1,348,78,29629,28439,29107,0,14,6,-2624,-4,-524,-4286,1,0,-3,0,11
EUW1_6835365444',4,33,7,0,0,0,0,6,0,370,102,25758,29571,27465,5,29,11,2,0,0,0,5,349,82,26141,29309,26352,1,21,20,-383,-4,262,1113,-2,0,0,0,1
EUW1_6831036952',4,27,25,2,0,2,0,6,0,374,96,34472,32331,46913,7,29,18,0,0,1,0,13,320,82,30445,29813,33833,1,54,14,4027,7,2518,13080,2,0,1,0,-7
EUW1_6830168798',2,30,11,1,0,0,0,10,0,370,116,27637,29956,30827,8,36,10,1,1,1,0,3,360,88,26807,28366,29093,1,10,28,830,1,1590,1734,0,-1,-1,0,7
EUW1_6825390615',3,30,11,0,0,0,0,14,0,292,95,26423,26689,29814,4,25,19,2,1,2,0,2,316,98,31151,28324,39251,0,-24,-3,-4728,-8,-1635,-9437,-2,-1,-2,0,12
EUW1_6823908407',6,63,13,0,0,0,0,9,1,344,92,27107,31058,34722,3,78,8,2,0,0,0,2,398,95,26612,30312,30903,0,-54,-3,495,5,746,3819,-2,0,0,0,7
EUW1_6823883476',4,27,21,1,1,2,0,9,0,348,102,32413,32364,39441,2,26,8,1,0,2,0,14,281,93,25462,25849,22133,1,67,9,6951,13,6515,17308,0,1,0,0,-5
EUW1_6823855196',4,25,12,1,0,0,0,12,1,288,92,25981,27385,31796,5,69,17,1,0,2,0,0,379,92,31411,31365,38375,0,-91,0,-5430,-5,-3980,-6579,0,0,-2,0,12
EUW1_6850852500',1,21,14,1,0,0,0,10,1,304,86,26648,28872,33960,3,30,13,1,0,0,0,4,282,86,26773,27356,35970,0,22,0,-125,1,1516,-2010,0,0,0,0,6
EUW1_6850787517',6,33,9,1,0,0,0,4,0,361,78,25388,27901,20724,3,51,10,1,0,0,0,2,375,89,26040,29548,27347,1,-14,-11,-652,-1,-1647,-6623,0,0,0,0,2
EUW1_6850585401',6,27,24,1,1,3,0,12,1,393,104,36078,32741,40097,2,33,8,0,0,1,0,7,316,80,26011,26441,22281,1,77,24,10067,16,6300,17816,1,1,2,0,5
EUW1_6847687207',2,28,17,2,1,1,0,7,1,306,98,29174,30058,42503,1,22,11,0,0,1,0,7,314,97,25277,29446,24662,1,-8,1,3897,6,612,17841,2,1,0,0,0
EUW1_6833589773',3,42,10,0,0,0,0,10,1,400,88,27260,30549,35565,7,31,13,1,0,0,0,3,356,83,28443,29371,33067,1,44,5,-1183,-3,1178,2498,-1,0,0,0,7
EUW1_6829688300',4,32,16,0,0,1,0,3,1,403,88,30252,31931,35669,4,63,14,1,0,0,0,9,317,79,27888,28244,33435,1,86,9,2364,2,3687,2234,-1,0,1,0,-6
EUW1_6829649665',4,24,16,0,0,0,0,7,1,347,82,28453,30182,34301,5,29,14,2,0,0,0,5,338,78,26423,30012,31294,0,9,4,2030,2,170,3007,-2,0,0,0,2
EUW1_6829607531',4,24,8,0,0,0,0,13,0,372,96,25540,28560,24732,1,30,14,1,0,2,0,2,363,96,30920,28794,31815,0,9,0,-5380,-6,-234,-7083,-1,0,-2,0,11
EUW1_6829051740',5,76,12,1,0,1,0,11,0,312,88,26706,26792,36049,5,64,7,0,0,0,0,5,307,84,23431,26970,26281,0,5,4,3275,5,-178,9768,1,0,1,0,6
EUW1_6828654528',4,30,13,0,0,0,0,7,0,326,88,27398,28576,31817,7,31,18,2,0,2,0,3,315,76,30071,28338,41264,0,11,12,-2673,-5,238,-9447,-2,0,-2,0,4
EUW1_6828333876',0,21,12,0,1,0,0,11,1,323,86,26229,27945,33734,1,21,13,2,0,1,0,2,374,82,28911,31894,34560,0,-51,4,-2682,-1,-3949,-826,-2,1,-1,0,9
EUW1_6828275240',1,25,9,1,0,0,0,9,0,423,95,28518,31503,35544,2,29,10,0,0,1,0,3,372,88,26058,29837,26111,1,51,7,2460,-1,1666,9433,1,0,-1,0,6
EUW1_6828242769',4,61,8,1,0,0,0,8,1,351,89,25001,27801,20318,6,104,6,1,0,0,0,3,373,85,24595,29666,22511,0,-22,4,406,2,-1865,-2193,0,0,0,0,5
EUW1_6828196055',2,39,9,1,1,1,0,5,0,386,109,27942,33278,25788,6,30,15,1,0,0,0,7,351,92,28126,31646,29612,0,35,17,-184,-6,1632,-3824,0,1,1,0,-2
EUW1_6828161717',5,26,9,0,0,0,0,9,1,325,78,26262,28549,30420,5,52,18,2,0,1,0,3,379,94,30344,31781,40834,0,-54,-16,-4082,-9,-3232,-10414,-2,0,-1,0,6
EUW1_6828128446',2,50,7,0,0,0,0,15,0,304,95,23887,27197,30059,5,29,20,2,0,4,0,2,386,88,35014,31109,35185,0,-82,7,-11127,-13,-3912,-5126,-2,0,-4,0,13
EUW1_6827968571',5,30,11,1,1,1,0,3,1,373,90,26387,30386,26316,4,37,4,1,0,0,0,2,355,94,22735,27978,21361,1,18,-4,3652,7,2408,4955,0,1,1,0,1
EUW1_6827665069',3,26,16,0,0,0,0,10,1,341,95,29876,29480,35487,1,39,21,1,0,1,0,3,346,92,31515,31137,39950,0,-5,3,-1639,-5,-1657,-4463,-1,0,-1,0,7
EUW1_6827614364',4,29,11,1,0,2,0,8,1,343,101,28108,28266,32220,1,23,6,0,0,0,0,6,331,40,22098,24118,20441,1,12,61,6010,5,4148,11779,1,0,2,0,2
EUW1_6827558299',3,24,22,0,1,2,0,8,1,340,97,33283,31268,42836,2,18,10,1,0,2,0,6,366,75,25309,28985,31467,1,-26,22,7974,12,2283,11369,-1,1,0,0,2
EUW1_6879518226',3,26,13,0,0,2,0,4,1,363,81,29547,30579,33723,5,27,10,1,0,0,0,8,353,89,25327,28432,24258,1,10,-8,4220,3,2147,9465,-1,0,2,0,-4
EUW1_6879494907',3,27,15,0,0,0,0,9,1,395,80,28381,30408,36292,3,31,13,1,0,1,0,3,358,99,29413,29770,30005,0,37,-19,-1032,2,638,6287,-1,0,-1,0,6
EUW1_6862882143',5,28,7,1,0,0,0,11,0,336,80,24225,28976,22256,3,27,16,1,1,1,0,3,368,108,30131,32750,33717,1,-32,-28,-5906,-9,-3774,-11461,0,-1,-1,0,8
EUW1_6861165815',0,43,12,0,0,0,0,11,0,350,100,26953,30352,36487,1,24,15,2,0,0,0,1,360,87,29339,30235,39762,0,-10,13,-2386,-3,117,-3275,-2,0,0,0,10
EUW1_6861111072',1,28,13,2,1,1,0,8,1,362,95,27183,30005,28492,3,29,4,0,0,0,0,4,353,90,23336,27635,21053,1,9,5,3847,9,2370,7439,2,1,1,0,4
EUW1_6861075401',1,25,2,0,0,0,0,12,0,379,102,22506,29582,26593,3,21,8,2,0,4,0,1,448,114,30121,33102,25238,0,-69,-12,-7615,-6,-3520,1355,-2,0,-4,0,11
EUW1_6861051014',0,23,12,1,0,0,0,8,0,385,64,29277,29520,34636,5,81,15,1,0,1,0,4,357,94,28067,30820,33528,1,28,-30,1210,-3,-1300,1108,0,0,-1,0,4
EUW1_6860946918',5,98,13,2,0,0,0,12,0,343,108,26657,29598,25382,9,60,10,0,1,1,0,0,361,106,28544,29187,24482,0,-18,2,-1887,3,411,900,2,-1,-1,0,12
EUW1_6860916037',6,37,13,1,0,0,0,8,0,379,98,28410,29392,31792,9,39,18,1,0,1,0,1,398,85,31424,31609,30282,0,-19,13,-3014,-5,-2217,1510,0,0,-1,0,7
EUW1_6855595976',2,25,9,0,0,0,0,15,0,320,86,25938,27182,22740,2,25,19,2,0,2,0,2,369,134,34492,32856,39380,0,-49,-48,-8554,-10,-5674,-16640,-2,0,-2,0,13
EUW1_6855568643',4,26,16,0,1,1,0,4,1,329,72,28847,28562,36321,1,23,15,1,0,0,0,4,316,87,26823,27882,32653,0,13,-15,2024,1,680,3668,-1,1,1,0,0
EUW1_6854651673',2,26,14,0,0,0,0,11,0,384,82,29098,30280,30555,6,26,17,2,0,1,0,3,363,90,29998,30640,31889,1,21,-8,-900,-3,-360,-1334,-2,0,-1,0,8
EUW1_6854598888',5,146,9,1,0,0,0,8,0,367,76,25938,28631,33831,1,28,16,0,0,0,0,2,370,80,28838,32420,31985,0,-3,-4,-2900,-7,-3789,1846,1,0,0,0,6
EUW1_6854549026',5,25,10,1,0,0,0,6,1,384,90,26121,30851,24816,2,20,7,0,0,0,0,4,343,92,25143,29795,19232,1,41,-2,978,3,1056,5584,1,0,0,0,2
EUW1_6854493500',5,25,14,0,0,1,0,7,0,330,100,29979,29858,26957,9,31,14,2,0,0,0,5,388,88,29282,30850,29128,1,-58,12,697,0,-992,-2171,-2,0,1,0,2
EUW1_6854392705',3,26,14,1,0,2,0,7,0,392,78,31837,29901,37896,5,64,14,0,0,1,0,12,323,90,28154,31031,32636,0,69,-12,3683,0,-1130,5260,1,0,1,0,-5
EUW1_6853622652',2,24,6,1,0,0,0,9,0,342,104,23708,29043,18561,4,32,6,1,0,1,0,0,350,103,25529,28742,27935,1,-8,1,-1821,0,301,-9374,0,0,-1,0,9
EUW1_6853402449',4,29,7,1,0,0,0,8,0,349,78,24508,28049,23505,2,39,14,1,0,2,0,1,400,94,29395,30449,36476,0,-51,-16,-4887,-7,-2400,-12971,0,0,-2,0,7
EUW1_6881181503',2,29,10,0,0,0,0,12,0,289,87,26269,27676,31578,6,26,17,2,0,2,0,3,334,98,30359,30721,34172,0,-45,-11,-4090,-7,-3045,-2594,-2,0,-2,0,9
EUW1_6881123604',4,144,16,1,0,0,0,9,1,368,71,28825,29466,34092,3,206,9,1,0,1,0,3,361,96,27622,29853,25301,1,7,-25,1203,7,-387,8791,0,0,-1,0,6
EUW1_6880433277',5,28,16,0,0,1,0,13,1,361,77,29713,29992,39961,2,20,17,1,0,0,0,5,308,82,28979,29710,29925,1,53,-5,734,-1,282,10036,-1,0,1,0,8
EUW1_6880395127',5,28,7,0,0,0,0,15,0,336,90,25074,30332,33629,3,26,18,1,0,3,0,1,433,103,33666,33511,41360,0,-97,-13,-8592,-11,-3179,-7731,-1,0,-3,0,14
EUW1_6879655600',4,30,11,1,0,1,0,8,0,372,90,27028,29601,35544,2,19,11,1,0,0,0,2,350,91,26105,28495,26914,1,22,-1,923,0,1106,8630,0,0,1,0,6
EUW1_6879607210',3,77,10,0,0,0,0,5,1,365,80,26437,29386,27190,3,19,12,2,0,0,0,3,373,96,27359,30565,25817,0,-8,-16,-922,-2,-1179,1373,-2,0,0,0,2
EUW1_6878961807',3,34,15,1,0,1,0,12,1,336,89,28579,28453,38134,5,20,16,0,0,1,0,4,347,84,29794,30601,31166,0,-11,5,-1215,-1,-2148,6968,1,0,0,0,8
EUW1_6878679434',4,28,11,2,1,0,0,7,1,352,91,25949,29965,30159,4,67,11,0,0,1,0,1,392,115,28002,30397,33331,0,-40,-24,-2053,0,-432,-3172,2,1,-1,0,6
EUW1_6878629304',8,75,5,1,0,2,0,17,0,385,80,25442,28914,24700,2,32,11,1,0,2,0,4,362,120,29440,32282,26888,0,23,-40,-3998,-6,-3368,-2188,0,0,0,0,13
EUW1_6876067446',8,28,12,1,0,0,0,8,1,372,100,28536,30618,27435,7,37,8,0,1,0,0,5,410,84,25649,30292,25948,1,-38,16,2887,4,326,1487,1,-1,0,0,3
EUW1_6876011942',1,24,16,1,0,0,0,8,0,360,66,28280,29886,36989,4,30,13,1,0,0,0,3,341,84,26330,28612,39558,1,19,-18,1950,3,1274,-2569,0,0,0,0,5
EUW1_6875967426',6,29,22,2,0,2,0,7,1,374,108,34019,33299,41168,1,25,9,0,0,0,0,8,341,92,25077,28377,37626,1,33,16,8942,13,4922,3542,2,0,2,0,-1
EUW1_6878767263',2,26,3,1,0,0,0,8,0,269,60,20548,23024,20771,2,51,7,1,0,3,1,0,411,108,28429,30379,20343,0,-142,-48,-7881,-4,-7355,428,0,0,-3,-1,8
EUW1_6870436443',11,32,11,0,0,0,0,8,1,339,120,26125,32043,26253,2,28,8,2,0,0,0,1,351,84,24435,28900,27740,1,-12,36,1690,3,3143,-1487,-2,0,0,0,7
EUW1_6866768106',2,30,10,0,0,0,0,14,0,273,82,24807,26865,27523,4,23,19,2,0,4,0,1,380,85,32303,31291,43130,0,-107,-3,-7496,-9,-4426,-15607,-2,0,-4,0,13
EUW1_6865038098',5,27,14,0,0,0,0,3,1,353,80,27708,27878,37166,4,68,12,2,0,0,0,4,322,96,26349,29128,37141,1,31,-16,1359,2,-1250,25,-2,0,0,0,-1
EUW1_6863425278',1,20,17,1,0,0,0,7,1,340,77,28640,30333,34950,3,24,12,1,0,2,0,9,349,82,28776,29740,35703,1,-9,-5,-136,5,593,-753,0,0,-2,0,-2
EUW1_6861280177',2,33,16,0,0,1,0,7,0,356,92,30820,31382,36294,4,47,17,1,0,0,0,6,359,87,30035,30188,34239,1,-3,5,785,-1,1194,2055,-1,0,1,0,1
EUW1_6860213287',5,24,22,2,1,1,0,3,1,354,83,32733,31064,40746,3,33,9,0,0,1,0,9,340,86,25256,27436,25166,1,14,-3,7477,13,3628,15580,2,1,0,0,-6
EUW1_6859197366',3,28,13,2,0,1,0,7,1,375,91,28354,31264,31941,1,21,5,0,0,0,0,4,358,94,24062,28844,30816,1,17,-3,4292,8,2420,1125,2,0,1,0,3
EUW1_6859169792',1,23,20,2,0,1,0,8,1,371,92,33365,31002,35425,2,21,12,0,0,2,0,8,334,84,26377,28240,31225,1,37,8,6988,8,2762,4200,2,0,-1,0,0
EUW1_6858690210',1,16,18,0,0,2,0,10,0,375,105,31379,33839,38266,3,22,8,0,1,0,0,5,316,74,24795,28127,28538,1,59,31,6584,10,5712,9728,0,-1,2,0,5
EUW1_6858659576',8,33,18,1,0,1,0,8,1,326,72,30755,29455,37221,4,33,12,0,0,0,0,7,319,76,27033,26095,30755,1,7,-4,3722,6,3360,6466,1,0,1,0,1
EUW1_6858425855',3,94,15,2,1,2,0,10,1,345,71,29482,28135,31562,1,22,8,0,0,0,0,8,288,85,23678,25377,20003,1,57,-14,5804,7,2758,11559,2,1,2,0,2
EUW1_6857201488',2,27,7,0,0,0,0,12,0,371,86,26137,28574,29374,2,32,12,2,0,2,0,1,353,94,28260,30558,30782,0,18,-8,-2123,-5,-1984,-1408,-2,0,-2,0,11
EUW1_6856864333',1,26,6,2,0,1,0,10,0,336,84,24093,27221,18078,7,34,14,0,0,2,0,2,390,116,30965,31405,31925,0,-54,-32,-6872,-8,-4184,-13847,2,0,-1,0,8
EUW1_6856847668',1,30,11,2,0,0,0,13,1,340,85,26068,28539,27653,1,29,14,0,0,3,0,1,364,85,30324,30381,33255,0,-24,0,-4256,-3,-1842,-5602,2,0,-3,0,12
EUW1_6856310451',9,32,11,0,0,1,0,9,1,364,96,28781,31597,28732,7,31,10,1,0,1,0,8,369,76,26944,28076,31469,1,-5,20,1837,1,3521,-2737,-1,0,0,0,1
EUW1_6854475057',3,27,13,0,0,1,0,14,0,333,112,29430,28087,31052,4,39,19,1,1,1,0,4,381,80,31694,31281,37984,0,-48,32,-2264,-6,-3194,-6932,-1,-1,0,0,10
EUW1_6853569044',1,57,11,2,0,1,0,6,1,374,92,29296,30037,28490,3,69,4,0,0,0,0,6,364,79,23002,27609,13864,1,10,13,6294,7,2428,14626,2,0,1,0,0
EUW1_6853153569',5,33,10,2,0,1,0,15,1,340,76,26563,27043,28470,4,25,10,0,0,2,0,5,402,124,30189,31870,26938,1,-62,-48,-3626,0,-4827,1532,2,0,-1,0,10
EUW1_6883756392',8,32,19,1,1,0,0,7,1,359,88,30233,30243,38562,2,24,11,0,0,0,0,2,379,92,28169,29719,33512,1,-20,-4,2064,8,524,5050,1,1,0,0,5
EUW1_6882986840',1,28,6,1,0,0,0,4,0,397,76,24953,28962,32107,1,32,15,1,0,0,0,1,378,92,27912,30537,35714,0,19,-16,-2959,-9,-1575,-3607,0,0,0,0,3
EUW1_6882944444',3,33,21,2,0,3,0,3,1,374,92,32947,32385,37179,2,24,5,0,0,0,0,12,317,88,23109,27568,31066,1,57,4,9838,16,4817,6113,2,0,3,0,-9
EUW1_6882411394',5,32,15,1,1,0,0,6,1,375,100,27861,30192,31249,11,36,9,0,0,0,0,3,384,76,26177,28024,26802,1,-9,24,1684,6,2168,4447,1,1,0,0,3
EUW1_6879887867',8,37,13,2,0,3,0,12,0,305,72,28202,27369,34897,3,27,16,0,0,1,0,8,343,92,28563,28847,38481,0,-38,-20,-361,-3,-1478,-3584,2,0,2,0,4
EUW1_6878524418',1,25,14,1,0,2,0,7,1,386,84,30096,32367,39920,6,42,13,1,0,0,0,7,321,70,25593,27771,29294,1,65,14,4503,1,4596,10626,0,0,2,0,0
EUW1_6876887905',5,35,19,0,0,2,0,12,0,356,66,31315,28665,41264,5,43,22,2,0,1,0,6,328,105,33309,30557,47183,0,28,-39,-1994,-3,-1892,-5919,-2,0,1,0,6
EUW1_6876851191',0,17,3,0,0,0,0,14,0,302,82,20880,23864,14592,7,34,20,1,0,6,1,1,367,90,33617,30877,30159,0,-65,-8,-12737,-17,-7013,-15567,-1,0,-6,-1,13
EUW1_6876569147',4,79,5,0,0,0,0,15,0,342,83,24050,26295,24574,3,27,19,1,0,4,0,3,387,112,32420,31749,35484,0,-45,-29,-8370,-14,-5454,-10910,-1,0,-4,0,12
EUW1_6876541908',6,35,16,1,0,2,0,10,0,397,80,30268,30764,35764,5,32,10,1,0,0,0,6,304,103,25840,27138,31746,1,93,-23,4428,6,3626,4018,0,0,2,0,4
EUW1_6883582796',2,21,16,1,0,1,0,11,0,381,105,30342,31964,31187,4,138,9,1,0,0,0,3,383,79,27448,30554,32921,1,-2,26,2894,7,1410,-1734,0,0,1,0,8
EUW1_6838817014',5,191,8,0,0,1,0,9,1,385,110,27052,28743,27992,5,94,16,2,0,1,0,5,336,81,28606,32654,36631,0,49,29,-1554,-8,-3911,-8639,-2,0,0,0,4
EUW1_6838744312',4,25,8,1,0,0,0,7,1,344,69,24759,26370,26705,5,31,13,1,0,0,0,2,386,83,27590,29950,29841,0,-42,-14,-2831,-5,-3580,-3136,0,0,0,0,5
EUW1_6838676954',3,21,12,1,0,0,0,12,1,307,68,27030,27733,30903,3,17,20,0,0,2,0,2,372,107,31386,34408,43550,1,-65,-39,-4356,-8,-6675,-12647,1,0,-2,0,10
EUW1_6838395750',1,24,6,0,0,0,0,5,0,393,45,23340,27678,16010,1,22,3,0,1,0,0,2,407,110,24388,30665,17372,0,-14,-65,-1048,3,-2987,-1362,0,-1,0,0,3
EUW1_6838340890',4,23,12,1,0,3,0,10,1,353,85,29536,28865,37503,2,82,16,0,0,0,0,9,289,82,27064,29652,32501,1,64,3,2472,-4,-787,5002,1,0,3,0,1
EUW1_6838291724',3,30,11,1,0,1,0,11,0,354,84,28391,28367,35237,4,72,18,0,0,2,0,6,333,92,30711,30037,40791,0,21,-8,-2320,-7,-1670,-5554,1,0,-1,0,5
EUW1_6838224940',5,30,11,0,1,1,0,6,1,356,105,28331,29895,34934,5,18,11,2,0,1,0,7,342,82,27111,28742,28351,1,14,23,1220,0,1153,6583,-2,1,0,0,-1
EUW1_6824435059',6,23,17,1,0,0,0,6,1,336,94,28940,30192,37422,3,218,16,0,0,1,0,3,359,80,29027,27933,29898,0,-23,14,-87,1,2259,7524,1,0,-1,0,3
EUW1_6824376043',5,28,18,2,1,0,0,7,1,322,99,30147,30133,44505,5,25,17,0,0,1,0,5,342,72,29268,28413,42534,0,-20,27,879,1,1720,1971,2,1,-1,0,2
EUW1_6824315377',7,39,22,1,0,2,0,6,1,395,66,34303,31877,47129,5,32,14,0,0,0,0,10,341,70,27733,28133,33298,1,54,-4,6570,8,3744,13831,1,0,2,0,-4
EUW1_6824272548',5,27,14,0,0,0,0,11,0,332,80,27446,28502,28123,2,23,14,1,1,0,0,3,388,100,28956,31618,24946,0,-56,-20,-1510,0,-3116,3177,-1,-1,0,0,8
EUW1_6824204557',2,21,9,0,0,0,0,10,0,302,99,25119,28584,34897,7,28,18,2,0,3,0,2,383,124,31974,33137,37996,0,-81,-25,-6855,-9,-4553,-3099,-2,0,-3,0,8
EUW1_6824143913',3,186,11,1,0,2,0,10,1,367,81,28794,29517,31669,2,28,9,1,1,1,0,5,381,122,28311,31277,27603,0,-14,-41,483,2,-1760,4066,0,-1,1,0,5
EUW1_6824003875',5,26,23,2,0,2,0,5,1,361,100,34251,30629,41520,3,364,9,0,0,0,0,10,317,68,23908,27623,26660,1,44,32,10343,14,3006,14860,2,0,2,0,-5
EUW1_6823976163',7,26,12,0,0,0,0,14,1,338,80,27295,30168,27196,3,431,13,2,0,0,0,2,378,115,28526,31825,34430,0,-40,-35,-1231,-1,-1657,-7234,-2,0,0,0,12
EUW1_6881266311',1,40,18,1,0,1,0,10,1,342,77,28615,29322,33383,4,26,13,0,0,0,0,3,286,49,24715,26284,36435,0,56,28,3900,5,3038,-3052,1,0,1,0,7
EUW1_6881214081',3,30,10,0,0,0,0,13,1,266,68,25275,26016,26057,5,33,22,2,0,2,0,0,357,70,30483,29234,41800,0,-91,-2,-5208,-12,-3218,-15743,-2,0,-2,0,13
EUW1_6883725825',3,30,15,0,0,0,0,9,0,331,90,26405,29666,30193,2,20,22,2,0,1,0,6,382,73,31494,33134,39730,0,-51,17,-5089,-7,-3468,-9537,-2,0,-1,0,3
EUW1_6863303149',2,28,5,0,0,0,0,6,1,372,119,24721,29525,25676,6,26,7,2,0,0,0,2,368,94,24044,30392,25461,0,4,25,677,-2,-867,215,-2,0,0,0,4
EUW1_6862088253',5,29,11,2,0,0,0,9,0,319,100,26353,28061,24386,2,26,9,0,0,0,0,2,366,99,26331,28693,26192,1,-47,1,22,2,-632,-1806,2,0,0,0,7
EUW1_6858244745',5,33,15,0,0,0,0,11,0,293,97,27573,30123,40517,3,23,14,1,0,2,0,3,339,73,28605,28608,35873,0,-46,24,-1032,1,1515,4644,-1,0,-2,0,8
EUW1_6858205007',6,36,10,0,0,0,0,9,0,348,99,27559,28082,27920,4,30,12,1,0,0,0,2,307,92,26290,26303,28915,1,41,7,1269,-2,1779,-995,-1,0,0,0,7
EUW1_6854851147',2,36,18,0,1,0,0,7,1,318,66,29583,29292,37072,0,26,17,1,0,0,0,0,346,88,29131,29842,40372,0,-28,-22,452,1,-550,-3300,-1,1,0,0,7
EUW1_6854818645',2,25,12,1,1,2,0,8,1,374,90,28742,31742,30781,4,153,5,1,0,0,0,8,325,108,23814,27599,21809,1,49,-18,4928,7,4143,8972,0,1,2,0,0
EUW1_6854294928',6,63,15,0,0,1,0,11,1,321,74,29445,28346,35418,8,65,22,2,0,1,0,7,342,87,32096,31579,44272,0,-21,-13,-2651,-7,-3233,-8854,-2,0,0,0,4
EUW1_6854285776',5,29,18,1,1,2,0,3,1,395,96,31945,32199,34535,5,32,5,1,0,0,0,8,356,84,23540,26346,20376,1,39,12,8405,13,5853,14159,0,1,2,0,-5
EUW1_6852353027',7,25,4,0,0,0,0,8,0,377,79,23105,29372,21173,4,29,15,2,0,1,0,3,402,102,30056,31773,32914,0,-25,-23,-6951,-11,-2401,-11741,-2,0,-1,0,5
EUW1_6852270369',3,28,19,0,0,0,0,12,0,339,92,29646,31467,29864,4,19,12,1,0,1,0,4,372,77,28748,32337,30113,1,-33,15,898,7,-870,-249,-1,0,-1,0,8
EUW1_6852224414',5,27,19,1,0,1,0,9,0,295,84,30761,30350,36389,0,29,16,1,0,2,0,8,325,86,29206,28562,34479,1,-30,-2,1555,3,1788,1910,0,0,-1,0,1
EUW1_6852178074',4,39,7,1,0,0,0,11,0,346,76,24405,29065,30966,4,26,12,1,0,0,0,4,391,94,27712,32646,34637,0,-45,-18,-3307,-5,-3581,-3671,0,0,0,0,7
EUW1_6851159801',1,19,14,0,0,0,0,10,0,301,72,27533,29615,35042,4,27,20,1,0,1,0,5,314,102,29340,30064,39164,1,-13,-30,-1807,-6,-449,-4122,-1,0,-1,0,5
EUW1_6850937038',4,26,21,1,0,1,0,9,1,340,92,32379,30872,42960,5,25,18,0,0,1,0,5,347,79,28794,28233,33875,1,-7,13,3585,3,2639,9085,1,0,0,0,4
EUW1_6850902041',1,28,20,1,0,1,0,5,1,393,86,31924,31192,33833,2,24,13,1,0,0,0,8,331,90,27062,27533,35664,1,62,-4,4862,7,3659,-1831,0,0,1,0,-3
EUW1_6850629170',6,257,8,0,0,0,0,11,0,352,74,24968,28802,31339,0,23,17,2,0,1,0,2,379,108,32726,33122,39206,0,-27,-34,-7758,-9,-4320,-7867,-2,0,-1,0,9
EUW1_6850589517',3,25,15,1,0,1,0,7,0,385,88,29886,31124,36403,2,24,10,1,0,0,0,7,338,86,25706,27258,26501,1,47,2,4180,5,3866,9902,0,0,1,0,0
EUW1_6848936791',4,26,11,0,0,0,0,5,0,401,106,28300,30708,27415,2,27,10,2,0,0,0,2,379,83,27332,29122,28650,1,22,23,968,1,1586,-1235,-2,0,0,0,3
EUW1_6848899881',6,365,20,2,0,1,0,9,0,365,78,32256,32897,39641,4,23,12,0,0,1,0,6,377,90,27913,30056,29422,1,-12,-12,4343,8,2841,10219,2,0,0,0,3
EUW1_6883153315',2,22,8,2,0,1,0,12,1,338,92,25958,29096,29336,4,26,14,0,0,1,0,3,367,103,29810,30865,30597,0,-29,-11,-3852,-6,-1769,-1261,2,0,0,0,9
EUW1_6883102915',0,25,15,0,0,0,0,5,1,358,120,28916,29873,37479,1,22,20,2,0,0,0,3,348,68,29566,30969,34168,1,10,52,-650,-5,-1096,3311,-2,0,0,0,2
EUW1_6878240169',9,88,9,0,0,0,0,8,0,331,61,24032,27500,25030,1,21,9,1,0,2,0,1,388,133,28358,32274,26199,0,-57,-72,-4326,0,-4774,-1169,-1,0,-2,0,7
EUW1_6871011289',4,41,5,1,0,0,0,6,0,321,104,23803,28051,26214,5,31,14,1,1,1,0,1,373,96,28142,30976,26445,0,-52,8,-4339,-9,-2925,-231,0,-1,-1,0,5
EUW1_6869816340',8,28,10,2,0,0,0,10,1,403,87,26968,30993,29981,3,24,10,0,0,1,0,2,399,92,27392,31043,25534,1,4,-5,-424,0,-50,4447,2,0,-1,0,8
EUW1_6869396752',4,32,22,2,0,3,0,9,1,347,64,33712,30836,40629,1,93,17,0,0,1,0,8,322,84,30151,30926,43625,1,25,-20,3561,5,-90,-2996,2,0,2,0,1
EUW1_6860009439',4,25,9,0,0,1,0,9,0,345,96,27081,27605,28560,5,30,16,2,1,1,0,8,374,99,29785,31312,33186,0,-29,-3,-2704,-7,-3707,-4626,-2,-1,0,0,1
EUW1_6850743890',9,39,13,0,0,0,0,7,1,371,78,27821,28941,28913,5,30,15,2,0,0,0,2,343,97,28175,30604,29502,1,28,-19,-354,-2,-1663,-589,-2,0,0,0,5
EUW1_6850387102',1,77,11,0,0,0,0,15,1,355,72,26057,28710,21576,2,23,9,2,0,3,0,0,407,108,29404,31755,34473,1,-52,-36,-3347,2,-3045,-12897,-2,0,-3,0,15
EUW1_6846159916',6,55,4,0,0,0,0,9,0,353,94,23392,26197,23833,5,35,16,2,0,1,0,3,376,92,29189,30779,29637,0,-23,2,-5797,-12,-4582,-5804,-2,0,-1,0,6
EUW1_6845198787',6,44,15,1,0,0,0,11,1,332,68,27850,28168,39006,5,25,19,0,0,1,0,1,344,104,30924,32042,41906,0,-12,-36,-3074,-4,-3874,-2900,1,0,-1,0,10
EUW1_6842444888',0,343,9,0,0,0,0,11,0,279,115,25673,27384,21047,3,28,17,1,0,2,0,2,383,98,31295,31562,33145,0,-104,17,-5622,-8,-4178,-12098,-1,0,-2,0,9
EUW1_6834675136',6,80,14,0,0,0,0,10,1,281,76,26370,28167,29918,3,32,14,1,0,1,0,0,371,96,29103,29827,39049,0,-90,-20,-2733,0,-1660,-9131,-1,0,-1,0,10
EUW1_6834584193',5,81,13,1,0,0,0,12,1,330,97,27253,29005,38200,1,28,19,1,0,3,0,1,361,74,32230,30883,39451,0,-31,23,-4977,-6,-1878,-1251,0,0,-3,0,11
EUW1_6833999554',2,149,8,1,0,0,0,12,0,387,84,25556,29605,28176,6,51,14,0,1,1,0,2,392,95,30688,33067,35634,0,-5,-11,-5132,-6,-3462,-7458,1,-1,-1,0,10
EUW1_6832744147',1,30,7,0,0,0,0,10,1,340,88,25849,27410,34081,4,94,15,2,1,1,0,4,336,88,28050,30579,30078,0,4,0,-2201,-8,-3169,4003,-2,-1,-1,0,6
EUW1_6832637936',2,24,13,0,0,0,0,13,0,368,54,27179,30057,34529,7,37,16,1,0,2,0,0,393,122,32171,32108,40474,0,-25,-68,-4992,-3,-2051,-5945,-1,0,-2,0,13
EUW1_6832610094',3,27,7,1,0,0,0,11,0,327,98,25328,28765,30642,3,25,18,1,0,0,0,2,358,94,28760,31048,36201,1,-31,4,-3432,-11,-2283,-5559,0,0,0,0,9
EUW1_6831125268',1,28,12,0,0,1,0,12,0,276,76,27190,27806,34713,5,21,26,2,0,1,0,2,334,105,33427,32282,47963,0,-58,-29,-6237,-14,-4476,-13250,-2,0,0,0,10
EUW1_6830249593',3,23,11,1,0,0,0,7,0,344,80,26910,30082,30040,6,32,11,0,0,1,0,5,363,112,29043,30133,30885,1,-19,-32,-2133,0,-51,-845,1,0,-1,0,2
EUW1_6877148342',3,29,15,0,1,0,0,12,0,321,77,29154,28257,32697,5,29,14,2,0,1,0,3,404,94,30249,30839,38520,0,-83,-17,-1095,1,-2582,-5823,-2,1,-1,0,9
EUW1_6877089438',3,52,8,0,0,0,0,10,0,338,74,24355,27100,23470,5,70,11,2,0,1,0,1,358,81,27387,27698,31614,0,-20,-7,-3032,-3,-598,-8144,-2,0,-1,0,9
EUW1_6876812640',4,24,11,0,0,0,0,11,1,306,85,26302,27673,30016,2,23,13,1,0,1,0,2,377,94,28412,29394,34873,0,-71,-9,-2110,-2,-1721,-4857,-1,0,-1,0,9
EUW1_6876777135',3,33,15,1,0,2,0,8,1,358,108,30986,31735,33357,2,17,7,0,0,1,0,11,323,80,24624,25637,32581,1,35,28,6362,8,6098,776,1,0,1,0,-3
EUW1_6876752133',4,27,7,0,0,0,0,17,0,263,68,21627,24247,26132,3,22,22,1,0,4,0,0,369,103,33711,32057,35659,0,-106,-35,-12084,-15,-7810,-9527,-1,0,-4,0,17
EUW1_6876335656',3,37,10,1,1,0,0,5,1,354,74,26391,28735,33112,1,29,7,0,0,0,0,6,341,73,23354,25237,24569,1,13,1,3037,3,3498,8543,1,1,0,0,-1
EUW1_6875890334',4,26,4,1,0,0,0,12,0,392,86,23448,28841,17229,2,25,15,1,0,3,0,2,397,85,30729,31666,33548,0,-5,1,-7281,-11,-2825,-16319,0,0,-3,0,10
EUW1_6875275651',2,46,7,0,0,0,0,13,0,346,108,25849,28425,28027,1,93,11,2,0,1,0,3,358,91,27029,29772,33529,1,-12,17,-1180,-4,-1347,-5502,-2,0,-1,0,10
EUW1_6875237316',3,32,17,2,0,1,0,5,1,399,72,29505,32967,34553,2,39,7,0,0,1,0,1,342,119,24428,29784,27519,1,57,-47,5077,10,3183,7034,2,0,0,0,4
EUW1_6875216638',7,38,10,0,0,0,0,7,1,379,77,27388,28986,33265,6,37,13,2,0,0,0,5,366,94,28019,29793,37012,0,13,-17,-631,-3,-807,-3747,-2,0,0,0,2
EUW1_6875179201',5,32,10,1,0,1,0,3,1,384,116,28140,31907,27366,5,44,6,1,0,0,0,8,393,81,25005,30348,28423,1,-9,35,3135,4,1559,-1057,0,0,1,0,-5
EUW1_6875157216',6,49,12,2,1,1,0,6,1,402,108,30426,30814,32234,0,27,8,0,0,1,0,7,332,72,24390,28904,23338,1,70,36,6036,4,1910,8896,2,1,0,0,-1
EUW1_6883665237',2,57,12,0,0,1,0,10,0,326,69,26391,26585,34712,6,21,18,1,0,1,0,5,349,68,28111,28587,36269,1,-23,1,-1720,-6,-2002,-1557,-1,0,0,0,5
EUW1_6883600606',1,33,14,1,0,1,0,10,1,360,64,28439,28025,36031,3,30,15,1,0,2,0,4,350,88,29713,29292,35331,1,10,-24,-1274,-1,-1267,700,0,0,-1,0,6
EUW1_6883568997',2,18,6,0,0,0,0,10,0,333,78,23419,26432,27903,4,33,12,1,0,3,0,1,406,112,30400,33345,26789,0,-73,-34,-6981,-6,-6913,1114,-1,0,-3,0,9
EUW1_6883542205',7,34,11,0,0,0,0,10,1,355,86,28114,28849,32221,2,34,15,2,0,2,0,4,310,98,27031,27755,32183,0,45,-12,1083,-4,1094,38,-2,0,-2,0,6
EUW1_6877369645',5,25,12,2,0,0,0,8,1,368,96,27496,30918,32351,4,35,11,0,0,0,0,2,372,95,27217,30044,35369,0,-4,1,279,1,874,-3018,2,0,0,0,6
EUW1_6877314929',3,27,7,1,0,0,0,14,0,317,70,23591,25866,21514,3,26,19,1,0,3,0,4,353,90,32106,29834,32645,0,-36,-20,-8515,-12,-3968,-11131,0,0,-3,0,10
EUW1_6877249028',5,34,8,2,1,2,0,7,1,400,100,27444,29776,23552,5,33,4,0,0,0,0,5,385,72,23541,28245,22183,1,15,28,3903,4,1531,1369,2,1,2,0,2
EUW1_6877218115',7,32,24,1,1,3,0,6,0,389,95,33756,31814,40858,0,22,7,0,0,1,0,10,286,70,22307,23793,20480,1,103,25,11449,17,8021,20378,1,1,2,0,-4
EUW1_6877034861',4,30,8,0,0,1,0,4,0,396,64,25573,29653,29097,6,266,6,2,0,0,0,2,378,116,25144,29516,22541,0,18,-52,429,2,137,6556,-2,0,1,0,2
EUW1_6876991060',4,42,16,1,0,0,0,5,0,361,70,28653,29922,32621,3,26,10,0,0,0,0,1,351,98,25591,28651,32744,1,10,-28,3062,6,1271,-123,1,0,0,0,4
EUW1_6876945824',5,177,16,0,0,1,0,12,1,350,86,30021,29994,38386,2,37,12,2,0,0,0,3,344,105,27704,29733,41239,0,6,-19,2317,4,261,-2853,-2,0,1,0,9
EUW1_6876899909',4,62,11,2,0,0,0,13,0,356,84,28693,30734,28156,7,62,16,0,0,2,0,5,363,76,28304,30215,28855,1,-7,8,389,-5,519,-699,2,0,-2,0,8
EUW1_6876854821',1,24,9,0,0,0,0,8,0,361,72,26572,28542,24230,3,46,13,2,0,1,0,7,309,85,27101,28397,31614,0,52,-13,-529,-4,145,-7384,-2,0,-1,0,1
EUW1_6876799669',5,27,13,2,0,1,0,6,0,384,98,28707,29725,30579,4,25,14,0,0,1,0,5,350,97,29052,31270,31823,0,34,1,-345,-1,-1545,-1244,2,0,0,0,1
EUW1_6876744145',2,24,9,0,0,0,0,5,0,346,104,25214,29373,26833,7,35,14,2,0,2,0,2,388,88,28646,30738,29264,1,-42,16,-3432,-5,-1365,-2431,-2,0,-2,0,3
EUW1_6872904782',1,24,17,0,0,0,0,12,1,369,83,29271,32628,35880,4,21,13,2,0,2,0,3,314,104,26889,29801,36084,0,55,-21,2382,4,2827,-204,-2,0,-2,0,9
EUW1_6871917887',3,33,8,0,0,0,0,6,1,382,88,26765,28270,22336,1,27,14,2,0,1,0,4,372,104,28189,30979,31856,0,10,-16,-1424,-6,-2709,-9520,-2,0,-1,0,2
EUW1_6871873615',1,23,8,0,0,0,0,9,0,325,90,24091,26288,29241,6,26,22,2,1,1,0,3,385,98,31948,34409,43541,0,-60,-8,-7857,-14,-8121,-14300,-2,-1,-1,0,6
EUW1_6871808392',4,30,10,1,0,0,0,9,1,374,89,25881,28430,31444,3,30,8,0,0,0,0,2,378,60,24603,28469,29711,0,-4,29,1278,2,-39,1733,1,0,0,0,7
EUW1_6865766694',3,25,20,0,0,0,0,13,1,258,55,28355,26678,33394,4,73,23,1,1,3,0,1,405,75,37003,31485,46100,0,-147,-20,-8648,-3,-4807,-12706,-1,-1,-3,0,12
EUW1_6865703673',2,21,13,0,0,0,0,6,0,317,84,27018,29511,30820,4,29,16,2,0,1,0,2,359,92,29221,30828,37737,0,-42,-8,-2203,-3,-1317,-6917,-2,0,-1,0,4
EUW1_6861388609',4,29,13,2,0,1,0,8,1,333,96,26970,30633,28548,4,26,7,0,0,1,0,3,359,95,25436,27243,28227,1,-26,1,1534,6,3390,321,2,0,0,0,5
EUW1_6861310587',1,61,13,0,0,2,0,8,1,433,112,31747,32725,32629,3,93,12,1,0,0,0,8,332,92,27384,29193,31272,1,101,20,4363,1,3532,1357,-1,0,2,0,0
EUW1_6834046172',3,45,19,1,0,0,0,8,1,293,108,29426,28964,38926,6,30,14,0,0,0,0,0,323,64,26806,26609,31525,1,-30,44,2620,5,2355,7401,1,0,0,0,8
EUW1_6831333247',4,30,12,1,0,0,0,7,1,357,103,26756,29802,29664,5,38,11,1,0,0,0,2,358,74,26896,30137,36846,1,-1,29,-140,1,-335,-7182,0,0,0,0,5
EUW1_6831207843',7,25,9,2,0,0,0,7,0,384,88,26324,30481,28224,6,98,9,0,0,1,0,3,420,108,27453,31016,19442,1,-36,-20,-1129,0,-535,8782,2,0,-1,0,4
EUW1_6831153310',2,141,17,0,0,0,0,9,1,348,100,29269,29990,31182,1,19,10,2,1,1,0,3,359,64,26159,28968,23547,0,-11,36,3110,7,1022,7635,-2,-1,-1,0,6
EUW1_6830402056',3,25,9,1,1,1,0,4,1,404,91,28485,30877,33360,4,24,10,0,0,0,0,5,394,84,27089,30543,30178,1,10,7,1396,-1,334,3182,1,1,1,0,-1
EUW1_6829658146',6,40,21,1,0,1,0,11,1,353,106,32177,33220,41404,0,26,12,0,0,1,0,5,335,82,29015,28380,39924,1,18,24,3162,9,4840,1480,1,0,0,0,6
EUW1_6842403120',6,30,16,1,1,2,0,10,1,339,77,31622,29739,36581,6,33,17,1,0,0,0,11,356,100,29451,30172,40660,0,-17,-23,2171,-1,-433,-4079,0,1,2,0,-1
EUW1_6842386739',7,28,23,1,0,1,0,7,0,381,82,33415,31357,56283,1,30,20,1,0,0,0,4,311,92,31223,30319,45533,1,70,-10,2192,3,1038,10750,0,0,1,0,3
EUW1_6840579025',3,25,6,0,0,0,0,12,0,328,93,24007,27541,23286,7,28,10,2,0,2,0,4,403,74,28454,29865,26806,0,-75,19,-4447,-4,-2324,-3520,-2,0,-2,0,8
EUW1_6839550199',4,41,15,1,0,1,0,3,1,373,111,30834,32083,28879,4,48,8,0,0,0,0,6,371,59,25419,28215,30939,1,2,52,5415,7,3868,-2060,1,0,1,0,-3
EUW1_6839519488',2,28,11,0,0,1,0,10,1,318,115,28094,27911,33873,6,25,15,2,0,2,0,3,332,76,28780,28725,31155,1,-14,39,-686,-4,-814,2718,-2,0,-1,0,7
EUW1_6838975705',5,29,18,1,0,4,0,6,1,367,105,33699,30832,42207,3,24,9,0,0,1,0,10,289,78,25342,26813,32698,1,78,27,8357,9,4019,9509,1,0,3,0,-4
EUW1_6838698258',6,29,13,1,0,1,0,8,0,398,86,29967,30686,30587,2,50,8,1,0,1,0,7,335,90,25635,27425,24984,1,63,-4,4332,5,3261,5603,0,0,0,0,1
EUW1_6838126502',5,30,15,1,0,1,0,12,1,342,63,28675,29637,36855,5,28,12,0,0,1,0,3,374,80,27865,31041,37031,0,-32,-17,810,3,-1404,-176,1,0,0,0,9
EUW1_6832776462',5,25,16,0,0,0,0,8,0,306,92,27510,28403,37771,4,103,17,2,1,1,0,1,331,88,29728,29313,35189,0,-25,4,-2218,-1,-910,2582,-2,-1,-1,0,7
EUW1_6832592075',4,35,18,0,0,1,0,5,0,388,71,30815,30781,33620,4,35,14,2,0,1,0,7,349,81,27226,28636,30067,1,39,-10,3589,4,2145,3553,-2,0,0,0,-2
EUW1_6830991550',2,24,13,1,0,1,0,8,1,332,82,28365,27617,32052,8,24,20,1,0,2,0,5,321,108,31387,31146,35112,0,11,-26,-3022,-7,-3529,-3060,0,0,-1,0,3
EUW1_6830971546',4,28,12,1,1,2,0,11,1,383,108,32136,30968,39797,4,29,9,0,0,2,0,9,281,80,25727,26431,29869,1,102,28,6409,3,4537,9928,1,1,0,0,2
EUW1_6830173138',4,27,10,0,0,0,0,10,1,345,92,25987,29164,26915,3,37,12,2,0,1,0,1,370,114,28525,31134,31678,0,-25,-22,-2538,-2,-1970,-4763,-2,0,-1,0,9
EUW1_6830106369',3,30,12,0,1,1,0,6,0,381,87,29064,29949,25285,3,102,7,1,0,0,0,3,373,96,26066,30077,26624,1,8,-9,2998,5,-128,-1339,-1,1,1,0,3
EUW1_6829467165',5,35,13,0,0,0,0,12,1,345,90,27908,29114,31572,8,37,9,2,0,1,0,1,411,92,28241,31406,28582,1,-66,-2,-333,4,-2292,2990,-2,0,-1,0,11
EUW1_6829398158',2,27,18,0,0,1,0,11,0,327,85,30332,28293,43287,3,26,17,0,0,2,0,6,294,86,29533,26891,34300,1,33,-1,799,1,1402,8987,0,0,-1,0,5
EUW1_6829392676',5,65,14,1,0,0,0,8,1,376,94,27228,30590,29975,3,30,7,1,0,1,0,1,370,93,27167,28703,27741,1,6,1,61,7,1887,2234,0,0,-1,0,7
EUW1_6829328291',7,46,6,0,0,0,0,11,1,327,65,23497,25955,26040,4,29,21,1,0,2,0,0,402,122,35311,32828,40758,0,-75,-57,-11814,-15,-6873,-14718,-1,0,-2,0,11
EUW1_6828166671',3,24,12,0,0,1,0,9,0,346,87,28590,29804,34661,3,28,24,2,1,1,0,7,355,109,34115,32954,42890,1,-9,-22,-5525,-12,-3150,-8229,-2,-1,0,0,2
EUW1_6828107299',2,24,12,1,0,1,0,4,1,354,90,28692,29381,29813,7,97,12,0,0,0,0,3,358,81,27314,29419,34481,1,-4,9,1378,0,-38,-4668,1,0,1,0,1
EUW1_6867755062',2,24,11,0,1,0,0,4,1,372,109,27677,30032,30503,2,34,9,2,0,2,0,2,367,82,26873,29890,34651,0,5,27,804,2,142,-4148,-2,1,-2,0,2
EUW1_6850395964',6,23,10,0,0,0,0,6,0,375,101,26977,30232,35124,8,35,12,2,0,0,0,1,379,79,26996,29832,30450,0,-4,22,-19,-2,400,4674,-2,0,0,0,5
EUW1_6848109859',2,24,23,1,0,1,0,10,0,327,89,31322,31410,39765,4,31,9,1,0,0,0,3,293,93,25026,27986,28418,0,34,-4,6296,14,3424,11347,0,0,1,0,7
EUW1_6848018348',1,27,19,1,0,1,0,7,1,365,86,31265,31816,32657,6,29,14,0,0,0,0,9,293,92,26644,28528,30461,1,72,-6,4621,5,3288,2196,1,0,1,0,-2
EUW1_6843876403',1,28,13,0,1,1,0,9,1,293,80,28805,26591,30954,3,28,16,2,0,0,0,4,320,84,27509,29298,36575,0,-27,-4,1296,-3,-2707,-5621,-2,1,1,0,5
EUW1_6843832419',5,29,13,1,0,0,0,8,0,361,76,27098,31189,27705,1,34,7,1,1,1,0,3,378,98,25942,29622,26095,0,-17,-22,1156,6,1567,1610,0,-1,-1,0,5
EUW1_6843795903',3,39,9,1,0,0,0,5,1,335,77,26595,27229,28596,3,40,14,0,0,1,0,9,387,82,28538,30234,33672,1,-52,-5,-1943,-5,-3005,-5076,1,0,-1,0,-4
EUW1_6843782496',3,20,5,0,0,0,0,8,0,325,88,23308,26310,19138,3,33,15,1,0,2,0,0,349,104,29897,29375,31038,0,-24,-16,-6589,-10,-3065,-11900,-1,0,-2,0,8
EUW1_6843683080',2,46,21,0,0,1,0,11,1,380,80,31683,31100,41394,2,25,13,1,0,1,0,7,338,64,28913,29710,34726,1,42,16,2770,8,1390,6668,-1,0,0,0,4
EUW1_6843657782',4,35,6,0,0,0,0,10,0,349,84,24172,27413,23199,3,96,12,1,0,0,0,1,361,81,26881,30602,28433,0,-12,3,-2709,-6,-3189,-5234,-1,0,0,0,9
EUW1_6843634766',1,23,13,1,0,0,0,14,1,341,82,27654,30075,31383,2,21,17,1,1,2,0,1,372,122,32243,31667,41497,0,-31,-40,-4589,-4,-1592,-10114,0,-1,-2,0,13
EUW1_6843618269',3,62,28,0,1,4,0,11,0,362,75,35770,30371,50159,0,92,17,0,0,0,0,9,279,68,28087,26531,35321,1,83,7,7683,11,3840,14838,0,1,4,0,2
EUW1_6843613014',5,30,19,2,0,3,0,7,1,364,95,33509,31108,41667,0,26,5,0,0,2,0,11,315,48,21783,26626,28276,1,49,47,11726,14,4482,13391,2,0,1,0,-4
EUW1_6843201302',5,26,9,0,0,2,0,10,0,303,68,26741,27336,30167,0,23,16,1,0,2,0,5,371,128,31734,33534,44903,0,-68,-60,-4993,-7,-6198,-14736,-1,0,0,0,5
EUW1_6843127010',7,36,7,1,0,0,0,9,1,367,116,25368,29368,23124,4,29,9,1,0,1,0,1,390,111,27313,30617,21870,1,-23,5,-1945,-2,-1249,1254,0,0,-1,0,8
EUW1_6843047148',4,37,12,0,0,0,0,12,0,294,108,26523,28320,26612,3,32,16,1,0,3,0,2,388,100,31141,31284,30039,0,-94,8,-4618,-4,-2964,-3427,-1,0,-3,0,10
EUW1_6842976735',7,30,19,1,0,0,0,7,0,306,78,30371,28572,36649,10,37,25,1,0,1,0,4,353,72,33368,29630,45543,1,-47,6,-2997,-6,-1058,-8894,0,0,-1,0,3
EUW1_6842912648',3,36,5,0,0,1,0,8,0,382,87,25088,27602,24398,4,99,10,2,1,1,0,7,380,82,27194,30018,24530,0,2,5,-2106,-5,-2416,-132,-2,-1,0,0,1
EUW1_6842852918',6,30,11,1,0,0,0,8,0,326,81,26258,27828,28437,0,28,9,1,0,0,0,1,358,108,26551,29458,28336,0,-32,-27,-293,2,-1630,101,0,0,0,0,7
EUW1_6842774244',4,35,12,2,0,0,0,9,1,368,84,27255,28568,31918,5,32,13,0,0,0,0,1,370,84,28918,28843,34381,1,-2,0,-1663,-1,-275,-2463,2,0,0,0,8
EUW1_6881338124',5,62,20,1,0,2,0,5,1,397,104,34083,33939,39744,3,22,8,1,0,1,0,11,364,68,24009,27773,21397,1,33,36,10074,12,6166,18347,0,0,1,0,-6
EUW1_6880524781',1,204,7,0,0,0,0,12,1,360,114,26516,30900,36886,4,47,8,2,0,0,0,2,421,109,26947,32017,28865,0,-61,5,-431,-1,-1117,8021,-2,0,0,0,10
EUW1_6880469499',4,30,16,0,0,1,0,11,1,318,92,29297,29240,35109,4,28,17,2,0,2,0,7,401,94,32435,30054,41374,0,-83,-2,-3138,-1,-814,-6265,-2,0,-1,0,4
EUW1_6880386864',3,23,14,1,0,1,0,8,0,363,103,28004,31613,35190,3,25,8,0,0,0,0,1,374,76,26255,29286,24812,0,-11,27,1749,6,2327,10378,1,0,1,0,7
EUW1_6880315202',9,27,15,1,0,1,0,13,1,350,101,30286,30815,34241,5,26,10,1,0,2,0,6,340,84,27427,27557,33876,1,10,17,2859,5,3258,365,0,0,-1,0,7
EUW1_6880267725',2,40,19,1,0,0,0,13,0,337,78,29940,29217,37576,3,29,12,1,0,2,0,5,325,73,27653,25798,31645,1,12,5,2287,7,3419,5931,0,0,-2,0,8
EUW1_6880191315',5,28,12,0,0,2,0,9,0,356,99,30037,29780,30794,5,28,10,2,0,1,0,10,314,88,24787,26632,30371,0,42,11,5250,2,3148,423,-2,0,1,0,-1
EUW1_6880127303',4,32,10,0,0,1,0,3,0,346,86,26675,28107,28132,6,30,15,2,0,0,0,0,354,94,28037,28753,28960,1,-8,-8,-1362,-5,-646,-828,-2,0,1,0,3
EUW1_6879956449',3,17,8,0,0,0,0,9,1,359,88,25935,27990,33443,2,20,13,1,0,3,0,5,366,91,29109,31986,34862,0,-7,-3,-3174,-5,-3996,-1419,-1,0,-3,0,4
EUW1_6879919466',6,26,18,0,1,1,0,10,1,323,87,29341,27763,35469,2,24,14,2,0,2,0,3,362,72,28573,30402,30293,0,-39,15,768,4,-2639,5176,-2,1,-1,0,7
EUW1_6879730173',3,23,10,1,1,0,0,11,0,376,116,25657,30014,25596,4,349,10,1,0,2,0,2,418,94,28722,30247,29524,0,-42,22,-3065,0,-233,-3928,0,1,-2,0,9
EUW1_6879676415',7,29,26,1,0,1,0,12,1,343,94,34343,30213,47748,2,18,20,0,0,2,0,8,324,82,30648,29361,37733,1,19,12,3695,6,852,10015,1,0,-1,0,4
EUW1_6879603166',5,30,17,2,0,2,0,5,1,399,83,32543,32256,43490,3,26,16,0,0,0,0,10,328,75,26944,27278,30522,1,71,8,5599,1,4978,12968,2,0,2,0,-5
EUW1_6879539721',4,37,18,0,0,0,0,5,1,309,58,28864,29588,39826,5,32,19,1,0,0,0,5,344,121,29996,32475,38067,1,-35,-63,-1132,-1,-2887,1759,-1,0,0,0,0
EUW1_6879043667',4,28,12,0,0,1,0,14,0,315,93,27280,29067,25088,4,29,24,2,0,3,0,4,367,94,33497,32345,39806,0,-52,-1,-6217,-12,-3278,-14718,-2,0,-2,0,10
EUW1_6878979170',0,38,6,0,0,0,0,10,0,342,82,24039,29416,33012,5,37,14,2,0,1,0,0,382,78,28852,31112,29487,0,-40,4,-4813,-8,-1696,3525,-2,0,-1,0,10
EUW1_6878932781',3,54,6,1,0,0,0,4,1,406,83,24787,28937,20157,8,29,6,1,0,0,0,1,410,76,24668,27815,19354,0,-4,7,119,0,1122,803,0,0,0,0,3
EUW1_6878890310',2,27,8,1,0,0,0,14,0,325,68,23987,25811,26111,4,18,15,1,0,1,0,3,368,105,28484,30367,30812,0,-43,-37,-4497,-7,-4556,-4701,0,0,-1,0,11
EUW1_6878824930',3,44,14,0,0,1,0,10,0,355,76,28273,29248,25924,5,31,7,1,0,0,0,1,390,88,24916,28294,30695,1,-35,-12,3357,7,954,-4771,-1,0,1,0,9
EUW1_6860532610',5,31,12,0,0,0,0,7,1,343,82,27315,26968,27970,7,35,11,1,0,2,0,4,346,101,27890,29603,29730,0,-3,-19,-575,1,-2635,-1760,-1,0,-2,0,3
EUW1_6860131461',2,31,9,0,0,0,0,9,1,336,70,25140,27595,30164,2,23,13,2,0,1,0,4,365,95,28309,30610,28079,0,-29,-25,-3169,-4,-3015,2085,-2,0,-1,0,5
EUW1_6859905235',4,25,9,1,0,0,0,15,0,293,82,24878,27817,30249,0,61,14,0,0,2,0,1,391,83,29580,29764,36147,0,-98,-1,-4702,-5,-1947,-5898,1,0,-2,0,14
EUW1_6859822846',4,28,13,0,0,0,0,11,0,350,54,26824,28362,25358,7,29,19,1,0,1,0,2,384,102,30679,31175,35821,0,-34,-48,-3855,-6,-2813,-10463,-1,0,-1,0,9
EUW1_6859388685',3,27,15,2,0,0,0,7,1,373,92,27912,31357,28738,2,25,9,0,0,0,0,7,380,84,26053,29091,28723,1,-7,8,1859,6,2266,15,2,0,0,0,0
EUW1_6859374615',0,24,16,2,0,1,0,10,1,376,95,29773,29168,34013,3,34,11,0,1,0,0,3,305,88,25831,28794,31450,1,71,7,3942,5,374,2563,2,-1,1,0,7
EUW1_6859314138',3,28,16,1,0,1,0,11,1,344,105,29276,30895,30332,0,20,7,0,1,0,0,4,372,98,26750,29870,25686,1,-28,7,2526,9,1025,4646,1,-1,1,0,7
EUW1_6859269316',3,28,10,1,0,0,0,17,0,267,79,24048,26148,34144,3,26,24,1,0,4,0,1,325,68,34115,31350,39786,0,-58,11,-10067,-14,-5202,-5642,0,0,-4,0,16
EUW1_6859215306',6,63,17,2,1,2,0,8,1,392,101,30792,33197,43306,5,38,7,0,0,0,0,5,383,58,24566,27826,28022,1,9,43,6226,10,5371,15284,2,1,2,0,3
EUW1_6859138150',0,25,15,1,0,1,0,11,0,394,100,30597,31315,35487,6,75,11,0,0,1,0,5,359,78,27478,29454,34199,1,35,22,3119,4,1861,1288,1,0,0,0,6
EUW1_6859084778',2,28,18,1,0,2,0,7,1,375,94,31028,33519,44274,3,22,11,1,0,0,0,6,343,96,24971,28105,27870,1,32,-2,6057,7,5414,16404,0,0,2,0,1
EUW1_6859012951',8,42,17,0,0,1,0,9,0,304,91,28677,29183,30862,1,24,17,2,1,2,0,4,323,92,29964,27980,36595,1,-19,-1,-1287,0,1203,-5733,-2,-1,-1,0,5
EUW1_6858938226',1,32,12,0,0,2,0,8,1,305,87,29299,26760,35438,2,56,23,2,0,1,0,4,333,94,31240,29840,38929,0,-28,-7,-1941,-11,-3080,-3491,-2,0,1,0,4
EUW1_6858900002',3,23,11,1,1,2,0,9,1,414,118,30047,32021,28765,5,27,4,1,0,1,0,8,315,82,23217,26912,20598,1,99,36,6830,7,5109,8167,0,1,1,0,1
EUW1_6858685949',8,37,13,0,0,0,0,7,1,334,87,26542,28924,33641,1,31,15,2,0,2,0,3,363,76,28765,32123,34986,1,-29,11,-2223,-2,-3199,-1345,-2,0,-2,0,4
EUW1_6858602270',3,32,17,0,0,1,0,16,1,383,79,30337,31351,28213,6,37,4,1,0,3,0,5,358,104,26183,27686,25877,1,25,-25,4154,13,3665,2336,-1,0,-2,0,11
EUW1_6857036141',7,27,11,2,0,0,0,14,0,318,92,25714,28912,23382,1,28,9,0,0,2,0,1,412,84,29020,29553,31056,1,-94,8,-3306,2,-641,-7674,2,0,-2,0,13
EUW1_6856931419',4,26,14,0,0,1,0,12,1,340,97,29474,31307,28681,4,26,11,1,1,2,0,6,401,93,30524,30436,30555,0,-61,4,-1050,3,871,-1874,-1,-1,-1,0,6
EUW1_6883640836',5,36,10,0,0,1,0,6,1,330,74,26841,27307,29708,1,28,16,2,0,0,0,5,355,102,28301,30319,37434,0,-25,-28,-1460,-6,-3012,-7726,-2,0,1,0,1
EUW1_6882227096',2,25,11,1,0,1,0,2,1,384,110,27958,30317,37904,2,26,13,1,0,0,0,5,364,77,27279,31301,31213,1,20,33,679,-2,-984,6691,0,0,1,0,-3
EUW1_6869861649',3,32,18,1,0,0,0,11,1,352,114,29577,31288,41435,6,25,13,1,0,1,0,2,366,78,29039,30526,32024,1,-14,36,538,5,762,9411,0,0,-1,0,9
EUW1_6868315400',4,29,18,2,0,0,0,12,1,332,88,28555,29261,37421,4,28,13,0,0,1,0,3,347,92,27903,29296,29928,1,-15,-4,652,5,-35,7493,2,0,-1,0,9
EUW1_6855253630',10,35,14,1,0,1,0,10,0,366,83,27724,29517,27269,3,37,11,0,0,0,0,2,338,96,27375,27142,34647,0,28,-13,349,3,2375,-7378,1,0,1,0,8
EUW1_6855188212',5,42,12,1,0,1,0,11,0,420,76,29038,32453,29520,4,32,9,1,0,0,0,6,364,100,26128,29881,26467,1,56,-24,2910,3,2572,3053,0,0,1,0,5
EUW1_6849880429',3,28,8,0,0,0,0,9,0,342,82,24709,28109,27192,5,31,11,2,0,1,0,0,388,95,27991,30785,27045,0,-46,-13,-3282,-3,-2676,147,-2,0,-1,0,9
EUW1_6840630255',6,32,1,1,0,0,0,4,0,407,98,23853,29112,21084,3,60,5,1,0,0,0,3,372,85,23621,30412,25163,0,35,13,232,-4,-1300,-4079,0,0,0,0,1
EUW1_6840594905',2,24,7,0,0,0,0,7,0,374,65,24896,28394,21921,4,27,16,1,0,2,0,0,389,97,30397,29576,33885,0,-15,-32,-5501,-9,-1182,-11964,-1,0,-2,0,7
EUW1_6840565853',3,27,7,0,0,0,0,11,0,346,76,23405,25864,28068,3,28,19,1,0,6,0,0,425,108,35462,33022,36111,0,-79,-32,-12057,-12,-7158,-8043,-1,0,-6,0,11
EUW1_6840497609',1,24,18,0,0,0,0,9,1,364,86,30732,32364,34875,0,33,10,1,0,2,0,2,359,95,27165,29906,41857,1,5,-9,3567,8,2458,-6982,-1,0,-2,0,7
EUW1_6840428390',6,20,15,1,0,0,0,10,1,356,74,29881,29924,32166,5,35,17,0,0,3,0,3,363,78,30263,29884,33524,0,-7,-4,-382,-2,40,-1358,1,0,-3,0,7
EUW1_6840388459',4,30,20,2,1,1,0,11,0,365,90,31022,31520,39019,3,19,9,0,0,1,0,4,307,89,27066,26589,29160,1,58,1,3956,11,4931,9859,2,1,0,0,7
EUW1_6840046744',6,35,19,1,1,0,0,9,1,351,102,29294,30309,37862,5,147,11,1,0,1,0,2,352,82,28438,28503,36854,1,-1,20,856,8,1806,1008,0,1,-1,0,7
EUW1_6883580398',4,28,8,0,0,1,0,16,0,354,74,27053,30354,26302,3,28,22,2,1,4,0,5,393,112,35166,33491,41289,0,-39,-38,-8113,-14,-3137,-14987,-2,-1,-3,0,11
EUW1_6883451179',4,30,14,0,0,2,0,8,0,418,99,30391,31328,46706,2,26,13,1,0,0,0,7,322,90,26962,28615,35275,1,96,9,3429,1,2713,11431,-1,0,2,0,1
EUW1_6883410050',3,49,4,0,0,0,0,15,1,349,75,23230,27200,20597,5,32,15,2,0,2,0,3,406,106,31485,32638,38856,0,-57,-31,-8255,-11,-5438,-18259,-2,0,-2,0,12
EUW1_6882986062',5,29,11,0,0,0,0,11,0,354,90,27015,28379,29464,3,28,19,1,0,1,0,0,402,90,31499,32751,39352,0,-48,0,-4484,-8,-4372,-9888,-1,0,-1,0,11
EUW1_6882068721',4,27,12,1,0,1,0,11,0,328,74,27432,28393,30635,3,60,18,1,1,2,0,4,379,83,30945,29789,41481,0,-51,-9,-3513,-6,-1396,-10846,0,-1,-1,0,7
EUW1_6881984935',2,27,11,0,0,1,0,3,0,375,78,26235,28739,25765,3,31,4,2,0,0,0,4,354,100,22872,27436,19780,1,21,-22,3363,7,1303,5985,-2,0,1,0,-1
EUW1_6881919972',4,32,14,1,1,1,0,11,1,392,108,30612,32507,35939,6,28,10,1,0,0,0,5,389,103,27319,31721,34045,1,3,5,3293,4,786,1894,0,1,1,0,6
EUW1_6881837951',6,33,8,1,0,1,0,5,1,361,87,26023,29002,20231,1,36,9,1,1,1,0,2,412,88,27073,29741,25790,1,-51,-1,-1050,-1,-739,-5559,0,-1,0,0,3
EUW1_6881759324',1,23,15,1,0,1,0,12,0,379,113,29374,31563,39433,3,41,13,1,0,0,0,5,378,74,28623,30979,30074,0,1,39,751,2,584,9359,0,0,1,0,7
EUW1_6880527221',6,32,10,1,0,0,0,8,1,365,93,26502,29711,27640,0,31,8,1,0,0,0,2,370,84,25267,28297,28876,1,-5,9,1235,2,1414,-1236,0,0,0,0,6
EUW1_6880459713',8,62,5,0,0,0,0,10,0,385,91,23272,29245,16433,8,29,5,1,0,1,0,1,396,112,25888,30941,15134,0,-11,-21,-2616,0,-1696,1299,-1,0,-1,0,9
EUW1_6880398707',3,27,15,1,0,0,0,5,1,375,90,28014,31321,38546,4,35,6,1,0,0,0,2,375,90,23821,29068,28327,1,0,0,4193,9,2253,10219,0,0,0,0,3
EUW1_6861570504',7,55,24,1,0,2,0,5,0,384,87,34227,31757,44950,1,206,14,0,0,0,0,7,333,76,29229,27440,28411,1,51,11,4998,10,4317,16539,1,0,2,0,-2
EUW1_6861518006',4,23,24,2,1,3,0,5,1,357,104,34610,31417,42885,6,40,8,0,0,0,0,12,283,80,24929,26265,33124,1,74,24,9681,16,5152,9761,2,1,3,0,-7
EUW1_6860747480',4,39,10,0,0,1,0,10,1,348,97,26200,31958,35000,7,31,11,1,0,1,0,2,353,80,26178,30016,33817,1,-5,17,22,-1,1942,1183,-1,0,0,0,8
EUW1_6860738526',6,41,19,1,0,2,0,10,0,311,80,29904,28960,42419,6,26,11,1,0,0,0,3,351,98,26543,28533,38304,1,-40,-18,3361,8,427,4115,0,0,2,0,7
EUW1_6860718023',4,23,31,1,0,2,0,8,0,366,130,36319,34510,52376,8,44,15,0,0,1,0,11,298,51,29082,28305,37640,1,68,79,7237,16,6205,14736,1,0,1,0,-3
EUW1_6859326229',4,29,23,1,0,0,0,13,1,284,80,32520,29851,48232,5,27,25,1,0,2,0,5,348,66,33967,30189,56159,0,-64,14,-1447,-2,-338,-7927,0,0,-2,0,8
EUW1_6859287166',3,30,7,0,0,0,0,6,0,395,113,25783,30414,33444,3,39,7,2,0,0,0,2,373,94,24483,29449,18339,1,22,19,1300,0,965,15105,-2,0,0,0,4
EUW1_6858008479',1,86,11,1,0,0,0,8,0,356,95,28116,30840,26193,2,31,6,1,1,1,0,3,364,99,25771,27892,24858,1,-8,-4,2345,5,2948,1335,0,-1,-1,0,5
EUW1_6872981745',4,75,11,0,0,3,0,9,0,355,78,27924,28239,24991,3,23,11,1,0,0,0,10,297,98,25415,25966,24934,1,58,-20,2509,0,2273,57,-1,0,3,0,-1
EUW1_6872894147',2,23,19,2,0,2,0,10,0,336,90,31912,29641,39018,2,19,18,0,0,0,0,7,324,90,29078,29236,36736,1,12,0,2834,1,405,2282,2,0,2,0,3
EUW1_6870941465',5,24,17,2,1,0,0,15,1,338,92,29252,30524,28103,1,39,7,0,0,2,0,4,363,96,24644,29682,25303,1,-25,-4,4608,10,842,2800,2,1,-2,0,11
EUW1_6870721645',5,29,27,0,0,3,0,9,1,340,84,34531,31900,49282,2,23,16,2,0,2,0,9,315,88,30256,27738,44946,1,25,-4,4275,11,4162,4336,-2,0,1,0,0
EUW1_6870676580',2,38,9,0,0,0,0,6,0,340,102,26213,29877,24132,1,23,9,2,0,1,0,4,339,94,25790,29229,29090,0,1,8,423,0,648,-4958,-2,0,-1,0,2
EUW1_6870200012',6,35,18,1,1,0,0,7,1,371,103,30524,31468,40447,3,27,10,1,0,2,0,3,334,80,26345,27103,31235,0,37,23,4179,8,4365,9212,0,1,-2,0,4
EUW1_6867588853',2,24,24,0,0,1,0,5,1,325,86,33630,30197,48170,2,17,21,2,0,1,0,6,312,62,28696,28861,46919,1,13,24,4934,3,1336,1251,-2,0,0,0,-1
EUW1_6867571752',2,24,10,0,0,0,0,8,1,365,112,26554,30205,28897,6,32,14,2,0,0,0,2,413,100,28769,31512,34189,0,-48,12,-2215,-4,-1307,-5292,-2,0,0,0,6
EUW1_6867516366',3,32,23,1,0,1,0,5,1,346,85,33581,31231,44376,6,22,7,1,0,2,0,10,283,79,23912,25531,27922,1,63,6,9669,16,5700,16454,0,0,-1,0,-5
EUW1_6862487068',1,24,8,0,0,0,0,10,0,317,92,24894,29329,31198,3,25,14,2,0,1,0,2,369,80,28149,31122,33930,0,-52,12,-3255,-6,-1793,-2732,-2,0,-1,0,8
EUW1_6862404642',3,26,16,0,0,2,0,13,0,320,88,30517,28222,39322,4,30,23,2,0,1,0,6,332,82,33583,30455,47140,0,-12,6,-3066,-7,-2233,-7818,-2,0,1,0,7
EUW1_6862336579',4,32,10,0,0,0,0,7,1,358,78,26282,29971,30913,1,24,15,1,0,0,0,1,353,98,26820,30366,37687,0,5,-20,-538,-5,-395,-6774,-1,0,0,0,6
EUW1_6854473840',3,25,7,1,1,0,0,6,1,357,110,25225,29321,24554,5,52,14,1,0,1,0,1,344,80,27952,30826,31718,0,13,30,-2727,-7,-1505,-7164,0,1,-1,0,5
EUW1_6851897679',2,26,11,1,0,0,0,8,0,367,70,26952,28380,31683,1,24,14,0,0,0,0,3,321,95,28204,29124,31572,1,46,-25,-1252,-3,-744,111,1,0,0,0,5
EUW1_6851862721',1,27,17,0,1,3,0,8,1,411,94,33111,32572,32005,0,23,9,1,0,0,0,9,371,98,26448,30231,29319,1,40,-4,6663,8,2341,2686,-1,1,3,0,-1
EUW1_6851836360',2,54,19,0,1,1,0,10,1,344,82,32242,31819,34867,3,22,7,1,0,1,0,5,354,111,24598,27309,27176,1,-10,-29,7644,12,4510,7691,-1,1,0,0,5
EUW1_6851813373',3,32,4,0,0,0,0,5,0,426,100,25219,30195,20794,5,108,12,2,1,0,0,2,368,76,26401,30094,27507,0,58,24,-1182,-8,101,-6713,-2,-1,0,0,3
EUW1_6851783454',4,28,6,1,0,0,0,6,1,363,78,24226,29577,22555,9,39,9,0,0,0,0,7,383,89,26556,31306,31871,0,-20,-11,-2330,-3,-1729,-9316,1,0,0,0,-1
EUW1_6850225639',3,43,7,2,1,3,0,5,1,386,120,28632,30326,23639,4,22,6,0,0,0,0,8,288,94,22200,26345,15483,1,98,26,6432,1,3981,8156,2,1,3,0,-3
EUW1_6850197188',3,20,10,0,0,0,0,12,0,302,72,24968,25831,31945,7,31,21,1,0,3,0,2,348,75,30950,29517,40884,0,-46,-3,-5982,-11,-3686,-8939,-1,0,-3,0,10
EUW1_6842268896',2,47,20,1,1,2,0,4,1,301,90,30987,31966,39891,6,29,15,0,0,0,0,8,308,72,26439,28998,32366,1,-7,18,4548,5,2968,7525,1,1,2,0,-4
EUW1_6842257046',5,30,11,0,0,1,0,14,1,321,71,27034,28152,30956,4,28,18,2,1,3,0,7,346,82,30398,30093,42258,0,-25,-11,-3364,-7,-1941,-11302,-2,-1,-2,0,7
EUW1_6837163562',2,64,15,1,0,0,0,7,0,313,76,27158,28829,30286,3,58,10,1,1,1,0,1,351,94,27080,27898,33370,1,-38,-18,78,5,931,-3084,0,-1,-1,0,6
EUW1_6837085702',4,173,15,0,0,0,0,9,0,304,75,27331,27286,45611,7,29,26,2,0,1,0,0,336,99,32913,32366,57908,1,-32,-24,-5582,-11,-5080,-12297,-2,0,-1,0,9
EUW1_6833698263',6,35,15,0,0,0,0,10,0,330,86,28341,28625,25147,4,32,11,1,0,2,0,4,399,109,28761,30866,30740,0,-69,-23,-420,4,-2241,-5593,-1,0,-2,0,6
EUW1_6833665181',9,34,15,0,0,0,0,6,0,384,76,30270,30460,40020,4,19,11,2,0,2,0,6,300,92,26172,27759,35982,0,84,-16,4098,4,2701,4038,-2,0,-2,0,0
EUW1_6833621362',3,57,23,2,0,0,0,8,1,349,92,31273,31318,36260,3,62,11,0,0,2,0,7,362,67,28155,29624,30520,1,-13,25,3118,12,1694,5740,2,0,-2,0,1
EUW1_6833572830',1,45,12,0,0,1,0,5,1,378,99,30403,29259,31901,3,85,11,1,0,1,0,8,323,80,26153,28954,26895,0,55,19,4250,1,305,5006,-1,0,0,0,-3
EUW1_6833337659',2,41,12,1,0,1,0,7,0,378,80,28446,29641,31929,3,144,16,0,0,0,0,4,353,92,28289,27520,33834,1,25,-12,157,-4,2121,-1905,1,0,1,0,3
EUW1_6833248447',6,32,10,0,0,0,0,5,0,354,88,26671,29517,34454,1,22,7,1,0,1,0,4,380,88,26773,29890,27937,0,-26,0,-102,3,-373,6517,-1,0,-1,0,1
EUW1_6833064710',6,28,12,2,0,0,0,5,1,363,104,28024,31030,37051,6,30,9,0,0,1,0,2,328,108,25468,28013,28564,1,35,-4,2556,3,3017,8487,2,0,-1,0,3
EUW1_6832999055',3,32,21,0,1,1,0,14,1,311,87,32380,28263,36964,5,31,15,2,0,0,0,7,343,112,29069,28273,33804,0,-32,-25,3311,6,-10,3160,-2,1,1,0,7
EUW1_6876702603',8,35,9,0,0,1,0,6,0,370,60,26645,28818,26583,7,65,8,1,1,0,0,4,353,104,26017,29172,25429,1,17,-44,628,1,-354,1154,-1,-1,1,0,2
EUW1_6883329818',5,63,12,1,0,1,0,13,1,402,79,29165,30224,31335,5,55,12,0,0,3,0,3,407,90,30838,30751,30608,0,-5,-11,-1673,0,-527,727,1,0,-2,0,10
EUW1_6883262552',3,28,7,0,1,1,0,16,0,336,94,25992,27800,20580,1,23,11,1,0,2,0,0,402,106,29165,30666,25690,0,-66,-12,-3173,-4,-2866,-5110,-1,1,-1,0,16
EUW1_6883108554',4,26,16,1,0,2,0,9,1,394,110,30646,31638,36885,8,26,15,1,1,1,0,9,322,88,27591,28584,32320,1,72,22,3055,1,3054,4565,0,-1,1,0,0
EUW1_6883042459',1,30,6,1,0,0,0,12,1,284,81,22497,25747,28871,7,37,18,1,0,2,0,0,371,74,31485,30894,38230,0,-87,7,-8988,-12,-5147,-9359,0,0,-2,0,12
EUW1_6882847857',2,21,3,0,0,0,0,15,1,327,72,21711,24322,26605,1,28,24,1,0,5,0,5,402,103,34833,33737,50533,0,-75,-31,-13122,-21,-9415,-23928,-1,0,-5,0,10
EUW1_6882287863',1,100,13,2,1,1,0,10,0,348,98,28709,29702,43276,1,29,14,0,0,1,0,8,381,90,28568,31247,28710,0,-33,8,141,-1,-1545,14566,2,1,0,0,2
EUW1_6882273139',4,25,11,0,0,0,0,13,0,301,96,24820,28974,29612,3,25,15,2,0,2,0,2,380,104,31027,32320,36248,0,-79,-8,-6207,-4,-3346,-6636,-2,0,-2,0,11
EUW1_6882264561',3,29,21,2,0,0,0,8,1,360,88,30727,32057,34045,4,25,5,0,0,1,0,4,368,88,24670,28296,30277,1,-8,0,6057,16,3761,3768,2,0,-1,0,4
EUW1_6882234044',5,24,13,0,0,2,0,7,1,350,93,29215,29602,28677,1,35,17,2,0,0,0,4,330,94,28570,27905,36510,0,20,-1,645,-4,1697,-7833,-2,0,2,0,3
EUW1_6882211260',8,211,22,0,1,3,0,9,1,366,94,33887,30658,39145,4,22,19,2,0,1,0,6,307,90,31006,29157,35921,0,59,4,2881,3,1501,3224,-2,1,2,0,3
EUW1_6881406248',3,32,18,2,0,1,0,2,1,383,85,30459,32530,44381,6,38,10,0,0,0,0,10,355,102,26953,31715,34445,1,28,-17,3506,8,815,9936,2,0,1,0,-8
EUW1_6854186331',4,21,8,0,0,0,0,11,0,343,85,25217,27761,22203,2,29,16,2,0,1,0,1,371,118,30435,30481,37633,0,-28,-33,-5218,-8,-2720,-15430,-2,0,-1,0,10
EUW1_6854175234',3,155,14,1,0,3,0,5,1,394,106,32804,30617,36256,2,18,8,0,0,0,0,9,341,88,25062,27762,26837,1,53,18,7742,6,2855,9419,1,0,3,0,-4
EUW1_6854168064',3,22,13,0,0,1,0,12,0,332,89,27224,27203,35504,3,53,15,1,0,1,0,1,281,79,28307,26524,45237,0,51,10,-1083,-2,679,-9733,-1,0,0,0,11
EUW1_6854125359',1,18,11,2,0,0,0,10,1,349,73,25619,28461,30548,4,30,15,0,0,2,0,0,359,98,29811,31347,39346,1,-10,-25,-4192,-4,-2886,-8798,2,0,-2,0,10
EUW1_6854099256',1,132,11,1,0,1,0,5,1,402,118,29747,32046,37619,5,39,9,0,0,1,0,9,380,82,26094,31127,28670,1,22,36,3653,2,919,8949,1,0,0,0,-4
EUW1_6854064054',3,31,8,1,0,0,0,9,0,340,91,24687,28173,28063,3,27,10,0,0,1,0,2,320,90,27238,28306,34389,0,20,1,-2551,-2,-133,-6326,1,0,-1,0,7
EUW1_6854026122',1,24,12,0,0,0,0,13,0,346,73,27240,28768,32117,7,40,11,1,0,1,0,3,397,98,28445,31185,36086,0,-51,-25,-1205,1,-2417,-3969,-1,0,-1,0,10
EUW1_6844979212',4,27,11,0,0,1,0,11,1,353,84,27182,28763,22686,4,24,9,2,0,0,0,3,377,115,27127,29612,25884,0,-24,-31,55,2,-849,-3198,-2,0,1,0,8
EUW1_6844959611',6,23,11,1,1,1,0,8,1,366,100,28810,30609,28862,2,29,7,0,0,1,0,5,365,96,26056,29183,24605,1,1,4,2754,4,1426,4257,1,1,0,0,3
EUW1_6844538208',3,298,6,1,0,0,0,16,1,388,86,24348,29326,25309,1,22,16,1,1,2,0,1,379,118,31299,32620,34374,0,9,-32,-6951,-10,-3294,-9065,0,-1,-2,0,15
EUW1_6844380185',5,32,13,0,0,0,0,16,1,276,100,25995,28101,33883,2,24,16,1,1,2,0,2,356,107,32335,31492,37052,0,-80,-7,-6340,-3,-3391,-3169,-1,-1,-2,0,14
EUW1_6843668759',5,34,10,0,0,0,0,8,1,339,80,25384,29493,27025,2,27,11,1,1,0,0,1,443,116,29061,31978,28422,0,-104,-36,-3677,-1,-2485,-1397,-1,-1,0,0,7
EUW1_6842215234',2,25,8,0,0,0,0,12,0,338,92,26324,27981,27585,1,29,16,1,1,2,0,2,395,112,30283,32244,27915,0,-57,-20,-3959,-8,-4263,-330,-1,-1,-2,0,10
EUW1_6842205173',3,29,8,1,0,0,0,7,1,346,81,25463,27351,32580,2,32,12,0,0,0,0,3,331,131,27145,30227,26921,0,15,-50,-1682,-4,-2876,5659,1,0,0,0,4
EUW1_6841033922',2,50,13,0,0,1,0,9,1,372,90,29329,29779,36794,3,28,18,2,0,1,0,5,364,101,31212,32130,39805,0,8,-11,-1883,-5,-2351,-3011,-2,0,0,0,4
EUW1_6840679687',4,28,13,1,0,0,0,8,1,325,118,28167,30009,32391,2,97,15,1,0,0,0,4,329,94,28097,29095,33215,0,-4,24,70,-2,914,-824,0,0,0,0,4
EUW1_6840409366',2,26,18,1,0,1,0,4,0,402,122,31923,34363,33411,3,24,8,0,0,0,0,0,346,82,25081,28916,30151,1,56,40,6842,10,5447,3260,1,0,1,0,4
EUW1_6840206308',3,35,7,0,0,1,0,13,1,316,50,24660,25022,27140,4,33,21,1,0,2,0,3,316,148,32583,33530,41281,0,0,-98,-7923,-14,-8508,-14141,-1,0,-1,0,10
EUW1_6838200319',3,27,14,0,0,0,0,10,0,348,85,28121,29342,33287,3,26,14,1,1,0,0,5,356,80,28393,28965,31362,1,-8,5,-272,0,377,1925,-1,-1,0,0,5
EUW1_6838149382',5,38,13,0,0,1,0,11,0,320,76,26948,28317,31095,3,41,12,2,0,2,0,3,340,89,28106,28237,28439,0,-20,-13,-1158,1,80,2656,-2,0,-1,0,8
EUW1_6883734363',5,27,14,2,1,0,0,8,0,336,98,26912,28444,31991,1,36,8,0,0,1,0,3,341,86,25816,26432,25169,1,-5,12,1096,6,2012,6822,2,1,-1,0,5
EUW1_6883550482',0,60,6,0,0,0,0,14,0,382,92,25615,29753,19905,3,66,11,2,0,1,0,3,414,97,29183,30646,28532,0,-32,-5,-3568,-5,-893,-8627,-2,0,-1,0,11
EUW1_6883510769',6,30,5,0,0,0,0,10,0,380,88,24607,29167,30001,6,16,13,2,1,3,0,1,388,112,29627,33459,27185,0,-8,-24,-5020,-8,-4292,2816,-2,-1,-3,0,9
EUW1_6883423542',6,36,13,1,0,0,0,10,1,345,83,26172,28390,38468,6,315,18,1,0,1,0,0,361,92,30778,30185,38375,0,-16,-9,-4606,-5,-1795,93,0,0,-1,0,10
EUW1_6883036033',4,60,16,1,0,1,0,13,0,337,97,29859,30349,39600,4,27,10,0,0,1,0,7,354,114,28214,29732,28503,1,-17,-17,1645,6,617,11097,1,0,0,0,6
EUW1_6882623393',1,20,8,1,0,0,0,7,0,352,92,25439,27923,26067,4,27,14,1,0,0,0,0,386,84,28548,30503,28574,0,-34,8,-3109,-6,-2580,-2507,0,0,0,0,7
EUW1_6882550056',6,27,11,1,1,0,0,13,0,347,116,27974,31301,33095,3,24,12,1,0,3,0,2,382,79,28774,29600,33415,0,-35,37,-800,-1,1701,-320,0,1,-3,0,11
EUW1_6882529763',1,23,6,1,0,0,0,17,1,287,75,22385,25253,26178,3,54,16,0,0,4,0,1,403,104,32068,31167,29102,0,-116,-29,-9683,-10,-5914,-2924,1,0,-4,0,16
EUW1_6882499631',2,26,15,0,0,0,0,11,0,340,86,28404,27656,37875,2,26,15,2,0,3,0,4,390,102,32106,30120,40854,0,-50,-16,-3702,0,-2464,-2979,-2,0,-3,0,7
EUW1_6882476463',7,35,13,1,1,1,0,9,1,413,104,29733,32977,32038,1,23,6,1,0,1,0,6,371,107,25291,30039,22884,1,42,-3,4442,7,2938,9154,0,1,0,0,3
EUW1_6882440206',1,26,16,1,0,0,0,11,1,366,60,28652,28890,34434,1,31,14,0,0,2,0,5,356,102,30454,30387,29401,0,10,-42,-1802,2,-1497,5033,1,0,-2,0,6
EUW1_6881801376',3,29,10,0,0,0,0,6,0,357,89,26215,29673,32121,2,22,17,2,0,2,0,0,360,85,29630,31262,41038,0,-3,4,-3415,-7,-1589,-8917,-2,0,-2,0,6
EUW1_6881709623',4,28,6,0,0,0,0,14,0,323,58,22282,25988,31668,1,27,15,2,0,2,0,1,367,100,29960,30907,41278,0,-44,-42,-7678,-9,-4919,-9610,-2,0,-2,0,13
EUW1_6881647055',4,24,12,0,0,0,0,10,1,364,74,27234,28413,36044,5,147,12,1,0,1,0,1,387,90,28997,31478,38478,0,-23,-16,-1763,0,-3065,-2434,-1,0,-1,0,9
EUW1_6881574834',1,35,11,1,0,1,0,10,1,359,106,27662,29372,26126,5,32,10,1,1,0,0,1,375,89,26440,29050,26817,0,-16,17,1222,1,322,-691,0,-1,1,0,9
EUW1_6821574775',4,22,22,1,0,0,0,11,1,299,92,30176,29658,46959,4,23,12,0,0,1,0,3,330,54,26949,28073,34801,0,-31,38,3227,10,1585,12158,1,0,-1,0,8
EUW1_6821517992',0,20,5,0,0,0,0,15,0,348,82,23045,26547,24837,7,30,19,2,1,2,0,1,421,124,32413,34215,35857,0,-73,-42,-9368,-14,-7668,-11020,-2,-1,-2,0,14
EUW1_6821466017',3,39,9,0,0,0,0,8,0,341,78,25250,26954,36402,4,19,20,2,0,2,0,0,392,104,33063,33686,36096,0,-51,-26,-7813,-11,-6732,306,-2,0,-2,0,8
EUW1_6821370002',7,35,12,2,0,0,0,12,0,308,90,27940,27796,34168,3,23,15,0,0,2,0,0,343,82,28900,27835,31627,1,-35,8,-960,-3,-39,2541,2,0,-2,0,12
EUW1_6821309605',3,58,9,1,0,0,0,13,0,360,86,25862,28847,24491,4,317,12,1,0,2,0,3,399,86,29465,30833,38099,0,-39,0,-3603,-3,-1986,-13608,0,0,-2,0,10
EUW1_6817262497',5,32,16,1,0,1,0,9,0,396,88,30973,31084,28544,3,42,10,1,0,0,0,4,372,79,27807,28766,36304,0,24,9,3166,6,2318,-7760,0,0,1,0,5
EUW1_6817169568',4,30,17,1,1,2,0,10,1,378,68,31420,31485,32129,4,28,6,0,0,1,0,7,310,108,24505,26771,25542,1,68,-40,6915,11,4714,6587,1,1,1,0,3
EUW1_6817080277',3,55,11,1,0,0,0,8,1,377,87,26934,29384,26276,2,18,12,1,0,0,0,4,351,93,26934,29796,30931,1,26,-6,0,-1,-412,-4655,0,0,0,0,4
EUW1_6816830354',5,30,10,1,0,0,0,9,1,381,71,27109,29282,28496,2,25,13,1,0,1,0,2,324,101,28342,30391,27681,1,57,-30,-1233,-3,-1109,815,0,0,-1,0,7
EUW1_6816777459',4,24,14,0,0,0,0,13,0,331,69,27605,28280,24948,3,25,15,2,0,2,0,1,411,110,31371,31909,33449,0,-80,-41,-3766,-1,-3629,-8501,-2,0,-2,0,12
EUW1_6816703562',6,21,11,1,0,0,0,8,0,382,87,27520,30437,25015,5,33,8,1,0,1,0,4,399,88,27268,29273,33584,1,-17,-1,252,3,1164,-8569,0,0,-1,0,4
EUW1_6816617709',3,41,14,0,1,0,0,8,0,337,54,27770,27770,32533,4,22,22,1,0,1,0,2,345,95,32510,30678,31579,0,-8,-41,-4740,-8,-2908,954,-1,1,-1,0,6
EUW1_6816568633',6,28,14,0,0,1,0,10,1,308,91,28887,29134,31696,6,34,12,1,0,0,0,3,333,85,26963,27166,35659,0,-25,6,1924,2,1968,-3963,-1,0,1,0,7
EUW1_6816491286',2,30,12,0,1,1,0,8,1,361,81,29285,29796,36815,5,85,23,2,0,1,0,3,349,90,31882,31933,43915,0,12,-9,-2597,-11,-2137,-7100,-2,1,0,0,5
EUW1_6816408311',4,28,9,1,0,0,0,10,0,353,86,25270,30790,33858,5,42,12,1,0,0,0,0,396,84,27525,31127,32421,1,-43,2,-2255,-3,-337,1437,0,0,0,0,10
EUW1_6816369393',4,36,17,1,0,0,0,8,1,304,99,29357,28738,32713,3,28,17,0,0,1,0,2,376,52,30784,30942,39953,0,-72,47,-1427,0,-2204,-7240,1,0,-1,0,6
EUW1_6815692068',4,36,18,1,0,1,0,14,0,325,66,29851,27503,41156,4,27,18,1,0,1,0,4,353,70,31328,29849,35391,0,-28,-4,-1477,0,-2346,5765,0,0,0,0,10
EUW1_6815490014',3,40,13,0,0,1,0,7,0,337,85,27827,29952,42105,2,31,10,2,0,1,0,4,319,81,25952,28254,32404,1,18,4,1875,3,1698,9701,-2,0,0,0,3
EUW1_6815436805',3,18,14,0,0,0,0,4,0,347,78,27124,31175,33507,3,27,14,1,0,0,0,3,313,98,27023,30119,43091,1,34,-20,101,0,1056,-9584,-1,0,0,0,1
EUW1_6815326398',3,30,10,0,0,0,0,13,0,329,98,26460,27202,31302,8,26,19,2,0,1,0,1,364,69,30221,30180,32568,0,-35,29,-3761,-9,-2978,-1266,-2,0,-1,0,12
EUW1_6874214400',4,32,9,0,0,1,0,11,0,388,92,27774,29939,27052,3,69,15,1,0,2,0,5,404,85,30575,30871,33983,0,-16,7,-2801,-6,-932,-6931,-1,0,-1,0,6
EUW1_6874178228',4,32,10,0,0,0,0,13,0,381,80,26741,30400,27039,5,41,18,2,0,2,0,1,427,104,32621,32534,38657,0,-46,-24,-5880,-8,-2134,-11618,-2,0,-2,0,12
EUW1_6873318935',3,30,9,0,0,1,0,8,1,347,50,25744,27718,30231,3,61,12,1,0,0,0,3,333,81,25017,28326,27110,1,14,-31,727,-3,-608,3121,-1,0,1,0,5
EUW1_6870099402',2,29,9,1,0,0,0,9,0,384,79,26639,30070,38155,3,31,12,1,0,1,0,2,347,80,26337,29061,29230,1,37,-1,302,-3,1009,8925,0,0,-1,0,7
EUW1_6870033693',3,19,18,1,0,1,0,10,1,363,76,30568,30526,38339,1,36,13,0,0,0,0,7,326,87,26834,28018,27124,1,37,-11,3734,5,2508,11215,1,0,1,0,3
EUW1_6869971586',4,62,16,0,1,2,0,9,0,433,115,31590,34927,27301,2,23,3,2,0,0,0,6,387,111,23859,28561,22201,1,46,4,7731,13,6366,5100,-2,1,2,0,3
EUW1_6868447658',1,23,18,2,1,0,0,5,1,393,118,31829,33305,33815,0,42,11,0,0,1,0,4,327,93,25711,28571,24514,1,66,25,6118,7,4734,9301,2,1,-1,0,1
EUW1_6868402877',3,26,8,1,0,0,0,10,0,375,93,25002,28309,32339,8,26,20,1,0,1,0,2,419,110,32504,35170,44888,0,-44,-17,-7502,-12,-6861,-12549,0,0,-1,0,8
EUW1_6868363464',7,35,24,2,0,2,0,10,1,384,116,34326,34552,37908,2,29,13,0,0,1,0,10,386,80,29240,30092,32881,1,-2,36,5086,11,4460,5027,2,0,1,0,0
EUW1_6868317931',2,140,3,1,0,0,0,15,0,318,110,22184,26206,26257,9,35,18,1,0,3,0,1,401,82,31305,32734,38069,0,-83,28,-9121,-15,-6528,-11812,0,0,-3,0,14
EUW1_6868258635',5,27,20,1,0,0,0,6,0,302,75,28107,27785,37821,5,34,11,0,0,0,0,4,361,78,26571,27395,31231,1,-59,-3,1536,9,390,6590,1,0,0,0,2
EUW1_6853946757',4,26,8,0,0,1,0,10,0,339,95,26700,28512,38491,6,34,19,2,0,2,0,4,346,98,29948,30439,36587,0,-7,-3,-3248,-11,-1927,1904,-2,0,-1,0,6
EUW1_6853608706',3,25,12,0,0,1,0,2,1,390,123,28996,31179,32565,1,31,12,2,0,0,0,6,361,80,27758,30016,28590,1,29,43,1238,0,1163,3975,-2,0,1,0,-4
EUW1_6853518797',3,202,20,1,0,2,0,7,0,338,72,31609,27548,35439,4,29,14,1,1,0,0,5,314,80,27389,27108,31792,1,24,-8,4220,6,440,3647,0,-1,2,0,2
EUW1_6853475215',4,169,2,0,0,0,0,13,0,347,76,21787,26665,15511,6,29,12,2,0,3,0,0,448,118,31651,32581,32885,0,-101,-42,-9864,-10,-5916,-17374,-2,0,-3,0,13
EUW1_6852774538',3,32,5,1,0,0,0,11,0,413,112,25677,30929,23507,4,37,5,1,0,1,0,5,395,99,26105,30134,29343,1,18,13,-428,0,795,-5836,0,0,-1,0,6
EUW1_6852596997',4,27,9,0,0,1,0,11,0,361,113,26855,29430,28756,0,27,14,2,0,1,0,4,394,78,29086,31672,34454,1,-33,35,-2231,-5,-2242,-5698,-2,0,0,0,7
EUW1_6852115598',2,28,12,1,0,0,0,7,0,395,107,31253,31229,33638,7,30,11,0,0,1,0,5,385,84,26605,27995,32530,1,10,23,4648,1,3234,1108,1,0,-1,0,2
EUW1_6852059452',4,30,12,1,1,2,0,13,0,372,103,29435,30002,34036,4,32,9,1,0,1,0,8,364,80,26578,28808,28990,0,8,23,2857,3,1194,5046,0,1,1,0,5
EUW1_6851937012',4,31,14,0,1,1,0,11,0,297,125,28452,30182,26332,7,32,12,2,0,3,0,4,341,70,27486,27799,26055,1,-44,55,966,2,2383,277,-2,1,-2,0,7
EUW1_6851567893',3,29,9,0,0,0,0,7,1,331,93,26146,27816,30770,4,211,10,2,0,0,0,1,330,78,25728,28121,28184,1,1,15,418,-1,-305,2586,-2,0,0,0,6
EUW1_6851535067',1,263,11,0,0,1,0,4,1,394,92,28779,30928,30003,2,25,4,2,0,1,0,5,293,112,21624,27863,19879,1,101,-20,7155,7,3065,10124,-2,0,0,0,-1
EUW1_6851481739',3,27,1,1,0,0,0,4,0,387,92,22831,28297,16513,7,30,9,1,0,0,0,1,440,106,27555,32540,26899,1,-53,-14,-4724,-8,-4243,-10386,0,0,0,0,3
EUW1_6850821173',6,35,10,0,0,2,0,10,1,347,84,27530,28421,31408,3,31,10,2,1,1,0,4,326,87,25876,29213,24321,0,21,-3,1654,0,-792,7087,-2,-1,1,0,6
EUW1_6850671713',3,39,9,0,0,2,0,14,0,320,96,27694,26585,25727,4,29,22,2,0,2,0,7,363,88,32345,32626,39189,0,-43,8,-4651,-13,-6041,-13462,-2,0,0,0,7
EUW1_6850486081',5,33,16,0,0,0,0,15,0,237,80,28266,25888,33961,5,266,26,2,0,3,0,2,415,75,35295,32136,46845,0,-178,5,-7029,-10,-6248,-12884,-2,0,-3,0,13
EUW1_6849776755',5,45,16,0,0,0,0,1,1,401,86,29915,31507,42713,6,42,6,1,0,0,0,4,345,90,23862,28391,25085,0,56,-4,6053,10,3116,17628,-1,0,0,0,-3
EUW1_6849678631',6,36,11,1,0,0,0,6,1,368,80,27637,29045,33004,5,45,9,0,0,1,0,5,387,94,26934,31148,27710,1,-19,-14,703,2,-2103,5294,1,0,-1,0,1
EUW1_6849614826',4,82,12,0,0,0,0,10,1,379,97,27433,28662,28893,5,29,13,1,0,1,0,1,331,83,27704,27196,32423,0,48,14,-271,-1,1466,-3530,-1,0,-1,0,9
EUW1_6849563895',3,27,6,0,0,1,0,13,0,346,108,25827,29043,21414,10,33,12,1,1,3,0,3,413,90,30505,32284,34415,0,-67,18,-4678,-6,-3241,-13001,-1,-1,-2,0,10
EUW1_6849285267',6,134,15,1,1,0,0,6,0,392,86,29736,33860,28299,2,61,7,1,0,0,0,8,305,110,24839,27846,29795,1,87,-24,4897,8,6014,-1496,0,1,0,0,-2
EUW1_6861828672',3,32,2,1,0,0,0,10,0,356,72,22263,27446,30414,5,40,18,1,0,1,0,2,375,103,30636,33950,40266,0,-19,-31,-8373,-16,-6504,-9852,0,0,-1,0,8
EUW1_6861760989',9,27,8,0,1,0,0,8,0,368,76,25312,27807,26296,3,23,9,2,0,0,0,4,357,76,25157,28027,31422,0,11,0,155,-1,-220,-5126,-2,1,0,0,4
EUW1_6859209191',9,28,4,0,0,1,0,12,0,353,76,24231,26763,27240,0,24,19,2,0,2,0,5,342,114,32230,32004,32602,0,11,-38,-7999,-15,-5241,-5362,-2,0,-1,0,7
EUW1_6859160831',2,21,10,0,1,1,0,8,0,376,85,27757,29676,31473,3,30,18,1,0,0,0,2,329,62,28645,28266,34454,0,47,23,-888,-8,1410,-2981,-1,1,1,0,6
EUW1_6857799189',3,19,10,1,0,1,0,10,0,339,89,27247,31094,26565,3,19,10,1,0,1,0,3,362,106,27108,31641,28141,0,-23,-17,139,0,-547,-1576,0,0,0,0,7
EUW1_6857751016',0,25,8,0,1,0,0,9,0,368,76,26223,28359,26265,4,25,15,2,0,0,0,2,396,106,30185,30701,32628,0,-28,-30,-3962,-7,-2342,-6363,-2,1,0,0,7
EUW1_6857681072',5,27,13,0,0,0,0,9,1,334,68,28419,27689,37081,4,23,15,1,0,1,0,2,318,82,26777,27955,36303,0,16,-14,1642,-2,-266,778,-1,0,-1,0,7
EUW1_6857610394',7,29,16,1,0,1,0,6,1,334,104,30329,30028,38468,6,46,14,0,0,0,0,7,307,74,26558,27495,30240,1,27,30,3771,2,2533,8228,1,0,1,0,-1
EUW1_6854993843',2,25,4,0,0,0,0,10,0,316,80,22552,26294,23144,7,29,14,1,0,2,0,1,393,104,29473,32030,31859,0,-77,-24,-6921,-10,-5736,-8715,-1,0,-2,0,9
EUW1_6854940629',0,28,8,0,0,1,0,11,1,322,98,25253,27812,25779,3,31,21,1,0,1,0,0,357,98,31244,33633,37863,0,-35,0,-5991,-13,-5821,-12084,-1,0,0,0,11
EUW1_6854885836',1,23,14,1,0,1,0,10,0,370,86,28896,30748,34497,1,27,16,0,0,1,0,4,317,82,29663,29133,34655,0,53,4,-767,-2,1615,-158,1,0,0,0,6
EUW1_6845887117',3,33,19,1,0,2,0,6,1,419,92,32284,33322,37616,2,36,3,0,0,0,0,5,363,98,23238,27405,22557,1,56,-6,9046,16,5917,15059,1,0,2,0,1
EUW1_6835247102',3,30,10,0,0,0,0,9,1,380,90,26418,29966,25006,3,104,10,1,1,3,0,1,394,77,28655,29414,29001,0,-14,13,-2237,0,552,-3995,-1,-1,-3,0,8
EUW1_6834249139',3,29,6,0,1,0,0,9,1,425,100,25409,30333,26543,0,70,8,2,0,0,0,0,392,100,26296,31228,26579,0,33,0,-887,-2,-895,-36,-2,1,0,0,9
EUW1_6834206313',4,48,23,1,1,3,0,5,1,343,88,32546,29972,42762,2,25,7,0,0,0,0,7,336,90,24413,27278,23518,1,7,-2,8133,16,2694,19244,1,1,3,0,-2
EUW1_6832926626',7,29,18,1,0,0,0,9,1,328,84,29807,27879,38802,4,18,14,1,0,1,0,5,353,72,28308,30276,35141,1,-25,12,1499,4,-2397,3661,0,0,-1,0,4
EUW1_6832881934',8,26,4,0,0,0,0,13,1,377,96,24762,28202,25928,9,67,14,1,1,1,0,1,376,104,30220,29774,31599,0,1,-8,-5458,-10,-1572,-5671,-1,-1,-1,0,12
EUW1_6882565464',4,25,13,2,1,2,0,9,0,347,108,28740,31268,34464,3,22,13,0,0,1,0,3,332,72,26399,28002,30744,1,15,36,2341,0,3266,3720,2,1,1,0,6
EUW1_6882528377',2,28,17,0,0,0,0,11,0,355,77,28284,31244,33332,5,31,15,2,0,1,0,0,374,106,29140,29205,34502,1,-19,-29,-856,2,2039,-1170,-2,0,-1,0,11
EUW1_6882504642',0,22,10,0,0,0,0,16,1,340,73,24999,27069,33571,1,22,18,1,0,3,0,1,394,102,32166,30636,37916,0,-54,-29,-7167,-8,-3567,-4345,-1,0,-3,0,15
EUW1_6871146380',1,27,11,1,0,0,0,9,1,385,76,27089,31220,25066,4,27,12,0,0,1,0,6,352,100,28345,31379,34706,1,33,-24,-1256,-1,-159,-9640,1,0,-1,0,3
EUW1_6871116102',0,45,12,0,0,0,0,12,1,337,86,27196,29704,26587,4,29,13,2,1,1,0,2,364,106,28470,31791,32159,1,-27,-20,-1274,-1,-2087,-5572,-2,-1,-1,0,10
EUW1_6883704224',3,28,3,0,0,0,0,14,0,348,81,22281,28088,17656,4,94,9,1,0,3,0,2,375,93,27838,30590,26650,0,-27,-12,-5557,-6,-2502,-8994,-1,0,-3,0,12
EUW1_6881153978',3,23,12,0,0,0,0,7,0,362,84,26972,30483,29514,3,28,16,2,0,0,0,2,339,88,27816,30920,31911,0,23,-4,-844,-4,-437,-2397,-2,0,0,0,5
EUW1_6880544306',5,32,12,0,0,1,0,5,0,386,88,27622,30985,33001,1,175,16,2,0,1,0,5,338,70,28692,30603,35883,1,48,18,-1070,-4,382,-2882,-2,0,0,0,0
EUW1_6880413033',6,26,11,0,0,0,0,11,1,325,74,25683,29218,30744,4,191,15,1,0,2,0,0,384,102,30991,32151,35047,0,-59,-28,-5308,-4,-2933,-4303,-1,0,-2,0,11
EUW1_6878124522',4,29,4,1,0,0,0,12,0,370,97,23578,28867,23315,8,30,17,1,0,2,0,1,416,83,31129,32626,37881,0,-46,14,-7551,-13,-3759,-14566,0,0,-2,0,11
EUW1_6877945189',5,25,10,0,0,2,0,12,0,395,106,28232,30751,31530,3,22,11,2,0,1,0,2,351,92,26374,29245,21056,0,44,14,1858,-1,1506,10474,-2,0,1,0,10
EUW1_6877311663',4,28,12,1,0,1,0,7,1,415,93,29721,30779,35389,3,27,8,1,0,1,0,6,321,97,24986,28354,26421,1,94,-4,4735,4,2425,8968,0,0,0,0,1
EUW1_6876954335',4,24,12,1,0,0,0,8,0,347,90,25910,31001,22959,6,26,9,1,0,0,0,0,415,94,26971,30511,31809,0,-68,-4,-1061,3,490,-8850,0,0,0,0,8
EUW1_6876575950',7,46,12,2,0,0,0,6,0,352,96,27320,29838,27170,5,188,10,0,0,0,0,2,379,84,26533,29046,33528,1,-27,12,787,2,792,-6358,2,0,0,0,4
EUW1_6875501808',3,19,16,0,0,1,0,5,1,365,87,30621,32539,38443,6,29,14,2,0,2,0,8,303,88,26320,27971,36864,1,62,-1,4301,2,4568,1579,-2,0,-1,0,-3
EUW1_6875156276',4,40,9,2,0,0,0,7,0,419,85,26595,29782,32761,8,33,10,0,0,0,0,0,338,82,26140,27439,28632,1,81,3,455,-1,2343,4129,2,0,0,0,7
EUW1_6875095842',3,28,15,1,1,2,0,9,1,371,104,29308,30340,31751,3,31,8,1,0,0,0,4,318,98,25895,27362,20713,1,53,6,3413,7,2978,11038,0,1,2,0,5
EUW1_6874185125',3,28,21,0,0,0,0,7,1,372,67,29531,29804,40576,2,47,14,1,0,0,0,5,334,75,28271,28395,33311,1,38,-8,1260,7,1409,7265,-1,0,0,0,2
EUW1_6874153505',1,179,12,1,0,0,0,7,1,349,90,25846,30929,29957,2,33,4,1,0,1,0,2,358,86,23139,28691,28437,1,-9,4,2707,8,2238,1520,0,0,-1,0,5
EUW1_6873968546',2,27,12,1,0,1,0,10,1,361,110,29494,29037,32427,5,23,15,1,1,2,0,7,378,76,29838,29504,34468,1,-17,34,-344,-3,-467,-2041,0,-1,-1,0,3
EUW1_6873794930',2,22,13,1,0,0,0,8,0,322,81,26354,30192,35946,3,27,16,1,0,1,0,2,326,81,28869,30035,38138,1,-4,0,-2515,-3,157,-2192,0,0,-1,0,6
EUW1_6873118961',4,26,21,0,0,1,0,10,1,369,76,30560,30453,40073,1,25,14,2,0,0,0,2,355,83,29534,30145,38329,1,14,-7,1026,7,308,1744,-2,0,1,0,8
EUW1_6872699417',2,60,9,0,1,0,0,8,0,364,88,25164,30476,20689,4,61,9,2,0,1,0,1,399,88,26992,30335,27551,0,-35,0,-1828,0,141,-6862,-2,1,-1,0,7
EUW1_6876453725',4,31,15,1,0,1,0,9,1,357,78,28453,29702,34507,5,24,15,1,1,1,0,4,364,107,30141,31304,34376,0,-7,-29,-1688,0,-1602,131,0,-1,0,0,5
EUW1_6876435375',2,29,21,1,1,4,0,5,0,360,156,34239,33772,47182,1,235,13,0,0,0,0,11,272,59,25425,26940,32289,1,88,97,8814,8,6832,14893,1,1,4,0,-6
EUW1_6876418739',1,25,19,0,0,1,0,17,0,350,88,31939,31204,34334,1,32,18,2,0,2,0,5,353,113,30979,31298,32372,0,-3,-25,960,1,-94,1962,-2,0,-1,0,12
EUW1_6876407673',1,26,4,0,0,0,0,15,0,206,65,19907,19061,19035,4,37,24,2,0,8,1,0,417,91,37694,33250,42801,0,-211,-26,-17787,-20,-14189,-23766,-2,0,-8,-1,15
EUW1_6876386044',2,18,27,0,0,2,0,8,1,387,87,35949,33444,45903,2,25,14,1,0,0,0,8,326,56,27100,28367,34256,1,61,31,8849,13,5077,11647,-1,0,2,0,0
EUW1_6876366245',3,28,21,1,0,1,0,10,1,406,100,34141,32820,44482,3,33,12,0,0,2,0,6,301,59,25497,26592,30143,1,105,41,8644,9,6228,14339,1,0,-1,0,4
EUW1_6876342020',7,38,19,1,0,2,0,6,1,363,98,31876,32961,34057,4,20,7,1,0,0,0,7,379,90,25593,28473,32031,1,-16,8,6283,12,4488,2026,0,0,2,0,-1
EUW1_6876307375',4,43,15,0,1,0,0,6,0,356,108,28595,32032,35807,3,27,15,1,0,1,0,4,331,84,28058,30289,32544,1,25,24,537,0,1743,3263,-1,1,-1,0,2
EUW1_6876284586',2,23,19,1,0,2,0,9,1,395,76,32299,31591,35908,6,34,10,1,0,0,0,7,303,96,25879,26764,33012,1,92,-20,6420,9,4827,2896,0,0,2,0,2
EUW1_6876202155',3,30,19,0,0,1,0,5,0,393,96,30188,32495,34095,8,33,13,1,0,0,0,3,372,88,28298,30595,33945,1,21,8,1890,6,1900,150,-1,0,1,0,2
EUW1_6876156474',3,23,18,1,0,2,0,7,1,332,83,31442,29928,34644,3,144,15,0,0,0,0,6,343,84,28171,30399,31207,0,-11,-1,3271,3,-471,3437,1,0,2,0,1
EUW1_6876087652',2,25,19,0,1,1,0,9,1,360,88,32657,32088,37094,4,50,18,1,0,2,0,6,359,103,31906,30375,39115,0,1,-15,751,1,1713,-2021,-1,1,-1,0,3
EUW1_6873976182',1,28,8,0,1,1,0,10,1,361,98,25920,30207,29243,5,27,12,2,0,1,0,5,359,113,28286,30816,31083,0,2,-15,-2366,-4,-609,-1840,-2,1,0,0,5
EUW1_6873950895',5,79,14,1,1,1,0,11,1,390,118,31375,31843,42855,1,322,9,1,0,1,0,7,322,71,24705,27276,23603,1,68,47,6670,5,4567,19252,0,1,0,0,4
EUW1_6873719179',1,19,20,0,0,2,0,9,1,368,98,32018,33119,37936,2,40,9,1,0,1,0,7,307,116,24345,29511,28708,1,61,-18,7673,11,3608,9228,-1,0,1,0,2
EUW1_6817371668',7,116,18,1,0,3,0,11,1,357,113,32714,31813,39714,2,24,6,0,0,0,0,4,324,85,24006,26384,26812,1,33,28,8708,12,5429,12902,1,0,3,0,7
EUW1_6815843334',3,236,16,1,0,1,0,11,0,334,68,27222,28935,39625,3,143,19,0,1,1,0,3,419,87,31861,34222,43853,0,-85,-19,-4639,-3,-5287,-4228,1,-1,0,0,8
EUW1_6815790247',2,36,8,0,0,1,0,12,0,350,65,26164,26463,32936,1,31,18,2,0,2,0,2,357,124,32592,30534,33651,0,-7,-59,-6428,-10,-4071,-715,-2,0,-1,0,10
EUW1_6813122061',3,35,17,1,0,0,0,8,0,335,90,30957,29931,39202,5,297,19,0,0,1,0,3,343,69,31616,29734,43876,1,-8,21,-659,-2,197,-4674,1,0,-1,0,5
EUW1_6813102757',4,30,16,0,0,1,0,13,1,359,27,30528,29225,36615,6,265,18,1,0,2,0,6,341,75,30715,28845,35238,0,18,-48,-187,-2,380,1377,-1,0,-1,0,7
EUW1_6813065986',3,23,13,0,0,1,0,10,1,317,78,26933,27552,33637,4,30,20,1,1,2,0,3,371,82,32123,30839,41968,0,-54,-4,-5190,-7,-3287,-8331,-1,-1,-1,0,7
EUW1_6812895884',1,22,17,1,1,2,0,9,1,383,92,31551,32354,33547,5,30,4,0,0,2,0,6,363,97,24327,27456,28738,1,20,-5,7224,13,4898,4809,1,1,0,0,3
EUW1_6811546825',7,28,10,1,0,0,0,10,1,353,85,27529,30079,35842,5,52,20,1,0,1,0,3,387,82,31339,30848,38513,0,-34,3,-3810,-10,-769,-2671,0,0,-1,0,7
EUW1_6811461171',1,69,11,0,0,1,0,15,1,351,80,27579,28536,26572,2,28,14,1,0,2,0,4,408,108,31179,32436,29589,0,-57,-28,-3600,-3,-3900,-3017,-1,0,-1,0,11
EUW1_6811328478',4,137,9,2,0,0,0,5,1,365,96,26332,28827,28973,3,28,11,0,0,0,0,2,435,88,28342,31160,24534,0,-70,8,-2010,-2,-2333,4439,2,0,0,0,3
EUW1_6809888920',4,67,12,0,0,2,0,10,0,386,78,29551,30032,36891,4,23,15,1,0,0,0,5,363,92,28750,30159,35818,0,23,-14,801,-3,-127,1073,-1,0,2,0,5
EUW1_6809853694',3,29,19,1,0,0,0,13,1,263,62,30568,26024,42322,3,26,21,0,0,2,0,3,376,98,33950,30173,42685,0,-113,-36,-3382,-2,-4149,-363,1,0,-2,0,10
EUW1_6809775203',3,28,9,0,0,1,0,5,0,399,74,27446,28229,35509,4,32,11,1,0,0,0,6,374,98,27730,30254,28697,0,25,-24,-284,-2,-2025,6812,-1,0,1,0,-1
EUW1_6809729964',2,55,2,0,0,0,0,6,0,393,84,22645,27307,16342,5,28,13,2,1,1,0,1,393,136,29983,34109,27585,0,0,-52,-7338,-11,-6802,-11243,-2,-1,-1,0,5
EUW1_6805500379',8,34,16,2,0,1,0,9,1,423,89,30244,32864,29779,3,23,5,0,0,0,0,6,319,101,23962,27680,18365,1,104,-12,6282,11,5184,11414,2,0,1,0,3
EUW1_6805434024',0,19,5,0,0,0,0,11,0,387,95,25180,30856,27230,1,26,10,2,0,1,0,4,384,100,26508,31946,30752,0,3,-5,-1328,-5,-1090,-3522,-2,0,-1,0,7
EUW1_6783000331',2,30,6,0,0,0,0,12,0,366,106,26588,28132,23902,6,23,17,1,0,4,0,3,387,106,31471,31685,32620,0,-21,0,-4883,-11,-3553,-8718,-1,0,-4,0,9
EUW1_6879249783',6,28,11,1,0,0,0,6,0,315,87,25542,26908,33290,5,41,15,0,0,1,0,1,336,80,28169,27846,36013,1,-21,7,-2627,-4,-938,-2723,1,0,-1,0,5
EUW1_6872260803',3,24,14,1,0,0,0,12,0,346,117,27913,30113,34755,6,31,10,1,0,1,0,1,330,98,27308,27919,30644,1,16,19,605,4,2194,4111,0,0,-1,0,11
EUW1_6872240446',3,27,8,0,0,0,0,8,1,383,81,24453,28817,30197,4,22,14,1,0,1,0,1,360,99,29343,31230,34833,0,23,-18,-4890,-6,-2413,-4636,-1,0,-1,0,7
EUW1_6870920899',7,37,22,0,0,2,0,14,0,333,94,33772,32449,48491,9,42,17,2,0,3,0,7,341,74,30650,29531,38149,0,-8,20,3122,5,2918,10342,-2,0,-1,0,7
EUW1_6870900266',7,38,9,0,0,0,0,7,0,371,82,25393,28607,29895,3,49,6,1,0,0,0,2,379,76,24992,29082,31229,0,-8,6,401,3,-475,-1334,-1,0,0,0,5
EUW1_6882540687',1,26,12,0,0,0,0,14,0,355,59,26557,27143,28496,6,37,22,1,0,3,0,3,410,86,35095,32152,35060,0,-55,-27,-8538,-10,-5009,-6564,-1,0,-3,0,11
EUW1_6846562385',5,63,10,1,0,0,0,10,0,323,72,25381,26978,30526,6,60,20,1,0,1,0,1,375,100,31791,31409,42581,0,-52,-28,-6410,-10,-4431,-12055,0,0,-1,0,9
EUW1_6846514817',3,136,11,1,1,1,0,12,1,332,82,25156,28743,31487,5,28,9,0,0,2,0,3,325,82,26614,27082,33217,0,7,0,-1458,2,1661,-1730,1,1,-1,0,9
EUW1_6846474529',6,33,15,0,0,0,0,12,1,325,84,28961,29914,36554,4,84,14,2,0,3,0,2,322,108,29450,30420,35246,0,3,-24,-489,1,-506,1308,-2,0,-3,0,10
EUW1_6842262744',5,27,18,2,0,2,0,11,0,338,100,29758,33356,33312,3,29,8,0,0,1,0,5,382,91,26761,28937,34502,1,-44,9,2997,10,4419,-1190,2,0,1,0,6
EUW1_6842248882',5,28,8,1,1,1,0,7,0,381,110,27502,29704,27097,1,30,9,1,0,0,0,3,340,84,25289,27883,24298,1,41,26,2213,-1,1821,2799,0,1,1,0,4
EUW1_6842229068',5,23,14,2,1,0,0,8,1,389,92,28616,31773,34940,3,76,11,0,0,1,0,5,378,96,27733,29305,34620,1,11,-4,883,3,2468,320,2,1,-1,0,3
EUW1_6839434432',3,25,10,1,0,0,0,7,1,367,84,26287,28670,26894,5,27,12,0,0,0,0,3,353,101,28312,30274,33639,1,14,-17,-2025,-2,-1604,-6745,1,0,0,0,4
EUW1_6839409236',0,58,8,1,1,0,0,19,0,309,90,26788,27600,30737,3,64,17,1,0,5,0,5,412,90,33975,32435,41935,0,-103,0,-7187,-9,-4835,-11198,0,1,-5,0,14
EUW1_6839379261',4,24,28,1,0,1,0,10,0,363,74,35679,32064,45733,4,174,18,0,0,1,0,6,299,84,30315,29445,34011,1,64,-10,5364,10,2619,11722,1,0,0,0,4
EUW1_6839360804',7,41,12,0,0,0,0,7,0,327,74,26304,28458,34049,1,30,12,1,0,1,0,2,359,89,27667,30014,33844,0,-32,-15,-1363,0,-1556,205,-1,0,-1,0,5
EUW1_6838172117',5,58,17,2,1,1,0,7,1,350,111,31252,32566,41290,7,59,10,0,0,0,0,8,359,82,27292,28829,26447,1,-9,29,3960,7,3737,14843,2,1,1,0,-1
EUW1_6838127280',3,25,8,0,0,0,0,16,0,325,79,25162,26732,27209,6,43,28,1,0,3,0,2,375,104,37087,34108,46860,0,-50,-25,-11925,-20,-7376,-19651,-1,0,-3,0,14
EUW1_6838096441',5,40,22,1,0,3,0,7,1,385,90,33424,31896,37389,3,28,13,1,0,2,0,7,342,78,28821,30777,34788,1,43,12,4603,9,1119,2601,0,0,1,0,0
EUW1_6838063959',4,30,12,0,0,1,0,12,0,356,88,29629,30188,35455,5,25,14,1,0,1,0,5,363,83,29946,30352,27860,0,-7,5,-317,-2,-164,7595,-1,0,0,0,7
EUW1_6838034025',6,29,15,1,0,0,0,6,0,321,90,27002,30031,29168,4,21,7,1,0,0,0,2,378,84,24834,27562,31008,1,-57,6,2168,8,2469,-1840,0,0,0,0,4
EUW1_6838006835',4,29,17,1,0,1,0,6,1,360,108,30811,32336,39629,3,39,9,0,0,1,0,5,363,80,25426,27866,28786,1,-3,28,5385,8,4470,10843,1,0,0,0,1
EUW1_6815881033',4,244,14,0,0,2,0,8,1,422,100,30439,33163,28450,5,43,7,1,0,0,0,6,354,84,26375,28594,28425,1,68,16,4064,7,4569,25,-1,0,2,0,2
EUW1_6870807642',4,31,11,1,0,1,0,8,1,361,91,28928,30634,28586,1,44,12,1,0,1,0,4,361,76,25944,28014,27321,1,0,15,2984,-1,2620,1265,0,0,0,0,4
EUW1_6870772826',1,54,15,1,0,0,0,14,0,262,84,27060,27428,35120,4,88,19,1,0,2,0,4,347,83,31260,30359,37854,0,-85,1,-4200,-4,-2931,-2734,0,0,-2,0,10
EUW1_6870715040',4,29,12,1,0,0,0,9,0,384,88,28634,30135,31206,3,28,11,1,1,1,0,7,361,100,27951,29206,31191,1,23,-12,683,1,929,15,0,-1,-1,0,2
EUW1_6870672990',4,21,9,0,0,0,0,10,0,337,91,25191,29183,30731,5,59,15,2,0,2,0,3,404,104,31697,33128,39416,0,-67,-13,-6506,-6,-3945,-8685,-2,0,-2,0,7
EUW1_6870617521',2,18,17,0,0,1,0,15,0,341,70,30980,29707,37296,4,27,26,1,1,3,0,5,365,86,33411,31417,46935,0,-24,-16,-2431,-9,-1710,-9639,-1,-1,-2,0,10
EUW1_6870554415',6,32,11,0,0,0,0,11,0,360,86,26323,30051,28605,2,30,10,2,0,1,0,2,386,101,28656,30746,38436,0,-26,-15,-2333,1,-695,-9831,-2,0,-1,0,9
EUW1_6870504679',2,55,9,1,1,0,0,6,0,359,104,26148,29720,27188,6,31,13,1,0,1,0,5,377,104,28102,31755,32636,0,-18,0,-1954,-4,-2035,-5448,0,1,-1,0,1
EUW1_6869747245',5,62,11,0,0,0,0,10,1,378,81,26968,28870,31357,6,34,14,1,0,1,0,3,419,110,30252,32175,32776,0,-41,-29,-3284,-3,-3305,-1419,-1,0,-1,0,7
EUW1_6869681944',3,26,8,0,0,1,0,4,1,362,98,26720,28845,25831,5,28,12,1,0,1,0,5,370,94,27551,29439,28095,1,-8,4,-831,-4,-594,-2264,-1,0,0,0,-1
EUW1_6866765476',3,31,13,0,0,1,0,7,0,322,82,27765,28719,32240,2,26,11,2,0,1,0,5,378,85,27956,28935,28647,0,-56,-3,-191,2,-216,3593,-2,0,0,0,2
EUW1_6866712603',5,27,19,1,0,0,0,7,1,333,99,29028,28374,28965,2,27,15,0,0,1,0,3,373,44,29916,28301,39724,0,-40,55,-888,4,73,-10759,1,0,-1,0,4
EUW1_6866632094',4,29,11,0,1,1,0,10,0,377,100,28810,31198,28165,4,32,8,2,0,1,0,6,406,80,26876,29871,21550,0,-29,20,1934,3,1327,6615,-2,1,0,0,4
EUW1_6866006096',3,29,16,0,0,0,0,10,1,362,106,29280,31899,33178,2,31,11,1,0,1,0,1,362,96,28332,28819,28308,1,0,10,948,5,3080,4870,-1,0,-1,0,9
EUW1_6865974147',2,28,10,0,0,0,0,14,0,298,60,25116,25054,33475,4,31,26,0,0,3,0,0,351,92,35306,32728,42668,0,-53,-32,-10190,-16,-7674,-9193,0,0,-3,0,14
EUW1_6865919043',5,28,11,0,0,0,0,12,0,346,116,26690,30153,27448,2,27,10,2,0,1,0,0,386,78,28251,31775,29543,1,-40,38,-1561,1,-1622,-2095,-2,0,-1,0,12
EUW1_6865626530',2,24,8,1,0,0,0,14,0,291,83,23723,26585,23946,4,23,16,1,1,3,0,1,387,96,31911,30451,31539,0,-96,-13,-8188,-8,-3866,-7593,0,-1,-3,0,13
EUW1_6863577272',2,29,15,0,0,0,0,8,0,368,110,30498,31053,39626,5,26,17,1,0,0,0,2,345,112,30168,30910,32206,1,23,-2,330,-2,143,7420,-1,0,0,0,6
EUW1_6861884930',2,27,8,0,0,0,0,10,0,303,80,25310,27595,27593,1,36,19,1,1,4,0,4,321,111,34253,31771,42760,0,-18,-31,-8943,-11,-4176,-15167,-1,-1,-4,0,6
EUW1_6861859463',4,31,17,1,0,2,0,12,1,336,78,32273,29440,38899,2,20,20,1,0,1,0,7,316,93,30188,29179,46357,1,20,-15,2085,-3,261,-7458,0,0,1,0,5
EUW1_6853238938',3,26,13,1,0,1,0,7,1,403,91,28825,31261,28966,4,25,8,0,0,0,0,4,338,91,25431,29427,29277,1,65,0,3394,5,1834,-311,1,0,1,0,3
EUW1_6853144707',4,22,7,0,0,0,0,12,0,344,88,23776,27637,24456,4,57,18,2,0,2,0,1,396,95,32642,32047,24495,0,-52,-7,-8866,-11,-4410,-39,-2,0,-2,0,11
EUW1_6853112098',7,31,17,1,0,0,0,11,0,346,79,29305,30410,32068,4,30,10,1,0,1,0,3,365,94,27243,29728,30402,1,-19,-15,2062,7,682,1666,0,0,-1,0,8
EUW1_6853098462',6,31,9,0,0,0,0,11,0,369,103,26072,30424,28550,3,28,8,1,0,1,0,1,444,106,28189,31202,22172,0,-75,-3,-2117,1,-778,6378,-1,0,-1,0,10
EUW1_6853025021',3,19,18,2,0,6,0,4,1,394,98,33137,32487,40049,2,26,6,0,0,1,1,12,274,75,22459,25074,22180,1,120,23,10678,12,7413,17869,2,0,5,-1,-8
EUW1_6853014769',2,34,6,0,0,0,0,7,1,341,94,24834,28130,27408,1,24,13,1,0,0,0,2,373,100,27916,30761,26580,0,-32,-6,-3082,-7,-2631,828,-1,0,0,0,5
EUW1_6850963097',3,25,18,1,0,2,0,3,0,352,94,30268,30786,36845,4,28,8,0,0,0,0,6,342,78,24779,28530,21274,1,10,16,5489,10,2256,15571,1,0,2,0,-3
EUW1_6850800220',7,43,7,1,0,0,0,8,0,335,71,24633,28820,24662,3,44,11,0,0,2,0,3,389,93,28223,29976,27560,0,-54,-22,-3590,-4,-1156,-2898,1,0,-2,0,5
EUW1_6850745463',6,41,15,1,0,0,0,8,1,333,98,29460,27738,31141,6,30,6,0,0,2,0,2,330,72,24338,27077,26529,1,3,26,5122,9,661,4612,1,0,-2,0,6
EUW1_6850676343',9,28,13,0,0,0,0,9,0,363,80,26902,28698,36072,3,41,16,1,0,1,0,0,369,84,29744,29947,32398,0,-6,-4,-2842,-3,-1249,3674,-1,0,-1,0,9
EUW1_6850605365',3,29,9,0,0,0,0,11,0,326,91,25802,27829,22582,3,35,17,1,1,2,0,1,413,100,32092,32581,31354,1,-87,-9,-6290,-8,-4752,-8772,-1,-1,-2,0,10
EUW1_6848771662',2,59,13,0,0,1,0,13,1,313,77,27302,27029,34831,3,356,20,2,0,1,0,5,390,80,31620,31817,45870,0,-77,-3,-4318,-7,-4788,-11039,-2,0,0,0,8
EUW1_6848743935',4,31,13,0,0,0,0,8,1,363,98,27709,29589,26815,6,35,11,1,0,1,0,6,399,92,28890,31182,29894,0,-36,6,-1181,2,-1593,-3079,-1,0,-1,0,2
EUW1_6848725803',3,24,17,1,0,3,0,10,1,398,100,32449,32515,31200,4,31,16,1,0,1,0,6,369,68,29636,30070,34070,1,29,32,2813,1,2445,-2870,0,0,2,0,4
EUW1_6870506605',5,25,19,2,0,3,0,6,1,328,91,32054,29189,42743,3,27,8,0,0,0,0,11,289,54,22417,23362,27980,1,39,37,9637,11,5827,14763,2,0,3,0,-5
EUW1_6862092832',11,261,15,1,0,1,0,8,0,359,96,31765,30494,29200,3,25,15,1,0,2,0,7,350,80,30522,30314,35972,0,9,16,1243,0,180,-6772,0,0,-1,0,1
EUW1_6862073842',4,27,14,1,1,0,0,12,1,369,99,29479,29471,37101,4,26,21,1,0,2,0,2,358,108,33152,33325,41749,0,11,-9,-3673,-7,-3854,-4648,0,1,-2,0,10
EUW1_6862061077',4,23,9,1,0,1,0,8,0,353,88,26421,28845,25278,3,30,11,1,0,0,0,3,389,88,26328,30216,22231,0,-36,0,93,-2,-1371,3047,0,0,1,0,5
EUW1_6858109365',5,35,13,2,0,0,0,9,0,352,93,27641,29546,32563,4,31,10,0,0,0,0,3,367,78,27488,27226,26768,0,-15,15,153,3,2320,5795,2,0,0,0,6
EUW1_6853943960',4,37,13,0,0,1,0,5,1,379,89,28490,31051,33094,3,25,14,1,0,1,0,7,333,106,27656,30951,39410,0,46,-17,834,-1,100,-6316,-1,0,0,0,-2
EUW1_6853891890',4,30,25,1,0,3,0,8,1,378,132,34706,34380,42107,1,24,10,0,0,0,0,7,320,72,25310,28249,32016,1,58,60,9396,15,6131,10091,1,0,3,0,1
EUW1_6853834204',1,19,11,0,0,0,0,13,0,302,90,25933,28317,29279,5,32,17,2,0,3,0,0,376,96,31622,30961,37418,0,-74,-6,-5689,-6,-2644,-8139,-2,0,-3,0,13
EUW1_6853765933',3,28,11,0,0,1,0,10,0,325,80,28727,28166,28995,4,26,18,1,1,3,0,7,338,88,30374,29059,28839,0,-13,-8,-1647,-7,-893,156,-1,-1,-2,0,3
EUW1_6853721619',3,31,15,0,0,1,0,10,1,321,96,29267,27385,38514,5,30,19,2,0,1,0,7,341,83,31569,30528,39343,0,-20,13,-2302,-4,-3143,-829,-2,0,0,0,3
EUW1_6853669803',7,340,16,1,0,1,0,7,1,347,95,29330,30166,41568,7,39,11,0,0,0,0,7,292,87,25723,28490,31319,1,55,8,3607,5,1676,10249,1,0,1,0,0
EUW1_6853615235',2,184,22,0,0,0,0,9,0,300,103,30775,29433,43210,2,28,20,2,0,1,0,5,323,68,31250,27695,47111,0,-23,35,-475,2,1738,-3901,-2,0,-1,0,4
EUW1_6853578024',0,23,8,1,0,0,0,8,0,302,98,23666,24983,24221,5,29,18,1,0,0,0,0,357,84,28737,30095,32317,0,-55,14,-5071,-10,-5112,-8096,0,0,0,0,8
EUW1_6853537981',3,23,17,1,0,2,0,7,1,328,126,30318,30331,33465,1,22,12,1,0,2,0,2,303,86,27511,26849,29549,1,25,40,2807,5,3482,3916,0,0,0,0,5
EUW1_6853495658',4,22,13,2,0,0,0,10,0,343,90,26646,28141,33992,7,30,14,0,0,0,0,1,352,84,29231,29627,36090,1,-9,6,-2585,-1,-1486,-2098,2,0,0,0,9
EUW1_6853451385',2,63,11,1,0,0,0,11,1,350,122,27814,31105,29148,5,61,14,1,0,0,0,2,353,90,27507,30445,36294,1,-3,32,307,-3,660,-7146,0,0,0,0,9
EUW1_6853402937',3,22,16,0,0,1,0,10,1,372,120,31036,32279,35314,3,22,14,1,0,1,0,8,293,68,26297,28784,32891,1,79,52,4739,2,3495,2423,-1,0,0,0,2
EUW1_6853369286',1,27,10,0,0,0,0,12,0,375,70,26665,29063,34770,6,48,19,2,0,0,0,3,393,129,31614,34643,36219,0,-18,-59,-4949,-9,-5580,-1449,-2,0,0,0,9
EUW1_6853331777',3,30,11,2,0,1,0,6,0,353,111,28109,29920,23192,5,32,7,0,0,0,0,3,348,76,23803,27806,17443,1,5,35,4306,4,2114,5749,2,0,1,0,3
EUW1_6853306084',4,26,14,2,0,2,0,10,1,352,95,28749,30860,28543,4,29,6,0,0,1,0,6,300,87,23703,25806,24714,1,52,8,5046,8,5054,3829,2,0,1,0,4
EUW1_6831600081',6,29,7,0,0,0,0,6,0,356,76,25262,28772,30181,1,27,10,2,0,1,0,4,364,100,26298,28279,26241,0,-8,-24,-1036,-3,493,3940,-2,0,-1,0,2
EUW1_6831382549',5,33,15,1,0,2,0,7,1,375,102,30207,30859,26443,1,123,6,1,0,0,0,3,373,90,24405,28630,26261,1,2,12,5802,9,2229,182,0,0,2,0,4
EUW1_6831193767',2,29,5,0,1,0,0,10,0,288,92,24030,25995,22190,5,22,17,2,0,0,0,0,348,84,28531,29847,27024,0,-60,8,-4501,-12,-3852,-4834,-2,1,0,0,10
EUW1_6831132116',3,27,18,2,0,1,0,6,1,360,102,30949,30640,44575,6,26,7,0,1,0,0,4,331,90,25327,28779,20736,1,29,12,5622,11,1861,23839,2,-1,1,0,2
EUW1_6830058327',2,139,11,1,0,1,0,6,0,347,88,28405,30162,31559,4,22,9,1,0,0,0,8,361,75,25485,28743,24957,0,-14,13,2920,2,1419,6602,0,0,1,0,-2
EUW1_6830018567',5,31,8,2,0,0,0,2,1,429,96,27800,31035,25293,6,24,7,0,1,0,0,6,367,100,24768,28829,21392,1,62,-4,3032,1,2206,3901,2,-1,0,0,-4
EUW1_6829811404',8,154,12,0,0,0,0,11,1,343,100,28025,30041,30057,5,32,11,1,0,2,0,4,329,83,26915,29994,29857,0,14,17,1110,1,47,200,-1,0,-2,0,7
EUW1_6829765629',3,25,11,0,0,0,0,17,1,374,92,27945,29146,26668,2,24,16,1,0,3,0,3,365,106,30686,32012,37593,0,9,-14,-2741,-5,-2866,-10925,-1,0,-3,0,14
EUW1_6829703419',3,46,10,1,0,0,0,6,0,345,100,26791,29923,23196,2,69,6,0,0,0,0,5,382,88,25005,28776,26878,1,-37,12,1786,4,1147,-3682,1,0,0,0,1
EUW1_6829662801',6,27,14,2,1,0,0,6,1,387,113,28444,29829,27373,9,37,7,0,0,0,0,4,348,90,25000,28759,21950,1,39,23,3444,7,1070,5423,2,1,0,0,2
EUW1_6829622449',4,84,14,0,0,0,0,14,0,323,60,27446,28352,36357,3,23,18,2,0,2,0,3,333,96,31212,30789,37781,0,-10,-36,-3766,-4,-2437,-1424,-2,0,-2,0,11
EUW1_6828878391',1,220,9,0,0,1,0,9,1,348,96,27108,30409,33047,4,23,16,1,0,2,0,5,369,75,30252,31815,31838,0,-21,21,-3144,-7,-1406,1209,-1,0,-1,0,4
EUW1_6828832114',6,66,10,0,0,1,0,6,0,365,95,28250,31504,26499,5,54,16,2,0,0,0,4,372,92,28786,30260,33234,0,-7,3,-536,-6,1244,-6735,-2,0,1,0,2
EUW1_6828770291',6,29,17,1,0,0,0,6,1,341,75,29168,30386,37196,4,21,9,0,0,0,0,3,340,72,24679,27458,29986,1,1,3,4489,8,2928,7210,1,0,0,0,3
EUW1_6828719654',5,28,12,0,0,2,0,6,0,375,80,28946,29182,32304,6,34,9,2,0,0,0,6,337,75,25119,27091,25219,1,38,5,3827,3,2091,7085,-2,0,2,0,0
EUW1_6828594661',6,155,16,0,1,0,0,9,1,382,73,28165,31403,37627,4,30,8,1,0,1,0,3,337,100,25071,29630,22684,1,45,-27,3094,8,1773,14943,-1,1,-1,0,6
EUW1_6828383054',2,41,11,1,0,1,0,15,0,333,72,26789,26862,27504,6,136,10,0,0,4,0,6,380,104,30289,28990,23866,0,-47,-32,-3500,1,-2128,3638,1,0,-3,0,9
EUW1_6879929839',3,22,7,0,0,0,0,11,1,378,89,25712,28644,29747,4,28,11,1,1,1,0,4,388,77,28130,30831,30319,0,-10,12,-2418,-4,-2187,-572,-1,-1,-1,0,7
EUW1_6879827909',4,20,11,0,0,0,0,12,0,379,82,27671,29805,30531,5,26,13,2,0,1,0,3,378,110,29198,31045,31151,0,1,-28,-1527,-2,-1240,-620,-2,0,-1,0,9
EUW1_6879775455',0,29,6,0,0,0,0,11,0,342,92,23779,27335,29663,4,24,21,2,0,2,0,1,354,99,32178,32544,39344,0,-12,-7,-8399,-15,-5209,-9681,-2,0,-2,0,10
EUW1_6878619169',0,26,20,1,0,2,0,7,1,384,108,33081,32813,40289,1,26,11,1,0,0,0,8,321,76,25044,26208,32184,0,63,32,8037,9,6605,8105,0,0,2,0,-1
EUW1_6878592558',5,34,16,2,0,3,0,9,1,388,92,30451,31657,32370,2,30,4,0,0,0,0,7,323,87,22691,26146,28345,1,65,5,7760,12,5511,4025,2,0,3,0,2
EUW1_6878538836',6,42,14,2,0,1,0,8,1,357,82,27699,30834,30064,3,27,8,0,0,0,0,1,337,94,25115,26525,26640,1,20,-12,2584,6,4309,3424,2,0,1,0,7
EUW1_6878375065',8,35,17,1,0,1,0,6,1,362,78,28459,31264,36835,1,25,8,1,0,0,0,3,350,90,25196,28652,24952,1,12,-12,3263,9,2612,11883,0,0,1,0,3
EUW1_6875726984',2,60,7,1,0,0,0,12,1,345,86,24601,28191,28600,3,86,17,1,0,2,0,2,410,98,31377,32136,32734,0,-65,-12,-6776,-10,-3945,-4134,0,0,-2,0,10
EUW1_6875683706',6,205,19,1,1,3,0,15,1,323,85,31018,29558,32640,1,31,5,1,0,1,0,5,339,89,25129,26679,23243,1,-16,-4,5889,14,2879,9397,0,1,2,0,10
EUW1_6875632565',1,29,16,0,0,1,0,6,1,345,96,30991,30419,41684,2,33,14,2,0,0,0,8,374,88,28205,29232,32253,1,-29,8,2786,2,1187,9431,-2,0,1,0,-2
EUW1_6875590123',4,37,17,1,0,2,0,6,1,384,104,32488,32142,38337,0,23,8,1,0,1,0,8,319,94,24271,28769,26136,1,65,10,8217,9,3373,12201,0,0,1,0,-2
EUW1_6872940200',3,19,12,2,0,0,0,15,0,304,80,25048,25701,28332,4,132,22,0,0,4,0,1,366,88,34951,32259,38118,0,-62,-8,-9903,-10,-6558,-9786,2,0,-4,0,14
EUW1_6872903762',4,29,18,0,1,2,0,10,1,355,94,30489,29824,41687,2,28,13,1,0,0,0,5,308,86,25151,27677,22918,1,47,8,5338,5,2147,18769,-1,1,2,0,5
EUW1_6871463270',2,25,5,1,0,1,0,13,0,376,89,25452,29348,29025,4,24,16,1,0,2,0,4,361,98,29564,32566,35256,0,15,-9,-4112,-11,-3218,-6231,0,0,-1,0,9
EUW1_6868213759',3,40,9,1,0,0,0,11,0,394,91,26020,31440,27592,6,26,13,1,0,1,0,0,384,95,27686,31284,31723,0,10,-4,-1666,-4,156,-4131,0,0,-1,0,11
EUW1_6868082188',4,27,17,1,0,1,0,13,1,347,68,32491,30965,41204,1,41,22,1,0,4,0,9,339,104,33939,32555,42375,0,8,-36,-1448,-5,-1590,-1171,0,0,-3,0,4
EUW1_6868015669',4,38,30,2,0,4,0,3,1,368,120,37549,33466,47908,8,27,3,0,0,0,0,13,307,67,21405,23411,26580,1,61,53,16144,27,10055,21328,2,0,4,0,-10
EUW1_6881085263',4,28,4,1,0,0,0,7,0,341,93,23098,27436,30630,4,46,14,0,0,1,0,1,385,82,28242,31157,35917,1,-44,11,-5144,-10,-3721,-5287,1,0,-1,0,6
EUW1_6881042774',1,26,11,1,0,0,0,8,1,353,92,26834,30067,29265,4,42,13,0,0,0,0,2,357,76,25952,28746,27865,0,-4,16,882,-2,1321,1400,1,0,0,0,6
EUW1_6880950444',3,22,12,1,0,0,0,7,0,376,104,28130,31514,34819,3,32,12,1,0,0,0,4,347,88,26689,30177,28267,1,29,16,1441,0,1337,6552,0,0,0,0,3
EUW1_6880936475',6,41,18,1,0,2,0,9,1,353,59,31207,30720,35195,4,31,8,0,0,0,0,9,348,93,25016,26115,28974,1,5,-34,6191,10,4605,6221,1,0,2,0,0
EUW1_6880901231',4,27,10,0,0,0,0,11,0,351,88,27417,27032,27241,5,289,24,1,0,1,0,3,384,86,32447,31664,33639,0,-33,2,-5030,-14,-4632,-6398,-1,0,-1,0,8
EUW1_6880890626',1,25,6,0,0,0,0,9,0,323,102,24604,27758,26438,1,34,19,2,0,0,0,6,352,86,28810,30000,36043,0,-29,16,-4206,-13,-2242,-9605,-2,0,0,0,3
EUW1_6879895359',4,27,12,2,0,0,0,4,0,360,82,25927,30682,26999,5,37,14,0,1,0,0,1,369,80,27277,30757,34246,0,-9,2,-1350,-2,-75,-7247,2,-1,0,0,3
EUW1_6879853803',5,34,16,0,0,0,0,8,1,324,76,27195,28320,41994,4,26,11,2,0,1,0,3,301,82,26322,27491,33613,1,23,-6,873,5,829,8381,-2,0,-1,0,5
EUW1_6879804749',3,94,13,1,0,2,0,3,0,349,112,28890,30919,38036,3,30,10,1,0,0,0,8,317,92,23873,27616,26285,1,32,20,5017,3,3303,11751,0,0,2,0,-5
EUW1_6879697697',3,24,6,2,0,0,0,8,0,340,80,23910,26073,28409,2,30,15,0,0,1,0,3,346,88,28101,29882,32542,0,-6,-8,-4191,-9,-3809,-4133,2,0,-1,0,5
EUW1_6879654627',5,155,4,1,0,0,0,7,0,384,90,23731,28892,23354,5,42,11,1,0,0,0,1,404,112,27318,32059,23773,0,-20,-22,-3587,-7,-3167,-419,0,0,0,0,6
EUW1_6879620763',6,30,3,0,0,0,0,16,0,289,83,20725,24092,16449,2,31,23,2,0,3,0,2,368,110,33400,32433,43761,0,-79,-27,-12675,-20,-8341,-27312,-2,0,-3,0,14
EUW1_6879570526',2,25,4,1,0,0,0,7,0,335,88,23100,28278,21851,4,26,11,0,0,2,0,1,414,92,28031,32250,25455,0,-79,-4,-4931,-7,-3972,-3604,1,0,-2,0,6
EUW1_6879527938',6,27,12,1,0,1,0,8,1,375,106,28653,31149,26082,4,41,8,1,0,0,0,6,389,78,25182,29903,25896,0,-14,28,3471,4,1246,186,0,0,1,0,2
EUW1_6879477152',2,21,4,0,0,0,0,8,0,350,98,23475,27851,24595,4,23,15,2,0,1,0,3,373,90,28533,31505,39884,0,-23,8,-5058,-11,-3654,-15289,-2,0,-1,0,5
EUW1_6878156878',5,25,5,0,0,0,0,13,0,359,79,23429,27720,25197,3,98,16,1,0,2,0,0,332,84,29183,31297,34934,0,27,-5,-5754,-11,-3577,-9737,-1,0,-2,0,13
EUW1_6855642912',5,25,18,0,0,0,0,11,0,307,86,29036,28715,31062,3,27,16,2,1,1,0,2,364,86,30996,30467,39304,0,-57,0,-1960,2,-1752,-8242,-2,-1,-1,0,9
EUW1_6855587285',7,30,14,1,0,0,0,13,1,333,76,27552,28432,27931,6,32,14,1,0,2,0,3,356,82,29353,29791,35725,0,-23,-6,-1801,0,-1359,-7794,0,0,-2,0,10
EUW1_6854972534',9,99,19,2,0,0,0,11,0,323,72,29458,29989,37115,5,28,14,0,1,1,0,4,341,104,29211,30490,33188,1,-18,-32,247,5,-501,3927,2,-1,-1,0,7
EUW1_6854605969',10,46,5,0,0,0,0,9,0,290,86,22748,25655,24550,1,58,17,1,0,1,0,3,385,104,31629,31770,37953,0,-95,-18,-8881,-12,-6115,-13403,-1,0,-1,0,6
EUW1_6839426008',5,25,12,0,0,1,0,8,1,342,86,28201,29371,34809,1,28,11,2,0,1,0,5,352,110,26574,30972,29580,0,-10,-24,1627,1,-1601,5229,-2,0,0,0,3
EUW1_6879079738',3,25,11,0,0,0,0,9,0,375,96,28902,29657,31438,5,25,23,2,0,1,0,3,377,80,31394,31930,39879,0,-2,16,-2492,-12,-2273,-8441,-2,0,-1,0,6
EUW1_6878629028',3,25,19,1,0,1,0,8,1,327,78,29871,30507,32311,4,24,14,1,0,2,0,4,360,78,29264,29200,30088,1,-33,0,607,5,1307,2223,0,0,-1,0,4
EUW1_6878125103',8,46,11,0,0,1,0,3,0,353,83,27092,28445,35677,6,27,13,1,0,0,0,5,343,75,27455,26700,34586,1,10,8,-363,-2,1745,1091,-1,0,1,0,-2
EUW1_6876651745',3,31,8,2,0,0,0,7,1,371,72,26847,29484,24663,1,14,4,0,0,1,0,1,307,112,21525,27145,19152,1,64,-40,5322,4,2339,5511,2,0,-1,0,6
EUW1_6876625617',4,73,13,1,0,2,0,10,0,320,87,27718,28241,39041,4,20,9,0,0,0,0,6,350,68,26025,26414,31089,1,-30,19,1693,4,1827,7952,1,0,2,0,4
EUW1_6883616093',6,73,26,1,0,3,0,7,1,350,80,33686,31017,42865,2,34,13,1,0,0,0,9,354,76,27095,28322,35267,1,-4,4,6591,13,2695,7598,0,0,3,0,-2
EUW1_6880121491',4,28,13,0,0,3,0,13,1,337,73,28979,29336,33209,7,30,21,2,0,1,0,7,331,124,32524,31691,41448,0,6,-51,-3545,-8,-2355,-8239,-2,0,2,0,6
EUW1_6869878730',4,134,11,0,0,0,0,14,0,272,84,25332,25542,29555,8,38,19,1,0,1,0,1,341,64,30444,29189,34832,0,-69,20,-5112,-8,-3647,-5277,-1,0,-1,0,13
EUW1_6831601675',5,28,12,1,0,0,0,7,0,353,103,26929,29123,38765,4,31,18,0,0,1,0,4,350,61,29600,30052,36580,0,3,42,-2671,-6,-929,2185,1,0,-1,0,3
EUW1_6831523680',1,52,4,0,1,0,0,9,0,349,79,24382,27199,27765,3,124,19,2,0,0,0,1,338,99,28659,31541,35523,0,11,-20,-4277,-15,-4342,-7758,-2,1,0,0,8
EUW1_6831471066',5,32,9,1,0,0,0,8,1,375,98,25208,30042,25016,3,22,13,0,1,1,0,3,393,110,29073,33210,38797,0,-18,-12,-3865,-4,-3168,-13781,1,-1,-1,0,5
EUW1_6831400628',5,24,8,1,0,0,0,18,1,390,84,25221,29462,21723,3,26,10,1,1,3,0,0,387,120,30441,31861,24553,0,3,-36,-5220,-2,-2399,-2830,0,-1,-3,0,18
EUW1_6831351608',10,62,13,0,0,2,0,9,1,393,84,31170,31677,30775,2,23,3,1,0,1,0,3,315,92,21906,25880,20606,1,78,-8,9264,10,5797,10169,-1,0,1,0,6
EUW1_6830274370',1,29,16,1,0,1,0,13,0,367,86,31395,29945,29621,4,23,8,0,0,1,0,4,384,98,25948,29170,28561,1,-17,-12,5447,8,775,1060,1,0,0,0,9
EUW1_6830209445',5,32,16,1,0,1,0,6,1,382,133,31471,33343,35245,5,41,11,1,0,0,0,2,386,72,25452,29745,28851,1,-4,61,6019,5,3598,6394,0,0,1,0,4
EUW1_6830187835',7,35,5,0,0,0,0,13,0,311,77,22321,24743,18960,7,36,24,1,1,4,0,2,369,89,34631,31315,41534,0,-58,-12,-12310,-19,-6572,-22574,-1,-1,-4,0,11
EUW1_6830135925',1,33,9,2,1,2,0,5,0,392,96,28623,30331,28495,5,39,9,0,0,0,0,9,401,100,26685,30409,23901,1,-9,-4,1938,0,-78,4594,2,1,2,0,-4
EUW1_6829931844',0,22,13,0,0,1,0,19,0,355,72,29788,29662,35648,7,31,25,2,0,3,0,4,361,80,34616,31372,49611,0,-6,-8,-4828,-12,-1710,-13963,-2,0,-2,0,15
EUW1_6824678431',5,27,15,1,0,0,0,7,1,376,90,29101,30093,30789,2,27,7,0,0,1,0,3,328,74,24890,27474,24429,1,48,16,4211,8,2619,6360,1,0,-1,0,4
EUW1_6824599974',4,30,10,2,0,0,0,7,0,341,69,25739,26646,36162,3,29,17,0,0,1,0,4,362,74,29708,29537,39938,0,-21,-5,-3969,-7,-2891,-3776,2,0,-1,0,3
EUW1_6824502157',3,27,17,1,0,0,0,4,0,332,106,29264,29332,37872,10,33,12,0,0,0,0,4,323,77,26502,27386,31171,0,9,29,2762,5,1946,6701,1,0,0,0,0
EUW1_6823407056',7,26,19,1,0,0,0,5,0,374,110,30421,32996,29089,2,41,13,0,0,0,0,5,328,82,27472,28885,32437,1,46,28,2949,6,4111,-3348,1,0,0,0,0
EUW1_6823352630',3,258,11,2,0,1,0,4,1,375,90,28941,30906,34829,6,32,7,0,0,0,0,7,368,73,24310,26999,18950,1,7,17,4631,4,3907,15879,2,0,1,0,-3
EUW1_6823133125',2,56,4,0,0,0,0,10,0,332,86,22911,26019,19105,9,66,10,1,0,1,0,2,407,102,28881,30150,20129,0,-75,-16,-5970,-6,-4131,-1024,-1,0,-1,0,8
EUW1_6823063461',7,41,21,2,0,0,0,10,0,314,76,30489,27971,44418,4,22,15,0,0,2,0,6,322,92,29367,27690,32363,1,-8,-16,1122,6,281,12055,2,0,-2,0,4
EUW1_6822995024',6,29,13,2,1,0,0,12,0,352,98,27650,30597,31650,4,29,10,0,0,1,0,2,347,94,28170,29044,34267,0,5,4,-520,3,1553,-2617,2,1,-1,0,10
EUW1_6869684615',5,26,13,1,0,1,0,11,0,387,93,28593,31605,37651,4,39,9,1,0,1,0,7,367,84,26059,28969,26464,0,20,9,2534,4,2636,11187,0,0,0,0,4
EUW1_6869616024',7,28,7,0,1,0,0,5,0,339,74,23510,27683,22249,7,29,5,1,0,0,0,1,375,74,24410,28334,29338,0,-36,0,-900,2,-651,-7089,-1,1,0,0,4
EUW1_6869586801',7,39,18,1,0,0,0,8,1,377,92,29627,32107,31150,1,18,5,1,0,1,0,5,348,84,22528,27755,18091,1,29,8,7099,13,4352,13059,0,0,-1,0,3
EUW1_6868179209',1,39,15,0,0,0,0,4,0,332,74,28585,27300,35743,4,306,15,2,0,2,0,7,333,78,30705,30407,39645,1,-1,-4,-2120,0,-3107,-3902,-2,0,-2,0,-3
EUW1_6868073246',3,29,13,0,0,0,0,5,1,377,82,27605,28331,28772,4,61,15,2,0,0,0,5,357,88,27401,29848,28413,0,20,-6,204,-2,-1517,359,-2,0,0,0,0
EUW1_6868010008',2,32,9,0,0,1,0,9,1,365,74,25509,30446,29417,4,27,8,1,0,0,0,1,363,106,25027,31368,27435,0,2,-32,482,1,-922,1982,-1,0,1,0,8
EUW1_6867970211',1,46,7,1,0,0,0,9,0,341,92,25540,27289,28854,1,22,13,0,0,0,0,4,359,106,27434,29298,29652,0,-18,-14,-1894,-6,-2009,-798,1,0,0,0,5
EUW1_6866954989',4,39,19,1,1,4,0,5,1,380,108,32003,31525,33053,3,27,9,1,0,0,0,11,328,67,24852,27955,29486,1,52,41,7151,10,3570,3567,0,1,4,0,-6
EUW1_6866838231',0,37,3,1,0,0,0,8,0,371,100,22903,28458,22624,2,55,15,0,0,0,0,2,371,89,28821,32229,28206,0,0,11,-5918,-12,-3771,-5582,1,0,0,0,6
EUW1_6866751348',2,29,15,0,0,0,0,5,1,398,84,27752,30884,33201,3,25,4,1,0,0,0,0,339,80,22350,27000,23698,1,59,4,5402,11,3884,9503,-1,0,0,0,5
EUW1_6866606029',2,27,10,1,0,2,0,8,1,398,93,27197,31848,31895,6,32,6,1,0,1,0,1,386,118,26343,31899,24127,0,12,-25,854,4,-51,7768,0,0,1,0,7
EUW1_6866061501',1,57,1,0,0,0,0,9,0,364,97,22137,27676,21376,3,144,9,1,0,1,0,3,346,86,26063,30633,29362,0,18,11,-3926,-8,-2957,-7986,-1,0,-1,0,6
EUW1_6865994746',0,25,5,0,0,0,0,9,0,368,68,23101,27143,20814,6,30,15,2,0,1,0,1,397,90,29008,32275,40387,0,-29,-22,-5907,-10,-5132,-19573,-2,0,-1,0,8
EUW1_6865940177',4,27,16,1,0,1,0,10,0,364,92,29842,30324,42802,4,24,15,0,0,1,0,4,348,75,28863,30054,36485,0,16,17,979,1,270,6317,1,0,0,0,6
EUW1_6865877996',2,24,8,1,0,0,0,6,0,357,89,24981,29267,34866,8,60,17,1,0,1,0,2,334,106,28992,30685,36315,0,23,-17,-4011,-9,-1418,-1449,0,0,-1,0,4
EUW1_6865822349',2,92,11,0,0,1,0,9,0,359,108,28269,30528,32092,2,57,9,0,0,0,0,3,338,66,25010,27564,26096,1,21,42,3259,2,2964,5996,0,0,1,0,6
EUW1_6876763908',4,29,15,1,1,0,0,11,1,340,85,27866,30767,28495,5,28,14,1,0,1,0,0,383,86,29346,29337,34430,1,-43,-1,-1480,1,1430,-5935,0,1,-1,0,11
EUW1_6858124564',2,34,10,1,0,1,0,11,0,339,102,27962,29723,35225,5,31,12,1,0,0,0,2,348,76,26396,29797,31758,1,-9,26,1566,-2,-74,3467,0,0,1,0,9
EUW1_6841053125',1,31,20,0,1,2,0,10,0,324,83,32590,30903,47322,2,25,19,2,0,0,0,5,334,82,30155,28942,38515,1,-10,1,2435,1,1961,8807,-2,1,2,0,5
EUW1_6839445501',8,25,15,1,0,0,0,7,1,358,85,27846,30096,35965,5,31,9,1,0,1,0,3,370,98,26810,29806,29740,1,-12,-13,1036,6,290,6225,0,0,-1,0,4
EUW1_6839412122',1,57,7,0,0,0,0,14,1,330,64,23895,25403,31200,4,34,19,2,1,4,0,0,393,132,34690,34450,41585,0,-63,-68,-10795,-12,-9047,-10385,-2,-1,-4,0,14
EUW1_6876283806',4,55,20,0,0,1,0,5,0,365,94,33022,32065,36587,7,31,15,1,0,0,0,8,329,79,27275,27962,33598,1,36,15,5747,5,4103,2989,-1,0,1,0,-3
EUW1_6876247342',3,25,13,1,0,1,0,7,0,349,112,28191,31888,26952,3,29,7,0,1,0,0,5,384,103,26384,30681,28201,1,-35,9,1807,6,1207,-1249,1,-1,1,0,2
EUW1_6876206055',6,33,12,1,0,2,0,5,1,333,79,28226,28908,35144,1,38,5,0,0,0,0,9,362,72,22971,27366,33476,0,-29,7,5255,7,1542,1668,1,0,2,0,-4
EUW1_6876162497',4,22,16,2,0,1,0,8,0,365,78,28948,29754,30879,2,29,10,0,0,1,0,5,356,76,27406,28788,29360,1,9,2,1542,6,966,1519,2,0,0,0,3
EUW1_6876092144',5,33,14,1,0,2,0,13,0,368,76,30120,30155,35755,2,29,19,1,0,2,0,7,322,94,31531,32431,37832,1,46,-18,-1411,-5,-2276,-2077,0,0,0,0,6
EUW1_6876011424',4,24,9,2,0,0,0,9,0,369,78,24707,27945,29098,6,33,18,0,0,1,0,4,358,78,30201,29811,37194,1,11,0,-5494,-9,-1866,-8096,2,0,-1,0,5
EUW1_6875808249',7,32,18,1,1,1,0,6,1,351,94,31223,30478,33880,4,30,10,1,0,0,0,8,298,66,24908,26181,29934,1,53,28,6315,8,4297,3946,0,1,1,0,-2
EUW1_6875761920',2,24,9,1,0,1,0,3,1,395,100,27344,31328,23612,2,26,5,1,0,0,0,4,369,100,24090,28880,25875,1,26,0,3254,4,2448,-2263,0,0,1,0,-1
EUW1_6875728469',5,28,2,1,0,0,0,9,1,339,83,21300,27002,16678,6,28,7,1,0,2,0,0,402,92,26824,29536,21760,0,-63,-9,-5524,-5,-2534,-5082,0,0,-2,0,9
EUW1_6874168595',6,28,13,0,1,0,0,3,1,382,126,27855,32284,29625,5,28,7,2,0,0,0,1,382,81,24392,28842,26610,1,0,45,3463,6,3442,3015,-2,1,0,0,2
EUW1_6874114589',6,22,16,1,0,1,0,9,0,350,66,28324,28552,35441,3,78,21,1,0,2,0,6,323,96,32280,29457,47413,0,27,-30,-3956,-5,-905,-11972,0,0,-1,0,3
EUW1_6873136023',4,30,14,0,0,1,0,7,0,373,54,27769,29720,29733,3,30,13,2,0,0,0,5,368,106,28314,29332,30319,0,5,-52,-545,1,388,-586,-2,0,1,0,2
EUW1_6873062348',4,30,12,0,0,0,0,16,1,317,110,27818,29362,36865,2,24,14,1,0,1,0,2,372,66,28866,28520,35515,0,-55,44,-1048,-2,842,1350,-1,0,-1,0,14
EUW1_6872802302',6,40,14,2,0,1,0,7,1,361,116,29658,32850,34786,1,96,2,0,0,1,0,5,350,82,21834,26945,25069,1,11,34,7824,12,5905,9717,2,0,0,0,2
EUW1_6871721516',9,44,24,1,0,3,0,4,1,362,89,33257,30876,38490,1,37,9,0,0,0,0,13,297,80,25170,25972,31465,1,65,9,8087,15,4904,7025,1,0,3,0,-9
EUW1_6871668933',2,28,4,0,0,0,0,15,0,276,88,20386,23501,22271,2,29,21,2,0,4,0,0,391,100,33732,33337,46961,0,-115,-12,-13346,-17,-9836,-24690,-2,0,-4,0,15
EUW1_6871603319',3,28,7,0,0,0,0,5,1,372,94,25081,29251,20528,5,25,9,1,0,0,0,4,393,103,26882,29828,21662,0,-21,-9,-1801,-2,-577,-1134,-1,0,0,0,1
EUW1_6862672257',2,32,8,0,0,0,0,2,1,381,105,26472,29942,23945,5,27,5,2,0,0,0,3,372,102,23693,29054,24025,1,9,3,2779,3,888,-80,-2,0,0,0,-1
EUW1_6880792632',3,164,8,0,1,1,0,6,0,374,111,26730,30618,32011,2,29,11,2,0,0,0,6,360,92,26478,30388,27788,0,14,19,252,-3,230,4223,-2,1,1,0,0
EUW1_6874505841',4,28,17,1,0,0,0,11,1,367,94,28534,31341,34388,0,32,7,0,0,1,0,2,356,72,25693,28832,28953,1,11,22,2841,10,2509,5435,1,0,-1,0,9
EUW1_6874458796',5,25,18,0,1,0,0,10,1,401,75,31401,30275,30469,3,142,7,1,0,1,0,3,366,65,25071,27805,25859,1,35,10,6330,11,2470,4610,-1,1,-1,0,7
EUW1_6874243634',3,28,11,2,0,1,0,6,0,410,89,30170,31328,31747,3,26,9,0,1,3,0,7,345,112,25151,30393,26107,1,65,-23,5019,2,935,5640,2,-1,-2,0,-1
EUW1_6864594340',4,18,14,0,0,0,0,15,0,328,82,27285,29933,28655,3,24,13,2,0,2,0,0,359,98,29220,31212,33058,0,-31,-16,-1935,1,-1279,-4403,-2,0,-2,0,15
EUW1_6882091327',4,42,12,0,0,0,0,11,1,360,92,26920,29184,28586,5,24,15,2,0,2,0,5,361,100,31537,31802,35291,0,-1,-8,-4617,-3,-2618,-6705,-2,0,-2,0,6
EUW1_6882021248',3,41,12,1,0,1,0,3,1,402,114,29584,31994,29813,3,27,10,1,0,0,0,5,355,70,25954,28968,25134,1,47,44,3630,2,3026,4679,0,0,1,0,-2
EUW1_6881754670',5,55,16,1,0,0,0,10,1,348,87,28588,29622,33616,5,74,10,1,0,2,0,4,367,110,27717,30080,30095,1,-19,-23,871,6,-458,3521,0,0,-2,0,6
EUW1_6880598633',3,25,23,1,0,1,0,11,1,338,85,31451,30941,37918,4,31,8,0,0,0,0,7,345,94,26209,28153,30430,1,-7,-9,5242,15,2788,7488,1,0,1,0,4
EUW1_6880409984',3,24,17,1,1,1,0,10,1,363,84,29427,30669,29024,4,26,4,1,0,0,0,2,378,95,23857,28671,22745,1,-15,-11,5570,13,1998,6279,0,1,1,0,8
EUW1_6879563381',8,42,5,0,0,0,0,10,0,376,84,24234,28673,27399,3,26,15,2,0,2,0,1,371,120,30605,32607,31972,0,5,-36,-6371,-10,-3934,-4573,-2,0,-2,0,9
EUW1_6878239161',1,27,17,1,0,1,0,7,1,375,88,32076,30763,36280,5,89,16,0,0,1,0,6,382,82,29769,31438,38325,1,-7,6,2307,1,-675,-2045,1,0,0,0,1
EUW1_6877671272',6,32,7,1,0,0,0,12,0,381,85,24291,29376,30326,2,24,8,1,0,2,0,2,404,106,28567,30926,26024,0,-23,-21,-4276,-1,-1550,4302,0,0,-2,0,10
EUW1_6877569447',2,22,16,1,1,2,0,10,0,378,119,32064,33953,33127,1,28,7,0,0,1,0,13,378,100,25768,29869,37244,1,0,19,6296,9,4084,-4117,1,1,1,0,-3
EUW1_6876835913',4,23,11,0,0,1,0,11,0,365,56,27623,29090,35322,4,40,20,1,0,2,0,6,363,91,31346,33187,41445,0,2,-35,-3723,-9,-4097,-6123,-1,0,-1,0,5
EUW1_6876770585',4,23,1,1,1,0,0,10,0,352,93,21854,26945,25169,6,36,13,1,0,2,0,3,342,93,28722,30261,28036,0,10,0,-6868,-12,-3316,-2867,0,1,-2,0,7
EUW1_6875790583',0,19,15,0,0,1,0,9,1,376,83,29166,29768,36533,2,28,14,1,0,0,0,8,379,51,28231,27546,34439,0,-3,32,935,1,2222,2094,-1,0,1,0,1
EUW1_6875401557',2,263,8,0,0,0,0,7,1,380,92,26476,28963,23813,4,33,15,2,1,0,0,4,343,104,28289,31130,27657,0,37,-12,-1813,-7,-2167,-3844,-2,-1,0,0,3
EUW1_6875248902',1,16,5,0,0,0,0,14,0,332,71,22930,25820,20905,3,26,20,2,0,3,0,1,394,120,33292,34558,33929,0,-62,-49,-10362,-15,-8738,-13024,-2,0,-3,0,13
EUW1_6875196436',4,32,9,1,1,0,0,7,0,356,96,26065,30236,31679,2,45,9,1,0,0,0,2,350,92,25504,28321,27483,0,6,4,561,0,1915,4196,0,1,0,0,5
EUW1_6873506679',6,32,13,0,0,0,0,7,1,346,82,26714,29305,36698,5,29,13,1,0,1,0,4,350,74,27519,30717,29424,1,-4,8,-805,0,-1412,7274,-1,0,-1,0,3
EUW1_6869106564',6,66,12,1,0,0,0,7,1,345,87,27188,28505,31731,6,28,16,1,0,1,0,4,294,97,28462,28247,29938,1,51,-10,-1274,-4,258,1793,0,0,-1,0,3
EUW1_6868457377',1,23,15,1,0,0,0,8,0,360,95,27519,30879,31901,6,24,7,1,0,1,0,4,372,116,26281,29314,34500,1,-12,-21,1238,8,1565,-2599,0,0,-1,0,4
EUW1_6868372794',1,25,11,1,0,0,0,7,1,374,98,27664,31249,29921,1,25,6,1,0,1,0,3,342,87,24386,29727,21937,1,32,11,3278,5,1522,7984,0,0,-1,0,4
EUW1_6867922975',4,44,4,0,0,0,0,13,0,293,73,21900,25141,31083,3,90,11,2,0,3,0,2,376,100,29241,31246,27906,0,-83,-27,-7341,-7,-6105,3177,-2,0,-3,0,11
EUW1_6880866750',3,25,13,0,0,0,0,16,0,334,100,26905,31346,34963,4,30,10,1,0,4,0,2,390,87,30139,30934,34637,0,-56,13,-3234,3,412,326,-1,0,-4,0,14
EUW1_6880852073',8,30,7,0,0,0,0,14,0,330,95,24390,29358,21517,6,32,14,2,0,3,0,3,384,100,30702,31616,32636,0,-54,-5,-6312,-7,-2258,-11119,-2,0,-3,0,11
EUW1_6880825551',8,43,11,1,0,1,0,5,0,383,92,29713,28865,27478,6,115,14,1,0,1,0,7,365,108,28964,31207,36116,1,18,-16,749,-3,-2342,-8638,0,0,0,0,-2
EUW1_6880196928',6,23,11,0,0,1,0,16,0,288,94,26126,26266,30143,1,22,17,2,0,3,0,5,354,105,31592,30411,38011,0,-66,-11,-5466,-6,-4145,-7868,-2,0,-2,0,11
EUW1_6880145872',6,27,11,1,0,0,0,5,1,338,100,26162,30569,24807,6,30,4,1,0,1,0,6,405,78,24727,30451,25101,1,-67,22,1435,7,118,-294,0,0,-1,0,-1
EUW1_6880094658',2,29,12,1,0,0,0,7,1,353,87,27027,28910,35735,8,33,19,1,0,0,0,3,313,86,29108,28081,35740,0,40,1,-2081,-7,829,-5,0,0,0,0,4
EUW1_6880024856',8,30,19,0,0,0,0,9,0,358,96,31336,32409,39833,4,32,19,2,0,1,0,7,364,92,31530,31880,48307,0,-6,4,-194,0,529,-8474,-2,0,-1,0,2
EUW1_6879983336',3,30,29,1,0,1,0,11,1,353,106,35216,33609,44750,5,26,7,0,0,0,0,1,359,59,24469,25571,29221,1,-6,47,10747,22,8038,15529,1,0,1,0,10
EUW1_6879404794',4,25,9,1,1,0,0,10,0,346,94,25532,28701,26608,5,24,14,1,0,2,0,5,352,107,29667,29530,29895,0,-6,-13,-4135,-5,-829,-3287,0,1,-2,0,5
EUW1_6883661919',4,25,13,2,1,0,0,9,1,360,102,26967,30442,23426,2,28,4,0,0,1,0,3,398,106,25890,30259,30576,0,-38,-4,1077,9,183,-7150,2,1,-1,0,6
EUW1_6883603889',3,25,15,2,0,1,0,7,1,326,96,28522,28481,29937,3,33,6,0,0,0,0,5,365,84,24538,28094,30110,1,-39,12,3984,9,387,-173,2,0,1,0,2
EUW1_6883567241',3,25,16,1,0,0,0,10,0,318,78,28550,27346,36311,2,28,19,1,0,2,0,0,320,78,30697,28330,39882,0,-2,0,-2147,-3,-984,-3571,0,0,-2,0,10
EUW1_6883543963',2,29,21,1,0,4,0,5,1,361,116,34187,32580,43846,1,23,12,0,0,1,0,13,280,70,26976,27454,31770,1,81,46,7211,9,5126,12076,1,0,3,0,-8
EUW1_6883485174',4,50,14,1,0,0,0,11,0,309,68,27458,27545,37364,4,25,14,1,0,0,0,1,330,94,27277,28873,37581,1,-21,-26,181,0,-1328,-217,0,0,0,0,10
EUW1_6881985623',4,24,10,2,0,0,0,12,0,341,84,26053,30248,28590,2,24,19,0,0,2,0,0,385,92,31435,32145,38508,0,-44,-8,-5382,-9,-1897,-9918,2,0,-2,0,12
EUW1_6880909937',4,62,11,1,0,0,0,14,1,287,78,25418,27242,31333,6,71,17,0,1,1,0,3,380,78,30354,29952,36321,0,-93,0,-4936,-6,-2710,-4988,1,-1,-1,0,11
EUW1_6880888145',2,24,17,1,0,0,0,8,1,350,112,30791,31511,32376,9,46,9,0,0,1,0,6,356,80,25315,27377,28264,1,-6,32,5476,8,4134,4112,1,0,-1,0,2
EUW1_6880847323',5,39,14,1,0,1,0,7,0,342,108,30193,29687,29052,3,31,15,1,0,1,0,3,320,86,28655,29818,34477,0,22,22,1538,-1,-131,-5425,0,0,0,0,4
EUW1_6880196822',5,28,18,0,0,0,0,11,0,301,81,28106,29334,35256,6,29,20,2,1,2,0,4,346,97,31911,30999,42190,0,-45,-16,-3805,-2,-1665,-6934,-2,-1,-2,0,7
EUW1_6880138027',5,91,6,1,0,0,0,14,0,376,86,23919,28166,22667,2,92,12,0,0,2,0,2,365,106,28974,31576,29052,0,11,-20,-5055,-6,-3410,-6385,1,0,-2,0,12
EUW1_6880107693',3,28,7,0,0,0,0,9,1,339,90,24299,28016,29160,4,174,15,2,0,0,0,3,361,92,27913,30593,40487,0,-22,-2,-3614,-8,-2577,-11327,-2,0,0,0,6
EUW1_6880051915',2,23,19,1,0,0,0,11,0,345,102,29673,29792,29447,0,27,15,1,0,2,0,6,343,78,29857,29536,36229,0,2,24,-184,4,256,-6782,0,0,-2,0,5
EUW1_6879991155',6,34,15,1,1,1,0,2,0,383,79,29013,30970,39443,5,29,12,1,0,0,0,5,322,76,26742,29265,30571,0,61,3,2271,3,1705,8872,0,1,1,0,-3
EUW1_6879945115',6,31,12,0,0,0,0,6,0,380,84,28882,30809,38716,8,35,11,2,0,1,0,3,360,95,26173,29466,34323,1,20,-11,2709,1,1343,4393,-2,0,-1,0,3
EUW1_6879875999',3,26,18,1,0,0,0,7,0,322,108,29409,30330,43394,3,33,20,1,0,0,0,2,329,104,30999,31387,48740,0,-7,4,-1590,-2,-1057,-5346,0,0,0,0,5
EUW1_6880183373',6,32,18,2,0,1,0,8,1,346,72,29676,29537,38331,7,30,9,0,0,0,0,6,382,92,26597,28845,41067,1,-36,-20,3079,9,692,-2736,2,0,1,0,2
EUW1_6880090103',5,25,9,1,1,0,0,5,0,371,76,25772,29338,29132,2,26,17,1,0,1,0,3,375,115,29741,32783,32818,0,-4,-39,-3969,-8,-3445,-3686,0,1,-1,0,2
EUW1_6880045506',4,26,12,0,0,1,0,6,0,374,86,28000,28911,29053,4,29,11,2,0,0,0,2,381,98,27033,30839,31199,0,-7,-12,967,1,-1928,-2146,-2,0,1,0,4
EUW1_6879894774',3,26,20,2,0,3,0,11,1,313,92,31615,28843,36991,3,27,14,0,1,1,0,7,310,100,28259,26400,31413,1,3,-8,3356,6,2443,5578,2,-1,2,0,4
EUW1_6879858979',4,63,17,1,0,2,0,10,1,421,100,31974,33395,34890,4,22,7,0,0,2,0,7,366,87,25143,28191,24200,1,55,13,6831,10,5204,10690,1,0,0,0,3
EUW1_6879785416',3,33,5,1,0,0,0,9,0,405,97,25315,30518,24683,1,37,11,1,0,0,0,4,395,75,26496,30755,42190,1,10,22,-1181,-6,-237,-17507,0,0,0,0,5
EUW1_6879746465',6,26,12,2,0,1,0,11,0,352,89,26981,28887,30319,2,28,14,0,0,1,0,4,334,54,26513,27076,39663,1,18,35,468,-2,1811,-9344,2,0,0,0,7
EUW1_6879684864',3,46,8,2,0,0,0,8,0,361,98,24838,29028,24659,4,25,13,0,0,0,0,4,353,94,27060,31569,27633,0,8,4,-2222,-5,-2541,-2974,2,0,0,0,4
EUW1_6879618019',2,21,12,2,0,0,0,14,0,372,91,28397,29650,36171,5,38,19,0,1,2,0,4,383,96,33559,31815,39700,1,-11,-5,-5162,-7,-2165,-3529,2,-1,-2,0,10
EUW1_6879586469',5,27,8,2,0,1,0,9,1,356,92,26469,29004,26219,5,34,11,0,0,3,0,3,382,86,27410,31095,27578,0,-26,6,-941,-3,-2091,-1359,2,0,-2,0,6
EUW1_6878944068',4,64,10,0,0,0,0,6,1,348,58,25064,27621,37981,6,38,13,1,0,0,0,4,370,82,26104,28841,35629,1,-22,-24,-1040,-3,-1220,2352,-1,0,0,0,2
EUW1_6878796541',4,31,14,0,0,0,0,17,0,289,69,27095,26414,33437,3,55,27,1,1,2,0,2,367,80,35936,31101,53242,0,-78,-11,-8841,-13,-4687,-19805,-1,-1,-2,0,15
EUW1_6878411272',5,32,21,0,0,2,0,6,0,408,92,33166,31698,44364,3,25,10,1,0,0,0,7,353,81,25858,29174,36568,1,55,11,7308,11,2524,7796,-1,0,2,0,-1
EUW1_6878377864',0,24,5,1,0,0,0,10,0,309,83,23597,27498,27552,1,53,19,1,0,2,0,1,371,96,30465,31036,34705,0,-62,-13,-6868,-14,-3538,-7153,0,0,-2,0,9
EUW1_6878315395',4,43,18,1,0,1,0,9,1,366,87,29964,31517,46348,2,28,11,0,0,0,0,4,360,91,27020,29767,31295,1,6,-4,2944,7,1750,15053,1,0,1,0,5
EUW1_6878099262',1,23,16,1,1,1,0,12,1,383,87,30328,31662,44084,1,36,13,0,0,2,0,9,339,78,27625,28231,31271,1,44,9,2703,3,3431,12813,1,1,-1,0,3
EUW1_6867505871',1,22,13,0,0,1,0,5,1,342,88,28723,29758,30950,5,21,8,2,0,0,0,10,346,70,24520,26930,32256,1,-4,18,4203,5,2828,-1306,-2,0,1,0,-5
EUW1_6829458285',4,29,16,1,0,0,0,8,0,353,88,28690,31065,36672,2,22,14,0,0,2,0,3,323,81,28811,28986,42255,0,30,7,-121,2,2079,-5583,1,0,-2,0,5
EUW1_6829431449',3,24,9,1,0,0,0,7,0,338,101,25601,29277,30807,2,25,17,1,0,1,0,4,349,85,29192,28831,31591,0,-11,16,-3591,-8,446,-784,0,0,-1,0,3
EUW1_6829415120',1,24,11,0,1,0,0,12,0,320,74,25755,28041,37378,3,24,17,2,0,2,0,1,324,101,30962,31327,38299,0,-4,-27,-5207,-6,-3286,-921,-2,1,-2,0,11
EUW1_6828580555',1,24,11,0,0,0,0,9,0,318,94,25816,28169,29845,3,25,14,1,0,0,0,1,325,74,26934,28686,29798,1,-7,20,-1118,-3,-517,47,-1,0,0,0,8
EUW1_6827349221',3,26,15,1,0,1,0,11,1,360,99,31346,32565,31986,2,28,10,0,0,2,0,4,347,68,27872,29236,31772,1,13,31,3474,5,3329,214,1,0,-1,0,7
EUW1_6827270023',5,33,3,0,0,0,0,5,0,403,93,24185,28688,26471,6,26,11,2,0,0,0,5,369,91,27121,31540,30065,0,34,2,-2936,-8,-2852,-3594,-2,0,0,0,0
EUW1_6821013846',4,23,8,0,0,1,0,12,0,385,88,27108,30053,34275,5,29,21,2,0,1,0,5,313,86,29409,30978,37413,0,72,2,-2301,-13,-925,-3138,-2,0,0,0,7
EUW1_6820968045',5,29,16,0,1,1,0,7,1,342,104,30183,29269,40022,2,54,14,0,0,0,0,7,343,56,28231,28313,32596,1,-1,48,1952,2,956,7426,0,1,1,0,0
EUW1_6868576313',3,36,19,0,1,2,0,9,1,405,101,32353,33755,33047,1,66,7,1,0,1,0,9,317,71,23486,24480,22208,1,88,30,8867,12,9275,10839,-1,1,1,0,0
EUW1_6868540550',4,26,18,1,0,4,0,7,1,415,101,33942,32055,40615,5,29,18,1,0,0,0,12,306,105,29638,31103,35259,1,109,-4,4304,0,952,5356,0,0,4,0,-5
EUW1_6865638761',2,369,16,2,1,2,0,6,1,391,92,30830,31859,35668,12,55,4,0,0,0,0,8,338,74,22858,26924,19154,1,53,18,7972,12,4935,16514,2,1,2,0,-2
EUW1_6859070045',3,131,5,0,0,0,0,8,1,357,102,24872,27513,27503,3,36,17,1,0,2,0,6,374,77,29848,30032,34633,0,-17,25,-4976,-12,-2519,-7130,-1,0,-2,0,2
EUW1_6874057986',0,29,5,0,0,0,0,15,1,327,98,23620,26564,33583,6,43,19,1,1,3,0,5,359,98,31644,30655,40461,0,-32,0,-8024,-14,-4091,-6878,-1,-1,-3,0,10
EUW1_6873976654',6,35,20,0,0,0,0,14,1,277,89,30471,27660,47860,6,27,19,1,0,2,0,3,327,93,32013,30521,46329,0,-50,-4,-1542,1,-2861,1531,-1,0,-2,0,11
EUW1_6872836888',6,32,18,0,0,3,0,6,1,427,100,32232,34971,34145,4,30,2,1,0,0,0,4,359,88,21944,26766,26441,1,68,12,10288,16,8205,7704,-1,0,3,0,2
EUW1_6872693860',5,44,15,0,1,0,0,14,0,312,82,27953,27211,40700,5,25,23,2,0,2,0,6,357,94,33816,31778,39294,0,-45,-12,-5863,-8,-4567,1406,-2,1,-2,0,8
EUW1_6871465980',0,27,13,0,0,0,0,14,1,344,56,27564,27781,27963,3,30,20,2,0,2,0,3,361,104,31224,30463,37295,0,-17,-48,-3660,-7,-2682,-9332,-2,0,-2,0,11
EUW1_6871425885',9,37,10,0,0,0,0,5,1,357,119,25967,29783,28808,2,30,9,1,0,1,0,2,366,64,25843,27567,35845,1,-9,55,124,1,2216,-7037,-1,0,-1,0,3
EUW1_6871227446',1,325,13,1,0,1,0,12,1,313,96,27704,28777,38747,1,63,16,1,0,2,0,5,342,104,29485,31537,44522,0,-29,-8,-1781,-3,-2760,-5775,0,0,-1,0,7
EUW1_6871192376',2,33,12,0,0,1,0,9,0,365,111,29064,30946,32586,5,29,17,2,1,1,0,8,367,102,30511,33434,38302,1,-2,9,-1447,-5,-2488,-5716,-2,-1,0,0,1
EUW1_6871160799',9,34,8,0,0,0,0,12,1,326,91,25478,28525,25865,2,23,16,2,0,3,0,3,398,100,31062,32071,33757,0,-72,-9,-5584,-8,-3546,-7892,-2,0,-3,0,9
EUW1_6871130953',2,30,13,0,0,1,0,7,0,379,80,28598,30957,31046,1,27,12,2,0,0,0,3,335,98,26053,27809,30336,1,44,-18,2545,1,3148,710,-2,0,1,0,4
EUW1_6871091124',1,125,8,1,0,0,0,14,1,375,84,26331,28791,34380,2,84,17,0,1,2,0,2,345,98,29508,31405,36052,1,30,-14,-3177,-9,-2614,-1672,1,-1,-2,0,12
EUW1_6871042108',4,77,15,1,0,1,0,15,0,320,96,28842,27866,30648,0,26,9,0,0,2,0,7,331,88,27365,26407,28325,0,-11,8,1477,6,1459,2323,1,0,-1,0,8
EUW1_6866544353',6,29,26,2,0,3,0,4,1,374,82,34750,31754,51838,3,22,8,0,0,0,0,7,308,75,24736,26569,29611,1,66,7,10014,18,5185,22227,2,0,3,0,-3
EUW1_6866502983',3,29,10,1,1,0,0,9,1,432,107,27851,32113,23665,0,21,4,0,0,0,0,1,394,95,24802,29358,17915,1,38,12,3049,6,2755,5750,1,1,0,0,8
EUW1_6864893043',3,30,13,1,0,0,0,8,0,356,78,26971,30016,34185,1,23,12,1,0,1,0,0,355,79,27517,27476,31673,1,1,-1,-546,1,2540,2512,0,0,-1,0,8
EUW1_6864869517',2,21,18,2,0,5,0,8,1,375,94,33875,29374,35548,2,45,6,0,0,0,0,9,261,69,21547,22900,19639,1,114,25,12328,12,6474,15909,2,0,5,0,-1
EUW1_6864712915',5,30,12,1,0,2,0,3,1,443,118,30693,33163,25439,4,25,1,1,0,0,0,4,338,85,20970,26851,16488,1,105,33,9723,11,6312,8951,0,0,2,0,-1
EUW1_6883543747',3,25,14,1,1,2,0,9,0,363,85,30077,31102,33931,1,26,13,1,0,1,0,9,334,110,28121,31122,29074,0,29,-25,1956,1,-20,4857,0,1,1,0,0
EUW1_6882522906',4,30,18,1,1,1,0,10,1,360,100,30506,31943,35554,4,27,8,1,0,0,0,2,346,90,25689,28187,23343,1,14,10,4817,10,3756,12211,0,1,1,0,8
EUW1_6882072971',3,27,8,0,0,1,0,9,0,361,80,25694,28719,23552,2,27,11,2,1,1,0,3,399,118,28202,31014,28202,0,-38,-38,-2508,-3,-2295,-4650,-2,-1,0,0,6
EUW1_6881946180',5,26,14,1,0,2,0,11,1,345,84,29964,29214,36554,3,36,14,1,0,1,0,10,361,80,29915,31437,31853,0,-16,4,49,0,-2223,4701,0,0,1,0,1
EUW1_6881880866',6,27,7,1,0,1,0,14,0,397,93,28342,28721,24516,3,53,18,1,0,2,0,8,349,104,29363,30609,33382,0,48,-11,-1021,-11,-1888,-8866,0,0,-1,0,6
EUW1_6881817189',0,56,25,2,0,1,0,7,1,373,112,33860,32664,48760,0,23,18,0,0,1,0,5,304,62,28700,29688,35972,1,69,50,5160,7,2976,12788,2,0,0,0,2
EUW1_6881626467',3,23,11,1,0,0,0,12,1,368,80,26866,29753,29325,7,49,22,1,1,1,0,3,346,91,31616,32251,37042,0,22,-11,-4750,-11,-2498,-7717,0,-1,-1,0,9
EUW1_6881572873',4,29,17,1,0,1,0,7,1,363,80,30157,30707,39360,2,59,8,1,0,0,0,8,329,95,24382,27026,25750,1,34,-15,5775,9,3681,13610,0,0,1,0,-1
EUW1_6881506744',5,25,13,1,0,0,0,15,0,356,104,28538,29584,36070,4,36,12,1,0,3,0,5,336,92,29626,31004,31087,1,20,12,-1088,1,-1420,4983,0,0,-3,0,10
EUW1_6881436804',1,27,7,0,1,1,0,12,0,356,88,27068,27199,23927,5,26,17,2,0,2,0,5,393,89,30173,30727,32293,0,-37,-1,-3105,-10,-3528,-8366,-2,1,-1,0,7
EUW1_6881372639',3,28,6,0,0,0,0,7,0,383,101,24819,30984,27898,1,28,10,1,0,0,0,3,406,96,27109,30086,32905,1,-23,5,-2290,-4,898,-5007,-1,0,0,0,4
EUW1_6881294947',7,37,21,2,0,1,0,10,1,342,71,31451,29563,39537,1,26,11,0,0,0,0,6,392,78,27065,28245,39761,1,-50,-7,4386,10,1318,-224,2,0,1,0,4
EUW1_6881241765',9,37,14,1,0,0,0,13,0,365,87,29083,28027,33777,6,30,17,1,1,1,0,3,366,85,31676,29926,33928,1,-1,2,-2593,-3,-1899,-151,0,-1,-1,0,10
EUW1_6881161357',1,27,18,1,0,1,0,5,1,417,117,32277,33979,34669,6,37,16,1,0,0,0,3,369,90,29044,31675,35640,1,48,27,3233,2,2304,-971,0,0,1,0,2
EUW1_6879649779',2,43,16,0,0,0,0,12,0,333,67,29204,29616,32782,1,24,25,1,0,2,0,4,328,111,34937,30913,46557,1,5,-44,-5733,-9,-1297,-13775,-1,0,-2,0,8
EUW1_6879614707',5,24,9,0,0,1,0,12,0,392,88,27470,29094,33428,2,24,17,2,0,2,0,3,367,107,30623,32041,35587,0,25,-19,-3153,-8,-2947,-2159,-2,0,-1,0,9
EUW1_6883554403',4,25,16,1,0,0,0,8,0,339,86,28081,30244,35960,4,32,12,0,0,2,0,3,341,76,27801,30284,33315,1,-2,10,280,4,-40,2645,1,0,-2,0,5
EUW1_6879006817',3,28,11,0,0,0,0,3,1,357,84,26518,28334,34267,2,232,12,2,0,0,0,5,353,100,26542,29312,29600,1,4,-16,-24,-1,-978,4667,-2,0,0,0,-2
EUW1_6878949150',4,234,19,1,0,1,0,7,0,394,98,30736,32474,35149,3,32,10,1,0,1,0,5,342,70,25124,27539,25842,1,52,28,5612,9,4935,9307,0,0,0,0,2
EUW1_6878890573',6,51,10,1,0,0,0,8,1,342,90,26392,28119,30467,5,32,9,1,0,0,0,4,311,84,25033,27519,24800,1,31,6,1359,1,600,5667,0,0,0,0,4
EUW1_6878363147',1,30,18,0,0,2,0,8,1,364,84,30695,30639,32930,6,37,16,2,1,0,0,8,355,84,29002,30508,37396,0,9,0,1693,2,131,-4466,-2,-1,2,0,0
EUW1_6878316774',5,27,23,1,0,3,0,5,1,382,98,34391,33436,39186,6,27,11,0,0,0,0,10,327,63,24216,27988,36417,1,55,35,10175,12,5448,2769,1,0,3,0,-5
EUW1_6878274891',5,22,11,0,0,0,0,11,1,352,66,27018,28633,31312,2,25,16,2,1,1,0,3,383,111,30211,32406,31538,0,-31,-45,-3193,-5,-3773,-226,-2,-1,-1,0,8
EUW1_6878230888',4,22,17,1,0,0,0,11,1,333,71,28282,29456,38517,4,23,15,1,0,2,0,2,362,76,30100,30791,44079,0,-29,-5,-1818,2,-1335,-5562,0,0,-2,0,9
EUW1_6878201724',5,25,16,1,0,1,0,3,1,409,86,30292,32935,37960,5,130,8,0,0,0,0,8,355,64,23997,26971,26905,1,54,22,6295,8,5964,11055,1,0,1,0,-5
EUW1_6876912696',7,36,12,1,1,1,0,8,1,338,72,27906,27457,35116,5,90,18,1,0,1,0,8,329,108,30624,31599,41415,0,9,-36,-2718,-6,-4142,-6299,0,1,0,0,0
EUW1_6876870455',9,30,23,2,0,2,0,5,1,389,91,32056,34291,42174,4,26,5,0,0,1,0,11,331,89,23458,25791,28941,1,58,2,8598,18,8500,13233,2,0,1,0,-6
EUW1_6876836469',3,44,12,1,0,1,0,11,1,356,80,28268,28719,36794,2,34,16,1,0,0,0,3,309,74,26624,28450,38876,0,47,6,1644,-4,269,-2082,0,0,1,0,8
EUW1_6876747823',3,31,11,1,0,0,0,7,0,371,84,27024,30778,28265,2,25,5,1,0,0,0,3,385,100,24247,29890,23526,1,-14,-16,2777,6,888,4739,0,0,0,0,4
EUW1_6876708994',4,25,17,1,0,1,0,12,1,354,80,31136,30577,30924,4,155,10,0,0,1,0,5,377,92,27605,28813,27652,1,-23,-12,3531,7,1764,3272,1,0,0,0,7
EUW1_6876681755',5,31,10,0,0,0,0,10,0,356,76,25153,28243,29607,6,24,20,1,0,1,0,1,352,116,32020,32802,37585,0,4,-40,-6867,-10,-4559,-7978,-1,0,-1,0,9
EUW1_6875974604',2,22,7,0,0,0,0,8,1,303,58,23493,25265,32628,4,24,13,1,0,2,0,1,350,74,28031,29011,31282,0,-47,-16,-4538,-6,-3746,1346,-1,0,-2,0,7
EUW1_6869940735',3,57,16,2,0,0,0,13,1,277,80,28462,30078,37203,1,122,13,0,0,1,0,0,374,92,27479,29083,43563,0,-97,-12,983,3,995,-6360,2,0,-1,0,13
EUW1_6869669512',5,28,10,2,0,2,0,9,1,391,76,27841,30123,27494,5,29,9,0,0,0,0,7,350,88,25813,29200,31849,0,41,-12,2028,1,923,-4355,2,0,2,0,2
EUW1_6869564404',4,17,14,2,0,1,0,11,0,347,96,29501,29429,32512,6,31,12,0,0,2,0,6,334,72,25554,26435,30340,1,13,24,3947,2,2994,2172,2,0,-1,0,5
EUW1_6878948077',2,30,18,1,0,1,0,17,1,361,80,32043,31779,40081,4,25,14,1,0,2,0,4,355,107,30536,30828,29533,1,6,-27,1507,4,951,10548,0,0,-1,0,13
EUW1_6870192373',5,34,17,0,0,2,0,5,1,356,92,31575,29257,41675,4,31,11,1,0,0,0,8,323,77,25770,28537,31339,1,33,15,5805,6,720,10336,-1,0,2,0,-3
EUW1_6870119328',3,25,12,0,0,0,0,7,1,365,94,26811,29363,30749,0,28,12,2,0,0,0,2,365,98,26668,29693,30173,0,0,-4,143,0,-330,576,-2,0,0,0,5
EUW1_6870060179',6,33,14,0,0,1,0,8,0,425,100,30114,33300,26018,1,24,6,2,0,1,0,9,382,96,25914,28639,21633,1,43,4,4200,8,4661,4385,-2,0,0,0,-1
EUW1_6869741777',3,27,22,1,0,0,0,7,0,384,84,31374,32723,48396,3,23,16,0,0,1,0,1,386,78,30266,31270,35670,0,-2,6,1108,6,1453,12726,1,0,-1,0,6
EUW1_6869674367',4,23,20,1,1,4,0,8,1,395,81,33556,30758,35510,3,25,10,1,0,0,0,7,341,100,26715,28340,30478,1,54,-19,6841,10,2418,5032,0,1,4,0,1
EUW1_6869626691',6,25,18,0,0,1,0,9,1,329,92,30234,31101,43925,0,17,9,2,0,0,0,7,369,76,25544,28637,36521,0,-40,16,4690,9,2464,7404,-2,0,1,0,2
EUW1_6868537447',2,34,19,0,0,1,0,9,1,373,98,31544,30747,37833,6,31,20,2,0,0,0,4,315,98,29751,29609,38515,0,58,0,1793,-1,1138,-682,-2,0,1,0,5
EUW1_6863847712',2,30,13,1,0,0,0,7,0,327,78,26959,27461,32061,2,21,21,1,0,1,0,1,337,117,32087,31946,37387,0,-10,-39,-5128,-8,-4485,-5326,0,0,-1,0,6
EUW1_6850264131',0,21,6,0,1,0,0,14,1,351,100,24796,26554,25321,8,30,16,2,0,2,0,1,385,95,30193,31667,32495,0,-34,5,-5397,-10,-5113,-7174,-2,1,-2,0,13
EUW1_6849531852',6,23,21,1,0,4,0,4,1,404,105,34511,31549,35294,1,26,9,0,0,0,0,13,305,82,25950,27866,23886,1,99,23,8561,12,3683,11408,1,0,4,0,-9
EUW1_6849494668',3,62,3,0,0,0,0,14,0,340,96,22341,27113,19675,4,67,16,2,0,3,0,2,397,110,32009,31714,30953,0,-57,-14,-9668,-13,-4601,-11278,-2,0,-3,0,12
EUW1_6883269781',1,23,10,0,0,2,0,12,1,376,99,28237,29683,27575,3,31,19,2,0,1,0,4,378,66,30579,31100,34634,0,-2,33,-2342,-9,-1417,-7059,-2,0,1,0,8
EUW1_6883195169',1,62,8,1,1,0,0,5,1,379,147,27424,32168,29319,3,62,9,1,0,1,0,5,385,76,26476,31254,26195,0,-6,71,948,-1,914,3124,0,1,-1,0,0
EUW1_6882790817',5,27,12,0,1,0,0,5,1,372,78,29002,31171,26481,2,30,7,1,0,2,0,7,375,102,25802,29441,28990,0,-3,-24,3200,5,1730,-2509,-1,1,-2,0,-2
EUW1_6882750833',3,26,15,1,0,2,0,13,0,325,88,30253,29548,42478,7,32,19,0,0,2,0,8,381,69,31330,31693,40800,0,-56,19,-1077,-4,-2145,1678,1,0,0,0,5
EUW1_6882716894',4,31,7,0,0,0,0,17,0,344,71,24700,26746,37899,5,29,27,2,0,3,0,2,383,86,35564,34428,48115,0,-39,-15,-10864,-20,-7682,-10216,-2,0,-3,0,15
EUW1_6882623440',7,28,13,0,0,0,0,10,1,345,85,27055,29699,27445,7,56,15,1,0,1,0,1,351,90,29066,28728,32598,0,-6,-5,-2011,-2,971,-5153,-1,0,-1,0,9
EUW1_6882548287',2,58,16,0,1,0,0,6,0,336,96,29592,32095,38698,6,68,15,2,0,1,0,4,393,89,28506,31254,43918,1,-57,7,1086,1,841,-5220,-2,1,-1,0,2
EUW1_6882154331',3,44,9,0,0,0,0,12,0,358,73,25728,29092,24141,4,30,11,1,0,1,0,4,388,103,27756,30722,31513,1,-30,-30,-2028,-2,-1630,-7372,-1,0,-1,0,8
EUW1_6881668685',8,29,18,2,0,0,0,5,1,405,106,30524,31685,33738,3,32,8,0,0,0,0,4,355,64,24548,26894,32734,1,50,42,5976,10,4791,1004,2,0,0,0,1
EUW1_6881424976',2,30,14,1,0,1,0,14,1,372,84,29349,29925,38346,7,29,22,1,0,1,0,5,370,86,32992,33245,41531,1,2,-2,-3643,-8,-3320,-3185,0,0,0,0,9
EUW1_6881057015',4,35,6,1,0,1,0,6,1,396,98,25639,28127,21023,4,31,4,1,0,0,0,3,377,86,23763,28974,21880,0,19,12,1876,2,-847,-857,0,0,1,0,3
EUW1_6881025279',4,33,20,2,0,2,0,8,0,349,108,31951,32555,39223,5,46,10,0,0,0,0,5,359,64,25823,27519,30924,1,-10,44,6128,10,5036,8299,2,0,2,0,3
EUW1_6881005213',8,34,20,1,1,3,0,7,0,391,114,33982,35543,34582,9,29,5,1,0,0,0,11,371,76,23497,27424,27594,1,20,38,10485,15,8119,6988,0,1,3,0,-4
EUW1_6879967331',4,25,8,0,0,1,0,10,1,356,113,26716,28600,28564,5,123,16,2,0,1,0,3,391,69,30026,30757,36488,0,-35,44,-3310,-8,-2157,-7924,-2,0,0,0,7
EUW1_6879822114',2,53,9,0,0,0,0,14,0,306,68,23263,26158,28429,4,26,22,2,0,4,0,0,366,111,34384,32531,43859,0,-60,-43,-11121,-13,-6373,-15430,-2,0,-4,0,14
EUW1_6879595167',5,34,8,0,0,0,0,8,1,378,92,26066,28816,29252,2,22,11,2,0,0,0,5,393,104,27631,31923,33029,0,-15,-12,-1565,-3,-3107,-3777,-2,0,0,0,3
EUW1_6872401938',3,28,20,1,0,0,0,9,1,298,78,30853,27779,39676,3,28,19,0,0,1,0,5,276,66,27652,26596,39094,1,22,12,3201,1,1183,582,1,0,-1,0,4
EUW1_6872381221',3,18,12,2,0,0,0,13,1,304,84,28034,28055,24868,6,33,18,0,0,2,0,2,346,108,29778,30489,34342,1,-42,-24,-1744,-6,-2434,-9474,2,0,-2,0,11
EUW1_6872364156',5,25,12,2,0,0,0,10,1,359,88,26019,28378,31103,4,28,10,0,0,1,0,3,342,104,27548,31054,31986,0,17,-16,-1529,2,-2676,-883,2,0,-1,0,7
EUW1_6867063154',4,25,18,1,0,2,0,14,1,263,68,29836,26893,40365,6,26,12,0,0,2,0,8,332,91,28356,29255,25843,0,-69,-23,1480,6,-2362,14522,1,0,0,0,6
EUW1_6849084056',4,26,14,1,0,1,0,5,1,368,84,28684,29237,28957,9,32,11,0,0,0,0,8,339,72,26453,28523,36427,1,29,12,2231,3,714,-7470,1,0,1,0,-3
EUW1_6849026417',3,26,8,1,0,1,0,12,0,346,82,25979,26562,35719,6,98,16,1,0,2,0,6,331,89,28238,30098,29960,1,15,-7,-2259,-8,-3536,5759,0,0,-1,0,6
EUW1_6848442796',3,24,10,0,0,0,0,15,1,358,91,28348,30315,27877,2,27,15,2,1,5,0,5,365,112,31421,33168,34883,0,-7,-21,-3073,-5,-2853,-7006,-2,-1,-5,0,10
EUW1_6848395580',5,25,11,0,0,0,0,7,0,351,52,24908,27602,28425,2,26,7,2,0,0,0,2,359,108,26102,31021,27069,0,-8,-56,-1194,4,-3419,1356,-2,0,0,0,5
EUW1_6848310223',9,56,14,0,0,0,0,13,0,302,74,27126,28623,38306,4,26,17,1,0,2,0,0,371,70,29954,30724,33093,0,-69,4,-2828,-3,-2101,5213,-1,0,-2,0,13
EUW1_6848136563',4,60,12,1,0,3,0,7,1,406,72,30449,31426,29956,4,60,9,0,0,0,0,9,289,82,24078,25344,24603,0,117,-10,6371,3,6082,5353,1,0,3,0,-2
EUW1_6848056815',8,34,11,1,0,0,0,14,0,291,72,25652,26668,31804,5,31,12,1,0,1,0,4,338,76,28526,30403,36319,0,-47,-4,-2874,-1,-3735,-4515,0,0,-1,0,10
EUW1_6847984020',9,143,10,0,0,0,0,7,0,344,85,26084,27615,30298,4,27,14,1,0,0,0,2,385,82,27526,30767,27941,1,-41,3,-1442,-4,-3152,2357,-1,0,0,0,5
EUW1_6847926145',4,26,14,1,0,0,0,12,1,353,86,27523,29526,36652,5,23,15,1,0,2,0,0,333,90,29201,30839,34046,1,20,-4,-1678,-1,-1313,2606,0,0,-2,0,12
EUW1_6847865707',5,230,18,0,0,1,0,12,0,307,74,27410,29581,36520,7,41,14,1,0,0,0,0,342,94,28840,28893,36379,0,-35,-20,-1430,4,688,141,-1,0,1,0,12
EUW1_6847816916',5,33,9,0,0,0,0,10,0,274,80,23901,25350,29505,6,30,20,2,0,3,0,0,366,95,33421,32472,41166,0,-92,-15,-9520,-11,-7122,-11661,-2,0,-3,0,10
EUW1_6847747317',3,39,11,1,0,1,0,7,1,332,74,27023,29961,30185,4,27,10,0,0,1,0,4,317,71,25740,28701,29081,1,15,3,1283,1,1260,1104,1,0,0,0,3
EUW1_6847677426',6,30,10,1,0,1,0,8,0,360,73,26151,29151,29726,6,32,15,1,0,1,0,5,338,96,29541,30420,30541,1,22,-23,-3390,-5,-1269,-815,0,0,0,0,3
EUW1_6847643847',2,28,18,2,0,2,0,8,1,362,88,31852,31261,34092,2,25,14,0,0,0,0,7,294,82,26500,28976,29438,1,68,6,5352,4,2285,4654,2,0,2,0,1
EUW1_6847607382',3,32,5,0,0,0,0,12,0,260,37,21207,23458,28373,4,21,28,2,1,2,0,1,370,96,33126,32942,46784,0,-110,-59,-11919,-23,-9484,-18411,-2,-1,-2,0,11
EUW1_6813967182',0,18,12,2,1,2,0,5,1,385,127,30671,31446,25370,3,29,14,0,0,0,0,8,354,72,27485,30218,31542,0,31,55,3186,-2,1228,-6172,2,1,2,0,-3
EUW1_6813905096',1,29,11,0,0,1,0,4,0,352,74,26334,27530,36724,5,29,15,2,0,0,0,3,342,86,27458,29498,28601,0,10,-12,-1124,-4,-1968,8123,-2,0,1,0,1
EUW1_6813845795',0,28,14,0,1,1,0,7,0,372,93,30490,30269,42514,5,34,14,2,0,0,0,5,261,90,26056,26594,34880,1,111,3,4434,0,3675,7634,-2,1,1,0,2
EUW1_6811500352',3,28,16,0,0,0,0,17,0,343,91,29599,30747,28526,1,29,23,1,0,3,0,5,381,85,34447,34123,46973,1,-38,6,-4848,-7,-3376,-18447,-1,0,-3,0,12
EUW1_6811229407',4,28,21,2,1,3,0,8,1,367,125,33600,33729,45963,2,18,3,0,0,1,0,9,318,98,22820,26401,31193,1,49,27,10780,18,7328,14770,2,1,2,0,-1
EUW1_6811163979',4,42,11,0,0,0,0,11,0,352,80,26102,28158,32203,5,30,16,1,0,1,0,2,365,82,31202,30300,31960,1,-13,-2,-5100,-5,-2142,243,-1,0,-1,0,9
EUW1_6811086166',7,30,18,1,0,0,0,11,0,325,78,30178,29714,45158,0,24,23,1,0,2,0,6,367,89,33766,31241,45806,1,-42,-11,-3588,-5,-1527,-648,0,0,-2,0,5
EUW1_6810562628',3,25,14,2,0,0,0,15,1,307,114,27076,27559,27264,4,25,6,0,0,5,0,4,383,88,28791,28950,21088,0,-76,26,-1715,8,-1391,6176,2,0,-5,0,11
EUW1_6810510684',6,91,21,1,0,1,0,15,0,313,118,32304,30148,38431,2,22,16,1,0,2,0,6,341,98,32293,29704,40230,0,-28,20,11,5,444,-1799,0,0,-1,0,9
EUW1_6810368522',3,27,8,1,0,0,0,9,1,352,94,24891,27361,31634,4,26,12,1,0,2,0,3,371,89,28788,30669,34149,0,-19,5,-3897,-4,-3308,-2515,0,0,-2,0,6
EUW1_6810312429',2,27,17,2,0,0,0,7,1,355,72,30627,29682,39222,3,24,19,0,0,1,0,1,353,100,31458,30662,34017,0,2,-28,-831,-2,-980,5205,2,0,-1,0,6
EUW1_6810258210',1,53,10,0,0,0,0,17,1,265,56,24301,25372,26266,3,72,28,2,0,3,0,0,348,94,35898,32239,55293,0,-83,-38,-11597,-18,-6867,-29027,-2,0,-3,0,17
EUW1_6809954913',2,60,10,0,0,0,0,10,0,303,78,24941,25989,31305,4,60,14,1,0,2,0,2,360,90,29799,30428,35480,0,-57,-12,-4858,-4,-4439,-4175,-1,0,-2,0,8
EUW1_6809905152',4,202,17,1,0,0,0,12,0,350,90,30108,29925,37185,5,30,8,1,1,1,0,5,331,82,24274,26517,37314,1,19,8,5834,9,3408,-129,0,-1,-1,0,7
EUW1_6703437125',4,38,16,0,0,1,0,15,1,328,86,30072,29907,32408,2,44,14,1,1,3,0,5,331,88,29148,28304,31635,0,-3,-2,924,2,1603,773,-1,-1,-2,0,10
EUW1_6703413942',3,25,11,0,1,0,0,7,0,404,96,27131,31179,25515,4,39,12,1,0,1,0,2,374,91,28080,30549,25030,0,30,5,-949,-1,630,485,-1,1,-1,0,5
EUW1_6703356117',5,31,14,2,1,1,0,5,1,375,103,29886,31562,30080,4,28,1,0,0,1,0,6,331,96,20499,26808,18971,1,44,7,9387,13,4754,11109,2,1,0,0,-1
EUW1_6703308761',2,37,8,0,0,0,0,2,1,382,102,26448,30237,22228,2,36,6,1,1,1,0,4,378,87,24199,29347,19138,1,4,15,2249,2,890,3090,-1,-1,-1,0,-2
EUW1_6692304033',5,28,9,1,1,0,0,12,0,337,101,25963,29044,23734,1,23,13,0,0,4,0,4,392,88,31918,30820,33669,0,-55,13,-5955,-4,-1776,-9935,1,1,-4,0,8
EUW1_6692212734',11,32,19,1,0,1,0,9,1,358,98,30131,29213,30723,6,27,18,1,1,1,0,6,314,82,30038,28906,31501,0,44,16,93,1,307,-778,0,-1,0,0,3
EUW1_6810367620',5,33,9,1,0,0,0,9,0,329,83,25729,27833,20679,0,48,13,0,0,2,0,3,365,97,29819,29916,33228,0,-36,-14,-4090,-4,-2083,-12549,1,0,-2,0,6
EUW1_6810316795',2,24,17,0,0,1,0,12,1,382,74,31085,30087,37832,1,27,14,1,1,0,0,6,365,96,28805,30107,35931,1,17,-22,2280,3,-20,1901,-1,-1,1,0,6
EUW1_6810358244',3,32,4,1,0,0,0,12,1,367,82,23466,28404,24494,2,28,10,0,0,2,0,1,385,90,27741,29463,29904,0,-18,-8,-4275,-6,-1059,-5410,1,0,-2,0,11
EUW1_6881223296',4,28,13,0,0,1,0,9,1,344,74,29032,29868,35765,8,32,19,2,0,1,0,4,375,106,30986,32723,37647,0,-31,-32,-1954,-6,-2855,-1882,-2,0,0,0,5
EUW1_6881173483',5,44,8,1,0,0,0,9,0,365,95,25348,28761,27133,4,81,8,0,0,1,0,1,404,80,26492,29911,25218,1,-39,15,-1144,0,-1150,1915,1,0,-1,0,8
EUW1_6878995561',4,34,13,0,0,0,0,8,1,317,67,26969,26823,34537,7,31,23,2,0,2,0,1,369,78,32259,31420,42208,0,-52,-11,-5290,-10,-4597,-7671,-2,0,-2,0,7
EUW1_6878659721',4,30,16,0,0,0,0,5,0,364,94,28344,30564,37593,2,27,16,2,0,0,0,3,343,84,27906,30095,33360,0,21,10,438,0,469,4233,-2,0,0,0,2
EUW1_6878611176',2,27,11,1,0,1,0,9,1,438,83,29653,30909,29301,4,28,6,0,0,1,0,8,361,115,25276,28544,19838,1,77,-32,4377,5,2365,9463,1,0,0,0,1
EUW1_6878562354',4,30,9,0,0,0,0,13,0,334,89,26667,28445,26065,3,32,15,2,0,1,0,2,361,80,28831,28581,34037,0,-27,9,-2164,-6,-136,-7972,-2,0,-1,0,11
EUW1_6878490716',4,26,10,2,0,0,0,13,0,313,88,25796,27337,25660,4,23,18,0,0,2,0,0,380,102,31231,32272,33671,0,-67,-14,-5435,-8,-4935,-8011,2,0,-2,0,13
EUW1_6878431615',8,81,13,1,0,1,0,1,0,379,92,29265,31650,34379,3,25,9,1,0,0,0,7,362,84,24260,28747,27146,1,17,8,5005,4,2903,7233,0,0,1,0,-6
EUW1_6878386757',2,44,15,0,0,0,0,10,0,365,85,28360,29840,35098,3,28,13,2,0,0,0,0,327,68,26833,28561,27332,1,38,17,1527,2,1279,7766,-2,0,0,0,10
EUW1_6878327368',4,29,18,1,0,1,0,5,0,335,92,29705,28635,42891,7,28,15,1,0,0,0,3,324,95,27569,27694,33946,1,11,-3,2136,3,941,8945,0,0,1,0,2
EUW1_6878274032',4,50,12,0,0,0,0,8,1,368,59,26915,27829,31358,1,17,11,2,0,2,0,4,352,106,27901,30438,32178,1,16,-47,-986,1,-2609,-820,-2,0,-2,0,4
EUW1_6878141885',1,90,17,0,0,0,0,14,0,321,66,28722,27060,35214,3,22,17,2,0,1,0,1,376,60,31485,28632,39662,0,-55,6,-2763,0,-1572,-4448,-2,0,-1,0,13
EUW1_6878110734',1,27,9,2,0,0,0,9,1,400,86,27369,30764,28223,2,166,9,0,1,3,0,3,401,106,28347,31914,26425,0,-1,-20,-978,0,-1150,1798,2,-1,-3,0,6
EUW1_6877627639',4,30,11,0,1,0,0,7,0,359,105,27411,30825,32603,4,80,14,2,0,0,0,3,328,78,25714,28050,30935,0,31,27,1697,-3,2775,1668,-2,1,0,0,4
EUW1_6877562666',5,29,11,0,0,0,0,8,1,329,78,24870,26314,31542,1,40,23,1,0,1,0,1,333,84,31710,31441,41591,0,-4,-6,-6840,-12,-5127,-10049,-1,0,-1,0,7
EUW1_6810198701',5,28,10,1,0,1,0,7,1,377,88,28202,29772,22139,1,31,6,0,0,0,0,7,405,84,24846,28413,18919,1,-28,4,3356,4,1359,3220,1,0,1,0,0
EUW1_6799598931',2,31,6,0,0,0,0,9,0,318,100,24157,28003,25481,1,22,14,1,0,1,0,3,390,87,29219,31159,28500,0,-72,13,-5062,-8,-3156,-3019,-1,0,-1,0,6
EUW1_6799569636',3,32,8,2,0,0,0,6,1,393,104,26036,30276,25561,3,31,4,0,0,0,0,3,379,88,24231,28752,26548,1,14,16,1805,4,1524,-987,2,0,0,0,3
EUW1_6799448607',1,104,4,0,1,0,0,9,0,349,106,23202,29008,23790,0,24,11,2,0,1,0,1,377,86,27526,31249,30403,0,-28,20,-4324,-7,-2241,-6613,-2,1,-1,0,8
EUW1_6799406080',1,17,14,2,0,0,0,2,1,357,89,27361,29149,36667,3,27,10,0,0,0,0,4,325,86,24831,29065,32422,1,32,3,2530,4,84,4245,2,0,0,0,-2
EUW1_6797989080',2,25,5,0,0,0,0,6,0,363,91,25344,27558,23833,4,24,10,1,0,1,0,5,355,82,26291,28764,25095,0,8,9,-947,-5,-1206,-1262,-1,0,-1,0,1
EUW1_6797943641',3,23,6,0,0,0,0,8,0,354,94,24004,29419,21011,2,25,10,1,0,0,0,1,370,81,26294,29196,31821,0,-16,13,-2290,-4,223,-10810,-1,0,0,0,7
EUW1_6797819555',5,278,6,2,0,0,0,8,0,356,76,24428,28520,27371,4,24,15,0,0,1,0,3,352,92,29395,30704,29419,0,4,-16,-4967,-9,-2184,-2048,2,0,-1,0,5
EUW1_6797789947',0,21,12,1,0,0,0,10,1,379,84,28321,29728,40774,5,27,11,1,1,2,0,2,344,100,27186,30358,32702,1,35,-16,1135,1,-630,8072,0,-1,-2,0,8
EUW1_6796658405',2,20,14,0,0,0,0,9,0,347,76,27253,30173,37230,2,21,16,1,0,1,0,5,385,84,29332,31578,41841,0,-38,-8,-2079,-2,-1405,-4611,-1,0,-1,0,4
EUW1_6796611196',4,35,17,1,0,0,0,6,0,371,89,29821,28846,35466,6,28,9,1,0,2,0,5,354,74,26231,27358,27673,1,17,15,3590,8,1488,7793,0,0,-2,0,1
EUW1_6789417077',1,38,18,1,0,3,0,9,1,350,56,30617,28404,32884,3,101,8,1,0,0,0,4,275,104,23425,25725,25304,1,75,-48,7192,10,2679,7580,0,0,3,0,5
EUW1_6789337334',6,28,13,1,1,0,0,7,0,344,110,27151,31171,33281,0,81,7,0,0,0,0,1,328,65,23977,27695,35050,1,16,45,3174,6,3476,-1769,1,1,0,0,6
EUW1_6789263191',2,28,12,1,0,0,0,8,1,373,86,28344,28761,27628,5,98,11,1,0,0,0,1,355,82,25711,28480,29209,0,18,4,2633,1,281,-1581,0,0,0,0,7
EUW1_6784639485',1,26,18,2,0,1,0,6,0,347,93,28789,30276,34078,6,34,10,0,0,0,0,4,308,77,25058,27074,26248,1,39,16,3731,8,3202,7830,2,0,1,0,2
EUW1_6784586310',5,47,10,0,0,0,0,13,1,292,80,24618,26674,25210,1,36,21,1,0,1,0,0,366,80,31510,33208,42226,0,-74,0,-6892,-11,-6534,-17016,-1,0,-1,0,13
EUW1_6778974577',5,22,11,0,0,2,0,11,1,356,92,28643,29151,33743,5,27,13,2,0,1,0,6,351,90,28320,32037,37462,0,5,2,323,-2,-2886,-3719,-2,0,1,0,5
EUW1_6850941151',2,28,13,1,0,0,0,16,0,273,72,25773,27123,34736,4,31,17,1,0,2,0,0,410,98,33434,31280,37364,1,-137,-26,-7661,-4,-4157,-2628,0,0,-2,0,16
EUW1_6809129630',5,22,24,2,0,2,0,10,1,364,90,34630,31814,44688,1,18,8,0,0,1,0,6,318,84,24366,26245,30115,1,46,6,10264,16,5569,14573,2,0,1,0,4
EUW1_6809042384',2,21,15,0,0,0,0,2,1,362,92,27926,29101,30696,2,23,12,1,0,0,0,1,353,96,26084,28382,27351,1,9,-4,1842,3,719,3345,-1,0,0,0,1
EUW1_6808991943',3,30,9,1,0,0,0,7,0,395,84,26262,30285,29914,2,27,9,1,0,0,0,1,369,96,26232,30161,24052,0,26,-12,30,0,124,5862,0,0,0,0,6
EUW1_6808936871',1,52,8,0,0,0,0,13,0,389,85,26517,29542,29355,3,46,17,2,0,0,0,1,365,106,30142,30869,33797,0,24,-21,-3625,-9,-1327,-4442,-2,0,0,0,12
EUW1_6808860703',3,94,9,0,0,0,0,10,0,348,76,24330,27680,21469,0,33,14,2,0,2,0,3,410,135,32477,31929,34516,1,-62,-59,-8147,-5,-4249,-13047,-2,0,-2,0,7
EUW1_6807761089',3,24,18,2,1,2,0,10,0,404,92,31944,32715,38818,1,22,9,0,0,0,0,7,306,91,26024,28398,32006,1,98,1,5920,9,4317,6812,2,1,2,0,3
EUW1_6807690539',2,25,10,2,0,0,0,9,0,351,93,25922,29476,29808,0,92,12,0,0,0,0,0,327,102,26555,29221,30799,1,24,-9,-633,-2,255,-991,2,0,0,0,9
EUW1_6805571337',5,23,16,1,0,0,0,8,0,340,90,29299,29833,32947,2,143,10,0,0,1,0,5,346,96,26635,28387,31446,0,-6,-6,2664,6,1446,1501,1,0,-1,0,3
EUW1_6805527702',5,81,14,1,0,0,0,12,1,318,100,27748,28685,33342,1,24,14,1,0,1,0,2,348,92,28553,31027,33499,0,-30,8,-805,0,-2342,-157,0,0,-1,0,10
EUW1_6805492728',3,23,14,1,0,1,0,10,0,366,105,29213,32415,37934,1,29,18,1,0,1,0,5,351,85,29425,30655,39895,1,15,20,-212,-4,1760,-1961,0,0,0,0,5
EUW1_6805438787',3,204,17,1,0,1,0,11,0,347,106,30313,31228,37841,3,31,15,0,0,1,0,6,346,54,29223,29909,37777,1,1,52,1090,2,1319,64,1,0,0,0,5
EUW1_6803857211',1,224,17,0,0,0,0,7,1,348,83,30492,29290,45229,2,28,15,2,0,3,0,6,329,79,28929,28039,35469,0,19,4,1563,2,1251,9760,-2,0,-3,0,1
EUW1_6803835979',5,33,13,2,0,1,0,6,0,369,80,28923,29707,37081,3,144,18,0,0,1,0,4,361,78,31518,30031,40206,1,8,2,-2595,-5,-324,-3125,2,0,0,0,2
EUW1_6803814557',0,127,3,0,0,0,0,11,0,316,60,21420,25877,22872,5,33,13,2,1,5,1,2,406,119,32172,31937,28922,0,-90,-59,-10752,-10,-6060,-6050,-2,-1,-5,-1,9
EUW1_6803789103',0,61,25,1,0,8,2,5,1,422,75,35665,31501,43247,3,16,3,1,0,1,0,10,283,64,19539,22249,25205,1,139,11,16126,22,9252,18042,0,0,7,2,-5
EUW1_6802684753',7,43,7,0,1,0,0,7,0,304,88,23085,27868,24920,0,24,14,2,0,1,0,2,323,82,26426,30531,37841,0,-19,6,-3341,-7,-2663,-12921,-2,1,-1,0,5
EUW1_6802640163',1,28,2,1,0,0,0,7,0,342,90,22305,27441,18615,4,27,12,1,0,0,0,2,412,116,27635,33332,26390,0,-70,-26,-5330,-10,-5891,-7775,0,0,0,0,5
EUW1_6880346487',3,20,12,1,0,0,0,7,1,357,107,27709,28404,24471,4,26,8,1,0,0,0,2,370,99,25641,29706,28253,1,-13,8,2068,4,-1302,-3782,0,0,0,0,5
EUW1_6880271960',5,30,13,0,0,0,0,6,1,342,88,28664,30119,39231,3,27,15,2,0,1,0,4,388,84,28121,31339,31770,0,-46,4,543,-2,-1220,7461,-2,0,-1,0,2
EUW1_6880216988',7,63,13,1,0,1,0,6,1,373,72,28104,30097,33781,3,75,10,1,0,0,0,6,326,90,25453,27713,27810,1,47,-18,2651,3,2384,5971,0,0,1,0,0
EUW1_6876405787',5,139,9,2,0,0,0,10,0,334,82,24908,29172,25559,3,67,8,0,0,0,0,1,380,102,26461,29819,28090,0,-46,-20,-1553,1,-647,-2531,2,0,0,0,9
EUW1_6876387945',3,20,23,1,0,1,0,9,0,335,76,32002,31177,37856,1,21,14,1,0,2,0,3,308,93,27444,26614,35865,0,27,-17,4558,9,4563,1991,0,0,-1,0,6
EUW1_6867337837',1,22,9,0,0,0,0,10,0,386,101,26788,30824,26430,2,31,10,2,0,2,0,2,353,82,27373,29767,29110,1,33,19,-585,-1,1057,-2680,-2,0,-2,0,8
EUW1_6869383129',2,26,10,0,0,1,0,11,0,365,89,27080,31040,23897,6,34,11,1,0,0,0,3,377,86,26440,31144,32226,1,-12,3,640,-1,-104,-8329,-1,0,1,0,8
EUW1_6869362069',4,24,7,1,0,0,0,12,0,373,98,24682,28919,27338,5,34,13,0,1,2,0,2,391,98,29734,30597,26571,0,-18,0,-5052,-6,-1678,767,1,-1,-2,0,10
EUW1_6869321215',6,33,22,1,1,2,0,9,1,334,129,34687,32354,36279,5,23,11,0,0,2,0,7,367,46,27831,28124,33425,1,-33,83,6856,11,4230,2854,1,1,0,0,2
EUW1_6867658975',4,30,31,0,0,2,0,5,1,414,74,36061,33596,49868,2,34,13,0,0,1,0,7,283,68,26883,26293,36544,1,131,6,9178,18,7303,13324,0,0,1,0,-2
EUW1_6880696631',3,217,25,0,0,2,0,4,0,312,119,32215,31269,41796,5,52,15,1,0,0,0,5,289,84,26427,25298,35020,1,23,35,5788,10,5971,6776,-1,0,2,0,-1
EUW1_6880655907',5,24,18,0,0,1,0,10,1,392,66,30687,32137,35623,4,19,8,1,0,0,0,4,362,86,25311,28358,26964,1,30,-20,5376,10,3779,8659,-1,0,1,0,6
EUW1_6880621869',7,24,10,0,0,1,0,13,0,330,82,26748,26678,27619,2,32,22,2,0,2,0,5,398,97,32796,31937,39584,0,-68,-15,-6048,-12,-5259,-11965,-2,0,-1,0,8
EUW1_6879925799',4,38,13,0,0,0,0,11,1,258,78,26696,24356,30247,5,43,21,2,0,2,0,1,402,77,31084,31297,45429,0,-144,1,-4388,-8,-6941,-15182,-2,0,-2,0,10
EUW1_6870020503',2,24,14,1,0,0,0,8,0,323,99,28660,27188,34938,5,30,11,1,0,2,0,2,367,68,27827,27788,33665,1,-44,31,833,3,-600,1273,0,0,-2,0,6
EUW1_6869971931',4,29,9,1,0,0,0,12,1,351,70,25366,29334,21072,4,33,18,1,0,0,0,3,405,126,33308,34898,44292,0,-54,-56,-7942,-9,-5564,-23220,0,0,0,0,9
EUW1_6869892262',3,27,11,1,0,0,0,10,1,330,88,26937,28671,31565,2,31,13,0,0,2,0,2,381,88,29296,31025,37482,0,-51,0,-2359,-2,-2354,-5917,1,0,-2,0,8
EUW1_6868840168',8,33,13,2,1,1,0,7,0,386,90,29767,32449,28022,4,25,11,0,0,1,0,5,405,94,28835,31464,29311,1,-19,-4,932,2,985,-1289,2,1,0,0,2
EUW1_6847681673',6,29,7,1,0,0,0,8,1,387,90,25292,27992,28876,3,25,14,1,0,1,0,3,355,90,28632,30256,31138,1,32,0,-3340,-7,-2264,-2262,0,0,-1,0,5
EUW1_6847626716',1,31,17,2,0,0,0,8,0,342,82,28479,30303,37453,4,31,13,0,0,0,0,3,333,67,26774,26968,36554,0,9,15,1705,4,3335,899,2,0,0,0,5
EUW1_6847557284',4,47,9,0,0,0,0,9,0,340,73,24754,27675,24698,6,39,10,1,0,1,0,1,398,79,26971,29957,32018,1,-58,-6,-2217,-1,-2282,-7320,-1,0,-1,0,8
EUW1_6847072610',5,36,12,1,0,0,0,9,0,378,113,29085,32029,30606,5,32,9,0,0,0,0,6,364,91,25791,29228,26632,1,14,22,3294,3,2801,3974,1,0,0,0,3
EUW1_6846376372',4,26,15,0,0,1,0,9,0,402,90,31705,30938,32692,4,27,21,2,0,1,0,7,350,98,31046,33113,41456,0,52,-8,659,-6,-2175,-8764,-2,0,0,0,2
EUW1_6846352888',5,27,12,1,0,0,0,9,0,304,82,25929,26681,36049,7,31,18,1,0,2,0,0,373,90,30842,30969,43894,0,-69,-8,-4913,-6,-4288,-7845,0,0,-2,0,9
EUW1_6846317622',7,62,15,0,0,0,0,10,0,374,77,28319,28859,28395,5,26,14,2,0,0,0,1,392,74,29274,31059,38687,1,-18,3,-955,1,-2200,-10292,-2,0,0,0,9
EUW1_6882241780',6,37,11,0,0,0,0,9,0,292,65,24654,25670,27443,6,86,18,2,0,1,0,1,359,86,30279,30478,36456,0,-67,-21,-5625,-7,-4808,-9013,-2,0,-1,0,8
EUW1_6882213028',1,20,10,1,0,0,0,14,0,238,50,23104,22762,26326,2,53,25,1,0,4,0,3,350,73,35440,28851,47234,0,-112,-23,-12336,-15,-6089,-20908,0,0,-4,0,11
EUW1_6882190662',6,26,10,0,1,1,0,6,1,390,92,28413,31548,32243,3,28,11,1,0,1,0,8,349,88,27649,30037,30276,1,41,4,764,-1,1511,1967,-1,1,0,0,-2
EUW1_6882109633',2,28,11,0,0,0,0,9,0,311,80,24482,27347,32976,8,70,13,2,0,2,0,4,340,99,27993,29158,33853,0,-29,-19,-3511,-2,-1811,-877,-2,0,-2,0,5
EUW1_6882048674',4,35,11,0,0,0,0,10,1,341,97,26529,29521,33162,4,30,17,2,0,2,0,1,394,86,29534,31649,37930,1,-53,11,-3005,-6,-2128,-4768,-2,0,-2,0,9
EUW1_6881982171',6,26,18,2,0,0,0,10,0,364,106,30665,30879,34280,3,24,11,0,0,2,0,3,360,108,28067,29305,27636,1,4,-2,2598,7,1574,6644,2,0,-2,0,7
EUW1_6881561277',6,27,12,0,0,1,0,8,0,338,107,26462,29615,32361,4,27,12,1,1,0,0,2,369,92,27621,29325,31394,0,-31,15,-1159,0,290,967,-1,-1,1,0,6
EUW1_6880454854',2,26,17,1,0,2,0,9,1,378,96,29672,32452,37315,3,23,11,1,0,0,0,8,365,96,26395,31742,34893,1,13,0,3277,6,710,2422,0,0,2,0,1
EUW1_6880323198',3,29,4,1,0,0,0,15,0,334,85,24569,26710,21579,3,90,23,1,0,3,0,1,401,110,33322,33339,38280,0,-67,-25,-8753,-19,-6629,-16701,0,0,-3,0,14
EUW1_6879763491',6,25,13,0,0,0,0,10,1,345,75,27672,30515,41503,2,29,10,2,0,2,0,3,398,88,27788,30862,31664,0,-53,-13,-116,3,-347,9839,-2,0,-2,0,7
EUW1_6879720466',2,25,13,0,0,2,0,6,0,365,83,30007,30456,32671,4,26,12,1,0,0,0,10,327,76,25291,29043,28930,1,38,7,4716,1,1413,3741,-1,0,2,0,-4
EUW1_6874840306',3,24,10,1,0,1,0,6,0,356,89,26947,28831,28177,3,25,13,1,0,0,0,5,303,78,25363,27523,32155,1,53,11,1584,-3,1308,-3978,0,0,1,0,1
EUW1_6874793359',5,25,12,2,0,0,0,10,1,319,99,26653,27743,29363,2,30,15,0,0,1,0,4,341,68,27570,29799,36513,0,-22,31,-917,-3,-2056,-7150,2,0,-1,0,6
EUW1_6874570371',2,26,15,2,0,1,0,9,1,360,106,30092,30868,31636,3,29,10,0,0,1,0,3,319,66,24452,28500,27425,1,41,40,5640,5,2368,4211,2,0,0,0,6
EUW1_6874325894',3,25,11,1,0,0,0,9,1,371,90,27510,30048,33159,0,32,10,1,0,2,0,5,378,94,27414,31218,32775,0,-7,-4,96,1,-1170,384,0,0,-2,0,4
EUW1_6874263181',4,42,8,0,0,0,0,11,0,321,69,24441,26971,33296,2,161,16,2,1,1,0,1,345,106,28724,31367,37983,0,-24,-37,-4283,-8,-4396,-4687,-2,-1,-1,0,10
EUW1_6873714435',5,25,8,1,0,1,0,17,0,311,72,24634,25995,37217,6,29,20,1,0,3,0,5,334,95,32321,31125,39583,0,-23,-23,-7687,-12,-5130,-2366,0,0,-2,0,12
EUW1_6873717630',3,21,14,2,1,3,0,7,0,374,94,29393,31265,35232,4,17,9,0,0,0,0,6,349,93,25845,28291,24672,1,25,1,3548,5,2974,10560,2,1,3,0,1
EUW1_6881733194',2,29,6,0,0,0,0,12,0,374,84,24822,28705,22795,3,40,17,2,1,2,0,0,386,108,32200,33469,32895,0,-12,-24,-7378,-11,-4764,-10100,-2,-1,-2,0,12
EUW1_6881679816',9,36,16,1,0,0,0,8,0,363,78,28990,27792,39199,4,59,17,0,0,2,0,3,380,77,31835,28470,37892,0,-17,1,-2845,-1,-678,1307,1,0,-2,0,5
EUW1_6881626533',6,24,14,1,0,0,0,13,0,344,73,27112,28386,34444,2,28,20,1,0,2,0,1,379,88,32445,32089,37037,0,-35,-15,-5333,-6,-3703,-2593,0,0,-2,0,12
EUW1_6881558046',2,27,16,1,0,1,0,9,0,346,82,30631,29305,34112,1,29,18,0,0,2,0,3,330,93,30677,29955,33875,1,16,-11,-46,-2,-650,237,1,0,-1,0,6
EUW1_6881458335',2,22,8,0,0,1,0,13,0,381,77,25854,30031,30080,4,28,10,1,0,1,0,1,371,98,28111,30510,32284,1,10,-21,-2257,-2,-479,-2204,-1,0,0,0,12
EUW1_6876186597',4,52,12,0,0,0,0,11,0,302,90,27017,27641,28063,2,24,19,1,0,1,0,2,379,106,31044,33950,35288,0,-77,-16,-4027,-7,-6309,-7225,-1,0,-1,0,9
EUW1_6876142638',3,20,22,2,0,4,0,8,0,392,96,36029,33859,43319,3,58,9,0,0,1,0,10,339,90,24306,26743,23439,1,53,6,11723,13,7116,19880,2,0,3,0,-2
EUW1_6876062511',3,30,6,2,1,0,0,7,1,356,98,24210,28517,20084,2,32,11,0,0,1,0,0,388,109,27397,32483,27154,0,-32,-11,-3187,-5,-3966,-7070,2,1,-1,0,7
EUW1_6875868375',3,26,11,0,0,0,0,8,1,355,67,26693,30301,29615,3,50,13,2,0,0,0,2,344,122,27032,30645,24885,0,11,-55,-339,-2,-344,4730,-2,0,0,0,6
EUW1_6875816700',5,29,8,2,0,0,0,11,0,321,106,24115,28231,26806,5,102,17,0,0,2,0,0,390,90,31230,31736,32090,0,-69,16,-7115,-9,-3505,-5284,2,0,-2,0,11
EUW1_6875645550',3,27,8,0,0,0,0,5,0,365,99,25277,28388,25186,3,30,6,1,0,0,0,3,377,99,23986,28587,18705,0,-12,0,1291,2,-199,6481,-1,0,0,0,2
EUW1_6875563302',7,27,5,2,1,0,0,8,0,368,90,24240,29259,25444,3,23,3,0,0,0,0,3,322,102,22697,27882,25617,1,46,-12,1543,2,1377,-173,2,1,0,0,5
EUW1_6875403966',7,33,16,0,0,0,0,12,1,366,66,29225,30105,31079,4,80,15,1,0,3,0,4,414,98,31813,31278,34558,1,-48,-32,-2588,1,-1173,-3479,-1,0,-3,0,8
EUW1_6875366750',4,39,13,0,0,2,0,3,1,398,108,28987,30947,36195,1,19,9,2,0,0,0,6,356,82,26139,29659,28663,1,42,26,2848,4,1288,7532,-2,0,2,0,-3
EUW1_6874748513',6,25,3,0,0,0,0,7,0,404,90,24705,29553,22023,3,28,9,2,0,1,0,1,409,70,27124,30679,28805,0,-5,20,-2419,-6,-1126,-6782,-2,0,-1,0,6
EUW1_6874682285',3,24,7,2,0,0,0,7,1,322,102,25319,27114,37011,4,50,17,0,0,1,0,2,350,98,28999,31358,37785,1,-28,4,-3680,-10,-4244,-774,2,0,-1,0,5
EUW1_6882852845',3,27,14,1,0,1,0,2,1,378,88,28316,29722,28010,3,29,12,1,0,0,0,2,351,93,26217,28876,28579,1,27,-5,2099,2,846,-569,0,0,1,0,0
EUW1_6882779334',5,28,12,2,0,0,0,9,1,315,61,26043,26154,31397,5,28,16,0,0,1,0,4,332,89,28674,27441,36571,1,-17,-28,-2631,-4,-1287,-5174,2,0,-1,0,5
EUW1_6882744538',3,25,12,2,0,0,0,6,1,417,84,27848,32285,33950,4,33,6,0,0,1,0,4,366,105,25565,29745,28008,1,51,-21,2283,6,2540,5942,2,0,-1,0,2
EUW1_6878283036',2,24,9,0,0,0,0,9,1,417,82,25904,31163,32724,2,26,12,2,0,0,0,8,381,105,27751,31435,25601,0,36,-23,-1847,-3,-272,7123,-2,0,0,0,1
EUW1_6878236267',5,28,12,1,0,2,0,10,0,359,95,29538,29922,30406,1,20,15,1,0,1,0,8,322,76,28067,28876,36411,1,37,19,1471,-3,1046,-6005,0,0,1,0,2
EUW1_6877817479',5,24,16,1,1,1,0,8,0,337,91,30836,30774,33045,5,31,14,1,0,1,0,4,352,96,29324,29298,42438,0,-15,-5,1512,2,1476,-9393,0,1,0,0,4
EUW1_6876306449',2,32,6,2,0,1,0,10,1,350,80,25495,26065,37406,6,31,17,0,0,2,0,3,347,70,28260,28441,32637,0,3,10,-2765,-11,-2376,4769,2,0,-1,0,7
EUW1_6876278971',1,26,13,0,0,0,0,12,1,312,95,27967,27822,27548,3,23,14,2,0,1,0,2,382,93,28109,29989,34699,0,-70,2,-142,-1,-2167,-7151,-2,0,-1,0,10
EUW1_6876223757',4,37,17,1,0,1,0,5,1,327,72,28136,29330,30600,2,29,4,1,0,0,0,4,346,115,23288,26972,28338,0,-19,-43,4848,13,2358,2262,0,0,1,0,1
EUW1_6876172759',7,34,7,0,0,1,0,12,0,352,104,25365,28790,25351,4,35,7,2,1,1,0,2,360,107,26558,29633,29861,0,-8,-3,-1193,0,-843,-4510,-2,-1,0,0,10
EUW1_6875467705',4,34,12,0,0,0,0,9,1,387,122,29672,32157,29028,3,41,10,1,0,1,0,4,327,68,25019,28675,29225,1,60,54,4653,2,3482,-197,-1,0,-1,0,5
EUW1_6875420971',13,31,18,1,0,1,0,7,1,288,87,29062,26498,34849,5,26,16,1,1,0,0,2,332,86,28710,28346,36723,1,-44,1,352,2,-1848,-1874,0,-1,1,0,5
EUW1_6875023455',3,33,5,1,0,0,0,5,0,369,70,23372,26457,20884,10,71,9,0,0,1,0,1,354,78,25126,28267,29280,0,15,-8,-1754,-4,-1810,-8396,1,0,-1,0,4
EUW1_6875010185',11,35,14,0,1,0,0,6,1,356,79,29240,28771,30098,4,36,7,2,0,1,0,4,331,98,24336,28342,28667,1,25,-19,4904,7,429,1431,-2,1,-1,0,2
EUW1_6875000918',5,29,19,2,0,0,0,8,1,377,96,31299,33401,44222,7,32,13,0,0,1,0,5,346,71,26432,28799,27516,1,31,25,4867,6,4602,16706,2,0,-1,0,3
EUW1_6874137310',2,52,19,2,0,0,0,12,1,364,89,29228,30502,40040,7,33,13,0,0,0,0,1,361,90,28293,28180,34071,0,3,-1,935,6,2322,5969,2,0,0,0,11
EUW1_6883782164',2,18,9,0,0,0,0,11,0,368,76,25864,29188,28951,3,28,18,1,0,4,0,1,429,100,34365,34220,42047,0,-61,-24,-8501,-9,-5032,-13096,-1,0,-4,0,10
EUW1_6882670832',8,158,12,2,0,1,0,8,1,322,95,28256,28986,37228,6,33,21,0,0,1,0,5,396,80,31288,33076,38424,0,-74,15,-3032,-9,-4090,-1196,2,0,0,0,3
EUW1_6882455453',7,28,23,2,0,3,0,5,1,370,88,35467,30493,42720,3,26,8,0,0,2,0,9,352,96,25723,27338,29568,1,18,-8,9744,15,3155,13152,2,0,1,0,-4
EUW1_6882382439',1,23,14,1,0,0,0,11,1,349,78,28457,29220,39244,6,69,11,1,0,1,0,4,347,71,26720,28008,30952,0,2,7,1737,3,1212,8292,0,0,-1,0,7
EUW1_6882374004',5,30,11,0,0,0,0,13,0,359,94,26184,30595,32271,6,28,16,1,0,1,0,1,392,81,29927,31445,38494,1,-33,13,-3743,-5,-850,-6223,-1,0,-1,0,12
EUW1_6880901077',5,54,7,0,0,0,0,9,0,387,85,24940,30108,25249,2,31,16,1,0,1,0,5,395,78,28458,30536,34856,0,-8,7,-3518,-9,-428,-9607,-1,0,-1,0,4
EUW1_6875174718',1,19,15,1,0,2,0,12,0,347,102,30098,30320,31195,2,92,7,0,0,1,0,11,347,77,24969,27969,27185,1,0,25,5129,8,2351,4010,1,0,1,0,1
EUW1_6875157809',4,27,18,1,0,2,0,10,1,383,110,31238,32994,39436,3,27,5,0,0,1,0,10,334,94,23851,27668,22370,1,49,16,7387,13,5326,17066,1,0,1,0,0
EUW1_6875120955',2,30,12,1,0,0,0,7,1,377,93,26825,29093,32630,4,29,8,1,0,0,0,2,385,85,25625,29562,22871,0,-8,8,1200,4,-469,9759,0,0,0,0,5
EUW1_6873842454',2,25,14,0,0,0,0,9,0,323,74,27037,26549,28283,4,33,13,1,0,0,0,3,317,90,27538,26801,31563,1,6,-16,-501,1,-252,-3280,-1,0,0,0,6
EUW1_6873817437',5,29,6,2,0,0,0,8,0,352,86,23769,27834,23651,1,95,11,0,0,0,0,1,350,78,25771,29312,26045,1,2,8,-2002,-5,-1478,-2394,2,0,0,0,7
EUW1_6873794469',9,35,6,0,0,0,0,7,0,372,56,23694,27813,30631,6,28,7,2,0,0,0,2,330,102,24355,28941,26364,1,42,-46,-661,-1,-1128,4267,-2,0,0,0,5
EUW1_6873778472',6,41,17,1,0,1,0,7,0,353,96,30409,29827,34714,4,26,16,1,0,0,0,4,339,73,28194,28337,34985,0,14,23,2215,1,1490,-271,0,0,1,0,3
EUW1_6873335989',4,29,7,0,0,1,0,11,1,390,76,26228,28562,24265,2,30,13,1,0,1,0,4,374,99,27526,31594,28061,0,16,-23,-1298,-6,-3032,-3796,-1,0,0,0,7
EUW1_6872394197',4,63,10,2,0,1,0,6,0,385,88,27345,29060,28309,3,74,12,0,0,1,0,5,355,81,26773,30324,26306,0,30,7,572,-2,-1264,2003,2,0,0,0,1
EUW1_6868092949',4,29,7,0,0,1,0,8,1,360,102,25733,30440,22607,2,25,11,2,0,0,0,1,405,90,27696,30947,29105,0,-45,12,-1963,-4,-507,-6498,-2,0,1,0,7
EUW1_6864667528',1,36,10,1,1,1,0,9,1,400,96,27783,31524,24898,5,182,6,1,0,0,0,5,388,91,24992,28684,24467,1,12,5,2791,4,2840,431,0,1,1,0,4
EUW1_6801264864',2,19,11,1,0,0,0,9,1,393,68,28138,30229,31594,5,91,9,0,0,1,0,1,296,118,25764,28582,23829,1,97,-50,2374,2,1647,7765,1,0,-1,0,8
EUW1_6801208291',6,27,13,0,0,1,0,7,1,354,80,28535,29369,35807,3,27,11,1,0,1,0,6,343,100,27827,29829,31101,1,11,-20,708,2,-460,4706,-1,0,0,0,1
EUW1_6801161654',2,25,10,0,0,0,0,7,1,349,100,25811,29690,29798,4,39,10,2,0,0,0,1,377,84,26479,30043,28312,0,-28,16,-668,0,-353,1486,-2,0,0,0,6
EUW1_6801084406',0,86,18,0,0,0,0,8,0,309,97,29526,30101,39645,7,60,17,1,0,1,0,2,291,73,28335,25764,34434,1,18,24,1191,1,4337,5211,-1,0,-1,0,6
EUW1_6797468791',3,28,10,2,0,0,0,7,1,353,99,26795,30354,27235,1,20,8,0,0,0,0,2,339,90,25201,29277,33355,1,14,9,1594,2,1077,-6120,2,0,0,0,5
EUW1_6797413346',1,19,5,0,0,0,0,12,0,361,114,24188,30388,24535,1,20,10,2,0,1,0,1,424,102,28940,33375,30855,0,-63,12,-4752,-5,-2987,-6320,-2,0,-1,0,11
EUW1_6684493422',6,29,15,1,1,1,0,5,1,382,92,28588,31069,29000,8,45,10,0,0,0,0,7,394,90,26724,32094,28653,1,-12,2,1864,5,-1025,347,1,1,1,0,-2
EUW1_6684284443',2,27,11,0,1,1,0,7,0,386,62,27440,30729,28383,8,27,6,1,0,0,0,7,385,97,23510,28135,20444,1,1,-35,3930,5,2594,7939,-1,1,1,0,0
EUW1_6684122329',6,28,9,2,1,2,0,7,1,413,104,27938,30564,22090,2,21,7,0,0,0,0,6,379,99,24539,30311,19403,1,34,5,3399,2,253,2687,2,1,2,0,1
EUW1_6684092958',5,32,8,0,1,0,0,6,1,363,88,24779,29310,28982,4,40,10,2,0,0,0,0,388,75,25539,29077,27144,0,-25,13,-760,-2,233,1838,-2,1,0,0,6
EUW1_6684044676',2,30,12,1,1,1,0,11,0,327,92,27597,29520,33595,3,29,14,1,0,1,0,3,405,77,28977,31326,28570,0,-78,15,-1380,-2,-1806,5025,0,1,0,0,8
EUW1_6683996475',3,25,6,1,1,1,0,12,0,382,88,25334,29398,26649,1,23,13,1,0,2,0,3,389,84,29006,32359,28861,0,-7,4,-3672,-7,-2961,-2212,0,1,-1,0,9
EUW1_6683968893',5,21,15,1,0,0,0,13,1,283,80,26416,25999,30307,4,190,29,0,1,3,0,3,380,99,36725,34322,48866,0,-97,-19,-10309,-14,-8323,-18559,1,-1,-3,0,10
EUW1_6682983816',5,32,12,0,1,1,0,11,1,342,88,27405,28624,27706,4,33,11,2,0,0,0,5,331,120,27008,29633,24023,0,11,-32,397,1,-1009,3683,-2,1,1,0,6
EUW1_6682926522',1,101,14,2,1,1,0,5,1,317,84,27599,29320,33915,3,26,7,0,0,0,0,4,371,92,24401,27696,31150,1,-54,-8,3198,7,1624,2765,2,1,1,0,1
EUW1_6682830302',4,29,9,1,1,0,0,5,1,404,60,25685,28633,26814,3,22,8,0,0,0,0,4,374,75,24798,27826,32605,1,30,-15,887,1,807,-5791,1,1,0,0,1
EUW1_6682780136',5,30,8,1,0,0,0,8,1,315,91,24318,26439,31435,2,20,16,0,1,3,0,3,352,80,29987,29673,33589,0,-37,11,-5669,-8,-3234,-2154,1,-1,-3,0,5
EUW1_6682721371',2,20,14,1,1,2,0,6,1,384,100,31903,31021,29684,1,25,7,0,0,1,0,11,358,85,25606,29540,27066,1,26,15,6297,7,1481,2618,1,1,1,0,-5
EUW1_6682654454',6,27,13,1,1,0,0,11,1,342,77,26862,28167,29164,3,26,12,1,0,1,0,1,369,54,26640,29025,30129,1,-27,23,222,1,-858,-965,0,1,-1,0,10
EUW1_6681546669',2,32,18,2,0,0,0,8,1,361,82,29526,31171,32500,1,22,14,0,1,2,0,2,377,91,30105,31621,32880,0,-16,-9,-579,4,-450,-380,2,-1,-2,0,6
EUW1_6841459878',2,37,10,0,0,0,0,16,0,287,68,25283,26222,32465,2,22,22,2,1,4,0,1,351,99,34074,32857,44431,0,-64,-31,-8791,-12,-6635,-11966,-2,-1,-4,0,15
EUW1_6841405393',5,27,12,0,0,0,0,15,1,330,72,27477,28687,31196,0,42,19,1,0,3,0,4,338,112,33166,33643,42829,0,-8,-40,-5689,-7,-4956,-11633,-1,0,-3,0,11
EUW1_6841064049',7,145,12,1,0,1,0,4,1,357,104,28355,29044,35607,0,22,14,1,0,0,0,5,370,76,28272,30343,28217,1,-13,28,83,-2,-1299,7390,0,0,1,0,-1
EUW1_6841023491',3,62,5,1,1,0,0,11,0,346,97,24716,29426,23322,8,67,7,1,0,1,0,1,343,94,25660,29553,27123,0,3,3,-944,-2,-127,-3801,0,1,-1,0,10
EUW1_6840965357',3,23,9,0,0,0,0,12,1,358,84,25489,29134,27685,6,282,11,1,0,3,0,0,356,82,28218,29406,31830,0,2,2,-2729,-2,-272,-4145,-1,0,-3,0,12
EUW1_6840811343',3,23,22,1,1,2,0,6,1,334,91,32418,30426,35825,2,31,6,0,0,0,0,5,316,80,22557,25413,25246,1,18,11,9861,16,5013,10579,1,1,2,0,1
EUW1_6840811483',5,64,23,1,1,3,0,6,1,371,142,34744,33882,43803,2,61,8,1,0,0,0,8,312,61,23633,26217,24328,1,59,81,11111,15,7665,19475,0,1,3,0,-2
EUW1_6840797689',4,26,13,0,0,2,0,10,1,366,89,29765,30592,32364,4,23,13,0,0,0,0,5,327,66,27197,28639,34278,1,39,23,2568,0,1953,-1914,0,0,2,0,5
EUW1_6840783003',5,34,18,2,1,3,0,8,1,364,85,32542,31342,39233,1,96,16,0,0,0,0,9,261,84,25894,27429,36735,1,103,1,6648,2,3913,2498,2,1,3,0,-1
EUW1_6839306195',6,29,9,0,0,1,0,5,0,326,99,25439,28540,30281,6,34,11,2,0,1,0,5,348,83,26319,28416,26023,1,-22,16,-880,-2,124,4258,-2,0,0,0,0
EUW1_6839296221',5,27,6,1,0,1,0,4,0,340,78,24214,27251,26265,6,242,9,0,1,1,0,3,379,96,26855,29937,27193,0,-39,-18,-2641,-3,-2686,-928,1,-1,0,0,1
EUW1_6839259139',5,33,13,0,0,1,0,12,0,328,74,27410,27198,39755,1,34,21,0,0,1,0,2,322,67,31328,28751,44922,1,6,7,-3918,-8,-1553,-5167,0,0,0,0,10
EUW1_6839240966',2,29,14,0,0,2,0,9,0,348,74,30031,29893,30599,4,36,15,2,0,1,0,7,353,94,29986,30221,31495,0,-5,-20,45,-1,-328,-896,-2,0,1,0,2
EUW1_6839070460',4,30,16,0,0,0,0,9,0,347,70,29497,31280,33379,1,31,21,2,1,3,0,4,349,110,32663,31910,46686,0,-2,-40,-3166,-5,-630,-13307,-2,-1,-3,0,5
EUW1_6837908303',3,28,13,0,0,1,0,13,0,307,88,29516,28729,35567,4,33,20,1,0,2,0,5,321,102,31732,28453,39152,1,-14,-14,-2216,-7,276,-3585,-1,0,-1,0,8
EUW1_6837906551',5,34,13,0,0,1,0,8,0,347,106,28682,29801,31225,3,25,13,2,0,0,0,6,322,94,27178,29114,27843,0,25,12,1504,0,687,3382,-2,0,1,0,2
EUW1_6837888864',7,29,12,2,0,1,0,7,1,378,78,29539,29415,29045,1,42,10,0,0,1,0,7,286,88,23861,28469,26921,1,92,-10,5678,2,946,2124,2,0,0,0,0
EUW1_6837877820',3,32,12,0,0,1,0,7,1,336,114,28603,31877,27733,2,27,9,2,0,1,0,4,348,80,25662,28165,29038,0,-12,34,2941,3,3712,-1305,-2,0,0,0,3
EUW1_6837870608',5,36,6,0,0,0,0,10,0,304,94,23054,27443,24428,7,27,17,1,0,3,0,0,440,80,33774,33776,33580,0,-136,14,-10720,-11,-6333,-9152,-1,0,-3,0,10
EUW1_6882600297',2,28,8,0,0,0,0,12,1,299,97,23805,27910,32086,3,22,11,2,0,3,0,2,376,94,29112,31846,33667,0,-77,3,-5307,-3,-3936,-1581,-2,0,-3,0,10
EUW1_6875578045',2,23,6,0,0,0,0,9,1,371,111,25521,29770,30576,2,39,12,2,0,1,0,5,378,88,27789,30336,31775,0,-7,23,-2268,-6,-566,-1199,-2,0,-1,0,4
EUW1_6875481749',1,41,12,0,0,0,0,9,1,324,75,26489,26460,36696,3,32,20,1,0,1,0,2,383,76,31915,32342,37357,0,-59,-1,-5426,-8,-5882,-661,-1,0,-1,0,7
EUW1_6874162624',2,27,8,1,0,0,0,19,1,364,103,25816,28982,27741,3,30,18,1,1,3,0,5,341,84,31181,31673,36795,0,23,19,-5365,-10,-2691,-9054,0,-1,-3,0,14
EUW1_6874089305',2,21,9,0,0,0,0,13,0,348,85,25982,28280,23607,6,29,24,2,1,2,0,2,342,96,32146,32875,41170,0,6,-11,-6164,-15,-4595,-17563,-2,-1,-2,0,11
EUW1_6873239768',6,47,6,0,0,0,0,11,0,328,85,24134,27046,25260,3,28,12,2,1,2,0,1,367,112,28338,30841,28995,0,-39,-27,-4204,-6,-3795,-3735,-2,-1,-2,0,10
EUW1_6872881718',6,40,15,1,0,2,0,9,1,375,96,30027,29476,28481,3,23,4,0,0,0,0,5,341,96,23436,27852,15381,1,34,0,6591,11,1624,13100,1,0,2,0,4
EUW1_6872743692',2,29,18,1,1,2,0,7,0,358,92,32176,31226,42177,2,23,14,1,0,0,0,7,353,79,26808,30387,37099,1,5,13,5368,4,839,5078,0,1,2,0,0
EUW1_6872691837',2,43,12,0,0,0,0,5,0,336,73,25844,27575,32675,7,30,12,1,0,0,0,4,352,82,26895,28408,33321,1,-16,-9,-1051,0,-833,-646,-1,0,0,0,1
EUW1_6871704532',3,30,18,2,0,1,0,13,1,340,95,29626,31121,38087,4,21,16,0,0,1,0,4,339,95,28434,29652,33679,0,1,0,1192,2,1469,4408,2,0,0,0,9
EUW1_6871553375',1,25,19,2,0,0,0,6,0,375,101,30098,33683,33040,4,29,6,0,0,0,0,3,294,102,23332,28236,28602,1,81,-1,6766,13,5447,4438,2,0,0,0,3
EUW1_6870303807',4,26,8,0,0,0,0,8,0,381,89,26745,29026,34446,3,57,12,2,0,1,0,4,350,94,26666,30063,26250,1,31,-5,79,-4,-1037,8196,-2,0,-1,0,4
EUW1_6865020923',4,20,15,0,0,1,0,4,1,380,88,28271,32657,32044,2,26,10,2,0,0,0,4,298,100,24319,29547,27597,0,82,-12,3952,5,3110,4447,-2,0,1,0,0
EUW1_6864931264',4,27,9,1,1,1,0,10,1,352,69,25255,26871,26864,5,28,8,1,0,1,0,4,380,110,26223,28450,23691,1,-28,-41,-968,1,-1579,3173,0,1,0,0,6
EUW1_6864670061',1,22,5,0,0,0,0,9,0,351,90,23891,29090,22488,3,25,15,2,0,2,0,2,370,86,27993,29265,25437,0,-19,4,-4102,-10,-175,-2949,-2,0,-2,0,7
EUW1_6864096072',2,25,8,0,0,1,0,8,0,349,96,25310,30541,26782,12,36,12,2,0,0,0,4,358,99,27054,29848,33793,1,-9,-3,-1744,-4,693,-7011,-2,0,1,0,4
EUW1_6863932407',3,24,18,0,0,2,0,8,1,310,98,31944,28396,40437,3,19,21,1,1,0,0,9,338,88,31758,30135,39668,1,-28,10,186,-3,-1739,769,-1,-1,2,0,-1
EUW1_6863882506',4,68,5,1,0,0,0,9,0,321,77,22856,27347,32901,3,51,11,0,1,1,0,2,362,69,26752,30572,28963,0,-41,8,-3896,-6,-3225,3938,1,-1,-1,0,7
EUW1_6814824204',4,29,13,1,1,1,0,14,0,294,97,27668,28085,34125,0,136,18,1,0,2,0,2,331,98,31730,29110,39931,1,-37,-1,-4062,-5,-1025,-5806,0,1,-1,0,12
EUW1_6814805780',1,25,14,1,0,0,0,10,1,354,87,29236,30449,29633,1,143,8,1,1,2,0,3,343,83,24821,28845,30275,1,11,4,4415,6,1604,-642,0,-1,-2,0,7
EUW1_6814773221',2,142,10,1,0,1,0,15,0,343,88,26382,28538,26506,4,31,18,1,0,2,0,2,381,87,31408,31569,39024,0,-38,1,-5026,-8,-3031,-12518,0,0,-1,0,13
EUW1_6814714286',1,21,9,1,0,0,0,9,1,335,108,25641,29362,27184,2,27,5,1,0,1,0,2,370,98,25119,29654,27286,1,-35,10,522,4,-292,-102,0,0,-1,0,7
EUW1_6812758120',2,483,12,1,1,0,0,8,1,392,98,29200,30766,34083,5,24,11,1,0,0,0,5,313,85,26047,26315,26014,0,79,13,3153,1,4451,8069,0,1,0,0,3
EUW1_6812678077',3,27,10,1,0,0,0,10,0,381,72,27066,29211,27958,0,130,17,1,0,1,0,4,393,102,30478,33301,37721,0,-12,-30,-3412,-7,-4090,-9763,0,0,-1,0,6
EUW1_6812601298',5,35,15,1,0,1,0,8,1,365,101,29480,31380,42314,4,24,10,0,0,0,0,2,331,74,25703,28601,30763,1,34,27,3777,5,2779,11551,1,0,1,0,6
EUW1_6812554137',3,24,11,0,0,0,0,10,1,333,83,26683,26610,30484,2,106,17,1,0,2,0,3,351,63,29950,28147,38405,0,-18,20,-3267,-6,-1537,-7921,-1,0,-2,0,7
EUW1_6812258827',5,31,10,2,0,0,0,5,1,361,117,26855,30664,28761,5,28,7,0,0,0,0,5,372,66,24945,27916,32498,1,-11,51,1910,3,2748,-3737,2,0,0,0,0
EUW1_6812192857',3,38,10,0,0,0,0,7,0,393,81,26175,31247,31802,4,21,9,1,0,0,0,2,366,89,25826,29775,35935,0,27,-8,349,1,1472,-4133,-1,0,0,0,5
EUW1_6812161105',6,40,20,2,0,3,0,10,1,319,74,31353,25988,31850,1,17,12,0,0,1,0,10,272,66,25092,22131,32513,1,47,8,6261,8,3857,-663,2,0,2,0,0
EUW1_6812126477',4,29,18,1,0,0,0,4,1,349,98,31013,32527,36348,0,137,10,1,0,1,0,5,331,94,25511,28621,29445,1,18,4,5502,8,3906,6903,0,0,-1,0,-1
EUW1_6812090060',2,26,14,1,0,1,0,7,1,377,94,29584,31508,32034,6,29,8,0,0,1,0,4,387,90,25627,31381,21296,1,-10,4,3957,6,127,10738,1,0,0,0,3
EUW1_6812047949',4,36,17,1,1,0,0,6,1,334,119,30414,30658,36767,4,96,13,0,0,0,0,4,368,60,27662,30272,38498,0,-34,59,2752,4,386,-1731,1,1,0,0,2
EUW1_6810857582',4,32,16,0,0,0,0,9,0,359,78,29639,31105,39334,2,20,16,1,0,2,0,6,314,98,29942,29645,40490,1,45,-20,-303,0,1460,-1156,-1,0,-2,0,3
EUW1_6810765911',2,23,4,2,0,0,0,6,1,382,82,23677,29446,18092,1,134,8,0,0,0,0,1,388,100,26109,30413,30586,0,-6,-18,-2432,-4,-967,-12494,2,0,0,0,5
EUW1_6810553982',2,26,8,0,1,1,0,11,0,380,111,27071,30197,29842,2,93,10,2,0,1,0,2,368,96,27902,30583,34050,1,12,15,-831,-2,-386,-4208,-2,1,0,0,9
EUW1_6810509299',3,32,6,0,0,0,0,11,0,367,71,24332,26290,20986,6,137,18,2,0,3,0,2,401,87,30766,33257,39960,0,-34,-16,-6434,-12,-6967,-18974,-2,0,-3,0,9
EUW1_6810446399',2,18,10,0,0,0,0,10,0,326,89,26185,29675,28085,2,27,16,1,0,1,0,1,396,100,30698,32817,47225,0,-70,-11,-4513,-6,-3142,-19140,-1,0,-1,0,9
EUW1_6810395135',5,86,17,2,0,0,0,12,1,381,91,30605,30479,32013,1,26,7,0,0,2,0,1,377,84,26053,28505,30446,1,4,7,4552,10,1974,1567,2,0,-2,0,11
EUW1_6883060130',3,33,19,0,0,1,0,12,1,317,81,31261,29430,36649,2,362,14,1,0,0,0,2,401,94,29553,29395,34500,1,-84,-13,1708,5,35,2149,-1,0,1,0,10
EUW1_6882975097',1,30,12,0,0,0,0,4,1,355,72,26883,28786,35762,5,29,14,2,0,0,0,1,398,95,28337,30747,35572,0,-43,-23,-1454,-2,-1961,190,-2,0,0,0,3
EUW1_6860334951',5,27,11,1,0,0,0,12,0,351,86,27777,29531,30861,6,36,17,0,0,2,0,3,348,106,30613,30676,38697,0,3,-20,-2836,-6,-1145,-7836,1,0,-2,0,9
EUW1_6859814348',4,36,16,0,1,1,0,13,0,363,75,30607,29132,31499,5,42,21,2,0,1,0,2,363,98,32391,32161,45641,0,0,-23,-1784,-5,-3029,-14142,-2,1,0,0,11
EUW1_6859762571',5,24,21,0,0,1,0,11,0,321,84,31224,31329,41549,2,27,15,1,1,3,0,3,359,92,30620,28456,32859,1,-38,-8,604,6,2873,8690,-1,-1,-2,0,8
EUW1_6857828675',0,25,8,0,0,1,0,11,1,306,78,25533,26830,26349,3,26,15,2,0,1,0,4,390,104,29868,30993,39765,1,-84,-26,-4335,-7,-4163,-13416,-2,0,0,0,7
EUW1_6857789271',4,28,7,0,0,0,0,8,0,356,105,25416,28461,32873,5,37,17,2,1,1,0,1,356,90,30967,31408,35469,0,0,15,-5551,-10,-2947,-2596,-2,-1,-1,0,7
EUW1_6857698775',2,28,12,0,0,0,0,12,0,321,66,27115,27207,33099,2,25,27,1,1,1,0,4,329,82,33343,31003,39707,0,-8,-16,-6228,-15,-3796,-6608,-1,-1,-1,0,8
EUW1_6857407182',3,29,10,0,0,0,0,11,0,336,96,26711,27341,33008,5,39,19,2,0,1,0,2,367,80,31161,30072,42688,0,-31,16,-4450,-9,-2731,-9680,-2,0,-1,0,9
EUW1_6857190948',7,31,10,2,0,1,0,6,1,412,96,28585,30469,24904,1,42,6,0,0,1,0,9,375,78,25212,29285,24332,1,37,18,3373,4,1184,572,2,0,0,0,-3
EUW1_6857138988',3,24,10,0,0,1,0,6,0,379,98,27796,32093,28250,6,35,8,2,0,0,0,4,367,83,25150,29374,21220,1,12,15,2646,2,2719,7030,-2,0,1,0,2
EUW1_6868836395',2,19,15,1,0,0,0,15,1,344,94,29201,28992,38393,1,34,16,1,0,3,0,4,360,68,29757,30837,36416,1,-16,26,-556,-1,-1845,1977,0,0,-3,0,11
EUW1_6868776968',8,26,13,0,0,1,0,11,1,327,51,27335,26654,34194,2,61,19,2,0,2,0,10,334,106,31042,30567,42453,0,-7,-55,-3707,-6,-3913,-8259,-2,0,-1,0,1
EUW1_6861693395',2,34,6,0,0,2,0,9,0,351,76,26236,27371,23676,2,34,13,1,0,0,0,6,343,63,26747,25734,27013,0,8,13,-511,-7,1637,-3337,-1,0,2,0,3
EUW1_6861644421',2,25,7,0,0,0,0,13,0,311,68,23594,26701,29357,3,51,21,1,0,1,0,0,366,94,31710,32189,42984,0,-55,-26,-8116,-14,-5488,-13627,-1,0,-1,0,13
EUW1_6860435645',3,37,7,0,0,0,0,7,0,368,93,26773,29160,26145,5,43,13,2,0,1,0,2,380,90,28344,30488,38947,1,-12,3,-1571,-6,-1328,-12802,-2,0,-1,0,5
EUW1_6859126342',1,23,4,0,0,1,0,4,1,387,96,26067,30748,29236,5,238,7,2,0,0,0,8,393,112,26030,30998,26130,1,-6,-16,37,-3,-250,3106,-2,0,1,0,-4
EUW1_6857942108',5,47,16,1,0,1,0,6,1,368,95,30050,29860,35100,4,87,3,1,0,0,0,5,316,72,21289,24142,19304,1,52,23,8761,13,5718,15796,0,0,1,0,1
EUW1_6857927811',5,59,23,1,0,1,0,7,0,316,102,32460,30795,40573,6,31,15,1,0,0,0,6,295,85,27024,24565,38791,1,21,17,5436,8,6230,1782,0,0,1,0,1
EUW1_6857894281',5,34,11,2,0,1,0,10,0,364,100,28485,29667,38281,5,23,14,0,0,1,0,7,354,91,26870,29888,27285,0,10,9,1615,-3,-221,10996,2,0,0,0,3
EUW1_6857842147',6,29,15,1,0,0,0,6,1,312,84,27041,30288,33720,4,25,11,1,0,0,0,1,354,128,27755,31322,33144,0,-42,-44,-714,4,-1034,576,0,0,0,0,5
EUW1_6857716184',4,20,15,0,0,0,0,10,0,349,109,28483,32141,38603,5,27,17,1,0,1,0,2,406,106,32278,33428,43551,0,-57,3,-3795,-2,-1287,-4948,-1,0,-1,0,8
EUW1_6856389350',4,24,13,2,1,1,0,8,1,341,95,29130,31024,35724,5,38,15,0,0,0,0,4,320,75,27402,27270,35852,0,21,20,1728,-2,3754,-128,2,1,1,0,4
EUW1_6856292018',5,27,8,0,0,0,0,11,1,354,75,24006,27858,24344,3,25,6,1,1,3,0,0,383,92,27361,29992,27943,0,-29,-17,-3355,2,-2134,-3599,-1,-1,-3,0,11
EUW1_6843824349',5,26,11,2,0,0,0,7,0,368,88,26457,30458,29435,7,29,9,0,0,0,0,0,376,101,26926,29616,31261,1,-8,-13,-469,2,842,-1826,2,0,0,0,7
EUW1_6843481511',4,25,7,0,0,0,0,14,0,350,84,24933,27620,30001,2,27,19,2,1,3,0,2,408,103,34734,34709,37004,0,-58,-19,-9801,-12,-7089,-7003,-2,-1,-3,0,12
EUW1_6843447030',4,28,7,1,0,0,0,11,1,357,73,23770,27421,30587,8,45,14,0,0,1,0,1,327,109,28078,30025,31436,0,30,-36,-4308,-7,-2604,-849,1,0,-1,0,10
EUW1_6881150180',1,25,8,0,0,0,0,10,0,363,82,25723,29634,27034,2,30,15,2,1,1,0,1,380,75,28452,30218,33041,0,-17,7,-2729,-7,-584,-6007,-2,-1,-1,0,9
EUW1_6881110750',2,23,17,2,0,0,0,8,1,335,80,29609,29909,36705,2,18,17,0,0,1,0,4,355,82,29969,28967,36965,1,-20,-2,-360,0,942,-260,2,0,-1,0,4
EUW1_6880373601',3,26,11,0,0,0,0,10,0,384,67,28300,28798,33205,3,28,18,2,0,1,0,8,356,75,30983,31672,28677,0,28,-8,-2683,-7,-2874,4528,-2,0,-1,0,2
EUW1_6877258161',7,48,17,1,1,0,0,9,0,373,82,30178,31172,37581,0,32,13,0,0,2,0,7,337,94,28148,28037,27437,1,36,-12,2030,4,3135,10144,1,1,-2,0,2
EUW1_6859994739',4,28,12,2,0,1,0,10,0,357,82,27984,28885,33307,7,33,11,0,0,1,0,0,381,78,27925,28848,31434,1,-24,4,59,1,37,1873,2,0,0,0,10
EUW1_6859931339',3,20,13,1,0,2,0,4,1,404,94,31625,30605,29308,3,95,17,1,1,0,0,11,362,101,29420,33193,30549,1,42,-7,2205,-4,-2588,-1241,0,-1,2,0,-7
EUW1_6859564760',5,42,19,1,0,1,0,10,1,313,100,31325,29434,37530,6,39,13,0,0,0,0,7,338,69,27072,27448,35572,0,-25,31,4253,6,1986,1958,1,0,1,0,3
EUW1_6859541611',3,43,23,1,0,1,0,9,1,359,112,31676,30969,50592,6,31,3,1,1,2,0,4,289,62,23053,24964,34071,1,70,50,8623,20,6005,16521,0,-1,-1,0,5
EUW1_6859505442',4,31,11,1,0,1,0,9,1,371,76,27771,28064,30698,4,38,12,1,0,0,0,4,362,92,27474,29947,39116,1,9,-16,297,-1,-1883,-8418,0,0,1,0,5
EUW1_6859492595',1,25,11,0,0,0,0,16,0,388,76,27978,31420,30695,5,83,16,1,0,2,0,2,354,96,31064,32533,34707,0,34,-20,-3086,-5,-1113,-4012,-1,0,-2,0,14
EUW1_6858434815',0,29,4,0,1,2,0,7,0,396,112,26677,29668,21014,6,36,10,2,0,1,0,8,367,84,25940,28063,22931,0,29,28,737,-6,1605,-1917,-2,1,1,0,-1
EUW1_6858268040',4,32,13,1,0,0,0,6,0,392,80,29916,30010,34878,2,26,13,0,0,2,0,4,356,92,27923,29440,29405,1,36,-12,1993,0,570,5473,1,0,-2,0,2
EUW1_6858237659',2,20,7,0,0,0,0,14,0,322,75,23177,25748,26214,3,32,17,1,0,2,0,1,403,112,31299,33428,34083,0,-81,-37,-8122,-10,-7680,-7869,-1,0,-2,0,13
EUW1_6881710761',9,34,15,1,1,1,0,13,1,423,99,30898,32405,29385,5,33,12,1,0,0,0,4,383,96,27982,30634,28189,1,40,3,2916,3,1771,1196,0,1,1,0,9
EUW1_6881615887',3,28,9,0,0,1,0,10,0,364,96,27706,29554,27166,3,28,16,2,0,0,0,3,304,91,27542,29092,33206,1,60,5,164,-7,462,-6040,-2,0,1,0,7
EUW1_6878975766',2,22,9,0,0,0,0,13,0,320,69,25246,26323,27809,3,30,31,2,0,3,0,0,386,101,36212,34055,44365,0,-66,-32,-10966,-22,-7732,-16556,-2,0,-3,0,13
EUW1_6878928379',4,23,18,1,0,0,0,13,1,303,35,29530,27559,34454,4,37,25,0,0,2,0,2,382,121,34959,32532,41370,0,-79,-86,-5429,-7,-4973,-6916,1,0,-2,0,11
EUW1_6878886556',2,24,6,0,0,0,0,12,1,292,108,23307,25078,26920,3,24,24,2,0,4,0,0,348,99,34207,31341,41827,0,-56,9,-10900,-18,-6263,-14907,-2,0,-4,0,12
EUW1_6878804269',5,36,17,0,0,0,0,9,1,332,72,27491,27350,34262,2,43,15,1,0,0,0,0,365,92,29499,30238,35435,1,-33,-20,-2008,2,-2888,-1173,-1,0,0,0,9
EUW1_6878473023',5,35,24,0,0,3,0,14,1,325,87,31793,31422,40026,2,29,12,1,0,1,0,6,321,88,29340,28806,30803,1,4,-1,2453,12,2616,9223,-1,0,2,0,8
EUW1_6878169244',1,20,14,0,0,0,0,18,0,360,103,29803,31259,26310,4,27,18,2,1,3,0,5,382,83,31682,31442,32093,1,-22,20,-1879,-4,-183,-5783,-2,-1,-3,0,13
EUW1_6878124452',8,30,8,1,0,0,0,11,0,353,98,25792,28578,26908,4,47,13,1,0,1,0,4,326,81,26899,29174,27079,1,27,17,-1107,-5,-596,-171,0,0,-1,0,7
EUW1_6877737090',0,15,7,0,0,0,0,16,0,360,91,25219,29628,28130,6,26,18,1,0,2,0,1,387,68,30893,31595,36859,0,-27,23,-5674,-11,-1967,-8729,-1,0,-2,0,15
EUW1_6876817839',1,13,12,0,0,0,0,16,1,259,95,26032,25878,29632,2,100,30,2,0,3,0,3,360,96,34463,32561,42899,0,-101,-1,-8431,-18,-6683,-13267,-2,0,-3,0,13
EUW1_6876761142',4,135,5,1,0,0,0,12,0,338,84,24376,26772,23982,5,42,17,0,0,1,0,5,355,69,29055,29271,36842,0,-17,15,-4679,-12,-2499,-12860,1,0,-1,0,7
EUW1_6876307653',2,23,11,1,0,1,0,5,1,375,94,28270,29698,24382,6,24,10,1,0,0,0,2,366,97,26789,30339,28275,1,9,-3,1481,1,-641,-3893,0,0,1,0,3
EUW1_6873317819',8,33,15,1,1,0,0,12,0,355,86,27509,29734,35103,7,43,19,1,0,2,0,3,335,96,30647,29414,30432,0,20,-10,-3138,-4,320,4671,0,1,-2,0,9
EUW1_6873227547',6,32,10,1,0,1,0,9,1,376,104,27048,30186,29979,4,30,8,1,0,0,0,3,367,84,24447,30313,30119,1,9,20,2601,2,-127,-140,0,0,1,0,6
EUW1_6873094271',3,28,22,1,0,1,0,8,1,317,80,31980,30399,44922,3,30,8,0,0,0,0,6,285,80,24107,25045,33379,1,32,0,7873,14,5354,11543,1,0,1,0,2
EUW1_6873043950',4,33,16,0,0,0,0,10,1,297,63,28604,28121,33816,3,25,26,0,0,2,0,0,357,116,34289,32504,36078,0,-60,-53,-5685,-10,-4383,-2262,0,0,-2,0,10
EUW1_6806147809',5,34,18,1,0,1,0,7,0,379,103,30833,32327,37956,4,32,6,1,0,1,0,7,341,80,23195,26264,22859,1,38,23,7638,12,6063,15097,0,0,0,0,0
EUW1_6806064145',3,32,12,2,0,0,0,10,0,344,84,27017,28984,31406,6,30,23,0,0,3,0,1,353,112,33610,33306,41501,0,-9,-28,-6593,-11,-4322,-10095,2,0,-3,0,9
EUW1_6805792307',6,31,7,1,0,0,0,10,0,373,117,25792,31296,26506,4,33,10,1,1,2,0,2,411,94,29078,31726,26153,0,-38,23,-3286,-3,-430,353,0,-1,-2,0,8
EUW1_6805731017',3,30,11,1,0,0,0,8,0,340,88,26468,29067,29390,5,20,15,1,0,1,0,6,403,95,30521,33552,35201,0,-63,-7,-4053,-4,-4485,-5811,0,0,-1,0,2
EUW1_6805579970',9,40,15,0,0,0,0,8,1,360,84,28205,30473,40448,3,28,12,2,0,1,0,1,341,92,26058,30794,33002,1,19,-8,2147,3,-321,7446,-2,0,-1,0,7
EUW1_6805380653',8,45,17,1,1,1,0,13,1,346,96,30740,29524,39104,3,97,15,1,0,2,0,6,324,87,28625,30681,36704,1,22,9,2115,2,-1157,2400,0,1,-1,0,7
EUW1_6804884807',4,25,14,0,0,0,0,10,0,298,93,27863,28513,36764,2,137,19,2,0,2,0,4,357,85,30774,30340,34449,0,-59,8,-2911,-5,-1827,2315,-2,0,-2,0,6
EUW1_6804794016',2,26,13,1,0,2,0,12,0,357,79,29206,28854,43318,4,28,14,1,1,1,0,8,294,82,28672,30276,32209,0,63,-3,534,-1,-1422,11109,0,-1,1,0,4
EUW1_6804727918',3,18,19,1,1,2,0,8,1,396,108,34754,33212,34735,5,34,5,0,0,1,0,9,344,84,23406,26976,26751,1,52,24,11348,14,6236,7984,1,1,1,0,-1
EUW1_6804140952',3,31,14,2,0,1,0,5,0,386,100,29765,31478,37748,4,24,9,0,0,0,0,5,328,73,24432,27180,19896,1,58,27,5333,5,4298,17852,2,0,1,0,0
EUW1_6804087773',8,36,26,1,0,2,0,11,1,361,98,34905,34036,43724,0,29,9,1,0,1,0,5,352,89,27253,28722,37425,1,9,9,7652,17,5314,6299,0,0,1,0,6
EUW1_6803406848',3,24,24,1,1,2,0,7,1,352,98,33875,32314,43344,4,20,14,0,0,0,0,4,304,99,27869,28387,36765,1,48,-1,6006,10,3927,6579,1,1,2,0,3
EUW1_6803350564',2,32,13,1,0,0,0,12,0,330,89,28978,29642,34153,4,144,19,1,0,2,0,2,349,94,32030,30719,42414,0,-19,-5,-3052,-6,-1077,-8261,0,0,-2,0,10
EUW1_6803215609',3,29,13,1,0,0,0,8,1,398,80,29047,32383,30127,3,146,12,1,0,0,0,1,350,116,27163,30672,32099,1,48,-36,1884,1,1711,-1972,0,0,0,0,7
EUW1_6803090545',4,22,9,1,0,0,0,6,0,371,105,26452,30396,29408,5,29,11,0,1,0,0,5,368,97,26975,30426,30311,0,3,8,-523,-2,-30,-903,1,-1,0,0,1
EUW1_6802787528',4,31,16,0,0,2,0,9,1,404,96,32067,31941,32316,2,21,9,1,0,0,0,8,332,86,24821,28511,24620,1,72,10,7246,7,3430,7696,-1,0,2,0,1
EUW1_6802615796',2,146,17,1,0,0,0,9,1,371,79,28253,31995,36230,2,27,7,0,0,0,0,2,344,111,27071,30011,35253,1,27,-32,1182,10,1984,977,1,0,0,0,7
EUW1_6802563896',8,29,8,0,0,1,0,5,1,345,83,25446,28189,31557,2,97,15,2,0,0,0,5,326,96,28214,30211,29980,0,19,-13,-2768,-7,-2022,1577,-2,0,1,0,0
EUW1_6802523385',5,139,15,0,0,1,0,5,0,380,93,30295,31056,38211,14,40,16,1,1,0,0,4,319,82,26756,28219,36289,1,61,11,3539,-1,2837,1922,-1,-1,1,0,1
EUW1_6882419903',5,38,11,1,0,1,0,13,0,325,81,26017,28094,32069,7,25,19,1,0,3,0,5,345,85,31337,30743,40359,0,-20,-4,-5320,-8,-2649,-8290,0,0,-2,0,8
EUW1_6882407506',5,30,16,2,0,0,0,11,0,335,84,28546,29060,35433,5,28,15,0,0,1,0,5,334,85,28697,28101,29552,1,1,-1,-151,1,959,5881,2,0,-1,0,6
EUW1_6882389703',5,25,19,1,0,0,0,5,1,387,86,32055,30868,41318,3,301,8,0,0,1,0,9,327,83,25433,28529,38917,1,60,3,6622,11,2339,2401,1,0,-1,0,-4
EUW1_6882368582',8,27,11,1,0,1,0,13,0,365,76,26283,28654,29770,1,29,9,1,0,1,0,4,340,126,27187,29509,30750,0,25,-50,-904,2,-855,-980,0,0,0,0,9
EUW1_6882360539',2,24,17,1,0,2,0,5,0,385,96,31342,32349,31594,2,26,10,1,0,0,0,4,315,103,26066,27642,29272,1,70,-7,5276,7,4707,2322,0,0,2,0,1
EUW1_6882116869',3,28,14,1,1,1,0,6,0,396,81,28861,28993,26918,2,26,16,1,0,0,0,2,347,80,29605,30030,30522,0,49,1,-744,-2,-1037,-3604,0,1,1,0,4
EUW1_6882067054',5,94,7,0,0,0,0,11,1,335,93,24330,27448,32519,7,34,12,2,0,1,0,0,362,90,27746,28072,28163,1,-27,3,-3416,-5,-624,4356,-2,0,-1,0,11
EUW1_6880769952',4,28,23,1,0,0,0,7,1,333,85,30872,31272,38630,3,26,12,1,0,1,0,6,343,94,27382,28409,32486,1,-10,-9,3490,11,2863,6144,0,0,-1,0,1
EUW1_6880508050',4,24,4,0,0,1,0,8,0,359,94,23656,27773,21211,2,30,9,2,1,1,0,4,402,85,26979,30224,22974,0,-43,9,-3323,-5,-2451,-1763,-2,-1,0,0,4
EUW1_6880451754',4,27,11,1,0,1,0,3,0,407,99,26790,31949,29870,4,25,5,1,0,0,0,3,401,80,23879,28929,19068,1,6,19,2911,6,3020,10802,0,0,1,0,0
EUW1_6880378943',4,24,16,2,0,2,0,11,0,347,74,29642,30031,41506,4,26,11,0,0,1,0,6,337,102,26162,28071,32686,1,10,-28,3480,5,1960,8820,2,0,1,0,5
EUW1_6879258443',0,24,12,2,0,4,1,8,0,367,95,30783,29392,31537,5,34,7,0,0,2,0,8,292,85,24496,24700,21574,1,75,10,6287,5,4692,9963,2,0,2,1,0
EUW1_6879247461',3,55,19,0,0,2,0,11,1,397,98,33012,33386,35507,4,27,12,2,0,0,0,4,283,83,24729,28008,28715,1,114,15,8283,7,5378,6792,-2,0,2,0,7
EUW1_6879207965',2,31,15,0,0,1,0,13,1,388,84,29839,30143,33021,9,34,11,2,0,2,0,6,347,74,27828,29095,28418,1,41,10,2011,4,1048,4603,-2,0,-1,0,7
EUW1_6882693903',4,36,6,1,0,0,0,4,0,382,82,24063,29128,27050,5,44,16,0,0,0,0,0,394,87,29097,32013,35332,0,-12,-5,-5034,-10,-2885,-8282,1,0,0,0,4
EUW1_6882652300',3,23,12,0,0,0,0,11,0,355,97,27079,30318,32388,5,40,21,2,0,0,0,2,363,94,30285,31953,42636,0,-8,3,-3206,-9,-1635,-10248,-2,0,0,0,9
EUW1_6881623033',6,37,7,0,0,1,0,9,0,373,114,26439,30088,26298,7,45,16,2,0,2,0,4,376,82,29744,30606,39718,0,-3,32,-3305,-9,-518,-13420,-2,0,-1,0,5
EUW1_6881578571',1,24,7,0,0,1,0,14,0,325,94,26604,27523,28791,7,28,24,1,0,2,0,2,336,85,32595,30876,41049,0,-11,9,-5991,-17,-3353,-12258,-1,0,-1,0,12
EUW1_6878442410',3,25,11,0,0,1,0,14,1,326,78,27451,28183,30826,3,27,20,2,0,2,0,3,394,126,33896,33924,38690,0,-68,-48,-6445,-9,-5741,-7864,-2,0,-1,0,11
EUW1_6878377271',4,32,15,1,0,1,0,6,1,370,107,30273,31297,37107,4,42,15,1,0,0,0,3,359,92,27493,29318,28409,0,11,15,2780,0,1979,8698,0,0,1,0,3
EUW1_6878347253',0,26,14,2,0,2,0,8,0,378,104,30229,30289,28037,7,59,7,0,0,0,0,7,353,71,24534,26816,25169,1,25,33,5695,7,3473,2868,2,0,2,0,1
EUW1_6878312731',9,32,17,1,0,1,0,4,1,356,74,29147,28864,33470,3,22,11,1,0,0,0,5,372,95,27136,28616,34690,1,-16,-21,2011,6,248,-1220,0,0,1,0,-1
EUW1_6878257423',8,52,7,0,0,0,0,7,0,391,79,25342,29673,24167,5,30,12,2,1,1,0,4,405,131,29654,32996,29400,0,-14,-52,-4312,-5,-3323,-5233,-2,-1,-1,0,3
EUW1_6875935224',7,34,17,0,1,0,0,7,0,379,74,28981,29006,37458,6,31,8,2,0,0,0,5,368,98,26350,28563,36180,0,11,-24,2631,9,443,1278,-2,1,0,0,2
EUW1_6875833788',0,23,11,1,0,0,0,7,0,390,84,26894,28962,26763,6,26,8,0,0,1,0,2,410,76,27373,29443,26791,1,-20,8,-479,3,-481,-28,1,0,-1,0,5
EUW1_6872731495',6,38,11,0,1,0,0,8,0,407,104,27326,32398,29193,7,40,10,2,0,1,0,2,397,90,27872,30095,28528,1,10,14,-546,1,2303,665,-2,1,-1,0,6
EUW1_6872675933',4,36,14,1,0,1,0,11,1,395,92,29298,30533,28807,1,33,7,1,0,1,0,7,375,103,26386,28349,21779,0,20,-11,2912,7,2184,7028,0,0,0,0,4
EUW1_6871853591',3,31,7,0,0,0,0,11,0,334,70,23847,26768,26443,4,30,16,1,0,1,0,2,393,128,32073,32937,34788,0,-59,-58,-8226,-9,-6169,-8345,-1,0,-1,0,9
EUW1_6869946510',3,38,15,2,1,1,0,7,1,398,76,30944,32819,34357,7,39,7,0,0,2,0,5,379,102,26240,29325,28628,1,19,-26,4704,8,3494,5729,2,1,-1,0,2
EUW1_6868892197',3,62,18,0,0,1,0,6,0,356,72,30579,31981,39627,2,70,18,1,0,0,0,8,347,98,30931,31247,43478,0,9,-26,-352,0,734,-3851,-1,0,1,0,-2
EUW1_6867249635',2,32,7,0,0,1,0,17,0,317,65,25224,26104,28942,2,31,16,2,1,3,0,4,353,91,31823,30130,32516,0,-36,-26,-6599,-9,-4026,-3574,-2,-1,-2,0,13
EUW1_6865487866',6,32,11,0,0,0,0,12,0,362,76,27408,29342,34111,7,100,20,1,0,1,0,3,337,89,31511,29628,40167,1,25,-13,-4103,-9,-286,-6056,-1,0,-1,0,9
EUW1_6864351106',7,36,11,0,1,1,0,13,0,313,85,26436,28401,32287,4,32,27,1,0,1,0,5,347,94,32620,32044,47399,0,-34,-9,-6184,-16,-3643,-15112,-1,1,0,0,8
EUW1_6862458745',7,26,14,0,0,1,0,11,1,355,81,29613,29677,39404,4,27,17,1,0,1,0,5,382,89,31480,30261,45638,1,-27,-8,-1867,-3,-584,-6234,-1,0,0,0,6
EUW1_6883017565',4,28,13,1,0,1,0,11,0,340,112,29844,30001,33130,6,57,17,1,0,0,0,6,307,81,27870,28390,33161,1,33,31,1974,-4,1611,-31,0,0,1,0,5
EUW1_6882488335',2,23,10,1,0,1,0,6,0,397,104,28150,31559,29424,1,91,9,0,0,1,0,7,315,72,24430,29782,21787,1,82,32,3720,1,1777,7637,1,0,0,0,-1
EUW1_6882472020',5,28,13,1,0,0,0,6,1,372,100,27465,31597,34824,2,13,5,0,0,0,0,1,377,59,23634,29106,28256,1,-5,41,3831,8,2491,6568,1,0,0,0,5
EUW1_6881203178',3,19,10,1,1,0,0,7,0,350,104,25489,30359,27369,4,29,12,1,0,1,0,1,375,88,27425,30109,25566,0,-25,16,-1936,-2,250,1803,0,1,-1,0,6
EUW1_6881067734',8,33,22,1,1,2,0,3,1,390,94,33327,31629,33593,1,27,12,0,0,0,0,6,343,86,27792,27952,28801,1,47,8,5535,10,3677,4792,1,1,2,0,-3
EUW1_6880965428',7,27,11,1,0,0,0,8,1,363,81,26263,30625,34595,4,23,14,1,0,0,0,1,337,86,26960,29881,27595,0,26,-5,-697,-3,744,7000,0,0,0,0,7
EUW1_6880900042',2,24,12,2,0,0,0,3,1,361,104,27940,32202,26442,4,35,9,0,0,0,0,3,370,113,25952,29646,28520,0,-9,-9,1988,3,2556,-2078,2,0,0,0,0
EUW1_6879461364',2,21,17,2,1,0,0,8,0,301,108,28542,30558,36006,4,28,10,0,0,1,0,2,295,92,26658,27333,28465,1,6,16,1884,7,3225,7541,2,1,-1,0,6
EUW1_6875228653',1,30,15,0,0,2,0,9,1,359,111,29173,31472,32449,2,25,10,1,0,0,0,7,279,60,24322,24774,30995,1,80,51,4851,5,6698,1454,-1,0,2,0,2
EUW1_6875178568',3,24,7,0,0,0,0,13,0,266,60,22574,23611,24607,3,30,19,2,1,4,0,3,352,88,31906,29376,37512,0,-86,-28,-9332,-12,-5765,-12905,-2,-1,-4,0,10
EUW1_6873963396',2,28,10,0,0,1,0,14,1,371,94,26598,31317,24586,2,31,9,2,0,2,0,1,368,86,26689,28603,26846,1,3,8,-91,1,2714,-2260,-2,0,-1,0,13
EUW1_6872408850',3,25,12,1,0,0,0,8,0,345,94,27049,29414,35463,3,29,14,0,0,0,0,3,331,82,28088,29065,33707,0,14,12,-1039,-2,349,1756,1,0,0,0,5
EUW1_6872383417',7,38,7,0,0,0,0,11,0,300,94,24489,27254,22647,9,99,14,1,0,2,0,4,325,94,27958,31146,29325,0,-25,0,-3469,-7,-3892,-6678,-1,0,-2,0,7
EUW1_6872377528',1,17,17,2,0,0,0,11,0,289,72,27921,28019,36287,3,423,12,0,0,1,0,0,362,72,27909,28981,31764,1,-73,0,12,5,-962,4523,2,0,-1,0,11
EUW1_6871359822',5,35,12,2,0,0,0,7,1,325,98,25675,28608,31021,6,28,8,0,0,0,0,3,345,61,24144,26692,29244,1,-20,37,1531,4,1916,1777,2,0,0,0,4
EUW1_6870223915',1,27,9,1,0,0,0,8,0,371,96,26835,29976,29333,5,21,15,1,0,0,0,4,367,68,27924,30212,34041,0,4,28,-1089,-6,-236,-4708,0,0,0,0,4
EUW1_6869531244',1,26,6,2,0,0,0,13,0,335,66,23579,27691,23540,6,31,22,0,0,2,0,1,358,81,31158,31803,39928,0,-23,-15,-7579,-16,-4112,-16388,2,0,-2,0,12
EUW1_6869421066',3,22,9,1,0,0,0,13,1,316,100,25345,27655,25377,6,30,13,1,0,2,0,1,382,93,28738,31250,36153,0,-66,7,-3393,-4,-3595,-10776,0,0,-2,0,12
EUW1_6869388271',4,24,14,2,0,0,0,5,1,340,82,26438,29245,37512,4,23,10,0,0,0,0,3,305,74,23649,27973,31771,1,35,8,2789,4,1272,5741,2,0,0,0,2
EUW1_6883506874',3,29,9,0,0,0,0,15,0,359,83,26010,27717,29135,0,47,18,1,0,2,0,2,412,88,31547,32342,36841,0,-53,-5,-5537,-9,-4625,-7706,-1,0,-2,0,13
EUW1_6883463025',0,24,21,1,0,2,0,7,1,354,100,32644,30819,33002,3,25,12,0,0,0,0,4,311,79,26500,27100,28722,1,43,21,6144,9,3719,4280,1,0,2,0,3
EUW1_6883414826',7,21,11,1,0,0,0,8,1,384,93,26015,29762,28325,5,30,16,1,1,1,0,0,344,98,29753,33126,33858,0,40,-5,-3738,-5,-3364,-5533,0,-1,-1,0,8
EUW1_6879265767',2,19,11,0,0,0,0,12,0,290,71,24924,27124,29845,2,19,22,2,0,4,0,0,373,94,33877,31334,44513,0,-83,-23,-8953,-11,-4210,-14668,-2,0,-4,0,12
EUW1_6879227093',1,43,6,0,0,1,0,11,1,315,79,25493,25900,25339,5,31,23,2,1,2,0,3,397,112,32590,35003,42216,0,-82,-33,-7097,-17,-9103,-16877,-2,-1,-1,0,8
EUW1_6879194898',5,318,17,0,0,1,0,11,0,325,67,29546,29072,36497,1,37,19,1,0,0,0,6,308,76,30219,28474,37207,0,17,-9,-673,-2,598,-710,-1,0,1,0,5
EUW1_6879146420',7,52,8,0,0,0,0,7,0,339,80,24850,26724,28616,6,24,17,2,0,1,0,1,385,79,28731,29391,35959,0,-46,1,-3881,-9,-2667,-7343,-2,0,-1,0,6
EUW1_6874658218',2,24,13,0,0,0,0,9,0,314,88,27165,31003,32190,5,42,17,2,0,0,0,1,345,94,29259,29612,37141,1,-31,-6,-2094,-4,1391,-4951,-2,0,0,0,8
EUW1_6874616459',3,25,16,1,0,1,0,5,1,366,101,29067,32451,42688,1,32,7,1,0,0,0,5,286,90,23464,26558,28761,1,80,11,5603,9,5893,13927,0,0,1,0,0
EUW1_6874547677',4,25,18,2,0,0,0,12,1,383,96,33597,32855,36923,6,23,20,0,0,3,0,7,322,78,31385,29357,34405,1,61,18,2212,-2,3498,2518,2,0,-3,0,5
EUW1_6867128863',5,30,13,0,0,1,0,5,0,368,90,28807,31705,33723,3,31,9,1,0,0,0,7,375,100,25446,30372,25521,1,-7,-10,3361,4,1333,8202,-1,0,1,0,-2
EUW1_6867084881',2,43,7,0,0,0,0,15,0,331,73,23614,26870,23639,7,33,19,1,1,2,0,0,391,120,32736,33370,36321,0,-60,-47,-9122,-12,-6500,-12682,-1,-1,-2,0,15
EUW1_6867033481',2,20,14,1,0,0,0,11,0,348,116,27753,32384,34564,1,24,11,1,0,1,0,5,382,95,27741,29749,37631,1,-34,21,12,3,2635,-3067,0,0,-1,0,6
EUW1_6866964947',0,21,14,0,0,0,0,8,1,333,85,28144,28777,37906,5,24,12,1,0,0,0,1,376,73,27573,29784,31878,0,-43,12,571,2,-1007,6028,-1,0,0,0,7
EUW1_6866896801',3,21,16,1,0,1,0,5,1,382,88,29180,30857,33315,10,45,12,1,1,0,0,0,408,102,28477,31175,29626,1,-26,-14,703,4,-318,3689,0,-1,1,0,5
EUW1_6866849024',3,27,8,0,0,1,0,10,0,389,84,25811,28645,30630,2,136,15,2,0,1,0,1,370,116,30344,32608,33785,0,19,-32,-4533,-7,-3963,-3155,-2,0,0,0,9
EUW1_6866712873',5,33,15,1,0,0,0,7,1,347,88,27463,29226,32898,2,36,7,1,0,0,0,2,387,82,24550,29175,26845,1,-40,6,2913,8,51,6053,0,0,0,0,5
EUW1_6866652747',4,30,11,0,0,1,0,6,1,365,77,26609,29208,32720,3,27,12,2,0,0,0,4,310,113,26815,30322,27517,0,55,-36,-206,-1,-1114,5203,-2,0,1,0,2
EUW1_6866595720',2,65,19,2,0,0,0,6,1,350,86,30313,29547,38949,4,24,12,0,0,0,0,2,334,73,26890,27603,36575,1,16,13,3423,7,1944,2374,2,0,0,0,4
EUW1_6866493144',2,60,10,0,0,1,0,13,0,333,93,26774,28038,29957,1,28,14,2,0,1,0,4,333,73,28249,28326,36301,0,0,20,-1475,-4,-288,-6344,-2,0,0,0,9
EUW1_6881673949',2,26,9,1,0,0,0,3,1,362,92,26658,29368,26387,3,31,13,1,0,1,0,4,371,84,27260,29809,32989,0,-9,8,-602,-4,-441,-6602,0,0,-1,0,-1
EUW1_6881421451',3,25,12,0,0,0,0,13,0,344,80,27965,29679,28876,6,26,17,1,0,1,0,7,395,92,30496,31593,32040,1,-51,-12,-2531,-5,-1914,-3164,-1,0,-1,0,6
EUW1_6881347605',2,23,11,0,0,1,0,10,0,347,82,27806,29545,31517,6,321,12,2,0,1,0,4,336,87,25840,28491,30309,0,11,-5,1966,-1,1054,1208,-2,0,0,0,6
EUW1_6879701793',5,23,10,0,0,1,0,6,0,376,88,28003,31629,29738,4,22,7,1,0,0,0,6,365,96,23891,29350,25763,1,11,-8,4112,3,2279,3975,-1,0,1,0,0
EUW1_6878375584',9,35,10,0,0,1,0,8,1,360,87,27224,28677,30529,8,32,18,2,1,0,0,3,385,112,31003,34130,33103,0,-25,-25,-3779,-8,-5453,-2574,-2,-1,1,0,5
EUW1_6878167846',2,58,11,0,0,0,0,12,0,339,102,26419,30581,29821,3,60,16,2,0,0,0,0,353,86,28953,30632,33318,1,-14,16,-2534,-5,-51,-3497,-2,0,0,0,12
EUW1_6878085680',7,56,14,1,0,2,0,6,1,396,82,29462,31081,35270,6,100,8,1,0,0,0,2,295,82,23277,27494,24023,1,101,0,6185,6,3587,11247,0,0,2,0,4
EUW1_6878045863',3,24,14,1,0,1,0,6,0,362,80,28654,28099,33125,7,38,13,0,0,1,0,7,356,76,28055,30128,27163,1,6,4,599,1,-2029,5962,1,0,0,0,-1
EUW1_6869531105',2,18,9,0,0,0,0,8,0,402,90,26174,30427,25111,6,39,12,2,0,2,0,3,402,92,29505,32969,26747,1,0,-2,-3331,-3,-2542,-1636,-2,0,-2,0,5
EUW1_6869491320',4,37,16,2,0,1,0,8,1,323,90,29666,28134,36969,4,31,12,0,1,0,0,6,291,88,25700,27025,30794,1,32,2,3966,4,1109,6175,2,-1,1,0,2
EUW1_6868699438',5,52,15,2,0,2,0,3,0,365,104,30049,32066,35271,3,30,11,0,0,0,0,5,389,76,25870,31130,29051,0,-24,28,4179,4,936,6220,2,0,2,0,-2
EUW1_6881448353',4,24,9,1,0,0,0,12,0,350,91,25872,29936,31796,6,28,13,0,0,1,0,2,389,112,29959,31597,31896,1,-39,-21,-4087,-4,-1661,-100,1,0,-1,0,10
EUW1_6881395988',1,24,8,0,0,2,0,15,0,334,63,26469,28321,30866,5,31,18,2,1,2,0,7,346,92,30675,30844,32774,0,-12,-29,-4206,-10,-2523,-1908,-2,-1,0,0,8
EUW1_6881354605',4,35,5,0,1,0,0,9,0,336,103,23907,29319,27797,3,26,11,2,0,2,0,5,396,75,28114,30482,32219,0,-60,28,-4207,-6,-1163,-4422,-2,1,-2,0,4
EUW1_6881297244',4,32,13,0,1,0,0,8,0,303,93,26662,29691,28901,6,32,9,2,0,1,0,2,372,109,27379,29550,28194,0,-69,-16,-717,4,141,707,-2,1,-1,0,6
EUW1_6881237107',4,32,17,2,0,3,0,12,0,346,106,30115,30885,34993,4,30,16,0,1,2,0,7,325,85,31309,31590,36584,1,21,21,-1194,1,-705,-1591,2,-1,1,0,5
EUW1_6881189968',3,27,6,0,0,0,0,10,0,348,91,24961,29677,30718,4,22,20,1,1,1,0,1,378,112,31096,33595,43850,0,-30,-21,-6135,-14,-3918,-13132,-1,-1,-1,0,9
EUW1_6881035444',3,24,18,0,0,1,0,12,0,311,98,30511,30339,35638,4,27,11,2,0,1,0,4,369,102,27615,29765,28608,1,-58,-4,2896,7,574,7030,-2,0,0,0,8
EUW1_6881000432',4,34,10,1,0,0,0,10,0,344,83,25894,28396,26883,1,22,15,1,0,2,0,6,363,84,30740,32478,33897,0,-19,-1,-4846,-5,-4082,-7014,0,0,-2,0,4
EUW1_6880972079',2,24,5,0,0,0,0,12,0,333,80,22933,27390,24942,5,24,18,2,0,2,0,1,346,82,30903,32166,32229,1,-13,-2,-7970,-13,-4776,-7287,-2,0,-2,0,11
EUW1_6877044292',8,35,11,0,0,1,0,10,1,400,104,28979,31870,25355,5,133,7,2,0,1,0,2,430,92,26561,30965,25405,0,-30,12,2418,4,905,-50,-2,0,0,0,8
EUW1_6876986560',7,34,17,1,0,0,0,11,0,322,76,28552,27664,34130,5,130,17,0,0,1,0,2,338,94,30406,29990,34550,1,-16,-18,-1854,0,-2326,-420,1,0,-1,0,9
EUW1_6876927629',2,23,16,0,0,1,0,7,1,355,74,29468,28251,34415,1,138,18,1,0,1,0,5,349,85,29760,30082,34740,0,6,-11,-292,-2,-1831,-325,-1,0,0,0,2
EUW1_6876851422',3,33,16,0,0,0,0,10,0,358,80,28072,30495,29611,2,32,14,1,0,1,0,3,346,94,27335,30577,31909,0,12,-14,737,2,-82,-2298,-1,0,-1,0,7
EUW1_6876802393',3,30,13,2,0,0,0,8,1,318,93,27658,30617,29551,6,28,13,0,0,0,0,3,361,102,28119,31312,35337,0,-43,-9,-461,0,-695,-5786,2,0,0,0,5
EUW1_6876753638',4,27,15,1,0,1,0,11,1,303,86,27222,29834,35933,4,31,8,1,0,0,0,2,357,82,25764,28623,35545,0,-54,4,1458,7,1211,388,0,0,1,0,9
EUW1_6874436250',2,31,23,0,0,0,0,10,1,284,105,30777,29998,46157,6,35,19,1,0,1,0,4,348,62,31383,29242,36184,1,-64,43,-606,4,756,9973,-1,0,-1,0,6
EUW1_6874372678',4,27,11,1,0,0,0,10,1,312,90,26579,26609,37838,5,38,18,0,0,1,0,3,344,61,29679,30499,44110,1,-32,29,-3100,-7,-3890,-6272,1,0,-1,0,7
EUW1_6874326014',3,31,16,0,0,0,0,12,1,298,100,29344,29191,36926,3,26,21,2,0,2,0,3,367,70,32783,32051,40608,0,-69,30,-3439,-5,-2860,-3682,-2,0,-2,0,9
EUW1_6874270710',7,33,9,0,0,0,0,15,0,346,88,24201,28059,22566,2,30,10,1,0,2,0,2,413,80,27607,31224,24282,0,-67,8,-3406,-1,-3165,-1716,-1,0,-2,0,13
EUW1_6871995773',4,131,16,2,0,0,0,5,0,365,92,28063,32930,33437,2,23,12,0,0,1,0,5,399,92,28386,31810,35564,0,-34,0,-323,4,1120,-2127,2,0,-1,0,0
EUW1_6880288057',6,33,10,1,1,1,0,13,0,307,101,26408,26631,31077,4,32,22,1,0,2,0,5,361,54,31598,30264,39921,0,-54,47,-5190,-12,-3633,-8844,0,1,-1,0,8
EUW1_6880061543',5,29,11,1,0,0,0,12,0,340,96,26627,28861,31335,5,26,12,0,0,1,0,2,376,92,27948,30034,31198,1,-36,4,-1321,-1,-1173,137,1,0,-1,0,10
EUW1_6880016507',2,24,19,1,0,1,0,11,1,329,95,30409,30872,32575,3,32,12,1,0,1,0,7,366,92,28096,29424,30506,1,-37,3,2313,7,1448,2069,0,0,0,0,4
EUW1_6879842492',7,21,18,1,0,0,0,14,0,333,81,29495,30575,36160,3,30,13,1,0,1,0,4,357,96,30214,29751,34668,0,-24,-15,-719,5,824,1492,0,0,-1,0,10
EUW1_6879545533',2,21,11,0,0,0,0,7,1,326,80,25686,27136,27512,3,35,9,1,0,0,0,1,368,94,26449,29913,31904,0,-42,-14,-763,2,-2777,-4392,-1,0,0,0,6
EUW1_6879523816',5,24,6,0,0,0,0,9,1,319,88,23531,27064,25448,6,25,17,2,0,2,0,2,356,88,30463,31796,35851,0,-37,0,-6932,-11,-4732,-10403,-2,0,-2,0,7
EUW1_6878660432',3,27,5,1,0,1,0,9,0,385,81,25252,28623,30466,3,33,16,1,0,2,0,5,359,81,29348,31430,31603,0,26,0,-4096,-11,-2807,-1137,0,0,-1,0,4
EUW1_6878611049',7,36,13,2,0,0,0,10,0,304,75,25915,28547,29448,3,25,10,0,0,1,0,2,373,72,26489,28775,33760,0,-69,3,-574,3,-228,-4312,2,0,-1,0,8
EUW1_6878426270',5,29,20,1,0,2,0,7,1,363,100,32211,30922,36559,3,27,17,1,0,0,0,7,321,92,28625,28980,40664,1,42,8,3586,3,1942,-4105,0,0,2,0,0
EUW1_6878323847',2,21,13,0,0,1,0,7,0,357,72,27704,28010,32775,1,87,17,2,1,2,0,7,327,100,30839,31218,35716,0,30,-28,-3135,-4,-3208,-2941,-2,-1,-1,0,0
EUW1_6878180609',3,24,8,0,1,0,0,10,0,332,81,24133,27554,25322,4,24,11,2,0,1,0,3,366,94,27146,29010,30317,0,-34,-13,-3013,-3,-1456,-4995,-2,1,-1,0,7
EUW1_6877574048',1,27,10,1,0,0,0,7,0,376,93,27424,30957,31002,3,28,11,0,0,0,0,7,340,74,26256,28519,30199,1,36,19,1168,-1,2438,803,1,0,0,0,0
EUW1_6877502669',7,39,10,0,0,0,0,5,0,332,98,25842,28421,28797,7,26,9,1,0,0,0,3,312,86,24871,27451,25467,0,20,12,971,1,970,3330,-1,0,0,0,2
EUW1_6877465761',2,56,13,2,0,3,0,7,1,361,86,30362,31892,23448,3,61,8,0,0,0,0,12,313,101,23874,28025,25186,1,48,-15,6488,5,3867,-1738,2,0,3,0,-5
EUW1_6876701110',2,26,16,1,0,2,0,10,1,400,82,30710,31895,35539,2,23,7,1,0,0,0,6,353,94,24884,27988,29702,1,47,-12,5826,9,3907,5837,0,0,2,0,4
EUW1_6876619901',3,29,9,1,0,1,0,8,0,309,82,25797,25002,34373,2,24,24,0,0,2,0,3,342,90,31982,30968,43482,0,-33,-8,-6185,-15,-5966,-9109,1,0,-1,0,5
EUW1_6777700801',5,33,26,1,0,2,0,5,1,335,101,36266,30335,48336,2,110,13,0,0,1,0,12,273,74,26101,25429,34870,1,62,27,10165,13,4906,13466,1,0,1,0,-7
EUW1_6777646488',4,27,18,1,1,0,0,9,0,332,81,28346,28590,35351,1,23,10,0,0,0,0,2,341,78,26209,27345,28660,0,-9,3,2137,8,1245,6691,1,1,0,0,7
EUW1_6777577644',3,27,12,1,0,0,0,13,0,334,82,27694,28086,29630,8,39,10,1,0,1,0,2,311,73,26072,25545,32363,0,23,9,1622,2,2541,-2733,0,0,-1,0,11
EUW1_6774613663',3,26,14,0,0,3,0,8,1,335,80,30125,29801,28970,2,32,4,2,0,0,0,8,331,112,23666,28034,21759,0,4,-32,6459,10,1767,7211,-2,0,3,0,0
EUW1_6774561513',3,38,9,0,1,0,0,10,0,345,71,25322,30248,31336,5,26,21,1,0,0,0,1,327,100,29108,31237,33234,0,18,-29,-3786,-12,-989,-1898,-1,1,0,0,9
EUW1_6774057514',4,23,17,2,1,0,0,5,1,375,108,29057,33054,30040,7,93,7,0,0,0,0,4,372,104,25213,30404,26936,1,3,4,3844,10,2650,3104,2,1,0,0,1
EUW1_6774005174',2,36,4,0,0,0,0,11,0,364,95,24672,28190,29540,4,64,18,1,0,1,0,5,380,84,30668,32181,32365,0,-16,11,-5996,-14,-3991,-2825,-1,0,-1,0,6
EUW1_6773240723',2,145,17,0,1,1,0,6,1,369,106,31297,32655,37084,3,29,16,1,0,0,0,5,348,88,29671,29838,26836,0,21,18,1626,1,2817,10248,-1,1,1,0,1
EUW1_6883062980',7,30,17,2,0,1,0,7,1,340,120,29512,31699,31016,4,48,5,0,0,1,0,5,373,80,25287,27547,25241,1,-33,40,4225,12,4152,5775,2,0,0,0,2
EUW1_6882994897',4,32,26,0,1,1,0,8,1,349,109,35624,31992,42222,4,32,16,1,0,2,0,9,292,90,27019,26642,28983,1,57,19,8605,10,5350,13239,-1,1,-1,0,-1
EUW1_6882938456',2,33,11,2,1,1,0,9,1,385,104,28577,32075,30709,6,30,7,0,0,0,0,5,369,95,25796,29731,24053,0,16,9,2781,4,2344,6656,2,1,1,0,4
EUW1_6882883049',3,41,20,1,0,0,0,5,1,331,91,28216,30090,41066,4,31,14,1,0,0,0,2,302,91,27225,28726,34607,0,29,0,991,6,1364,6459,0,0,0,0,3
EUW1_6882850187',7,32,19,1,0,3,0,4,0,395,103,32852,33096,38751,4,43,10,1,0,0,0,9,316,71,22647,26687,26924,1,79,32,10205,9,6409,11827,0,0,3,0,-5
EUW1_6882808650',3,32,7,1,0,0,0,5,0,366,80,25330,29635,24299,1,31,9,1,0,0,0,3,379,98,25783,28581,27338,1,-13,-18,-453,-2,1054,-3039,0,0,0,0,2
EUW1_6882771719',3,23,11,0,0,0,0,15,1,302,86,25602,25975,31782,6,31,21,2,1,3,0,2,334,106,32822,32191,42016,0,-32,-20,-7220,-10,-6216,-10234,-2,-1,-3,0,13
EUW1_6882690530',0,255,9,0,0,0,0,10,0,356,102,25547,29660,28995,4,74,10,2,0,1,0,0,337,100,26636,29479,32694,0,19,2,-1089,-1,181,-3699,-2,0,-1,0,10
EUW1_6882662537',3,27,7,0,0,0,0,13,1,324,85,24317,26645,23279,6,28,21,2,0,3,0,0,408,106,34333,33427,36191,0,-84,-21,-10016,-14,-6782,-12912,-2,0,-3,0,13
EUW1_6882598176',4,22,11,0,1,1,0,7,1,357,98,29458,31272,28258,3,28,10,2,0,0,0,8,364,97,26253,30851,25186,0,-7,1,3205,1,421,3072,-2,1,1,0,-1
EUW1_6881764004',6,156,15,1,0,1,0,5,1,341,114,28820,31330,33858,1,17,6,0,0,0,0,4,374,65,24110,28919,24660,1,-33,49,4710,9,2411,9198,1,0,1,0,1
EUW1_6881650241',3,25,7,1,0,0,0,8,0,364,78,24015,26787,28595,4,24,15,0,0,1,0,2,360,87,28933,30207,32403,0,4,-9,-4918,-8,-3420,-3808,1,0,-1,0,6
EUW1_6881606849',4,32,14,0,0,0,0,7,1,330,83,28018,29554,34183,5,27,21,1,0,1,0,4,363,88,31064,32843,45476,0,-33,-5,-3046,-7,-3289,-11293,-1,0,-1,0,3
EUW1_6881552929',7,30,10,0,0,0,0,7,1,362,58,26155,27376,37728,5,29,13,2,0,1,0,4,334,82,26945,30197,29684,0,28,-24,-790,-3,-2821,8044,-2,0,-1,0,3
EUW1_6880969559',5,32,10,0,0,0,0,9,0,362,86,26836,27688,35862,4,42,9,1,0,1,0,4,365,82,26207,29063,24065,1,-3,4,629,1,-1375,11797,-1,0,-1,0,5
EUW1_6880929009',4,116,17,1,0,1,0,12,0,343,110,30852,30855,34995,4,38,12,0,0,2,0,5,325,82,28996,28528,33763,1,18,28,1856,5,2327,1232,1,0,-1,0,7
EUW1_6880536342',3,24,7,1,0,1,0,10,0,325,104,26633,27824,27734,3,27,15,1,0,2,0,10,324,93,29138,28739,30597,0,1,11,-2505,-8,-915,-2863,0,0,-1,0,0
EUW1_6880044025',1,31,20,2,0,1,0,3,1,390,91,32231,31790,37355,5,32,11,0,0,0,0,10,315,80,25025,27851,33657,1,75,11,7206,9,3939,3698,2,0,1,0,-7
EUW1_6879988256',7,32,10,0,0,0,0,12,0,350,73,25397,27301,30782,5,29,15,2,0,3,0,2,364,106,30449,28915,29313,0,-14,-33,-5052,-5,-1614,1469,-2,0,-3,0,10
EUW1_6874145226',2,34,14,0,0,0,0,9,1,359,102,28424,29183,42088,5,25,20,2,1,1,0,4,342,89,30943,29269,41148,0,17,13,-2519,-6,-86,940,-2,-1,-1,0,5
EUW1_6874105440',7,31,13,1,1,2,0,7,1,373,96,30045,30531,36262,4,36,8,1,0,0,0,9,395,96,27431,30434,32554,1,-22,0,2614,5,97,3708,0,1,2,0,-2
EUW1_6874019804',8,44,6,2,0,0,0,11,0,414,114,26435,31152,21733,6,65,10,0,0,1,0,4,433,109,28211,32324,23855,0,-19,5,-1776,-4,-1172,-2122,2,0,-1,0,7
EUW1_6873989870',4,22,7,0,0,0,0,8,0,377,82,24266,30620,22836,4,28,17,1,0,0,0,1,377,105,30252,30934,38692,0,0,-23,-5986,-10,-314,-15856,-1,0,0,0,7
EUW1_6869961419',2,26,5,0,0,0,0,9,0,401,103,24151,29766,27480,3,29,9,1,0,1,0,1,420,111,27870,32444,37101,0,-19,-8,-3719,-4,-2678,-9621,-1,0,-1,0,8
EUW1_6869903835',4,29,13,1,1,0,0,8,0,403,106,28872,31224,31608,5,38,10,1,0,1,0,4,391,110,27449,31120,24981,1,12,-4,1423,3,104,6627,0,1,-1,0,4
EUW1_6866697187',6,27,4,0,0,0,0,8,0,387,100,23933,30105,21713,2,26,3,1,0,0,0,0,408,96,23746,31109,25829,0,-21,4,187,1,-1004,-4116,-1,0,0,0,8
EUW1_6853475472',3,32,12,1,0,1,0,8,0,331,62,27673,26862,41185,3,31,18,0,0,0,0,4,317,84,28479,28891,39463,1,14,-22,-806,-6,-2029,1722,1,0,1,0,4
EUW1_6853434736',3,27,17,2,0,0,0,5,1,382,72,29697,31095,35525,4,27,11,0,0,0,0,5,347,78,25721,27763,27918,1,35,-6,3976,6,3332,7607,2,0,0,0,0
EUW1_6852225165',4,26,8,1,0,0,0,14,0,320,66,24183,26170,32492,1,36,24,0,0,2,0,1,355,82,33541,32999,40735,0,-35,-16,-9358,-16,-6829,-8243,1,0,-2,0,13
EUW1_6882361169',1,44,11,1,0,1,0,5,1,354,90,27915,30195,27915,1,23,13,1,0,0,0,5,326,101,25436,29937,29666,0,28,-11,2479,-2,258,-1751,0,0,1,0,0
EUW1_6880558430',6,25,14,1,0,0,0,14,1,370,87,28341,28739,31509,2,23,15,0,0,2,0,7,333,74,30257,30352,34166,0,37,13,-1916,-1,-1613,-2657,1,0,-2,0,7
EUW1_6880500804',5,28,4,1,1,0,0,9,0,382,86,23811,27871,24559,4,123,7,1,0,0,0,2,359,89,25165,27880,22822,0,23,-3,-1354,-3,-9,1737,0,1,0,0,7
EUW1_6877400294',3,26,8,0,0,0,0,9,0,356,92,25498,28894,26219,6,30,14,2,0,2,0,2,362,108,29383,32001,35529,0,-6,-16,-3885,-6,-3107,-9310,-2,0,-2,0,7
EUW1_6876388786',3,27,6,0,0,0,0,6,0,356,105,25155,28823,24002,7,32,19,2,1,1,0,3,346,90,28787,32006,31953,0,10,15,-3632,-13,-3183,-7951,-2,-1,-1,0,3
EUW1_6876236418',1,26,9,0,0,0,0,10,1,380,109,26984,30104,30337,0,21,11,1,0,2,0,5,391,60,27203,30847,25388,1,-11,49,-219,-2,-743,4949,-1,0,-2,0,5
EUW1_6875282747',3,28,17,0,1,0,0,10,0,362,124,30806,32079,31733,2,26,19,1,0,1,0,3,384,79,32003,30584,40266,1,-22,45,-1197,-2,1495,-8533,-1,1,-1,0,7
EUW1_6875244894',5,36,18,2,0,0,0,8,0,293,68,28400,27013,39052,3,45,18,0,0,0,0,6,334,86,30152,28778,41413,0,-41,-18,-1752,0,-1765,-2361,2,0,0,0,2
EUW1_6875176256',3,69,4,0,0,1,0,12,1,313,107,24489,24875,18102,4,70,17,2,1,2,0,6,350,106,31077,29987,33562,0,-37,1,-6588,-13,-5112,-15460,-2,-1,-1,0,6
EUW1_6822516022',1,74,19,0,0,0,0,7,1,388,75,29735,32262,36530,3,17,14,2,0,2,0,3,356,101,28279,29490,29596,0,32,-26,1456,5,2772,6934,-2,0,-2,0,4
EUW1_6822495236',0,25,22,1,0,2,0,7,0,345,102,32898,33745,40093,4,39,8,0,0,0,0,9,322,91,24716,27509,30753,1,23,11,8182,14,6236,9340,1,0,2,0,-2
EUW1_6822461988',5,40,10,0,1,0,0,9,1,370,115,27678,31785,29034,5,154,8,2,0,1,0,2,400,100,27416,29314,27951,1,-30,15,262,2,2471,1083,-2,1,-1,0,7
EUW1_6822432211',7,40,14,1,1,1,0,13,0,339,64,27850,28867,31334,2,71,14,0,0,1,0,4,338,84,29700,29499,36529,1,1,-20,-1850,0,-632,-5195,1,1,0,0,9
EUW1_6819809473',3,66,8,2,1,0,0,14,0,352,90,25817,29549,33809,4,141,20,0,0,1,0,3,375,93,30941,32583,41400,1,-23,-3,-5124,-12,-3034,-7591,2,1,-1,0,11
EUW1_6805040057',6,55,14,0,1,1,0,10,1,347,106,29234,31509,40480,4,48,14,2,0,1,0,1,343,81,28129,28730,28620,0,4,25,1105,0,2779,11860,-2,1,0,0,9
EUW1_6805020186',5,30,5,1,0,2,0,11,1,360,82,25277,27309,29440,3,113,8,1,0,2,0,5,362,97,27745,29980,35349,1,-2,-15,-2468,-3,-2671,-5909,0,0,0,0,6
EUW1_6805007335',3,28,13,1,0,2,0,10,0,385,116,30054,31088,37011,3,75,11,1,0,0,0,6,298,91,27347,29409,38157,1,87,25,2707,2,1679,-1146,0,0,2,0,4
EUW1_6800841276',0,81,8,0,0,0,0,14,1,294,88,24493,24923,25654,5,59,22,1,0,1,0,1,348,92,31909,29186,33656,0,-54,-4,-7416,-14,-4263,-8002,-1,0,-1,0,13
EUW1_6800819435',2,42,15,1,0,1,0,11,1,376,86,30596,30755,34680,6,47,16,0,1,2,0,4,300,85,29499,27986,29587,0,76,1,1097,-1,2769,5093,1,-1,-1,0,7
EUW1_6800814458',3,25,26,2,0,3,0,11,1,359,87,33753,33186,47232,2,53,6,0,0,0,0,6,335,83,24490,27414,30434,1,24,4,9263,20,5772,16798,2,0,3,0,5
EUW1_6800772384',7,29,8,0,0,0,0,3,0,400,95,26153,30514,25837,2,48,6,2,0,0,0,3,357,96,23701,28482,27671,1,43,-1,2452,2,2032,-1834,-2,0,0,0,0
EUW1_6800752735',5,38,7,0,0,1,0,9,1,394,98,26275,29934,30829,7,101,9,1,0,1,0,2,412,91,28488,31370,24640,0,-18,7,-2213,-2,-1436,6189,-1,0,0,0,7
EUW1_6800717272',2,41,11,1,0,0,0,14,1,355,80,26989,29052,30446,6,31,22,1,0,3,0,1,413,106,34450,33758,38678,0,-58,-26,-7461,-11,-4706,-8232,0,0,-3,0,13
EUW1_6800682375',5,35,11,0,0,0,0,8,0,351,116,26682,30143,28681,6,29,11,2,1,1,0,4,407,92,29077,31330,29371,0,-56,24,-2395,0,-1187,-690,-2,-1,-1,0,4
EUW1_6800646382',5,45,13,1,0,0,0,12,0,334,92,28455,29556,38239,6,98,23,1,0,1,0,2,327,99,33026,32796,44675,0,7,-7,-4571,-10,-3240,-6436,0,0,-1,0,10
EUW1_6849533997',2,26,12,1,0,0,0,8,1,332,96,27360,29663,31407,5,27,11,0,0,1,0,3,344,84,26270,28254,32028,1,-12,12,1090,1,1409,-621,1,0,-1,0,5
EUW1_6849474104',3,25,10,1,1,0,0,10,0,381,104,27509,29649,29140,5,89,12,1,0,1,0,3,350,83,27210,29905,25352,0,31,21,299,-2,-256,3788,0,1,-1,0,7
EUW1_6845656257',5,32,12,0,1,1,0,11,0,355,103,29458,28686,36169,1,23,20,2,0,0,0,7,326,88,31202,30902,36469,0,29,15,-1744,-8,-2216,-300,-2,1,1,0,4
EUW1_6837293037',2,73,8,0,0,2,0,8,0,358,87,26464,29525,28068,4,21,14,2,0,1,0,2,325,90,27512,29250,37148,1,33,-3,-1048,-6,275,-9080,-2,0,1,0,6
EUW1_6837213445',4,26,13,0,0,1,0,8,0,366,92,29369,30929,32757,6,31,8,1,0,0,0,5,355,80,25470,27335,28611,1,11,12,3899,5,3594,4146,-1,0,1,0,3
EUW1_6837134228',3,23,13,0,0,1,0,10,1,341,87,29379,28901,30706,2,124,21,2,0,0,0,6,348,82,30056,30689,38686,1,-7,5,-677,-8,-1788,-7980,-2,0,1,0,4
EUW1_6836732322',3,31,12,0,0,0,0,5,1,396,99,28410,31408,31765,3,58,4,1,0,2,0,3,371,97,24490,27590,23326,0,25,2,3920,8,3818,8439,-1,0,-2,0,2
EUW1_6836709088',4,26,6,0,0,0,0,13,0,357,83,24119,27541,19561,3,25,16,2,0,3,0,3,415,98,31584,31888,27294,0,-58,-15,-7465,-10,-4347,-7733,-2,0,-3,0,10
EUW1_6836673421',5,28,11,1,0,2,0,10,1,383,98,29030,31315,31221,5,28,11,0,0,0,0,8,375,85,26786,31251,29873,1,8,13,2244,0,64,1348,1,0,2,0,2
EUW1_6836115772',9,148,8,0,0,1,0,3,0,390,84,26316,29681,26506,4,44,5,2,0,0,0,2,405,91,24587,29008,24269,1,-15,-7,1729,3,673,2237,-2,0,1,0,1
EUW1_6836008941',6,30,9,1,0,0,0,11,0,374,83,26008,28287,25528,0,22,11,0,1,3,0,2,361,84,27467,29036,24498,0,13,-1,-1459,-2,-749,1030,1,-1,-3,0,9
EUW1_6835424105',3,28,8,0,0,1,0,12,0,385,98,26770,30346,28010,8,31,13,2,0,2,0,4,388,86,29136,30246,32565,1,-3,12,-2366,-5,100,-4555,-2,0,-1,0,8
EUW1_6835379430',2,29,20,0,0,1,0,14,1,356,64,31053,31076,41346,4,26,13,2,0,1,0,2,347,100,27723,29758,42777,1,9,-36,3330,7,1318,-1431,-2,0,0,0,12
EUW1_6863570323',6,28,20,2,0,1,0,8,0,365,84,30249,30744,32818,2,143,14,0,0,1,0,1,331,91,28779,30919,33593,1,34,-7,1470,6,-175,-775,2,0,0,0,7
EUW1_6846395265',3,25,14,0,0,0,0,10,0,349,88,27468,30307,36671,6,32,12,2,0,1,0,2,347,96,28326,29306,32034,0,2,-8,-858,2,1001,4637,-2,0,-1,0,8
EUW1_6839270514',10,30,13,0,0,2,0,6,0,377,83,30268,29744,28117,1,56,10,1,0,1,0,10,309,104,26183,28170,32795,1,68,-21,4085,3,1574,-4678,-1,0,1,0,-4
EUW1_6839254833',4,30,11,1,0,0,0,13,0,327,90,25987,29737,28799,5,32,17,1,0,3,0,0,388,95,32335,31843,41832,0,-61,-5,-6348,-6,-2106,-13033,0,0,-3,0,13
EUW1_6837067226',2,128,13,1,0,0,0,11,0,323,75,26932,28411,40964,2,97,16,0,0,2,0,1,348,84,30718,32258,32694,0,-25,-9,-3786,-3,-3847,8270,1,0,-2,0,10
EUW1_6834618395',4,24,15,1,0,1,0,8,1,360,72,29058,29778,33205,6,31,10,0,0,0,0,1,373,88,27147,29232,30487,0,-13,-16,1911,5,546,2718,1,0,1,0,7
EUW1_6833796278',4,18,7,1,0,0,0,7,0,333,88,26056,29391,23709,3,27,20,1,0,0,0,3,357,103,30516,32548,35190,0,-24,-15,-4460,-13,-3157,-11481,0,0,0,0,4
EUW1_6833794639',1,26,14,0,0,0,0,13,0,282,80,27759,26305,34893,4,30,24,2,0,1,0,2,315,96,31934,29693,44148,0,-33,-16,-4175,-10,-3388,-9255,-2,0,-1,0,11
EUW1_6833243309',3,18,3,0,0,0,0,6,0,385,86,24498,27645,29101,3,27,16,1,0,1,0,5,348,86,28382,29883,35106,1,37,0,-3884,-13,-2238,-6005,-1,0,-1,0,1
EUW1_6810952615',7,28,7,1,0,0,0,15,0,288,58,22781,24276,20008,3,25,29,0,0,5,0,1,390,109,38799,34611,48835,0,-102,-51,-16018,-22,-10335,-28827,1,0,-5,0,14
EUW1_6810858389',5,31,7,1,0,0,0,7,0,304,102,24102,27970,23515,6,34,12,1,0,0,0,0,385,86,28749,28687,28292,1,-81,16,-4647,-5,-717,-4777,0,0,0,0,7
EUW1_6810802442',3,27,12,1,0,0,0,6,0,343,110,28412,28155,32117,3,33,12,1,0,1,0,4,356,94,26824,29980,29285,1,-13,16,1588,0,-1825,2832,0,0,-1,0,2
EUW1_6810560111',4,29,15,2,0,1,0,8,0,387,81,29814,30393,36099,3,22,12,0,1,2,0,3,328,106,27635,29573,31685,0,59,-25,2179,3,820,4414,2,-1,-1,0,5
EUW1_6810483371',4,37,20,2,0,0,0,8,0,373,86,30224,31094,32688,3,152,15,0,0,0,0,1,361,82,28800,29565,36384,0,12,4,1424,5,1529,-3696,2,0,0,0,7
EUW1_6810398464',10,73,13,1,1,0,0,11,0,310,99,27471,28148,35444,5,64,10,1,0,1,0,2,329,100,26966,26933,24430,1,-19,-1,505,3,1215,11014,0,1,-1,0,9
EUW1_6810317744',7,34,9,1,0,1,0,7,0,403,64,26974,28868,31609,8,39,9,0,0,0,0,4,387,84,26899,28780,29647,0,16,-20,75,0,88,1962,1,0,1,0,3
EUW1_6810283932',6,38,6,0,0,0,0,14,0,355,69,23789,27269,21803,5,111,15,1,1,2,0,0,362,107,30935,31898,33112,0,-7,-38,-7146,-9,-4629,-11309,-1,-1,-2,0,14
EUW1_6809773951',3,29,11,0,0,1,0,8,1,391,90,28639,30056,24873,3,24,4,2,0,1,0,5,380,87,24557,27457,27499,1,11,3,4082,7,2599,-2626,-2,0,0,0,3
EUW1_6809693250',10,38,8,1,0,0,0,6,1,386,91,26935,29189,21629,3,39,9,1,0,1,0,2,434,107,29163,32899,24017,1,-48,-16,-2228,-1,-3710,-2388,0,0,-1,0,4
EUW1_6809619227',1,28,9,2,0,1,0,9,0,325,94,26140,29448,34020,6,46,11,0,0,1,0,6,338,86,26865,28744,32732,1,-13,8,-725,-2,704,1288,2,0,0,0,3
EUW1_6809557756',4,29,11,1,0,0,0,5,0,361,84,27227,28768,30337,4,23,11,1,0,0,0,6,384,95,26975,30669,30711,0,-23,-11,252,0,-1901,-374,0,0,0,0,-1
EUW1_6809472122',8,33,9,1,0,0,0,5,0,376,105,26872,30239,28729,5,33,14,0,0,0,0,4,352,71,27453,28857,30065,1,24,34,-581,-5,1382,-1336,1,0,0,0,1
EUW1_6809393419',2,29,7,2,0,0,0,7,0,366,90,25536,29517,28694,4,114,12,0,0,0,0,1,354,93,27450,30986,26874,0,12,-3,-1914,-5,-1469,1820,2,0,0,0,6
EUW1_6809202240',1,27,16,0,0,1,0,9,1,398,110,30960,32745,29682,2,43,13,2,0,0,0,5,342,96,28011,28638,34445,1,56,14,2949,3,4107,-4763,-2,0,1,0,4
EUW1_6809150994',6,42,17,1,0,1,0,7,1,436,94,32135,31926,33390,7,69,9,0,0,0,0,3,384,71,27476,29118,25460,1,52,23,4659,8,2808,7930,1,0,1,0,4
EUW1_6809105495',4,26,13,0,1,0,0,12,0,307,89,26549,27270,31383,2,33,16,2,0,2,0,2,365,86,31960,29543,40263,0,-58,3,-5411,-3,-2273,-8880,-2,1,-2,0,10
EUW1_6809045971',4,25,12,2,1,1,0,8,0,362,104,30108,30754,33064,4,46,13,0,0,1,0,5,337,91,26798,28673,25875,1,25,13,3310,-1,2081,7189,2,1,0,0,3
EUW1_6808955305',3,38,13,1,0,2,0,7,1,392,86,30056,30245,31029,7,38,10,0,0,0,0,7,306,69,25510,28418,31624,1,86,17,4546,3,1827,-595,1,0,2,0,0
EUW1_6808893635',8,31,16,0,0,0,0,10,1,360,76,28251,30501,37549,4,41,11,2,0,1,0,4,343,106,28769,29127,31194,0,17,-30,-518,5,1374,6355,-2,0,-1,0,6
EUW1_6882857049',4,32,7,1,0,1,0,6,1,350,104,26739,25996,30650,8,80,15,0,0,0,0,5,330,67,27785,28994,30655,0,20,37,-1046,-8,-2998,-5,1,0,1,0,1
EUW1_6882630056',6,27,23,2,0,1,0,13,0,335,90,33427,31155,41536,6,29,23,0,0,2,0,7,334,82,34339,30882,51218,0,1,8,-912,0,273,-9682,2,0,-1,0,6
EUW1_6880051937',3,24,5,0,0,0,0,11,0,331,84,23793,27362,28440,4,29,16,2,0,3,0,1,396,111,31808,33568,39497,0,-65,-27,-8015,-11,-6206,-11057,-2,0,-3,0,10
EUW1_6876967476',6,33,15,1,0,0,0,8,0,369,93,29716,30469,31032,6,31,10,1,0,1,0,3,358,98,26835,29262,31875,0,11,-5,2881,5,1207,-843,0,0,-1,0,5
EUW1_6876484080',5,28,15,1,0,1,0,8,0,329,99,28695,29344,42416,9,46,19,1,0,1,0,0,327,85,29838,29514,37673,0,2,14,-1143,-4,-170,4743,0,0,0,0,8
EUW1_6876160093',1,29,7,0,0,0,0,10,0,395,76,26408,29920,27718,4,40,10,2,0,1,0,3,351,94,26884,29223,30983,0,44,-18,-476,-3,697,-3265,-2,0,-1,0,7
EUW1_6875195399',1,29,10,1,0,1,0,12,0,350,92,26398,28938,26170,4,25,13,1,1,2,0,5,334,120,28661,29388,30391,0,16,-28,-2263,-3,-450,-4221,0,-1,-1,0,7
EUW1_6875129871',1,42,12,0,0,0,0,11,0,360,90,27181,29803,44903,9,27,13,2,0,1,0,2,398,89,28352,30839,40942,1,-38,1,-1171,-1,-1036,3961,-2,0,-1,0,9
EUW1_6874016356',4,23,9,2,1,0,0,8,1,357,78,25748,30737,26614,3,26,10,0,0,0,0,2,372,106,26381,30349,25594,1,-15,-28,-633,-1,388,1020,2,1,0,0,6
EUW1_6873470816',3,33,12,0,0,0,0,6,0,392,78,28960,31933,30311,5,24,5,2,0,2,0,5,318,104,22730,27610,23047,1,74,-26,6230,7,4323,7264,-2,0,-2,0,1
EUW1_6872525603',6,30,14,1,1,0,0,8,1,311,113,27085,29273,28639,5,24,12,1,0,0,0,0,321,107,26596,30272,25816,1,-10,6,489,2,-999,2823,0,1,0,0,8
EUW1_6872378157',5,36,13,1,0,0,0,14,1,292,96,25955,27848,25847,3,26,20,1,0,2,0,3,333,99,31632,30322,42297,0,-41,-3,-5677,-7,-2474,-16450,0,0,-2,0,11
EUW1_6872364415',5,24,13,1,0,0,0,10,0,342,73,27093,27306,32340,3,29,16,0,0,2,0,4,371,87,31289,31968,35208,0,-29,-14,-4196,-3,-4662,-2868,1,0,-2,0,6
EUW1_6872119268',4,27,14,2,0,3,0,5,1,388,92,30342,30857,32967,3,103,9,0,0,0,0,6,352,80,25375,27426,23931,1,36,12,4967,5,3431,9036,2,0,3,0,-1
EUW1_6872035833',1,21,9,1,0,0,0,12,0,362,86,26129,30057,26106,4,36,19,1,0,2,0,1,400,112,32445,32953,34735,1,-38,-26,-6316,-10,-2896,-8629,0,0,-2,0,11
EUW1_6871892141',2,23,18,0,0,1,0,12,0,321,68,28390,28353,37396,0,30,16,1,1,1,0,5,313,96,29385,28614,40076,1,8,-28,-995,2,-261,-2680,-1,-1,0,0,7
EUW1_6871829901',5,27,17,1,0,1,0,7,0,383,92,30793,32303,38849,4,29,10,1,1,0,0,4,349,112,25855,30358,27714,1,34,-20,4938,7,1945,11135,0,-1,1,0,3
EUW1_6871600549',2,26,15,1,0,1,0,12,1,334,77,28712,29175,32697,8,32,14,1,0,2,0,5,337,98,29222,29864,39321,0,-3,-21,-510,1,-689,-6624,0,0,-1,0,7
EUW1_6871242373',9,37,23,0,0,2,0,10,1,370,81,33423,30687,38674,3,27,14,1,0,0,0,8,340,98,27683,27576,28923,1,30,-17,5740,9,3111,9751,-1,0,2,0,2
EUW1_6869389447',6,41,21,2,0,3,0,5,0,378,72,33493,31245,39420,5,29,13,0,0,0,0,9,316,92,26778,26821,27812,1,62,-20,6715,8,4424,11608,2,0,3,0,-4
EUW1_6867763599',3,27,22,1,0,2,0,2,0,318,109,31904,29799,39975,0,26,15,1,0,0,0,7,282,98,26903,27188,39743,1,36,11,5001,7,2611,232,0,0,2,0,-5
EUW1_6862724004',4,31,9,0,0,1,0,10,0,330,83,26790,28932,30393,4,28,12,2,0,1,0,5,359,124,27357,32228,35283,1,-29,-41,-567,-3,-3296,-4890,-2,0,0,0,5
EUW1_6855818441',4,27,9,2,0,1,0,13,1,284,86,25139,24713,31048,4,27,17,0,0,3,0,2,354,82,31729,29825,31313,0,-70,4,-6590,-8,-5112,-265,2,0,-2,0,11
EUW1_6854616849',4,29,20,1,0,1,0,10,0,309,60,29380,29373,39629,1,25,15,0,0,2,0,5,284,76,29163,27101,34200,1,25,-16,217,5,2272,5429,1,0,-1,0,5
EUW1_6853440791',7,30,16,0,0,4,0,11,0,373,104,33066,32189,41395,2,287,13,1,0,0,0,9,310,68,27445,29142,28871,1,63,36,5621,3,3047,12524,-1,0,4,0,2
EUW1_6851837010',3,27,14,0,0,0,0,11,0,324,73,27243,29574,33066,3,34,19,2,0,2,0,3,354,111,30924,32559,40285,1,-30,-38,-3681,-5,-2985,-7219,-2,0,-2,0,8
EUW1_6848770464',5,29,14,1,0,0,0,8,0,340,90,27194,29109,37074,2,22,11,1,0,1,0,3,307,77,26741,27547,34533,0,33,13,453,3,1562,2541,0,0,-1,0,5
EUW1_6847442941',5,33,9,1,0,0,0,14,0,287,69,24782,24646,34351,4,29,31,0,0,3,0,2,379,110,36626,35167,50699,0,-92,-41,-11844,-22,-10521,-16348,1,0,-3,0,12
EUW1_6847367740',3,26,18,1,0,1,0,12,1,346,88,29310,32192,29552,2,24,17,1,0,1,0,2,379,82,31215,31497,39321,1,-33,6,-1905,1,695,-9769,0,0,0,0,10
EUW1_6845039077',1,20,11,0,0,0,0,8,1,296,90,25838,28794,31398,2,48,4,1,0,1,0,1,396,77,25381,29624,31273,0,-100,13,457,7,-830,125,-1,0,-1,0,7
EUW1_6844942531',2,22,11,0,0,0,0,12,0,320,77,26793,28120,36792,2,29,24,2,0,2,0,4,307,118,33328,32728,40505,0,13,-41,-6535,-13,-4608,-3713,-2,0,-2,0,8
EUW1_6844899114',3,59,18,0,0,1,0,9,1,349,78,29978,30802,40393,2,52,16,2,0,0,0,2,340,88,27860,29665,38825,0,9,-10,2118,2,1137,1568,-2,0,1,0,7
EUW1_6842502669',2,31,11,1,0,0,0,9,1,314,97,25499,27349,34452,3,141,20,1,1,0,0,0,324,78,29512,30084,37344,0,-10,19,-4013,-9,-2735,-2892,0,-1,0,0,9
EUW1_6883260652',2,25,1,0,0,0,0,13,0,336,107,21619,26830,22640,7,32,14,2,0,1,0,2,400,104,29084,32203,25874,0,-64,3,-7465,-13,-5373,-3234,-2,0,-1,0,11
EUW1_6861530004',4,32,10,1,0,0,0,5,1,386,106,26765,29589,33275,8,26,7,1,1,0,0,4,343,70,24220,26968,25235,1,43,36,2545,3,2621,8040,0,-1,0,0,1
EUW1_6861469787',4,37,16,2,0,1,0,11,1,342,96,29441,30925,31417,5,38,7,0,0,0,0,5,342,62,24385,25973,27892,1,0,34,5056,9,4952,3525,2,0,1,0,6
EUW1_6861412950',9,34,10,0,0,0,0,6,0,378,91,26897,30520,31255,6,29,12,1,0,0,0,1,370,100,27869,31702,27532,0,8,-9,-972,-2,-1182,3723,-1,0,0,0,5
EUW1_6852798814',9,33,9,0,0,0,0,9,0,351,70,25782,29818,29815,4,56,13,2,0,0,0,1,357,104,27345,30784,32071,1,-6,-34,-1563,-4,-966,-2256,-2,0,0,0,8
EUW1_6852751105',3,56,9,1,0,0,0,5,0,394,92,27552,30146,32533,1,25,11,0,0,1,0,6,340,88,25879,29305,21788,1,54,4,1673,-2,841,10745,1,0,-1,0,-1
EUW1_6852674047',3,27,14,1,0,1,0,8,0,361,124,29711,32447,31404,2,29,8,0,0,0,0,3,341,97,26378,28834,30092,1,20,27,3333,6,3613,1312,1,0,1,0,5
EUW1_6852606573',10,54,10,0,0,0,0,4,0,352,94,25996,29437,29870,6,66,7,1,0,0,0,2,369,60,24307,27705,30031,0,-17,34,1689,3,1732,-161,-1,0,0,0,2
EUW1_6852556647',1,23,9,1,0,0,0,8,1,340,88,26572,28301,31210,4,27,12,1,0,0,0,5,349,88,26329,28586,29435,1,-9,0,243,-3,-285,1775,0,0,0,0,3
EUW1_6852490639',6,33,8,0,0,0,0,6,1,331,80,23957,26223,24369,4,35,8,1,0,1,0,1,363,84,26198,28978,24159,0,-32,-4,-2241,0,-2755,210,-1,0,-1,0,5
EUW1_6852417929',8,52,9,1,0,1,0,4,0,380,105,27236,28891,29084,3,24,11,1,0,0,0,4,339,78,26895,28268,25736,0,41,27,341,-2,623,3348,0,0,1,0,0
EUW1_6852362615',2,27,18,0,0,2,0,4,1,347,74,31336,31939,36606,4,26,17,1,0,0,0,7,356,101,29894,30091,37148,1,-9,-27,1442,1,1848,-542,-1,0,2,0,-3
EUW1_6852292376',3,62,8,0,0,0,0,11,1,340,107,25228,27772,20343,3,64,13,2,1,1,0,1,389,92,27930,31252,25341,0,-49,15,-2702,-5,-3480,-4998,-2,-1,-1,0,10
EUW1_6851471864',2,32,16,1,0,0,0,8,1,354,70,28089,28315,37711,6,25,12,1,0,0,0,5,359,90,28201,30299,27689,1,-5,-20,-112,4,-1984,10022,0,0,0,0,3
EUW1_6851430258',6,31,9,0,0,0,0,11,0,356,58,24814,28146,26945,4,30,11,1,0,0,0,1,346,82,25864,28715,27921,1,10,-24,-1050,-2,-569,-976,-1,0,0,0,10
EUW1_6851381381',2,20,7,0,0,0,0,10,0,334,78,23314,28229,23998,3,28,11,2,0,1,0,1,388,74,27424,30115,31238,0,-54,4,-4110,-4,-1886,-7240,-2,0,-1,0,9
EUW1_6849413019',6,34,20,2,1,1,0,10,0,276,93,30043,27224,30352,2,23,10,0,0,1,0,2,354,84,28739,26691,25261,1,-78,9,1304,10,533,5091,2,1,0,0,8
EUW1_6849359158',5,28,11,1,0,0,0,10,1,373,94,28249,30521,34812,4,30,17,1,0,1,0,2,367,100,29880,31922,30765,1,6,-6,-1631,-6,-1401,4047,0,0,-1,0,8
EUW1_6849048992',3,242,24,1,0,0,0,10,0,325,88,29877,32111,42467,5,93,12,0,0,1,0,3,307,95,28267,27951,37096,0,18,-7,1610,12,4160,5371,1,0,-1,0,7
EUW1_6854467625',2,26,13,0,0,2,0,10,1,360,82,28956,28896,35523,3,25,9,1,0,1,0,6,333,98,25528,28342,28895,1,27,-16,3428,4,554,6628,-1,0,1,0,4
EUW1_6854437209',3,25,14,1,0,1,0,11,0,358,76,28302,29042,33743,3,29,17,1,0,2,0,4,345,90,30981,30828,39516,0,13,-14,-2679,-3,-1786,-5773,0,0,-1,0,7
EUW1_6853273332',1,24,11,0,0,0,0,15,0,343,88,27171,28543,30722,3,33,15,1,1,3,0,2,363,84,30571,29947,32123,0,-20,4,-3400,-4,-1404,-1401,-1,-1,-3,0,13
EUW1_6853231445',0,62,19,1,0,0,0,12,1,317,84,29501,30201,38683,6,61,13,1,0,0,0,2,364,80,27492,28572,34666,1,-47,4,2009,6,1629,4017,0,0,0,0,10
EUW1_6853214031',3,35,9,0,0,0,0,12,0,380,122,27777,30322,23607,6,33,18,1,0,2,0,4,383,85,31453,30645,32540,1,-3,37,-3676,-9,-323,-8933,-1,0,-2,0,8
EUW1_6851822565',8,94,12,0,0,2,0,17,0,311,57,29533,26338,34001,1,28,21,1,0,3,0,4,331,94,32101,29922,36112,0,-20,-37,-2568,-9,-3584,-2111,-1,0,-1,0,13
EUW1_6847529152',0,26,17,1,0,0,0,12,0,297,87,28318,29100,38397,5,29,20,0,0,2,0,0,331,109,31941,30720,39803,0,-34,-22,-3623,-3,-1620,-1406,1,0,-2,0,12
EUW1_6847492250',7,32,20,1,0,0,0,7,1,328,84,30516,27782,42480,6,26,21,1,0,0,0,4,366,84,30855,29729,39810,0,-38,0,-339,-1,-1947,2670,0,0,0,0,3
EUW1_6847464934',4,27,19,1,0,1,0,9,1,353,93,31684,29570,43795,4,26,17,1,0,1,0,2,335,78,28895,27872,37824,1,18,15,2789,2,1698,5971,0,0,0,0,7
EUW1_6847421411',6,29,9,1,0,1,0,7,1,386,94,27827,29385,28853,1,26,10,0,1,0,0,2,388,102,26534,32314,30257,1,-2,-8,1293,-1,-2929,-1404,1,-1,1,0,5
EUW1_6843878355',10,265,9,0,1,1,0,11,0,388,76,26934,28741,26068,3,28,11,2,0,1,0,4,373,96,28373,29575,30927,0,15,-20,-1439,-2,-834,-4859,-2,1,0,0,7
EUW1_6843774680',8,42,12,1,1,0,0,9,1,378,49,27397,30457,29737,4,37,10,0,0,1,0,2,415,97,28040,29623,27921,0,-37,-48,-643,2,834,1816,1,1,-1,0,7
EUW1_6853131938',6,49,12,0,0,0,0,11,1,380,108,29669,30906,27920,4,30,6,2,0,2,0,5,345,95,25415,28884,22227,1,35,13,4254,6,2022,5693,-2,0,-2,0,6
EUW1_6846259776',3,31,13,1,0,0,0,12,1,378,94,29550,30552,34663,3,26,12,1,0,2,0,3,364,92,28569,29271,39610,0,14,2,981,1,1281,-4947,0,0,-2,0,9
EUW1_6834113121',3,27,11,0,0,1,0,6,1,371,83,28202,30256,27646,7,37,14,2,0,0,0,7,320,97,28465,30249,29869,1,51,-14,-263,-3,7,-2223,-2,0,1,0,-1
EUW1_6832304085',3,287,16,0,0,1,0,3,1,378,76,29221,30180,34525,4,89,13,2,0,0,0,4,325,83,27141,28898,32708,0,53,-7,2080,3,1282,1817,-2,0,1,0,-1
EUW1_6831880157',3,32,5,0,1,0,0,12,1,356,96,25297,30074,24701,1,21,3,2,0,2,0,3,398,95,24823,29741,20154,0,-42,1,474,2,333,4547,-2,1,-2,0,9
EUW1_6879818194',6,30,11,2,0,1,0,6,0,390,90,28411,28510,35158,2,130,15,0,0,0,0,2,364,112,28698,32269,33972,1,26,-22,-287,-4,-3759,1186,2,0,1,0,4
EUW1_6879533506',4,22,10,1,0,0,0,9,0,304,62,26163,26525,29451,1,24,19,1,0,3,0,1,381,98,33321,31470,35100,0,-77,-36,-7158,-9,-4945,-5649,0,0,-3,0,8
EUW1_6859504961',2,51,8,0,0,0,0,14,0,357,74,27192,28181,25869,7,41,8,1,0,2,0,0,348,85,26842,28782,23972,0,9,-11,350,0,-601,1897,-1,0,-2,0,14
EUW1_6848475037',0,39,12,0,0,1,0,8,0,373,88,27963,30337,29103,3,24,12,2,0,0,0,4,360,94,27605,30326,29115,0,13,-6,358,0,11,-12,-2,0,1,0,4
EUW1_6844213863',5,28,15,0,0,0,0,12,0,342,56,28076,30185,37832,2,23,16,1,0,1,0,5,363,75,28959,29733,39795,0,-21,-19,-883,-1,452,-1963,-1,0,-1,0,7
EUW1_6842877478',8,34,13,1,0,1,0,5,1,354,87,28061,29397,31890,6,39,11,0,0,0,0,4,317,92,25832,29119,26557,1,37,-5,2229,2,278,5333,1,0,1,0,1
EUW1_6842810010',6,25,10,1,0,0,0,8,1,333,83,25286,27891,38582,1,98,15,1,0,0,0,0,355,80,28799,31399,35981,0,-22,3,-3513,-5,-3508,2601,0,0,0,0,8
EUW1_6842520300',6,36,9,1,0,0,0,10,1,373,106,26181,30088,33509,2,27,1,1,0,1,0,1,371,112,22851,29025,25456,1,2,-6,3330,8,1063,8053,0,0,-1,0,9
EUW1_6842493850',4,40,9,0,0,0,0,6,1,346,60,25335,26271,24264,2,43,19,2,0,1,0,4,339,120,30413,31882,43950,0,7,-60,-5078,-10,-5611,-19686,-2,0,-1,0,2
EUW1_6842475542',4,29,17,0,0,3,0,6,0,409,80,32167,32248,38382,2,27,13,1,0,0,0,11,321,86,26811,28865,27483,1,88,-6,5356,4,3383,10899,-1,0,3,0,-5
EUW1_6842430059',3,50,14,1,0,0,0,11,0,349,96,28723,30842,29682,3,137,15,0,0,2,0,2,388,92,30095,30950,40375,0,-39,4,-1372,-1,-108,-10693,1,0,-2,0,9
EUW1_6842334979',2,33,9,1,0,0,0,10,0,346,96,25808,29621,28698,0,19,8,1,0,1,0,0,395,91,27368,29549,26832,0,-49,5,-1560,1,72,1866,0,0,-1,0,10
EUW1_6842320299',0,25,7,0,0,0,0,8,1,360,84,25187,27278,34972,5,38,18,0,1,1,0,1,377,84,29885,31236,39692,0,-17,0,-4698,-11,-3958,-4720,0,-1,-1,0,7
EUW1_6838656721',4,29,4,0,0,0,0,10,0,376,86,23031,27770,31764,4,27,15,2,0,2,0,2,385,104,31217,31103,29759,0,-9,-18,-8186,-11,-3333,2005,-2,0,-2,0,8
EUW1_6835491591',4,28,6,0,0,0,0,10,1,297,90,23592,24894,29025,7,25,19,2,0,1,0,2,349,80,30543,30705,35892,0,-52,10,-6951,-13,-5811,-6867,-2,0,-1,0,8
EUW1_6835456217',7,36,5,0,0,0,0,7,1,344,94,23851,26987,27285,6,99,11,2,0,0,0,1,374,93,27062,31209,32719,0,-30,1,-3211,-6,-4222,-5434,-2,0,0,0,6
EUW1_6835394921',4,27,7,0,0,0,0,5,0,396,71,25461,30561,28220,5,155,10,1,1,0,0,2,377,130,26670,31289,28682,0,19,-59,-1209,-3,-728,-462,-1,-1,0,0,3
EUW1_6774492793',1,43,11,1,0,1,0,13,0,356,84,27222,29839,28905,4,28,10,1,0,2,0,1,375,116,28975,30680,27914,1,-19,-32,-1753,1,-841,991,0,0,-1,0,12
EUW1_6774420673',4,134,14,0,0,0,0,9,1,323,91,27942,29389,27191,4,25,13,2,1,2,0,2,369,124,27698,31893,22168,0,-46,-33,244,1,-2504,5023,-2,-1,-2,0,7
EUW1_6774356676',3,60,8,0,0,0,0,6,1,372,95,27050,29541,25174,7,98,13,2,0,1,0,2,415,103,27983,31535,25703,1,-43,-8,-933,-5,-1994,-529,-2,0,-1,0,4
EUW1_6774223625',5,40,13,1,0,1,0,9,1,375,111,29654,31447,32529,6,42,13,1,0,1,0,6,352,89,28081,28625,27904,1,23,22,1573,0,2822,4625,0,0,0,0,3
EUW1_6774150135',9,39,19,1,0,0,0,5,1,353,92,30325,30973,29388,3,26,11,1,0,0,0,4,385,105,28081,30037,29944,0,-32,-13,2244,8,936,-556,0,0,0,0,1
EUW1_6774074371',4,25,7,0,0,0,0,4,0,394,85,25318,28502,28159,2,22,11,1,0,1,0,2,388,90,27320,30318,29266,0,6,-5,-2002,-4,-1816,-1107,-1,0,-1,0,2
EUW1_6774012364',4,33,12,0,0,1,0,11,0,354,74,28054,29411,28296,3,34,18,2,1,1,0,4,348,99,31608,30607,31944,0,6,-25,-3554,-6,-1196,-3648,-2,-1,0,0,7
EUW1_6772899937',4,56,13,1,0,0,0,9,1,375,107,28838,29938,26140,4,27,14,1,0,1,0,5,321,94,28183,27615,30054,1,54,13,655,-1,2323,-3914,0,0,-1,0,4
EUW1_6772819993',6,26,15,1,0,1,0,9,0,353,84,29401,30065,32183,9,34,17,1,0,0,0,2,314,80,28531,25986,33538,1,39,4,870,-2,4079,-1355,0,0,1,0,7
EUW1_6752315262',5,30,6,2,1,0,0,5,0,419,84,25903,29551,24613,2,30,10,0,0,0,0,5,356,92,25445,29833,25516,0,63,-8,458,-4,-282,-903,2,1,0,0,0
EUW1_6752287785',5,28,9,0,0,1,0,14,1,354,85,25078,28142,24313,3,31,15,2,1,2,0,1,354,95,30297,30676,34880,0,0,-10,-5219,-6,-2534,-10567,-2,-1,-1,0,13
EUW1_6752253477',3,27,17,2,1,2,0,8,1,364,91,32629,29612,38772,1,26,20,0,0,1,0,4,311,76,28231,31111,37779,0,53,15,4398,-3,-1499,993,2,1,1,0,4
EUW1_6752224607',5,27,11,0,0,1,0,10,0,399,80,28053,29047,32847,5,51,12,1,0,0,0,3,309,100,26853,29716,22934,1,90,-20,1200,-1,-669,9913,-1,0,1,0,7
EUW1_6751682442',1,18,17,0,1,1,0,8,0,335,80,29707,30321,35526,1,15,13,1,0,0,0,10,358,95,27862,30176,30491,1,-23,-15,1845,4,145,5035,-1,1,1,0,-2
EUW1_6751627484',6,26,15,2,1,2,0,9,0,367,99,30502,30760,32533,1,22,12,0,0,0,0,7,343,86,26664,29475,29208,1,24,13,3838,3,1285,3325,2,1,2,0,2
EUW1_6751568647',4,33,17,2,1,3,0,4,1,392,68,32685,32908,41954,3,22,8,0,0,0,0,10,335,91,23032,27353,25885,1,57,-23,9653,9,5555,16069,2,1,3,0,-6
EUW1_6750765740',5,45,18,0,1,0,0,8,0,325,82,29738,28669,38082,6,28,21,2,0,1,0,1,343,93,30892,30804,37479,0,-18,-11,-1154,-3,-2135,603,-2,1,-1,0,7
EUW1_6883741997',3,25,8,0,0,0,0,3,1,375,81,24110,29378,25256,4,25,10,2,0,1,0,0,400,85,26253,30691,29147,0,-25,-4,-2143,-2,-1313,-3891,-2,0,-1,0,3
EUW1_6883335601',3,32,18,1,0,1,0,5,1,360,89,30846,29832,34972,3,26,9,0,0,0,0,5,388,82,26808,28972,26815,1,-28,7,4038,9,860,8157,1,0,1,0,0
EUW1_6883275915',2,25,11,0,0,0,0,10,0,364,94,27283,30347,36473,1,23,10,1,0,1,0,2,396,98,27984,30628,27691,1,-32,-4,-701,1,-281,8782,-1,0,-1,0,8
EUW1_6883220868',3,27,4,0,0,1,0,10,0,368,66,23913,26980,30325,4,20,20,1,1,2,0,4,367,114,32722,34515,37503,0,1,-48,-8809,-16,-7535,-7178,-1,-1,-1,0,6
EUW1_6882950640',5,24,11,1,0,0,0,12,1,375,98,26776,30476,33117,2,28,16,1,0,1,0,3,382,106,29766,32381,39282,0,-7,-8,-2990,-5,-1905,-6165,0,0,-1,0,9
EUW1_6882819223',3,26,18,0,1,1,0,11,1,344,91,29757,30857,39421,3,26,17,1,0,1,0,4,360,67,29762,30530,46519,0,-16,24,-5,1,327,-7098,-1,1,0,0,7
EUW1_6882745731',2,29,16,1,0,0,0,10,0,370,88,28387,31469,34112,4,24,9,1,0,0,0,1,374,96,26465,30220,24026,1,-4,-8,1922,7,1249,10086,0,0,0,0,9
EUW1_6882692691',4,25,11,1,0,0,0,15,1,370,84,27390,29035,31198,8,34,9,0,0,2,0,2,343,86,26220,28510,29675,1,27,-2,1170,2,525,1523,1,0,-2,0,13
EUW1_6882653649',3,31,19,1,0,1,0,11,1,337,72,30217,27883,35871,9,35,10,0,0,2,0,5,370,75,27235,29529,28150,0,-33,-3,2982,9,-1646,7721,1,0,-1,0,6
EUW1_6882613958',4,27,9,1,0,1,0,12,1,333,68,24561,25710,26161,6,95,14,1,0,2,0,1,382,84,29268,31340,35556,0,-49,-16,-4707,-5,-5630,-9395,0,0,-1,0,11
EUW1_6882472336',3,25,6,0,0,0,0,13,0,346,76,24389,26817,22127,7,32,19,2,0,3,0,4,355,102,31318,30387,28399,0,-9,-26,-6929,-13,-3570,-6272,-2,0,-3,0,9
EUW1_6882443814',4,40,5,0,0,0,0,12,0,296,54,21242,23530,25687,5,27,21,1,0,2,0,0,355,94,31793,29219,37094,0,-59,-40,-10551,-16,-5689,-11407,-1,0,-2,0,12
EUW1_6883759855',2,22,10,1,0,1,0,11,0,317,84,25917,28010,30128,5,19,20,1,1,1,0,3,339,92,31622,29641,39847,0,-22,-8,-5705,-10,-1631,-9719,0,-1,0,0,8
EUW1_6883412730',3,20,12,0,0,1,0,9,1,369,80,27324,29473,38309,5,21,10,1,1,1,0,3,325,96,26248,30230,26812,1,44,-16,1076,2,-757,11497,-1,-1,0,0,6
EUW1_6883349963',3,27,14,1,0,0,0,10,1,314,72,27225,27424,38391,3,27,20,1,0,3,0,5,305,102,30874,31047,38511,0,9,-30,-3649,-6,-3623,-120,0,0,-3,0,5
EUW1_6883281735',3,23,15,0,0,0,0,8,0,327,99,27601,28464,36057,4,23,18,1,0,1,0,2,373,76,30660,32018,38935,0,-46,23,-3059,-3,-3554,-2878,-1,0,-1,0,6
EUW1_6883206479',3,38,17,1,0,1,0,12,1,347,88,30346,30385,39494,3,28,12,0,0,0,0,2,340,72,26774,28858,34341,1,7,16,3572,5,1527,5153,1,0,1,0,10
EUW1_6882516811',6,27,17,2,0,1,0,9,1,365,106,30674,31575,35409,7,96,15,0,0,0,0,3,329,70,27431,29398,32877,1,36,36,3243,2,2177,2532,2,0,1,0,6
EUW1_6882489699',4,23,3,0,0,0,0,9,1,397,106,23557,29515,21492,3,24,5,2,0,1,0,0,417,100,25573,30996,26721,0,-20,6,-2016,-2,-1481,-5229,-2,0,-1,0,9
EUW1_6882464903',2,151,14,1,0,2,0,6,1,410,115,31420,31949,34137,2,33,7,0,0,1,0,7,371,24,23437,26127,22320,1,39,91,7983,7,5822,11817,1,0,1,0,-1
EUW1_6882437237',3,43,12,1,0,0,0,11,0,333,69,26964,27588,35177,2,25,25,1,1,5,0,3,378,130,35711,34893,45024,0,-45,-61,-8747,-13,-7305,-9847,0,-1,-5,0,8
EUW1_6881978860',4,22,17,0,0,0,0,3,0,381,72,30424,31132,42148,3,25,14,2,0,1,0,8,324,92,27161,28212,34005,1,57,-20,3263,3,2920,8143,-2,0,-1,0,-5
EUW1_6881890845',9,30,10,0,0,0,0,11,1,312,68,24996,27177,27309,8,29,15,1,0,1,0,2,334,110,29306,29753,33081,0,-22,-42,-4310,-5,-2576,-5772,-1,0,-1,0,9
EUW1_6881809447',6,36,16,1,0,0,0,7,0,413,84,30715,32578,33060,5,30,9,0,0,0,0,5,366,99,25905,30114,34950,1,47,-15,4810,7,2464,-1890,1,0,0,0,2
EUW1_6880987233',5,26,13,1,0,0,0,9,0,305,76,25788,28658,35639,2,25,20,1,0,1,0,0,349,84,30481,31123,41732,0,-44,-8,-4693,-7,-2465,-6093,0,0,-1,0,9
EUW1_6880964754',1,22,11,0,0,1,0,6,0,324,78,25710,27062,30854,6,26,11,2,0,1,0,2,358,98,26964,28421,27324,0,-34,-20,-1254,0,-1359,3530,-2,0,0,0,4
EUW1_6880930180',3,49,7,0,0,0,0,12,1,313,80,24090,26653,23573,6,66,10,1,0,1,0,2,347,92,26703,28426,34463,0,-34,-12,-2613,-3,-1773,-10890,-1,0,-1,0,10
EUW1_6880902369',3,31,15,1,0,0,0,12,0,357,75,27456,31058,37759,1,25,9,0,0,1,0,1,350,76,27183,28852,38688,0,7,-1,273,6,2206,-929,1,0,-1,0,11
EUW1_6880888913',2,132,8,0,0,0,0,7,0,287,80,24178,27719,28006,1,22,14,2,0,0,0,4,349,75,26674,29151,40026,0,-62,5,-2496,-6,-1432,-12020,-2,0,0,0,3
EUW1_6880383949',4,26,12,1,0,2,0,11,1,351,80,28756,29865,32930,4,33,7,1,0,0,0,6,328,92,24492,27388,29761,1,23,-12,4264,5,2477,3169,0,0,2,0,5
EUW1_6880307047',3,28,19,1,0,1,0,12,0,287,76,29342,29317,37506,2,24,18,0,0,1,0,3,362,62,29685,29049,42117,1,-75,14,-343,1,268,-4611,1,0,0,0,9
EUW1_6880254760',4,22,17,0,1,2,0,8,1,369,88,29199,31375,36883,5,21,15,1,0,2,0,8,312,76,28700,30185,40740,0,57,12,499,2,1190,-3857,-1,1,0,0,0
EUW1_6883653919',0,46,13,0,0,0,0,8,0,355,73,27344,29312,32928,5,28,16,1,0,1,0,2,400,98,30450,31699,33644,0,-45,-25,-3106,-3,-2387,-716,-1,0,-1,0,6
EUW1_6883632344',5,31,11,1,0,2,0,10,0,393,96,29053,31282,30141,3,25,6,0,0,1,0,8,371,107,26251,29771,24842,1,22,-11,2802,5,1511,5299,1,0,1,0,2
EUW1_6883608319',4,170,11,0,0,1,0,14,1,357,100,27181,31292,33864,2,96,6,1,0,1,0,3,355,96,25110,29116,22993,0,2,4,2071,5,2176,10871,-1,0,0,0,11
EUW1_6883591539',3,34,12,0,0,0,0,6,0,387,85,28672,30675,30723,4,29,10,2,0,0,0,5,382,104,26708,29386,23436,0,5,-19,1964,2,1289,7287,-2,0,0,0,1
EUW1_6883465533',1,65,12,0,0,0,0,11,1,371,82,27781,29574,33602,5,73,24,2,0,2,0,3,350,106,33322,32407,39752,0,21,-24,-5541,-12,-2833,-6150,-2,0,-2,0,8
EUW1_6883406410',1,15,4,0,0,0,0,12,0,330,94,22736,27329,28705,5,54,21,2,0,2,0,1,381,95,32773,33482,38511,0,-51,-1,-10037,-17,-6153,-9806,-2,0,-2,0,11
EUW1_6883369886',3,26,8,1,0,0,0,11,1,335,82,24114,27615,28670,3,28,16,1,0,1,0,1,396,82,28330,30671,42576,0,-61,0,-4216,-8,-3056,-13906,0,0,-1,0,10
EUW1_6883323603',0,123,7,0,0,0,0,15,1,339,97,26159,29882,24834,6,28,15,1,0,3,0,6,363,79,29712,29913,28406,0,-24,18,-3553,-8,-31,-3572,-1,0,-3,0,9
EUW1_6882306505',4,29,9,1,0,2,0,10,0,376,84,27392,29839,35115,4,25,9,1,0,1,0,8,375,74,26555,29465,26506,0,1,10,837,0,374,8609,0,0,1,0,2
EUW1_6882284921',5,22,7,0,1,1,0,8,0,427,94,26861,30595,19798,8,35,9,2,0,0,0,5,344,114,25974,28471,19762,1,83,-20,887,-2,2124,36,-2,1,1,0,3
EUW1_6882268754',3,95,13,0,0,1,0,11,0,342,102,28940,29872,33793,7,31,13,2,0,1,0,4,372,86,28038,30321,32757,1,-30,16,902,0,-449,1036,-2,0,0,0,7
EUW1_6882228830',3,34,14,1,0,1,0,8,0,365,90,28738,29678,31768,1,30,7,0,0,1,0,7,371,84,25460,28972,29507,1,-6,6,3278,7,706,2261,1,0,0,0,1
EUW1_6882205147',7,45,22,0,0,2,0,3,0,359,96,33354,31634,42047,5,34,12,0,0,0,0,10,367,60,26536,27944,32249,1,-8,36,6818,10,3690,9798,0,0,2,0,-7
EUW1_6882176089',6,40,17,2,0,1,0,10,1,387,78,29688,30900,37546,6,29,11,0,0,1,0,1,372,82,27870,31334,30402,1,15,-4,1818,6,-434,7144,2,0,0,0,9
EUW1_6828841400',4,22,5,1,0,0,0,8,0,358,101,23712,28995,18943,4,22,7,1,1,1,0,1,328,85,25675,28938,22397,0,30,16,-1963,-2,57,-3454,0,-1,-1,0,7
EUW1_6828779784',3,23,13,0,0,1,0,8,0,343,78,28241,31039,29330,0,21,9,1,0,1,0,1,394,82,26349,29089,27303,1,-51,-4,1892,4,1950,2027,-1,0,0,0,7
EUW1_6828714509',4,23,18,1,0,0,0,3,1,352,69,28863,30267,34373,6,101,12,0,0,0,0,2,315,104,27123,29917,39117,1,37,-35,1740,6,350,-4744,1,0,0,0,1
EUW1_6816639597',5,25,14,1,0,0,0,6,0,309,79,26617,30598,36738,4,80,15,1,0,1,0,1,362,108,30830,31632,41215,0,-53,-29,-4213,-1,-1034,-4477,0,0,-1,0,5
EUW1_6814320975',5,30,9,0,0,1,0,9,0,344,108,27483,30050,34288,5,27,15,1,0,2,0,3,385,76,29121,30964,29693,0,-41,32,-1638,-6,-914,4595,-1,0,-1,0,6
EUW1_6814246046',4,39,13,2,0,0,0,8,1,329,106,27541,31530,38267,0,27,11,0,0,0,0,3,359,89,26512,30635,31655,0,-30,17,1029,2,895,6612,2,0,0,0,5
EUW1_6807376561',4,31,10,0,0,1,0,5,1,357,96,27596,29173,26759,5,29,9,1,0,0,0,5,384,81,25354,29757,28993,0,-27,15,2242,1,-584,-2234,-1,0,1,0,0
EUW1_6807302294',2,38,10,2,0,0,0,7,0,380,73,25912,29993,27321,7,28,8,0,0,0,0,3,358,102,25612,29585,26999,1,22,-29,300,2,408,322,2,0,0,0,4
EUW1_6807236431',4,31,15,0,0,0,0,10,0,317,70,28832,26839,36182,7,35,29,1,0,1,0,4,324,84,34957,30263,46747,0,-7,-14,-6125,-14,-3424,-10565,-1,0,-1,0,6
EUW1_6807205324',3,29,15,1,0,3,0,3,0,415,104,32172,31421,45383,4,27,6,0,0,0,0,9,327,68,23687,25744,27983,1,88,36,8485,9,5677,17400,1,0,3,0,-6
EUW1_6806978415',3,28,10,2,0,2,0,7,1,362,110,28021,28642,21302,3,120,9,0,0,0,0,5,362,89,24909,28841,18158,1,0,21,3112,1,-199,3144,2,0,2,0,2
EUW1_6800967662',1,79,12,1,0,2,0,7,1,375,105,29316,31534,30567,7,33,5,0,0,0,0,7,377,78,24052,27948,23053,1,-2,27,5264,7,3586,7514,1,0,2,0,0
EUW1_6799870800',4,30,16,1,0,1,0,13,0,312,78,28895,25584,45123,1,31,25,0,0,3,0,4,350,82,34468,30033,42704,0,-38,-4,-5573,-9,-4449,2419,1,0,-2,0,9
EUW1_6799597907',2,319,14,0,0,1,0,8,1,343,76,28423,28785,31304,9,32,15,2,0,0,0,4,322,79,28057,28496,35078,0,21,-3,366,-1,289,-3774,-2,0,1,0,4
EUW1_6799530306',8,47,15,0,0,1,0,8,1,349,108,31151,30859,42110,3,46,13,2,0,1,0,7,370,75,27259,29023,37963,1,-21,33,3892,2,1836,4147,-2,0,0,0,1
EUW1_6859878192',0,24,12,0,0,0,0,11,1,310,72,27137,26860,28736,3,30,23,1,0,2,0,3,371,78,31118,29940,40871,0,-61,-6,-3981,-11,-3080,-12135,-1,0,-2,0,8
EUW1_6859829480',3,32,13,0,0,1,0,12,1,364,85,28948,28995,31102,5,70,23,1,0,1,0,3,366,90,32033,31444,39436,0,-2,-5,-3085,-10,-2449,-8334,-1,0,0,0,9
EUW1_6859646081',8,31,18,1,0,1,0,14,0,397,90,30778,33748,36507,3,97,12,0,0,1,0,4,347,122,29321,32520,30058,1,50,-32,1457,6,1228,6449,1,0,0,0,10
EUW1_6859602479',2,31,7,0,0,0,0,8,0,358,100,25178,29346,33569,3,48,15,2,0,1,0,2,380,95,29566,30986,37265,0,-22,5,-4388,-8,-1640,-3696,-2,0,-1,0,6
EUW1_6859556835',7,57,14,1,0,0,0,8,0,346,86,29315,28274,33461,4,20,17,0,0,1,0,3,372,82,29059,30934,37182,1,-26,4,256,-3,-2660,-3721,1,0,-1,0,5
EUW1_6859517894',5,35,3,0,0,0,0,7,0,387,88,22996,27367,20652,1,37,16,1,1,2,0,2,399,100,31679,31386,32904,0,-12,-12,-8683,-13,-4019,-12252,-1,-1,-2,0,5
EUW1_6859496485',1,28,14,1,0,0,0,5,1,317,66,26833,27182,44021,1,23,18,0,0,0,0,0,336,75,28794,30554,43855,1,-19,-9,-1961,-4,-3372,166,1,0,0,0,5
EUW1_6859476730',5,26,19,2,1,3,0,6,1,409,87,32494,32717,39310,1,23,4,0,0,0,0,10,315,90,22476,26595,32983,1,94,-3,10018,15,6122,6327,2,1,3,0,-4
EUW1_6859452221',2,27,8,2,0,0,0,14,0,364,70,26079,28920,31457,4,127,14,0,0,2,0,2,406,113,31488,32381,35709,0,-42,-43,-5409,-6,-3461,-4252,2,0,-2,0,12
EUW1_6858122902',4,30,22,1,0,1,0,10,0,357,90,31801,33057,48804,2,22,15,0,0,1,0,3,328,96,29271,29381,39048,0,29,-6,2530,7,3676,9756,1,0,0,0,7
EUW1_6858106528',5,30,16,2,0,1,0,11,1,346,91,29819,30958,28369,6,70,9,0,0,1,0,4,366,90,27772,28419,30000,0,-20,1,2047,7,2539,-1631,2,0,0,0,7
EUW1_6858084893',4,28,12,2,0,1,0,5,0,384,110,29330,31796,27307,2,27,10,0,1,1,0,5,366,94,27702,31696,23512,0,18,16,1628,2,100,3795,2,-1,0,0,0
EUW1_6858072037',1,40,24,1,0,1,0,12,1,342,86,32334,31066,51526,4,28,9,1,0,1,0,4,313,94,26397,27933,32517,1,29,-8,5937,15,3133,19009,0,0,0,0,8
EUW1_6858053357',1,20,11,1,0,0,0,13,0,319,96,26530,26842,33257,5,29,14,1,0,2,0,3,326,104,30011,29217,39664,0,-7,-8,-3481,-3,-2375,-6407,0,0,-2,0,10
EUW1_6871821789',4,26,8,1,0,0,0,5,1,343,111,25168,28891,29728,7,32,5,1,1,0,0,3,357,80,23630,27912,23948,0,-14,31,1538,3,979,5780,0,-1,0,0,2
EUW1_6871732920',4,27,14,1,0,0,0,10,0,299,94,26469,27558,27374,3,34,17,1,1,2,0,3,369,86,30515,30822,34850,0,-70,8,-4046,-3,-3264,-7476,0,-1,-2,0,7
EUW1_6871673748',5,36,15,1,1,3,0,6,0,382,106,31339,32447,38621,2,22,7,1,0,0,0,12,343,90,24069,28528,23051,1,39,16,7270,8,3919,15570,0,1,3,0,-6
EUW1_6783398368',3,32,17,1,0,1,0,10,0,364,90,30043,29876,36196,6,47,18,1,0,0,0,8,355,72,29809,30280,37736,0,9,18,234,-1,-404,-1540,0,0,1,0,2
EUW1_6776211063',2,35,13,2,1,1,0,4,0,360,110,29642,30121,27333,6,28,13,0,0,0,0,4,407,86,28783,29785,26403,0,-47,24,859,0,336,930,2,1,1,0,0
EUW1_6776123803',1,27,15,1,0,1,0,10,0,313,74,28685,28996,36179,3,26,17,1,0,0,0,5,331,78,28538,30491,44254,0,-18,-4,147,-2,-1495,-8075,0,0,1,0,5
EUW1_6776054539',6,32,7,0,0,0,0,10,0,335,102,25075,27386,27985,6,36,22,1,0,1,0,0,356,64,30364,30780,32486,0,-21,38,-5289,-15,-3394,-4501,-1,0,-1,0,10
EUW1_6775963459',4,31,14,1,0,0,0,8,0,352,85,27722,28433,29629,3,32,16,1,0,0,0,0,383,82,29460,30318,39149,1,-31,3,-1738,-2,-1885,-9520,0,0,0,0,8
EUW1_6775876046',6,53,11,0,0,1,0,10,0,319,64,26404,24871,27164,5,32,21,2,0,1,0,4,356,95,33018,29512,41027,0,-37,-31,-6614,-10,-4641,-13863,-2,0,0,0,6
EUW1_6775802253',1,23,16,0,1,0,0,7,0,336,74,28525,27447,32600,6,45,14,1,0,1,0,1,337,114,29259,28837,28243,0,-1,-40,-734,2,-1390,4357,-1,1,-1,0,6
EUW1_6772751684',4,27,11,0,0,1,0,7,0,321,87,25838,28695,26710,6,30,20,1,0,0,0,5,326,104,30601,31473,30509,1,-5,-17,-4763,-9,-2778,-3799,-1,0,1,0,2
EUW1_6772683316',8,48,17,2,0,0,0,7,1,370,81,29385,31720,32296,2,23,4,0,0,1,0,8,374,82,23369,27199,26489,1,-4,-1,6016,13,4521,5807,2,0,-1,0,-1
EUW1_6843708438',2,28,12,0,0,1,0,10,0,325,84,27492,29251,31838,3,26,15,2,0,0,0,4,328,86,27163,28296,44912,1,-3,-2,329,-3,955,-13074,-2,0,1,0,6
EUW1_6835493726',1,26,26,1,0,1,0,10,1,321,78,33301,30448,45021,7,33,23,1,0,0,0,5,325,98,31398,31126,49832,1,-4,-20,1903,3,-678,-4811,0,0,1,0,5
EUW1_6770663955',7,29,15,1,1,1,0,12,1,362,104,30565,28919,33831,5,32,13,1,0,1,0,4,387,86,28622,29528,28290,1,-25,18,1943,2,-609,5541,0,1,0,0,8
EUW1_6770451587',0,81,7,2,0,0,0,10,0,312,102,24556,27037,23154,5,61,16,0,0,1,0,2,370,66,28924,29198,32439,0,-58,36,-4368,-9,-2161,-9285,2,0,-1,0,8
EUW1_6770413627',2,23,10,0,0,1,0,11,0,343,92,27186,27706,34415,2,25,25,1,0,1,0,1,313,82,30629,29308,37653,0,30,10,-3443,-15,-1602,-3238,-1,0,0,0,10
EUW1_6770374387',3,23,22,2,0,0,0,11,1,376,100,32511,32226,40453,1,20,11,0,0,1,0,5,354,75,26958,31047,31465,1,22,25,5553,11,1179,8988,2,0,-1,0,6
EUW1_6770358099',6,93,21,1,1,1,0,10,0,343,114,31609,33567,32616,1,62,4,0,0,0,0,5,379,42,23678,25115,21266,1,-36,72,7931,17,8452,11350,1,1,1,0,5
EUW1_6769868963',4,24,11,1,0,1,0,11,0,380,100,27755,30938,30617,1,20,10,1,1,0,0,3,359,111,26843,32161,24291,1,21,-11,912,1,-1223,6326,0,-1,1,0,8
EUW1_6769788046',4,23,16,1,0,1,0,11,0,358,89,29578,29568,36381,0,33,15,0,0,1,0,4,327,70,29412,27303,28754,0,31,19,166,1,2265,7627,1,0,0,0,7
EUW1_6769746868',4,28,11,1,0,0,0,13,1,337,77,27133,27852,23776,2,37,25,0,0,2,0,6,374,98,34415,33149,40617,0,-37,-21,-7282,-14,-5297,-16841,1,0,-2,0,7
EUW1_6769683456',4,30,10,1,0,0,0,8,0,417,82,27964,30847,32109,7,32,10,0,0,1,0,3,356,82,26500,29300,25541,0,61,0,1464,0,1547,6568,1,0,-1,0,5
EUW1_6769292190',1,25,11,0,0,0,0,12,1,324,97,26705,27410,31312,4,102,16,2,0,2,0,2,364,96,30731,32545,31788,0,-40,1,-4026,-5,-5135,-476,-2,0,-2,0,10
EUW1_6769044727',3,26,15,0,0,0,0,8,0,314,66,27140,27109,34156,3,34,21,1,0,1,0,1,332,98,31129,29063,36323,0,-18,-32,-3989,-6,-1954,-2167,-1,0,-1,0,7
EUW1_6768989771',5,27,11,1,0,0,0,9,1,403,84,26836,31784,30916,2,50,5,1,1,0,0,1,396,108,26207,30424,23631,1,7,-24,629,6,1360,7285,0,-1,0,0,8
EUW1_6768930017',2,22,5,1,0,0,0,6,0,374,90,23909,28021,24613,2,90,9,0,0,0,0,2,390,81,26027,31237,22747,0,-16,9,-2118,-4,-3216,1866,1,0,0,0,4
EUW1_6768799283',3,43,16,0,1,1,0,12,1,345,92,30213,29502,33960,4,92,17,2,0,1,0,5,330,98,30526,32000,39072,0,15,-6,-313,-1,-2498,-5112,-2,1,0,0,7
EUW1_6768779982',0,18,5,0,0,0,0,14,0,357,98,24078,29025,27977,3,42,18,2,0,1,0,0,365,94,31103,32457,33257,0,-8,4,-7025,-13,-3432,-5280,-2,0,-1,0,14
EUW1_6768407022',6,84,7,1,0,0,0,14,1,296,95,23011,26368,24407,4,27,16,1,0,1,0,0,363,76,29721,28693,33395,0,-67,19,-6710,-9,-2325,-8988,0,0,-1,0,14
EUW1_6768364964',0,49,13,0,0,1,0,9,1,345,70,28915,27905,33362,5,35,21,2,0,1,0,4,340,82,31582,30079,31868,0,5,-12,-2667,-8,-2174,1494,-2,0,0,0,5
EUW1_6768315529',6,23,14,1,0,0,0,7,0,335,91,28165,30262,37237,3,20,14,1,0,0,0,4,334,96,27980,29635,28797,0,1,-5,185,0,627,8440,0,0,0,0,3
EUW1_6883431123',4,69,9,2,0,0,0,5,0,365,104,26428,30077,20506,2,61,8,0,0,0,0,3,421,87,25810,29456,20470,1,-56,17,618,1,621,36,2,0,0,0,2
EUW1_6883349546',1,33,7,0,0,0,0,17,1,322,73,24763,26592,29855,4,45,28,1,0,6,0,1,383,94,37855,33463,45444,0,-61,-21,-13092,-21,-6871,-15589,-1,0,-6,0,16
EUW1_6883285810',8,32,12,0,0,1,0,13,0,383,82,29509,29899,29395,2,27,17,2,0,1,0,4,417,102,31152,31058,33512,0,-34,-20,-1643,-5,-1159,-4117,-2,0,0,0,9
EUW1_6882792177',5,28,18,1,0,0,0,14,0,370,94,31320,31828,35988,2,29,15,1,0,2,0,2,355,78,29194,29889,33835,1,15,16,2126,3,1939,2153,0,0,-2,0,12
EUW1_6881642546',6,39,5,0,0,0,0,16,0,361,80,24615,28739,17995,6,28,17,2,0,3,0,4,436,111,34064,33909,31513,0,-75,-31,-9449,-12,-5170,-13518,-2,0,-3,0,12
EUW1_6881495912',8,44,8,1,0,1,0,9,0,359,96,27375,28459,21456,8,31,15,1,1,0,0,7,367,99,29508,29160,30343,0,-8,-3,-2133,-7,-701,-8887,0,-1,1,0,2
EUW1_6880865913',6,27,9,2,0,0,0,13,0,355,93,24739,30077,22064,2,31,8,0,0,3,0,1,411,89,29510,31810,30057,1,-56,4,-4771,1,-1733,-7993,2,0,-3,0,12
EUW1_6880844647',5,50,10,2,0,0,0,11,0,364,76,27027,27853,24188,5,153,12,0,1,2,0,4,370,89,28044,28747,28404,1,-6,-13,-1017,-2,-894,-4216,2,-1,-2,0,7
EUW1_6878650362',6,27,22,1,0,2,0,8,1,362,80,32504,32489,43121,6,45,10,1,0,1,0,8,321,83,25981,26153,31254,1,41,-3,6523,12,6336,11867,0,0,1,0,0
EUW1_6878502574',4,32,9,0,0,1,0,7,1,370,88,26672,30789,33897,6,29,12,2,0,0,0,1,355,112,27603,31853,34695,0,15,-24,-931,-3,-1064,-798,-2,0,1,0,6
EUW1_6878456009',2,40,12,1,0,1,0,15,1,336,85,28263,28081,31067,3,29,18,0,0,2,0,5,359,122,31514,32650,38044,0,-23,-37,-3251,-6,-4569,-6977,1,0,-1,0,10
EUW1_6878330080',2,23,13,1,0,2,0,12,1,361,82,28876,28674,31760,4,31,23,1,0,1,0,8,337,73,32174,30844,37089,0,24,9,-3298,-10,-2170,-5329,0,0,1,0,4
EUW1_6878295507',4,65,14,0,0,2,0,10,0,365,98,28913,31476,27874,3,63,9,1,0,1,0,6,364,81,27388,29686,33655,0,1,17,1525,5,1790,-5781,-1,0,1,0,4
EUW1_6873063458',4,27,8,1,0,1,0,7,1,369,78,25766,27313,35459,2,29,12,0,0,1,0,6,333,77,25607,28348,25372,0,36,1,159,-4,-1035,10087,1,0,0,0,1
EUW1_6870118612',5,31,13,0,0,2,0,9,0,363,75,29247,29461,28515,8,42,9,0,0,0,0,7,338,68,24592,27568,24343,0,25,7,4655,4,1893,4172,0,0,2,0,2
EUW1_6869065122',2,24,14,1,1,0,0,9,0,325,94,27066,29096,34230,5,318,22,1,0,2,0,3,334,70,31958,29584,40124,0,-9,24,-4892,-8,-488,-5894,0,1,-2,0,6
EUW1_6867066409',3,26,10,2,0,2,0,15,0,397,80,28220,30146,27202,2,47,16,0,0,1,0,2,366,100,30627,31507,38000,1,31,-20,-2407,-6,-1361,-10798,2,0,1,0,13
EUW1_6866969329',5,29,9,1,0,0,0,10,0,365,106,25804,30542,26243,5,27,5,1,0,0,0,2,390,89,24798,28638,21369,1,-25,17,1006,4,1904,4874,0,0,0,0,8
EUW1_6862542705',4,23,12,1,0,0,0,7,1,330,98,27834,28540,30847,2,142,12,1,0,0,0,2,329,86,26605,29619,29969,1,1,12,1229,0,-1079,878,0,0,0,0,5
EUW1_6861341453',3,29,8,1,0,1,0,2,1,406,88,27338,30467,35232,5,32,8,1,0,0,0,9,391,91,25232,30757,25455,1,15,-3,2106,0,-290,9777,0,0,1,0,-7
EUW1_6861299358',5,32,13,0,0,0,0,8,0,333,89,28940,27046,34672,3,20,15,1,0,1,0,4,305,79,28075,26420,36728,1,28,10,865,-2,626,-2056,-1,0,-1,0,4
EUW1_6860133383',6,149,12,1,1,0,0,7,0,371,76,27884,29876,31725,3,27,10,1,0,2,0,3,392,96,27203,29817,26664,0,-21,-20,681,2,59,5061,0,1,-2,0,4
EUW1_6860029642',6,34,10,1,1,1,0,11,1,389,99,27353,30312,25682,7,31,8,0,0,1,0,2,427,88,27503,30205,25303,0,-38,11,-150,2,107,379,1,1,0,0,9
EUW1_6853650537',5,65,10,1,0,0,0,10,0,363,74,26398,29447,29999,3,61,7,0,0,0,0,1,366,74,25451,27864,31848,0,-3,0,947,3,1583,-1849,1,0,0,0,9
EUW1_6852104302',2,80,8,0,0,0,0,7,0,338,92,24364,26926,27199,3,27,16,1,0,2,0,2,386,84,30688,30844,34861,0,-48,8,-6324,-8,-3918,-7662,-1,0,-2,0,5
EUW1_6849421823',3,243,13,1,0,0,0,13,1,357,81,28697,30492,31456,4,32,14,0,0,1,0,2,443,81,30631,30900,29476,0,-86,0,-1934,-1,-408,1980,1,0,-1,0,11
EUW1_6847829799',3,20,7,1,0,1,0,18,1,351,70,25318,28138,24417,2,68,9,1,1,3,0,4,398,95,29474,29833,26544,0,-47,-25,-4156,-2,-1695,-2127,0,-1,-2,0,14
EUW1_6834626636',3,66,21,0,0,1,0,7,1,347,76,30150,30025,40119,7,31,14,2,0,1,0,5,311,73,27574,27041,36619,1,36,3,2576,7,2984,3500,-2,0,0,0,2
EUW1_6834439923',8,36,11,1,1,1,0,10,1,358,101,28131,30173,33078,3,26,9,1,0,0,0,3,386,94,26758,30116,34380,0,-28,7,1373,2,57,-1302,0,1,1,0,7
EUW1_6827558381',3,25,12,1,0,2,0,11,1,346,106,28615,31290,29709,4,26,10,1,0,2,0,9,286,82,25744,27965,29132,1,60,24,2871,2,3325,577,0,0,0,0,2
EUW1_6768366985',2,119,8,1,0,0,0,10,0,350,100,26772,28780,27899,4,30,15,1,1,3,0,7,337,89,29570,30555,28345,0,13,11,-2798,-7,-1775,-446,0,-1,-3,0,3
EUW1_6768242360',4,37,19,2,0,1,0,13,0,390,98,32063,31639,32611,5,22,5,0,0,0,0,4,342,94,24312,26452,23896,1,48,4,7751,14,5187,8715,2,0,1,0,9
EUW1_6767407344',4,23,7,0,0,2,0,8,1,349,84,26954,27844,25665,2,32,15,2,1,1,0,6,316,94,27981,29412,28955,1,33,-10,-1027,-8,-1568,-3290,-2,-1,1,0,2
EUW1_6766437734',3,22,8,1,0,2,0,10,1,336,88,26510,26969,20468,3,45,16,1,0,2,0,7,347,119,30991,31095,30053,0,-11,-31,-4481,-8,-4126,-9585,0,0,0,0,3
EUW1_6766376046',4,227,10,0,0,0,0,8,1,340,82,27237,28301,30116,4,26,15,2,0,0,0,7,342,114,28094,30435,40429,0,-2,-32,-857,-5,-2134,-10313,-2,0,0,0,1
EUW1_6764781273',3,32,7,0,0,1,0,7,0,417,71,27170,30068,19907,6,31,9,2,0,1,0,3,323,104,25283,28391,22880,0,94,-33,1887,-2,1677,-2973,-2,0,0,0,4
EUW1_6764769570',1,39,11,0,0,1,0,14,0,328,84,25962,28285,25401,4,29,14,1,0,2,0,2,371,68,29451,28864,32208,0,-43,16,-3489,-3,-579,-6807,-1,0,-1,0,12
EUW1_6878495824',4,26,18,1,0,1,0,13,1,313,90,30854,29512,37501,3,23,22,1,0,1,0,3,376,77,31999,30751,43863,1,-63,13,-1145,-4,-1239,-6362,0,0,0,0,10
EUW1_6878447843',3,30,19,2,0,0,0,14,1,332,84,30545,31368,41693,2,25,19,0,0,0,0,1,352,97,29333,31779,40846,1,-20,-13,1212,0,-411,847,2,0,0,0,13
EUW1_6878002566',3,65,15,1,0,0,0,8,1,374,100,29095,32193,44552,1,23,9,1,0,0,0,2,378,103,26306,31209,35692,1,-4,-3,2789,6,984,8860,0,0,0,0,6
EUW1_6876560625',5,27,9,0,0,0,0,7,1,391,107,27302,30404,25724,2,23,2,2,0,1,0,6,357,91,22645,27663,23702,1,34,16,4657,7,2741,2022,-2,0,-1,0,1
EUW1_6869337769',6,21,11,0,0,0,0,16,1,368,87,27152,30425,28036,3,26,18,2,0,1,0,1,409,104,33174,33815,37884,0,-41,-17,-6022,-7,-3390,-9848,-2,0,-1,0,15
EUW1_6868272898',9,30,8,0,0,1,0,14,0,380,92,27218,27458,26465,4,26,14,2,1,1,0,5,394,93,29754,31909,32965,0,-14,-1,-2536,-6,-4451,-6500,-2,-1,0,0,9
EUW1_6868212492',2,39,19,2,0,1,0,7,0,365,92,31178,30988,38738,4,32,14,0,0,0,0,3,311,108,27854,29304,33077,1,54,-16,3324,5,1684,5661,2,0,1,0,4
EUW1_6883524899',3,33,11,0,0,1,0,10,0,369,92,29680,30484,35369,4,27,17,1,0,1,0,5,323,86,27408,30052,38691,0,46,6,2272,-6,432,-3322,-1,0,0,0,5
EUW1_6883438314',8,31,17,2,0,1,0,4,0,366,94,29897,31044,38611,3,27,10,0,0,0,0,10,322,72,25796,29058,33264,1,44,22,4101,7,1986,5347,2,0,1,0,-6
EUW1_6874595996',5,37,13,2,1,0,0,12,0,353,91,28746,29934,33684,8,35,10,0,0,1,0,2,373,92,27672,29580,37052,0,-20,-1,1074,3,354,-3368,2,1,-1,0,10
EUW1_6874511971',2,29,5,1,0,0,0,12,0,366,77,24926,27313,33977,6,113,23,0,0,3,0,4,375,101,33666,34386,42627,0,-9,-24,-8740,-18,-7073,-8650,1,0,-3,0,8
EUW1_6872994941',4,29,8,0,0,0,0,8,1,367,88,25064,27338,21215,4,29,7,2,0,1,0,3,401,111,26965,30707,21843,0,-34,-23,-1901,1,-3369,-628,-2,0,-1,0,5
EUW1_6872920447',3,26,13,0,0,1,0,7,0,424,88,29871,31008,29291,5,23,13,2,0,0,0,4,355,75,27917,29178,28795,1,69,13,1954,0,1830,496,-2,0,1,0,3
EUW1_6870355108',5,21,13,0,0,1,0,9,0,335,72,27259,28080,29513,2,25,11,1,0,0,0,1,348,102,26486,27312,25090,1,-13,-30,773,2,768,4423,-1,0,1,0,8
EUW1_6866847043',6,46,9,2,0,4,0,8,1,375,104,29105,28282,23314,2,30,11,0,0,0,0,5,311,102,26691,27020,26838,0,64,2,2414,-2,1262,-3524,2,0,4,0,3
EUW1_6866797386',5,22,10,1,0,0,0,8,0,343,98,25541,29776,40398,7,27,16,1,0,1,0,1,355,92,29961,31062,37991,0,-12,6,-4420,-6,-1286,2407,0,0,-1,0,7
EUW1_6866721626',5,25,16,2,0,0,0,10,0,353,80,28635,30227,34669,8,38,11,0,0,1,0,3,333,77,27140,27455,26965,1,20,3,1495,5,2772,7704,2,0,-1,0,7
EUW1_6865980341',7,25,9,0,0,0,0,7,0,375,94,26518,29973,26966,3,21,19,2,1,1,0,3,408,92,31977,32668,35221,0,-33,2,-5459,-10,-2695,-8255,-2,-1,-1,0,4
EUW1_6865906205',8,34,11,1,0,0,0,6,1,349,86,26754,27358,34472,4,29,11,1,0,0,0,8,319,80,25879,28332,35216,0,30,6,875,0,-974,-744,0,0,0,0,-2
EUW1_6865327796',2,28,9,1,0,0,0,11,0,346,78,25941,29675,25510,9,27,18,1,0,2,0,0,374,97,31609,31553,34156,0,-28,-19,-5668,-9,-1878,-8646,0,0,-2,0,11
EUW1_6865246755',5,30,12,1,0,2,0,10,0,379,62,28869,29896,29666,5,21,19,1,0,0,0,4,347,98,29741,29936,31809,1,32,-36,-872,-7,-40,-2143,0,0,2,0,6
EUW1_6865179815',1,28,11,1,0,1,0,7,1,377,96,28204,30417,35397,3,24,11,0,0,1,0,5,352,95,27510,30079,35430,0,25,1,694,0,338,-33,1,0,0,0,2
EUW1_6863831855',6,27,11,1,0,0,0,7,1,420,92,26578,30857,25394,4,31,11,1,0,0,0,4,364,92,25755,28466,26053,1,56,0,823,0,2391,-659,0,0,0,0,3
EUW1_6863758109',4,27,13,1,0,2,0,8,1,388,123,30578,31835,34686,3,24,5,1,0,0,0,4,393,72,24974,28010,21387,1,-5,51,5604,8,3825,13299,0,0,2,0,4
EUW1_6863699589',6,44,16,2,0,3,0,4,0,375,79,31094,30082,37210,6,42,7,0,0,0,0,9,303,90,23799,27046,29647,1,72,-11,7295,9,3036,7563,2,0,3,0,-5
EUW1_6862817836',3,28,14,0,0,1,0,14,0,327,82,28262,27063,27507,6,29,17,2,1,1,0,2,352,90,29440,28761,29634,0,-25,-8,-1178,-3,-1698,-2127,-2,-1,0,0,12
EUW1_6883136096',3,30,14,0,0,0,0,9,0,320,129,28332,30158,41496,6,25,20,2,0,1,0,6,336,81,32013,32399,50183,1,-16,48,-3681,-6,-2241,-8687,-2,0,-1,0,3
EUW1_6883059483',6,28,6,0,0,0,0,8,0,380,106,24721,30252,19077,2,36,8,2,0,1,0,0,400,134,27174,31324,30826,0,-20,-28,-2453,-2,-1072,-11749,-2,0,-1,0,8
EUW1_6882987782',5,25,11,1,0,0,0,14,0,347,104,27370,29417,29760,2,28,15,1,0,2,0,1,387,80,29994,29535,32487,0,-40,24,-2624,-4,-118,-2727,0,0,-2,0,13
EUW1_6882930097',3,35,18,1,0,0,0,9,1,346,76,30712,29073,37552,5,43,18,1,0,1,0,1,358,85,31642,29793,40471,0,-12,-9,-930,0,-720,-2919,0,0,-1,0,8
EUW1_6882831402',4,27,13,1,0,0,0,13,1,328,76,26781,27705,37362,6,32,16,1,0,1,0,1,361,73,30165,29017,45329,1,-33,3,-3384,-3,-1312,-7967,0,0,-1,0,12
EUW1_6882773120',2,41,8,1,0,0,0,10,0,404,101,26545,30739,19863,2,71,8,0,0,0,0,5,391,84,26329,30132,22721,1,13,17,216,0,607,-2858,1,0,0,0,5
EUW1_6882694891',6,31,14,0,0,0,0,9,0,362,70,28479,30123,35357,6,47,11,1,0,1,0,3,303,85,25582,26299,32348,1,59,-15,2897,3,3824,3009,-1,0,-1,0,6
EUW1_6882601683',1,28,9,1,1,1,0,9,1,426,90,27864,30791,31609,7,78,9,0,0,0,0,3,387,84,26496,30835,25125,0,39,6,1368,0,-44,6484,1,1,1,0,6
EUW1_6882516146',6,36,8,0,0,1,0,7,0,415,87,27105,30178,33295,4,28,7,1,0,0,0,4,350,82,24023,27421,25859,0,65,5,3082,1,2757,7436,-1,0,1,0,3
EUW1_6882488718',4,26,10,0,0,0,0,16,0,327,72,24175,27057,22688,5,26,13,2,1,3,0,3,407,103,30643,31699,29618,0,-80,-31,-6468,-3,-4642,-6930,-2,-1,-3,0,13
EUW1_6881874462',2,27,8,0,0,0,0,13,0,326,78,26157,28390,33129,1,26,13,2,0,3,0,4,354,93,29357,30748,30042,0,-28,-15,-3200,-5,-2358,3087,-2,0,-3,0,9
EUW1_6881673374',3,24,21,0,0,2,0,6,1,389,72,32816,31849,42707,2,24,21,1,0,0,0,8,299,76,28636,29758,37474,1,90,-4,4180,0,2091,5233,-1,0,2,0,-2
EUW1_6881496792',3,319,13,1,0,1,0,11,1,318,84,28455,29320,30833,4,22,17,0,0,2,0,2,386,104,30675,31295,35971,0,-68,-20,-2220,-4,-1975,-5138,1,0,-1,0,9
EUW1_6876377434',1,27,11,0,0,0,0,14,0,321,70,25972,28015,29417,5,26,21,1,1,3,0,1,369,102,33835,33255,46297,0,-48,-32,-7863,-10,-5240,-16880,-1,-1,-3,0,13
EUW1_6876371940',5,27,25,1,0,3,0,11,1,371,91,37666,31876,38134,3,31,8,1,0,1,0,9,296,74,25081,25375,20957,1,75,17,12585,17,6501,17177,0,0,2,0,2
EUW1_6876357047',3,27,8,0,1,0,0,10,1,331,88,24935,27086,29319,1,31,22,2,0,1,0,0,328,92,31138,30413,36676,0,3,-4,-6203,-14,-3327,-7357,-2,1,-1,0,10
EUW1_6876320349',3,257,13,1,0,1,0,9,1,310,88,27374,26656,28900,3,21,10,1,0,1,0,5,364,90,27648,31777,24537,1,-54,-2,-274,3,-5121,4363,0,0,0,0,4
EUW1_6876206696',4,21,15,1,0,1,0,8,0,367,108,30046,31001,31600,4,99,18,0,0,0,0,5,367,100,29491,30748,36559,0,0,8,555,-3,253,-4959,1,0,1,0,3
EUW1_6876159471',0,38,17,1,0,3,0,7,1,359,116,32761,30288,39738,2,31,15,1,1,0,0,11,305,84,26606,29669,28213,1,54,32,6155,2,619,11525,0,-1,3,0,-4
EUW1_6875812847',5,26,14,1,0,0,0,6,0,350,72,27246,30147,35877,6,43,9,0,0,1,0,1,359,84,26511,28228,27111,1,-9,-12,735,5,1919,8766,1,0,-1,0,5
EUW1_6875726549',5,43,23,1,0,2,0,11,1,354,92,32458,31861,37669,3,26,8,1,0,0,0,4,319,92,24684,26861,27722,1,35,0,7774,15,5000,9947,0,0,2,0,7
EUW1_6875658287',5,27,21,0,0,0,0,6,1,383,92,31183,33207,35441,5,27,7,1,0,1,0,2,416,88,26195,28639,35779,1,-33,4,4988,14,4568,-338,-1,0,-1,0,4
EUW1_6875611169',2,27,6,1,0,0,0,10,0,288,83,21614,26063,25550,4,31,13,0,0,2,0,0,379,108,29075,31042,31734,0,-91,-25,-7461,-7,-4979,-6184,1,0,-2,0,10
EUW1_6875021826',0,25,18,1,1,3,0,7,1,348,108,31566,30309,27476,2,40,9,1,0,0,0,12,285,96,23976,25246,25463,1,63,12,7590,9,5063,2013,0,1,3,0,-5
EUW1_6875007010',3,65,10,2,0,1,0,8,0,368,96,26921,28700,24091,4,47,13,0,0,0,0,3,363,80,27355,30077,33938,1,5,16,-434,-3,-1377,-9847,2,0,1,0,5
EUW1_6874986700',6,27,18,1,0,0,0,9,1,372,92,29590,32142,39617,3,29,15,1,0,1,0,1,370,78,29145,28392,32739,1,2,14,445,3,3750,6878,0,0,-1,0,8
EUW1_6874868184',5,57,22,2,1,2,0,9,0,407,106,34397,34139,48309,2,23,13,0,0,1,0,8,354,82,27222,29076,27166,1,53,24,7175,9,5063,21143,2,1,1,0,1
EUW1_6883572203',4,212,10,1,0,1,0,11,0,363,76,26122,27587,25079,3,24,11,1,0,1,0,3,389,92,27961,31174,29364,1,-26,-16,-1839,-1,-3587,-4285,0,0,0,0,8
EUW1_6883537092',6,27,4,1,0,0,0,11,0,356,64,22873,26625,22842,5,28,15,0,1,3,0,2,373,84,30128,30449,33022,0,-17,-20,-7255,-11,-3824,-10180,1,-1,-3,0,9
EUW1_6883496910',3,26,10,2,0,1,0,10,1,364,114,28418,29539,23004,7,32,9,0,0,0,0,4,386,90,25936,28780,22489,1,-22,24,2482,1,759,515,2,0,1,0,6
EUW1_6883460794',1,24,6,0,0,0,0,11,0,367,74,24448,29064,21676,3,28,11,2,1,1,0,2,365,118,28252,30280,28634,0,2,-44,-3804,-5,-1216,-6958,-2,-1,-1,0,9
EUW1_6883418796',2,27,10,1,0,0,0,13,0,332,80,25505,29255,36051,3,288,19,1,0,2,0,1,356,78,30470,29761,35392,1,-24,2,-4965,-9,-506,659,0,0,-2,0,12
EUW1_6883352260',2,219,6,0,0,0,0,15,0,337,78,23806,25678,25091,5,76,21,1,0,5,0,3,416,96,34671,34096,38770,0,-79,-18,-10865,-15,-8418,-13679,-1,0,-5,0,12
EUW1_6883293776',6,29,11,1,0,0,0,8,0,387,98,29041,30377,28689,5,23,11,1,0,2,0,5,349,80,27011,30475,26828,1,38,18,2030,0,-98,1861,0,0,-2,0,3
EUW1_6883208970',6,29,11,0,0,1,0,6,1,381,66,27447,29396,29372,3,23,8,2,0,0,0,1,351,106,25547,28652,27934,1,30,-40,1900,3,744,1438,-2,0,1,0,5
EUW1_6883151955',4,25,12,0,0,0,0,10,0,347,83,26930,26854,30549,2,260,22,2,0,2,0,1,388,88,33360,32084,34063,0,-41,-5,-6430,-10,-5230,-3514,-2,0,-2,0,9
EUW1_6883098369',4,40,21,2,0,2,0,10,1,353,88,31496,32608,38812,1,23,14,0,0,1,0,3,308,82,27691,28150,35496,1,45,6,3805,7,4458,3316,2,0,1,0,7
EUW1_6883039767',2,24,9,1,0,0,0,12,1,357,95,26636,30761,27982,6,51,12,1,0,1,0,1,373,88,28088,29974,29591,1,-16,7,-1452,-3,787,-1609,0,0,-1,0,11
EUW1_6882998878',2,23,13,0,0,2,0,10,1,359,74,29085,30047,34240,1,76,11,1,0,0,0,2,346,118,27454,31149,33153,0,13,-44,1631,2,-1102,1087,-1,0,2,0,8
EUW1_6882905364',4,21,16,0,0,1,0,8,0,372,96,31032,29625,36357,2,25,14,1,0,0,0,2,381,99,29139,30963,34003,1,-9,-3,1893,2,-1338,2354,-1,0,1,0,6
EUW1_6882838112',2,24,15,0,0,0,0,10,0,323,87,28285,28694,47698,4,27,18,2,0,2,0,3,346,82,29972,29373,46444,1,-23,5,-1687,-3,-679,1254,-2,0,-2,0,7
EUW1_6882802702',2,31,8,0,0,1,0,11,0,315,83,24183,27907,24348,4,21,16,2,0,2,0,3,357,92,29440,29785,34043,0,-42,-9,-5257,-8,-1878,-9695,-2,0,-1,0,8
EUW1_6882749225',2,25,16,2,0,1,0,10,1,352,92,30875,30293,36157,4,27,10,0,0,1,0,6,345,64,26368,27617,26251,1,7,28,4507,6,2676,9906,2,0,0,0,4
EUW1_6882701432',3,30,13,0,0,0,0,7,1,366,111,28660,30450,29853,5,30,15,2,0,1,0,4,363,82,28280,29498,28819,0,3,29,380,-2,952,1034,-2,0,-1,0,3
EUW1_6882668959',2,27,11,0,0,0,0,4,1,317,82,24934,26779,30365,5,214,20,2,1,1,0,3,363,114,30108,32399,41211,0,-46,-32,-5174,-9,-5620,-10846,-2,-1,-1,0,1
EUW1_6882310324',4,41,11,1,0,0,0,7,1,342,84,26117,27890,26297,2,23,8,0,0,2,0,4,374,80,26956,29472,24918,1,-32,4,-839,3,-1582,1379,1,0,-2,0,3
EUW1_6882306542',6,27,12,1,0,0,0,13,0,284,91,26283,26630,34932,6,31,16,1,0,2,0,0,362,79,30186,31092,38964,1,-78,12,-3903,-4,-4462,-4032,0,0,-2,0,13
EUW1_6865594526',6,27,15,2,0,1,0,8,0,343,59,27503,30008,34983,4,25,17,0,0,2,0,6,327,100,29877,29699,38965,1,16,-41,-2374,-2,309,-3982,2,0,-1,0,2
EUW1_6862909085',3,29,11,1,0,1,0,12,1,363,101,27786,30997,26790,4,32,4,1,0,0,0,5,371,94,24255,28806,28813,1,-8,7,3531,7,2191,-2023,0,0,1,0,7
EUW1_6862853826',6,27,10,0,0,0,0,11,1,318,108,25784,29797,26940,4,32,18,1,0,1,0,2,383,76,30343,31231,40587,0,-65,32,-4559,-8,-1434,-13647,-1,0,-1,0,9
EUW1_6862793925',1,25,4,0,0,0,0,15,0,343,63,23860,27363,20668,5,32,16,1,0,3,0,0,406,84,31137,31211,33879,0,-63,-21,-7277,-12,-3848,-13211,-1,0,-3,0,15
EUW1_6848463421',1,24,18,0,0,0,0,9,0,348,85,30738,30684,37460,1,39,16,1,0,1,0,4,312,91,27635,29384,31095,1,36,-6,3103,2,1300,6365,-1,0,-1,0,5
EUW1_6848423822',0,20,12,1,0,0,0,12,0,254,79,24795,22948,27637,5,30,11,0,0,2,0,4,365,116,28431,30681,30019,1,-111,-37,-3636,1,-7733,-2382,1,0,-2,0,8
EUW1_6848352498',4,29,14,2,0,0,0,12,1,356,98,27789,31614,30954,5,50,15,0,0,1,0,1,376,91,28903,30923,35021,1,-20,7,-1114,-1,691,-4067,2,0,-1,0,11
EUW1_6831636285',5,107,13,0,0,2,0,11,1,341,68,28517,29555,34889,7,29,11,1,0,2,0,5,368,76,28850,28802,31139,1,-27,-8,-333,2,753,3750,-1,0,0,0,6
EUW1_6816898643',3,31,19,2,1,0,0,14,0,382,110,30659,33313,41812,4,25,6,0,0,2,0,2,367,78,25664,28655,32319,1,15,32,4995,13,4658,9493,2,1,-2,0,12
EUW1_6816846413',4,29,15,1,1,1,0,7,1,376,98,31116,31906,34702,4,36,4,1,0,1,0,6,349,95,22822,28263,19446,1,27,3,8294,11,3643,15256,0,1,0,0,1
EUW1_6816795575',3,24,11,1,0,1,0,7,1,360,129,28042,31502,32901,0,32,7,1,0,0,0,4,362,70,24947,28777,29898,1,-2,59,3095,4,2725,3003,0,0,1,0,3
EUW1_6815648189',2,23,14,0,1,0,0,5,1,336,96,28220,28771,33422,8,32,18,2,0,0,0,2,374,94,29240,30951,34913,0,-38,2,-1020,-4,-2180,-1491,-2,1,0,0,3
EUW1_6815134857',7,35,14,1,0,1,0,14,1,292,88,27600,28869,32854,4,27,18,1,0,0,0,1,350,75,30328,30090,41577,0,-58,13,-2728,-4,-1221,-8723,0,0,1,0,13
EUW1_6765360483',6,39,13,0,0,1,0,9,1,381,95,29490,31167,27729,6,28,12,2,0,0,0,4,366,87,27317,28724,30614,0,15,8,2173,1,2443,-2885,-2,0,1,0,5
EUW1_6731989422',7,30,14,1,0,0,0,9,1,389,112,27346,31199,29483,2,48,10,1,0,1,0,3,370,96,27435,30907,29181,1,19,16,-89,4,292,302,0,0,-1,0,6
EUW1_6731939312',8,29,19,1,0,0,0,17,1,272,90,28074,28739,35804,2,23,18,0,1,3,0,3,402,77,33529,32023,35565,0,-130,13,-5455,1,-3284,239,1,-1,-3,0,14
EUW1_6730505148',2,25,7,1,0,0,0,14,1,276,96,23209,25695,22748,5,25,14,1,1,2,0,0,374,72,30157,29600,30245,0,-98,24,-6948,-7,-3905,-7497,0,-1,-2,0,14
EUW1_6730444780',2,20,13,0,0,0,0,16,0,347,50,26417,28240,24378,4,33,12,2,1,2,0,2,380,104,29803,29862,31488,0,-33,-54,-3386,1,-1622,-7110,-2,-1,-2,0,14
EUW1_6730393179',3,43,17,2,0,2,0,14,0,323,84,30829,29206,33835,2,25,13,0,1,2,0,6,354,92,28803,29082,32728,1,-31,-8,2026,4,124,1107,2,-1,0,0,8
EUW1_6883390097',6,32,18,0,0,1,0,9,0,313,83,30287,29124,42124,3,23,19,2,0,0,0,4,380,71,31271,31008,38930,1,-67,12,-984,-1,-1884,3194,-2,0,1,0,5
EUW1_6883306006',3,25,17,0,1,1,0,13,0,371,112,30691,31565,30299,6,34,11,1,0,2,0,4,365,91,28362,28579,36149,1,6,21,2329,6,2986,-5850,-1,1,-1,0,9
EUW1_6883013383',3,81,14,0,0,2,0,10,1,408,108,31907,31615,37393,5,28,16,1,0,1,0,7,338,90,29539,30276,40348,1,70,18,2368,-2,1339,-2955,-1,0,1,0,3
EUW1_6880488431',3,54,8,0,0,3,0,13,0,392,100,28605,28877,29724,5,74,16,1,0,1,0,9,354,74,28689,28512,39366,0,38,26,-84,-8,365,-9642,-1,0,2,0,4
EUW1_6879447883',2,27,6,0,0,1,0,10,1,374,107,26707,28670,21567,3,33,17,2,0,1,0,3,426,108,30486,33323,35820,0,-52,-1,-3779,-11,-4653,-14253,-2,0,0,0,7
EUW1_6878294945',5,34,9,2,0,0,0,9,0,377,100,25949,29560,33964,5,32,13,0,0,1,0,0,419,101,30541,32664,33088,1,-42,-1,-4592,-4,-3104,876,2,0,-1,0,9
EUW1_6878216340',7,46,18,0,0,0,0,8,1,359,100,28872,29321,32661,2,31,12,1,0,1,0,1,377,78,27910,28768,29517,0,-18,22,962,6,553,3144,-1,0,-1,0,7
EUW1_6876715632',9,31,8,1,1,1,0,6,0,417,100,26472,30888,27444,2,29,7,1,0,0,0,2,404,106,25419,30738,19144,1,13,-6,1053,1,150,8300,0,1,1,0,4
EUW1_6876659934',3,29,16,2,0,0,0,11,1,402,76,30710,33203,38367,3,71,15,0,1,1,0,6,372,126,29588,32341,35691,0,30,-50,1122,1,862,2676,2,-1,-1,0,5
EUW1_6876598387',3,27,9,1,0,1,0,12,0,353,97,25873,28754,25826,5,30,11,0,0,2,0,4,410,94,28158,30219,24759,1,-57,3,-2285,-2,-1465,1067,1,0,-1,0,8
EUW1_6876539678',4,24,10,2,0,0,0,8,0,383,77,26493,28382,27408,3,45,9,0,1,2,0,2,396,122,27570,31277,28199,0,-13,-45,-1077,1,-2895,-791,2,-1,-2,0,6
EUW1_6876513839',4,28,7,0,0,0,0,11,1,347,69,24049,26630,24109,5,51,16,2,0,1,0,2,368,97,29922,32148,30877,0,-21,-28,-5873,-9,-5518,-6768,-2,0,-1,0,9
EUW1_6876469109',1,37,24,0,1,0,0,8,0,369,97,33122,32532,38789,3,29,13,0,0,1,0,2,363,88,28342,28883,36789,1,6,9,4780,11,3649,2000,0,1,-1,0,6
EUW1_6876461519',4,33,11,1,0,0,0,7,1,338,90,26001,28356,33524,1,29,10,0,0,0,0,1,379,117,26784,30183,23653,1,-41,-27,-783,1,-1827,9871,1,0,0,0,6
EUW1_6875142636',2,20,13,0,0,2,0,12,0,356,104,30524,30087,33901,3,22,6,1,0,1,0,9,362,71,24907,26595,25536,1,-6,33,5617,7,3492,8365,-1,0,1,0,3
EUW1_6875111089',2,48,9,0,0,1,0,12,0,354,91,26569,27406,23575,6,33,20,2,0,2,0,4,400,128,33791,33495,36564,0,-46,-37,-7222,-11,-6089,-12989,-2,0,-1,0,8
EUW1_6875093412',3,31,11,0,0,0,0,11,0,346,105,26326,28862,31998,4,36,21,2,0,2,0,1,398,106,32710,32142,42398,0,-52,-1,-6384,-10,-3280,-10400,-2,0,-2,0,10
EUW1_6875084966',7,35,14,0,0,0,0,12,0,335,66,28357,28427,32815,2,25,17,1,0,1,0,4,354,77,29046,29938,37061,0,-19,-11,-689,-3,-1511,-4246,-1,0,-1,0,8
EUW1_6874170297',2,24,13,0,0,0,0,13,0,384,92,31163,30523,31925,5,39,16,2,0,3,0,5,388,89,30774,28388,33705,0,-4,3,389,-3,2135,-1780,-2,0,-3,0,8
EUW1_6873841616',5,27,14,0,0,1,0,10,1,360,74,27882,27007,31978,2,23,18,1,0,0,0,5,308,86,27791,28282,37440,0,52,-12,91,-4,-1275,-5462,-1,0,1,0,5
EUW1_6877633087',7,36,19,0,1,1,0,8,0,376,82,32047,31300,41283,5,39,19,0,0,1,0,6,354,106,31501,31540,49327,1,22,-24,546,0,-240,-8044,0,1,0,0,2
EUW1_6876080828',3,26,10,2,0,1,0,12,0,380,92,27947,29987,27663,1,24,11,0,0,1,0,4,358,94,26814,30422,24294,1,22,-2,1133,-1,-435,3369,2,0,0,0,8
EUW1_6873450172',4,29,18,2,1,2,0,7,0,357,127,32448,33161,38245,5,26,10,0,0,0,0,7,346,80,26340,28545,26369,1,11,47,6108,8,4616,11876,2,1,2,0,0
EUW1_6872081096',2,36,13,1,0,1,0,9,0,351,83,29962,30441,28296,7,30,16,1,0,1,0,3,399,105,30001,31100,33117,1,-48,-22,-39,-3,-659,-4821,0,0,0,0,6
EUW1_6870747212',2,28,14,0,0,0,0,8,1,371,99,29837,30123,33806,5,34,11,1,0,1,0,6,348,72,25274,26719,24060,1,23,27,4563,3,3404,9746,-1,0,-1,0,2
EUW1_6868959089',2,27,10,1,0,2,0,9,1,357,71,28615,29268,26671,3,35,15,0,1,0,0,4,341,101,29005,30333,40717,0,16,-30,-390,-5,-1065,-14046,1,-1,2,0,5
EUW1_6849407710',3,193,12,0,0,0,0,11,0,310,58,26807,25758,31644,2,36,25,1,0,1,0,4,360,118,34967,34484,43823,0,-50,-60,-8160,-13,-8726,-12179,-1,0,-1,0,7
EUW1_6849363742',1,25,12,0,0,2,0,10,0,379,104,29177,29593,31567,3,46,12,2,0,1,0,4,299,90,28119,27829,29126,1,80,14,1058,0,1764,2441,-2,0,1,0,6
EUW1_6849242684',1,32,26,0,0,2,0,15,1,355,65,34067,30091,50984,5,50,19,0,0,1,0,6,278,97,31208,27146,44179,1,77,-32,2859,7,2945,6805,0,0,1,0,9
EUW1_6848869177',3,62,11,1,0,1,0,2,1,363,85,27617,28692,29213,6,28,7,0,0,0,0,5,399,90,25231,29871,27487,1,-36,-5,2386,4,-1179,1726,1,0,1,0,-3
EUW1_6848047342',8,41,5,0,0,0,0,13,0,353,77,23618,26829,20957,2,56,13,1,0,1,0,2,387,91,30026,29215,31267,0,-34,-14,-6408,-8,-2386,-10310,-1,0,-1,0,11
EUW1_6847996961',6,44,14,0,0,0,0,7,1,375,99,29260,30975,30543,6,29,20,1,0,0,0,3,385,108,31117,31567,39176,1,-10,-9,-1857,-6,-592,-8633,-1,0,0,0,4
EUW1_6883207743',4,30,12,1,0,2,0,8,0,440,96,31868,33016,29701,3,27,13,0,0,1,0,7,385,80,27715,29875,30408,1,55,16,4153,-1,3141,-707,1,0,1,0,1
EUW1_6883132047',2,19,7,1,0,0,0,6,0,402,103,26268,31189,35886,2,36,7,1,0,0,0,3,353,76,24071,29780,26675,1,49,27,2197,0,1409,9211,0,0,0,0,3
EUW1_6883017810',3,31,13,1,0,1,0,12,1,339,80,30149,28717,32035,5,43,13,1,0,1,0,5,331,76,26321,27784,34780,1,8,4,3828,0,933,-2745,0,0,0,0,7
EUW1_6882763067',4,23,13,1,0,0,0,14,1,356,92,26790,29665,30288,2,29,13,1,0,2,0,2,344,96,29120,30461,30591,0,12,-4,-2330,0,-796,-303,0,0,-2,0,12
EUW1_6882712726',10,32,17,1,0,1,0,9,1,361,101,30373,29432,41417,2,64,13,0,0,1,0,3,360,94,27577,30885,28918,1,1,7,2796,4,-1453,12499,1,0,0,0,6
EUW1_6882095296',6,34,19,1,0,3,0,10,1,398,98,33704,32819,37458,1,19,14,0,0,0,0,8,342,80,27863,28663,32757,1,56,18,5841,5,4156,4701,1,0,3,0,2
EUW1_6882067163',4,35,18,2,1,2,0,14,1,373,85,31559,31036,33614,2,31,7,0,0,1,0,6,360,82,26255,27784,27980,1,13,3,5304,11,3252,5634,2,1,1,0,8
EUW1_6882028338',2,30,19,2,0,4,0,5,1,456,95,35997,33246,38603,2,19,7,0,0,3,0,10,282,64,23301,25131,20573,1,174,31,12696,12,8115,18030,2,0,1,0,-5
EUW1_6881957869',3,63,16,1,0,0,0,17,1,372,81,28234,30954,35524,5,25,14,1,0,4,0,4,371,78,30638,31575,36937,0,1,3,-2404,2,-621,-1413,0,0,-4,0,13
EUW1_6881901545',4,30,17,1,0,1,0,4,1,344,102,29833,30023,45087,3,129,19,1,0,0,0,6,280,62,27709,29108,35692,1,64,40,2124,-2,915,9395,0,0,1,0,-2
EUW1_6876555796',3,29,13,1,0,2,0,8,0,418,90,29525,31364,28825,7,29,11,0,0,0,0,3,355,101,26809,29143,27294,1,63,-11,2716,2,2221,1531,1,0,2,0,5
EUW1_6876231977',0,27,6,0,0,3,0,5,0,375,82,26427,28793,28711,8,28,13,1,0,0,0,8,398,90,28045,30834,29208,1,-23,-8,-1618,-7,-2041,-497,-1,0,3,0,-3
EUW1_6875801207',4,32,8,2,0,0,0,5,1,405,93,27291,31029,28424,2,126,10,0,1,0,0,3,397,127,27635,31903,31886,0,8,-34,-344,-2,-874,-3462,2,-1,0,0,2
EUW1_6875760536',0,20,14,0,0,1,0,10,1,337,97,29472,30453,29357,6,51,13,1,1,1,0,8,355,71,27936,29483,37994,0,-18,26,1536,1,970,-8637,-1,-1,0,0,2
EUW1_6800090404',5,56,18,1,0,1,0,6,1,330,116,27980,29253,27576,3,55,4,0,0,0,0,8,291,0,19936,22607,23867,1,39,116,8044,14,6646,3709,1,0,1,0,-2
EUW1_6800034083',1,30,12,2,0,0,0,9,0,413,96,28745,32207,28585,2,22,12,0,0,1,0,4,395,72,27373,29490,31203,1,18,24,1372,0,2717,-2618,2,0,-1,0,5
EUW1_6799983805',2,26,16,1,0,1,0,11,1,332,98,30139,28958,33012,3,23,19,0,0,1,0,4,367,84,32342,31690,35038,0,-35,14,-2203,-3,-2732,-2026,1,0,0,0,7
EUW1_6799947666',2,24,14,1,1,1,0,6,0,388,111,30053,33482,33208,4,25,7,0,0,0,0,5,319,68,23456,26951,27909,1,69,43,6597,7,6531,5299,1,1,1,0,1
EUW1_6799894023',6,26,17,1,0,3,0,8,1,387,89,32172,31294,35188,3,102,7,0,0,1,0,5,357,98,25685,29516,23024,1,30,-9,6487,10,1778,12164,1,0,2,0,3
EUW1_6799831982',3,88,14,1,0,0,0,9,1,328,94,28743,29147,31565,9,64,18,0,1,0,0,6,330,74,28644,28899,38559,1,-2,20,99,-4,248,-6994,1,-1,0,0,3
EUW1_6799765982',8,33,8,1,0,0,0,11,0,355,90,25572,29559,25738,8,36,13,0,0,1,0,2,395,110,29188,31382,31880,1,-40,-20,-3616,-5,-1823,-6142,1,0,-1,0,9
EUW1_6779369134',2,27,10,1,0,0,0,9,0,353,87,25859,28902,28671,3,103,17,0,1,2,0,0,370,108,31818,33511,36449,0,-17,-21,-5959,-7,-4609,-7778,1,-1,-2,0,9
EUW1_6779303281',4,48,10,0,0,1,0,7,1,346,93,27116,28048,33458,4,39,11,1,0,1,0,7,355,96,26582,29118,29481,0,-9,-3,534,-1,-1070,3977,-1,0,0,0,0
EUW1_6779244732',3,27,13,2,1,1,0,6,1,383,89,29897,30520,39877,0,21,11,0,0,0,0,4,327,97,26635,28503,27952,1,56,-8,3262,2,2017,11925,2,1,1,0,2
EUW1_6779187793',4,21,10,0,0,0,0,11,1,386,76,25913,29508,22142,0,44,19,1,1,2,0,1,390,96,31573,32960,37471,0,-4,-20,-5660,-9,-3452,-15329,-1,-1,-2,0,10
EUW1_6770069104',3,27,8,1,0,0,0,10,0,353,74,24413,28101,27413,2,25,11,1,0,1,0,0,383,88,28061,29949,31272,0,-30,-14,-3648,-3,-1848,-3859,0,0,-1,0,10
EUW1_6770050856',3,36,18,0,0,3,0,12,1,381,70,32998,29121,28471,6,31,8,1,0,2,0,8,338,95,27559,27966,20044,1,43,-25,5439,10,1155,8427,-1,0,1,0,4
EUW1_6769360876',3,24,17,0,0,0,0,12,0,284,97,28304,27912,35760,1,22,14,1,1,2,0,6,371,105,30560,31692,34793,0,-87,-8,-2256,3,-3780,967,-1,-1,-2,0,6
EUW1_6769284133',4,32,12,0,0,1,0,15,1,321,92,28845,28131,35447,4,38,15,1,0,3,0,3,351,94,29890,30859,33898,0,-30,-2,-1045,-3,-2728,1549,-1,0,-2,0,12
EUW1_6769151261',5,38,20,1,0,1,0,8,1,374,95,32759,30907,39295,0,37,14,1,0,0,0,5,324,84,28363,28331,28043,1,50,11,4396,6,2576,11252,0,0,1,0,3
EUW1_6769097665',1,30,13,0,0,0,0,8,0,338,76,27464,27784,32268,3,98,19,1,0,1,0,0,339,86,31169,29898,41512,0,-1,-10,-3705,-6,-2114,-9244,-1,0,-1,0,8
EUW1_6769037754',1,80,11,1,0,0,0,15,0,329,108,28806,28824,31167,2,60,19,1,0,3,0,5,384,100,32723,32533,40686,1,-55,8,-3917,-8,-3709,-9519,0,0,-3,0,10
EUW1_6768982990',3,23,11,1,0,0,0,13,1,344,85,27069,28139,37825,1,40,23,0,1,2,0,4,378,114,34831,34182,45688,0,-34,-29,-7762,-12,-6043,-7863,1,-1,-2,0,9
EUW1_6768941518',2,52,17,0,0,1,0,4,0,352,89,30452,30102,33899,4,20,18,1,0,0,0,2,331,76,28438,28925,34796,1,21,13,2014,-1,1177,-897,-1,0,1,0,2
EUW1_6780791920',2,26,12,1,0,1,0,8,1,354,68,27231,27510,25946,3,98,9,1,0,1,0,2,417,104,28343,31499,29339,1,-63,-36,-1112,3,-3989,-3393,0,0,0,0,6
EUW1_6779015044',5,31,4,0,0,1,0,6,0,400,106,24914,30666,19653,6,29,4,2,0,1,0,1,394,94,24002,30029,22788,0,6,12,912,0,637,-3135,-2,0,0,0,5
EUW1_6778929375',3,50,7,0,0,1,0,9,1,390,80,25988,29724,23891,7,30,10,2,0,0,0,2,406,110,27093,31886,24170,0,-16,-30,-1105,-3,-2162,-279,-2,0,1,0,7
EUW1_6776334757',2,31,17,0,0,0,0,7,0,350,82,30354,30834,40351,3,47,20,0,0,0,0,0,310,78,29821,28969,36470,1,40,4,533,-3,1865,3881,0,0,0,0,7
EUW1_6776249276',4,25,8,1,0,0,0,10,0,374,93,25218,29860,23476,4,52,11,0,1,1,0,0,398,97,28741,30367,31664,1,-24,-4,-3523,-3,-507,-8188,1,-1,-1,0,10
EUW1_6776194421',6,22,10,2,1,2,0,2,1,433,108,29673,32538,25623,2,38,1,0,0,0,0,11,383,75,21580,27298,21387,1,50,33,8093,9,5240,4236,2,1,2,0,-9
EUW1_6775998458',2,42,8,0,0,0,0,8,0,330,90,24216,27367,25822,3,30,15,2,1,1,0,4,359,96,28949,30645,32878,0,-29,-6,-4733,-7,-3278,-7056,-2,-1,-1,0,4
EUW1_6775916061',7,31,14,0,1,1,0,7,0,377,84,29413,30412,34223,3,23,15,2,0,2,0,5,348,102,29423,29733,33037,0,29,-18,-10,-1,679,1186,-2,1,-1,0,2
EUW1_6775839907',2,27,18,0,0,1,0,9,0,345,94,31111,31194,37352,1,26,14,1,0,1,0,1,344,100,28396,29684,33822,0,1,-6,2715,4,1510,3530,-1,0,0,0,8
EUW1_6775750447',4,30,12,1,0,2,0,4,0,367,88,29251,30154,24089,5,30,5,0,0,0,0,4,380,80,24651,27836,26277,1,-13,8,4600,7,2318,-2188,1,0,2,0,0
EUW1_6772948882',7,35,12,2,0,1,0,8,1,408,86,29043,30385,27374,7,28,11,0,1,0,0,0,407,102,28937,30633,25671,1,1,-16,106,1,-248,1703,2,-1,1,0,8
EUW1_6772886663',2,28,7,0,0,1,0,10,0,360,80,25318,28076,16894,7,34,13,2,0,1,0,2,401,104,28720,31889,23845,0,-41,-24,-3402,-6,-3813,-6951,-2,0,0,0,8
EUW1_6772782669',6,62,14,0,0,1,0,7,0,376,132,28353,31859,26976,4,30,7,1,0,0,0,3,344,84,23869,28679,16986,0,32,48,4484,7,3180,9990,-1,0,1,0,4
EUW1_6771651978',5,26,11,0,0,0,0,8,1,298,86,26069,27557,27340,0,36,11,2,0,1,0,2,391,101,28408,30714,30432,0,-93,-15,-2339,0,-3157,-3092,-2,0,-1,0,6
EUW1_6771624556',6,34,12,2,0,0,0,13,0,363,72,26572,29977,24905,5,29,8,0,0,2,0,0,396,95,29242,29838,26290,1,-33,-23,-2670,4,139,-1385,2,0,-2,0,13
EUW1_6771594775',4,29,5,2,0,0,0,11,1,316,86,23424,27268,17504,2,88,12,0,0,2,0,3,401,92,29280,32472,21369,0,-85,-6,-5856,-7,-5204,-3865,2,0,-2,0,8
EUW1_6771552851',5,30,14,0,0,0,0,17,1,368,82,28305,30611,27440,4,33,10,0,0,3,0,6,390,88,30099,30147,26791,0,-22,-6,-1794,4,464,649,0,0,-3,0,11
EUW1_6771506212',1,19,20,2,0,0,0,7,1,351,87,31031,29100,33953,3,31,20,0,1,1,0,3,348,100,32168,31747,41075,1,3,-13,-1137,0,-2647,-7122,2,-1,-1,0,4
EUW1_6853547899',5,25,11,0,0,0,0,7,0,360,92,26838,27970,33036,4,78,14,1,0,1,0,0,368,127,29263,31505,33673,0,-8,-35,-2425,-3,-3535,-637,-1,0,-1,0,7
EUW1_6853487129',2,40,9,0,0,0,0,4,0,402,89,27102,30195,24884,4,33,8,2,0,0,0,4,417,78,26203,30567,24814,1,-15,11,899,1,-372,70,-2,0,0,0,0
EUW1_6831464672',5,28,14,1,0,0,0,6,1,381,88,30979,31807,33300,4,40,16,1,0,1,0,0,322,107,28964,31095,43850,1,59,-19,2015,-2,712,-10550,0,0,-1,0,6
EUW1_6831396954',2,33,11,1,0,0,0,4,1,374,98,27240,30797,26153,2,24,3,1,0,0,0,0,396,94,24260,29280,19869,1,-22,4,2980,8,1517,6284,0,0,0,0,4
EUW1_6766301456',4,26,17,2,0,0,0,6,0,358,122,30504,31890,47501,2,20,12,0,0,1,0,3,322,74,25877,25596,31705,1,36,48,4627,5,6294,15796,2,0,-1,0,3
EUW1_6766203204',1,27,14,0,0,0,0,11,0,345,64,27915,28473,39527,2,37,14,2,0,0,0,3,347,89,27716,28856,33950,1,-2,-25,199,0,-383,5577,-2,0,0,0,8
EUW1_6766106287',3,30,5,0,1,1,0,7,1,380,100,25626,29727,26569,2,25,12,1,0,0,0,0,370,67,26215,31777,30354,1,10,33,-589,-7,-2050,-3785,-1,1,1,0,7
EUW1_6766026482',1,104,14,2,0,1,0,9,0,308,82,27974,29201,33191,6,30,12,0,0,1,0,4,353,97,28216,29706,29716,1,-45,-15,-242,2,-505,3475,2,0,0,0,5
EUW1_6765955725',4,22,17,1,0,1,0,8,1,340,96,30746,29136,36904,2,26,13,0,1,0,0,8,339,91,27906,30783,29204,0,1,5,2840,4,-1647,7700,1,-1,1,0,0
EUW1_6765909973',1,190,13,1,1,4,0,9,1,358,102,32062,31671,31392,2,25,7,0,0,0,0,11,374,92,26060,28465,19463,1,-16,10,6002,6,3206,11929,1,1,4,0,-2
EUW1_6880375374',4,32,8,0,0,1,0,7,1,345,74,25610,28500,25710,1,31,10,2,0,0,0,5,354,142,25963,29715,31818,0,-9,-68,-353,-2,-1215,-6108,-2,0,1,0,2
EUW1_6870571485',4,28,15,1,0,0,0,3,1,324,70,26475,28531,34859,3,21,11,1,0,0,0,0,331,82,24774,26222,36770,1,-7,-12,1701,4,2309,-1911,0,0,0,0,3
EUW1_6867879721',10,35,19,2,0,1,0,10,1,416,70,30617,32430,32471,5,47,11,0,0,0,0,1,366,121,27642,31061,35023,1,50,-51,2975,8,1369,-2552,2,0,1,0,9
EUW1_6867825178',4,27,9,0,1,1,0,11,1,415,100,28615,31864,22043,4,37,7,2,0,1,0,8,383,102,25677,29042,21993,0,32,-2,2938,2,2822,50,-2,1,0,0,3
EUW1_6867791649',2,30,8,0,0,0,0,12,0,393,88,26582,28826,25489,4,26,21,2,0,2,0,3,412,61,33384,31628,39674,0,-19,27,-6802,-13,-2802,-14185,-2,0,-2,0,9
EUW1_6866651744',1,29,17,0,0,0,0,13,0,352,75,28878,31043,36315,7,41,21,1,1,3,0,4,391,87,33250,32091,48463,0,-39,-12,-4372,-4,-1048,-12148,-1,-1,-3,0,9
EUW1_6866543759',5,32,11,1,0,1,0,12,0,379,96,29138,28379,30780,6,32,17,1,0,2,0,6,375,96,31463,29495,30514,1,4,0,-2325,-6,-1116,266,0,0,-1,0,6
EUW1_6866510167',2,26,16,1,0,1,0,8,1,425,116,32136,34968,36133,2,26,7,1,0,1,0,7,340,83,26307,29421,32438,1,85,33,5829,9,5547,3695,0,0,0,0,1
EUW1_6883525045',4,70,10,0,0,1,0,15,1,383,81,27226,30971,33522,2,66,13,1,1,2,0,2,398,104,30709,33207,38885,0,-15,-23,-3483,-3,-2236,-5363,-1,-1,-1,0,13
EUW1_6882775869',1,32,10,0,0,0,0,10,1,398,86,27895,29308,28370,5,31,18,2,1,1,0,4,400,114,31701,32723,38090,0,-2,-28,-3806,-8,-3415,-9720,-2,-1,-1,0,6
EUW1_6882201838',12,76,18,1,0,2,0,11,0,350,104,30973,30691,35732,2,63,16,0,1,1,0,5,354,80,30103,28286,35282,1,-4,24,870,2,2405,450,1,-1,1,0,6
EUW1_6882165211',9,28,24,2,1,2,0,5,1,378,88,32459,32253,43116,3,31,7,0,0,0,0,10,308,79,23951,28924,31613,1,70,9,8508,17,3329,11503,2,1,2,0,-5
EUW1_6882015864',0,25,15,0,0,0,0,7,1,356,102,28912,31155,33633,4,29,11,2,0,0,0,0,397,102,28508,31520,38853,0,-41,0,404,4,-365,-5220,-2,0,0,0,7
EUW1_6876787869',5,28,9,1,0,0,0,11,1,305,79,22874,26883,27765,3,27,15,1,0,2,0,1,424,116,30759,33349,29898,0,-119,-37,-7885,-6,-6466,-2133,0,0,-2,0,10
EUW1_6876745707',2,28,7,1,0,0,0,13,0,387,104,26638,29169,26163,6,26,21,1,1,3,0,2,414,104,34605,33243,44024,0,-27,0,-7967,-14,-4074,-17861,0,-1,-3,0,11
EUW1_6876589165',4,86,14,0,0,0,0,8,1,346,76,27545,28594,35811,4,24,18,2,1,2,0,2,344,99,30148,30559,36420,0,2,-23,-2603,-4,-1965,-609,-2,-1,-2,0,6
EUW1_6876545927',2,24,10,0,0,0,0,9,0,363,92,25461,30655,25344,6,33,14,2,1,1,0,3,374,105,29296,31375,31910,0,-11,-13,-3835,-4,-720,-6566,-2,-1,-1,0,6
EUW1_6876242965',2,23,15,1,0,1,0,8,1,359,104,30355,31315,36212,4,20,14,0,0,1,0,9,374,98,29421,32340,32520,0,-15,6,934,1,-1025,3692,1,0,0,0,-1
EUW1_6876181459',3,21,23,2,0,1,0,9,0,363,116,33535,32724,46945,3,52,9,0,0,1,0,5,300,77,24249,29076,23511,1,63,39,9286,14,3648,23434,2,0,0,0,4
EUW1_6874968592',2,26,8,0,0,0,0,12,0,333,73,25012,28171,31168,4,25,16,1,0,2,0,1,403,107,31665,32001,39773,0,-70,-34,-6653,-8,-3830,-8605,-1,0,-2,0,11
EUW1_6874937800',3,81,13,1,0,0,0,4,1,364,96,27656,30991,38336,5,66,9,0,0,0,0,5,364,92,25766,28836,21716,1,0,4,1890,4,2155,16620,1,0,0,0,-1
EUW1_6874822441',2,32,11,0,1,0,0,6,0,341,85,26026,30279,26658,1,22,11,1,0,0,0,4,408,102,27545,31310,29567,0,-67,-17,-1519,0,-1031,-2909,-1,1,0,0,2
EUW1_6874324217',6,26,12,0,0,2,0,5,1,368,104,29507,31670,30575,4,82,6,1,0,0,0,5,370,84,24491,28467,24526,0,-2,20,5016,6,3203,6049,-1,0,2,0,0
EUW1_6882026189',7,32,8,1,0,0,0,12,1,381,74,27267,28028,29608,3,32,15,1,0,3,0,3,370,109,29490,32098,31515,1,11,-35,-2223,-7,-4070,-1907,0,0,-3,0,9
EUW1_6881977216',1,73,15,2,0,1,0,12,0,367,98,31047,29545,41415,7,32,18,0,0,3,0,6,328,69,29861,29789,31326,0,39,29,1186,-3,-244,10089,2,0,-2,0,6
EUW1_6881817557',5,26,16,2,0,2,0,4,0,389,98,33357,32035,41258,2,99,9,0,0,2,0,8,333,106,24840,28946,29522,1,56,-8,8517,7,3089,11736,2,0,0,0,-4
EUW1_6881750011',8,32,15,1,0,1,0,9,0,369,88,31755,28934,44260,3,35,10,0,0,1,0,7,372,76,26853,28940,30923,1,-3,12,4902,5,-6,13337,1,0,0,0,2
EUW1_6881483519',3,26,9,0,0,0,0,12,1,327,86,25070,28235,34183,1,53,16,2,0,2,0,1,383,110,30826,31400,34318,0,-56,-24,-5756,-7,-3165,-135,-2,0,-2,0,11
EUW1_6881290543',3,44,9,0,0,0,0,14,0,318,80,26146,27901,25221,7,34,23,2,0,3,0,1,372,82,33890,31245,42429,0,-54,-2,-7744,-14,-3344,-17208,-2,0,-3,0,13
EUW1_6881226124',5,30,13,2,0,1,0,10,0,346,87,27785,30175,35162,2,24,14,0,0,1,0,1,360,87,28728,29704,35281,0,-14,0,-943,-1,471,-119,2,0,0,0,9
EUW1_6880545937',2,34,13,0,0,0,0,11,0,336,87,27189,28008,32294,4,31,13,2,0,1,0,3,385,90,29441,29826,33715,1,-49,-3,-2252,0,-1818,-1421,-2,0,-1,0,8
EUW1_6881247773',3,28,28,1,0,2,0,10,0,320,85,34596,31204,54224,1,31,7,0,0,0,0,6,266,69,24087,23156,39623,1,54,16,10509,21,8048,14601,1,0,2,0,4
EUW1_6879556688',3,129,2,1,0,0,0,18,0,274,90,20037,23630,18792,5,26,11,1,0,4,0,0,388,119,30607,31365,26950,0,-114,-29,-10570,-9,-7735,-8158,0,0,-4,0,18
EUW1_6879515210',6,25,12,1,0,0,0,9,0,349,109,25995,29854,25709,3,165,15,1,0,1,0,2,378,70,28896,29789,34169,0,-29,39,-2901,-3,65,-8460,0,0,-1,0,7
EUW1_6877224340',7,27,13,1,1,1,0,5,1,351,92,28072,29802,30975,4,20,12,1,0,1,0,8,329,82,27510,27701,32794,0,22,10,562,1,2101,-1819,0,1,0,0,-3
EUW1_6877175551',3,25,7,0,0,0,0,11,0,340,86,24167,29386,23886,3,30,7,1,0,0,0,5,381,102,25534,29460,34331,1,-41,-16,-1367,0,-74,-10445,-1,0,0,0,6
EUW1_6877128834',5,26,9,1,0,0,0,8,1,358,103,25461,31142,31443,2,24,5,1,0,0,0,3,358,94,23286,27624,26206,1,0,9,2175,4,3518,5237,0,0,0,0,5
EUW1_6876999497',3,38,13,0,0,0,0,12,1,343,90,27796,29330,33569,2,34,16,2,0,1,0,5,374,94,30155,31070,39083,0,-31,-4,-2359,-3,-1740,-5514,-2,0,-1,0,7
EUW1_6874304773',1,23,8,0,0,0,0,9,1,299,68,23241,25287,28492,8,29,17,2,0,1,0,2,360,104,29335,30752,41977,0,-61,-36,-6094,-9,-5465,-13485,-2,0,-1,0,7
EUW1_6874255789',5,30,25,1,0,2,0,13,1,366,78,32992,30361,42819,1,50,9,1,0,1,0,9,343,77,26675,27655,31776,1,23,1,6317,16,2706,11043,0,0,1,0,4
EUW1_6874210881',0,41,3,0,0,0,0,8,0,401,108,24357,30039,21592,4,30,6,1,0,1,0,4,366,91,25538,30373,26188,0,35,17,-1181,-3,-334,-4596,-1,0,-1,0,4
EUW1_6873902628',4,30,8,1,0,1,0,11,1,347,90,25324,30011,29855,4,27,11,1,1,1,0,4,355,106,27043,30451,25901,0,-8,-16,-1719,-3,-440,3954,0,-1,0,0,7
EUW1_6873870200',2,28,9,0,0,1,0,9,0,351,92,26260,29443,39729,1,19,12,2,0,0,0,3,385,96,27965,30754,29495,0,-34,-4,-1705,-3,-1311,10234,-2,0,1,0,6
EUW1_6873840454',6,91,10,2,1,0,0,6,0,337,74,24875,27655,26321,5,28,5,0,0,0,0,3,334,76,24043,24795,24212,0,3,-2,832,5,2860,2109,2,1,0,0,3
EUW1_6871676281',0,26,21,2,0,5,0,8,1,358,112,34968,32331,44099,1,21,7,0,0,0,0,11,286,71,21544,23652,27388,1,72,41,13424,14,8679,16711,2,0,5,0,-3
EUW1_6871625030',5,30,4,0,0,0,0,7,0,348,82,23608,26219,28085,3,27,17,1,0,0,0,3,326,82,27325,30595,33412,0,22,0,-3717,-13,-4376,-5327,-1,0,0,0,4
EUW1_6863324920',1,30,10,1,0,0,0,6,0,364,88,27331,30181,25809,2,27,8,0,0,1,0,5,385,75,25344,29958,28401,0,-21,13,1987,2,223,-2592,1,0,-1,0,1
EUW1_6858157414',3,28,15,2,1,0,0,14,1,339,52,27791,26034,33111,2,34,14,0,0,2,0,1,365,92,29553,29164,31403,0,-26,-40,-1762,1,-3130,1708,2,1,-2,0,13
EUW1_6858142999',8,76,17,0,1,1,0,7,0,342,76,29227,30869,34698,3,62,9,2,0,0,0,4,359,80,25067,27904,28982,1,-17,-4,4160,8,2965,5716,-2,1,1,0,3
EUW1_6848774214',4,30,15,2,1,1,0,6,1,380,100,29803,30969,39205,0,33,11,0,0,0,0,5,297,87,25435,28449,29350,1,83,13,4368,4,2520,9855,2,1,1,0,1
EUW1_6848742435',1,25,14,0,0,1,0,15,1,318,86,29342,29300,27514,3,22,20,2,0,2,0,8,337,109,32405,30846,43912,0,-19,-23,-3063,-6,-1546,-16398,-2,0,-1,0,7
EUW1_6833681026',5,28,10,2,0,1,0,11,0,373,74,26888,29456,36747,6,80,12,0,1,1,0,2,375,97,27884,30056,36418,1,-2,-23,-996,-2,-600,329,2,-1,0,0,9
EUW1_6833633202',7,33,5,0,0,0,0,13,0,310,78,22934,27225,27146,2,25,16,2,0,3,0,0,388,109,31156,32846,36077,0,-78,-31,-8222,-11,-5621,-8931,-2,0,-3,0,13
EUW1_6833553429',9,24,13,0,0,0,0,9,0,344,96,27695,29427,32989,5,25,12,1,0,1,0,2,333,96,26946,28534,39530,0,11,0,749,1,893,-6541,-1,0,-1,0,7
EUW1_6827604120',6,198,8,1,0,1,0,7,0,333,124,26745,27710,27835,2,203,16,1,1,1,0,6,310,72,28216,27779,25606,1,23,52,-1471,-8,-69,2229,0,-1,0,0,1
EUW1_6827536540',3,48,9,0,0,0,0,8,0,384,85,26592,29445,33583,2,28,14,1,0,0,0,6,397,66,27591,31796,34178,1,-13,19,-999,-5,-2351,-595,-1,0,0,0,2
EUW1_6827479502',6,24,12,1,0,1,0,4,0,406,88,28721,30577,27473,6,23,8,1,0,1,0,7,344,80,25111,27166,24243,1,62,8,3610,4,3411,3230,0,0,0,0,-3
EUW1_6802908835',1,57,8,0,0,1,0,4,1,396,79,26229,29372,26835,5,90,9,1,0,0,0,1,330,105,25274,30029,28467,1,66,-26,955,-1,-657,-1632,-1,0,1,0,3
EUW1_6802524076',3,24,16,0,0,0,0,9,1,364,70,28469,28410,41257,0,44,13,0,0,1,0,3,319,81,26236,28487,30516,0,45,-11,2233,3,-77,10741,0,0,-1,0,6
EUW1_6802487326',7,93,16,1,0,1,0,13,0,311,104,30076,29841,31803,8,32,14,0,1,2,0,1,345,78,29187,28856,36698,1,-34,26,889,2,985,-4895,1,-1,-1,0,12
EUW1_6801294354',4,25,14,2,1,1,0,7,1,392,106,30344,31404,28208,6,38,8,0,0,0,0,7,327,89,24507,26823,28869,1,65,17,5837,6,4581,-661,2,1,1,0,0
EUW1_6801188846',1,25,15,2,0,0,0,7,1,363,109,27823,32084,37074,3,28,5,0,0,0,0,1,361,95,23923,29099,30608,1,2,14,3900,10,2985,6466,2,0,0,0,6
EUW1_6801105625',3,47,12,1,0,0,0,8,1,350,75,26972,27879,32516,3,19,17,1,1,1,0,2,340,102,29530,32580,36019,0,10,-27,-2558,-5,-4701,-3503,0,-1,-1,0,6
EUW1_6801080283',4,55,19,1,0,1,0,7,1,392,110,32175,31847,39268,1,18,2,0,0,2,0,6,345,60,22003,26092,16630,1,47,50,10172,17,5755,22638,1,0,-1,0,1
EUW1_6800616761',7,55,16,0,0,1,0,7,0,349,82,29856,30246,38548,2,26,16,2,0,0,0,1,366,94,29272,31592,40999,0,-17,-12,584,0,-1346,-2451,-2,0,1,0,6
EUW1_6800514237',4,27,10,1,0,0,0,10,0,364,108,28194,32341,28203,4,28,11,0,0,2,0,1,379,90,29594,28202,26750,1,-15,18,-1400,-1,4139,1453,1,0,-2,0,9
EUW1_6800443812',3,33,16,2,0,2,0,6,1,394,80,32368,30240,40189,1,155,4,0,0,1,0,9,316,84,22472,27637,19409,1,78,-4,9896,12,2603,20780,2,0,1,0,-3
EUW1_6799934941',2,31,10,1,0,0,0,15,0,353,90,26157,27499,36148,3,29,23,0,0,3,0,3,349,108,33531,32030,39243,0,4,-18,-7374,-13,-4531,-3095,1,0,-3,0,12
EUW1_6836817181',1,30,16,0,0,0,0,13,1,301,78,28802,30126,35868,8,27,14,2,0,2,0,3,401,88,30714,30537,46036,1,-100,-10,-1912,2,-411,-10168,-2,0,-2,0,10
EUW1_6836387816',3,22,7,1,0,0,0,8,0,340,84,24885,28804,30410,3,30,21,1,0,1,0,1,392,106,31863,34222,41084,0,-52,-22,-6978,-14,-5418,-10674,0,0,-1,0,7
EUW1_6836357559',1,15,10,0,0,0,0,15,1,318,66,25790,26076,25095,3,21,19,1,0,4,0,2,375,84,33105,31615,40351,0,-57,-18,-7315,-9,-5539,-15256,-1,0,-4,0,13
EUW1_6836302300',4,27,10,0,0,0,0,12,1,354,72,25417,27883,30384,5,36,12,2,1,2,0,2,382,115,30738,31291,30771,0,-28,-43,-5321,-2,-3408,-387,-2,-1,-2,0,10
EUW1_6836235425',4,73,11,1,0,0,0,7,1,354,104,27410,30030,31318,8,66,10,1,0,0,0,3,363,96,25371,29911,25333,1,-9,8,2039,1,119,5985,0,0,0,0,4
EUW1_6832100228',3,49,16,0,0,0,0,12,0,319,101,29344,27691,35873,3,28,13,1,0,1,0,4,318,102,28512,27156,31350,0,1,-1,832,3,535,4523,-1,0,-1,0,8
EUW1_6831361113',1,15,20,1,0,0,0,7,1,308,76,29240,30010,37212,4,93,16,0,0,1,0,3,303,67,28399,28880,45509,1,5,9,841,4,1130,-8297,1,0,-1,0,4
EUW1_6831320645',5,35,23,1,1,1,0,6,1,358,92,33008,31370,49034,1,26,15,0,0,0,0,8,321,74,27958,28424,37837,1,37,18,5050,8,2946,11197,1,1,1,0,-2
EUW1_6831248715',4,187,11,0,1,2,0,8,1,397,108,29292,32793,31977,3,104,9,2,0,0,0,6,341,94,25311,29428,30530,1,56,14,3981,2,3365,1447,-2,1,2,0,2
EUW1_6830486989',4,30,15,1,1,0,0,8,1,317,91,27837,28313,36623,3,92,14,1,0,1,0,0,324,92,28204,28881,39725,1,-7,-1,-367,1,-568,-3102,0,1,-1,0,8
EUW1_6828884788',3,27,7,0,0,2,0,12,1,337,94,26298,29291,29783,3,25,18,2,1,2,0,6,330,106,31195,31873,39502,0,7,-12,-4897,-11,-2582,-9719,-2,-1,0,0,6
EUW1_6828746254',3,65,12,0,0,3,0,7,1,389,76,29586,30198,44489,0,18,6,1,0,0,0,12,323,84,23168,27713,30032,1,66,-8,6418,6,2485,14457,-1,0,3,0,-5
EUW1_6823605764',2,54,17,0,0,2,0,10,0,373,96,32029,32645,39873,0,58,16,1,0,1,0,9,303,84,28408,29362,50133,1,70,12,3621,1,3283,-10260,-1,0,1,0,1
EUW1_6823569293',3,19,6,0,0,0,0,10,1,311,63,23064,25183,24084,5,81,19,1,0,4,0,0,375,97,32102,30801,32989,0,-64,-34,-9038,-13,-5618,-8905,-1,0,-4,0,10
EUW1_6823500041',2,24,18,1,0,0,0,8,0,364,87,30045,31465,39218,2,357,12,0,0,0,0,3,340,88,27007,29782,32008,1,24,-1,3038,6,1683,7210,1,0,0,0,5
EUW1_6823447723',6,27,25,2,0,1,0,11,1,312,82,30647,29326,43172,5,29,12,0,0,2,0,5,291,90,28267,28042,35098,1,21,-8,2380,13,1284,8074,2,0,-1,0,6
EUW1_6823375346',5,25,8,2,0,2,0,13,0,362,85,27744,29494,27135,6,33,21,0,0,2,0,7,333,78,30000,29781,39221,0,29,7,-2256,-13,-287,-12086,2,0,0,0,6
EUW1_6823322221',2,34,2,0,0,0,0,6,0,304,90,20890,24065,22962,3,29,20,1,1,2,0,1,373,94,30414,31654,36228,0,-69,-4,-9524,-18,-7589,-13266,-1,-1,-2,0,5
EUW1_6823175844',5,26,10,0,0,1,0,5,1,341,90,27543,27506,27936,7,98,15,1,0,0,0,6,336,78,27901,27964,32653,0,5,12,-358,-5,-458,-4717,-1,0,1,0,-1
EUN1_3568504823',4,27,21,2,0,2,0,9,1,327,76,31724,28393,45051,6,28,14,0,0,1,0,8,327,76,28328,29790,30739,1,0,0,3396,7,-1397,14312,2,0,1,0,1
EUN1_3568500748',4,26,16,0,0,0,0,16,1,312,61,28452,27012,34072,1,29,25,2,0,2,0,2,360,81,34389,31960,45874,0,-48,-20,-5937,-9,-4948,-11802,-2,0,-2,0,14
EUN1_3568480754',6,45,20,0,0,1,0,8,1,313,82,30706,28755,44306,6,26,17,2,0,1,0,7,309,66,29001,27190,36366,0,4,16,1705,3,1565,7940,-2,0,0,0,1
EUN1_3568473774',2,18,12,1,0,0,0,11,0,349,84,27130,28692,28146,4,24,15,1,1,1,0,1,366,72,29282,28698,40277,0,-17,12,-2152,-3,-6,-12131,0,-1,-1,0,10
EUN1_3568448004',3,25,15,0,1,0,0,6,0,383,90,29665,32793,30495,2,34,9,1,0,1,0,6,346,78,25029,29313,28846,1,37,12,4636,6,3480,1649,-1,1,-1,0,0
EUN1_3568446541',3,30,17,2,0,2,0,10,1,370,88,31072,30242,35878,0,25,5,0,0,1,0,6,380,80,23567,27579,24384,1,-10,8,7505,12,2663,11494,2,0,1,0,4
EUN1_3568334358',3,82,9,1,0,0,0,14,1,315,70,25959,25939,30890,2,192,19,0,1,2,0,2,372,109,32631,32423,38801,0,-57,-39,-6672,-10,-6484,-7911,1,-1,-2,0,12
EUN1_3568316255',2,30,13,1,0,0,0,9,0,340,66,26995,28486,37523,5,27,16,1,0,0,0,4,316,86,28026,28986,31900,0,24,-20,-1031,-3,-500,5623,0,0,0,0,5
EUN1_3568284615',4,25,18,0,0,0,0,6,0,345,73,30658,30956,45665,3,58,20,2,0,0,0,4,308,70,28962,28472,40749,0,37,3,1696,-2,2484,4916,-2,0,0,0,2
EUN1_3568256994',2,113,8,0,0,0,0,16,0,332,68,24784,28396,25853,5,28,17,2,0,4,0,1,406,84,33624,29945,28715,0,-74,-16,-8840,-9,-1549,-2862,-2,0,-4,0,15
EUN1_3568079214',4,29,12,0,0,0,0,8,1,313,62,26114,29219,28495,1,27,15,2,0,0,0,4,367,82,27644,31593,33885,0,-54,-20,-1530,-3,-2374,-5390,-2,0,0,0,4
EUN1_3568065199',0,29,14,0,0,1,0,9,0,329,80,27279,29495,32572,1,20,11,1,0,1,0,3,318,76,26914,28809,34133,1,11,4,365,3,686,-1561,-1,0,0,0,6
EUN1_3567846254',4,182,13,1,0,1,0,11,1,326,86,28331,28470,30494,4,20,18,1,0,2,0,6,312,87,31370,28055,42585,1,14,-1,-3039,-5,415,-12091,0,0,-1,0,5
EUN1_3567821183',2,29,14,0,0,0,0,6,0,363,74,27167,29771,40996,5,57,15,2,0,0,0,2,297,74,26616,26239,39337,0,66,0,551,-1,3532,1659,-2,0,0,0,4
EUN1_3567797142',2,25,14,1,0,0,0,8,1,335,88,28060,28376,33360,4,26,12,1,0,0,0,1,339,67,26290,28121,35110,1,-4,21,1770,2,255,-1750,0,0,0,0,7
EUN1_3567750181',2,59,20,2,0,1,0,12,1,281,68,30394,28995,39748,3,61,16,0,0,0,0,5,329,76,27740,27833,40963,1,-48,-8,2654,4,1162,-1215,2,0,1,0,7
EUN1_3567719436',1,31,15,1,0,2,0,7,1,339,70,29881,27381,33489,7,34,19,0,0,0,0,12,299,90,30463,28618,36794,0,40,-20,-582,-4,-1237,-3305,1,0,2,0,-5
EUN1_3567698693',3,21,9,1,0,0,0,10,0,347,78,26138,29205,29853,4,21,14,1,0,1,0,1,365,93,28468,30526,31151,0,-18,-15,-2330,-5,-1321,-1298,0,0,-1,0,9
EUN1_3567684395',4,21,14,0,0,2,0,9,0,353,70,29865,29403,32185,3,25,16,1,1,1,0,4,339,106,29709,30072,32221,1,14,-36,156,-2,-669,-36,-1,-1,1,0,5
EUN1_3575727213',1,19,11,0,0,1,0,14,0,361,88,28522,27178,35839,4,37,30,2,0,1,0,5,389,103,37514,33368,47334,0,-28,-15,-8992,-19,-6190,-11495,-2,0,0,0,9
EUN1_3575423952',2,26,16,1,0,3,0,10,1,359,107,30940,29191,29451,6,31,12,0,0,1,0,11,294,99,26750,27721,27228,0,65,8,4190,4,1470,2223,1,0,2,0,-1
EUN1_3575393931',4,26,8,0,0,0,0,9,0,334,80,23545,28208,23898,4,38,11,2,0,1,0,2,369,84,26870,29691,32900,0,-35,-4,-3325,-3,-1483,-9002,-2,0,-1,0,7
EUN1_3575388176',4,23,11,1,1,1,0,13,1,356,97,26491,29390,22691,7,27,17,1,0,1,0,1,397,114,31139,31766,28232,0,-41,-17,-4648,-6,-2376,-5541,0,1,0,0,12
EUN1_3575368115',3,25,8,1,0,1,0,7,1,400,79,25999,29147,22912,4,28,10,1,0,0,0,8,354,104,26054,29190,25348,0,46,-25,-55,-2,-43,-2436,0,0,1,0,-1
EUN1_3574997251',2,23,12,0,0,0,0,11,0,362,94,26865,29550,24395,6,28,11,2,0,1,0,3,388,78,27869,28868,34291,1,-26,16,-1004,1,682,-9896,-2,0,-1,0,8
EUN1_3574965421',1,30,10,1,0,1,0,11,1,354,96,28479,27028,30900,5,27,22,1,1,3,0,7,342,100,31257,30027,39414,1,12,-4,-2778,-12,-2999,-8514,0,-1,-2,0,4
EUN1_3574910820',1,20,9,1,0,1,0,10,1,297,72,25577,26227,28035,0,18,21,1,1,1,0,4,304,104,29157,28560,34384,0,-7,-32,-3580,-12,-2333,-6349,0,-1,0,0,6
EUN1_3574897170',6,42,19,2,0,1,0,15,0,345,82,30669,29249,40723,4,29,18,0,1,1,0,4,327,69,30662,28609,32592,1,18,13,7,1,640,8131,2,-1,0,0,11
EUN1_3574302283',1,27,17,1,1,2,0,7,1,309,86,29917,28236,35488,4,26,14,1,0,0,0,4,320,78,26378,28170,29214,0,-11,8,3539,3,66,6274,0,1,2,0,3
EUN1_3571969123',5,33,16,1,1,3,0,11,0,327,88,30573,28237,30858,3,28,19,0,0,1,0,8,326,95,31411,29594,34111,1,1,-7,-838,-3,-1357,-3253,1,1,2,0,3
EUN1_3571873479',0,20,11,2,0,0,0,11,0,320,89,26968,26655,32051,2,24,20,0,0,2,0,4,337,86,30657,29305,35082,1,-17,3,-3689,-9,-2650,-3031,2,0,-2,0,7
EUN1_3571681927',0,22,16,1,0,0,0,11,1,316,61,27822,28075,30948,1,22,21,1,0,0,0,2,377,97,31428,32250,39561,0,-61,-36,-3606,-5,-4175,-8613,0,0,0,0,9
EUN1_3571650790',2,26,11,0,0,1,0,11,1,348,87,28014,30323,33147,3,22,14,2,0,1,0,4,356,119,28877,30947,36552,0,-8,-32,-863,-3,-624,-3405,-2,0,0,0,7
EUN1_3571622510',2,50,13,1,0,1,0,15,1,323,82,27598,29010,31562,3,30,12,1,0,2,0,7,330,82,28212,30157,41953,1,-7,0,-614,1,-1147,-10391,0,0,-1,0,8
EUN1_3571594404',1,20,12,0,0,1,0,5,1,369,88,29159,29669,34118,7,30,14,2,0,1,0,6,307,100,28148,30270,30154,0,62,-12,1011,-2,-601,3964,-2,0,0,0,-1
EUN1_3575979084',2,167,15,1,0,0,0,13,1,324,98,29476,28453,36804,4,27,15,1,0,3,0,4,342,74,29194,29415,32446,0,-18,24,282,0,-962,4358,0,0,-3,0,9
EUN1_3575946715',3,20,16,1,1,2,0,6,0,323,92,30143,28979,36564,5,29,19,1,0,0,0,2,346,84,29173,30041,34594,0,-23,8,970,-3,-1062,1970,0,1,2,0,4
EUN1_3575930747',4,29,8,0,0,0,0,10,1,346,66,24275,29617,28278,4,26,14,2,0,1,0,1,366,110,30421,30232,33507,0,-20,-44,-6146,-6,-615,-5229,-2,0,-1,0,9
EUN1_3575846168',5,29,19,1,0,2,0,3,1,318,90,30821,29829,41743,3,27,14,0,0,0,0,12,281,78,27481,27157,36222,0,37,12,3340,5,2672,5521,1,0,2,0,-9
EUN1_3575830129',6,34,12,1,1,0,0,9,0,337,84,27203,31257,31722,2,26,15,1,0,0,0,1,318,92,26901,29161,33386,1,19,-8,302,-3,2096,-1664,0,1,0,0,8
EUN1_3573208752',5,28,6,0,0,0,0,11,0,299,106,23261,26040,21950,5,26,11,2,0,1,0,1,409,81,28200,30477,24582,0,-110,25,-4939,-5,-4437,-2632,-2,0,-1,0,10
EUN1_3573204096',2,27,11,0,0,0,0,9,0,302,68,25121,26096,28337,1,50,14,2,0,1,0,3,305,72,27066,28409,29128,0,-3,-4,-1945,-3,-2313,-791,-2,0,-1,0,6
EUN1_3572650996',3,43,12,1,0,0,0,11,0,326,96,26234,29253,27884,4,27,15,1,0,1,0,1,356,95,30698,30649,35012,0,-30,1,-4464,-3,-1396,-7128,0,0,-1,0,10
EUN1_3572300794',2,27,5,0,0,0,0,11,0,293,91,22259,25154,27814,5,27,12,2,1,2,0,2,314,96,27773,27495,33715,0,-21,-5,-5514,-7,-2341,-5901,-2,-1,-2,0,9
EUN1_3572275053',5,28,6,1,0,0,0,8,0,332,94,24180,28678,20132,2,42,10,1,0,1,0,0,358,110,27534,30883,25663,0,-26,-16,-3354,-4,-2205,-5531,0,0,-1,0,8
EUN1_3572254808',8,29,16,2,1,0,0,7,1,311,90,28520,30364,26279,2,24,5,0,0,0,0,3,369,90,24743,28620,30961,1,-58,0,3777,11,1744,-4682,2,1,0,0,4
EUN1_3572226613',3,89,11,0,0,0,0,9,0,331,82,26929,27360,30407,5,25,15,2,1,1,0,4,341,94,28714,30637,34189,0,-10,-12,-1785,-4,-3277,-3782,-2,-1,-1,0,5
EUN1_3572141797',3,31,10,2,0,0,0,8,1,334,79,26525,29908,27600,5,29,16,0,1,1,0,2,366,96,29978,29640,28449,0,-32,-17,-3453,-6,268,-849,2,-1,-1,0,6
EUN1_3572117337',7,23,16,0,0,0,0,11,1,343,106,29086,31577,39335,1,26,19,2,0,2,0,3,369,86,32184,33681,43853,0,-26,20,-3098,-3,-2104,-4518,-2,0,-2,0,8
EUN1_3572095420',3,29,11,0,0,0,0,6,0,347,83,27113,29452,35842,6,38,15,2,1,0,0,0,343,82,28920,30074,31686,0,4,1,-1807,-4,-622,4156,-2,-1,0,0,6
EUN1_3572072536',2,24,11,0,0,0,0,9,0,389,98,27006,32244,31094,3,27,5,2,0,0,0,1,375,84,24279,28728,26416,1,14,14,2727,6,3516,4678,-2,0,0,0,8
EUN1_3572046469',5,145,13,2,1,0,0,5,1,367,77,26668,30551,37133,5,30,9,0,0,1,0,2,345,85,26386,28486,33773,1,22,-8,282,4,2065,3360,2,1,-1,0,3
EUN1_3572011087',3,26,11,1,0,1,0,11,0,381,92,27354,30605,37004,3,191,18,1,0,1,0,5,363,108,30660,33537,41331,0,18,-16,-3306,-7,-2932,-4327,0,0,0,0,6
EUN1_3571988548',6,137,20,2,0,1,0,8,1,338,82,30912,29421,36395,0,24,11,0,1,0,0,7,305,94,26877,29167,30645,1,33,-12,4035,9,254,5750,2,-1,1,0,1
EUN1_3571737928',9,30,13,1,1,0,0,9,1,334,92,26692,28686,33369,3,29,11,1,0,0,0,3,300,84,24969,26461,27646,1,34,8,1723,2,2225,5723,0,1,0,0,6
EUN1_3576239135',8,48,12,1,0,0,0,8,0,327,104,27115,28084,31093,2,24,17,1,0,1,0,5,343,100,28952,30772,32086,1,-16,4,-1837,-5,-2688,-993,0,0,-1,0,3
EUN1_3576226661',2,30,20,1,0,1,0,7,0,315,97,30639,31313,44720,3,24,12,0,0,0,0,3,323,94,26296,29299,35692,1,-8,3,4343,8,2014,9028,1,0,1,0,4
EUN1_3573547974',5,37,13,1,0,1,0,14,1,361,95,28434,30221,27063,5,34,9,0,1,1,0,2,344,88,26853,28801,24765,1,17,7,1581,4,1420,2298,1,-1,0,0,12
EUN1_3573551108',5,27,11,0,0,2,0,11,0,354,84,30048,29516,35978,1,25,22,1,0,1,0,5,322,105,31080,30982,30844,0,32,-21,-1032,-11,-1466,5134,-1,0,1,0,6
EUN1_3573414876',3,26,15,1,0,0,0,8,0,348,76,28827,29955,37061,1,24,14,0,1,1,0,2,345,91,29119,29642,32896,0,3,-15,-292,1,313,4165,1,-1,-1,0,6
EUN1_3573400282',3,241,18,2,0,1,0,5,1,291,79,28866,26918,33177,3,19,11,0,0,0,0,3,284,80,24792,25641,33949,1,7,-1,4074,7,1277,-772,2,0,1,0,2
EUN1_3573357644',6,31,20,2,0,0,0,6,0,338,110,28831,31347,30745,2,34,6,0,0,0,0,5,343,110,24734,28170,31049,1,-5,0,4097,14,3177,-304,2,0,0,0,1
EUN1_3573326194',5,29,16,0,0,0,0,8,0,282,75,29076,25290,48453,3,76,19,2,0,2,0,6,237,90,28875,25778,38077,0,45,-15,201,-3,-488,10376,-2,0,-2,0,2
EUN1_3573298312',4,35,18,1,0,0,0,13,0,333,76,29003,30851,40813,3,33,19,1,1,1,0,7,312,100,30355,29383,42684,1,21,-24,-1352,-1,1468,-1871,0,-1,-1,0,6
EUN1_3573268403',1,25,19,1,0,0,0,9,0,329,76,29057,31040,32906,4,30,10,1,0,0,0,3,340,89,25891,28205,30541,1,-11,-13,3166,9,2835,2365,0,0,0,0,6
EUN1_3573017668',5,27,12,1,0,0,0,8,0,321,92,26001,27456,25258,8,34,11,1,0,1,0,4,345,84,27200,28058,36643,1,-24,8,-1199,1,-602,-11385,0,0,-1,0,4
EUN1_3572679093',5,29,16,1,0,1,0,7,1,346,84,27817,29857,34004,2,28,10,1,0,0,0,3,318,70,25328,27508,30187,1,28,14,2489,6,2349,3817,0,0,1,0,4
EUN1_3572648673',4,27,14,0,1,2,0,8,1,334,106,29574,30743,34976,2,27,9,2,0,1,0,7,339,82,25509,28717,30151,1,-5,24,4065,5,2026,4825,-2,1,1,0,1
EUN1_3572628731',1,38,10,1,0,1,0,10,1,372,100,27686,29284,28315,4,27,16,0,0,1,0,3,369,80,29420,29253,30140,1,3,20,-1734,-6,31,-1825,1,0,0,0,7
EUN1_3572602722',3,32,14,1,0,0,0,5,1,365,91,28421,30068,37807,3,222,9,1,0,1,0,2,317,79,24029,25913,30867,0,48,12,4392,5,4155,6940,0,0,-1,0,3
EUN1_3572588258',5,27,14,2,0,0,0,8,0,350,112,28285,30785,33386,6,30,13,0,0,1,0,1,328,76,26080,28357,29949,0,22,36,2205,1,2428,3437,2,0,-1,0,7
EUN1_3572574133',3,15,15,1,1,0,0,6,0,363,104,29886,30440,26227,7,146,8,0,0,2,0,5,381,71,25910,27967,29801,1,-18,33,3976,7,2473,-3574,1,1,-2,0,1
EUN1_3572542047',1,35,7,1,0,1,0,7,0,339,98,24668,28918,26275,6,28,10,0,0,0,0,3,394,82,25594,29782,26763,0,-55,16,-926,-3,-864,-488,1,0,1,0,4
EUN1_3572527936',3,31,12,1,0,2,0,8,1,368,96,28533,32898,28503,4,33,8,1,0,0,0,4,356,82,25114,29443,27199,0,12,14,3419,4,3455,1304,0,0,2,0,4
EUN1_3572491371',6,37,11,0,0,1,0,11,0,312,76,28457,26698,26627,8,37,16,2,0,1,0,5,361,108,29966,31140,29987,0,-49,-32,-1509,-5,-4442,-3360,-2,0,0,0,6
EUN1_3575665618',3,25,6,0,0,0,0,12,0,341,94,23032,27967,24780,3,26,14,1,1,1,0,0,385,82,30206,30926,34577,0,-44,12,-7174,-8,-2959,-9797,-1,-1,-1,0,12
EUN1_3575071256',3,148,16,1,0,0,0,4,1,323,67,27601,28236,44705,5,26,12,0,0,0,0,3,375,78,27356,28834,31994,1,-52,-11,245,4,-598,12711,1,0,0,0,1
EUN1_3574707614',8,27,13,1,0,1,0,6,0,363,88,27865,28266,30755,2,25,8,0,0,0,0,7,341,68,24096,26391,22435,1,22,20,3769,5,1875,8320,1,0,1,0,-1
EUN1_3574696282',2,23,13,2,0,0,0,14,0,327,96,27028,28645,40633,2,25,18,0,0,1,0,3,324,82,31043,31154,43228,0,3,14,-4015,-5,-2509,-2595,2,0,-1,0,11
EUN1_3574582364',3,23,16,2,0,2,0,9,1,332,84,29091,29978,41416,6,28,14,0,0,0,0,6,257,96,26006,28225,28199,1,75,-12,3085,2,1753,13217,2,0,2,0,3
EUN1_3574562510',10,39,19,2,0,0,0,5,0,307,106,28327,28130,34012,2,35,11,0,0,2,0,5,325,82,27433,27721,24994,1,-18,24,894,8,409,9018,2,0,-2,0,0
EUN1_3574533475',2,43,17,0,0,2,0,8,1,392,96,31088,32249,38798,0,12,9,2,0,0,0,8,318,76,24078,28445,28116,1,74,20,7010,8,3804,10682,-2,0,2,0,0
EUN1_3574508603',5,28,16,1,0,2,0,5,1,374,96,29467,30684,34680,2,21,12,1,0,0,0,9,332,72,25604,29052,24679,1,42,24,3863,4,1632,10001,0,0,2,0,-4
EUN1_3572928483',1,24,20,1,0,0,0,9,1,318,102,31041,31429,40656,5,30,14,1,0,2,0,4,337,93,28597,28752,35142,0,-19,9,2444,6,2677,5514,0,0,-2,0,5
EUN1_3572921795',3,26,18,2,0,1,0,5,1,376,90,29356,31818,32787,0,25,4,0,0,0,0,6,304,80,21574,25330,19911,1,72,10,7782,14,6488,12876,2,0,1,0,-1
EUN1_3572830578',2,29,23,0,0,2,0,8,0,361,90,33357,31157,42509,5,99,19,1,0,0,0,7,271,58,27894,25868,36106,1,90,32,5463,4,5289,6403,-1,0,2,0,1
EUN1_3572810827',3,36,19,1,0,1,0,13,1,292,94,30379,26805,35475,2,20,13,1,0,3,0,5,306,100,29355,27970,25599,1,-14,-6,1024,6,-1165,9876,0,0,-2,0,8
EUN1_3572734233',2,27,7,0,0,0,0,10,1,390,86,26148,29718,32261,5,40,17,1,0,0,0,4,330,82,28571,30443,30896,1,60,4,-2423,-10,-725,1365,-1,0,0,0,6
EUN1_3572712130',7,32,15,2,0,0,0,5,1,404,99,27147,30800,25595,3,26,7,0,0,0,0,3,353,88,24189,27873,21129,1,51,11,2958,8,2927,4466,2,0,0,0,2
EUN1_3572668352',3,30,16,0,0,0,0,9,1,351,73,27549,28772,33844,5,27,15,2,0,0,0,1,362,127,29844,32522,27121,0,-11,-54,-2295,1,-3750,6723,-2,0,0,0,8
EUN1_3572630381',2,19,23,0,0,3,0,5,1,425,105,34675,34922,38337,3,34,4,1,0,0,0,11,297,73,21753,25054,22802,1,128,32,12922,19,9868,15535,-1,0,3,0,-6
EUN1_3572063014',6,35,18,1,1,1,0,4,0,364,93,29573,32553,37740,0,17,13,1,0,1,0,3,384,74,27765,29589,35222,1,-20,19,1808,5,2964,2518,0,1,0,0,1
EUN1_3570688005',6,28,9,0,1,1,0,3,1,402,111,28286,30860,25696,4,31,7,2,0,0,0,5,386,84,26095,29873,27841,0,16,27,2191,2,987,-2145,-2,1,1,0,-2
EUN1_3570674179',5,21,9,1,0,0,0,11,1,329,78,25108,28358,21167,6,31,9,1,0,0,0,1,375,112,26617,29927,25422,0,-46,-34,-1509,0,-1569,-4255,0,0,0,0,10
EUN1_3570658170',1,26,9,0,0,1,0,13,0,313,92,27083,28876,23882,4,24,24,2,1,2,0,5,374,105,34279,33192,45565,0,-61,-13,-7196,-15,-4316,-21683,-2,-1,-1,0,8
EUN1_3570253341',1,33,12,0,0,0,0,7,0,414,98,29357,31310,31159,2,28,8,1,0,1,0,8,305,97,24911,26954,23647,1,109,1,4446,4,4356,7512,-1,0,-1,0,-1
EUN1_3570223591',1,27,9,1,0,0,0,5,0,337,84,26295,28000,34717,5,44,16,0,0,1,0,7,301,80,26618,28467,41305,0,36,4,-323,-7,-467,-6588,1,0,-1,0,-2
EUN1_3570204210',4,30,3,1,0,0,0,8,1,392,111,23637,30607,23337,1,138,11,1,0,1,0,3,402,102,27444,30944,25059,0,-10,9,-3807,-8,-337,-1722,0,0,-1,0,5
EUN1_3572896236',4,30,15,1,0,0,0,7,0,291,83,26966,26038,36493,2,283,21,1,0,1,0,1,347,53,30885,29515,43122,0,-56,30,-3919,-6,-3477,-6629,0,0,-1,0,6
EUN1_3572841782',9,34,14,1,0,2,0,12,1,314,64,27853,26607,34738,1,20,15,1,0,1,0,6,308,83,27526,28380,36475,0,6,-19,327,-1,-1773,-1737,0,0,1,0,6
EUN1_3572812845',0,24,6,1,0,0,0,13,1,342,92,24885,27169,17493,3,28,12,1,0,2,0,2,323,92,27626,29733,27408,0,19,0,-2741,-6,-2564,-9915,0,0,-2,0,11
EUN1_3572763346',5,22,13,1,0,2,0,10,0,336,106,30563,29181,33119,3,35,17,0,0,1,0,6,330,82,28760,30997,40553,1,6,24,1803,-4,-1816,-7434,1,0,1,0,4
EUN1_3572726261',4,29,16,0,0,0,0,5,0,332,77,27908,29242,44440,2,74,13,2,0,0,0,3,296,82,26236,28660,31275,0,36,-5,1672,3,582,13165,-2,0,0,0,2
EUN1_3572656895',7,28,15,1,0,1,0,11,1,362,91,29880,31736,33195,4,27,11,1,0,1,0,4,389,91,28415,29492,27923,0,-27,0,1465,4,2244,5272,0,0,0,0,7
EUN1_3572556892',2,41,13,1,0,1,0,8,1,318,54,28493,27332,32287,1,21,16,0,0,1,0,3,278,73,26102,27566,35003,1,40,-19,2391,-3,-234,-2716,1,0,0,0,5
EUN1_3572538806',4,26,13,0,0,3,0,5,1,384,86,30261,29946,37248,4,33,14,1,0,0,0,8,309,78,26755,27491,38257,1,75,8,3506,-1,2455,-1009,-1,0,3,0,-3
EUN1_3572531464',3,28,11,1,0,0,0,5,1,392,86,27770,31122,30345,2,93,4,1,0,1,0,4,335,118,23408,30520,23650,1,57,-32,4362,7,602,6695,0,0,-1,0,1
EUN1_3572347069',1,21,12,1,0,0,0,15,0,336,72,25994,28868,25809,6,36,12,1,1,2,0,3,369,96,29088,30191,28120,0,-33,-24,-3094,0,-1323,-2311,0,-1,-2,0,12
EUN1_3571811355',4,30,12,2,0,0,0,7,0,373,100,27315,31305,28547,6,73,14,0,0,0,0,6,379,116,28774,31454,27713,0,-6,-16,-1459,-2,-149,834,2,0,0,0,1
EUN1_3571800141',4,24,14,1,0,1,0,7,0,305,96,27833,26219,34939,2,67,21,1,0,0,0,4,371,88,31902,32775,39260,0,-66,8,-4069,-7,-6556,-4321,0,0,1,0,3
EUN1_3571785266',2,19,13,1,0,0,0,16,0,327,66,26875,28602,33174,2,23,21,1,0,3,0,4,370,110,34261,33346,41596,0,-43,-44,-7386,-8,-4744,-8422,0,0,-3,0,12
EUN1_3571333894',1,29,11,0,0,1,0,8,0,354,90,27855,27733,37859,7,38,19,1,0,0,0,4,346,84,30276,28630,37822,0,8,6,-2421,-8,-897,37,-1,0,1,0,4
EUN1_3571321495',5,29,10,0,0,1,0,10,1,337,75,27222,28358,24146,5,23,19,2,0,0,0,2,389,84,29905,30644,32122,0,-52,-9,-2683,-9,-2286,-7976,-2,0,1,0,8
EUN1_3570448645',5,56,20,1,0,0,0,11,1,313,83,28543,30235,36695,0,23,8,0,0,0,0,1,337,83,24463,27764,28831,1,-24,0,4080,12,2471,7864,1,0,0,0,10
EUN1_3570391910',3,45,18,1,0,1,0,11,0,374,82,31277,30848,39260,8,100,15,1,0,0,0,1,350,63,28950,28755,34805,1,24,19,2327,3,2093,4455,0,0,1,0,10
EUN1_3570318896',4,49,13,1,0,1,0,11,0,341,79,27640,29346,38778,1,22,17,1,0,3,0,7,383,89,31480,30953,35938,1,-42,-10,-3840,-4,-1607,2840,0,0,-2,0,4
EUN1_3569555052',5,156,13,1,0,1,0,11,0,327,90,28455,28633,33294,5,28,17,0,0,2,0,6,361,86,30755,30122,32659,0,-34,4,-2300,-4,-1489,635,1,0,-1,0,5
EUN1_3575875020',3,25,11,0,0,0,0,8,0,324,91,26296,29559,29654,4,22,16,2,0,1,0,4,346,76,28218,30330,32085,0,-22,15,-1922,-5,-771,-2431,-2,0,-1,0,4
EUN1_3575835205',4,29,14,1,0,1,0,9,1,380,82,30163,31174,38073,7,24,13,1,0,0,0,5,337,78,26179,28617,29361,1,43,4,3984,1,2557,8712,0,0,1,0,4
EUN1_3574262602',1,20,8,0,0,0,0,13,0,345,106,25300,29450,27716,6,26,21,2,0,2,0,3,371,124,32436,33764,35810,0,-26,-18,-7136,-13,-4314,-8094,-2,0,-2,0,10
EUN1_3574241456',4,32,9,0,0,0,0,8,0,347,86,25224,29211,30289,3,26,8,2,0,0,0,1,369,83,25330,29949,30022,0,-22,3,-106,1,-738,267,-2,0,0,0,7
EUN1_3573800298',5,28,10,0,0,0,0,13,1,318,77,25005,27660,30312,5,23,17,1,0,2,0,2,354,82,30402,31479,33984,0,-36,-5,-5397,-7,-3819,-3672,-1,0,-2,0,11
EUN1_3573716502',5,35,15,1,1,0,0,10,0,328,110,28655,30946,29978,1,26,13,1,0,1,0,3,340,90,28147,28747,30518,1,-12,20,508,2,2199,-540,0,1,-1,0,7
EUN1_3573692671',3,26,18,2,0,0,0,2,1,370,92,30434,30280,36487,3,27,11,0,0,1,0,4,362,68,26850,27587,31664,1,8,24,3584,7,2693,4823,2,0,-1,0,-2
EUN1_3573501726',6,34,11,0,0,0,0,7,0,337,88,27696,27213,34314,7,37,21,2,0,1,0,6,325,78,31065,31275,39093,0,12,10,-3369,-10,-4062,-4779,-2,0,-1,0,1
EUN1_3573505138',2,22,9,0,0,1,0,8,0,321,88,25409,28519,30734,7,26,11,2,0,0,0,4,363,71,25290,29058,32925,1,-42,17,119,-2,-539,-2191,-2,0,1,0,4
EUN1_3573496551',2,31,17,1,0,0,0,6,1,364,90,29898,30959,33305,3,24,9,1,0,1,0,4,347,78,24363,26388,30273,0,17,12,5535,8,4571,3032,0,0,-1,0,2
EUN1_3573281486',3,26,7,0,0,0,0,8,0,350,85,24960,27714,22284,8,37,11,2,0,1,0,3,393,113,28026,30961,34682,1,-43,-28,-3066,-4,-3247,-12398,-2,0,-1,0,5
EUN1_3573214768',4,27,21,2,0,0,0,14,1,308,68,29318,28905,31775,3,29,12,0,1,2,0,7,329,120,29734,30322,31936,1,-21,-52,-416,9,-1417,-161,2,-1,-2,0,7
EUN1_3573192772',3,28,15,1,0,0,0,15,0,333,88,29775,31281,40355,4,32,18,1,0,3,0,3,354,100,32398,31686,35684,0,-21,-12,-2623,-3,-405,4671,0,0,-3,0,12
EUN1_3572897892',1,19,15,0,0,0,0,8,0,303,84,27019,28517,36063,3,23,20,2,0,0,0,4,321,68,29443,30289,32624,1,-18,16,-2424,-5,-1772,3439,-2,0,0,0,4
EUN1_3567986182',2,23,17,1,0,2,0,9,0,389,86,31681,31774,34632,2,29,6,0,0,0,0,8,362,91,25011,29503,32041,1,27,-5,6670,11,2271,2591,1,0,2,0,1
EUN1_3567974792',1,28,4,0,0,0,0,13,0,323,76,22735,26309,21774,7,41,18,2,0,4,0,2,385,108,32392,32582,31968,0,-62,-32,-9657,-14,-6273,-10194,-2,0,-4,0,11
EUN1_3567196023',5,34,16,0,0,2,0,4,0,331,73,30034,28753,33818,5,94,11,1,0,0,0,13,306,90,26517,26940,33019,1,25,-17,3517,5,1813,799,-1,0,2,0,-9
EUN1_3566232597',5,29,11,1,1,1,0,11,1,379,84,27789,30077,35717,4,26,12,1,0,1,0,5,362,82,27941,29014,33301,1,17,2,-152,-1,1063,2416,0,1,0,0,6
EUN1_3565751356',5,31,17,1,0,1,0,6,0,372,85,30608,29450,39512,3,36,17,1,0,1,0,5,343,113,30611,30907,37729,0,29,-28,-3,0,-1457,1783,0,0,0,0,1
EUN1_3565723860',5,29,15,2,0,0,0,6,1,363,86,27926,29575,31429,3,28,8,0,0,1,0,4,391,68,26815,27944,26104,1,-28,18,1111,7,1631,5325,2,0,-1,0,2
EUN1_3565700941',4,31,8,1,0,0,0,10,1,328,100,25748,28789,21810,4,30,10,1,0,1,0,1,356,92,27139,30493,22734,1,-28,8,-1391,-2,-1704,-924,0,0,-1,0,9
EUN1_3565693521',2,27,23,0,0,2,0,9,0,372,103,32383,32222,39192,0,24,8,0,0,2,0,5,346,74,25936,29471,20733,1,26,29,6447,15,2751,18459,0,0,0,0,4
EUN1_3565678587',8,31,19,2,0,3,0,12,0,317,104,31905,28708,38452,4,26,12,0,0,0,0,5,316,80,26402,29173,34640,1,1,24,5503,7,-465,3812,2,0,3,0,7
EUN1_3565665509',4,210,15,1,1,0,0,10,1,314,68,27241,27996,26613,3,31,7,1,0,1,0,6,327,92,24521,27936,28192,1,-13,-24,2720,8,60,-1579,0,1,-1,0,4
EUN1_3565591856',3,28,15,1,0,0,0,5,1,355,92,29490,31373,33407,5,27,13,1,0,1,0,1,348,70,27259,27987,34367,1,7,22,2231,2,3386,-960,0,0,-1,0,4
EUN1_3565593287',3,62,19,2,0,0,0,5,0,352,93,30981,31313,42024,5,24,10,0,0,1,0,5,350,102,25330,28617,25999,1,2,-9,5651,9,2696,16025,2,0,-1,0,0
EUN1_3565182217',3,31,6,0,0,0,0,11,0,332,84,24908,27268,31862,5,26,15,1,0,0,0,2,336,99,28203,28241,41362,0,-4,-15,-3295,-9,-973,-9500,-1,0,0,0,9
EUN1_3565168560',4,24,14,1,0,0,0,5,1,360,86,28550,28346,36714,3,23,8,0,0,0,0,3,345,74,25134,28644,26759,1,15,12,3416,6,-298,9955,1,0,0,0,2
EUN1_3565160351',2,46,16,0,0,0,0,7,0,322,89,27459,29398,37332,7,45,16,1,0,0,0,3,307,79,27741,28359,40011,0,15,10,-282,0,1039,-2679,-1,0,0,0,4
EUN1_3564793173',4,48,15,0,0,0,0,10,1,316,106,28718,27879,34748,5,101,15,1,0,2,0,2,334,70,28069,28779,36061,1,-18,36,649,0,-900,-1313,-1,0,-2,0,8
EUN1_3571374988',3,48,20,0,0,1,0,6,0,312,76,31462,29249,40579,4,25,18,0,0,1,0,9,338,71,30967,30793,35231,0,-26,5,495,2,-1544,5348,0,0,0,0,-3
EUN1_3571348385',1,25,7,1,0,1,0,6,0,342,99,25271,29043,27622,3,27,5,1,0,1,0,2,329,92,24796,28570,26752,0,13,7,475,2,473,870,0,0,0,0,4
EUN1_3571334719',3,102,13,1,0,0,0,12,1,352,56,25938,26580,26784,4,101,8,1,0,2,0,3,339,111,28153,28901,32359,0,13,-55,-2215,5,-2321,-5575,0,0,-2,0,9
EUN1_3570989032',4,144,8,2,0,1,0,7,1,401,79,27379,29563,26988,5,29,8,0,0,1,0,7,348,97,25412,29745,29203,1,53,-18,1967,0,-182,-2215,2,0,0,0,0
EUN1_3570962872',2,26,16,1,0,0,0,11,1,362,104,29284,31578,31865,5,29,12,0,0,0,0,2,378,60,26547,28657,27822,1,-16,44,2737,4,2921,4043,1,0,0,0,9
EUN1_3570923624',6,141,14,1,0,0,0,9,1,348,78,28600,28190,30093,1,25,13,1,0,1,0,2,359,98,27606,29515,21394,0,-11,-20,994,1,-1325,8699,0,0,-1,0,7
EUN1_3569476141',3,31,18,2,0,1,0,13,1,293,106,30081,28517,30454,5,31,19,0,1,3,0,5,374,76,33273,29356,35770,1,-81,30,-3192,-1,-839,-5316,2,-1,-2,0,8
EUN1_3569092055',4,29,20,1,0,2,0,15,0,321,98,31865,30620,41862,3,29,17,1,0,0,0,2,310,90,29827,29533,36869,1,11,8,2038,3,1087,4993,0,0,2,0,13
EUN1_3569075871',3,26,22,2,0,2,0,10,0,388,76,33512,32557,37317,4,23,16,0,1,1,0,7,291,96,29170,27930,33139,0,97,-20,4342,6,4627,4178,2,-1,1,0,3
EUN1_3568911125',3,37,9,1,0,0,0,8,0,330,82,24708,25467,26825,4,48,20,1,0,2,0,2,298,94,31403,28144,36494,0,32,-12,-6695,-11,-2677,-9669,0,0,-2,0,6
EUN1_3568593533',2,27,9,0,0,0,0,8,1,336,79,26329,30172,26201,3,26,8,1,1,2,0,3,365,88,26408,29207,28201,1,-29,-9,-79,1,965,-2000,-1,-1,-2,0,5
EUN1_3568580412',1,25,7,0,0,1,0,10,0,307,68,24214,27491,21986,3,23,18,2,1,1,0,1,348,112,30028,30741,35055,0,-41,-44,-5814,-11,-3250,-13069,-2,-1,0,0,9
EUN1_3568510797',2,87,12,1,0,0,0,9,0,323,75,25382,27152,35319,1,21,16,1,0,2,0,2,332,104,30009,30103,42554,0,-9,-29,-4627,-4,-2951,-7235,0,0,-2,0,7
EUN1_3568486815',2,28,10,0,0,1,0,12,0,304,66,24466,25915,27672,5,25,15,2,0,2,0,4,362,94,29836,29446,33097,0,-58,-28,-5370,-5,-3531,-5425,-2,0,-1,0,8
EUN1_3567627147',2,29,20,2,0,1,0,11,1,373,88,32255,30510,34511,3,27,11,0,0,1,0,6,359,92,30220,29540,28888,1,14,-4,2035,9,970,5623,2,0,0,0,5
EUN1_3567609238',1,27,14,0,0,0,0,10,1,362,99,27868,31148,38221,7,25,9,2,0,1,0,3,359,92,26360,30202,31622,0,3,7,1508,5,946,6599,-2,0,-1,0,7
EUN1_3567598369',3,152,17,2,1,3,0,9,0,406,106,32726,33413,33611,4,23,6,0,0,2,0,11,332,88,25204,28261,20707,1,74,18,7522,11,5152,12904,2,1,1,0,-2
EUN1_3567584340',2,190,11,1,0,0,0,14,0,313,102,26392,26826,34528,7,35,16,1,0,3,0,1,347,88,30585,28437,33352,1,-34,14,-4193,-5,-1611,1176,0,0,-3,0,13
EUN1_3567567759',3,30,10,2,0,0,0,11,0,334,104,26991,28586,26174,2,21,10,0,0,0,0,2,366,82,26861,28141,24981,1,-32,22,130,0,445,1193,2,0,0,0,9
EUN1_3575937792',8,28,17,2,0,1,0,11,1,366,112,30628,32204,33492,3,22,11,0,0,1,0,5,323,80,25767,28300,27149,1,43,32,4861,6,3904,6343,2,0,0,0,6
EUN1_3575914025',4,49,7,0,0,1,0,2,1,413,80,27105,28831,21341,6,63,7,2,0,0,0,6,387,92,24494,29449,20033,1,26,-12,2611,0,-618,1308,-2,0,1,0,-4
EUN1_3575897624',4,32,17,1,1,1,0,12,0,341,76,30056,29651,36199,2,22,12,0,0,0,0,4,344,76,26846,27535,30258,1,-3,0,3210,5,2116,5941,1,1,1,0,8
EUN1_3575631742',6,30,18,0,0,1,0,13,1,336,61,29060,28139,35404,6,33,22,2,0,2,0,3,343,90,33139,31112,42368,0,-7,-29,-4079,-4,-2973,-6964,-2,0,-1,0,10
EUN1_3575543623',5,64,15,1,0,0,0,3,1,365,72,28010,29890,36733,1,59,2,0,0,1,0,6,375,72,22135,27733,21764,1,-10,0,5875,13,2157,14969,1,0,-1,0,-3
EUN1_3575514628',2,23,9,0,0,1,0,11,0,395,84,29019,29300,22363,2,32,15,1,0,0,0,5,382,72,28586,30027,32441,1,13,12,433,-6,-727,-10078,-1,0,1,0,6
EUN1_3575481927',3,21,18,0,1,1,0,10,1,343,96,30879,31843,31997,1,22,10,2,0,2,0,4,339,92,26335,27753,38241,0,4,4,4544,8,4090,-6244,-2,1,-1,0,6
EUN1_3575460090',4,34,15,1,0,1,0,9,0,362,94,28997,31486,37525,5,26,12,0,0,0,0,5,330,76,25924,27379,29381,0,32,18,3073,3,4107,8144,1,0,1,0,4
EUN1_3576023708',1,26,10,1,0,0,0,13,0,328,86,25216,30873,32457,4,56,11,0,0,0,0,2,351,82,26184,28600,32972,1,-23,4,-968,-1,2273,-515,1,0,0,0,11
EUN1_3575997306',4,30,10,0,0,0,0,10,0,437,120,29382,33511,26491,0,36,7,2,0,1,0,3,366,94,25818,30000,22543,0,71,26,3564,3,3511,3948,-2,0,-1,0,7
EUN1_3575967502',1,25,6,0,0,1,0,10,0,340,100,24041,29502,28517,4,36,13,1,0,1,0,3,365,104,28203,31038,37117,0,-25,-4,-4162,-7,-1536,-8600,-1,0,0,0,7
EUN1_3575909822',2,23,6,0,0,0,0,13,1,369,93,23706,29243,22351,3,20,15,2,1,1,0,1,371,105,29085,32382,32732,0,-2,-12,-5379,-9,-3139,-10381,-2,-1,-1,0,12
EUN1_3575893657',0,19,10,0,0,0,0,15,0,300,56,25276,26107,36997,5,33,25,0,0,3,0,5,336,96,33736,30497,43310,0,-36,-40,-8460,-15,-4390,-6313,0,0,-3,0,10
EUN1_3575604339',3,29,9,0,0,0,0,9,0,326,86,26252,28870,28485,7,41,19,2,0,1,0,5,355,120,31144,30894,38104,0,-29,-34,-4892,-10,-2024,-9619,-2,0,-1,0,4
EUN1_3575586348',6,40,22,1,1,3,0,10,1,400,104,34326,34748,41180,1,28,6,1,0,0,0,7,332,76,23811,27029,30281,1,68,28,10515,16,7719,10899,0,1,3,0,3
EUN1_3575558413',4,28,17,1,0,0,0,7,1,374,95,28098,32303,40545,1,31,6,1,0,0,0,3,340,84,23384,28517,20700,1,34,11,4714,11,3786,19845,0,0,0,0,4
EUN1_3575512738',1,34,11,1,0,0,0,11,0,348,88,26662,28780,30309,5,27,19,1,0,1,0,2,292,84,29682,29510,34630,0,56,4,-3020,-8,-730,-4321,0,0,-1,0,9
EUN1_3575493329',1,30,9,1,0,0,0,12,0,316,98,25755,27718,24087,6,28,17,1,0,1,0,0,386,98,29772,32113,40440,0,-70,0,-4017,-8,-4395,-16353,0,0,-1,0,12
EUN1_3575457956',2,39,11,1,0,1,0,10,0,320,78,28083,29635,35119,2,134,17,1,0,1,0,6,370,89,30092,31262,42538,0,-50,-11,-2009,-6,-1627,-7419,0,0,0,0,4
EUN1_3575417511',0,26,15,0,0,1,0,13,0,345,88,28873,31604,28490,5,30,14,1,1,1,0,4,363,72,28723,30234,35891,0,-18,16,150,1,1370,-7401,-1,-1,0,0,9
EUN1_3575375205',5,30,12,0,0,2,0,11,0,326,75,28368,29413,33630,2,47,18,1,1,0,0,6,353,100,28878,30263,27854,0,-27,-25,-510,-6,-850,5776,-1,-1,2,0,5
EUN1_3575344852',5,28,9,0,0,2,0,7,1,356,81,26596,29965,33978,6,45,13,2,0,0,0,7,366,72,27136,30107,32523,0,-10,9,-540,-4,-142,1455,-2,0,2,0,0
EUN1_3575309294',2,34,5,1,0,0,0,5,1,374,79,23547,28720,25865,4,25,13,1,0,0,0,1,435,112,29078,33969,34798,0,-61,-33,-5531,-8,-5249,-8933,0,0,0,0,4
EUN1_3575281646',2,36,17,0,0,0,0,9,0,331,86,29463,29187,39059,2,27,21,2,0,1,0,2,324,117,32445,30764,39323,1,7,-31,-2982,-4,-1577,-264,-2,0,-1,0,7
EUN1_3575033596',2,29,13,0,0,0,0,11,1,338,84,27718,29565,35682,4,26,14,2,0,1,0,5,338,84,28417,29274,34336,1,0,0,-699,-1,291,1346,-2,0,-1,0,6
EUN1_3574203487',4,25,12,0,0,0,0,10,0,378,82,28140,30662,28385,3,24,14,1,1,1,0,6,382,89,28679,31316,29443,1,-4,-7,-539,-2,-654,-1058,-1,-1,-1,0,4
EUN1_3569958945',5,24,8,0,0,0,0,8,0,313,100,24383,27207,26759,3,24,12,2,1,1,0,0,373,88,28320,30818,28000,0,-60,12,-3937,-4,-3611,-1241,-2,-1,-1,0,8
EUN1_3557504935',3,33,12,2,0,0,0,6,0,381,100,28147,31391,40343,5,22,9,0,1,1,0,5,301,88,25248,28197,31784,0,80,12,2899,3,3194,8559,2,-1,-1,0,1
EUN1_3557504192',3,21,6,1,0,0,0,16,1,405,100,24988,29826,27237,0,20,16,1,0,3,0,1,365,108,31283,30846,34603,0,40,-8,-6295,-10,-1020,-7366,0,0,-3,0,15
EUN1_3557485701',1,79,12,1,1,1,0,6,1,378,88,29415,32439,36741,2,31,8,1,0,1,0,8,349,100,25396,28355,31815,1,29,-12,4019,4,4084,4926,0,1,0,0,-2
EUN1_3557471843',4,22,17,1,0,2,0,12,1,363,86,32197,30864,39658,6,23,21,1,0,1,0,11,355,76,32640,32092,42166,0,8,10,-443,-4,-1228,-2508,0,0,1,0,1
EUN1_3556956397',4,24,10,0,0,1,0,10,0,320,90,26103,28264,28119,2,23,15,2,0,3,0,5,352,85,28461,30268,31201,0,-32,5,-2358,-5,-2004,-3082,-2,0,-2,0,5
EUN1_3575768568',3,26,9,1,0,0,0,9,0,320,73,24744,25081,33826,1,33,21,1,0,2,0,2,397,82,32145,31996,36576,0,-77,-9,-7401,-12,-6915,-2750,0,0,-2,0,7
EUN1_3575427930',4,24,13,0,0,1,0,6,0,359,86,28850,29064,29524,3,28,11,2,0,2,0,8,312,105,26781,27184,25270,1,47,-19,2069,2,1880,4254,-2,0,-1,0,-2
EUN1_3575392026',5,22,6,1,0,0,0,11,1,333,84,24474,25963,20238,5,30,13,1,0,3,0,4,325,104,28581,29325,26682,1,8,-20,-4107,-7,-3362,-6444,0,0,-3,0,7
EUN1_3575284818',6,44,9,1,0,0,0,3,1,346,94,26475,29359,29485,6,29,13,1,1,0,0,3,384,96,27257,31112,27419,0,-38,-2,-782,-4,-1753,2066,0,-1,0,0,0
EUN1_3575262118',6,24,9,0,0,1,0,12,1,357,96,25862,29625,31721,5,29,9,2,0,0,0,3,343,92,25246,31074,33277,1,14,4,616,0,-1449,-1556,-2,0,1,0,9
EUN1_3575100828',4,26,13,2,0,0,0,5,1,346,87,26389,30024,29753,3,32,11,0,0,0,0,3,319,87,24790,28787,30234,1,27,0,1599,2,1237,-481,2,0,0,0,2
EUN1_3574709038',4,33,10,0,0,0,0,7,0,345,86,25877,29513,28461,5,30,11,1,0,0,0,1,330,103,26012,29510,29879,0,15,-17,-135,-1,3,-1418,-1,0,0,0,6
EUN1_3573693265',9,35,10,0,1,0,0,14,0,282,74,25219,24356,26466,2,25,20,2,0,4,0,1,400,102,32716,31219,36278,0,-118,-28,-7497,-10,-6863,-9812,-2,1,-4,0,13
EUN1_3575690997',6,70,12,0,0,0,0,11,0,317,96,26551,30475,27634,3,62,13,2,0,0,0,5,405,72,27727,30158,30979,0,-88,24,-1176,-1,317,-3345,-2,0,0,0,6
EUN1_3574459006',3,20,10,1,0,0,0,9,1,350,103,26850,30785,28264,3,20,11,1,0,1,0,4,369,88,27798,28824,25761,0,-19,15,-948,-1,1961,2503,0,0,-1,0,5
EUN1_3574447395',5,24,18,2,0,0,0,7,1,332,95,28987,29889,39840,4,80,11,0,0,0,0,2,350,92,26504,29063,25383,1,-18,3,2483,7,826,14457,2,0,0,0,5
EUN1_3574275163',4,39,19,1,1,0,0,12,0,336,99,29146,30903,34867,7,47,15,1,0,0,0,2,338,72,28285,29897,34968,1,-2,27,861,4,1006,-101,0,1,0,0,10
EUN1_3573868090',2,45,19,2,0,0,0,10,0,282,74,28710,30244,40332,3,24,18,0,0,2,0,2,337,103,30293,29958,44139,1,-55,-29,-1583,1,286,-3807,2,0,-2,0,8
EUN1_3572902335',2,27,14,2,0,0,0,8,0,353,71,27941,29852,39336,7,30,16,0,0,0,0,2,364,109,30112,31904,33516,1,-11,-38,-2171,-2,-2052,5820,2,0,0,0,6
EUN1_3571821443',4,27,23,1,0,1,0,9,1,371,90,32477,32690,38592,0,25,8,1,0,2,0,5,319,73,23794,27632,23084,1,52,17,8683,15,5058,15508,0,0,-1,0,4
EUN1_3571802545',4,44,7,0,0,0,0,8,0,355,92,24953,29640,24595,3,21,10,2,0,0,0,3,408,72,26060,30837,27758,1,-53,20,-1107,-3,-1197,-3163,-2,0,0,0,5
EUN1_3571781556',2,31,7,0,0,1,0,7,1,379,84,25873,28714,17927,3,62,14,1,1,0,0,5,364,104,27979,30962,30644,1,15,-20,-2106,-7,-2248,-12717,-1,-1,1,0,2
EUN1_3571387520',5,37,1,0,0,0,0,13,0,389,92,22172,29173,14760,3,52,13,2,0,1,0,0,373,107,30020,31585,26835,0,16,-15,-7848,-12,-2412,-12075,-2,0,-1,0,13
EUN1_3571373098',1,143,5,0,0,0,0,13,0,354,93,24220,28670,23842,6,34,17,2,0,1,0,2,418,78,32321,31730,34603,0,-64,15,-8101,-12,-3060,-10761,-2,0,-1,0,11
EUN1_3576085835',3,36,16,1,0,0,0,10,1,283,96,27686,27869,33015,6,31,9,1,0,1,0,3,340,92,26881,28745,25550,0,-57,4,805,7,-876,7465,0,0,-1,0,7
EUN1_3573580703',1,16,5,0,0,0,0,17,0,293,92,22301,26263,39434,2,193,24,2,0,2,0,1,346,105,32844,34462,40342,0,-53,-13,-10543,-19,-8199,-908,-2,0,-2,0,16
EUN1_3573567805',1,28,27,1,0,1,0,9,1,356,88,34861,32544,52082,3,20,19,0,0,0,0,3,320,88,30068,29930,40328,1,36,0,4793,8,2614,11754,1,0,1,0,6
EUN1_3573554029',3,51,9,0,0,0,0,3,1,381,77,26488,31040,24444,1,24,7,2,0,0,0,5,383,118,26086,30368,24526,1,-2,-41,402,2,672,-82,-2,0,0,0,-2
EUN1_3573554157',5,32,9,1,0,0,0,5,1,367,84,25267,29291,33241,2,22,11,1,0,0,0,1,367,88,26295,29647,34495,0,0,-4,-1028,-2,-356,-1254,0,0,0,0,4
EUN1_3573071769',3,25,15,2,0,0,0,6,1,359,88,28066,30931,28789,4,38,9,0,0,1,0,5,335,96,25193,29390,28057,1,24,-8,2873,6,1541,732,2,0,-1,0,1
EUN1_3572460591',5,30,20,0,0,2,0,7,1,378,72,30533,31513,32925,2,24,5,1,0,0,0,8,336,80,22909,26622,22873,1,42,-8,7624,15,4891,10052,-1,0,2,0,-1
EUN1_3572178114',1,67,20,1,1,3,0,4,0,342,92,32293,29939,34257,1,23,15,1,0,0,0,9,291,104,27583,27021,37345,1,51,-12,4710,5,2918,-3088,0,1,3,0,-5
EUN1_3571932070',1,20,15,1,0,1,0,11,1,366,92,29662,29660,27650,6,33,11,1,0,1,0,7,340,94,26551,29789,29949,0,26,-2,3111,4,-129,-2299,0,0,0,0,4
EUN1_3571913787',4,24,13,0,0,1,0,9,0,362,100,28096,30522,33587,2,27,18,2,1,0,0,2,297,92,28122,29423,32304,1,65,8,-26,-5,1099,1283,-2,-1,1,0,7
EUN1_3571899638',2,22,15,1,0,0,0,10,0,326,110,29491,30358,40716,3,25,19,1,0,0,0,0,333,83,28759,28946,36584,0,-7,27,732,-4,1412,4132,0,0,0,0,10
EUN1_3573762963',2,29,13,1,0,1,0,9,1,371,90,27167,30851,24581,4,24,7,1,0,1,0,4,351,60,25237,28153,24981,1,20,30,1930,6,2698,-400,0,0,0,0,5
EUN1_3573634210',4,26,13,0,1,1,0,6,1,335,108,27765,29791,29227,2,28,10,1,0,0,0,5,360,88,26021,28451,32608,1,-25,20,1744,3,1340,-3381,-1,1,1,0,1
EUN1_3573596537',3,25,6,0,0,1,0,14,0,338,85,24548,28564,25101,3,169,10,1,0,2,0,2,355,102,27867,30813,30888,0,-17,-17,-3319,-4,-2249,-5787,-1,0,-1,0,12
EUN1_3573554823',4,22,12,1,0,0,0,10,0,335,56,26381,28117,31132,1,35,20,0,0,2,0,3,326,105,31378,30190,39892,0,9,-49,-4997,-8,-2073,-8760,1,0,-2,0,7
EUN1_3573542418',2,19,13,1,1,0,0,11,1,304,76,26181,30386,28746,3,236,8,1,0,1,0,3,338,100,25867,28535,28930,1,-34,-24,314,5,1851,-184,0,1,-1,0,8
EUN1_3573526599',3,25,7,1,0,0,0,14,0,304,88,23784,26486,27604,3,36,9,1,0,2,0,3,347,96,26629,28111,28703,1,-43,-8,-2845,-2,-1625,-1099,0,0,-2,0,11
EUN1_3573334540',3,38,11,2,0,1,0,6,1,330,92,27304,29731,33594,6,36,10,0,0,1,0,5,321,84,25825,29169,28499,1,9,8,1479,1,562,5095,2,0,0,0,1
EUN1_3573298395',6,27,23,2,0,3,0,9,1,355,124,34189,34945,41536,5,21,8,0,0,0,0,8,317,67,24854,27370,35606,1,38,57,9335,15,7575,5930,2,0,3,0,1
EUN1_3573260011',3,24,11,1,0,0,0,7,0,356,94,27116,30460,29743,3,41,12,1,0,0,0,3,350,98,26113,29765,30232,0,6,-4,1003,-1,695,-489,0,0,0,0,4
EUN1_3573205740',2,23,6,0,1,1,0,12,1,330,81,25215,28397,28505,3,21,18,2,0,1,0,4,317,90,28594,29585,34722,0,13,-9,-3379,-12,-1188,-6217,-2,1,0,0,8
EUN1_3571565645',3,139,16,1,0,0,0,13,1,334,100,28816,30365,37867,0,24,18,1,0,1,0,3,350,96,29058,30935,33221,0,-16,4,-242,-2,-570,4646,0,0,-1,0,10
EUN1_3571357456',3,34,6,0,0,0,0,10,0,291,80,24020,28776,33684,4,32,12,2,0,0,0,1,369,92,26399,30551,30146,0,-78,-12,-2379,-6,-1775,3538,-2,0,0,0,9
EUN1_3571346413',4,42,9,0,0,1,0,10,1,341,89,26432,29877,25609,8,26,8,2,0,1,0,2,348,85,24718,28413,24486,1,-7,4,1714,1,1464,1123,-2,0,0,0,8
EUN1_3571324620',3,24,13,1,0,1,0,11,0,363,94,28487,30303,29038,5,140,14,1,0,1,0,7,367,118,30316,31730,42328,0,-4,-24,-1829,-1,-1427,-13290,0,0,0,0,4
EUN1_3571321121',6,74,6,0,0,0,0,9,0,350,81,24638,28393,23412,5,37,15,1,0,1,0,5,347,63,27383,29513,34331,0,3,18,-2745,-9,-1120,-10919,-1,0,-1,0,4
EUN1_3571081224',5,29,7,0,0,0,0,7,1,399,80,24845,29300,23601,1,25,7,2,0,1,0,3,385,96,25763,30780,23584,0,14,-16,-918,0,-1480,17,-2,0,-1,0,4
EUN1_3570977375',1,25,5,1,0,0,0,4,0,363,102,23987,30334,24454,4,24,7,0,0,0,0,5,362,86,24801,29467,23578,1,1,16,-814,-2,867,876,1,0,0,0,-1
EUN1_3570591022',2,55,15,0,0,0,0,8,1,379,67,27934,30724,37634,5,33,16,2,0,0,0,5,360,81,28369,30987,34149,0,19,-14,-435,-1,-263,3485,-2,0,0,0,3
EUN1_3570365914',1,23,8,0,0,0,0,7,1,346,94,26507,31291,25241,6,22,11,2,0,1,0,5,355,94,26152,29726,30383,0,-9,0,355,-3,1565,-5142,-2,0,-1,0,2
EUN1_3570263283',6,30,7,0,0,0,0,10,0,374,76,25917,28888,29642,6,62,16,2,0,2,0,3,371,100,30414,31910,27793,0,3,-24,-4497,-9,-3022,1849,-2,0,-2,0,7
EUN1_3573784145',4,63,20,1,0,1,0,9,0,320,66,31078,31134,41539,3,58,14,1,0,1,0,6,320,71,28748,29502,48377,1,0,-5,2330,6,1632,-6838,0,0,0,0,3
EUN1_3573760676',2,26,21,1,0,2,0,7,1,343,88,31722,30315,39001,1,27,11,0,0,1,0,6,269,76,25678,25692,26482,1,74,12,6044,10,4623,12519,1,0,1,0,1
EUN1_3573721569',3,33,13,1,0,0,0,8,0,331,86,27108,28309,29698,4,26,15,0,0,1,0,2,355,90,29503,29836,37237,0,-24,-4,-2395,-2,-1527,-7539,1,0,-1,0,6
EUN1_3573682994',2,18,20,1,0,1,0,8,0,357,82,31926,30569,42662,6,25,27,1,1,0,0,6,306,94,32668,30826,42860,0,51,-12,-742,-7,-257,-198,0,-1,1,0,2
EUN1_3573664049',5,34,18,2,0,1,0,8,0,324,84,29700,30093,39642,1,29,20,0,0,0,0,4,303,68,29293,29101,41065,0,21,16,407,-2,992,-1423,2,0,1,0,4
EUN1_3573646365',4,20,18,1,0,1,0,8,0,355,82,29899,31206,33476,2,20,8,1,0,0,0,4,337,90,24737,29715,33343,1,18,-8,5162,10,1491,133,0,0,1,0,4
EUN1_3573524775',4,23,8,0,0,0,0,13,0,365,84,26163,28970,30790,6,69,13,1,0,2,0,4,349,100,28857,32158,36213,0,16,-16,-2694,-5,-3188,-5423,-1,0,-2,0,9
EUN1_3573516843',6,29,8,0,0,0,0,15,0,298,47,24758,26331,26383,3,41,25,2,0,3,0,0,365,120,33891,32875,42908,0,-67,-73,-9133,-17,-6544,-16525,-2,0,-3,0,15
EUN1_3573520371',6,61,21,2,0,1,0,8,1,344,111,30649,34096,35631,0,56,6,0,0,0,0,9,338,100,24798,27028,28455,1,6,11,5851,15,7068,7176,2,0,1,0,-1
EUN1_3573268465',3,27,17,0,0,0,0,10,0,327,70,28174,29840,31824,1,44,19,1,0,1,0,3,373,100,31590,33717,43485,1,-46,-30,-3416,-2,-3877,-11661,-1,0,-1,0,7
EUN1_3573238782',1,20,8,0,0,0,0,10,0,329,76,25026,26978,30279,8,35,18,2,0,0,0,3,338,96,29116,32098,35128,0,-9,-20,-4090,-10,-5120,-4849,-2,0,0,0,7
EUN1_3573214998',2,28,12,0,0,0,0,9,0,297,60,25513,25804,26491,1,25,15,1,0,0,0,3,342,72,27284,29074,34316,0,-45,-12,-1771,-3,-3270,-7825,-1,0,0,0,6
EUN1_3573195880',5,29,21,0,0,0,0,9,1,352,82,33234,29905,37549,6,27,17,1,0,1,0,5,293,84,27938,28630,36432,0,59,-2,5296,4,1275,1117,-1,0,-1,0,4
EUN1_3573185291',2,24,13,0,0,1,0,11,0,344,60,26656,27631,31772,4,26,13,2,0,1,0,5,349,91,28848,28619,38298,0,-5,-31,-2192,0,-988,-6526,-2,0,0,0,6
EUN1_3573137889',5,28,24,1,0,0,0,10,0,314,84,31481,34283,43386,1,19,12,0,0,2,0,3,369,92,28562,30948,38499,1,-55,-8,2919,12,3335,4887,1,0,-2,0,7
EUN1_3573137106',2,44,19,2,0,1,0,5,0,383,100,32779,31259,40404,4,104,15,0,0,2,0,10,248,80,26620,27251,39022,1,135,20,6159,4,4008,1382,2,0,-1,0,-5
EUN1_3573107943',1,33,9,2,0,1,0,16,1,330,103,24677,29177,31875,4,54,14,0,0,1,0,1,324,87,29122,30285,27455,1,6,16,-4445,-5,-1108,4420,2,0,0,0,15
EUN1_3573097737',0,28,15,1,1,2,0,7,1,342,95,30305,29630,38801,3,29,16,0,0,0,0,7,304,64,26942,29013,35016,1,38,31,3363,-1,617,3785,1,1,2,0,0
EUN1_3572701050',2,24,18,1,0,0,0,9,0,301,94,27822,29127,30860,1,20,12,0,0,2,0,0,326,77,27561,29745,32136,0,-25,17,261,6,-618,-1276,1,0,-2,0,9
EUN1_3570725360',2,166,9,0,0,1,0,8,0,383,74,27087,30171,31628,1,86,10,1,0,0,0,0,337,100,25898,29534,31903,0,46,-26,1189,-1,637,-275,-1,0,1,0,8
EUN1_3570693419',2,38,6,1,0,0,0,8,0,399,88,24600,29359,27231,5,84,11,1,1,0,0,3,405,107,27528,32171,25890,0,-6,-19,-2928,-5,-2812,1341,0,-1,0,0,5
EUN1_3569406982',5,27,16,2,0,2,0,10,1,357,94,30936,31323,37749,7,26,12,0,0,0,0,5,382,88,27092,30632,34746,0,-25,6,3844,4,691,3003,2,0,2,0,5
EUN1_3568494802',2,21,14,0,0,0,0,11,1,383,98,28401,32158,33765,7,33,7,0,0,0,0,2,355,78,25440,27370,32775,1,28,20,2961,7,4788,990,0,0,0,0,9
EUN1_3560561387',2,64,7,0,0,0,0,13,0,373,72,24702,30019,28230,4,135,13,2,0,1,0,2,342,108,28500,30179,26563,0,31,-36,-3798,-6,-160,1667,-2,0,-1,0,11
EUN1_3560507955',3,138,8,0,0,0,0,10,0,359,90,26163,27111,31635,4,23,13,1,0,1,0,3,334,85,27411,29926,27899,0,25,5,-1248,-5,-2815,3736,-1,0,-1,0,7
EUN1_3553978026',5,30,6,0,0,0,0,12,0,302,84,23239,24572,30174,4,31,26,1,0,2,0,0,341,96,34330,31660,42887,0,-39,-12,-11091,-20,-7088,-12713,-1,0,-2,0,12
EUN1_3553971832',4,52,17,0,0,1,0,7,1,385,104,30799,30637,37195,2,179,8,2,1,0,0,7,341,80,24679,29463,25346,1,44,24,6120,9,1174,11849,-2,-1,1,0,0
EUN1_3553940033',5,34,13,0,0,2,0,6,1,388,112,29679,32621,33758,3,38,8,2,0,0,0,4,305,92,24617,27953,20654,1,83,20,5062,5,4668,13104,-2,0,2,0,2
EUN1_3553714618',3,149,17,1,0,1,0,5,1,333,82,29493,28946,42891,3,44,14,1,0,0,0,4,301,94,27839,28405,24987,0,32,-12,1654,3,541,17904,0,0,1,0,1
EUN1_3553674939',4,35,12,1,0,1,0,4,0,365,86,28150,28972,33339,3,26,11,1,1,0,0,4,322,90,26773,30059,31815,1,43,-4,1377,1,-1087,1524,0,-1,1,0,0
EUN1_3553649443',4,42,9,2,0,0,0,8,1,335,84,24905,29229,26908,4,21,7,0,0,1,0,1,355,88,26093,28625,29304,0,-20,-4,-1188,2,604,-2396,2,0,-1,0,7
EUN1_3551974771',2,37,18,1,1,0,0,5,1,344,106,30083,32301,28416,4,46,10,0,0,0,0,5,356,94,27080,29708,29480,1,-12,12,3003,8,2593,-1064,1,1,0,0,0
EUN1_3551940964',5,143,12,2,0,0,0,10,1,357,95,26919,28283,26319,3,26,14,0,0,1,0,4,322,100,27524,30119,27838,0,35,-5,-605,-2,-1836,-1519,2,0,-1,0,6
EUN1_3551920886',0,59,6,0,0,1,0,11,0,298,89,25826,27059,29344,3,122,27,2,1,1,0,3,369,96,33865,34548,50142,0,-71,-7,-8039,-21,-7489,-20798,-2,-1,0,0,8
EUN1_3576238440',1,20,21,1,0,1,0,5,0,373,76,31971,30999,39803,5,29,16,0,0,1,0,6,305,80,27221,28476,36325,1,68,-4,4750,5,2523,3478,1,0,0,0,-1
EUN1_3575939786',1,146,5,0,0,0,0,7,0,293,94,23221,26280,24387,4,21,22,2,1,2,0,3,345,98,31065,31386,41833,0,-52,-4,-7844,-17,-5106,-17446,-2,-1,-2,0,4
EUN1_3575913014',1,24,11,0,0,0,0,8,1,336,79,26835,29335,29980,9,33,14,1,0,2,0,1,382,80,29532,30621,36596,1,-46,-1,-2697,-3,-1286,-6616,-1,0,-2,0,7
EUN1_3575757714',3,24,12,0,1,1,0,9,1,365,103,28418,30527,34528,6,132,9,2,0,0,0,3,320,100,25501,27790,28295,1,45,3,2917,3,2737,6233,-2,1,1,0,6
EUN1_3575745619',2,24,10,0,0,1,0,9,1,278,92,24978,25484,33057,2,21,15,1,0,0,0,9,352,72,27985,29015,32215,0,-74,20,-3007,-5,-3531,842,-1,0,1,0,0
EUN1_3575736242',2,27,8,1,0,0,0,10,0,353,89,24131,27368,24081,1,29,14,1,0,1,0,1,394,97,28604,31629,28993,0,-41,-8,-4473,-6,-4261,-4912,0,0,-1,0,9
EUN1_3575723364',3,26,8,0,0,1,0,7,0,388,97,26354,30161,28330,4,49,8,2,0,0,0,2,378,64,24542,28679,26790,1,10,33,1812,0,1482,1540,-2,0,1,0,5
EUN1_3575452924',3,36,13,0,0,1,0,11,1,381,74,28844,29956,33736,5,96,12,1,0,0,0,3,331,106,27135,28015,36785,1,50,-32,1709,1,1941,-3049,-1,0,1,0,8
EUN1_3575295548',2,21,11,1,0,2,0,8,1,365,116,28828,31157,27920,2,104,8,1,0,1,0,4,347,64,24855,27891,25715,1,18,52,3973,3,3266,2205,0,0,1,0,4
EUN1_3575268768',5,44,6,0,0,0,0,11,0,381,88,24514,30205,22636,4,36,8,1,0,0,0,1,412,100,26528,30599,32299,0,-31,-12,-2014,-2,-394,-9663,-1,0,0,0,10
EUN1_3575256357',4,26,10,1,0,0,0,13,0,340,75,25669,27660,28022,8,34,10,1,0,2,0,1,385,94,28813,30692,30715,1,-45,-19,-3144,0,-3032,-2693,0,0,-2,0,12
EUN1_3575195720',2,33,26,2,0,4,0,9,1,374,94,36316,33558,44670,4,24,7,0,0,1,0,6,246,106,23107,24848,23909,1,128,-12,13209,19,8710,20761,2,0,3,0,3
EUN1_3575835362',6,28,13,0,0,0,0,5,0,309,92,26921,29181,31004,3,27,9,2,0,0,0,0,343,92,24639,28159,32199,0,-34,0,2282,4,1022,-1195,-2,0,0,0,5
EUN1_3575808722',4,36,26,0,0,0,0,12,1,306,98,32311,31575,48435,1,34,17,2,0,1,0,2,315,76,29164,27541,45069,1,-9,22,3147,9,4034,3366,-2,0,-1,0,10
EUN1_3575336388',1,27,14,1,0,2,0,7,1,381,100,31069,31525,32653,0,34,8,1,0,0,0,8,352,74,24414,27976,27786,1,29,26,6655,6,3549,4867,0,0,2,0,-1
EUN1_3575253071',1,25,21,2,0,1,0,8,0,297,82,30832,29083,48337,4,37,19,0,0,2,0,3,312,63,30674,27025,40009,1,-15,19,158,2,2058,8328,2,0,-1,0,5
EUN1_3575005654',2,23,11,1,0,0,0,8,0,370,116,27714,31557,29910,2,24,16,1,0,0,0,5,406,88,29741,33805,30784,1,-36,28,-2027,-5,-2248,-874,0,0,0,0,3
EUN1_3574984320',3,21,16,2,0,3,0,8,1,333,104,30910,31236,32885,4,96,12,0,0,0,0,5,335,76,26584,27883,28133,1,-2,28,4326,4,3353,4752,2,0,3,0,3
EUN1_3574591079',4,25,9,2,0,0,0,11,0,299,81,25789,28328,27835,3,28,17,0,0,1,0,1,362,90,30585,29684,34480,0,-63,-9,-4796,-8,-1356,-6645,2,0,-1,0,10
EUN1_3574568029',2,27,9,0,0,0,0,9,1,306,70,24870,27603,28042,7,29,18,1,0,2,0,0,375,82,32396,31664,35460,1,-69,-12,-7526,-9,-4061,-7418,-1,0,-2,0,9
EUN1_3574451074',3,33,10,0,0,0,0,12,0,320,79,24464,25544,23944,3,33,23,2,1,2,0,1,424,110,34393,33531,39065,0,-104,-31,-9929,-13,-7987,-15121,-2,-1,-2,0,11
EUN1_3574376416',1,27,4,0,0,0,0,8,0,369,98,23083,28996,20933,4,25,10,2,0,1,0,2,366,86,27265,28922,28840,1,3,12,-4182,-6,74,-7907,-2,0,-1,0,6
EUN1_3574050592',2,34,8,1,0,0,0,12,1,337,89,25605,27977,27494,3,30,16,1,0,3,0,3,392,102,32056,31907,35488,0,-55,-13,-6451,-8,-3930,-7994,0,0,-3,0,9
EUN1_3574046390',4,24,10,1,0,0,0,17,1,310,91,24196,26083,27513,3,25,18,1,0,3,0,2,314,88,30878,28868,38930,0,-4,3,-6682,-8,-2785,-11417,0,0,-3,0,15
EUN1_3574043201',6,29,17,1,0,1,0,4,1,368,96,29927,31603,31123,0,22,7,0,0,0,0,6,346,56,24377,26857,21061,1,22,40,5550,10,4746,10062,1,0,1,0,-2
EUN1_3574018036',2,23,10,0,1,0,0,10,0,341,78,25744,29244,31151,4,26,17,2,0,0,0,1,382,110,28879,31966,40396,1,-41,-32,-3135,-7,-2722,-9245,-2,1,0,0,9
EUN1_3574006923',5,146,12,1,0,0,0,8,0,340,71,25980,29374,36473,1,39,12,1,0,0,0,3,332,84,25843,29643,31553,0,8,-13,137,0,-269,4920,0,0,0,0,5
EUN1_3573314499',1,22,15,2,0,0,0,10,1,364,72,28248,30683,33112,5,26,13,0,0,1,0,4,368,108,28771,31370,27652,1,-4,-36,-523,2,-687,5460,2,0,-1,0,6
EUN1_3573285882',2,22,7,0,0,0,0,8,0,336,70,24235,28966,23997,5,330,18,2,1,1,0,0,398,116,30955,34585,34217,0,-62,-46,-6720,-11,-5619,-10220,-2,-1,-1,0,8
EUN1_3573253065',3,29,10,0,0,0,0,11,1,374,102,26859,31358,31527,2,29,10,1,0,2,0,4,373,70,27211,30190,33179,1,1,32,-352,0,1168,-1652,-1,0,-2,0,7
EUN1_3573097622',4,32,15,0,0,2,0,11,1,388,93,30604,32440,34966,9,82,9,1,0,0,0,7,386,86,26578,29788,24600,1,2,7,4026,6,2652,10366,-1,0,2,0,4
EUN1_3573087454',3,25,18,1,0,1,0,9,1,313,71,29499,29629,30141,4,120,9,1,0,1,0,6,398,99,28311,31409,33069,1,-85,-28,1188,9,-1780,-2928,0,0,0,0,3
EUN1_3573728846',3,37,5,0,0,0,0,15,0,347,88,23315,26204,25730,7,63,22,2,0,2,0,0,376,99,32723,33391,32972,0,-29,-11,-9408,-17,-7187,-7242,-2,0,-2,0,15
EUN1_3573207261',6,21,6,0,0,0,0,6,1,357,92,24379,28561,25158,3,26,10,1,0,1,0,0,382,79,26111,30581,30608,0,-25,13,-1732,-4,-2020,-5450,-1,0,-1,0,6
EUN1_3573186475',2,24,12,0,0,0,0,8,1,358,76,27969,28679,36696,3,32,11,2,0,1,0,2,275,87,25455,26850,27986,1,83,-11,2514,1,1829,8710,-2,0,-1,0,6
EUN1_3573097075',4,24,8,2,0,1,0,8,1,337,80,25203,28679,29064,8,28,17,0,0,1,0,3,352,100,28707,30622,36393,1,-15,-20,-3504,-9,-1943,-7329,2,0,0,0,5
EUN1_3573050862',4,29,7,0,0,0,0,6,0,340,84,24683,29261,24573,4,25,13,2,0,1,0,3,360,104,28931,29869,32841,0,-20,-20,-4248,-6,-608,-8268,-2,0,-1,0,3
EUN1_3573015856',2,32,14,1,0,0,0,10,0,287,74,26190,28611,34026,4,30,16,0,0,1,0,4,346,94,28522,29734,37200,1,-59,-20,-2332,-2,-1123,-3174,1,0,-1,0,6
EUN1_3572990063',3,150,8,0,0,0,0,12,0,360,82,25451,27424,24608,7,98,11,1,1,2,0,3,363,106,28397,31513,33206,0,-3,-24,-2946,-3,-4089,-8598,-1,-1,-2,0,9
EUN1_3572798323',5,26,12,0,0,0,0,8,0,343,78,26617,30107,29552,4,32,15,2,0,0,0,5,351,109,29392,32154,38279,1,-8,-31,-2775,-3,-2047,-8727,-2,0,0,0,3
EUN1_3572756843',1,32,14,1,0,1,0,11,1,304,72,27403,28705,41040,9,30,22,1,0,1,0,3,300,101,30852,29307,35065,0,4,-29,-3449,-8,-602,5975,0,0,0,0,8
EUN1_3572581439',4,25,13,0,0,0,0,5,0,384,76,27184,30571,34365,5,36,14,2,0,0,0,5,345,99,28115,30999,35418,1,39,-23,-931,-1,-428,-1053,-2,0,0,0,0
EUN1_3572562171',3,33,14,2,1,2,0,9,1,398,117,31417,34343,34049,4,22,6,0,0,0,0,6,341,93,23890,28465,23917,1,57,24,7527,8,5878,10132,2,1,2,0,3
EUN1_3572529944',7,29,16,1,0,1,0,7,0,325,102,30436,31091,33140,4,28,13,0,0,1,0,6,342,78,26786,28133,30653,1,-17,24,3650,3,2958,2487,1,0,0,0,1
EUN1_3572511519',3,25,11,0,0,1,0,8,1,335,95,27487,27280,29078,4,27,17,1,0,1,0,7,334,76,28255,29157,33733,1,1,19,-768,-6,-1877,-4655,-1,0,0,0,1
EUN1_3572486347',12,41,9,0,0,2,0,7,0,366,72,27795,27098,30440,7,28,19,2,1,1,0,6,326,72,29982,30195,38019,0,40,0,-2187,-10,-3097,-7579,-2,-1,1,0,1
EUN1_3572154011',3,32,7,0,0,0,0,6,1,328,78,23621,27421,30002,2,27,12,2,0,0,0,3,311,92,26346,29695,27566,0,17,-14,-2725,-5,-2274,2436,-2,0,0,0,3
EUN1_3572119394',4,17,7,1,0,0,0,8,0,340,91,24369,28640,32212,2,27,10,1,0,0,0,2,332,82,25199,29842,28988,0,8,9,-830,-3,-1202,3224,0,0,0,0,6
EUN1_3574387944',4,22,16,0,0,1,0,7,0,385,76,29504,32092,34959,4,23,8,1,0,0,0,4,348,104,25561,29241,33455,0,37,-28,3943,8,2851,1504,-1,0,1,0,3
EUN1_3574213560',5,29,16,1,0,0,0,8,0,302,70,27075,26971,29976,3,16,12,1,0,1,0,1,346,87,26711,28159,31177,0,-44,-17,364,4,-1188,-1201,0,0,-1,0,7
EUN1_3574121550',6,30,17,1,0,2,0,8,1,388,110,30903,31715,34976,4,53,8,1,0,0,0,5,343,86,24608,27932,28386,1,45,24,6295,9,3783,6590,0,0,2,0,3
EUN1_3574109481',2,29,16,2,0,0,0,9,0,394,100,29828,34853,34776,5,33,11,0,0,1,0,2,355,92,28795,28897,38567,0,39,8,1033,5,5956,-3791,2,0,-1,0,7
EUN1_3571109685',1,27,19,1,0,0,0,14,0,241,78,28274,28173,35691,2,43,20,1,0,2,0,0,323,94,32021,28693,44029,1,-82,-16,-3747,-1,-520,-8338,0,0,-2,0,14
EUN1_3570476364',2,21,13,0,0,1,0,13,0,343,92,29173,29984,30554,2,36,15,2,0,1,0,6,352,107,28537,29028,33059,0,-9,-15,636,-2,956,-2505,-2,0,0,0,7
EUN1_3569888552',3,21,15,2,0,1,0,13,1,350,87,29403,29409,34923,1,27,15,0,0,2,0,4,277,92,27519,27486,30368,1,73,-5,1884,0,1923,4555,2,0,-1,0,9
EUN1_3569206209',2,28,6,1,0,0,0,8,0,364,90,24043,28163,19318,3,23,13,1,0,0,0,1,361,80,26612,30062,31289,0,3,10,-2569,-7,-1899,-11971,0,0,0,0,7
EUN1_3568861575',2,29,18,1,0,0,0,10,1,302,80,29211,31449,33822,4,40,15,1,0,1,0,1,360,110,29590,31606,38132,0,-58,-30,-379,3,-157,-4310,0,0,-1,0,9
EUN1_3568463841',3,27,12,1,0,0,0,6,1,318,66,25730,27073,35977,4,30,15,0,0,0,0,1,322,44,26278,25143,37912,0,-4,22,-548,-3,1930,-1935,1,0,0,0,5
EUN1_3568042591',3,25,6,1,0,1,0,7,0,363,99,25582,28702,24503,5,21,12,0,0,0,0,4,381,84,28261,30357,30954,1,-18,15,-2679,-6,-1655,-6451,1,0,1,0,3
EUN1_3567541053',4,30,17,0,0,1,0,7,0,305,90,29261,29896,33081,3,28,15,2,0,1,0,3,336,89,28806,30010,33087,0,-31,1,455,2,-114,-6,-2,0,0,0,4
EUN1_3567430575',2,29,9,1,1,1,0,10,1,324,104,26788,28153,30037,6,58,7,0,0,0,0,8,364,80,25454,28498,28216,1,-40,24,1334,2,-345,1821,1,1,1,0,2
EUN1_3566571995',3,28,8,0,0,0,0,9,1,359,90,26351,27917,28006,3,29,9,2,0,1,0,6,362,80,25944,29788,28503,1,-3,10,407,-1,-1871,-497,-2,0,-1,0,3
EUN1_3566563552',7,30,15,0,0,0,0,12,0,325,89,27245,30245,37943,5,28,21,1,0,2,0,1,395,97,32710,33534,46943,0,-70,-8,-5465,-6,-3289,-9000,-1,0,-2,0,11
EUN1_3575655958',3,21,12,2,0,0,0,11,1,306,86,25462,28355,27958,2,28,15,0,0,1,0,3,297,94,26591,29670,32196,1,9,-8,-1129,-3,-1315,-4238,2,0,-1,0,8
EUN1_3575102033',3,26,12,1,0,1,0,6,1,343,86,27927,29974,38394,2,24,11,1,1,0,0,4,333,94,26220,29737,35649,1,10,-8,1707,1,237,2745,0,-1,1,0,2
EUN1_3574744735',3,27,12,2,1,3,0,4,1,393,112,30892,30796,24876,4,72,1,0,0,1,0,9,304,64,19428,24145,16195,1,89,48,11464,11,6651,8681,2,1,2,0,-5
EUN1_3574559583',7,34,14,0,0,0,0,8,1,365,84,28857,29193,36073,1,21,17,1,0,2,0,3,345,64,28888,29640,40993,1,20,20,-31,-3,-447,-4920,-1,0,-2,0,5
EUN1_3574546904',2,29,10,0,0,0,0,12,1,372,86,25625,27834,29230,4,47,21,1,0,0,0,1,370,72,30608,32966,35354,0,2,14,-4983,-11,-5132,-6124,-1,0,0,0,11
EUN1_3574226273',4,37,9,1,0,0,0,10,0,322,108,25560,28380,33328,5,35,13,1,0,1,0,2,351,87,29491,30058,38040,0,-29,21,-3931,-4,-1678,-4712,0,0,-1,0,8
EUN1_3572923999',2,23,8,1,0,0,0,12,0,367,93,24623,29364,29083,2,28,19,1,1,1,0,2,345,86,28845,31148,32363,0,22,7,-4222,-11,-1784,-3280,0,-1,-1,0,10
EUN1_3572844604',8,39,16,1,0,1,0,12,1,339,100,29119,31312,35489,5,28,15,1,0,0,0,1,328,80,27418,29282,31222,0,11,20,1701,1,2030,4267,0,0,1,0,11
EUN1_3572657458',9,31,4,1,0,0,0,6,1,367,99,22491,28849,22814,6,24,6,1,0,1,0,1,399,88,25595,31249,21076,1,-32,11,-3104,-2,-2400,1738,0,0,-1,0,5
EUN1_3571753921',1,24,12,0,1,0,0,14,1,312,94,26981,28036,29642,6,27,22,1,0,2,0,1,355,98,33140,32631,41319,0,-43,-4,-6159,-10,-4595,-11677,-1,1,-2,0,13
EUN1_3571220412',6,31,11,2,0,0,0,9,0,336,90,27464,30643,34827,2,34,9,0,0,1,0,2,347,91,24850,28500,25248,1,-11,-1,2614,2,2143,9579,2,0,-1,0,7
EUN1_3571208311',3,94,18,1,0,2,0,9,0,353,108,31637,33036,38227,0,23,7,0,0,0,0,7,354,48,24065,26094,23220,1,-1,60,7572,11,6942,15007,1,0,2,0,2
EUN1_3571177901',8,29,7,1,0,0,0,6,1,371,84,24946,29955,26190,1,97,2,1,0,0,0,1,397,104,23236,29634,22973,1,-26,-20,1710,5,321,3217,0,0,0,0,5
EUN1_3570749679',1,17,14,2,1,2,0,11,1,379,113,30362,30536,32464,3,73,7,0,0,0,0,7,354,74,24855,26658,23922,1,25,39,5507,7,3878,8542,2,1,2,0,4
EUN1_3575841034',2,29,12,0,0,0,0,15,0,376,82,27070,29358,27595,6,42,13,2,1,3,0,1,399,76,30340,31688,33999,1,-23,6,-3270,-1,-2330,-6404,-2,-1,-3,0,14
EUN1_3572567467',0,32,9,1,0,0,0,11,1,313,89,24045,27857,25636,5,25,11,1,0,1,0,3,353,90,26945,29231,25821,0,-40,-1,-2900,-2,-1374,-185,0,0,-1,0,8
EUN1_3572030801',4,34,12,1,0,0,0,8,0,354,106,27474,31018,39176,2,33,9,1,0,0,0,1,327,86,24121,27603,26767,0,27,20,3353,3,3415,12409,0,0,0,0,7
EUN1_3568953640',5,30,6,0,0,0,0,9,1,355,82,23924,26353,23969,2,27,10,2,0,1,0,1,395,91,28235,31444,33259,0,-40,-9,-4311,-4,-5091,-9290,-2,0,-1,0,8
EUN1_3568944613',1,25,11,1,0,1,0,6,1,358,60,25384,27604,31450,3,34,6,1,0,0,0,3,361,56,23537,27500,29560,1,-3,4,1847,5,104,1890,0,0,1,0,3
EUN1_3568755419',5,27,21,1,0,1,0,5,1,379,88,31816,33240,41069,4,28,9,1,0,1,0,8,331,81,25095,27349,29255,1,48,7,6721,12,5891,11814,0,0,0,0,-3
EUN1_3568729569',3,26,21,2,1,1,0,4,1,351,74,30795,31849,36149,3,25,9,0,0,0,0,7,303,84,24577,27416,31154,1,48,-10,6218,12,4433,4995,2,1,1,0,-3
EUN1_3568709176',2,44,19,1,0,1,0,12,1,319,110,30330,30408,35300,1,20,10,0,0,0,0,3,352,80,25522,27489,26363,1,-33,30,4808,9,2919,8937,1,0,1,0,9
EUN1_3568661597',6,33,6,0,1,0,0,10,1,302,86,23661,27788,20911,2,141,11,2,0,2,0,1,380,96,27523,31478,28179,0,-78,-10,-3862,-5,-3690,-7268,-2,1,-2,0,9
EUN1_3575857448',5,34,17,2,0,2,0,3,1,401,100,30812,32634,36018,4,31,6,0,0,0,0,10,305,71,23396,27460,18166,1,96,29,7416,11,5174,17852,2,0,2,0,-7
EUN1_3575846089',1,21,8,0,1,0,0,10,0,399,124,28768,33487,26344,1,97,10,1,0,2,0,6,393,111,28986,32335,26321,1,6,13,-218,-2,1152,23,-1,1,-2,0,4
EUN1_3575065556',4,48,6,1,0,0,0,15,0,322,76,23830,26303,29515,2,23,18,1,0,3,0,4,365,76,30817,30368,34109,0,-43,0,-6987,-12,-4065,-4594,0,0,-3,0,11
EUN1_3575032071',8,28,22,2,0,0,0,7,0,386,104,31586,33030,43128,6,22,13,0,0,0,0,3,330,108,27726,30252,28742,0,56,-4,3860,9,2778,14386,2,0,0,0,4
EUN1_3575014592',2,24,19,1,0,1,0,9,1,350,76,29859,31359,35918,2,24,15,0,0,0,0,4,316,99,27986,30522,42448,1,34,-23,1873,4,837,-6530,1,0,1,0,5
EUN1_3574989740',5,27,18,2,0,1,0,8,0,335,82,30277,31089,38239,4,31,14,0,0,1,0,4,378,107,29740,31087,36620,1,-43,-25,537,4,2,1619,2,0,0,0,4
EUN1_3572222093',6,25,7,0,1,0,0,5,1,356,92,25174,28575,22917,5,31,6,2,0,0,0,2,386,92,25048,28408,17820,0,-30,0,126,1,167,5097,-2,1,0,0,3
EUN1_3572189512',3,23,15,0,0,0,0,12,0,332,72,27688,28291,33522,7,35,19,2,0,1,0,3,384,100,31056,31331,40174,0,-52,-28,-3368,-4,-3040,-6652,-2,0,-1,0,9
EUN1_3572163497',1,28,9,0,0,0,0,10,0,376,90,27003,29978,26558,6,67,12,1,0,0,0,1,300,94,26130,28287,30539,1,76,-4,873,-3,1691,-3981,-1,0,0,0,9
EUN1_3571999542',4,17,12,0,0,0,0,11,1,369,90,27126,29891,28004,4,22,10,0,0,1,0,4,355,112,26919,31225,31341,0,14,-22,207,2,-1334,-3337,0,0,-1,0,7
EUN1_3571982465',1,182,17,0,0,0,0,6,1,340,66,29437,29456,33312,2,32,14,2,0,0,0,3,364,93,28029,29478,40571,0,-24,-27,1408,3,-22,-7259,-2,0,0,0,3
EUN1_3576134014',3,21,14,1,0,0,0,7,0,382,91,29856,30972,32697,3,25,11,1,0,1,0,8,350,88,25166,27834,24584,1,32,3,4690,3,3138,8113,0,0,-1,0,-1
EUN1_3576125703',2,23,17,1,0,1,0,6,1,311,87,29728,29797,37095,2,23,10,1,0,1,0,6,313,76,25168,27347,35136,1,-2,11,4560,7,2450,1959,0,0,0,0,0
EUN1_3576106742',2,23,11,0,0,0,0,13,0,354,84,27565,28514,29206,6,32,16,1,0,1,0,2,395,78,29533,32260,39243,1,-41,6,-1968,-5,-3746,-10037,-1,0,-1,0,11
EUN1_3575052158',0,16,13,1,0,1,0,9,0,325,80,28484,29111,35411,3,22,21,1,0,1,0,5,337,91,29936,31093,34631,0,-12,-11,-1452,-8,-1982,780,0,0,0,0,4
EUN1_3575015984',3,27,19,2,0,3,0,4,1,366,102,31583,31060,31052,7,39,6,0,0,0,0,12,307,82,24122,25421,25494,1,59,20,7461,13,5639,5558,2,0,3,0,-8
EUN1_3575000261',2,25,10,1,0,0,0,11,0,317,76,25382,28251,26704,5,255,17,1,0,2,0,1,362,72,29756,31189,34944,0,-45,4,-4374,-7,-2938,-8240,0,0,-2,0,10
EUN1_3574974458',3,25,12,0,0,2,0,3,1,355,68,28456,27557,40172,3,91,24,2,0,0,0,6,318,78,30965,30150,34404,1,37,-10,-2509,-12,-2593,5768,-2,0,2,0,-3
EUN1_3574946444',3,32,9,1,0,0,0,9,1,296,92,24641,25450,30205,6,30,9,1,0,0,0,4,324,74,24596,25967,27152,0,-28,18,45,0,-517,3053,0,0,0,0,5
EUN1_3574919495',7,28,12,0,0,1,0,10,1,306,80,26580,27249,25803,4,42,14,2,0,1,0,4,358,67,28357,29326,33310,0,-52,13,-1777,-2,-2077,-7507,-2,0,0,0,6
EUN1_3572922222',2,25,9,0,0,0,0,8,0,358,74,24556,28177,25912,0,19,8,1,0,0,0,1,330,72,24197,26919,22416,1,28,2,359,1,1258,3496,-1,0,0,0,7
EUN1_3572909204',1,156,10,0,0,0,0,7,0,348,96,26284,29270,37024,3,29,12,2,0,1,0,2,365,80,27226,29563,30268,1,-17,16,-942,-2,-293,6756,-2,0,-1,0,5
EUN1_3572890164',4,23,15,1,1,1,0,6,1,378,73,28244,27899,36161,7,31,9,1,0,1,0,7,329,114,26371,28120,30756,1,49,-41,1873,6,-221,5405,0,1,0,0,-1
EUN1_3576049092',2,28,7,2,1,0,0,8,0,363,110,24730,29862,26514,3,26,9,0,0,1,0,0,408,82,27852,30492,26852,1,-45,28,-3122,-2,-630,-338,2,1,-1,0,8
EUN1_3576005898',4,307,8,1,0,1,0,6,0,379,82,25991,29636,29408,3,27,11,1,0,0,0,4,388,96,26497,29465,28615,1,-9,-14,-506,-3,171,793,0,0,1,0,2
EUN1_3575989319',5,39,13,1,0,0,0,7,1,374,91,28972,29505,41208,3,24,17,1,0,2,0,9,356,70,28976,29450,32647,1,18,21,-4,-4,55,8561,0,0,-2,0,-2
EUN1_3575961250',5,27,7,0,0,2,0,5,1,433,86,27254,31251,30202,2,24,7,1,0,0,0,8,375,66,23871,28199,23577,0,58,20,3383,0,3052,6625,-1,0,2,0,-3
EUN1_3575908665',4,32,11,1,0,0,0,8,1,365,76,27103,26906,40021,0,20,17,1,0,1,0,1,362,72,28631,29871,37046,1,3,4,-1528,-6,-2965,2975,0,0,-1,0,7
EUN1_3575886046',2,25,11,0,0,0,0,10,1,339,91,25781,28134,28090,6,30,14,1,1,1,0,0,411,97,29854,30732,29964,1,-72,-6,-4073,-3,-2598,-1874,-1,-1,-1,0,10
EUN1_3575596029',3,33,10,0,0,0,0,8,0,309,73,26874,28974,29122,1,17,16,2,0,2,0,0,370,122,30939,32659,32197,0,-61,-49,-4065,-6,-3685,-3075,-2,0,-2,0,8
EUN1_3575578122',3,29,19,1,0,1,0,15,1,290,80,30721,28528,33785,4,25,14,0,0,2,0,4,354,84,29721,28991,33268,1,-64,-4,1000,5,-463,517,1,0,-1,0,11
EUN1_3575531986',1,19,17,0,0,1,0,7,1,366,102,30221,33389,41820,2,26,10,2,0,0,0,7,382,74,26261,30460,29060,0,-16,28,3960,7,2929,12760,-2,0,1,0,0
EUN1_3575501983',3,21,14,0,1,0,0,7,0,339,74,27786,30013,28592,1,43,14,1,0,0,0,4,350,120,29466,31131,31495,1,-11,-46,-1680,0,-1118,-2903,-1,1,0,0,3
EUN1_3575470956',4,28,17,0,0,1,0,5,0,397,88,30741,31459,36664,2,27,14,1,0,0,0,6,328,74,27192,29677,27164,1,69,14,3549,3,1782,9500,-1,0,1,0,-1
EUN1_3575458329',4,27,7,0,0,0,0,13,1,367,75,24882,28274,19351,6,28,15,2,0,2,0,4,371,128,30867,31480,32461,0,-4,-53,-5985,-8,-3206,-13110,-2,0,-2,0,9
EUN1_3575428300',4,68,18,1,0,1,0,11,0,338,70,29307,30908,40125,1,57,9,0,0,1,0,2,347,94,26999,29574,29604,1,-9,-24,2308,9,1334,10521,1,0,0,0,9
EUN1_3575373432',3,30,15,0,0,0,0,9,1,323,88,28051,28876,28959,4,28,11,0,0,1,0,3,359,88,26851,28079,29714,1,-36,0,1200,4,797,-755,0,0,-1,0,6
EUN1_3575019187',2,24,14,0,0,1,0,5,1,350,74,29209,29737,38595,2,82,11,1,0,0,0,8,305,76,24901,27357,34885,1,45,-2,4308,3,2380,3710,-1,0,1,0,-3
EUN1_3574992265',1,22,15,2,0,1,0,5,1,347,106,29891,31326,36511,1,25,6,0,0,1,0,8,338,94,23492,28206,25148,1,9,12,6399,9,3120,11363,2,0,0,0,-3
EUN1_3574950472',5,25,9,0,0,0,0,7,1,342,88,25481,29000,27251,3,26,12,1,0,2,0,5,354,68,26711,28838,30216,1,-12,20,-1230,-3,162,-2965,-1,0,-2,0,2
EUN1_3574902014',2,32,14,1,0,1,0,11,0,313,106,28412,28777,28604,2,27,11,0,0,0,0,5,336,66,25823,27880,25827,1,-23,40,2589,3,897,2777,1,0,1,0,6
EUN1_3574893087',0,17,4,0,0,0,0,14,1,300,94,22763,26130,22425,3,19,11,2,0,3,0,1,355,106,28540,30370,34706,0,-55,-12,-5777,-7,-4240,-12281,-2,0,-3,0,13
EUN1_3573431539',4,27,5,1,0,0,0,12,0,287,94,22204,26842,27156,4,36,15,1,0,3,0,2,400,102,31802,31319,38561,0,-113,-8,-9598,-10,-4477,-11405,0,0,-3,0,10
EUN1_3572886141',4,27,16,1,0,1,0,5,1,369,76,29009,30431,34522,5,44,14,0,0,0,0,7,341,88,27432,28494,32929,0,28,-12,1577,2,1937,1593,1,0,1,0,-2
EUN1_3567898717',1,29,6,0,0,0,0,5,0,354,98,24384,27679,28411,7,26,15,2,0,1,0,2,361,93,28462,30795,28569,0,-7,5,-4078,-9,-3116,-158,-2,0,-1,0,3
EUN1_3567879696',3,29,25,2,0,4,0,11,1,325,86,35657,30339,49339,4,25,19,0,0,2,0,11,304,73,30970,26946,33747,1,21,13,4687,6,3393,15592,2,0,2,0,0
EUN1_3567863175',5,31,11,0,0,1,0,9,0,352,62,26202,29317,31882,3,183,15,1,0,2,0,3,368,110,30442,33860,39155,0,-16,-48,-4240,-4,-4543,-7273,-1,0,-1,0,6
EUN1_3567830335',1,20,14,0,1,2,0,9,1,351,59,28659,29844,27230,3,27,14,1,0,0,0,7,274,84,26137,26907,31511,0,77,-25,2522,0,2937,-4281,-1,1,2,0,2
EUN1_3564350361',6,30,13,2,0,0,0,11,0,367,76,27922,28014,40740,3,30,16,0,0,1,0,3,295,88,28201,27560,34357,1,72,-12,-279,-3,454,6383,2,0,-1,0,8
EUN1_3564329247',3,24,5,0,0,0,0,11,1,384,92,25596,29346,16521,5,30,6,2,0,1,0,4,345,95,23893,27944,24028,0,39,-3,1703,-1,1402,-7507,-2,0,-1,0,7
EUN1_3561124108',3,29,12,2,0,2,0,8,0,328,84,28729,28975,29119,1,19,18,0,0,0,0,6,347,64,28735,30411,33733,0,-19,20,-6,-6,-1436,-4614,2,0,2,0,2
EUN1_3561096651',3,78,15,2,0,1,0,10,0,351,98,29461,32261,41032,4,27,10,0,0,0,0,3,333,82,25872,28020,33894,1,18,16,3589,5,4241,7138,2,0,1,0,7
EUN1_3561079326',3,22,9,1,0,0,0,5,1,375,94,25408,29045,20835,7,88,4,1,0,0,0,2,359,85,23445,27673,23361,1,16,9,1963,5,1372,-2526,0,0,0,0,3
EUN1_3561035831',1,45,29,2,0,1,0,8,1,374,102,32706,32117,49141,5,30,13,0,0,1,0,6,334,4,24106,24209,33425,1,40,98,8600,16,7908,15716,2,0,0,0,2
EUN1_3560085237',3,27,15,2,0,0,0,6,1,372,102,29363,30462,37368,5,242,13,0,0,1,0,6,325,90,26367,29458,31925,0,47,12,2996,2,1004,5443,2,0,-1,0,0
EUN1_3560003502',2,82,8,0,0,0,0,8,0,317,76,24296,25790,28071,5,28,11,1,0,1,0,1,351,96,28037,28924,31648,0,-34,-20,-3741,-3,-3134,-3577,-1,0,-1,0,7
EUN1_3573783999',7,31,10,0,0,0,0,5,1,343,72,26140,28057,21908,5,33,12,2,0,0,0,2,390,98,28244,30460,25572,0,-47,-26,-2104,-2,-2403,-3664,-2,0,0,0,3
EUN1_3573771585',2,31,14,1,0,0,0,8,1,367,91,27319,29305,27504,1,28,8,1,0,1,0,1,352,58,23981,26794,24887,1,15,33,3338,6,2511,2617,0,0,-1,0,7
EUN1_3573737401',4,25,11,1,0,0,0,8,0,316,78,26852,26328,31612,4,32,23,0,0,1,0,5,342,74,31389,29491,39657,0,-26,4,-4537,-12,-3163,-8045,1,0,-1,0,3
EUN1_3573684947',2,27,13,0,0,0,0,8,1,336,92,27308,27933,33806,6,40,11,1,0,0,0,4,323,66,25659,28603,39586,0,13,26,1649,2,-670,-5780,-1,0,0,0,4
EUN1_3573665865',6,26,8,1,1,0,0,6,0,393,115,26304,32260,28183,1,22,10,1,0,1,0,2,375,92,27383,31536,30889,1,18,23,-1079,-2,724,-2706,0,1,-1,0,4
EUN1_3573646140',4,20,13,1,0,2,0,7,1,394,84,30060,30109,30189,8,38,12,1,0,1,0,8,353,76,26429,29961,27544,1,41,8,3631,1,148,2645,0,0,1,0,-1
EUN1_3573264705',4,92,15,0,0,0,0,10,1,322,92,27153,29018,31813,4,24,9,1,0,1,0,3,338,95,25930,28879,31328,1,-16,-3,1223,6,139,485,-1,0,-1,0,7
EUN1_3573224990',3,27,18,2,1,3,0,4,1,369,96,33050,30657,43679,5,39,13,0,0,0,0,12,308,88,26869,27630,31020,1,61,8,6181,5,3027,12659,2,1,3,0,-8
EUN1_3573182953',1,30,16,0,1,0,0,13,1,357,98,30314,30172,37044,5,28,17,2,0,2,0,1,321,88,27725,28459,29349,0,36,10,2589,-1,1713,7695,-2,1,-2,0,12
EUN1_3573153339',3,27,14,2,0,1,0,5,1,362,107,30916,30660,27421,3,25,8,0,0,1,0,8,349,80,25199,29414,21056,1,13,27,5717,6,1246,6365,2,0,0,0,-3
EUN1_3572990382',3,24,17,2,0,2,0,10,0,352,96,31233,30110,38634,4,28,9,0,0,1,0,5,319,102,26087,27751,31021,0,33,-6,5146,8,2359,7613,2,0,1,0,5
EUN1_3572480149',1,22,11,0,0,0,0,10,1,386,112,27388,30793,25009,4,29,13,2,0,1,0,4,349,120,29204,30065,33742,0,37,-8,-1816,-2,728,-8733,-2,0,-1,0,6
EUN1_3572145729',6,36,10,0,0,0,0,8,1,354,71,25776,29543,28541,2,27,13,0,0,1,0,4,331,104,27800,29826,28502,1,23,-33,-2024,-3,-283,39,0,0,-1,0,4
EUN1_3576238073',2,27,14,1,0,0,0,13,0,340,76,26567,30501,30605,3,26,11,1,0,2,0,2,344,100,28274,28967,35476,0,-4,-24,-1707,3,1534,-4871,0,0,-2,0,11
EUN1_3575999433',6,66,21,2,0,2,0,7,1,371,91,32630,30082,39253,3,23,13,0,0,0,0,8,286,64,26723,26034,31488,1,85,27,5907,8,4048,7765,2,0,2,0,-1
EUN1_3575969685',5,26,7,0,0,0,0,4,0,344,66,22762,27818,29022,4,28,13,2,1,0,0,2,344,74,26362,29767,31051,0,0,-8,-3600,-6,-1949,-2029,-2,-1,0,0,2
EUN1_3575945933',7,148,17,2,0,1,0,5,0,345,96,29664,31253,40126,2,21,7,0,1,0,0,5,359,88,24621,28515,30318,1,-14,8,5043,10,2738,9808,2,-1,1,0,0
EUN1_3575920261',2,24,7,1,1,1,0,6,1,345,80,25383,28348,19435,4,27,8,1,0,1,0,6,327,104,26063,29068,23089,1,18,-24,-680,-1,-720,-3654,0,1,0,0,0
EUN1_3575778824',1,36,10,1,1,0,0,7,1,358,94,25894,31877,29291,3,25,9,1,0,0,0,5,329,70,24555,27912,29266,0,29,24,1339,1,3965,25,0,1,0,0,2
EUN1_3575765838',1,20,10,0,0,0,0,5,1,330,74,24931,27391,25162,3,25,11,1,0,0,0,3,335,104,25984,29556,26507,0,-5,-30,-1053,-1,-2165,-1345,-1,0,0,0,2
EUN1_3575725105',7,33,10,2,0,2,0,6,1,405,80,28558,30146,27517,2,136,4,0,0,0,0,6,333,84,22476,27524,21487,1,72,-4,6082,6,2622,6030,2,0,2,0,0
EUN1_3575708784',0,25,4,0,0,0,0,6,0,330,69,22090,27064,31764,3,23,8,2,0,1,0,1,330,113,25479,29826,33902,0,0,-44,-3389,-4,-2762,-2138,-2,0,-1,0,5
EUN1_3575704435',7,33,5,1,0,0,0,7,0,391,86,23588,29396,22417,2,27,8,1,0,1,0,0,399,110,28115,30835,24364,1,-8,-24,-4527,-3,-1439,-1947,0,0,-1,0,7
EUN1_3575200752',3,21,13,0,0,0,0,14,0,320,74,27266,28603,32300,4,31,16,2,0,3,0,4,411,88,31881,30864,33288,0,-91,-14,-4615,-3,-2261,-988,-2,0,-3,0,10
EUN1_3575186822',2,25,12,1,0,2,0,6,1,342,104,27687,31609,26622,1,20,7,0,0,1,0,8,340,88,24263,27836,27807,1,2,16,3424,5,3773,-1185,1,0,1,0,-2
EUN1_3574803748',4,22,5,0,0,0,0,14,0,337,76,24757,27185,32442,3,74,21,2,0,2,0,6,316,70,28996,30039,43128,0,21,6,-4239,-16,-2854,-10686,-2,0,-2,0,8
EUN1_3574790553',4,25,19,1,0,1,0,14,1,356,68,30558,29263,32239,1,34,11,1,0,2,0,3,325,92,28185,26718,25505,1,31,-24,2373,8,2545,6734,0,0,-1,0,11
EUN1_3575330457',7,37,13,1,0,0,0,13,0,353,74,27297,29985,32594,5,28,15,1,0,2,0,1,356,83,29792,30028,32255,0,-3,-9,-2495,-2,-43,339,0,0,-2,0,12
EUN1_3575313233',6,29,9,0,0,0,0,14,1,338,88,25561,27007,21477,5,24,7,2,0,3,0,2,391,103,27467,29273,23889,0,-53,-15,-1906,2,-2266,-2412,-2,0,-3,0,12
EUN1_3575282908',3,22,10,1,0,1,0,9,0,373,89,27199,30037,28893,4,26,11,0,1,2,0,3,353,86,29062,30090,32888,0,20,3,-1863,-1,-53,-3995,1,-1,-1,0,6
EUN1_3575262855',3,238,14,1,0,1,0,12,1,315,96,28380,29980,39406,2,424,13,1,0,0,0,5,353,64,28168,28536,34519,1,-38,32,212,1,1444,4887,0,0,1,0,7
EUN1_3575246784',5,37,13,1,0,0,0,7,0,348,86,27424,29878,25650,4,33,4,1,0,0,0,4,374,90,23300,26676,25648,1,-26,-4,4124,9,3202,2,0,0,0,0,3
EUN1_3575081369',6,34,14,1,0,2,0,8,0,371,58,29146,30354,36748,4,37,11,1,0,0,0,8,346,96,26790,28252,25853,1,25,-38,2356,3,2102,10895,0,0,2,0,0
EUN1_3575061229',4,32,14,1,0,2,0,2,0,375,102,31324,30006,29556,4,53,13,0,0,0,0,9,306,86,27881,27989,31700,1,69,16,3443,1,2017,-2144,1,0,2,0,-7
EUN1_3574828803',1,22,8,0,0,0,0,9,0,366,72,24775,28376,29282,4,42,13,2,0,2,0,0,362,99,28260,31216,35561,0,4,-27,-3485,-5,-2840,-6279,-2,0,-2,0,9
EUN1_3574776556',5,34,10,2,0,0,0,8,1,373,72,27021,28199,28761,4,60,17,0,0,0,0,2,380,87,28366,30984,34323,0,-7,-15,-1345,-7,-2785,-5562,2,0,0,0,6
EUN1_3574755368',3,36,13,1,0,0,0,11,1,380,86,28966,30172,26101,4,28,8,1,0,1,0,3,375,88,25072,29016,27851,1,5,-2,3894,5,1156,-1750,0,0,-1,0,8
EUN1_3574719365',6,38,6,0,0,0,0,10,0,347,85,24763,29159,32516,6,30,14,1,0,1,0,3,331,94,26096,29678,33481,0,16,-9,-1333,-8,-519,-965,-1,0,-1,0,7
EUN1_3574707299',2,34,6,1,0,0,0,11,0,323,80,24330,27841,28043,5,34,17,1,0,1,0,2,366,89,31049,32040,34020,0,-43,-9,-6719,-11,-4199,-5977,0,0,-1,0,9
EUN1_3574537648',3,75,7,0,0,1,0,13,1,342,90,26574,27872,25851,5,42,21,1,1,1,0,5,367,52,30436,30229,41115,0,-25,38,-3862,-14,-2357,-15264,-1,-1,0,0,8
EUN1_3574498186',3,85,12,1,0,1,0,8,0,338,73,27841,27725,40072,1,25,16,0,0,0,0,4,363,100,29054,30177,33651,0,-25,-27,-1213,-4,-2452,6421,1,0,1,0,4
EUN1_3574452162',1,32,10,0,1,0,0,8,0,346,80,25536,27881,30393,1,27,17,2,0,1,0,1,376,76,29444,31587,33839,0,-30,4,-3908,-7,-3706,-3446,-2,1,-1,0,7
EUN1_3574318018',5,31,21,1,1,1,0,7,0,325,100,31064,31343,39318,2,316,15,1,0,0,0,2,328,67,28784,27824,37624,1,-3,33,2280,6,3519,1694,0,1,1,0,5
EUN1_3574302674',2,24,12,0,1,2,0,4,1,369,79,29724,29161,34003,4,25,19,2,0,0,0,5,295,89,28410,30643,37524,0,74,-10,1314,-7,-1482,-3521,-2,1,2,0,-1
EUN1_3574259214',3,21,14,1,0,0,0,8,1,332,68,26607,27894,34007,3,25,16,0,0,1,0,3,325,72,28099,29655,38802,1,7,-4,-1492,-2,-1761,-4795,1,0,-1,0,5
EUN1_3573192119',6,28,16,1,0,2,0,4,1,356,74,28455,30148,38437,5,35,8,1,0,0,0,4,329,109,24491,28588,36753,1,27,-35,3964,8,1560,1684,0,0,2,0,0
EUN1_3572061037',6,28,15,1,0,2,0,7,1,369,81,30154,30406,40997,4,26,14,1,0,0,0,5,320,78,25573,28732,37752,1,49,3,4581,1,1674,3245,0,0,2,0,2
EUN1_3570887487',3,26,19,0,0,1,0,11,0,349,79,29664,31508,34559,1,19,11,1,0,1,0,6,383,88,29509,31557,32771,1,-34,-9,155,8,-49,1788,-1,0,0,0,5
EUN1_3570780350',2,23,15,1,0,0,0,7,1,320,102,27621,29953,33589,6,29,11,1,0,1,0,1,354,82,26496,30286,27816,0,-34,20,1125,4,-333,5773,0,0,-1,0,6
EUN1_3570766265',7,57,11,0,0,0,0,16,1,307,59,24757,24173,30090,2,20,31,1,0,4,0,0,331,106,37452,29496,43265,0,-24,-47,-12695,-20,-5323,-13175,-1,0,-4,0,16
EUN1_3569571878',3,28,19,1,0,2,0,3,1,371,101,31227,31247,39450,0,17,8,0,0,0,0,8,317,74,23656,26757,29124,1,54,27,7571,11,4490,10326,1,0,2,0,-5
EUN1_3569181970',4,25,23,1,0,1,0,8,0,282,82,32511,29724,45241,5,26,21,1,0,0,0,3,268,78,29664,28466,42339,0,14,4,2847,2,1258,2902,0,0,1,0,5
EUN1_3568837242',4,30,15,2,0,2,0,5,1,410,112,30783,33389,30065,4,24,1,0,0,0,0,7,378,80,21323,27406,14771,1,32,32,9460,14,5983,15294,2,0,2,0,-2
EUN1_3568703420',2,26,14,1,0,0,0,9,0,340,82,28763,29761,38907,0,25,14,1,0,2,0,8,330,85,28611,28732,37755,1,10,-3,152,0,1029,1152,0,0,-2,0,1
EUN1_3576208464',6,31,18,1,0,1,0,12,0,294,66,28471,28776,33412,3,35,8,1,0,0,0,5,334,82,24810,28605,29098,1,-40,-16,3661,10,171,4314,0,0,1,0,7
EUN1_3576002569',1,29,18,0,0,1,0,7,1,421,96,31826,33234,35146,4,25,4,1,0,0,0,9,328,95,23017,26876,23766,1,93,1,8809,14,6358,11380,-1,0,1,0,-2
EUN1_3575955939',3,25,13,1,0,0,0,11,1,355,80,26655,28955,32778,4,23,14,1,0,0,0,0,379,80,27716,31273,32577,0,-24,0,-1061,-1,-2318,201,0,0,0,0,11
EUN1_3575717608',4,29,14,2,0,0,0,9,1,338,100,27756,29648,25566,6,32,10,0,0,1,0,4,361,84,27393,29247,28526,1,-23,16,363,4,401,-2960,2,0,-1,0,5
EUN1_3575691058',5,25,10,0,0,0,0,10,0,311,76,24125,27191,30799,4,24,20,2,0,1,0,0,364,91,30436,31942,37855,1,-53,-15,-6311,-10,-4751,-7056,-2,0,-1,0,10
EUN1_3574776644',7,34,6,1,0,0,0,11,0,334,84,24450,27842,25213,3,26,14,1,0,0,0,2,357,102,27675,31632,31299,1,-23,-18,-3225,-8,-3790,-6086,0,0,0,0,9
EUN1_3574624559',2,22,13,0,0,1,0,11,1,333,85,27654,30756,24821,4,22,11,2,1,2,0,4,343,108,28143,30105,27146,0,-10,-23,-489,2,651,-2325,-2,-1,-1,0,7
EUN1_3574615760',2,19,10,0,0,0,0,17,0,311,80,24665,28348,30464,2,25,23,2,1,4,0,2,355,128,34355,32702,39627,0,-44,-48,-9690,-13,-4354,-9163,-2,-1,-4,0,15
EUN1_3574087149',7,23,7,0,0,0,0,11,0,316,94,25635,26776,29431,4,96,14,2,0,2,0,4,333,74,27450,27826,31073,1,-17,20,-1815,-7,-1050,-1642,-2,0,-2,0,7
EUN1_3573727635',6,38,12,1,1,0,0,8,0,390,103,27535,30697,30147,6,32,8,0,0,0,0,3,348,84,25602,28998,28676,1,42,19,1933,4,1699,1471,1,1,0,0,5
EUN1_3573599469',3,21,4,0,0,0,0,13,0,318,98,23013,27273,21157,7,29,19,1,0,1,0,3,384,96,29933,30871,37206,0,-66,2,-6920,-15,-3598,-16049,-1,0,-1,0,10
EUN1_3573513766',3,22,6,1,0,0,0,10,1,374,80,24341,28040,26532,4,21,8,0,0,3,0,1,409,91,28375,30631,24921,1,-35,-11,-4034,-2,-2591,1611,1,0,-3,0,9
EUN1_3573155962',0,126,12,2,0,4,0,5,1,370,112,30733,32237,35614,4,22,5,0,0,1,0,7,401,88,25125,30940,19014,0,-31,24,5608,7,1297,16600,2,0,3,0,-2
EUN1_3573061706',3,20,9,0,0,0,0,13,0,322,84,25090,28888,23303,4,31,11,2,0,1,0,3,414,96,27806,30653,24391,1,-92,-12,-2716,-2,-1765,-1088,-2,0,-1,0,10
EUN1_3572975934',5,28,15,1,0,1,0,6,1,371,94,28873,30448,32208,9,45,8,0,0,0,0,5,328,70,24374,27253,28225,0,43,24,4499,7,3195,3983,1,0,1,0,1
EUN1_3572798673',3,24,12,0,0,0,0,8,0,369,74,26535,29484,32606,4,39,18,2,0,1,0,1,365,86,29548,30502,36617,0,4,-12,-3013,-6,-1018,-4011,-2,0,-1,0,7
EUN1_3572657103',4,33,12,2,0,0,0,11,0,357,85,26460,29580,23830,2,21,10,0,0,1,0,3,409,86,28071,31605,35059,0,-52,-1,-1611,2,-2025,-11229,2,0,-1,0,8
EUN1_3572624815',6,191,14,1,0,1,0,10,1,363,96,29232,32495,34375,3,25,7,1,0,1,0,10,329,90,24473,27801,28742,1,34,6,4759,7,4694,5633,0,0,0,0,0
EUN1_3572580290',7,30,11,1,0,0,0,11,1,340,74,26352,29876,30527,3,25,4,0,0,2,0,4,395,98,24553,29361,18843,1,-55,-24,1799,7,515,11684,1,0,-2,0,7
EUN1_3571371530',5,96,12,0,0,0,0,7,0,378,108,28289,30910,32868,1,26,10,2,0,0,0,4,369,72,26487,28596,32035,1,9,36,1802,2,2314,833,-2,0,0,0,3
EUN1_3571197402',3,24,18,2,0,1,0,9,1,347,90,28800,30625,30713,0,32,5,0,0,1,0,5,321,70,23021,26313,23526,1,26,20,5779,13,4312,7187,2,0,0,0,4
EUN1_3571177129',2,30,14,0,0,1,0,4,0,328,86,28244,28195,36614,6,25,14,2,0,1,0,9,327,84,27957,29974,31642,1,1,2,287,0,-1779,4972,-2,0,0,0,-5
EUN1_3568446348',2,20,15,1,0,2,0,5,1,372,108,30696,30854,40357,2,22,11,1,0,0,0,7,298,72,24130,28073,24076,1,74,36,6566,4,2781,16281,0,0,2,0,-2
EUN1_3568440746',7,34,9,0,0,0,0,10,0,366,80,25546,29257,29239,0,23,12,1,0,0,0,1,351,80,27095,28609,30201,0,15,0,-1549,-3,648,-962,-1,0,0,0,9
EUN1_3568431878',3,71,10,1,0,0,0,6,0,351,105,26273,31227,32610,5,167,12,1,0,0,0,3,353,76,26137,29545,28384,0,-2,29,136,-2,1682,4226,0,0,0,0,3
EUN1_3568425446',5,29,20,2,0,2,0,11,0,398,68,32523,32831,35689,3,26,17,0,0,1,0,4,347,89,29151,31340,36643,1,51,-21,3372,3,1491,-954,2,0,1,0,7
EUN1_3568115984',3,20,9,1,0,0,0,5,0,335,60,23819,27420,32299,8,35,5,0,0,0,0,3,349,103,24026,29386,32532,1,-14,-43,-207,4,-1966,-233,1,0,0,0,2
EUN1_3565682411',6,31,14,2,0,1,0,10,1,365,60,27574,28128,33218,3,25,12,0,0,0,0,3,352,88,28473,29106,34130,1,13,-28,-899,2,-978,-912,2,0,1,0,7
EUN1_3575723716',2,25,10,0,1,0,0,8,1,356,92,25444,30455,29089,5,24,7,2,0,1,0,2,344,100,25264,29471,25040,1,12,-8,180,3,984,4049,-2,1,-1,0,6
EUN1_3575553622',2,24,11,0,0,1,0,11,0,320,60,25705,26551,27632,2,23,17,1,0,1,0,2,302,71,29070,27436,34436,0,18,-11,-3365,-6,-885,-6804,-1,0,0,0,9
EUN1_3575505766',2,135,15,0,1,0,0,3,1,361,94,28801,30444,29322,2,28,10,2,0,0,0,2,311,90,24847,27115,23418,1,50,4,3954,5,3329,5904,-2,1,0,0,1
EUN1_3575483105',3,125,10,1,1,0,0,6,0,381,87,26098,29977,25243,6,31,8,1,0,0,0,2,382,107,26330,30651,22230,0,-1,-20,-232,2,-674,3013,0,1,0,0,4
EUN1_3575433729',3,32,13,1,0,0,0,10,1,337,110,29001,30812,36478,6,147,16,1,0,2,0,4,359,76,29791,29725,38081,0,-22,34,-790,-3,1087,-1603,0,0,-2,0,6
EUN1_3575413555',3,26,12,0,0,0,0,5,1,359,66,26559,28658,31800,2,33,13,2,0,1,0,3,364,105,28679,30367,32612,0,-5,-39,-2120,-1,-1709,-812,-2,0,-1,0,2
EUN1_3574505010',4,30,10,2,0,0,0,6,0,340,89,26157,28140,27826,4,29,11,0,0,1,0,1,333,67,24496,26603,21728,1,7,22,1661,-1,1537,6098,2,0,-1,0,5
EUN1_3574488122',3,30,18,0,0,0,0,3,0,370,78,29382,29441,38298,3,25,16,2,0,0,0,6,352,73,28361,28814,33612,1,18,5,1021,2,627,4686,-2,0,0,0,-3
EUN1_3574440600',4,137,17,1,0,2,0,9,0,388,88,30341,33467,34192,3,140,10,1,0,0,0,9,335,88,25677,28031,30762,0,53,0,4664,7,5436,3430,0,0,2,0,0
EUN1_3574418768',4,135,24,1,0,0,0,12,1,380,104,34232,33571,41257,0,25,6,0,0,3,0,8,273,78,23805,25865,25033,1,107,26,10427,18,7706,16224,1,0,-3,0,4
EUN1_3574396542',2,36,13,0,0,1,0,8,0,365,74,28500,31385,34265,3,133,18,2,0,1,0,3,375,69,29519,30481,35784,0,-10,5,-1019,-5,904,-1519,-2,0,0,0,5
EUN1_3574372407',4,26,12,1,0,2,0,9,0,322,86,27990,30123,30952,3,42,10,0,0,0,0,4,326,88,25562,28133,25724,1,-4,-2,2428,2,1990,5228,1,0,2,0,5
EUN1_3574331311',3,20,8,1,0,0,0,5,1,361,97,24497,28884,25494,2,31,7,1,0,1,0,3,374,84,25619,29957,20897,0,-13,13,-1122,1,-1073,4597,0,0,-1,0,2
EUN1_3574300717',3,17,20,2,0,2,0,9,1,399,96,32737,32807,46279,1,30,11,0,0,0,0,5,337,92,27896,28188,29476,1,62,4,4841,9,4619,16803,2,0,2,0,4
EUN1_3574257922',2,23,6,1,0,0,0,11,0,323,94,22831,26752,19129,2,22,12,1,0,2,0,0,418,98,30794,31921,29779,0,-95,-4,-7963,-6,-5169,-10650,0,0,-2,0,11
EUN1_3574204467',2,37,14,1,0,0,0,14,1,315,78,27712,27579,29431,6,31,18,1,0,3,0,1,385,84,32509,29154,39020,0,-70,-6,-4797,-4,-1575,-9589,0,0,-3,0,13
EUN1_3573825791',2,28,4,1,0,1,0,8,0,303,93,24473,26479,29780,2,92,11,0,0,1,0,3,346,80,27234,27953,31179,0,-43,13,-2761,-7,-1474,-1399,1,0,0,0,5
EUN1_3573348058',5,27,15,0,0,1,0,9,1,376,80,29521,30360,38429,3,46,14,2,0,1,0,4,313,84,27627,29748,32364,0,63,-4,1894,1,612,6065,-2,0,0,0,5
EUN1_3573285685',4,336,12,1,0,2,0,4,1,402,82,28991,30518,34376,3,48,6,1,0,0,0,4,357,79,24668,29231,24334,0,45,3,4323,6,1287,10042,0,0,2,0,0
EUN1_3573140295',1,40,13,0,0,0,0,6,0,404,68,28739,32034,33110,2,20,13,0,0,1,0,4,325,104,26976,30958,35043,0,79,-36,1763,0,1076,-1933,0,0,-1,0,2
EUN1_3573457511',2,61,11,1,0,1,0,1,1,356,72,27489,29386,30669,3,136,14,1,0,0,0,3,345,82,27106,29899,27546,1,11,-10,383,-3,-513,3123,0,0,1,0,-2
EUN1_3572603553',3,21,11,2,1,0,0,13,0,346,87,27265,30308,24632,4,45,10,0,0,3,0,2,359,84,28865,29927,31729,1,-13,3,-1600,1,381,-7097,2,1,-3,0,11
EUN1_3572590202',2,25,9,0,0,0,0,14,1,337,80,26682,29375,27894,7,37,13,2,0,1,0,4,371,88,27780,30283,29907,0,-34,-8,-1098,-4,-908,-2013,-2,0,-1,0,10
EUN1_3576145796',3,20,11,0,0,1,0,8,1,354,106,27273,31280,26293,6,23,9,1,0,0,0,4,366,80,25428,28599,23767,1,-12,26,1845,2,2681,2526,-1,0,1,0,4
EUN1_3576038355',5,24,17,1,1,1,0,12,0,361,86,30783,29641,34462,3,29,15,1,0,0,0,4,361,89,28877,29706,31648,1,0,-3,1906,2,-65,2814,0,1,1,0,8
EUN1_3575840241',4,52,19,0,0,1,0,6,0,341,116,30514,33865,33533,7,35,4,2,1,1,0,5,349,88,22601,26540,25060,1,-8,28,7913,15,7325,8473,-2,-1,0,0,1
EUN1_3575822097',2,199,8,0,0,0,0,10,0,332,75,24505,27298,27605,9,30,20,2,1,1,0,1,382,120,31988,33091,38771,0,-50,-45,-7483,-12,-5793,-11166,-2,-1,-1,0,9
EUN1_3575804091',0,27,13,1,0,0,0,5,0,315,106,27660,29918,29875,1,23,9,1,0,1,0,5,314,77,23882,26747,32526,1,1,29,3778,4,3171,-2651,0,0,-1,0,0
EUN1_3575779667',4,30,14,1,0,0,0,12,0,378,76,28506,30954,31036,4,22,16,1,0,2,0,6,356,77,29824,30895,31819,1,22,-1,-1318,-2,59,-783,0,0,-2,0,6
EUN1_3575117377',1,19,12,1,0,0,0,12,1,310,76,25468,27921,32506,3,27,23,1,0,4,0,2,371,108,35528,33570,44911,0,-61,-32,-10060,-11,-5649,-12405,0,0,-4,0,10
EUN1_3575103828',3,29,16,1,0,0,0,5,1,322,81,26982,29719,33336,4,27,10,0,1,0,0,2,327,75,24410,28050,30431,1,-5,6,2572,6,1669,2905,1,-1,0,0,3
EUN1_3573683731',1,20,7,0,0,0,0,9,0,320,94,24322,28608,17813,7,152,14,2,0,1,0,5,371,104,29291,32439,42515,0,-51,-10,-4969,-7,-3831,-24702,-2,0,-1,0,4
EUN1_3573661811',8,36,15,1,1,0,0,5,1,403,75,29512,32100,37765,5,28,7,0,0,0,0,4,342,74,23629,27109,27329,1,61,1,5883,8,4991,10436,1,1,0,0,1
EUN1_3573646654',4,20,21,1,0,2,0,3,0,367,98,32569,33009,36042,2,50,9,0,0,0,0,9,324,78,24454,27002,26591,1,43,20,8115,12,6007,9451,1,0,2,0,-6
EUN1_3573484560',3,25,19,0,0,1,0,6,0,312,82,29449,29647,34452,3,26,12,2,0,0,0,3,342,90,27292,29912,30969,0,-30,-8,2157,7,-265,3483,-2,0,1,0,3
EUN1_3573467936',5,30,14,0,1,0,0,9,1,375,91,27803,31714,30686,6,23,12,2,0,0,0,3,343,96,26806,29117,25181,1,32,-5,997,2,2597,5505,-2,1,0,0,6
EUN1_3573196104',5,24,7,0,0,1,0,9,1,389,79,25996,29325,22358,4,29,7,2,0,0,0,2,388,89,25113,28474,22184,1,1,-10,883,0,851,174,-2,0,1,0,7
EUN1_3573168903',5,26,14,0,0,0,0,14,1,265,60,24415,27761,34708,3,25,18,2,1,2,0,3,379,116,33012,32679,40638,0,-114,-56,-8597,-4,-4918,-5930,-2,-1,-2,0,11
EUN1_3575619129',1,21,14,1,0,0,0,15,0,336,91,27032,30229,35010,2,24,10,1,0,2,0,3,368,84,28542,29997,34952,0,-32,7,-1510,4,232,58,0,0,-2,0,12
EUN1_3575600386',4,233,22,2,0,2,0,5,1,378,80,33245,32636,39676,4,29,5,0,0,1,0,8,305,91,22550,25916,23995,1,73,-11,10695,17,6720,15681,2,0,1,0,-3
EUN1_3575553921',3,28,21,2,0,2,0,7,1,351,82,32248,30035,38541,1,23,5,0,0,1,0,11,294,80,21850,25067,33554,1,57,2,10398,16,4968,4987,2,0,1,0,-4
EUN1_3575398702',3,21,10,0,0,1,0,8,1,373,102,26122,29905,24759,3,24,6,1,0,1,0,5,370,75,25106,28333,28015,0,3,27,1016,4,1572,-3256,-1,0,0,0,3
EUN1_3575262129',3,57,19,2,0,0,0,10,1,318,92,29815,29465,39565,5,24,20,0,0,1,0,2,325,84,30505,28906,37666,0,-7,8,-690,-1,559,1899,2,0,-1,0,8
EUN1_3575244282',2,20,4,0,0,0,0,12,0,334,92,22701,25749,26053,1,26,24,1,1,4,0,2,355,96,33803,32454,44008,0,-21,-4,-11102,-20,-6705,-17955,-1,-1,-4,0,10
EUN1_3575060429',5,31,21,0,0,4,0,4,0,390,100,34009,32787,40291,2,22,8,1,0,0,0,11,318,75,23944,26640,28592,1,72,25,10065,13,6147,11699,-1,0,4,0,-7
EUN1_3574898991',7,37,18,1,0,0,0,4,1,367,82,30099,31278,36458,3,32,12,1,0,0,0,5,341,82,27191,30725,34363,0,26,0,2908,6,553,2095,0,0,0,0,-1
EUN1_3574326754',7,34,25,2,0,2,0,17,1,354,82,33001,29959,40861,4,28,12,0,0,1,0,4,330,82,27302,27087,29101,1,24,0,5699,13,2872,11760,2,0,1,0,13
EUN1_3574233783',2,23,6,0,0,0,0,13,0,299,70,23158,25651,31489,2,29,19,1,0,3,0,0,392,84,31873,32303,41370,0,-93,-14,-8715,-13,-6652,-9881,-1,0,-3,0,13
EUN1_3573939958',2,27,7,0,0,0,0,12,1,401,91,26477,29888,32121,3,29,17,2,0,1,0,2,326,80,29380,30329,33743,1,75,11,-2903,-10,-441,-1622,-2,0,-1,0,10
EUN1_3573902569',4,46,8,2,1,0,0,4,1,371,96,25416,28528,25937,4,28,8,0,0,0,0,2,336,96,24908,29299,24678,0,35,0,508,0,-771,1259,2,1,0,0,2
EUN1_3573854312',2,25,16,0,0,1,0,7,1,285,66,29210,27375,36496,5,32,16,2,0,1,0,3,335,82,28155,27603,42467,1,-50,-16,1055,0,-228,-5971,-2,0,0,0,4
EUN1_3573805379',2,33,9,0,0,2,0,7,1,382,87,27898,29297,33837,2,25,15,2,0,0,0,3,351,106,28336,32742,28242,0,31,-19,-438,-6,-3445,5595,-2,0,2,0,4
EUN1_3575245023',3,26,9,1,0,1,0,8,1,345,98,25610,28951,30435,6,36,14,1,0,0,0,0,356,90,27384,31334,32010,1,-11,8,-1774,-5,-2383,-1575,0,0,1,0,8
EUN1_3574242521',7,31,17,1,0,1,0,8,1,327,98,29489,30633,30939,1,52,10,0,1,0,0,3,305,101,26329,28272,28928,1,22,-3,3160,7,2361,2011,1,-1,1,0,5
EUN1_3574216649',6,27,8,1,1,2,0,11,1,368,116,27854,30414,28324,4,28,12,1,0,1,0,4,363,96,27497,29536,27250,0,5,20,357,-4,878,1074,0,1,1,0,7
EUN1_3574199492',8,35,14,1,0,1,0,8,1,376,111,29305,29942,30609,5,27,10,0,0,0,0,4,312,51,25292,26429,28901,1,64,60,4013,4,3513,1708,1,0,1,0,4
EUN1_3573539415',5,32,9,1,0,0,0,7,0,318,84,24845,27715,27238,4,30,16,1,0,1,0,4,324,91,28822,30287,35370,0,-6,-7,-3977,-7,-2572,-8132,0,0,-1,0,3
EUN1_3572122345',5,28,9,1,0,0,0,6,0,332,87,24948,27322,38163,6,29,16,0,0,0,0,2,333,98,27654,30931,31442,1,-1,-11,-2706,-7,-3609,6721,1,0,0,0,4
EUN1_3572072737',3,26,9,0,0,0,0,9,1,381,113,28062,30524,28981,4,25,15,2,0,0,0,7,333,82,27200,29310,32974,0,48,31,862,-6,1214,-3993,-2,0,0,0,2
EUN1_3571418120',1,25,12,2,0,0,0,5,0,349,90,27254,29819,29681,4,24,10,0,0,0,0,8,361,93,25909,28817,26612,0,-12,-3,1345,2,1002,3069,2,0,0,0,-3
EUN1_3571392838',5,25,14,0,1,1,0,12,0,339,72,29064,30558,37992,6,140,20,2,0,0,0,4,376,103,29931,31687,38563,0,-37,-31,-867,-6,-1129,-571,-2,1,1,0,8
EUN1_3571245624',2,25,7,0,0,0,0,12,0,340,64,24192,27457,21200,3,25,10,1,1,0,0,1,387,116,27690,31326,35706,0,-47,-52,-3498,-3,-3869,-14506,-1,-1,0,0,11
EUN1_3571283744',1,25,19,0,0,1,0,15,0,294,67,31092,29119,38001,2,20,10,0,0,1,0,8,345,88,27211,27943,34660,1,-51,-21,3881,9,1176,3341,0,0,0,0,7
EUN1_3571063840',2,24,15,1,0,0,0,12,0,304,100,27323,29070,30405,7,34,16,1,0,1,0,1,353,87,28543,28635,35944,1,-49,13,-1220,-1,435,-5539,0,0,-1,0,11
EUN1_3570994527',3,19,9,0,0,1,0,7,1,371,67,26377,29667,29032,3,40,13,2,0,0,0,5,301,116,25785,29248,36180,1,70,-49,592,-4,419,-7148,-2,0,1,0,2
EUN1_3570833623',3,23,24,2,0,1,0,5,1,339,88,32417,30117,44111,3,25,17,0,0,0,0,6,294,72,28245,28149,35906,1,45,16,4172,7,1968,8205,2,0,1,0,-1
EUN1_3575397163',3,70,8,0,0,0,0,10,0,345,80,25857,27524,32634,4,20,19,1,1,3,0,2,381,90,32422,31459,34580,0,-36,-10,-6565,-11,-3935,-1946,-1,-1,-3,0,8
EUN1_3575368833',2,24,7,0,0,0,0,9,1,357,82,23990,27928,27682,10,35,15,1,0,2,0,0,392,95,29760,33109,41936,0,-35,-13,-5770,-8,-5181,-14254,-1,0,-2,0,9
EUN1_3574862435',2,20,17,1,0,1,0,6,1,386,92,29442,31428,38169,2,25,7,0,0,0,0,5,290,84,23765,27297,28948,1,96,8,5677,10,4131,9221,1,0,1,0,1
EUN1_3574836566',1,24,13,1,0,0,0,1,1,375,87,29012,31075,35104,9,102,6,1,0,0,0,4,342,100,23391,27456,23540,1,33,-13,5621,7,3619,11564,0,0,0,0,-3
EUN1_3568746601',4,28,14,0,0,1,0,8,1,327,74,28649,29060,31430,6,95,15,1,0,1,0,5,311,85,27484,27972,30360,1,16,-11,1165,-1,1088,1070,-1,0,0,0,3
EUN1_3568714687',4,18,9,1,0,0,0,5,1,298,84,24268,25167,34864,6,95,15,0,0,0,0,2,318,76,25170,27458,33450,0,-20,8,-902,-6,-2291,1414,1,0,0,0,3
EUN1_3568678422',1,26,12,1,0,0,0,12,1,334,92,26023,28367,37488,4,26,19,1,0,2,0,4,363,110,31084,32302,37405,0,-29,-18,-5061,-7,-3935,83,0,0,-2,0,8
EUN1_3568581314',5,33,15,1,0,1,0,3,1,349,98,29230,27838,42038,5,30,18,1,0,0,0,5,338,70,27801,28420,33384,1,11,28,1429,-3,-582,8654,0,0,1,0,-2
EUN1_3568558170',0,27,8,1,1,1,0,9,1,324,94,24758,26766,21764,6,27,14,1,0,0,0,1,335,92,26816,29901,28302,0,-11,2,-2058,-6,-3135,-6538,0,1,1,0,8
EUN1_3568532844',2,29,15,0,0,0,0,9,1,265,71,25960,25109,35630,5,29,15,1,0,1,0,5,334,63,26768,27300,30253,1,-69,8,-808,0,-2191,5377,-1,0,-1,0,4
EUN1_3568448049',6,23,14,1,0,1,0,15,0,342,68,28778,29678,28442,2,21,15,0,0,2,0,0,367,120,30923,30396,38473,0,-25,-52,-2145,-1,-718,-10031,1,0,-1,0,15
EUN1_3568435379',2,22,6,0,0,1,0,11,1,352,93,25202,29310,20779,5,27,13,2,0,1,0,4,395,106,29041,31591,27094,0,-43,-13,-3839,-7,-2281,-6315,-2,0,0,0,7
EUN1_3576142249',3,21,10,1,0,1,0,8,0,328,74,26517,29419,25502,7,32,14,0,0,0,0,7,331,94,27213,31105,31549,0,-3,-20,-696,-4,-1686,-6047,1,0,1,0,1
EUN1_3576080622',6,25,11,1,0,0,0,10,1,302,90,26180,26535,34146,2,28,19,1,0,2,0,2,359,89,31815,30090,37150,0,-57,1,-5635,-8,-3555,-3004,0,0,-2,0,8
EUN1_3576059763',3,33,15,1,1,1,0,7,0,357,87,30827,29696,34571,4,26,21,1,0,2,0,10,344,80,30220,30741,37903,1,13,7,607,-6,-1045,-3332,0,1,-1,0,-3
EUN1_3575889406',2,22,21,0,0,1,0,9,0,373,94,31674,32711,42744,3,64,12,1,0,0,0,4,347,66,26459,29214,34149,1,26,28,5215,9,3497,8595,-1,0,1,0,5
EUN1_3575872600',1,28,4,0,0,0,0,11,0,340,104,23087,27770,26876,2,24,13,1,0,1,0,2,411,91,28721,31511,29131,0,-71,13,-5634,-9,-3741,-2255,-1,0,-1,0,9
EUN1_3575818495',6,25,26,1,0,3,0,9,1,354,72,32806,33392,37876,3,26,9,0,0,1,0,7,333,87,25660,27466,32553,1,21,-15,7146,17,5926,5323,1,0,2,0,2
EUN1_3575779235',5,29,25,1,1,2,0,16,0,303,76,33008,28594,44325,5,384,20,1,0,1,0,2,331,62,31208,27048,40815,0,-28,14,1800,5,1546,3510,0,1,1,0,14
EUN1_3575277954',4,30,13,1,1,2,0,12,1,362,114,29617,30406,30646,1,24,5,1,0,1,0,3,397,72,25223,27948,24209,1,-35,42,4394,8,2458,6437,0,1,1,0,9
EUN1_3575214740',4,34,10,1,0,1,0,6,1,355,90,27054,28379,32797,3,94,8,1,0,1,0,3,383,82,26363,31179,21652,1,-28,8,691,2,-2800,11145,0,0,0,0,3
EUN1_3575198652',3,26,11,1,0,0,0,6,1,382,67,26161,28922,32175,7,29,10,1,0,0,0,1,340,116,26251,29064,33728,1,42,-49,-90,1,-142,-1553,0,0,0,0,5
EUN1_3575064976',4,29,20,1,0,1,0,11,0,306,102,28492,29031,40975,3,25,12,0,0,2,0,6,324,89,28436,28284,34111,0,-18,13,56,8,747,6864,1,0,-1,0,5
EUN1_3575046121',3,23,25,2,0,2,0,10,1,345,68,34085,30922,41941,3,31,15,0,0,0,0,8,329,93,28252,29304,34136,0,16,-25,5833,10,1618,7805,2,0,2,0,2
EUN1_3575012648',6,39,9,1,0,1,0,8,0,375,90,27425,28517,27861,2,20,15,0,0,2,0,5,383,90,30789,31183,29983,0,-8,0,-3364,-6,-2666,-2122,1,0,-1,0,3
EUN1_3574995117',5,30,7,2,0,0,0,8,0,335,68,23789,28682,24740,6,30,12,0,0,0,0,2,336,91,26403,27684,29878,1,-1,-23,-2614,-5,998,-5138,2,0,0,0,6
EUN1_3574961882',4,228,19,2,0,1,0,13,0,314,60,28909,26567,47098,3,22,17,0,0,3,0,4,358,94,32428,29315,39126,0,-44,-34,-3519,2,-2748,7972,2,0,-2,0,9
EUN1_3574932044',1,24,6,2,0,0,0,6,0,377,102,25225,30062,23305,3,25,11,0,1,2,0,4,378,78,27905,31263,29390,0,-1,24,-2680,-5,-1201,-6085,2,-1,-2,0,2
EUN1_3574895676',3,26,12,0,0,0,0,16,0,310,78,28330,28459,38448,3,24,26,2,0,4,0,6,375,78,35361,32574,48286,0,-65,0,-7031,-14,-4115,-9838,-2,0,-4,0,10
EUN1_3574883084',7,64,15,1,0,2,0,10,0,333,99,29213,29262,32559,2,29,10,1,0,0,0,10,328,84,25288,26160,27821,1,5,15,3925,5,3102,4738,0,0,2,0,0
EUN1_3574857418',2,26,12,0,1,1,0,10,0,327,70,27607,29554,40664,1,18,16,2,0,1,0,6,352,112,29805,30718,35462,0,-25,-42,-2198,-4,-1164,5202,-2,1,0,0,4
EUN1_3574834788',4,25,11,0,0,0,0,11,1,241,72,23673,22997,25371,6,35,24,2,0,2,0,2,357,88,33954,30928,39473,0,-116,-16,-10281,-13,-7931,-14102,-2,0,-2,0,9
EUN1_3574869333',3,26,19,1,0,2,0,3,1,403,128,34148,34902,27138,7,45,4,0,0,1,0,11,376,69,22146,26896,21457,1,27,59,12002,15,8006,5681,1,0,1,0,-8
EUN1_3574535968',6,26,18,1,0,0,0,7,1,293,88,27500,29439,29391,3,23,16,0,0,1,0,1,379,87,30876,32093,35126,1,-86,1,-3376,2,-2654,-5735,1,0,-1,0,6
EUN1_3574521971',4,73,16,1,0,1,0,13,1,273,71,28002,25698,34792,1,29,20,1,1,2,0,4,319,108,32532,30802,36530,0,-46,-37,-4530,-4,-5104,-1738,0,-1,-1,0,9
EUN1_3573427525',5,31,8,1,0,0,0,5,1,390,86,25396,29480,27840,0,27,10,0,0,0,0,2,364,86,26262,31366,33819,1,26,0,-866,-2,-1886,-5979,1,0,0,0,3
EUN1_3573119969',4,30,17,0,0,1,0,8,0,349,103,30119,30913,33394,5,28,11,2,0,0,0,6,335,91,26697,27518,32379,1,14,12,3422,6,3395,1015,-2,0,1,0,2
EUN1_3573093363',2,29,5,1,0,0,0,7,0,328,82,22600,26457,27255,4,23,17,1,0,1,0,1,346,106,28547,32369,34751,0,-18,-24,-5947,-12,-5912,-7496,0,0,-1,0,6
EUN1_3572892024',5,83,8,1,0,0,0,3,0,307,68,23019,27248,27022,4,30,12,1,1,0,0,0,327,92,25974,30605,33402,0,-20,-24,-2955,-4,-3357,-6380,0,-1,0,0,3
EUN1_3570738225',1,18,11,1,0,0,0,6,0,314,104,26544,28407,34404,4,33,14,1,1,0,0,1,372,68,27771,28388,33229,1,-58,36,-1227,-3,19,1175,0,-1,0,0,5
EUN1_3570713621',3,34,15,2,0,1,0,7,1,414,100,30367,31786,35177,6,34,7,0,0,0,0,7,314,88,24328,26557,25214,1,100,12,6039,8,5229,9963,2,0,1,0,0
EUN1_3570061542',3,148,10,0,0,0,0,13,1,296,91,26164,28331,34289,3,24,20,2,0,2,0,4,375,102,31239,32731,37683,0,-79,-11,-5075,-10,-4400,-3394,-2,0,-2,0,9
EUN1_3569443013',4,26,8,1,1,1,0,6,1,345,98,27242,28782,32982,5,24,12,0,0,0,0,6,317,87,25728,30641,29232,1,28,11,1514,-4,-1859,3750,1,1,1,0,0
EUN1_3569296058',2,13,8,0,0,0,0,11,1,368,103,25636,30009,25512,3,19,9,2,0,1,0,4,379,108,27182,30052,27829,1,-11,-5,-1546,-1,-43,-2317,-2,0,-1,0,7
EUN1_3569272663',2,24,12,0,0,0,0,12,0,333,78,26121,28481,27974,1,15,16,1,0,2,0,0,403,121,32241,33124,32779,0,-70,-43,-6120,-4,-4643,-4805,-1,0,-2,0,12
EUN1_3569250794',0,45,28,1,0,4,0,4,1,342,84,37689,30184,45777,4,31,12,1,0,0,0,11,240,72,24133,22279,37915,1,102,12,13556,16,7905,7862,0,0,4,0,-7
EUN1_3569227404',2,18,5,0,0,0,0,9,1,361,66,23116,26659,21592,4,27,11,1,1,0,0,2,380,110,27282,30638,29473,0,-19,-44,-4166,-6,-3979,-7881,-1,-1,0,0,7
EUN1_3569004144',3,60,13,1,0,0,0,11,0,330,80,27629,30908,33408,1,60,13,0,0,0,0,2,362,96,28037,29803,37199,0,-32,-16,-408,0,1105,-3791,1,0,0,0,9
EUN1_3568975055',3,25,16,1,0,1,0,10,0,339,78,29377,29804,32699,2,26,11,1,0,0,0,2,307,86,24854,24691,30168,0,32,-8,4523,5,5113,2531,0,0,1,0,8
EUN1_3575834728',0,31,4,0,0,0,0,14,0,309,72,21656,23699,18231,4,25,10,2,0,4,0,0,379,120,30767,29921,16606,0,-70,-48,-9111,-6,-6222,1625,-2,0,-4,0,14
EUN1_3575820302',1,19,10,0,0,0,0,7,0,352,74,26218,28533,31466,4,21,16,2,0,0,0,1,308,89,26674,29795,37503,1,44,-15,-456,-6,-1262,-6037,-2,0,0,0,6
EUN1_3575801401',0,23,23,1,0,0,0,6,1,367,108,32559,33409,39220,4,21,12,1,0,2,0,9,360,83,28426,29570,29699,1,7,25,4133,11,3839,9521,0,0,-2,0,-3
EUN1_3575784660',2,54,15,1,0,2,0,6,1,338,102,28330,30170,36804,2,37,8,1,0,0,0,3,355,72,24140,26036,28386,1,-17,30,4190,7,4134,8418,0,0,2,0,3
EUN1_3575390628',6,25,18,0,0,0,0,8,0,348,71,29765,29649,37315,4,16,18,1,0,2,0,0,374,84,31505,30118,38509,0,-26,-13,-1740,0,-469,-1194,-1,0,-2,0,8
EUN1_3575249124',6,26,9,2,0,0,0,10,0,284,86,23883,24581,25847,1,15,19,0,0,3,0,1,371,94,33222,32196,31482,0,-87,-8,-9339,-10,-7615,-5635,2,0,-3,0,9
EUN1_3575231149',5,74,12,1,0,0,0,5,0,374,112,27252,31211,33486,5,26,13,0,0,0,0,6,366,83,28199,32797,32006,0,8,29,-947,-1,-1586,1480,1,0,0,0,-1
EUN1_3575202632',7,41,12,1,0,0,0,4,1,328,96,27040,28856,36371,7,55,11,0,1,0,0,3,331,62,25899,27912,28343,0,-3,34,1141,1,944,8028,1,-1,0,0,1
EUN1_3574401488',2,24,16,1,0,0,0,13,0,345,82,29161,29313,38107,5,32,14,1,0,2,0,3,366,94,29665,29773,33960,0,-21,-12,-504,2,-460,4147,0,0,-2,0,10
EUN1_3574380228',3,29,11,1,0,0,0,3,0,374,102,26598,30817,36533,2,26,13,1,0,0,0,1,364,85,26833,31507,33552,0,10,17,-235,-2,-690,2981,0,0,0,0,2
EUN1_3573717314',4,31,13,0,0,1,0,6,1,377,96,28964,30711,28910,0,26,16,2,0,2,0,3,281,92,27820,27582,31576,1,96,4,1144,-3,3129,-2666,-2,0,-1,0,3
EUN1_3573622162',1,37,13,0,1,0,0,11,0,329,86,27757,27850,27290,3,45,13,1,0,2,0,4,342,74,28990,27585,26862,0,-13,12,-1233,0,265,428,-1,1,-2,0,7
EUN1_3573286272',3,29,20,1,0,0,0,9,1,296,67,30402,27929,31179,3,30,17,1,0,0,0,3,320,74,27834,26841,43214,1,-24,-7,2568,3,1088,-12035,0,0,0,0,6
EUN1_3573119485',5,25,16,2,1,1,0,7,1,372,112,29866,31973,33771,5,42,7,0,0,0,0,8,363,88,24860,29504,26875,1,9,24,5006,9,2469,6896,2,1,1,0,-1
EUN1_3573099379',4,23,11,0,0,0,0,10,0,276,72,25356,25963,24171,3,26,22,1,0,2,0,2,338,88,32567,30821,39137,1,-62,-16,-7211,-11,-4858,-14966,-1,0,-2,0,8
EUN1_3572585775',3,25,11,0,0,0,0,10,0,326,76,25401,28623,34125,4,25,10,2,0,1,0,4,354,88,27767,29923,36210,0,-28,-12,-2366,1,-1300,-2085,-2,0,-1,0,6
EUN1_3572565907',1,27,13,0,0,0,0,13,0,332,64,26847,26615,34098,4,30,21,1,1,1,0,1,365,91,32301,30849,39173,0,-33,-27,-5454,-8,-4234,-5075,-1,-1,-1,0,12
EUN1_3572558678',1,21,14,0,1,0,0,6,0,330,94,27533,30731,33787,3,93,11,1,0,1,0,6,372,65,27069,30027,28011,1,-42,29,464,3,704,5776,-1,1,-1,0,0
EUN1_3576118965',4,31,13,0,0,0,0,15,0,359,72,29157,29243,30249,1,88,15,2,0,4,0,5,344,108,30157,31594,37974,0,15,-36,-1000,-2,-2351,-7725,-2,0,-4,0,10
EUN1_3575858418',2,24,8,1,0,1,0,8,1,336,79,25704,28084,29579,6,41,14,1,0,1,0,4,298,92,26913,28143,33201,1,38,-13,-1209,-6,-59,-3622,0,0,0,0,4
EUN1_3575087328',9,34,14,1,0,0,0,6,1,376,68,27157,29861,28214,8,50,10,1,0,0,0,0,370,80,26457,29307,24438,1,6,-12,700,4,554,3776,0,0,0,0,6
EUN1_3575044243',0,26,13,0,0,0,0,9,1,322,70,26301,28523,26964,6,40,11,1,0,0,0,2,391,76,27413,30280,39335,0,-69,-6,-1112,2,-1757,-12371,-1,0,0,0,7
EUN1_3574719354',4,25,9,0,0,0,0,7,0,311,88,25444,28007,25905,2,146,17,1,0,1,0,4,349,84,28296,29197,34113,1,-38,4,-2852,-8,-1190,-8208,-1,0,-1,0,3
EUN1_3574520536',4,35,14,0,0,1,0,1,0,364,97,28915,29602,31536,8,25,12,2,0,0,0,5,373,98,27854,29908,25343,0,-9,-1,1061,2,-306,6193,-2,0,1,0,-4
EUN1_3574474908',6,28,12,0,0,0,0,10,0,351,80,26177,29845,32018,6,38,17,1,1,3,0,0,360,77,30918,29692,35804,0,-9,3,-4741,-5,153,-3786,-1,-1,-3,0,10
EUN1_3573984911',5,26,10,1,0,1,0,11,0,409,60,27776,31102,33317,7,61,17,1,0,1,0,5,344,92,29185,31385,27442,1,65,-32,-1409,-7,-283,5875,0,0,0,0,6
EUN1_3573961825',4,24,17,2,0,1,0,7,1,346,112,30189,32241,39990,3,22,6,0,0,0,0,5,319,88,23314,26705,31197,1,27,24,6875,11,5536,8793,2,0,1,0,2
EUN1_3573944429',3,23,9,1,0,0,0,4,0,343,92,24681,29083,30501,9,27,13,1,1,0,0,0,402,88,26999,32449,28063,1,-59,4,-2318,-4,-3366,2438,0,-1,0,0,4
EUN1_3573920172',5,28,16,0,0,0,0,9,0,374,100,30995,31034,32882,1,27,14,2,0,2,0,5,285,84,25801,27216,29294,1,89,16,5194,2,3818,3588,-2,0,-2,0,4
EUN1_3573892728',2,27,9,0,0,1,0,5,0,311,84,25961,27720,32102,4,24,20,1,0,0,0,4,339,96,29238,30925,39774,0,-28,-12,-3277,-11,-3205,-7672,-1,0,1,0,1
EUN1_3572482010',6,71,1,0,0,0,0,9,0,337,104,21327,29611,22708,0,23,4,2,1,2,0,1,426,116,26819,32158,22858,0,-89,-12,-5492,-3,-2547,-150,-2,-1,-2,0,8
EUN1_3572248648',6,140,21,0,0,1,0,14,0,338,68,31238,31970,40087,7,28,13,2,0,1,0,2,371,105,30791,31745,34797,1,-33,-37,447,8,225,5290,-2,0,0,0,12
EUN1_3572108432',4,97,12,0,0,0,0,10,0,350,65,25651,29279,28335,9,35,10,1,0,1,0,1,352,90,26852,28657,31281,0,-2,-25,-1201,2,622,-2946,-1,0,-1,0,9
EUN1_3571999102',6,31,13,1,1,2,0,4,1,378,101,30373,31765,33547,3,20,4,1,0,0,0,8,338,103,22689,27345,18159,1,40,-2,7684,9,4420,15388,0,1,2,0,-4
EUN1_3571973841',6,33,10,1,0,0,0,9,0,351,95,26205,28403,26025,2,41,10,1,1,1,0,2,382,91,28160,30067,29516,0,-31,4,-1955,0,-1664,-3491,0,-1,-1,0,7
EUN1_3571946215',3,18,9,2,0,0,0,13,0,298,68,25245,25679,33179,1,17,23,0,1,3,0,3,402,92,32800,33659,37141,0,-104,-24,-7555,-14,-7980,-3962,2,-1,-3,0,10
EUN1_3571934135',1,23,16,0,0,0,0,14,1,324,84,28001,29729,31636,4,223,19,1,0,3,0,1,348,88,30955,30098,40243,0,-24,-4,-2954,-3,-369,-8607,-1,0,-3,0,13
EUN1_3571725252',1,20,12,1,0,0,0,8,1,353,96,27044,29045,31176,4,98,18,0,0,0,0,2,334,96,28746,30830,32876,1,19,0,-1702,-6,-1785,-1700,1,0,0,0,6
EUN1_3571604733',3,26,12,0,0,0,0,11,0,360,67,27777,30289,32793,5,23,20,2,0,3,0,3,369,100,32062,32618,37148,0,-9,-33,-4285,-8,-2329,-4355,-2,0,-3,0,8
EUN1_3571563572',1,283,2,0,0,0,0,16,0,369,84,22072,27764,25241,2,28,21,2,0,4,0,1,385,88,34003,33725,34435,0,-16,-4,-11931,-19,-5961,-9194,-2,0,-4,0,15
EUN1_3571480509',5,26,9,1,1,0,0,7,1,372,124,26925,30772,27953,2,25,5,1,0,0,0,6,350,84,23609,28722,21978,1,22,40,3316,4,2050,5975,0,1,0,0,1
EUN1_3571459200',4,64,14,1,0,1,0,4,1,416,92,30521,31191,25360,5,32,13,1,0,0,0,6,395,92,28338,30803,30732,1,21,0,2183,1,388,-5372,0,0,1,0,-2
EUN1_3570021858',3,192,10,1,0,2,0,6,1,415,91,28880,31844,32250,6,28,6,1,0,1,0,8,359,100,24546,30286,20783,0,56,-9,4334,4,1558,11467,0,0,1,0,-2
EUN1_3570004454',1,42,9,1,0,1,0,4,0,410,104,27431,30564,29389,5,31,8,1,0,0,0,3,350,84,24664,28930,26771,1,60,20,2767,1,1634,2618,0,0,1,0,1
EUN1_3569544571',2,32,21,2,0,1,0,7,0,310,70,30358,30385,38231,4,38,14,0,0,1,0,2,311,78,28003,28949,40019,1,-1,-8,2355,7,1436,-1788,2,0,0,0,5
EUN1_3568445353',3,21,22,1,0,2,0,5,1,372,100,32255,32630,37898,3,45,8,1,0,0,0,7,276,79,23179,25271,25438,1,96,21,9076,14,7359,12460,0,0,2,0,-2
EUN1_3568423885',3,25,11,1,0,0,0,11,1,366,96,27289,29871,27071,7,27,11,1,0,1,0,4,373,101,28342,29502,30317,1,-7,-5,-1053,0,369,-3246,0,0,-1,0,7
EUN1_3568322219',5,23,4,0,0,0,0,12,0,358,96,24151,28777,27038,2,21,19,2,0,2,0,4,363,83,30868,30935,30841,0,-5,13,-6717,-15,-2158,-3803,-2,0,-2,0,8
EUN1_3568288682',4,26,14,1,0,0,0,6,1,349,98,27135,30054,32974,5,55,11,1,0,1,0,1,312,86,25984,28208,32667,1,37,12,1151,3,1846,307,0,0,-1,0,5
EUN1_3576236123',2,27,6,0,0,0,0,6,0,384,84,24769,29771,24463,3,43,10,1,0,2,0,0,382,85,27036,30006,24411,0,2,-1,-2267,-4,-235,52,-1,0,-2,0,6
EUN1_3576163165',5,24,13,1,1,2,0,8,1,345,100,28366,29123,29092,5,28,11,1,0,1,0,5,306,100,26968,28117,25595,1,39,0,1398,2,1006,3497,0,1,1,0,3
EUN1_3576153393',9,309,20,0,0,2,0,12,1,337,84,32637,30030,35998,3,28,12,1,0,1,0,7,336,75,28316,27142,35917,1,1,9,4321,8,2888,81,-1,0,1,0,5
EUN1_3575926196',4,25,7,1,0,1,0,3,1,384,84,25543,27476,28944,5,31,12,1,0,0,0,5,332,76,25845,29943,30304,1,52,8,-302,-5,-2467,-1360,0,0,1,0,-2
EUN1_3575902791',3,23,18,2,0,1,0,7,0,401,96,31877,33375,33836,5,29,7,0,0,2,0,7,340,80,25003,27847,27359,1,61,16,6874,11,5528,6477,2,0,-1,0,0
EUN1_3575864557',3,25,14,0,0,0,0,6,0,370,82,28419,32067,33542,6,30,9,1,0,0,0,7,347,68,24933,26936,24942,1,23,14,3486,5,5131,8600,-1,0,0,0,-1
EUN1_3575841593',4,24,6,0,0,0,0,3,0,375,98,24386,29402,27192,7,26,9,2,0,0,0,3,397,101,26139,30005,25795,0,-22,-3,-1753,-3,-603,1397,-2,0,0,0,0
EUN1_3575826742',7,26,7,1,0,0,0,13,1,337,69,24466,27824,28154,8,330,15,1,0,2,0,1,376,80,30056,31155,34759,0,-39,-11,-5590,-8,-3331,-6605,0,0,-2,0,12
EUN1_3575819207',3,38,6,1,0,1,0,13,0,337,102,25653,27262,31409,2,26,16,0,0,2,0,7,345,89,29269,30376,35078,0,-8,13,-3616,-10,-3114,-3669,1,0,-1,0,6
EUN1_3575794522',5,25,15,1,0,0,0,7,1,344,90,28926,28568,29412,5,24,16,0,0,1,0,4,382,90,30292,31328,33455,1,-38,0,-1366,-1,-2760,-4043,1,0,-1,0,3
EUN1_3575625903',6,30,10,0,0,0,0,12,1,337,86,26256,28385,31239,5,17,13,2,0,1,0,4,340,86,28344,29018,39536,0,-3,0,-2088,-3,-633,-8297,-2,0,-1,0,8
EUN1_3575610944',3,28,19,2,0,0,0,14,1,358,86,31698,29971,37450,11,31,13,0,0,4,0,4,333,98,29248,28530,38690,1,25,-12,2450,6,1441,-1240,2,0,-4,0,10
EUN1_3575599473',1,34,11,1,0,0,0,9,1,309,90,25469,28891,30145,7,28,10,0,0,0,0,0,337,86,25668,29779,29979,1,-28,4,-199,1,-888,166,1,0,0,0,9
EUN1_3575572148',3,23,13,1,0,1,0,7,1,351,92,28673,28851,32364,2,26,19,1,0,1,0,9,374,78,30619,31269,34107,0,-23,14,-1946,-6,-2418,-1743,0,0,0,0,-2
EUN1_3575537063',2,299,17,2,0,2,0,8,1,401,84,32113,30887,33098,2,29,9,0,0,2,0,10,319,74,24785,27704,27360,1,82,10,7328,8,3183,5738,2,0,0,0,-2
EUN1_3576022033',4,30,9,0,0,1,0,10,1,360,86,26682,29620,26232,5,23,12,2,0,1,0,8,382,113,28610,30972,30654,0,-22,-27,-1928,-3,-1352,-4422,-2,0,0,0,2
EUN1_3575978572',4,33,8,1,0,0,0,8,0,369,96,24725,28794,20232,1,21,9,0,0,1,0,2,354,112,26725,31428,35047,0,15,-16,-2000,-1,-2634,-14815,1,0,-1,0,6
EUN1_3575953448',3,19,13,0,0,0,0,8,0,338,98,27836,29935,30788,5,27,23,2,0,2,0,6,329,98,32365,31823,36807,0,9,0,-4529,-10,-1888,-6019,-2,0,-2,0,2
EUN1_3575890449',0,27,14,0,0,0,0,15,0,283,74,26068,27628,29892,5,34,14,2,0,2,0,0,370,93,30564,30250,37515,0,-87,-19,-4496,0,-2622,-7623,-2,0,-2,0,15
EUN1_3575864611',0,19,5,0,0,1,0,8,1,363,74,24625,28256,25093,5,104,7,2,0,0,0,3,354,94,23372,28382,31852,1,9,-20,1253,-2,-126,-6759,-2,0,1,0,5
EUN1_3575390259',1,16,6,0,0,0,0,9,0,353,96,23654,29826,27375,5,28,12,1,1,1,0,0,397,110,27622,32362,30058,0,-44,-14,-3968,-6,-2536,-2683,-1,-1,-1,0,9
EUN1_3575363893',5,24,25,2,0,2,0,3,1,345,110,33010,31249,39092,1,35,6,0,0,0,0,8,265,80,23544,24416,25705,1,80,30,9466,19,6833,13387,2,0,2,0,-5
EUN1_3575343423',4,28,8,0,0,1,0,11,0,338,74,26014,28036,27628,2,31,17,2,0,1,0,4,358,81,28805,29807,35645,0,-20,-7,-2791,-9,-1771,-8017,-2,0,0,0,7
EUN1_3575319952',2,184,16,0,0,0,0,13,0,289,92,28739,29509,36821,4,33,23,1,0,1,0,4,374,70,33399,31614,41204,0,-85,22,-4660,-7,-2105,-4383,-1,0,-1,0,9
EUN1_3575217797',5,42,13,0,0,0,0,5,1,359,74,27387,30229,31409,2,38,12,1,0,0,0,3,374,92,27437,30999,31131,1,-15,-18,-50,1,-770,278,-1,0,0,0,2
EUN1_3575203673',2,21,16,0,0,1,0,7,0,331,72,28597,31580,30997,6,31,13,1,0,1,0,5,350,84,28036,28381,40153,0,-19,-12,561,3,3199,-9156,-1,0,0,0,2
EUN1_3575028992',2,38,3,0,0,0,0,6,0,374,113,23382,29163,24263,6,31,10,2,1,0,0,2,354,90,24755,30939,26129,0,20,23,-1373,-7,-1776,-1866,-2,-1,0,0,4
EUN1_3575017160',1,21,10,0,0,0,0,10,1,381,68,26763,29488,28208,3,23,14,1,0,1,0,2,407,103,29256,33443,29082,0,-26,-35,-2493,-4,-3955,-874,-1,0,-1,0,8
EUN1_3576055048',2,26,23,0,1,2,0,5,1,354,70,31795,29720,42948,5,29,11,1,0,0,0,6,306,74,25342,24787,27869,1,48,-4,6453,12,4933,15079,-1,1,2,0,-1
EUN1_3576034896',3,26,19,2,0,1,0,8,0,358,122,30402,31910,37133,0,24,10,0,0,2,0,4,384,16,26864,26840,28762,1,-26,106,3538,9,5070,8371,2,0,-1,0,4
EUN1_3576021368',2,24,22,2,0,3,0,5,1,353,100,32486,32551,41964,3,25,13,0,0,0,0,11,336,84,27653,29838,35399,1,17,16,4833,9,2713,6565,2,0,3,0,-6
EUN1_3575857927',2,26,7,1,0,0,0,7,0,308,92,24151,27763,24118,2,33,17,1,0,1,0,2,402,71,30049,31245,33586,0,-94,21,-5898,-10,-3482,-9468,0,0,-1,0,5
EUN1_3575839838',6,27,6,0,0,0,0,14,1,299,80,23205,25825,20895,2,18,20,2,1,3,0,0,389,108,33493,32389,34211,0,-90,-28,-10288,-14,-6564,-13316,-2,-1,-3,0,14
EUN1_3575819172',1,41,7,1,0,0,0,7,0,392,80,25052,28124,25016,5,29,11,1,0,2,0,4,359,110,28056,29918,26410,1,33,-30,-3004,-4,-1794,-1394,0,0,-2,0,3
EUN1_3575800290',2,25,9,2,0,0,0,9,0,315,79,24322,27561,28708,3,43,10,0,0,1,0,0,362,82,26445,28455,28282,0,-47,-3,-2123,-1,-894,426,2,0,-1,0,9
EUN1_3575776691',5,33,9,0,0,1,0,4,1,390,64,26229,28305,28341,0,23,4,1,0,0,0,1,368,108,23539,29292,22232,0,22,-44,2690,5,-987,6109,-1,0,1,0,3
EUN1_3575764426',7,34,16,0,0,0,0,7,0,353,72,29754,29138,30771,3,21,14,2,0,1,0,8,340,78,28792,29779,32859,0,13,-6,962,2,-641,-2088,-2,0,-1,0,-1
EUN1_3575746915',2,28,5,0,0,0,0,15,0,333,99,24851,27438,24563,0,23,21,2,1,3,0,5,355,72,31298,29937,38693,0,-22,27,-6447,-16,-2499,-14130,-2,-1,-3,0,10
EUN1_3575736395',2,24,19,0,0,0,0,11,0,296,83,29141,28325,41860,4,22,18,2,0,2,0,1,348,72,30707,27823,39439,0,-52,11,-1566,1,502,2421,-2,0,-2,0,10
EUN1_3575727153',4,28,12,1,0,1,0,9,1,352,114,28474,31102,29822,1,18,7,1,0,0,0,5,368,90,24752,28552,25361,0,-16,24,3722,5,2550,4461,0,0,1,0,4
EUN1_3575714441',1,42,13,0,0,0,0,8,1,343,112,28524,29748,26730,4,21,20,2,0,1,0,6,360,75,31233,30564,43972,0,-17,37,-2709,-7,-816,-17242,-2,0,-1,0,2
EUN1_3575703658',2,31,24,0,0,1,0,11,0,333,58,33210,29815,47400,2,28,17,1,0,1,0,8,326,93,28478,28840,37522,0,7,-35,4732,7,975,9878,-1,0,0,0,3
EUN1_3575707201',6,29,11,1,0,2,0,2,1,365,102,28848,31646,29388,3,31,6,0,0,1,0,6,347,85,23886,28346,27496,1,18,17,4962,5,3300,1892,1,0,1,0,-4
EUN1_3575692034',4,33,17,2,0,0,0,11,1,373,82,29106,30130,34202,1,28,8,0,0,1,0,1,359,98,26507,27973,22488,1,14,-16,2599,9,2157,11714,2,0,-1,0,10
EUN1_3575692723',2,24,16,0,0,1,0,11,0,344,85,29954,31007,35326,4,28,14,0,0,2,0,4,354,72,28523,29075,34415,0,-10,13,1431,2,1932,911,0,0,-1,0,7
EUN1_3575682945',2,26,11,1,0,1,0,7,1,363,86,27376,29845,33762,2,26,10,1,0,2,0,8,312,92,26727,29017,28814,1,51,-6,649,1,828,4948,0,0,-1,0,-1
EUN1_3575683609',3,19,10,0,0,0,0,9,1,341,82,25711,28852,34411,4,26,16,2,0,2,0,2,326,114,31873,31659,41832,0,15,-32,-6162,-6,-2807,-7421,-2,0,-2,0,7
EUN1_3575685202',2,30,23,1,0,1,0,13,1,283,84,33097,29215,36585,5,31,18,1,0,2,0,4,334,87,30561,27828,41591,1,-51,-3,2536,5,1387,-5006,0,0,-1,0,9
EUN1_3575099844',3,19,15,2,0,3,0,4,1,404,90,31353,31433,28608,2,28,6,0,0,0,0,11,338,86,24388,28332,21740,1,66,4,6965,9,3101,6868,2,0,3,0,-7
EUN1_3575099097',5,27,23,1,0,0,0,8,1,333,77,30825,29454,38807,3,139,8,0,0,0,0,3,302,76,24878,27113,29335,1,31,1,5947,15,2341,9472,1,0,0,0,5
EUN1_3575075978',5,36,16,0,0,0,0,5,1,404,72,28815,30092,36075,2,185,11,1,1,0,0,5,357,75,25759,28541,33376,1,47,-3,3056,5,1551,2699,-1,-1,0,0,0
EUN1_3575066674',5,34,17,1,0,1,0,7,1,384,88,30383,30916,40529,4,26,13,0,0,0,0,5,346,80,26787,29592,27151,1,38,8,3596,4,1324,13378,1,0,1,0,2
EUN1_3575043405',3,146,17,1,1,2,0,9,0,350,116,32100,30785,32532,3,21,15,0,0,0,0,5,348,76,28982,29708,28589,0,2,40,3118,2,1077,3943,1,1,2,0,4
EUN1_3575018621',2,40,14,2,1,1,0,6,0,358,90,28520,30311,33935,2,34,16,0,0,0,0,6,376,98,28515,31469,32590,0,-18,-8,5,-2,-1158,1345,2,1,1,0,0
EUN1_3574933532',1,34,11,2,0,1,0,8,0,381,93,27893,30486,30992,4,32,3,0,0,0,0,5,385,87,22917,27918,16402,1,-4,6,4976,8,2568,14590,2,0,1,0,3
EUN1_3574916173',5,19,25,1,0,2,0,12,1,336,66,32904,30619,40387,4,22,10,0,0,2,0,10,336,110,28824,28627,29037,1,0,-44,4080,15,1992,11350,1,0,0,0,2
EUN1_3574886456',4,33,17,2,0,2,0,10,1,336,92,30657,30140,35755,5,27,11,0,0,0,0,7,339,60,26049,26605,37157,1,-3,32,4608,6,3535,-1402,2,0,2,0,3
EUN1_3574863509',3,23,14,1,0,1,0,8,1,403,80,28851,31977,36939,4,31,11,0,0,0,0,7,329,103,26289,30183,28804,1,74,-23,2562,3,1794,8135,1,0,1,0,1
EUN1_3574059894',2,27,23,0,0,2,0,4,1,357,99,32632,33268,35280,0,33,12,1,0,0,0,5,328,85,26367,28820,28469,1,29,14,6265,11,4448,6811,-1,0,2,0,-1
EUN1_3574063551',3,24,11,1,0,1,0,3,1,371,70,28615,29288,26599,4,22,10,1,1,0,0,4,352,118,26003,30834,23162,0,19,-48,2612,1,-1546,3437,0,-1,1,0,-1
EUN1_3573932172',3,29,15,1,0,0,0,10,1,354,80,28076,30306,32314,3,27,8,0,0,1,0,2,352,94,26382,28873,32044,1,2,-14,1694,7,1433,270,1,0,-1,0,8
EUN1_3573901612',7,36,10,1,0,1,0,12,1,338,78,26233,28054,29872,7,30,24,1,0,2,0,2,396,78,34045,32117,40185,0,-58,0,-7812,-14,-4063,-10313,0,0,-1,0,10
EUN1_3573870655',0,272,13,2,0,0,0,9,1,265,72,24856,25328,29623,3,27,13,0,0,0,0,1,326,88,26915,28021,33022,1,-61,-16,-2059,0,-2693,-3399,2,0,0,0,8
EUN1_3573840270',5,31,12,1,0,1,0,6,1,341,86,28714,29881,40074,4,41,9,0,0,0,0,7,340,90,26002,28475,30249,0,1,-4,2712,3,1406,9825,1,0,1,0,-1
EUN1_3573811774',3,23,11,0,0,1,0,8,1,355,76,26850,28067,31397,1,36,13,2,0,0,0,7,352,91,27258,29845,36931,0,3,-15,-408,-2,-1778,-5534,-2,0,1,0,1
EUN1_3573677937',5,32,13,0,0,0,0,6,1,356,96,26351,30116,31345,1,24,11,2,0,0,0,3,353,100,26619,30495,31451,0,3,-4,-268,2,-379,-106,-2,0,0,0,3
EUN1_3573665129',5,135,15,2,0,3,0,11,0,347,124,30639,31088,29187,2,20,10,0,0,0,0,7,376,68,25746,29030,28904,1,-29,56,4893,5,2058,283,2,0,3,0,4
EUN1_3573641948',3,34,5,0,0,0,0,12,1,367,84,23527,27212,23013,6,28,17,2,0,2,0,0,372,132,31267,34462,42933,0,-5,-48,-7740,-12,-7250,-19920,-2,0,-2,0,12
EUN1_3568290139',3,22,9,1,0,0,0,10,0,351,86,25838,29013,31470,5,31,14,1,0,0,0,0,371,70,28105,29262,32718,0,-20,16,-2267,-5,-249,-1248,0,0,0,0,10
EUN1_3568251939',1,21,17,0,0,1,0,8,1,355,96,29957,29814,36347,2,31,6,1,0,1,0,7,364,100,26358,28645,26819,0,-9,-4,3599,11,1169,9528,-1,0,0,0,1
EUN1_3568238694',5,33,19,2,0,2,0,5,1,362,96,31953,32339,33581,1,24,6,0,0,1,0,8,322,72,22569,27321,22207,1,40,24,9384,13,5018,11374,2,0,1,0,-3
EUN1_3568206941',4,32,7,1,0,1,0,10,0,372,74,25906,29169,34538,2,21,11,1,0,0,0,4,301,86,25939,30764,29079,1,71,-12,-33,-4,-1595,5459,0,0,1,0,6
EUN1_3568195142',2,25,3,2,1,0,0,10,0,344,128,22951,30063,21195,5,25,8,0,0,2,0,2,410,84,28391,30337,25671,0,-66,44,-5440,-5,-274,-4476,2,1,-2,0,8
EUN1_3567447635',6,23,9,1,0,0,0,17,1,323,71,26199,27987,27351,3,46,24,1,0,3,0,1,395,92,34914,32966,40783,0,-72,-21,-8715,-15,-4979,-13432,0,0,-3,0,16
EUN1_3567266030',3,26,10,0,0,0,0,11,1,318,94,25786,28700,32447,3,65,8,2,1,1,0,1,378,90,27514,29588,31519,0,-60,4,-1728,2,-888,928,-2,-1,-1,0,10
EUN1_3566868080',2,23,10,1,0,2,0,8,1,348,105,26986,30415,27022,3,25,5,1,0,0,0,5,364,80,23888,28734,23873,1,-16,25,3098,5,1681,3149,0,0,2,0,3
EUN1_3566837598',7,29,9,0,0,0,0,7,0,311,70,24415,25931,24600,2,46,14,2,0,1,0,3,330,80,27934,28286,37341,0,-19,-10,-3519,-5,-2355,-12741,-2,0,-1,0,4
EUN1_3566423770',2,33,11,2,0,1,0,14,1,361,90,28246,30462,35212,7,32,7,0,0,2,0,4,334,66,24171,26561,24565,1,27,24,4075,4,3901,10647,2,0,-1,0,10
EUN1_3566396964',4,34,11,0,0,1,0,10,0,348,72,28303,30336,32140,0,22,19,1,0,0,0,5,349,110,28361,31688,39985,1,-1,-38,-58,-8,-1352,-7845,-1,0,1,0,5
EUN1_3566390126',5,33,7,0,0,0,0,14,1,275,80,24434,25660,24853,0,24,16,1,0,2,0,3,351,107,32342,31780,36930,0,-76,-27,-7908,-9,-6120,-12077,-1,0,-2,0,11
EUN1_3566363219',6,27,9,1,0,0,0,8,1,344,80,25290,28920,30207,3,30,5,1,0,1,0,3,336,107,24218,28668,33294,1,8,-27,1072,4,252,-3087,0,0,-1,0,5
EUN1_3566325799',5,167,24,1,0,1,0,19,1,316,96,32927,32279,44178,3,34,32,1,0,3,0,3,347,92,38312,33703,52548,0,-31,4,-5385,-8,-1424,-8370,0,0,-2,0,16
EUN1_3566301494',4,45,13,1,0,1,0,11,1,365,74,28725,29577,35781,1,28,12,0,0,1,0,7,337,86,27510,29879,27335,1,28,-12,1215,1,-302,8446,1,0,0,0,4
EUN1_3565797147',2,30,11,1,0,1,0,10,1,300,88,27184,27281,28449,3,40,19,1,0,1,0,2,363,104,30820,31431,34449,1,-63,-16,-3636,-8,-4150,-6000,0,0,0,0,8
EUN1_3565696715',0,27,22,1,0,1,0,6,0,328,78,30495,29155,41982,4,30,3,0,0,1,0,7,312,89,22166,25479,29202,1,16,-11,8329,19,3676,12780,1,0,0,0,-1
EUN1_3398662585',5,34,10,1,0,0,0,9,1,302,71,26382,26520,25841,5,39,7,0,1,2,0,4,328,77,24904,27232,25831,1,-26,-6,1478,3,-712,10,1,-1,-2,0,5
EUN1_3352148551',3,27,17,1,0,0,0,14,1,274,56,28913,25673,38490,5,42,21,1,1,2,0,7,306,88,31972,28921,31872,1,-32,-32,-3059,-4,-3248,6618,0,-1,-2,0,7
EUN1_3576033026',2,196,5,0,0,0,0,16,0,309,74,23414,27012,22775,1,22,22,1,0,5,0,5,409,112,35828,35582,38336,0,-100,-38,-12414,-17,-8570,-15561,-1,0,-5,0,11
EUN1_3576010804',2,185,7,1,0,1,0,15,0,353,89,26370,28233,28422,4,28,20,1,0,2,0,3,373,78,31483,31961,47830,0,-20,11,-5113,-13,-3728,-19408,0,0,-1,0,12
EUN1_3575999422',4,29,8,0,0,0,0,9,0,309,86,24300,25595,24733,6,26,18,2,0,1,0,0,349,102,29334,31881,36235,0,-40,-16,-5034,-10,-6286,-11502,-2,0,-1,0,9
EUN1_3575955193',1,24,17,0,0,1,0,11,0,365,82,30985,31909,39936,4,341,14,2,0,2,0,7,303,87,27272,28100,34041,0,62,-5,3713,3,3809,5895,-2,0,-1,0,4
EUN1_3575836050',1,19,9,2,0,0,0,9,0,363,76,25739,29469,32774,3,25,15,0,0,1,0,2,341,96,27903,31312,34397,0,22,-20,-2164,-6,-1843,-1623,2,0,-1,0,7
EUN1_3575822896',6,28,16,2,0,1,0,8,0,341,93,28488,29813,37293,4,27,11,0,0,1,0,3,325,82,25319,28447,29761,1,16,11,3169,5,1366,7532,2,0,0,0,5
EUN1_3568352999',2,27,14,0,0,0,0,11,1,351,90,28473,31203,31926,3,28,9,1,0,1,0,4,398,102,28022,30927,26185,1,-47,-12,451,5,276,5741,-1,0,-1,0,7
EUN1_3568352400',4,32,8,0,0,0,0,16,0,295,84,24951,25971,30068,5,31,19,1,0,3,0,1,384,80,32681,31134,36259,0,-89,4,-7730,-11,-5163,-6191,-1,0,-3,0,15
EUN1_3568339186',4,30,15,1,0,1,0,12,1,347,70,29785,29021,41700,3,45,20,0,0,1,0,8,330,98,31863,32102,37489,1,17,-28,-2078,-5,-3081,4211,1,0,0,0,4
EUN1_3568290269',3,29,13,2,0,0,0,12,1,372,76,28386,29909,33410,5,32,16,0,0,1,0,3,360,98,30505,29875,34181,1,12,-22,-2119,-3,34,-771,2,0,-1,0,9
EUN1_3568117450',6,30,19,2,0,1,0,10,1,318,84,29691,28458,43313,1,70,13,0,0,1,0,8,338,95,28959,29351,31411,1,-20,-11,732,6,-893,11902,2,0,0,0,2
EUN1_3567897012',4,32,8,1,0,0,0,9,1,308,77,23903,25873,32444,5,29,15,1,0,1,0,1,360,102,28875,31664,34887,0,-52,-25,-4972,-7,-5791,-2443,0,0,-1,0,8
EUN1_3567889323',1,37,10,1,0,0,0,16,0,343,83,26138,31073,29748,0,101,12,1,1,3,0,4,341,112,30262,31145,30104,0,2,-29,-4124,-2,-72,-356,0,-1,-3,0,12
EUN1_3567790484',4,48,18,0,0,0,0,10,1,348,86,29303,30465,37623,6,27,11,1,0,0,0,3,330,64,25893,28634,33390,1,18,22,3410,7,1831,4233,-1,0,0,0,7
EUN1_3567658859',3,35,12,0,0,0,0,11,0,306,82,25851,27988,31680,5,16,21,2,1,2,0,2,362,92,31256,31857,34881,1,-56,-10,-5405,-9,-3869,-3201,-2,-1,-2,0,9
EUN1_3567639981',4,54,14,0,0,0,0,5,1,361,108,28525,31294,31974,7,26,10,2,0,0,0,3,387,84,26205,30981,27761,0,-26,24,2320,4,313,4213,-2,0,0,0,2
EUN1_3567113509',3,29,22,0,0,1,0,7,1,333,87,31715,29065,40342,3,55,13,1,0,0,0,6,299,66,26072,27769,35596,1,34,21,5643,9,1296,4746,-1,0,1,0,1
EUN1_3567100105',5,28,14,0,0,2,0,5,0,362,98,29403,31166,35131,4,32,8,1,0,0,0,7,338,84,24276,28255,24936,1,24,14,5127,6,2911,10195,-1,0,2,0,-2
EUN1_3566803504',4,46,16,2,0,1,0,8,1,379,80,29053,32209,34693,5,28,2,0,0,0,0,6,360,80,23499,26485,22234,1,19,0,5554,14,5724,12459,2,0,1,0,2
EUN1_3566687505',4,45,6,1,0,0,0,7,0,328,96,24362,27775,21386,4,26,7,0,0,0,0,4,392,80,25164,29354,25715,0,-64,16,-802,-1,-1579,-4329,1,0,0,0,3
EUN1_3566618317',1,28,21,1,0,0,0,10,0,303,68,29683,28611,45498,0,26,19,1,0,1,0,1,310,79,29940,28024,38334,0,-7,-11,-257,2,587,7164,0,0,-1,0,9
EUN1_3566581674',4,27,11,0,0,0,0,10,1,325,72,27940,27046,32973,2,28,20,2,0,3,0,5,362,88,31980,32143,43002,0,-37,-16,-4040,-9,-5097,-10029,-2,0,-3,0,5
EUN1_3566424885',0,183,11,1,0,2,0,12,0,349,106,28206,30972,31218,3,20,15,1,0,0,0,4,318,98,27698,29866,27749,0,31,8,508,-4,1106,3469,0,0,2,0,8
EUN1_3566412487',4,28,17,0,0,1,0,10,0,331,78,28424,28275,32162,5,32,8,1,0,1,0,4,324,70,25720,27142,25918,1,7,8,2704,9,1133,6244,-1,0,0,0,6
EUN1_3575473171',2,27,18,0,0,0,0,14,1,291,90,28595,29472,32806,1,37,20,1,1,1,0,2,337,81,30909,31216,42908,1,-46,9,-2314,-2,-1744,-10102,-1,-1,-1,0,12
EUN1_3575296027',2,146,15,2,0,1,0,15,1,341,92,29294,30144,37122,3,18,17,0,0,3,0,5,348,84,30143,28310,38333,1,-7,8,-849,-2,1834,-1211,2,0,-2,0,10
EUN1_3574098990',3,29,10,2,0,1,0,9,1,391,72,27895,30574,23836,6,43,13,0,1,1,0,4,354,119,28709,31061,24572,0,37,-47,-814,-3,-487,-736,2,-1,0,0,5
EUN1_3574099291',2,25,15,0,0,0,0,8,1,325,84,28506,28728,37498,1,30,17,1,0,1,0,6,351,92,31156,31374,34426,0,-26,-8,-2650,-2,-2646,3072,-1,0,-1,0,2
EUN1_3572522955',1,60,13,2,0,0,0,16,1,401,106,29736,33642,32985,1,65,11,0,0,2,0,5,354,84,27700,29716,27163,1,47,22,2036,2,3926,5822,2,0,-2,0,11
EUN1_3572511574',2,30,13,1,0,1,0,8,1,369,95,27961,30654,25459,3,23,9,1,0,0,0,2,392,92,26396,28981,27390,0,-23,3,1565,4,1673,-1931,0,0,1,0,6
EUN1_3572229255',3,37,17,2,0,1,0,15,0,307,76,29048,31359,34257,5,28,14,0,0,2,0,4,348,80,29299,27705,43568,0,-41,-4,-251,3,3654,-9311,2,0,-1,0,11
EUN1_3571592351',2,28,13,0,0,1,0,8,1,383,80,26643,29368,29599,1,25,9,2,0,1,0,2,366,80,26538,27819,27043,0,17,0,105,4,1549,2556,-2,0,0,0,6
EUN1_3571543529',4,134,10,1,0,0,0,13,1,333,76,25718,28844,33148,5,27,15,1,0,1,0,2,351,100,29694,31449,31967,1,-18,-24,-3976,-5,-2605,1181,0,0,-1,0,11
EUN1_3569962661',1,26,9,0,0,0,0,10,0,332,82,26097,27448,29257,5,24,17,2,0,0,0,4,383,68,29240,31395,41377,0,-51,14,-3143,-8,-3947,-12120,-2,0,0,0,6
EUN1_3569953761',6,83,8,0,0,0,0,8,1,341,92,24068,27739,22820,2,25,14,2,0,1,0,0,428,100,30846,31380,29747,0,-87,-8,-6778,-6,-3641,-6927,-2,0,-1,0,8
EUN1_3569480478',4,29,12,1,1,0,0,6,1,354,90,26651,29066,28747,2,22,7,1,0,0,0,6,375,89,25102,29710,22744,1,-21,1,1549,5,-644,6003,0,1,0,0,0
EUN1_3569466504',3,28,18,1,1,0,0,12,0,351,92,28387,31457,44578,3,28,9,1,0,1,0,1,340,76,25694,26984,33536,1,11,16,2693,9,4473,11042,0,1,-1,0,11
EUN1_3569417658',0,67,12,0,0,0,0,16,0,325,84,26990,27026,26053,0,28,21,2,0,3,0,2,340,106,31679,32746,40347,0,-15,-22,-4689,-9,-5720,-14294,-2,0,-3,0,14
EUN1_3569408095',5,29,9,1,0,0,0,11,0,320,90,26218,28920,27590,2,24,15,1,0,2,0,6,401,114,30981,32374,31003,0,-81,-24,-4763,-6,-3454,-3413,0,0,-2,0,5
EUN1_3576083913',3,24,7,1,1,1,0,3,1,353,106,25371,30152,21988,0,27,2,1,0,0,0,8,339,105,22128,27814,16832,1,14,1,3243,5,2338,5156,0,1,1,0,-5
EUN1_3576062284',1,30,10,0,0,0,0,5,0,334,91,25559,28842,32532,3,27,10,1,0,1,0,5,375,88,26907,29208,32649,0,-41,3,-1348,0,-366,-117,-1,0,-1,0,0
EUN1_3575630497',3,55,9,0,0,0,0,14,0,326,88,25735,27129,27664,2,27,12,1,0,1,0,2,347,80,28949,27890,29039,1,-21,8,-3214,-3,-761,-1375,-1,0,-1,0,12
EUN1_3575374701',5,31,3,0,0,0,0,15,0,342,84,22127,27227,24568,2,30,17,2,0,1,0,0,334,127,30257,31318,31419,0,8,-43,-8130,-14,-4091,-6851,-2,0,-1,0,15
EUN1_3575288269',4,25,12,2,0,0,0,10,1,327,99,26536,28476,39243,5,24,18,0,0,0,0,2,347,106,30191,30058,44014,0,-20,-7,-3655,-6,-1582,-4771,2,0,0,0,8
EUN1_3575259024',4,31,7,0,1,0,0,10,0,346,79,24196,27938,26468,5,36,11,2,0,1,0,4,354,116,27523,29952,32667,0,-8,-37,-3327,-4,-2014,-6199,-2,1,-1,0,6
EUN1_3575250264',3,24,6,0,0,0,0,10,0,385,73,25449,28642,30195,4,31,20,1,0,1,0,2,398,74,31335,30701,39144,0,-13,-1,-5886,-14,-2059,-8949,-1,0,-1,0,8
EUN1_3575091896',4,24,11,1,0,2,0,14,0,378,95,28303,29355,27278,3,24,19,1,1,1,0,5,367,65,32137,30515,30160,0,11,30,-3834,-8,-1160,-2882,0,-1,1,0,9
EUN1_3575088144',4,33,18,2,0,2,0,7,0,326,94,31352,29151,38803,4,26,14,0,0,1,0,10,307,71,26909,26221,32983,1,19,23,4443,4,2930,5820,2,0,1,0,-3
EUN1_3575059922',1,27,11,0,0,0,0,12,0,273,88,26049,27979,32179,1,22,10,2,0,2,0,0,337,87,26360,28567,35230,1,-64,1,-311,1,-588,-3051,-2,0,-2,0,12
EUN1_3575017286',0,23,12,0,0,0,0,6,0,350,94,26851,30441,32501,1,30,8,2,1,1,0,7,384,95,26742,30165,32558,1,-34,-1,109,4,276,-57,-2,-1,-1,0,-1
EUN1_3575390267',2,47,7,0,0,0,0,10,0,349,78,24592,27658,22499,3,20,18,1,0,1,0,0,371,81,29705,30904,32618,0,-22,-3,-5113,-11,-3246,-10119,-1,0,-1,0,10
EUN1_3575365019',3,70,16,2,0,2,0,4,1,402,93,30175,32113,34997,2,26,4,0,0,0,0,8,346,88,23216,27833,29643,1,56,5,6959,12,4280,5354,2,0,2,0,-4
EUN1_3575337017',4,29,6,0,0,0,0,6,0,381,86,25479,28801,30306,5,27,17,2,0,0,0,3,336,86,27745,31374,36469,1,45,0,-2266,-11,-2573,-6163,-2,0,0,0,3
EUN1_3575313696',1,29,4,2,0,0,0,12,0,343,91,22190,25536,33583,4,92,28,0,0,2,0,1,352,84,34293,31543,42104,0,-9,7,-12103,-24,-6007,-8521,2,0,-2,0,11
EUN1_3575285442',5,23,9,0,0,0,0,11,0,305,92,24071,26771,42212,5,32,22,2,0,2,0,1,366,107,32706,33541,45449,0,-61,-15,-8635,-13,-6770,-3237,-2,0,-2,0,10
EUN1_3575263651',6,51,9,2,1,1,0,5,1,372,96,26736,29758,24505,3,20,7,0,0,0,0,6,280,100,22522,24505,22165,1,92,-4,4214,2,5253,2340,2,1,1,0,-1
EUN1_3575242049',6,33,14,2,0,0,0,12,1,312,81,26241,27268,26435,7,162,7,0,0,1,0,1,359,92,25653,27677,24940,1,-47,-11,588,7,-409,1495,2,0,-1,0,11
EUN1_3575230348',3,31,10,1,0,0,0,12,1,300,92,25121,25920,27632,7,32,20,1,0,3,0,0,356,82,31481,30649,40707,0,-56,10,-6360,-10,-4729,-13075,0,0,-3,0,12
EUN1_3575219228',2,20,8,0,0,0,0,14,1,277,97,24159,26998,30288,6,37,18,2,0,2,0,3,367,96,31140,32715,39250,0,-90,1,-6981,-10,-5717,-8962,-2,0,-2,0,11
EUN1_3574965688',5,30,7,0,0,0,0,9,0,371,106,24390,28210,26631,9,44,13,2,1,1,0,2,358,82,27050,29462,32033,1,13,24,-2660,-6,-1252,-5402,-2,-1,-1,0,7
EUN1_3574907538',2,23,15,1,0,1,0,8,1,350,86,28879,29931,33089,3,31,18,0,0,0,0,4,339,74,28178,30344,37903,0,11,12,701,-3,-413,-4814,1,0,1,0,4
EUN1_3574883184',3,23,2,0,0,0,0,9,0,302,84,21574,27634,19952,6,35,15,2,1,1,0,4,347,112,28422,31418,34755,0,-45,-28,-6848,-13,-3784,-14803,-2,-1,-1,0,5
EUN1_3574848809',4,31,9,2,0,1,0,9,0,348,86,25029,28204,28664,4,30,5,0,0,0,0,0,382,89,24495,28655,27999,1,-34,-3,534,4,-451,665,2,0,1,0,9
EUN1_3574386735',3,24,16,0,0,0,0,8,1,276,68,28449,25931,31448,3,29,24,1,0,0,0,4,307,76,30807,28269,43172,1,-31,-8,-2358,-8,-2338,-11724,-1,0,0,0,4
EUN1_3574359752',7,32,13,1,1,3,0,7,0,315,84,28871,28194,30279,0,17,12,1,0,2,0,8,332,97,28784,27515,31610,1,-17,-13,87,1,679,-1331,0,1,1,0,-1
EUN1_3574208860',3,29,12,1,0,0,0,6,1,380,80,27825,29228,30381,4,25,10,1,0,0,0,4,349,108,24990,29316,25770,0,31,-28,2835,2,-88,4611,0,0,0,0,2
EUN1_3574987480',4,26,8,1,0,2,0,8,1,415,79,27543,29794,23901,3,27,4,1,0,0,0,6,353,106,23555,28935,21275,1,62,-27,3988,4,859,2626,0,0,2,0,2
EUN1_3574923925',2,23,12,0,0,0,0,12,0,363,84,26330,30472,36405,5,148,8,2,0,2,0,2,350,79,27450,29556,34113,1,13,5,-1120,4,916,2292,-2,0,-2,0,10
EUN1_3574881659',4,27,10,1,0,0,0,4,1,316,96,26030,30293,28246,8,32,7,0,0,0,0,1,367,83,23661,29134,32383,1,-51,13,2369,3,1159,-4137,1,0,0,0,3
EUN1_3574436824',3,38,5,1,0,0,0,5,1,397,88,24056,28790,21856,4,26,7,0,0,1,0,1,390,96,27213,32062,25128,0,7,-8,-3157,-2,-3272,-3272,1,0,-1,0,4
EUN1_3574412578',5,35,17,2,1,0,0,11,0,315,88,28508,30675,32084,2,24,9,0,0,0,0,1,344,102,25768,29653,26719,1,-29,-14,2740,8,1022,5365,2,1,0,0,10
EUN1_3574392647',5,29,11,1,0,1,0,11,1,386,82,27699,30386,33149,0,30,6,0,0,0,0,3,325,106,23313,29449,26668,1,61,-24,4386,5,937,6481,1,0,1,0,8
EUN1_3574379181',6,32,8,0,0,0,0,13,0,321,74,24793,26548,23777,4,28,12,2,0,2,0,1,320,90,27629,28229,30987,0,1,-16,-2836,-4,-1681,-7210,-2,0,-2,0,12
EUN1_3574347198',4,28,10,0,1,0,0,12,0,337,90,25553,29040,26003,9,33,15,2,0,2,0,0,382,74,29209,29441,38595,0,-45,16,-3656,-5,-401,-12592,-2,1,-2,0,12
EUN1_3573984534',3,25,10,2,1,1,0,8,1,351,92,27467,29452,31338,4,33,13,0,0,2,0,4,389,100,29501,30377,32028,0,-38,-8,-2034,-3,-925,-690,2,1,-1,0,4
EUN1_3573959754',10,94,16,1,0,1,0,9,1,370,59,29741,30565,37474,8,32,14,1,0,0,0,3,374,72,28269,30092,33393,1,-4,-13,1472,2,473,4081,0,0,1,0,6
EUN1_3573930858',6,29,18,1,1,4,0,6,1,409,87,35246,32880,35429,1,25,9,1,0,1,0,12,317,80,25098,27607,23058,1,92,7,10148,9,5273,12371,0,1,3,0,-6
EUN1_3573903639',4,32,7,0,0,0,0,10,0,359,80,24951,28540,31213,8,28,13,2,0,1,0,1,362,92,27980,30656,29311,0,-3,-12,-3029,-6,-2116,1902,-2,0,-1,0,9
EUN1_3573878268',3,40,6,0,0,0,0,11,0,333,83,23666,28138,29555,6,20,16,2,0,1,0,2,375,100,29088,32852,29107,0,-42,-17,-5422,-10,-4714,448,-2,0,-1,0,9
EUN1_3573835220',2,43,11,0,0,1,0,9,1,358,98,26268,29035,30145,3,26,8,2,0,0,0,4,346,90,25224,28357,31738,1,12,8,1044,3,678,-1593,-2,0,1,0,5
EUN1_3573809477',5,61,14,0,1,1,0,10,0,390,114,28855,32412,32428,1,219,14,2,0,1,0,2,280,88,26689,28319,29636,1,110,26,2166,0,4093,2792,-2,1,0,0,8
EUN1_3573306847',5,54,13,2,0,0,0,11,0,359,86,27215,30927,27578,4,35,8,0,0,0,0,2,339,99,24731,28960,31065,0,20,-13,2484,5,1967,-3487,2,0,0,0,9
EUN1_3573293142',7,41,12,1,0,2,0,6,1,364,74,29253,30117,29087,6,33,11,1,0,0,0,3,359,72,26097,28366,28375,1,5,2,3156,1,1751,712,0,0,2,0,3
EUN1_3573266717',2,25,16,2,0,0,0,8,1,400,90,30035,32969,34761,1,28,8,0,1,0,0,7,317,93,25287,29791,26159,1,83,-3,4748,8,3178,8602,2,-1,0,0,1
EUN1_3568314490',5,29,19,2,1,1,0,7,0,319,84,31750,28448,39048,4,31,21,0,0,1,0,9,350,91,33133,30672,42753,1,-31,-7,-1383,-2,-2224,-3705,2,1,0,0,-2
EUN1_3568243128',5,25,11,0,0,0,0,11,0,375,98,26898,29995,33702,2,33,11,1,0,1,0,2,319,82,27259,27447,30901,1,56,16,-361,0,2548,2801,-1,0,-1,0,9
EUN1_3568111321',3,27,9,2,0,0,0,3,1,360,92,25501,28193,27589,2,40,8,0,0,0,0,3,334,88,25340,29329,26628,0,26,4,161,1,-1136,961,2,0,0,0,0
EUN1_3568095628',8,31,18,2,0,1,0,11,0,355,108,32807,33351,42486,4,23,15,0,0,1,0,7,324,76,27223,29828,32459,1,31,32,5584,3,3523,10027,2,0,0,0,4
EUN1_3568054102',2,30,12,0,0,1,0,4,0,389,89,29008,31440,37341,3,28,5,2,0,0,0,6,341,89,23392,27491,26956,1,48,0,5616,7,3949,10385,-2,0,1,0,-2
EUN1_3568039516',5,23,18,2,0,2,0,5,1,336,100,31459,30960,40013,1,22,11,0,0,0,0,8,324,72,25848,26912,34161,1,12,28,5611,7,4048,5852,2,0,2,0,-3
EUN1_3568025722',4,32,10,1,0,1,0,4,0,328,85,25930,27242,31213,2,24,17,1,0,1,0,4,360,78,29186,31862,39494,0,-32,7,-3256,-7,-4620,-8281,0,0,0,0,0
EUN1_3567942671',3,37,9,1,0,0,0,9,0,360,100,28041,29593,25416,2,25,9,1,0,1,0,7,345,88,26420,28634,25456,1,15,12,1621,0,959,-40,0,0,-1,0,2
EUN1_3564609605',2,25,20,2,1,1,0,6,1,343,106,30887,32325,34293,3,31,13,0,0,0,0,6,317,90,28031,28219,28100,1,26,16,2856,7,4106,6193,2,1,1,0,0
EUN1_3564595557',2,27,18,2,0,1,0,8,1,325,93,30429,30846,41479,1,21,17,0,1,1,0,5,309,74,27508,29824,39660,1,16,19,2921,1,1022,1819,2,-1,0,0,3
EUN1_3564573417',3,21,10,1,1,0,0,7,1,332,92,26309,27878,33541,3,23,11,1,0,0,0,6,325,84,26757,30342,25664,0,7,8,-448,-1,-2464,7877,0,1,0,0,1
EUN1_3553315226',4,37,14,1,0,1,0,11,1,344,84,28854,29734,35416,7,35,13,1,0,0,0,4,364,70,28218,29987,29033,1,-20,14,636,1,-253,6383,0,0,1,0,7
EUN1_3553305501',1,27,13,1,0,0,0,7,1,349,88,27520,30888,31511,0,127,14,1,0,0,0,2,328,84,27326,30401,29857,0,21,4,194,-1,487,1654,0,0,0,0,5
EUN1_3553293962',1,34,4,0,0,1,0,9,0,374,81,23900,27400,23307,3,21,9,2,0,2,0,3,439,88,28827,30879,28318,0,-65,-7,-4927,-5,-3479,-5011,-2,0,-1,0,6
EUN1_3575788157',1,19,12,0,0,2,0,9,0,347,92,28671,29335,31586,2,88,23,2,0,2,0,6,361,91,33286,30752,35986,0,-14,1,-4615,-11,-1417,-4400,-2,0,0,0,3
EUN1_3575772180',2,30,19,1,0,0,0,12,1,318,98,30460,29355,39687,2,17,12,1,0,3,0,3,345,94,28881,29970,30945,1,-27,4,1579,7,-615,8742,0,0,-3,0,9
EUN1_3575360870',6,141,11,1,0,0,0,8,0,309,92,25601,26964,38211,2,28,11,1,0,1,0,6,364,82,27889,29847,25989,1,-55,10,-2288,0,-2883,12222,0,0,-1,0,2
EUN1_3575337928',3,36,16,1,0,0,0,5,1,345,88,30648,29880,32589,3,41,17,1,0,0,0,7,364,84,29069,30493,33229,0,-19,4,1579,-1,-613,-640,0,0,0,0,-2
EUN1_3575329863',3,31,4,0,0,0,0,12,1,327,74,21740,26560,26059,6,26,17,1,0,2,0,0,410,112,31416,34927,39681,0,-83,-38,-9676,-13,-8367,-13622,-1,0,-2,0,12
EUN1_3574539941',2,24,9,1,0,1,0,9,0,361,86,26615,30273,32645,2,19,13,0,1,1,0,4,380,73,27646,30934,29418,1,-19,13,-1031,-4,-661,3227,1,-1,0,0,5
EUN1_3573997759',7,31,10,1,0,1,0,8,0,383,114,28497,30306,29108,3,70,14,1,0,0,0,6,306,73,26038,26112,35408,0,77,41,2459,-4,4194,-6300,0,0,1,0,2
EUN1_3573964689',4,30,15,1,0,1,0,10,0,338,90,29927,29599,38760,3,22,18,0,0,2,0,7,364,103,31604,30669,40902,1,-26,-13,-1677,-3,-1070,-2142,1,0,-1,0,3
EUN1_3573228434',3,28,24,0,0,0,0,9,1,354,91,31902,33720,42531,3,28,15,0,0,0,0,2,342,72,28501,28790,34903,1,12,19,3401,9,4930,7628,0,0,0,0,7
EUN1_3572790832',2,33,12,1,0,1,0,6,1,362,78,27584,31601,34102,2,28,8,0,0,0,0,5,351,74,24171,26837,22677,1,11,4,3413,4,4764,11425,1,0,1,0,1
EUN1_3572751789',4,64,16,1,0,0,0,6,1,311,87,26654,27716,33762,1,64,9,0,0,0,0,2,319,100,26305,28028,30483,0,-8,-13,349,7,-312,3279,1,0,0,0,4
EUN1_3572520018',8,25,12,2,0,1,0,8,0,311,80,25277,28105,34641,4,28,12,0,0,1,0,3,331,92,27369,28953,32865,0,-20,-12,-2092,0,-848,1776,2,0,0,0,5
EUN1_3572507381',2,25,17,0,0,0,0,5,1,362,79,29620,29797,35443,6,36,11,2,1,1,0,3,318,92,26123,27713,34043,0,44,-13,3497,6,2084,1400,-2,-1,-1,0,2
EUN1_3567683498',3,22,3,1,0,0,0,16,1,337,64,21313,25708,28064,3,24,22,1,0,5,0,1,397,112,35892,35455,39022,0,-60,-48,-14579,-19,-9747,-10958,0,0,-5,0,15
EUN1_3567118743',8,32,10,1,0,0,0,5,0,404,84,26930,31621,32055,1,16,10,0,0,0,0,2,313,72,24659,27678,34513,1,91,12,2271,0,3943,-2458,1,0,0,0,3
EUN1_3567096020',1,27,7,0,0,0,0,6,1,350,92,24682,28994,28303,5,25,10,1,0,1,0,4,363,90,26196,29841,32445,0,-13,2,-1514,-3,-847,-4142,-1,0,-1,0,2
EUN1_3562059645',3,33,9,0,0,0,0,12,1,308,72,24573,26143,27980,1,23,12,2,0,1,0,2,370,96,28773,30237,34561,0,-62,-24,-4200,-3,-4094,-6581,-2,0,-1,0,10
EUN1_3561488809',6,30,29,1,0,2,0,10,1,329,96,35385,33270,43176,4,25,9,1,0,1,0,5,311,76,24816,25213,33335,1,18,20,10569,20,8057,9841,0,0,1,0,5
EUN1_3575452061',9,30,11,1,0,0,0,8,1,359,102,27061,30797,25685,4,27,8,1,0,0,0,3,384,78,25455,29690,26298,1,-25,24,1606,3,1107,-613,0,0,0,0,5
EUN1_3575434228',2,64,16,0,0,2,0,8,0,369,108,30768,31098,30532,3,27,16,2,0,1,0,6,348,71,29401,28832,31678,0,21,37,1367,0,2266,-1146,-2,0,1,0,2
EUN1_3575104245',3,22,24,2,0,2,0,8,1,341,92,32930,33657,42445,4,39,13,0,0,1,0,8,324,88,28058,30127,27995,1,17,4,4872,11,3530,14450,2,0,1,0,0
EUN1_3575088312',2,68,18,0,0,1,0,5,1,360,88,28337,31275,36551,2,34,7,2,0,0,0,3,339,92,23821,27276,25564,1,21,-4,4516,11,3999,10987,-2,0,1,0,2
EUN1_3575014699',4,22,11,1,0,0,0,12,1,382,88,25803,31012,26590,4,21,6,0,0,1,0,3,344,88,24979,27696,31183,1,38,0,824,5,3316,-4593,1,0,-1,0,9
EUN1_3574592860',0,33,13,0,0,0,0,10,1,324,56,26284,27990,29249,7,28,7,1,0,0,0,3,336,88,24206,29349,27642,0,-12,-32,2078,6,-1359,1607,-1,0,0,0,7
EUN1_3574598343',4,39,19,1,0,0,0,8,1,348,72,29925,30587,37412,1,34,6,1,0,2,0,4,305,96,23374,28167,25193,1,43,-24,6551,13,2420,12219,0,0,-2,0,4
EUN1_3574582915',4,35,15,1,0,0,0,4,0,335,70,26386,29519,38990,2,15,14,1,0,0,0,4,283,76,25735,29860,36441,0,52,-6,651,1,-341,2549,0,0,0,0,0
EUN1_3574573829',3,19,5,1,0,1,0,14,0,341,112,23910,30093,21737,4,33,9,1,0,4,0,1,440,112,30593,32707,24275,1,-99,0,-6683,-4,-2614,-2538,0,0,-3,0,13
EUN1_3573975849',4,36,11,0,0,0,0,5,0,374,74,25877,28777,30784,5,34,14,1,0,0,0,3,340,89,27417,28934,28694,0,34,-15,-1540,-3,-157,2090,-1,0,0,0,2
EUN1_3573718941',3,33,14,1,0,0,0,9,1,349,102,28017,30598,36417,5,30,12,1,0,1,0,2,311,86,26539,28829,34090,1,38,16,1478,2,1769,2327,0,0,-1,0,7
EUN1_3573701617',1,30,10,0,0,0,0,7,0,328,74,24318,28250,28150,4,25,13,2,1,0,0,4,390,82,29225,31612,32112,1,-62,-8,-4907,-3,-3362,-3962,-2,-1,0,0,3
EUN1_3573687439',3,48,7,2,0,1,0,10,1,387,92,27117,28716,28065,5,28,9,0,0,0,0,6,365,84,25399,29224,35178,1,22,8,1718,-2,-508,-7113,2,0,1,0,4
EUN1_3573663951',3,350,17,1,0,2,0,5,0,340,85,30194,29983,38510,3,26,15,1,0,0,0,8,339,70,27633,29036,35423,1,1,15,2561,2,947,3087,0,0,2,0,-3
EUN1_3573648657',1,24,21,1,1,1,0,10,1,339,98,31191,31368,38077,3,22,12,0,0,0,0,4,322,74,25802,27747,34464,1,17,24,5389,9,3621,3613,1,1,1,0,6
EUN1_3573632700',3,31,10,1,0,0,0,8,1,312,84,24304,27287,26949,8,152,15,1,0,0,0,1,331,92,27503,30708,34138,0,-19,-8,-3199,-5,-3421,-7189,0,0,0,0,7
EUN1_3573613004',0,24,9,2,0,0,0,2,1,413,98,27672,30848,30405,4,27,8,0,0,0,0,5,333,106,24856,28623,21379,1,80,-8,2816,1,2225,9026,2,0,0,0,-3
EUN1_3573604599',4,35,14,0,0,1,0,12,1,347,100,29273,31219,25250,2,27,11,1,0,0,0,4,383,83,26827,30029,23155,1,-36,17,2446,3,1190,2095,-1,0,1,0,8
EUN1_3573764621',2,148,18,0,1,2,0,9,1,383,72,31540,31754,36176,5,25,7,1,0,0,0,5,316,88,24467,27021,30211,1,67,-16,7073,11,4733,5965,-1,1,2,0,4
EUN1_3573244061',6,48,16,2,0,3,0,6,0,346,98,29488,29803,33579,4,29,6,0,0,1,0,6,335,102,24688,27872,20856,1,11,-4,4800,10,1931,12723,2,0,2,0,0
EUN1_3572712092',2,138,5,1,0,0,0,10,1,365,92,23609,29412,25715,6,31,8,1,0,1,0,1,373,96,26225,30754,24675,0,-8,-4,-2616,-3,-1342,1040,0,0,-1,0,9
EUN1_3574213333',9,40,6,0,0,0,0,4,1,383,108,25451,30141,20015,7,31,6,1,0,0,0,3,388,96,24540,29287,20645,0,-5,12,911,0,854,-630,-1,0,0,0,1
EUN1_3573366892',2,17,5,0,0,0,0,12,1,322,15,20773,23042,21083,2,30,21,2,0,2,0,2,377,100,31024,32701,37431,0,-55,-85,-10251,-16,-9659,-16348,-2,0,-2,0,10
EUN1_3571948970',4,29,9,0,0,1,0,7,0,399,110,27475,32493,37317,4,29,6,2,0,0,0,5,378,82,24452,30340,27827,1,21,28,3023,3,2153,9490,-2,0,1,0,2
EUN1_3571937809',4,41,10,0,0,0,0,10,1,341,96,26708,26314,23152,5,30,17,2,0,2,0,2,279,108,28174,28474,28229,1,62,-12,-1466,-7,-2160,-5077,-2,0,-2,0,8
EUN1_3571921948',3,24,12,1,0,2,0,2,1,353,78,28058,28570,28582,1,36,8,0,1,0,0,8,331,89,24071,28265,28842,1,22,-11,3987,4,305,-260,1,-1,2,0,-6
EUN1_3571920255',3,34,8,1,0,1,0,8,1,359,100,27411,28885,20224,4,21,9,0,0,1,0,8,367,80,25403,28803,21411,1,-8,20,2008,-1,82,-1187,1,0,0,0,0
EUN1_3571738275',4,35,11,1,0,1,0,10,0,331,94,27631,29411,26548,5,27,6,1,0,1,0,4,336,96,24447,27735,23730,1,-5,-2,3184,5,1676,2818,0,0,0,0,6
EUN1_3571714167',4,26,12,0,0,0,0,13,0,323,92,25349,28813,25174,0,23,7,1,1,2,0,3,381,116,27285,30101,21882,0,-58,-24,-1936,5,-1288,3292,-1,-1,-2,0,10
EUN1_3571662063',5,34,12,1,0,1,0,8,0,343,78,26992,27675,27685,7,28,11,1,0,0,0,4,345,86,26052,28576,28382,1,-2,-8,940,1,-901,-697,0,0,1,0,4
EUN1_3571631323',4,132,9,0,0,0,0,7,0,361,84,25248,28793,23355,5,99,9,2,1,1,0,1,415,124,28065,32321,22652,0,-54,-40,-2817,0,-3528,703,-2,-1,-1,0,6
EUN1_3571132226',2,28,15,1,0,0,0,7,1,394,102,30281,33063,32444,4,22,10,1,1,2,0,6,362,102,26823,29641,17639,1,32,0,3458,5,3422,14805,0,-1,-2,0,1
EUN1_3571091825',3,25,11,0,0,0,0,16,0,334,79,25696,28373,33085,6,28,18,1,0,3,0,1,302,92,31185,29275,38153,0,32,-13,-5489,-7,-902,-5068,-1,0,-3,0,15
EUN1_3571064505',2,27,17,1,0,1,0,12,0,292,92,29438,29312,36543,2,31,22,0,0,3,0,3,365,96,33004,32302,41484,0,-73,-4,-3566,-5,-2990,-4941,1,0,-2,0,9
EUN1_3571024122',3,28,19,2,0,2,0,5,0,333,100,30581,28276,39736,3,38,9,0,0,1,0,7,353,72,26968,29742,36108,1,-20,28,3613,10,-1466,3628,2,0,1,0,-2
EUN1_3570800469',6,80,12,0,0,1,0,10,1,381,115,30224,30699,28827,4,100,9,1,1,3,0,7,358,91,26573,31136,24530,0,23,24,3651,3,-437,4297,-1,-1,-2,0,3
EUN1_3570770037',3,28,14,1,1,0,0,11,1,367,95,28567,30699,30071,3,37,4,1,0,0,0,0,338,96,22649,26577,22624,1,29,-1,5918,10,4122,7447,0,1,0,0,11
EUN1_3570754542',1,41,18,1,0,0,0,11,0,366,96,30247,32634,37129,5,31,14,1,1,1,0,2,352,98,28788,30167,32312,1,14,-2,1459,4,2467,4817,0,-1,-1,0,9
EUN1_3570728013',4,47,13,1,0,1,0,15,1,362,82,28471,29865,38297,3,198,16,0,0,1,0,2,365,74,29716,31220,42900,0,-3,8,-1245,-3,-1355,-4603,1,0,0,0,13
EUN1_3568834903',3,88,12,0,0,1,0,9,0,333,112,27637,29640,33834,2,23,13,2,0,2,0,3,361,80,29105,31388,37927,0,-28,32,-1468,-1,-1748,-4093,-2,0,-1,0,6
EUN1_3568767713',0,20,8,0,0,0,0,16,0,302,70,23367,25988,31878,4,28,22,1,1,2,0,1,325,118,33354,31492,44197,0,-23,-48,-9987,-14,-5504,-12319,-1,-1,-2,0,15
EUN1_3568729748',7,90,20,2,0,1,0,16,1,354,102,31027,33024,37107,2,24,8,0,0,1,0,4,359,97,27168,30537,27855,1,-5,5,3859,12,2487,9252,2,0,0,0,12
EUN1_3568626845',8,101,9,1,1,0,0,6,0,356,88,25301,28424,27247,1,24,6,0,0,0,0,0,371,92,24643,29253,20748,0,-15,-4,658,3,-829,6499,1,1,0,0,6
EUN1_3568613102',1,16,12,0,0,1,0,9,1,294,65,28030,26884,36963,4,79,22,1,1,1,0,5,273,86,30397,29076,40253,0,21,-21,-2367,-10,-2192,-3290,-1,-1,0,0,4
EUN1_3568585388',6,110,5,0,0,1,0,7,0,355,106,25139,28890,19806,1,20,6,2,0,0,0,5,336,100,24032,27289,23427,1,19,6,1107,-1,1601,-3621,-2,0,1,0,2
EUN1_3568545736',5,101,12,2,0,0,0,4,1,367,103,27435,29666,29243,3,24,7,0,0,0,0,2,400,92,25106,29135,19984,1,-33,11,2329,5,531,9259,2,0,0,0,2
EUN1_3568297196',2,28,8,0,0,1,0,9,0,365,98,26877,29390,30893,6,89,21,2,0,1,0,2,328,98,31239,32069,39741,0,37,0,-4362,-13,-2679,-8848,-2,0,0,0,7
EUN1_3568244168',3,29,11,2,0,0,0,8,1,347,68,25629,28054,31918,3,106,16,0,0,2,0,1,325,104,29869,30542,40526,0,22,-36,-4240,-5,-2488,-8608,2,0,-2,0,7
EUN1_3568182067',4,37,14,1,0,0,0,10,1,349,85,28572,27739,28493,2,122,19,0,1,2,0,2,317,74,29673,29061,32823,0,32,11,-1101,-5,-1322,-4330,1,-1,-2,0,8
EUN1_3568161796',4,68,7,0,0,1,0,7,0,372,109,26968,30922,30669,2,216,15,1,0,1,0,4,320,90,27243,32144,35323,0,52,19,-275,-8,-1222,-4654,-1,0,0,0,3
EUN1_3567874205',2,22,12,0,0,1,0,9,1,370,70,27876,29509,33722,2,95,11,1,0,0,0,3,329,81,25709,28422,39226,1,41,-11,2167,1,1087,-5504,-1,0,1,0,6
EUN1_3567845812',4,32,11,0,1,0,0,11,1,340,98,27538,30731,31966,2,111,10,1,0,2,0,1,359,64,26696,28689,32875,0,-19,34,842,1,2042,-909,-1,1,-2,0,10
EUN1_3567690649',4,64,12,0,0,0,0,10,0,317,104,26890,28889,29850,4,102,15,2,0,2,0,4,374,78,30014,30516,28049,1,-57,26,-3124,-3,-1627,1801,-2,0,-2,0,6
EUN1_3567666753',1,133,11,0,0,1,0,11,0,361,84,27978,29951,32458,10,194,10,2,0,2,0,3,325,96,25838,27975,32365,0,36,-12,2140,1,1976,93,-2,0,-1,0,8
EUN1_3567650680',7,23,4,0,0,0,0,11,0,319,76,22999,25307,29749,2,92,14,2,0,0,0,4,348,90,27169,27927,30549,0,-29,-14,-4170,-10,-2620,-800,-2,0,0,0,7
EUN1_3567639482',6,31,17,0,0,1,0,14,0,346,66,30884,29318,37705,2,198,13,1,0,2,0,7,299,101,28703,26775,35434,0,47,-35,2181,4,2543,2271,-1,0,-1,0,7
EUN1_3575883973',5,24,14,1,1,1,0,6,1,333,102,30606,31423,33195,3,29,11,1,0,0,0,8,338,82,26196,28251,32554,1,-5,20,4410,3,3172,641,0,1,1,0,-2
EUN1_3575862448',3,25,18,0,0,0,0,5,0,304,80,28331,28504,33553,2,28,20,2,0,0,0,3,299,92,29080,27862,41218,0,5,-12,-749,-2,642,-7665,-2,0,0,0,2
EUN1_3575844347',1,106,16,0,0,0,0,4,0,336,94,28854,32064,34484,4,25,12,2,0,0,0,2,358,102,26629,30533,31270,1,-22,-8,2225,4,1531,3214,-2,0,0,0,2
EUN1_3575829140',4,140,11,0,0,0,0,8,1,276,66,24963,26194,32130,2,33,17,1,0,1,0,3,338,102,27980,30181,35798,0,-62,-36,-3017,-6,-3987,-3668,-1,0,-1,0,5
EUN1_3575807454',6,31,18,1,0,0,0,6,1,331,116,30491,32588,34546,1,29,11,1,0,2,0,6,354,78,27278,30032,33167,0,-23,38,3213,7,2556,1379,0,0,-2,0,0
EUN1_3574093579',3,26,15,0,0,0,0,7,0,321,86,27026,28074,34559,6,56,14,1,0,0,0,5,322,78,26976,30164,37560,0,-1,8,50,1,-2090,-3001,-1,0,0,0,2
EUN1_3573624326',4,28,12,0,0,1,0,10,1,300,92,27853,28052,23474,6,27,16,2,0,0,0,5,329,79,27876,27346,37832,0,-29,13,-23,-4,706,-14358,-2,0,1,0,5
EUN1_3573603819',4,130,7,1,0,0,0,10,1,339,76,24593,26165,26481,4,34,19,1,1,2,0,2,354,92,31818,31003,33906,0,-15,-16,-7225,-12,-4838,-7425,0,-1,-2,0,8
EUN1_3572210310',4,27,8,2,0,0,0,10,1,351,88,24883,28034,26200,3,25,15,0,0,1,0,1,369,88,28796,29791,37448,1,-18,0,-3913,-7,-1757,-11248,2,0,-1,0,9
EUN1_3572179827',4,21,10,2,0,0,0,13,0,338,99,25489,28241,29510,3,22,13,0,0,1,0,3,347,80,27761,30388,42401,0,-9,19,-2272,-3,-2147,-12891,2,0,-1,0,10
EUN1_3572084826',4,26,11,1,0,0,0,14,1,353,80,27421,29161,34645,4,21,18,1,0,2,0,5,331,92,29982,30381,42775,1,22,-12,-2561,-7,-1220,-8130,0,0,-2,0,9
EUN1_3572060886',5,32,11,1,0,1,0,6,1,315,104,27332,28472,27738,8,97,12,0,0,0,0,3,373,80,26762,28830,29533,1,-58,24,570,-1,-358,-1795,1,0,1,0,3
EUN1_3572047597',2,24,16,1,0,1,0,5,1,376,80,29354,31357,39729,1,28,7,1,0,0,0,5,335,76,23046,27297,30881,1,41,4,6308,9,4060,8848,0,0,1,0,0
EUN1_3570898128',3,27,15,0,0,1,0,7,1,367,84,28427,29938,34566,1,31,8,1,0,0,0,4,358,68,24008,27027,21215,1,9,16,4419,7,2911,13351,-1,0,1,0,3
EUN1_3570864577',4,95,13,2,0,0,0,4,0,352,104,27094,30750,32819,4,28,9,0,0,1,0,1,299,80,23063,28591,30551,1,53,24,4031,4,2159,2268,2,0,-1,0,3
EUN1_3570829815',7,41,26,2,0,1,0,9,1,335,90,34240,28836,41042,6,47,11,0,0,1,0,8,322,74,25676,25607,34249,1,13,16,8564,15,3229,6793,2,0,0,0,1
EUN1_3570709993',3,24,6,0,0,0,0,3,1,379,80,24128,28850,22611,4,74,9,2,0,0,0,1,322,80,24662,28851,26244,1,57,0,-534,-3,-1,-3633,-2,0,0,0,2
EUN1_3570701169',5,30,8,1,0,0,0,16,0,326,79,23563,26466,25246,3,27,18,1,1,2,0,2,376,108,31429,32438,30298,0,-50,-29,-7866,-10,-5972,-5052,0,-1,-2,0,14
EUN1_3570447059',3,26,14,2,0,1,0,4,1,344,88,27930,30083,30751,1,22,7,0,0,0,0,2,337,80,23842,27727,28564,1,7,8,4088,7,2356,2187,2,0,1,0,2
EUN1_3570421372',2,34,15,0,0,0,0,12,0,304,86,27812,28773,29402,5,32,20,2,0,1,0,1,368,70,31116,31240,44570,0,-64,16,-3304,-5,-2467,-15168,-2,0,-1,0,11
EUN1_3570135084',4,32,9,0,0,0,0,9,1,342,67,25033,27852,31390,1,171,15,1,1,2,0,2,390,132,31535,33540,35364,0,-48,-65,-6502,-6,-5688,-3974,-1,-1,-2,0,7
EUN1_3570101877',4,28,11,2,0,1,0,6,1,335,76,25964,29456,30910,3,33,8,0,0,0,0,4,326,64,24458,28127,25136,0,9,12,1506,3,1329,5774,2,0,1,0,2
EUN1_3570080776',2,27,7,0,0,0,0,12,0,356,94,24779,28504,29382,2,27,16,2,0,1,0,3,405,106,30455,31501,33101,0,-49,-12,-5676,-9,-2997,-3719,-2,0,-1,0,9
EUN1_3570065524',3,23,11,0,0,0,0,10,0,302,86,25119,28438,29982,7,34,20,2,0,2,0,1,345,94,30690,30929,36745,0,-43,-8,-5571,-9,-2491,-6763,-2,0,-2,0,9
EUN1_3570060266',2,16,5,0,0,0,0,14,0,283,87,22186,24314,31346,1,88,33,2,0,3,0,1,306,88,35234,31735,50218,0,-23,-1,-13048,-28,-7421,-18872,-2,0,-3,0,13
EUN1_3570042364',4,37,27,2,0,1,0,9,1,341,92,34161,33782,45336,3,25,9,0,0,0,0,5,309,80,25401,27606,30439,1,32,12,8760,18,6176,14897,2,0,1,0,4
EUN1_3576031439',6,238,14,1,0,1,0,4,0,336,86,28914,29291,37369,8,34,16,0,0,1,0,5,309,78,27715,27672,34641,0,27,8,1199,-2,1619,2728,1,0,0,0,-1
EUN1_3575995821',7,27,2,0,0,0,0,9,0,391,77,22410,28937,17995,6,42,10,1,0,1,0,1,415,92,27297,31754,23232,0,-24,-15,-4887,-8,-2817,-5237,-1,0,-1,0,8
EUN1_3575936812',4,30,5,0,0,0,0,8,0,370,82,23625,27012,18155,3,25,11,2,0,0,0,0,378,89,26526,28811,29495,0,-8,-7,-2901,-6,-1799,-11340,-2,0,0,0,8
EUN1_3575871679',2,22,6,1,0,0,0,17,0,369,86,23944,28576,34711,4,141,17,0,0,3,0,1,344,102,31879,31722,32683,0,25,-16,-7935,-11,-3146,2028,1,0,-3,0,16
EUN1_3575845833',4,32,7,0,0,1,0,8,1,364,104,26692,28356,29104,4,25,9,2,0,1,0,3,402,76,26498,31310,27054,0,-38,28,194,-2,-2954,2050,-2,0,0,0,5
EUN1_3575822375',3,21,22,1,0,1,0,10,1,321,82,31060,28393,42022,6,29,18,1,0,0,0,4,315,82,29641,30712,45242,1,6,0,1419,4,-2319,-3220,0,0,1,0,6
EUN1_3575808300',2,46,10,0,0,0,0,10,0,316,89,26497,29364,28906,4,28,21,2,0,1,0,2,332,98,30300,31307,37562,0,-16,-9,-3803,-11,-1943,-8656,-2,0,-1,0,8
EUN1_3575694058',1,24,23,0,0,1,0,7,1,314,100,30927,29968,45108,8,28,19,2,0,1,0,3,282,80,28241,27703,38891,0,32,20,2686,4,2265,6217,-2,0,0,0,4
EUN1_3575692793',5,39,10,2,0,0,0,7,0,346,92,25496,29451,28987,5,31,8,0,0,0,0,1,370,107,25951,30135,32137,1,-24,-15,-455,2,-684,-3150,2,0,0,0,6
EUN1_3575692495',2,29,22,2,0,1,0,9,1,338,92,32279,31230,40704,1,20,11,0,0,1,0,6,298,83,26638,28307,32239,1,40,9,5641,11,2923,8465,2,0,0,0,3
EUN1_3573652112',1,29,16,1,0,0,0,8,0,351,103,29870,30626,36636,5,29,17,1,0,0,0,5,359,74,28335,30905,30430,1,-8,29,1535,-1,-279,6206,0,0,0,0,3
EUN1_3573586348',2,23,16,1,0,1,0,12,0,347,90,30875,31546,28267,0,20,16,1,0,0,0,4,360,104,30037,31289,36855,0,-13,-14,838,0,257,-8588,0,0,1,0,8
EUN1_3573579524',4,29,14,2,1,3,0,6,1,330,116,30370,30555,43950,5,21,12,0,0,0,0,11,244,68,22653,23199,31881,1,86,48,7717,2,7356,12069,2,1,3,0,-5
EUN1_3573555893',5,31,13,2,0,0,0,7,0,345,96,27412,29613,30862,3,20,16,0,1,0,0,3,390,88,29401,32584,41181,0,-45,8,-1989,-3,-2971,-10319,2,-1,0,0,4
EUN1_3573529307',7,22,8,1,1,0,0,8,0,368,86,27544,30719,34656,3,30,12,1,0,1,0,7,327,78,26459,31231,28540,0,41,8,1085,-4,-512,6116,0,1,-1,0,1
EUN1_3571494614',5,28,8,0,0,0,0,11,0,351,88,24442,27873,29891,4,24,15,2,1,2,0,0,338,104,28392,31216,30144,0,13,-16,-3950,-7,-3343,-253,-2,-1,-2,0,11
EUN1_3571477961',2,32,15,2,0,1,0,11,1,271,98,29126,26470,40904,4,79,23,0,0,1,0,5,354,70,31821,30294,45176,1,-83,28,-2695,-8,-3824,-4272,2,0,0,0,6
EUN1_3571468173',8,36,14,1,0,1,0,9,1,383,94,27423,32159,36764,2,30,4,1,0,1,0,2,358,94,24717,28156,20742,1,25,0,2706,10,4003,16022,0,0,0,0,7
EUN1_3570625792',6,22,17,0,0,0,0,9,0,334,74,28371,29088,36398,4,30,14,1,0,2,0,4,366,79,29499,28364,36464,0,-32,-5,-1128,3,724,-66,-1,0,-2,0,5
EUN1_3575427425',1,33,13,0,0,1,0,5,0,382,104,28900,30721,31859,5,30,10,2,1,0,0,1,357,88,26320,29256,23138,1,25,16,2580,3,1465,8721,-2,-1,1,0,4
EUN1_3574752786',3,23,8,0,0,0,0,8,0,291,116,24915,27487,27214,1,91,15,2,0,1,0,4,353,96,29449,30094,41420,0,-62,20,-4534,-7,-2607,-14206,-2,0,-1,0,4
EUN1_3574671739',7,29,14,0,1,0,0,12,0,306,93,27677,28662,39868,4,30,19,2,0,1,0,1,293,86,28818,28729,44922,0,13,7,-1141,-5,-67,-5054,-2,1,-1,0,11
EUN1_3574654054',3,29,9,1,1,0,0,6,1,388,84,27574,30667,30762,2,24,12,1,0,1,0,6,339,82,26395,29566,29086,0,49,2,1179,-3,1101,1676,0,1,-1,0,0
EUN1_3574305394',6,32,13,2,0,0,0,11,0,360,109,27349,28923,32740,6,30,20,0,0,1,0,2,320,86,30708,31045,37175,1,40,23,-3359,-7,-2122,-4435,2,0,-1,0,9
EUN1_3574104526',4,61,14,1,0,1,0,10,1,354,89,29026,30795,32311,2,53,9,0,0,0,0,3,356,92,24796,26576,23254,1,-2,-3,4230,5,4219,9057,1,0,1,0,7
EUN1_3573889205',3,29,12,1,0,0,0,11,0,364,96,26484,30095,31692,8,34,9,1,0,0,0,3,384,72,27549,29911,34606,1,-20,24,-1065,3,184,-2914,0,0,0,0,8
EUN1_3573852276',2,307,18,2,0,0,0,9,1,304,84,27387,28404,38539,1,18,8,0,0,1,0,2,291,80,24420,26184,33227,0,13,4,2967,10,2220,5312,2,0,-1,0,7
EUN1_3573700516',5,23,10,1,1,0,0,6,0,371,80,26457,30424,30891,1,28,8,1,0,0,0,1,397,97,26443,30703,26740,0,-26,-17,14,2,-279,4151,0,1,0,0,5
EUN1_3573678023',6,28,10,1,0,0,0,3,0,372,87,25331,29139,35331,3,31,9,1,0,0,0,4,343,80,25178,29472,24591,0,29,7,153,1,-333,10740,0,0,0,0,-1
EUN1_3573665423',5,27,13,1,0,0,0,14,0,347,87,27586,27717,36974,3,25,15,0,0,0,0,2,379,74,29448,30293,39664,1,-32,13,-1862,-2,-2576,-2690,1,0,0,0,12
EUN1_3573613581',3,32,10,0,0,0,0,5,1,344,99,25844,26617,35497,7,81,15,2,0,1,0,4,346,72,27424,28657,31382,0,-2,27,-1580,-5,-2040,4115,-2,0,-1,0,1
EUN1_3572546633',3,28,16,2,0,1,0,10,0,308,98,28033,27959,32431,3,140,4,0,0,0,0,3,367,90,24188,28393,25425,1,-59,8,3845,12,-434,7006,2,0,1,0,7
EUN1_3572521028',5,32,14,1,0,0,0,14,0,321,104,28436,30837,31777,4,32,17,1,0,1,0,1,377,98,31006,31261,37612,0,-56,6,-2570,-3,-424,-5835,0,0,-1,0,13
EUN1_3575417124',3,35,3,1,0,0,0,11,1,343,80,22414,26655,33419,2,30,14,1,0,0,0,1,383,104,28228,31331,32223,0,-40,-24,-5814,-11,-4676,1196,0,0,0,0,10
EUN1_3575389403',2,19,10,0,0,1,0,10,0,382,76,27480,30072,31049,2,22,11,1,0,1,0,6,350,108,27897,31627,34644,0,32,-32,-417,-1,-1555,-3595,-1,0,0,0,4
EUN1_3575369378',5,24,11,2,1,0,0,7,1,391,88,26951,30213,32295,2,26,4,0,0,2,0,4,323,86,22918,28096,24137,1,68,2,4033,7,2117,8158,2,1,-2,0,3
EUN1_3574866634',4,20,18,0,0,1,0,5,1,382,104,31947,32398,39442,2,30,8,2,0,0,0,6,358,84,25006,29198,28233,1,24,20,6941,10,3200,11209,-2,0,1,0,-1
EUN1_3574688308',5,28,13,0,0,0,0,9,1,314,84,26229,29831,27771,2,26,17,1,0,1,0,2,354,100,29873,30528,39254,1,-40,-16,-3644,-4,-697,-11483,-1,0,-1,0,7
EUN1_3574638459',6,29,6,0,0,1,0,6,0,295,73,23838,27336,35352,3,48,14,1,0,0,0,3,307,94,25602,31157,39019,1,-12,-21,-1764,-8,-3821,-3667,-1,0,1,0,3
EUN1_3574633345',4,61,16,1,0,1,0,4,1,403,115,30980,32323,37823,8,31,7,1,0,0,0,5,328,55,22793,26622,30062,1,75,60,8187,9,5701,7761,0,0,1,0,-1
EUN1_3574395338',5,33,10,0,0,1,0,4,1,411,99,29318,31717,32060,0,25,3,1,0,1,0,6,362,87,22437,28178,24227,1,49,12,6881,7,3539,7833,-1,0,0,0,-2
EUN1_3574240649',4,24,8,2,0,0,0,13,0,354,81,24544,29110,30390,2,27,16,0,1,2,0,0,392,114,30694,33933,35821,0,-38,-33,-6150,-8,-4823,-5431,2,-1,-2,0,13
EUN1_3574135967',4,61,6,0,0,0,0,12,0,371,96,25631,31393,25494,6,60,11,2,0,2,0,3,376,104,27822,30557,29243,0,-5,-8,-2191,-5,836,-3749,-2,0,-2,0,9
EUN1_3574118731',8,91,15,1,0,1,0,13,0,301,76,28345,28515,33561,5,34,18,1,0,1,0,6,336,88,30784,29476,37147,0,-35,-12,-2439,-3,-961,-3586,0,0,0,0,7
EUN1_3573886573',0,27,11,0,0,0,0,9,1,373,71,27178,30153,27852,6,50,22,2,0,1,0,4,341,108,32212,32396,40602,0,32,-37,-5034,-11,-2243,-12750,-2,0,-1,0,5
EUN1_3573851938',5,71,16,0,0,0,0,12,1,319,78,27915,27057,40023,3,64,19,2,0,2,0,1,361,90,31885,31628,41477,0,-42,-12,-3970,-3,-4571,-1454,-2,0,-2,0,11
EUN1_3573839101',1,133,11,1,1,0,0,8,0,319,116,26100,29190,29234,5,35,13,1,0,0,0,0,389,76,27698,29753,28978,1,-70,40,-1598,-2,-563,256,0,1,0,0,8
EUN1_3573807592',2,24,23,1,1,1,0,6,1,328,111,32828,30282,39560,1,22,16,0,0,0,0,8,279,68,27492,25467,38085,1,49,43,5336,7,4815,1475,1,1,1,0,-2
EUN1_3573282482',1,33,8,2,0,0,0,6,1,410,92,27384,30017,30263,0,21,9,0,0,0,0,5,362,86,25177,30434,29109,1,48,6,2207,-1,-417,1154,2,0,0,0,1
EUN1_3573253814',9,31,10,1,0,0,0,8,1,380,96,27915,30040,27683,3,32,9,1,0,2,0,5,352,76,25919,29416,25170,1,28,20,1996,1,624,2513,0,0,-2,0,3
EUN1_3575887269',4,25,6,1,0,0,0,7,1,333,98,22813,27088,36113,3,25,16,1,0,0,0,2,336,83,28241,29915,32142,0,-3,15,-5428,-10,-2827,3971,0,0,0,0,5
EUN1_3575170671',2,22,10,1,0,1,0,11,1,342,103,26511,30110,25159,7,31,6,0,0,1,0,5,382,68,24841,28802,23133,1,-40,35,1670,4,1308,2026,1,0,0,0,6
EUN1_3574845031',3,30,14,1,0,1,0,7,1,353,96,27628,30082,39642,2,48,11,0,0,0,0,2,347,92,26314,30371,31343,1,6,4,1314,3,-289,8299,1,0,1,0,5
EUN1_3574201910',6,22,12,1,0,0,0,10,0,341,76,27158,29252,32287,6,23,13,1,0,1,0,4,369,64,28007,29726,33152,0,-28,12,-849,-1,-474,-865,0,0,-1,0,6
EUN1_3573765546',6,31,9,1,0,0,0,12,0,362,92,25805,29477,25713,4,29,6,1,0,1,0,1,376,100,26003,28691,22966,0,-14,-8,-198,3,786,2747,0,0,-1,0,11
EUN1_3573046567',4,62,11,1,0,0,0,10,1,336,107,26928,30080,23974,4,29,7,1,0,0,0,2,367,80,24857,29069,21578,1,-31,27,2071,4,1011,2396,0,0,0,0,8
EUN1_3573031777',1,34,13,1,1,1,0,5,0,351,88,28300,30477,27600,4,26,19,0,0,0,0,2,354,80,28601,30157,36943,0,-3,8,-301,-6,320,-9343,1,1,1,0,3
EUN1_3573017071',5,163,17,2,0,2,0,2,1,393,90,30914,30903,30273,4,25,3,0,0,1,0,11,328,102,22138,27717,18475,1,65,-12,8776,14,3186,11798,2,0,1,0,-9
EUN1_3572929827',8,31,9,1,0,1,0,12,0,343,67,25740,29121,25731,7,32,14,1,0,2,0,3,348,129,29403,32139,39582,0,-5,-62,-3663,-5,-3018,-13851,0,0,-1,0,9
EUN1_3575494817',5,51,21,1,0,1,0,10,1,327,68,30937,29646,37458,1,26,13,1,0,1,0,6,348,91,29121,30209,37418,0,-21,-23,1816,8,-563,40,0,0,0,0,4
EUN1_3575465446',1,19,9,1,0,2,0,13,0,379,111,28428,31091,32038,5,23,11,1,0,0,0,5,332,97,27630,30707,21488,0,47,14,798,-2,384,10550,0,0,2,0,8
EUN1_3575428869',6,135,12,0,1,1,0,10,1,410,84,30509,31064,29393,3,22,8,2,0,1,0,8,402,95,27453,29118,24480,1,8,-11,3056,4,1946,4913,-2,1,0,0,2
EUN1_3575412507',3,22,7,0,0,0,0,11,0,374,88,25782,27785,19378,3,29,12,2,1,2,0,3,398,104,28702,30720,28080,0,-24,-16,-2920,-5,-2935,-8702,-2,-1,-2,0,8
EUN1_3575391525',2,187,24,0,0,2,0,7,0,366,107,33761,31842,35676,3,58,13,2,0,0,0,5,292,65,26327,27453,34691,1,74,42,7434,11,4389,985,-2,0,2,0,2
EUN1_3575373638',4,23,11,1,0,0,0,14,0,335,76,24780,28053,29580,6,68,22,1,0,4,0,3,349,88,35003,33485,46225,0,-14,-12,-10223,-11,-5432,-16645,0,0,-4,0,11
EUN1_3575349988',8,34,13,2,0,0,0,11,0,289,95,25691,28789,30677,1,30,17,0,0,1,0,0,352,84,28940,29401,38942,1,-63,11,-3249,-4,-612,-8265,2,0,-1,0,11
EUN1_3574946509',0,85,3,0,0,0,0,12,0,327,82,23072,26720,26844,2,27,20,2,1,2,0,2,356,94,32631,31111,34614,0,-29,-12,-9559,-17,-4391,-7770,-2,-1,-2,0,10
EUN1_3574839113',2,63,17,2,0,1,0,11,1,336,96,30045,29827,35673,1,25,11,0,0,0,0,5,325,88,26439,28816,34107,1,11,8,3606,6,1011,1566,2,0,1,0,6
EUN1_3576085481',4,30,4,1,0,0,0,6,0,332,78,22598,26887,20542,7,34,14,1,0,1,0,0,378,75,28284,30199,29335,0,-46,3,-5686,-10,-3312,-8793,0,0,-1,0,6
EUN1_3576059822',3,32,10,1,0,0,0,5,1,339,82,26555,29941,29047,7,32,14,0,0,1,0,4,360,90,26607,32194,32941,0,-21,-8,-52,-4,-2253,-3894,1,0,-1,0,1
EUN1_3576026793',2,26,15,0,0,0,0,9,0,317,94,27121,29273,37003,5,29,19,1,0,1,0,0,313,78,30357,29522,44185,0,4,16,-3236,-4,-249,-7182,-1,0,-1,0,9
EUN1_3575893779',2,23,8,0,0,0,0,9,0,349,88,25128,27436,31903,5,31,20,1,0,0,0,2,340,84,29455,30127,33191,0,9,4,-4327,-12,-2691,-1288,-1,0,0,0,7
EUN1_3575876346',4,22,11,0,0,1,0,13,0,322,75,28005,27674,31350,2,17,16,2,0,1,0,5,350,100,28862,32290,31306,0,-28,-25,-857,-5,-4616,44,-2,0,0,0,8
EUN1_3575851419',3,43,12,1,0,0,0,7,0,316,74,26766,27100,32274,6,33,13,1,0,1,0,5,305,87,27183,28125,35138,1,11,-13,-417,-1,-1025,-2864,0,0,-1,0,2
EUN1_3575828989',4,31,17,2,0,0,0,8,1,382,108,28927,33749,36997,2,29,8,0,0,0,0,5,345,72,25397,28376,33356,1,37,36,3530,9,5373,3641,2,0,0,0,3
EUN1_3575807769',2,55,20,2,0,1,0,7,0,329,123,32986,33385,33433,5,27,8,0,0,2,0,10,327,64,23257,26996,30140,1,2,59,9729,12,6389,3293,2,0,-1,0,-3
EUN1_3575789782',3,20,8,1,0,0,0,9,0,340,80,24220,29436,23746,5,40,9,1,0,0,0,0,377,82,25211,28344,24490,1,-37,-2,-991,-1,1092,-744,0,0,0,0,9
EUN1_3575462633',3,27,9,2,0,1,0,10,1,390,74,26514,28976,18752,5,31,8,0,0,1,0,3,382,98,26548,30204,29759,1,8,-24,-34,1,-1228,-11007,2,0,0,0,7
EUN1_3575082331',1,18,16,2,0,0,0,6,1,331,86,27968,28198,39110,5,29,7,0,0,0,0,3,322,90,23891,26838,34201,1,9,-4,4077,9,1360,4909,2,0,0,0,3
EUN1_3575064668',1,29,19,1,0,2,0,7,0,340,108,31078,29160,41780,1,27,12,0,0,0,0,6,305,60,26390,27015,28916,1,35,48,4688,7,2145,12864,1,0,2,0,1
EUN1_3575049567',5,24,7,0,0,0,0,5,1,356,101,26022,27634,33522,4,29,16,2,0,2,0,5,343,94,28707,30126,30640,0,13,7,-2685,-9,-2492,2882,-2,0,-2,0,0
EUN1_3575972173',2,29,10,0,0,1,0,11,0,326,85,27305,27820,36259,6,238,23,2,0,0,0,6,351,86,31833,31826,46348,0,-25,-1,-4528,-13,-4006,-10089,-2,0,1,0,5
EUN1_3575931054',3,25,8,0,0,0,0,11,1,281,74,23382,25613,30047,3,25,17,2,0,2,0,1,371,96,29778,31498,40054,0,-90,-22,-6396,-9,-5885,-10007,-2,0,-2,0,10
EUN1_3575914505',2,30,14,1,0,1,0,7,0,371,70,29195,28912,31949,3,29,16,1,0,0,0,3,333,82,28392,28966,39188,0,38,-12,803,-2,-54,-7239,0,0,1,0,4
EUN1_3575882613',1,21,12,0,0,0,0,7,0,350,94,27777,30103,30786,7,75,16,1,0,0,0,4,382,76,29002,30589,36359,0,-32,18,-1225,-4,-486,-5573,-1,0,0,0,3
EUN1_3575870392',6,38,12,1,0,2,0,13,1,349,86,31675,28642,28146,5,28,18,1,0,3,0,9,249,74,28536,24245,38471,1,100,12,3139,-6,4397,-10325,0,0,-1,0,4
EUN1_3575833018',2,17,12,0,0,0,0,9,1,317,68,25928,27820,27994,1,23,16,1,0,2,0,3,381,96,31214,31748,37900,0,-64,-28,-5286,-4,-3928,-9906,-1,0,-2,0,6
EUN1_3575231823',1,22,14,0,0,0,0,9,0,341,104,28474,30320,37040,8,31,18,2,0,1,0,0,314,64,27935,28544,36067,1,27,40,539,-4,1776,973,-2,0,-1,0,9
EUN1_3575212725',3,23,17,1,0,0,0,9,1,336,78,27480,30351,34411,5,24,11,0,0,1,0,0,323,97,27210,29991,34390,1,13,-19,270,6,360,21,1,0,-1,0,9
EUN1_3574901537',2,21,8,1,0,0,0,14,0,297,81,24156,26579,25940,3,30,16,1,0,2,0,4,340,86,29343,30619,34043,0,-43,-5,-5187,-8,-4040,-8103,0,0,-2,0,10
EUN1_3574875262',6,24,20,1,0,1,0,10,0,323,95,30735,31369,34943,7,62,17,0,0,0,0,4,336,84,28530,30758,46510,0,-13,11,2205,3,611,-11567,1,0,1,0,6
EUN1_3574716553',4,150,11,1,0,1,0,5,0,392,96,27195,32078,30990,2,29,5,0,0,0,0,3,354,87,23415,27697,29598,1,38,9,3780,6,4381,1392,1,0,1,0,2
EUN1_3574696071',2,26,22,0,0,1,0,9,1,300,93,32220,31679,44598,3,26,14,2,1,0,0,6,263,98,25884,27190,42270,1,37,-5,6336,8,4489,2328,-2,-1,1,0,3
EUN1_3574318685',5,32,15,1,0,1,0,11,0,339,88,28575,30578,40362,4,26,11,0,0,2,0,4,367,80,28792,30350,31718,0,-28,8,-217,4,228,8644,1,0,-1,0,7
EUN1_3574298169',3,29,18,0,0,1,0,10,0,346,76,30262,30174,33543,6,171,19,1,0,1,0,5,347,96,30952,30718,36876,0,-1,-20,-690,-1,-544,-3333,-1,0,0,0,5
EUN1_3574274819',2,26,24,2,0,1,0,7,0,335,76,34371,30870,51427,4,41,20,0,0,1,0,8,329,83,30641,28172,49252,1,6,-7,3730,4,2698,2175,2,0,0,0,-1
EUN1_3574233881',6,28,11,1,0,2,0,7,1,349,96,28601,30444,25564,3,19,13,1,0,0,0,5,342,98,27523,31512,27789,1,7,-2,1078,-2,-1068,-2225,0,0,2,0,2
EUN1_3574202961',2,309,7,2,0,0,0,7,1,357,87,25392,26698,25060,4,32,16,0,0,1,0,4,341,92,28876,31439,33325,0,16,-5,-3484,-9,-4741,-8265,2,0,-1,0,3
EUN1_3574185487',3,46,10,1,0,1,0,5,1,349,80,26928,30845,25745,4,23,7,1,0,0,0,4,358,107,24263,30335,29351,0,-9,-27,2665,3,510,-3606,0,0,1,0,1
EUN1_3574174550',4,28,23,1,0,2,0,6,1,317,95,32998,31413,45545,4,25,13,1,0,1,0,6,308,76,26450,26991,30257,1,9,19,6548,10,4422,15288,0,0,1,0,0
EUN1_3574164128',2,24,13,2,0,1,0,11,0,366,80,27893,30345,38418,2,24,12,0,0,0,0,4,360,104,28559,32342,35894,1,6,-24,-666,1,-1997,2524,2,0,1,0,7
EUN1_3575996818',3,26,5,0,0,0,0,11,0,339,88,23429,27231,24527,4,55,14,1,0,0,0,1,348,67,26769,29329,37340,0,-9,21,-3340,-9,-2098,-12813,-1,0,0,0,10
EUN1_3575956223',4,29,11,1,0,0,0,11,1,369,83,26695,28091,27933,8,38,9,0,0,1,0,3,393,72,27279,28442,29668,1,-24,11,-584,2,-351,-1735,1,0,-1,0,8
EUN1_3575936125',2,28,15,0,0,1,0,10,1,351,98,29857,29629,31622,2,25,8,1,0,1,0,5,362,74,25489,28592,26892,0,-11,24,4368,7,1037,4730,-1,0,0,0,5
EUN1_3575914236',2,25,9,1,0,0,0,10,0,305,84,24411,26491,23311,1,23,12,1,1,2,0,4,401,72,29247,29678,34012,1,-96,12,-4836,-3,-3187,-10701,0,-1,-2,0,6
EUN1_3575892327',3,23,9,1,1,0,0,9,1,334,94,25092,29603,33327,4,38,17,1,0,1,0,1,358,100,29808,31258,34440,1,-24,-6,-4716,-8,-1655,-1113,0,1,-1,0,8
EUN1_3575831564',4,46,13,0,1,1,0,5,1,353,120,27550,31238,33873,4,27,11,2,0,0,0,2,316,80,24541,27885,27514,1,37,40,3009,2,3353,6359,-2,1,1,0,3
EUN1_3575485794',0,24,7,0,0,1,0,10,0,334,73,25650,27051,23032,2,30,21,2,1,1,0,4,386,85,32017,31451,40315,0,-52,-12,-6367,-14,-4400,-17283,-2,-1,0,0,6
EUN1_3575451720',3,31,10,0,0,1,0,14,0,280,91,25739,27975,42720,2,28,17,1,0,1,0,5,391,80,29942,31286,36187,0,-111,11,-4203,-7,-3311,6533,-1,0,0,0,9
EUN1_3575415670',3,38,10,0,0,0,0,4,1,361,88,25419,29420,31423,3,24,7,2,0,1,0,2,364,96,26028,30179,29461,0,-3,-8,-609,3,-759,1962,-2,0,-1,0,2
EUN1_3575388818',2,75,10,0,0,0,0,7,1,372,73,25328,27168,24063,4,39,16,2,0,1,0,3,318,89,28548,31151,38087,0,54,-16,-3220,-6,-3983,-14024,-2,0,-1,0,4
EUN1_3575371858',4,90,13,0,0,0,0,5,1,320,88,27476,28261,29882,5,271,8,2,0,1,0,6,317,88,24047,28057,28509,1,3,0,3429,5,204,1373,-2,0,-1,0,-1
EUN1_3575185551',6,93,10,0,0,1,0,8,1,350,79,26471,29082,34984,3,60,13,1,0,1,0,4,372,60,27619,28327,30029,0,-22,19,-1148,-3,755,4955,-1,0,0,0,4
EUN1_3575177108',3,24,14,1,0,0,0,11,1,334,82,28885,29181,30068,6,22,12,0,0,3,0,4,357,74,28219,28058,30784,0,-23,8,666,2,1123,-716,1,0,-3,0,7
EUN1_3575165320',6,37,7,1,0,0,0,9,1,378,90,25067,29573,23021,3,92,6,1,0,1,0,0,376,110,26211,31385,22918,0,2,-20,-1144,1,-1812,103,0,0,-1,0,9
EUN1_3575149815',0,29,12,1,1,1,0,9,0,345,108,27783,29516,26108,4,25,10,1,0,1,0,5,353,91,27003,27924,25442,1,-8,17,780,2,1592,666,0,1,0,0,4
EUN1_3574794179',4,22,9,0,1,0,0,6,0,338,90,25514,28013,24330,1,30,19,1,0,0,0,0,332,89,28376,30045,39558,0,6,1,-2862,-10,-2032,-15228,-1,1,0,0,6
EUN1_3574694476',3,20,12,2,0,0,0,9,1,359,110,28045,30064,35035,7,29,9,0,0,1,0,0,357,70,25151,28128,27859,0,2,40,2894,3,1936,7176,2,0,-1,0,9
EUN1_3574675400',1,28,12,0,0,1,0,10,0,330,99,27539,29917,29175,4,28,16,2,0,2,0,6,332,67,28577,28586,31838,0,-2,32,-1038,-4,1331,-2663,-2,0,-1,0,4
EUN1_3575840376',2,25,8,0,0,1,0,5,0,338,108,26562,30045,25854,2,24,8,1,0,0,0,7,354,74,24451,27471,29064,1,-16,34,2111,0,2574,-3210,-1,0,1,0,-2
EUN1_3575813945',2,27,18,2,0,0,0,6,1,321,101,29276,30403,42700,4,182,21,0,0,1,0,2,338,82,29856,30483,45245,1,-17,19,-580,-3,-80,-2545,2,0,-1,0,4
EUN1_3575804568',5,26,27,2,0,3,0,8,0,338,90,34200,31088,47472,4,31,16,0,0,0,0,5,339,65,28010,29060,38205,1,-1,25,6190,11,2028,9267,2,0,3,0,3
EUN1_3575753941',5,26,17,1,0,2,0,6,0,379,74,30242,30442,39249,3,267,10,0,0,0,0,10,300,78,25238,27698,24807,1,79,-4,5004,7,2744,14442,1,0,2,0,-4
EUN1_3575754078',5,29,15,1,0,1,0,10,1,337,101,28073,29878,33824,3,26,12,1,0,0,0,2,325,78,26869,28426,28143,0,12,23,1204,3,1452,5681,0,0,1,0,8
EUN1_3574874155',3,27,9,0,0,1,0,8,0,375,110,27429,30591,26296,4,37,9,1,0,0,0,8,332,73,25095,28850,31069,0,43,37,2334,0,1741,-4773,-1,0,1,0,0
EUN1_3574561481',3,34,20,1,0,1,0,8,1,354,78,30844,31083,42005,4,136,15,1,1,1,0,5,296,88,27512,29508,34190,1,58,-10,3332,5,1575,7815,0,-1,0,0,3
EUN1_3574538741',3,24,6,0,0,0,0,12,1,404,90,25973,29692,19671,5,28,12,2,0,2,0,4,362,114,28457,30838,28958,0,42,-24,-2484,-6,-1146,-9287,-2,0,-2,0,8
EUN1_3574525169',3,27,9,1,1,0,0,8,0,310,84,24287,28202,25125,5,29,15,1,0,1,0,0,391,79,29035,29302,33835,0,-81,5,-4748,-6,-1100,-8710,0,1,-1,0,8
EUN1_3573646498',3,27,15,0,0,1,0,8,1,355,93,30472,28386,31003,3,28,10,1,0,1,0,7,341,82,26728,28276,26889,1,14,11,3744,5,110,4114,-1,0,0,0,1
EUN1_3573098370',3,179,6,1,0,0,0,7,0,338,102,23456,27075,26877,1,23,11,1,0,2,0,5,377,78,27554,29502,30978,0,-39,24,-4098,-5,-2427,-4101,0,0,-2,0,2
EUN1_3575949464',2,26,6,0,0,0,0,5,0,370,74,23658,28908,24664,7,30,7,1,0,0,0,2,420,98,25868,30751,22987,0,-50,-24,-2210,-1,-1843,1677,-1,0,0,0,3
EUN1_3575926366',4,54,13,2,0,0,0,12,0,308,78,26049,27714,40001,2,25,20,0,0,2,0,2,359,83,31235,30737,37471,0,-51,-5,-5186,-7,-3023,2530,2,0,-2,0,10
EUN1_3575875374',3,29,10,0,0,0,0,7,0,325,55,25281,26441,31802,3,27,9,2,0,2,0,5,360,116,26935,30158,28407,1,-35,-61,-1654,1,-3717,3395,-2,0,-2,0,2
EUN1_3575837902',3,69,8,1,0,0,0,14,1,374,113,26707,29875,30596,3,27,7,1,0,1,0,4,371,84,24897,29532,20386,1,3,29,1810,1,343,10210,0,0,-1,0,10
EUN1_3575796497',2,20,13,0,0,1,0,9,1,313,91,27423,29348,34282,9,32,14,1,0,1,0,3,369,87,28244,31011,35800,0,-56,4,-821,-1,-1663,-1518,-1,0,0,0,6
EUN1_3575781072',7,37,19,0,0,0,0,12,1,317,94,30015,29398,39386,2,24,17,1,0,1,0,4,318,88,28652,29832,37578,1,-1,6,1363,2,-434,1808,-1,0,-1,0,8
EUN1_3575748244',0,23,22,1,0,0,0,6,1,338,80,31218,29837,40689,6,27,19,1,0,0,0,3,319,107,30621,27927,36468,0,19,-27,597,3,1910,4221,0,0,0,0,3
EUN1_3575727570',4,32,12,1,0,1,0,9,0,389,72,28066,29479,26387,7,29,14,0,0,1,0,4,347,70,27386,28485,32594,1,42,2,680,-2,994,-6207,1,0,0,0,5
EUN1_3575631164',1,24,12,1,0,0,0,15,0,325,79,26846,28954,31017,3,23,20,1,0,3,0,1,351,71,32853,29395,36530,0,-26,8,-6007,-8,-441,-5513,0,0,-3,0,14
EUN1_3575611696',3,29,11,0,0,0,0,7,1,358,68,26446,28425,37492,2,86,15,1,0,0,0,2,343,80,28066,29892,42197,0,15,-12,-1620,-4,-1467,-4705,-1,0,0,0,5
EUN1_3575583786',7,31,16,1,1,0,0,11,0,315,71,27590,29092,34193,2,20,12,0,0,1,0,3,342,92,28381,28564,26801,0,-27,-21,-791,4,528,7392,1,1,-1,0,8
EUN1_3575539530',3,28,12,0,0,0,0,4,0,392,66,27039,30542,31078,4,29,7,1,0,0,0,1,367,102,25729,30117,24990,1,25,-36,1310,5,425,6088,-1,0,0,0,3
EUN1_3575494823',6,26,11,0,0,0,0,11,0,331,88,25878,29582,31168,1,23,15,2,0,2,0,3,375,124,31248,33361,32724,0,-44,-36,-5370,-4,-3779,-1556,-2,0,-2,0,8
EUN1_3575468845',4,33,18,1,1,1,0,7,1,367,99,31264,32015,31106,4,32,5,0,0,0,0,10,361,71,23843,28112,30102,1,6,28,7421,13,3903,1004,1,1,1,0,-3
EUN1_3575182947',1,27,9,1,0,0,0,7,0,350,98,26580,29236,26677,4,28,10,0,0,1,0,4,384,86,26199,28799,23970,1,-34,12,381,-1,437,2707,1,0,-1,0,3
EUN1_3568156944',7,28,9,0,0,0,0,8,0,337,97,28272,29014,33229,4,19,17,2,0,2,0,4,370,69,29785,31196,31988,0,-33,28,-1513,-8,-2182,1241,-2,0,-2,0,4
EUN1_3568139204',3,24,17,1,0,2,0,10,0,326,83,31241,30325,30563,3,29,12,1,0,0,0,6,344,87,26335,27971,25012,0,-18,-4,4906,5,2354,5551,0,0,2,0,4
EUN1_3568121522',5,28,5,0,0,0,0,16,1,356,94,25188,28819,26206,8,35,9,2,0,2,0,2,378,77,28096,31976,33378,1,-22,17,-2908,-4,-3157,-7172,-2,0,-2,0,14
EUN1_3568098880',2,29,12,1,1,0,0,9,0,362,102,27575,31227,24677,2,18,9,0,0,1,0,3,359,102,28387,30772,25649,0,3,0,-812,3,455,-972,1,1,-1,0,6
EUN1_3568087677',4,25,10,1,1,0,0,10,0,341,82,25033,29279,26016,2,24,13,1,0,1,0,1,406,75,28304,30247,35954,0,-65,7,-3271,-3,-968,-9938,0,1,-1,0,9
EUN1_3567425870',2,19,20,2,1,2,0,6,0,352,86,31819,32832,32685,0,18,6,0,0,0,0,8,346,80,24764,26921,28772,1,6,6,7055,14,5911,3913,2,1,2,0,-2
EUN1_3567405064',6,31,5,1,0,0,0,6,0,388,102,25358,29468,22226,5,29,7,1,0,0,0,4,391,94,25764,30038,22817,0,-3,8,-406,-2,-570,-591,0,0,0,0,2
EUN1_3567384029',4,76,12,0,0,3,0,8,0,365,88,29997,30136,37934,5,26,12,2,0,0,0,7,343,66,27178,28444,27741,1,22,22,2819,0,1692,10193,-2,0,3,0,1
EUN1_3567369201',4,29,20,1,0,0,0,10,1,272,74,28560,28970,44303,5,41,15,0,0,2,0,2,321,85,29942,30622,33379,0,-49,-11,-1382,5,-1652,10924,1,0,-2,0,8
EUN1_3567335497',7,51,14,0,0,0,0,10,0,309,79,29131,29553,33009,0,23,15,1,0,3,0,7,369,96,29717,30491,37848,1,-60,-17,-586,-1,-938,-4839,-1,0,-3,0,3
EUN1_3567315110',3,46,9,1,0,0,0,10,1,375,106,27561,29545,28216,5,27,9,1,0,1,0,4,365,74,25816,28182,36666,1,10,32,1745,0,1363,-8450,0,0,-1,0,6
EUN1_3567274976',3,43,23,1,0,2,0,6,0,313,92,32881,31554,43886,5,28,12,1,0,0,0,7,292,68,25315,26627,34723,1,21,24,7566,11,4927,9163,0,0,2,0,-1
EUN1_3566078710',0,16,25,1,0,0,0,14,0,292,78,31141,29803,35081,0,55,20,0,0,3,0,1,335,72,32922,29513,42017,1,-43,6,-1781,5,290,-6936,1,0,-3,0,13
EUN1_3566061029',3,28,12,1,0,0,0,11,0,335,106,27571,30742,34755,5,27,16,1,1,1,0,5,349,98,29358,31438,41361,0,-14,8,-1787,-4,-696,-6606,0,-1,-1,0,6
EUN1_3566057446',4,27,14,1,0,0,0,11,0,355,83,27556,30788,29484,8,38,13,1,0,1,0,5,372,92,29290,29262,34205,1,-17,-9,-1734,1,1526,-4721,0,0,-1,0,6
EUN1_3566047853',2,21,19,1,1,4,0,6,0,376,94,34652,31829,34712,0,29,9,0,0,0,0,11,279,97,25855,26297,19633,1,97,-3,8797,10,5532,15079,1,1,4,0,-5
EUN1_3566046413',5,32,25,2,0,1,0,12,1,312,86,32787,30577,46395,2,23,11,0,0,1,0,5,314,90,26244,26569,33405,1,-2,-4,6543,14,4008,12990,2,0,0,0,7
EUN1_3566037615',4,25,25,2,0,3,0,8,1,337,104,36194,32379,46440,0,17,11,0,0,0,0,10,307,52,24549,24433,32803,1,30,52,11645,14,7946,13637,2,0,3,0,-2
EUN1_3566035411',1,24,12,1,0,0,0,6,0,383,78,28274,30434,31273,2,21,9,0,0,1,0,4,322,82,26268,28044,31878,1,61,-4,2006,3,2390,-605,1,0,-1,0,2
EUN1_3575337651',1,31,11,0,0,0,0,4,1,385,81,27756,30209,28823,3,101,6,2,0,1,0,4,338,86,23218,27195,21990,1,47,-5,4538,5,3014,6833,-2,0,-1,0,0
EUN1_3575326688',2,36,21,2,0,2,0,2,1,359,98,31563,32347,34448,1,23,9,0,0,0,0,9,327,86,25581,28818,27183,1,32,12,5982,12,3529,7265,2,0,2,0,-7
EUN1_3575248811',3,23,17,2,1,2,0,10,1,329,92,30133,29824,35984,0,21,2,0,0,1,0,6,336,96,22149,25605,27535,1,-7,-4,7984,15,4219,8449,2,1,1,0,4
EUN1_3568481211',3,31,8,0,0,0,0,10,0,300,64,23484,25721,36156,2,22,23,2,0,2,0,5,352,92,32364,34016,41031,0,-52,-28,-8880,-15,-8295,-4875,-2,0,-2,0,5
EUN1_3568458907',1,23,8,0,0,0,0,7,0,324,93,24350,29027,22138,0,17,8,1,0,0,0,1,366,90,26551,28693,23944,0,-42,3,-2201,0,334,-1806,-1,0,0,0,6
EUN1_3568437951',5,33,8,1,0,0,0,8,1,350,84,24727,28557,28433,3,31,13,1,0,1,0,0,391,85,28616,31748,31751,0,-41,-1,-3889,-5,-3191,-3318,0,0,-1,0,8
EUN1_3568422069',2,54,6,1,0,1,0,10,0,383,109,26251,29447,33191,6,29,9,1,0,1,0,3,377,74,26347,28439,30996,1,6,35,-96,-3,1008,2195,0,0,0,0,7
EUN1_3568413055',3,24,7,0,0,0,0,13,0,219,70,22352,22140,27586,5,28,27,1,0,3,0,0,359,109,35181,30930,44059,0,-140,-39,-12829,-20,-8790,-16473,-1,0,-3,0,13
EUN1_3568350386',2,27,14,0,1,0,0,3,1,404,91,29236,32223,26862,6,33,11,1,0,0,0,4,329,98,25690,28578,33238,0,75,-7,3546,3,3645,-6376,-1,1,0,0,-1
EUN1_3568342229',1,21,12,2,0,4,0,7,1,430,148,33406,36292,24720,3,26,3,0,0,1,0,7,338,36,20947,25335,17101,1,92,112,12459,9,10957,7619,2,0,3,0,0
EUN1_3568064323',5,23,15,1,0,2,0,6,1,362,90,30041,31794,34288,5,31,6,0,1,0,0,6,316,94,25570,27656,23364,1,46,-4,4471,9,4138,10924,1,-1,2,0,0
EUN1_3568043441',2,23,11,1,0,0,0,7,0,343,77,25559,28872,26341,6,29,10,1,1,1,0,2,329,120,26680,28981,25273,0,14,-43,-1121,1,-109,1068,0,-1,-1,0,5
EUN1_3568035111',8,30,8,1,0,0,0,7,0,400,104,26724,30807,24407,5,22,8,1,0,1,0,3,394,87,27078,29466,24019,0,6,17,-354,0,1341,388,0,0,-1,0,4
EUN1_3567896765',7,30,12,2,0,1,0,5,0,357,80,28284,28944,35657,4,27,17,0,0,0,0,3,313,68,28086,28623,32674,1,44,12,198,-5,321,2983,2,0,1,0,2
EUN1_3567879436',5,25,14,1,0,0,0,5,1,379,80,28415,29912,28328,2,26,5,1,0,1,0,4,346,88,25515,26833,25718,1,33,-8,2900,9,3079,2610,0,0,-1,0,1
EUN1_3576119232',1,25,5,0,0,0,0,5,0,331,106,24279,28563,25471,2,24,10,1,0,0,0,1,339,66,24397,27968,27337,1,-8,40,-118,-5,595,-1866,-1,0,0,0,4
EUN1_3576092699',1,33,13,1,0,0,0,7,0,346,84,27941,28579,35948,3,29,14,1,0,1,0,3,317,75,26565,26632,27882,1,29,9,1376,-1,1947,8066,0,0,-1,0,4
EUN1_3575748247',0,20,17,2,0,0,0,10,1,325,80,28013,28106,34953,4,45,13,0,0,0,0,2,309,57,26071,26299,34766,0,16,23,1942,4,1807,187,2,0,0,0,8
EUN1_3575528713',5,24,13,0,0,1,0,9,1,333,88,28385,30672,35025,1,29,10,1,1,1,0,4,367,86,26917,29401,31033,0,-34,2,1468,3,1271,3992,-1,-1,0,0,5
EUN1_3575499966',3,29,11,0,0,0,0,9,1,380,90,27213,29981,28939,3,23,18,1,0,1,0,2,351,86,30340,31123,37603,0,29,4,-3127,-7,-1142,-8664,-1,0,-1,0,7
EUN1_3575480499',3,24,25,0,0,2,0,5,0,317,85,33638,32941,47554,2,24,15,1,0,0,0,2,362,74,29011,28297,33230,1,-45,11,4627,10,4644,14324,-1,0,2,0,3
EUN1_3575459138',1,36,10,0,0,0,0,8,1,357,87,26450,30417,25380,3,25,12,1,0,1,0,5,339,96,27087,29376,28483,0,18,-9,-637,-2,1041,-3103,-1,0,-1,0,3
EUN1_3575429118',4,30,18,0,0,1,0,4,1,321,79,28267,29519,42726,0,17,15,1,1,1,0,5,320,112,30271,30419,33831,1,1,-33,-2004,3,-900,8895,-1,-1,0,0,-1
EUN1_3568539569',5,24,12,1,0,2,0,8,0,363,90,29142,31319,32495,4,26,13,1,0,0,0,6,296,86,25939,27741,27221,1,67,4,3203,-1,3578,5274,0,0,2,0,2
EUN1_3568007025',3,30,11,0,0,0,0,10,0,371,68,26904,30068,30839,2,25,11,2,0,1,0,3,373,108,28748,31402,33572,0,-2,-40,-1844,0,-1334,-2733,-2,0,-1,0,7
EUN1_3567996929',8,32,13,1,0,2,0,10,1,370,86,29681,29907,30448,8,30,9,0,0,0,0,9,348,84,26139,30016,28683,1,22,2,3542,4,-109,1765,1,0,2,0,1
EUN1_3566951017',5,100,18,0,0,0,0,8,0,317,56,29117,26930,42468,4,28,18,1,1,4,0,6,331,129,32251,30187,35868,0,-14,-73,-3134,0,-3257,6600,-1,-1,-4,0,2
EUN1_3566952350',0,22,22,2,0,1,0,11,0,362,86,32833,33384,39644,2,20,6,0,0,2,0,4,320,90,23616,25329,29118,1,42,-4,9217,16,8055,10526,2,0,-1,0,7
EUN1_3565948196',4,29,11,2,1,0,0,7,1,369,105,29170,30080,29674,5,25,6,0,0,3,0,5,354,94,24525,28418,19121,1,15,11,4645,5,1662,10553,2,1,-3,0,2
EUN1_3564247492',3,26,12,0,0,0,0,14,1,298,78,27170,27401,27366,3,39,24,2,0,3,0,1,397,75,36717,32463,41702,0,-99,3,-9547,-12,-5062,-14336,-2,0,-3,0,13
EUN1_3575423802',3,21,10,1,0,0,0,9,1,364,122,27533,29806,30557,4,31,7,1,0,1,0,3,336,74,24929,27217,21656,1,28,48,2604,3,2589,8901,0,0,-1,0,6
EUN1_3574418193',5,24,13,2,0,0,0,13,0,315,94,26552,29784,36800,4,23,14,0,0,1,0,3,325,90,28207,29290,31029,0,-10,4,-1655,-1,494,5771,2,0,-1,0,10
EUN1_3574390346',2,20,10,0,0,0,0,8,1,363,110,27357,30329,23030,4,37,9,1,0,0,0,2,340,80,25082,28428,24882,1,23,30,2275,1,1901,-1852,-1,0,0,0,6
EUN1_3573969450',0,15,11,1,0,0,0,13,0,379,100,27592,30960,28544,4,46,16,1,0,2,0,4,364,91,29004,33267,35976,0,15,9,-1412,-5,-2307,-7432,0,0,-2,0,9
EUN1_3573935521',2,25,16,1,0,1,0,13,0,301,58,28303,29859,33653,6,54,12,0,0,1,0,4,339,107,28495,28768,29855,0,-38,-49,-192,4,1091,3798,1,0,0,0,9
EUN1_3573915351',4,20,12,0,0,0,0,10,0,321,56,25571,27779,24231,2,23,16,2,0,0,0,1,352,71,27992,27945,29529,0,-31,-15,-2421,-4,-166,-5298,-2,0,0,0,9
EUN1_3573435802',2,42,21,0,0,2,0,7,1,386,52,33610,31227,39548,3,21,7,0,0,2,0,7,286,88,22560,27788,23783,1,100,-36,11050,14,3439,15765,0,0,0,0,0
EUN1_3573424471',2,25,6,1,0,0,0,7,0,335,83,23205,29826,27063,0,27,13,1,0,1,0,0,345,90,28150,31289,28735,0,-10,-7,-4945,-7,-1463,-1672,0,0,-1,0,7
EUN1_3575214234',4,146,18,2,0,1,0,4,0,317,68,28070,30522,40882,1,20,19,0,0,0,0,1,305,84,27833,29733,43623,0,12,-16,237,-1,789,-2741,2,0,1,0,3
EUN1_3575203179',5,196,8,0,0,1,0,11,1,386,90,26501,29880,30116,7,34,9,2,0,2,0,5,385,90,27521,29679,25469,0,1,0,-1020,-1,201,4647,-2,0,-1,0,6
EUN1_3574891687',4,26,19,2,0,0,0,11,1,326,107,30664,29844,32721,2,28,17,0,0,0,0,6,336,80,28910,30716,37812,1,-10,27,1754,2,-872,-5091,2,0,0,0,5
EUN1_3574297165',1,28,17,1,0,0,0,10,0,383,74,30783,31392,33573,4,28,16,1,0,1,0,2,343,108,30668,30622,39477,1,40,-34,115,1,770,-5904,0,0,-1,0,8
EUN1_3574267033',7,290,17,2,0,1,0,7,1,345,81,29208,29650,32259,1,26,13,0,0,1,0,5,367,85,28537,30190,37881,1,-22,-4,671,4,-540,-5622,2,0,0,0,2
EUN1_3573639368',2,22,24,2,1,2,0,12,1,382,106,36026,33162,37935,7,31,11,0,0,0,0,7,305,80,27432,28525,29398,1,77,26,8594,13,4637,8537,2,1,2,0,5
EUN1_3573631227',7,30,10,0,0,0,0,8,0,357,82,25936,28459,25698,2,23,19,2,0,0,0,2,341,94,29834,30703,36596,0,16,-12,-3898,-9,-2244,-10898,-2,0,0,0,6
EUN1_3573618241',0,37,9,0,0,0,0,10,0,338,46,23718,26869,30830,6,63,16,1,0,0,0,2,346,102,28386,29610,29615,0,-8,-56,-4668,-7,-2741,1215,-1,0,0,0,8
EUN1_3573331477',3,49,9,0,0,1,0,10,1,319,66,25890,27445,34878,5,87,24,2,0,1,0,3,325,85,32062,32038,51330,0,-6,-19,-6172,-15,-4593,-16452,-2,0,0,0,7
EUN1_3573290035',7,29,12,1,0,0,0,13,1,335,76,25775,28263,29492,3,30,14,1,0,2,0,0,356,91,29500,28898,34184,0,-21,-15,-3725,-2,-635,-4692,0,0,-2,0,13
EUN1_3572677964',4,26,15,0,0,0,0,9,1,386,97,28548,29866,33726,1,26,12,2,0,0,0,4,376,74,27112,31031,31791,0,10,23,1436,3,-1165,1935,-2,0,0,0,5
EUN1_3568049187',2,22,24,2,1,0,0,7,1,351,91,32990,32104,44306,2,34,11,0,0,1,0,5,301,80,26508,27211,32682,0,50,11,6482,13,4893,11624,2,1,-1,0,2
EUN1_3567919235',3,25,15,1,0,3,0,10,0,390,110,32261,31600,36312,3,25,8,0,0,0,0,6,320,82,25137,28180,19346,1,70,28,7124,7,3420,16966,1,0,3,0,4
EUN1_3567903219',4,27,12,0,0,0,0,7,0,293,82,26355,27332,35086,4,41,13,1,0,0,0,1,338,82,26965,27538,30779,1,-45,0,-610,-1,-206,4307,-1,0,0,0,6
EUN1_3567876821',7,27,14,0,1,0,0,10,1,312,86,28186,27663,32994,2,29,16,2,0,0,0,1,330,110,29979,29776,38359,0,-18,-24,-1793,-2,-2113,-5365,-2,1,0,0,9
EUN1_3564641471',4,77,9,2,0,0,0,14,0,310,102,25137,28520,29386,3,21,19,0,0,3,0,1,346,99,31995,31821,40543,0,-36,3,-6858,-10,-3301,-11157,2,0,-3,0,13
EUN1_3564631506',4,29,11,1,0,0,0,9,1,349,78,26040,27556,30552,3,175,13,1,1,0,0,0,370,101,28616,30388,37138,0,-21,-23,-2576,-2,-2832,-6586,0,-1,0,0,9
EUN1_3564240639',2,24,5,1,0,0,0,4,0,387,92,24663,28167,21608,3,23,10,1,0,0,0,4,336,92,25151,29061,28990,1,51,0,-488,-5,-894,-7382,0,0,0,0,0
EUN1_3564226925',2,29,13,0,0,0,0,5,1,351,84,26487,28456,31322,4,55,9,2,0,0,0,1,373,76,24988,30201,29539,0,-22,8,1499,4,-1745,1783,-2,0,0,0,4
EUN1_3568145238',4,28,10,0,0,1,0,10,1,331,78,25931,28043,27940,4,26,16,2,0,0,0,2,369,117,29290,31380,34824,0,-38,-39,-3359,-6,-3337,-6884,-2,0,1,0,8
EUN1_3568110056',1,84,10,1,0,0,0,8,1,325,104,26665,28553,24335,3,20,12,1,0,0,0,1,355,100,27144,30409,28166,0,-30,4,-479,-2,-1856,-3831,0,0,0,0,7
EUN1_3568101760',6,21,10,1,1,0,0,5,0,361,86,26089,29703,25910,6,28,7,0,0,0,0,5,326,60,23359,26892,26861,1,35,26,2730,3,2811,-951,1,1,0,0,0
EUN1_3568077345',4,20,10,0,0,0,0,9,1,314,94,25825,29407,24684,6,32,10,1,0,1,0,1,345,82,25582,27992,27995,1,-31,12,243,0,1415,-3311,-1,0,-1,0,8
EUN1_3568059162',4,23,4,1,0,0,0,12,0,370,76,23906,27705,20497,4,35,20,1,0,3,0,1,373,106,32580,33701,40344,0,-3,-30,-8674,-16,-5996,-19847,0,0,-3,0,11
EUN1_3567891765',5,30,9,1,0,0,0,10,0,344,96,25874,29755,30314,2,25,10,0,0,0,0,0,344,80,26316,29976,29732,0,0,16,-442,-1,-221,582,1,0,0,0,10
EUN1_3567876495',3,22,16,2,0,1,0,10,0,340,104,30023,29759,33748,4,49,8,0,0,1,0,5,326,104,26637,28527,24511,1,14,0,3386,8,1232,9237,2,0,0,0,5
EUN1_3564873183',9,30,7,0,0,0,0,9,1,297,88,23215,26575,32875,5,17,18,2,0,2,0,0,371,84,31176,32882,35247,0,-74,4,-7961,-11,-6307,-2372,-2,0,-2,0,9
EUN1_3560658302',2,25,8,1,1,0,0,3,0,360,88,25965,31016,26003,10,35,15,1,0,1,0,2,376,84,27989,29884,30149,0,-16,4,-2024,-7,1132,-4146,0,1,-1,0,1
EUN1_3560600065',1,27,14,0,0,1,0,7,0,355,80,28213,29423,33477,4,50,10,2,1,0,0,1,344,85,25470,29357,24566,1,11,-5,2743,4,66,8911,-2,-1,1,0,6
EUN1_3560490777',3,14,17,1,0,0,0,10,0,333,78,28166,30425,41087,3,32,13,0,0,1,0,4,311,86,27774,30047,35902,1,22,-8,392,4,378,5185,1,0,-1,0,6
EUN1_3559796739',3,41,9,0,0,0,0,9,1,338,84,25555,28349,22594,4,28,17,1,0,1,0,2,352,92,30058,30196,35679,0,-14,-8,-4503,-8,-1847,-13085,-1,0,-1,0,7
EUN1_3555767438',3,25,12,0,0,0,0,11,0,289,76,26186,27788,28198,5,29,20,2,1,2,0,3,351,100,32606,29306,39852,0,-62,-24,-6420,-8,-1518,-11654,-2,-1,-2,0,8
EUN1_3555555607',3,24,20,1,1,1,0,6,1,349,94,31004,30745,39547,3,91,12,1,0,0,0,8,298,82,26441,29971,33042,1,51,12,4563,8,774,6505,0,1,1,0,-2
EUN1_3555540896',3,22,12,2,0,1,0,5,0,370,80,28202,29493,32532,4,25,10,0,0,0,0,3,346,64,25550,27369,30871,1,24,16,2652,2,2124,1661,2,0,1,0,2
EUN1_3572184830',1,43,17,1,0,0,0,7,1,384,84,30011,32612,36744,3,61,7,1,0,0,0,4,381,108,25009,29696,31601,0,3,-24,5002,10,2916,5143,0,0,0,0,3
EUN1_3571755369',2,39,16,1,1,1,0,6,1,333,105,29095,30700,38787,2,28,14,1,0,0,0,6,343,78,27738,30391,36774,1,-10,27,1357,2,309,2013,0,1,1,0,0
EUN1_3571640925',2,27,13,2,0,0,0,3,1,396,122,28807,33139,37338,2,27,6,0,0,1,0,6,334,62,23209,28344,22985,1,62,60,5598,7,4795,14353,2,0,-1,0,-3
EUN1_3571552494',1,150,17,2,0,2,0,6,0,384,127,31568,32619,36967,4,28,10,0,0,0,0,6,344,64,25516,30039,27999,1,40,63,6052,7,2580,8968,2,0,2,0,0
EUN1_3575448808',4,33,11,0,1,1,0,9,1,359,88,28611,29926,30657,3,22,13,2,0,0,0,4,316,98,27098,27557,35594,0,43,-10,1513,-2,2369,-4937,-2,1,1,0,5
EUN1_3575207450',4,31,6,1,1,2,0,6,1,368,96,26628,29788,21744,1,27,4,1,0,0,0,7,341,76,22295,27900,15832,1,27,20,4333,2,1888,5912,0,1,2,0,-1
EUN1_3573592133',5,191,6,0,0,0,0,7,1,346,99,24516,30589,23541,2,26,6,1,0,0,0,4,394,99,25272,30594,21444,1,-48,0,-756,0,-5,2097,-1,0,0,0,3
EUN1_3572265353',2,64,11,0,0,1,0,5,1,329,71,26013,29442,29389,3,79,9,1,0,0,0,3,325,65,24616,27785,34990,0,4,6,1397,2,1657,-5601,-1,0,1,0,2
EUN1_3572200269',3,28,18,1,0,0,0,13,0,333,86,29338,29455,34447,2,23,12,0,0,2,0,3,368,81,28545,29961,32768,1,-35,5,793,6,-506,1679,1,0,-2,0,10
EUN1_3571980650',5,28,15,1,0,0,0,11,0,295,95,25877,29765,32533,1,22,16,1,1,2,0,0,354,96,30621,30871,36472,0,-59,-1,-4744,-1,-1106,-3939,0,-1,-2,0,11
EUN1_3571967270',10,32,3,1,0,0,0,6,0,318,96,21195,27121,25634,3,26,15,1,1,0,0,0,389,116,28691,33232,34848,0,-71,-20,-7496,-12,-6111,-9214,0,-1,0,0,6
EUN1_3571944844',6,57,18,0,0,0,0,12,1,311,83,29288,26987,43001,5,27,20,1,0,1,0,4,301,73,29939,28078,42639,0,10,10,-651,-2,-1091,362,-1,0,-1,0,8
EUN1_3571936530',6,39,12,1,0,0,0,8,1,369,85,27594,30286,31071,3,89,7,1,0,0,0,2,336,80,24451,28011,19662,1,33,5,3143,5,2275,11409,0,0,0,0,6
EUN1_3571920057',4,30,21,1,0,3,0,5,1,407,86,33601,35225,42778,3,28,5,1,0,0,0,9,296,85,22723,27664,28279,1,111,1,10878,16,7561,14499,0,0,3,0,-4
EUN1_3571727560',2,81,7,1,0,0,0,7,0,315,76,23667,26738,22836,1,28,6,0,0,1,0,2,408,96,26778,30482,28241,0,-93,-20,-3111,1,-3744,-5405,1,0,-1,0,5
EUN1_3571681562',3,29,20,2,1,3,0,6,1,356,108,31692,29703,36504,3,27,6,0,0,1,0,10,287,68,23840,25337,23056,1,69,40,7852,14,4366,13448,2,1,2,0,-4
EUN1_3571656171',1,33,10,0,0,0,0,9,0,293,90,25557,27306,31194,3,24,12,2,0,1,0,1,334,90,27991,28890,32945,0,-41,0,-2434,-2,-1584,-1751,-2,0,-1,0,8
EUN1_3571615329',2,23,3,1,0,0,0,12,0,308,84,21128,26125,19121,3,27,9,0,0,2,0,2,407,119,29036,31564,34619,0,-99,-35,-7908,-6,-5439,-15498,1,0,-2,0,10
EUN1_3571419648',6,27,8,1,0,0,0,7,1,343,89,26328,28281,27648,4,28,14,1,0,1,0,6,378,83,28331,29680,31442,0,-35,6,-2003,-6,-1399,-3794,0,0,-1,0,1
EUN1_3571412430',6,24,7,0,0,0,0,15,0,296,76,22903,27411,27690,0,26,20,1,0,2,0,0,350,104,31466,30672,44446,0,-54,-28,-8563,-13,-3261,-16756,-1,0,-2,0,15
EUN1_3571390415',3,24,11,1,0,0,0,9,0,357,60,25164,27847,28978,7,50,11,0,0,0,0,1,373,70,26407,28504,26807,0,-16,-10,-1243,0,-657,2171,1,0,0,0,8
EUN1_3571373015',3,45,13,0,0,0,0,8,1,347,108,27288,30749,30463,0,30,15,2,0,1,0,1,360,88,29404,32328,36290,1,-13,20,-2116,-2,-1579,-5827,-2,0,-1,0,7
EUN1_3570320789',3,58,10,1,0,0,0,12,0,313,63,25075,25304,30723,5,65,18,0,0,2,0,4,369,80,30306,30855,41120,0,-56,-17,-5231,-8,-5551,-10397,1,0,-2,0,8
EUN1_3570298216',3,32,8,1,0,0,0,5,1,359,92,25089,28839,23967,2,28,7,0,0,0,0,4,346,103,25011,28739,22526,1,13,-11,78,1,100,1441,1,0,0,0,1
EUN1_3574109204',0,30,10,0,1,0,0,10,0,340,68,26128,28659,27322,7,36,14,2,0,1,0,2,385,94,29396,30776,31263,0,-45,-26,-3268,-4,-2117,-3941,-2,1,-1,0,8
EUN1_3573926847',0,18,15,0,0,0,0,11,1,363,80,27948,29585,32953,3,24,14,1,0,1,0,3,373,96,28867,32279,36640,0,-10,-16,-919,1,-2694,-3687,-1,0,-1,0,8
EUN1_3573821506',3,24,11,0,0,0,0,8,0,317,98,25596,28581,30089,3,252,17,2,0,1,0,3,338,77,28450,29667,36109,0,-21,21,-2854,-6,-1086,-6020,-2,0,-1,0,5
EUN1_3573805846',2,24,15,0,0,2,0,1,1,399,96,31134,33295,34340,0,19,7,2,0,1,0,9,327,84,23400,28034,30747,1,72,12,7734,8,5261,3593,-2,0,1,0,-8
EUN1_3573747516',2,17,9,0,0,1,0,15,0,317,82,27288,27420,27873,4,23,32,2,1,4,0,2,376,114,40168,35921,56367,0,-59,-32,-12880,-23,-8501,-28494,-2,-1,-3,0,13
EUN1_3573732326',2,19,9,2,0,1,0,13,1,351,93,26671,29320,29253,6,31,20,0,0,1,0,1,348,86,30625,31178,39357,1,3,7,-3954,-11,-1858,-10104,2,0,0,0,12
EUN1_3573618833',1,27,14,0,1,0,0,10,0,345,84,26657,30138,27780,3,29,11,2,0,1,0,0,373,80,27388,30014,28528,0,-28,4,-731,3,124,-748,-2,1,-1,0,10
EUN1_3573599920',6,24,14,2,1,1,0,7,0,352,101,27897,30012,34615,2,27,9,0,0,0,0,3,335,71,24423,28501,25334,1,17,30,3474,5,1511,9281,2,1,1,0,4
EUN1_3573577203',4,26,11,2,0,0,0,10,0,305,88,25620,27563,31576,3,25,14,0,0,1,0,2,366,92,29162,28802,37107,0,-61,-4,-3542,-3,-1239,-5531,2,0,-1,0,8
EUN1_3573127999',2,22,15,1,0,0,0,11,0,346,86,28625,29298,30079,6,156,6,1,1,1,0,3,363,98,25547,29437,24314,0,-17,-12,3078,9,-139,5765,0,-1,-1,0,8
EUN1_3573078494',2,24,9,0,0,0,0,8,1,323,65,25240,26972,35226,6,30,15,1,0,2,0,1,369,98,28763,32955,31598,0,-46,-33,-3523,-6,-5983,3628,-1,0,-2,0,7
EUN1_3573058946',2,24,7,0,0,0,0,12,0,287,87,24057,27011,33635,5,27,28,2,0,3,0,4,350,100,34954,35081,49250,0,-63,-13,-10897,-21,-8070,-15615,-2,0,-3,0,8
EUN1_3572926174',4,41,12,2,0,0,0,6,0,371,64,26343,31855,32198,3,31,5,0,0,0,0,5,316,88,22523,27095,26778,1,55,-24,3820,7,4760,5420,2,0,0,0,1
EUN1_3572911525',4,22,16,2,0,1,0,9,0,370,96,31125,30495,35648,1,30,14,0,0,1,0,6,325,70,27577,28896,38512,0,45,26,3548,2,1599,-2864,2,0,0,0,3
EUN1_3572787344',3,30,18,2,1,0,0,10,1,381,126,31384,32264,32815,5,25,12,0,0,0,0,3,363,72,27844,29918,29813,1,18,54,3540,6,2346,3002,2,1,0,0,7
EUN1_3572746806',3,363,16,1,0,0,0,7,1,330,70,27832,29084,34668,2,44,13,1,0,0,0,1,321,78,26618,28039,30745,1,9,-8,1214,3,1045,3923,0,0,0,0,6
EUN1_3572288176',3,31,15,0,0,1,0,9,1,323,76,30051,28069,36774,1,28,11,2,0,1,0,4,329,87,26698,28418,33340,1,-6,-11,3353,4,-349,3434,-2,0,0,0,5
EUN1_3575280364',4,31,24,1,1,1,0,9,1,367,106,34350,34767,44065,0,30,8,1,0,1,0,10,361,77,24995,27998,31517,1,6,29,9355,16,6769,12548,0,1,0,0,-1
EUN1_3575220138',0,35,7,1,0,0,0,8,1,330,94,23899,28440,24944,6,71,15,0,1,0,0,4,351,98,28459,32512,30820,1,-21,-4,-4560,-8,-4072,-5876,1,-1,0,0,4
EUN1_3575206222',1,26,16,0,0,2,0,5,0,407,94,31609,33194,35578,3,34,9,2,0,0,0,10,308,82,24351,27912,25781,1,99,12,7258,7,5282,9797,-2,0,2,0,-5
EUN1_3575173842',2,25,24,1,0,2,0,14,1,340,80,32501,31235,44082,3,20,8,1,0,1,0,5,346,92,26592,28596,25230,1,-6,-12,5909,16,2639,18852,0,0,1,0,9
EUN1_3574360525',0,32,7,2,1,0,0,14,0,325,96,23621,27725,26021,7,31,15,0,0,3,0,0,371,100,30889,30716,30722,0,-46,-4,-7268,-8,-2991,-4701,2,1,-3,0,14
EUN1_3574291025',1,24,14,2,0,0,0,12,1,328,80,27655,30386,33595,4,27,11,0,0,2,0,2,348,76,26861,27402,29175,1,-20,4,794,3,2984,4420,2,0,-2,0,10
EUN1_3574282661',4,34,2,1,0,0,0,11,0,289,104,20521,25002,26572,2,24,20,1,0,3,0,1,371,102,31967,33549,39891,0,-82,2,-11446,-18,-8547,-13319,0,0,-3,0,10
EUN1_3574101032',2,28,6,1,1,2,0,5,1,436,105,27918,31749,17558,4,35,5,1,0,0,0,9,335,114,24214,28820,22261,1,101,-9,3704,1,2929,-4703,0,1,2,0,-4
EUN1_3573818542',5,23,12,1,1,1,0,6,0,350,105,27466,29523,25838,3,92,22,1,0,1,0,5,360,82,32385,32969,41486,0,-10,23,-4919,-10,-3446,-15648,0,1,0,0,1
EUN1_3573784020',4,32,16,0,0,0,0,4,0,367,46,28853,28774,28540,5,38,15,1,0,0,0,2,355,88,28154,27941,32653,1,12,-42,699,1,833,-4113,-1,0,0,0,2
EUN1_3571677612',4,25,21,0,0,0,0,9,1,316,96,30875,31035,42375,6,29,13,2,0,1,0,6,343,82,26756,30226,30341,0,-27,14,4119,8,809,12034,-2,0,-1,0,3
EUN1_3570793680',8,27,11,0,0,0,0,14,0,339,78,26748,28635,27973,5,77,13,2,0,2,0,0,395,86,30066,31872,40003,0,-56,-8,-3318,-2,-3237,-12030,-2,0,-2,0,14
EUN1_3570773299',4,27,14,0,0,0,0,13,1,299,99,28394,29267,29987,0,23,17,2,0,3,0,4,369,92,30594,29496,33204,0,-70,7,-2200,-3,-229,-3217,-2,0,-3,0,9
EUN1_3570624588',4,38,8,1,0,0,0,9,0,333,92,25347,28261,22347,3,150,10,1,0,1,0,4,396,88,26912,30568,23517,0,-63,4,-1565,-2,-2307,-1170,0,0,-1,0,5
EUN1_3570239905',4,35,11,1,0,0,0,8,0,313,84,24482,27383,35740,1,24,15,0,0,1,0,0,340,105,29269,30479,31806,0,-27,-21,-4787,-4,-3096,3934,1,0,-1,0,8
EUN1_3570221368',3,27,7,0,0,1,0,9,1,351,76,24355,29878,24038,1,30,10,1,0,1,0,5,352,108,26164,30398,25852,1,-1,-32,-1809,-3,-520,-1814,-1,0,0,0,4
EUN1_3570191753',5,27,7,0,0,0,0,7,0,308,83,23558,26222,29139,0,25,15,1,0,1,0,3,383,76,28994,31087,36406,1,-75,7,-5436,-8,-4865,-7267,-1,0,-1,0,4
EUN1_3570172403',5,24,14,1,0,0,0,2,0,375,102,29403,31630,31309,1,26,10,1,0,1,0,9,352,89,26269,29879,32559,1,23,13,3134,4,1751,-1250,0,0,-1,0,-7
EUN1_3570138989',2,57,12,1,1,1,0,7,1,384,116,27494,31328,44041,3,30,13,1,0,1,0,5,350,83,27568,29882,28900,0,34,33,-74,-1,1446,15141,0,1,0,0,2
EUN1_3570113978',4,29,9,1,1,1,0,6,0,372,86,26212,27769,24961,2,26,15,1,0,0,0,4,299,106,27315,27959,28669,1,73,-20,-1103,-6,-190,-3708,0,1,1,0,2
EUN1_3573309970',5,24,10,0,0,0,0,11,0,308,78,24664,28350,29414,3,23,13,1,0,2,0,0,365,92,29047,30199,32956,1,-57,-14,-4383,-3,-1849,-3542,-1,0,-2,0,11
EUN1_3573286556',6,94,23,1,0,1,0,10,1,353,87,32566,31537,40001,4,24,7,1,0,1,0,5,357,96,25270,27477,20478,1,-4,-9,7296,16,4060,19523,0,0,0,0,5
EUN1_3570446226',4,20,5,0,0,0,0,7,0,343,86,24306,28759,24949,5,119,16,2,0,0,0,4,318,102,27202,28220,29832,0,25,-16,-2896,-11,539,-4883,-2,0,0,0,3
EUN1_3570407047',5,28,13,1,0,0,0,10,0,272,79,27539,26455,33947,3,19,20,1,0,2,0,2,343,72,30602,29596,43741,0,-71,7,-3063,-7,-3141,-9794,0,0,-2,0,8
EUN1_3567812967',5,227,11,1,0,0,0,9,1,360,88,26167,29788,33652,3,19,12,0,0,0,0,0,372,83,27019,31586,35315,1,-12,5,-852,-1,-1798,-1663,1,0,0,0,9
EUN1_3576031687',2,24,18,0,0,2,0,9,1,332,72,28983,28043,35846,6,167,13,2,0,1,0,9,330,104,28543,27624,29200,1,2,-32,440,5,419,6646,-2,0,1,0,0
EUN1_3576004807',2,132,11,2,1,1,0,4,1,364,132,27920,31865,26265,2,28,2,0,0,0,0,7,365,32,21256,25831,19437,1,-1,100,6664,9,6034,6828,2,1,1,0,-3
EUN1_3574120892',1,26,10,0,0,0,0,8,1,337,78,26234,26364,35402,6,24,25,2,1,0,0,0,340,86,31188,30626,35613,0,-3,-8,-4954,-15,-4262,-211,-2,-1,0,0,8
EUN1_3573986639',3,27,9,1,0,0,0,4,1,371,90,26163,29179,27598,4,27,11,1,0,0,0,3,343,94,25738,29434,27806,0,28,-4,425,-2,-255,-208,0,0,0,0,1
EUN1_3573950974',3,27,15,2,0,2,0,7,0,349,88,30133,29594,33771,5,30,7,0,0,1,0,9,299,83,23790,25101,24663,1,50,5,6343,8,4493,9108,2,0,1,0,-2
EUN1_3573683707',4,20,11,2,0,0,0,5,0,373,80,26750,30697,28739,8,30,11,0,1,1,0,2,355,103,27676,30907,33283,1,18,-23,-926,0,-210,-4544,2,-1,-1,0,3
EUN1_3571754920',2,28,11,0,0,1,0,10,1,351,83,28571,27964,28626,5,27,14,1,0,2,0,3,293,76,27451,28185,34330,1,58,7,1120,-3,-221,-5704,-1,0,-1,0,7
EUN1_3571728605',0,20,12,2,0,2,0,13,1,315,112,30265,30304,34049,3,24,11,0,0,1,0,7,335,98,26189,29214,26954,0,-20,14,4076,1,1090,7095,2,0,1,0,6
EUN1_3571645403',1,25,15,1,0,0,0,11,0,330,84,28641,28511,35559,4,29,18,0,0,2,0,4,376,88,31427,31131,37078,1,-46,-4,-2786,-3,-2620,-1519,1,0,-2,0,7
EUN1_3571574357',1,26,26,0,0,2,0,6,1,397,94,34840,34243,40927,2,22,12,0,0,0,0,7,300,66,25863,27563,31145,1,97,28,8977,14,6680,9782,0,0,2,0,-1
EUN1_3571550078',6,85,8,2,0,0,0,4,0,367,100,25270,30367,27230,4,297,7,0,0,0,0,3,382,76,25104,29082,23829,1,-15,24,166,1,1285,3401,2,0,0,0,1
EUN1_3571528677',3,27,14,1,0,1,0,5,1,397,102,28794,32541,26187,4,17,0,0,0,0,0,7,343,66,19936,25841,16639,1,54,36,8858,14,6700,9548,1,0,1,0,-2
EUN1_3571423604',2,22,18,1,1,1,0,7,1,336,90,29371,29121,42184,6,25,15,1,0,0,0,1,287,112,28115,28800,33842,0,49,-22,1256,3,321,8342,0,1,1,0,6
EUN1_3571415388',5,137,5,1,0,0,0,15,0,276,84,21578,26559,27169,5,23,22,1,0,4,0,2,353,96,34658,31842,39820,0,-77,-12,-13080,-17,-5283,-12651,0,0,-4,0,13
EUN1_3571401141',3,29,10,2,0,0,0,5,1,366,94,26198,28786,27052,4,25,12,0,0,1,0,2,388,84,27307,29971,29149,0,-22,10,-1109,-2,-1185,-2097,2,0,-1,0,3
EUN1_3571386321',5,27,15,2,0,0,0,8,0,368,87,28140,29656,30630,5,26,9,0,0,0,0,4,350,71,25498,26983,23805,1,18,16,2642,6,2673,6825,2,0,0,0,4
EUN1_3571372235',6,27,17,1,0,1,0,12,0,338,87,28665,31376,32596,2,26,22,1,0,1,0,2,357,73,31346,32844,41580,1,-19,14,-2681,-5,-1468,-8984,0,0,0,0,10
EUN1_3571234820',4,27,21,2,0,1,0,6,0,357,81,32417,29842,37395,9,31,17,0,0,1,0,3,285,68,27717,25240,33068,1,72,13,4700,4,4602,4327,2,0,0,0,3
EUN1_3571220167',6,29,10,0,0,0,0,15,0,300,114,27335,29978,25627,2,24,17,2,0,1,0,1,413,98,30051,33327,30257,0,-113,16,-2716,-7,-3349,-4630,-2,0,-1,0,14
EUN1_3576112569',6,36,12,2,0,0,0,4,0,403,114,28329,32315,32490,5,31,8,0,0,0,0,3,317,78,23796,27673,26885,1,86,36,4533,4,4642,5605,2,0,0,0,1
EUN1_3576021186',2,40,12,0,0,0,0,15,0,318,81,26324,27733,27855,4,135,20,1,0,2,0,1,330,74,31330,29556,36391,0,-12,7,-5006,-8,-1823,-8536,-1,0,-2,0,14
EUN1_3575980164',1,23,14,1,0,1,0,10,1,368,82,29316,29212,35481,2,27,14,1,0,0,0,3,358,106,28615,30398,37431,1,10,-24,701,0,-1186,-1950,0,0,1,0,7
EUN1_3575957230',5,29,15,1,0,4,0,6,0,394,102,32764,32436,34861,3,254,10,1,0,0,0,9,341,76,25976,28154,31003,1,53,26,6788,5,4282,3858,0,0,4,0,-3
EUN1_3573823590',2,25,13,1,0,0,0,11,0,310,84,27221,29370,30378,4,22,17,1,1,2,0,4,382,99,31038,32007,33332,0,-72,-15,-3817,-4,-2637,-2954,0,-1,-2,0,7
EUN1_3573799804',3,71,10,2,0,0,0,9,1,336,108,25862,29663,30400,5,154,3,0,0,0,0,2,374,99,24932,29622,21902,1,-38,9,930,7,41,8498,2,0,0,0,7
EUN1_3573766960',4,29,9,0,0,0,0,8,1,279,80,23184,26991,23374,3,20,17,1,0,1,0,0,384,96,29673,32917,32902,0,-105,-16,-6489,-8,-5926,-9528,-1,0,-1,0,8
EUN1_3567816266',7,33,11,0,0,1,0,8,1,343,78,28691,28979,33984,0,26,14,1,0,0,0,8,349,89,26964,29249,32749,0,-6,-11,1727,-3,-270,1235,-1,0,1,0,0
EUN1_3567418636',1,135,17,1,0,0,0,6,0,362,75,30624,30957,42638,4,28,15,0,0,1,0,4,368,76,29004,30275,30393,1,-6,-1,1620,2,682,12245,1,0,-1,0,2
EUN1_3562754043',3,25,16,0,0,2,0,7,1,379,79,29458,29639,30711,5,93,6,1,0,0,0,3,338,80,24573,28387,26091,1,41,-1,4885,10,1252,4620,-1,0,2,0,4
EUN1_3562328744',2,44,12,1,0,1,0,8,0,343,80,27167,30101,32056,2,28,10,0,0,0,0,3,348,80,25092,29366,31416,0,-5,0,2075,2,735,640,1,0,1,0,5
EUN1_3574541875',1,21,20,1,0,0,0,7,1,357,92,30705,32094,40438,3,29,19,1,0,1,0,5,354,76,30511,30135,43010,1,3,16,194,1,1959,-2572,0,0,-1,0,2
EUN1_3573022944',2,22,6,0,0,0,0,12,0,361,115,25020,31127,27829,5,74,13,2,0,2,0,2,399,100,29029,32926,31182,1,-38,15,-4009,-7,-1799,-3353,-2,0,-2,0,10
EUN1_3572870505',1,98,6,0,0,0,0,4,0,308,84,23346,27639,30589,3,58,17,2,1,0,0,3,359,87,29245,31741,35962,0,-51,-3,-5899,-11,-4102,-5373,-2,-1,0,0,1
EUN1_3572855071',5,58,5,0,0,0,0,15,0,320,82,24005,26928,22426,5,26,13,1,0,3,0,3,387,89,30393,31353,33634,0,-67,-7,-6388,-8,-4425,-11208,-1,0,-3,0,12
EUN1_3572835336',3,25,7,0,0,1,0,10,0,317,88,24402,26612,21868,4,30,19,2,0,1,0,3,354,78,29944,30501,38125,0,-37,10,-5542,-12,-3889,-16257,-2,0,0,0,7
EUN1_3572799654',4,24,13,1,0,0,0,6,0,359,86,27551,29955,36426,6,28,15,0,1,0,0,2,372,78,28538,31714,36769,1,-13,8,-987,-2,-1759,-343,1,-1,0,0,4
EUN1_3572774716',8,27,15,2,0,0,0,8,0,306,62,26620,27398,31919,2,27,16,0,0,2,0,3,412,77,30476,31096,35936,0,-106,-15,-3856,-1,-3698,-4017,2,0,-2,0,5
EUN1_3572375973',4,25,16,0,0,0,0,12,0,288,77,27571,26764,30542,1,26,19,1,0,3,0,3,325,76,31044,26786,39850,1,-37,1,-3473,-3,-22,-9308,-1,0,-3,0,9
EUN1_3572362058',5,25,14,1,0,0,0,10,1,355,72,27904,28258,32878,6,31,11,1,1,2,0,1,392,107,30126,30554,31863,1,-37,-35,-2222,3,-2296,1015,0,-1,-2,0,9
EUN1_3572337727',1,23,21,0,1,0,0,8,0,340,72,30838,31521,38349,7,25,18,2,0,0,0,3,336,114,29690,30615,37281,1,4,-42,1148,3,906,1068,-2,1,0,0,5
EUN1_3572326222',5,24,15,0,1,2,0,10,1,347,92,29496,31029,29583,7,29,10,2,0,1,0,4,323,88,27030,29555,32776,0,24,4,2466,5,1474,-3193,-2,1,1,0,6
EUN1_3572303321',4,23,14,1,0,0,0,11,1,360,102,28800,30044,29785,5,36,16,1,0,1,0,2,388,86,28612,31319,29828,0,-28,16,188,-2,-1275,-43,0,0,-1,0,9
EUN1_3571967496',7,26,16,2,0,1,0,3,1,366,96,28884,30135,38924,4,31,12,0,0,0,0,7,290,76,24566,28590,30701,1,76,20,4318,4,1545,8223,2,0,1,0,-4
EUN1_3571810291',5,28,5,1,1,0,0,7,0,366,94,23909,29726,23954,5,26,7,1,0,0,0,2,388,93,25933,32151,27321,0,-22,1,-2024,-2,-2425,-3367,0,1,0,0,5
EUN1_3571628133',2,23,6,0,1,0,0,7,1,363,120,25212,28795,21882,3,24,12,2,0,0,0,4,362,84,26204,30212,23149,0,1,36,-992,-6,-1417,-1267,-2,1,0,0,3
EUN1_3571493373',6,30,14,0,0,1,0,12,1,346,102,29184,30667,38146,2,24,12,2,0,0,0,3,337,104,27843,31237,36657,0,9,-2,1341,2,-570,1489,-2,0,1,0,9
EUN1_3571478374',6,26,6,0,0,1,0,4,0,394,76,25459,29434,24670,4,39,6,1,0,0,0,7,345,60,22955,26906,25001,1,49,16,2504,0,2528,-331,-1,0,1,0,-3
EUN1_3571451622',5,34,11,0,0,1,0,13,1,346,119,27870,30752,29579,4,282,15,1,0,2,0,3,362,80,29224,28743,27882,1,-16,39,-1354,-4,2009,1697,-1,0,-1,0,10
EUN1_3571442623',6,32,5,0,0,0,0,11,0,364,91,23493,28672,25640,6,31,16,1,0,2,0,1,385,96,30500,31993,33753,0,-21,-5,-7007,-11,-3321,-8113,-1,0,-2,0,10
EUN1_3571408704',2,22,15,1,0,0,0,9,0,338,104,28777,30769,34483,5,30,20,1,0,1,0,0,328,63,29611,28931,40627,1,10,41,-834,-5,1838,-6144,0,0,-1,0,9
EUN1_3570101612',6,29,15,0,0,1,0,9,1,340,78,28593,29662,34415,1,22,10,1,0,0,0,3,326,90,26474,29647,34362,1,14,-12,2119,5,15,53,-1,0,1,0,6
EUN1_3570078866',5,27,13,0,0,0,0,8,1,336,74,28125,29518,34157,3,20,14,2,0,0,0,3,348,85,27072,29015,40141,0,-12,-11,1053,-1,503,-5984,-2,0,0,0,5
EUN1_3570068148',1,23,20,0,0,0,0,11,1,311,88,32459,30811,42323,3,100,14,1,0,3,0,2,359,91,31173,31190,35885,0,-48,-3,1286,6,-379,6438,-1,0,-3,0,9
EUN1_3569004282',4,31,9,0,0,0,0,5,1,366,80,26565,30226,27659,3,28,10,1,0,1,0,3,378,100,27992,30944,31593,0,-12,-20,-1427,-1,-718,-3934,-1,0,-1,0,2
EUN1_3568202069',3,21,14,1,0,1,0,10,1,334,96,27172,28672,30821,2,26,13,0,0,0,0,4,322,80,26604,30000,31384,0,12,16,568,1,-1328,-563,1,0,1,0,6
EUN1_3567880705',4,30,24,2,0,2,0,6,1,354,89,33702,31582,44870,6,30,15,0,0,0,0,10,355,89,29009,30197,36387,1,-1,0,4693,9,1385,8483,2,0,2,0,-4
EUN1_3567860022',1,23,7,0,1,0,0,8,0,339,70,25606,26781,21333,7,25,18,2,0,1,0,4,378,82,29915,31749,36014,0,-39,-12,-4309,-11,-4968,-14681,-2,1,-1,0,4
EUN1_3567846223',4,23,7,0,1,1,0,5,1,329,78,25369,26904,23676,6,143,11,1,0,0,0,6,328,94,26277,28873,28654,0,1,-16,-908,-4,-1969,-4978,-1,1,1,0,-1
EUN1_3567788784',3,28,11,0,0,0,0,9,0,348,83,26946,29386,29307,10,38,14,2,1,1,0,3,358,116,29288,29810,28484,0,-10,-33,-2342,-3,-424,823,-2,-1,-1,0,6
EUN1_3566333495',4,31,19,2,0,2,0,14,1,278,75,29651,30079,40559,7,150,13,0,0,2,0,6,362,72,29554,29669,35582,0,-84,3,97,6,410,4977,2,0,0,0,8
EUN1_3566308255',2,24,12,2,0,2,0,8,1,402,92,30846,31561,31445,4,26,9,0,0,0,0,6,322,81,24019,28946,32209,0,80,11,6827,3,2615,-764,2,0,2,0,2
EUN1_3575761338',6,29,15,1,0,1,0,5,1,358,104,29665,30662,37875,3,24,12,1,0,0,0,5,317,72,25364,26107,25814,0,41,32,4301,3,4555,12061,0,0,1,0,0
EUN1_3575745415',2,23,14,0,0,1,0,11,1,392,90,29437,30897,33523,6,32,12,2,0,0,0,2,331,102,27143,29994,32163,1,61,-12,2294,2,903,1360,-2,0,1,0,9
EUN1_3575055978',3,23,13,0,0,0,0,10,0,343,88,26486,28165,35710,6,22,20,0,0,1,0,2,375,75,30399,32326,39008,0,-32,13,-3913,-7,-4161,-3298,0,0,-1,0,8
EUN1_3575028400',4,22,10,0,0,0,0,12,0,313,77,25882,27656,26895,6,28,22,2,1,2,0,8,335,85,31926,30779,34092,0,-22,-8,-6044,-12,-3123,-7197,-2,-1,-2,0,4
EUN1_3574997636',4,133,14,0,0,0,0,13,0,317,96,27929,29177,34917,2,19,18,1,0,2,0,4,370,100,31669,32009,39832,0,-53,-4,-3740,-4,-2832,-4915,-1,0,-2,0,9
EUN1_3574967714',5,27,10,0,0,0,0,13,0,372,70,25546,29475,30915,6,33,10,1,0,1,0,1,424,93,29456,31807,24772,0,-52,-23,-3910,0,-2332,6143,-1,0,-1,0,12
EUN1_3574934050',3,128,11,1,0,1,0,6,1,361,94,26955,29342,25511,4,22,11,0,0,0,0,5,303,90,26654,28233,24511,1,58,4,301,0,1109,1000,1,0,1,0,1
EUN1_3574921502',1,25,5,1,0,0,0,9,0,366,88,23853,27641,25795,7,39,16,1,1,2,0,2,375,90,29511,31818,31469,0,-9,-2,-5658,-11,-4177,-5674,0,-1,-2,0,7
EUN1_3574647607',2,23,8,2,0,0,0,7,0,339,116,25479,29458,29999,7,382,8,0,0,0,0,3,365,83,25416,30267,25480,0,-26,33,63,0,-809,4519,2,0,0,0,4
EUN1_3574637565',8,34,6,1,0,0,0,14,1,322,76,23603,26731,25792,3,26,19,1,0,2,0,1,379,92,31972,32312,33389,0,-57,-16,-8369,-13,-5581,-7597,0,0,-2,0,13
EUN1_3574616912',5,76,21,2,0,0,0,9,0,340,92,30981,30473,41855,5,42,14,0,0,0,0,3,289,71,27362,26364,35098,1,51,21,3619,7,4109,6757,2,0,0,0,6
EUN1_3574210692',3,27,13,0,0,0,0,3,0,390,88,28342,29695,26323,6,22,11,2,0,0,0,7,344,100,26827,29025,26196,1,46,-12,1515,2,670,127,-2,0,0,0,-4
EUN1_3574185701',2,39,17,0,0,2,0,10,0,343,103,30106,31020,39430,4,17,10,2,0,1,0,10,347,83,26851,29234,29565,1,-4,20,3255,7,1786,9865,-2,0,1,0,0
EUN1_3574174405',7,31,9,1,0,0,0,11,0,329,82,24613,27095,32582,5,29,10,1,1,2,0,1,333,116,27886,27982,31661,1,-4,-34,-3273,-1,-887,921,0,-1,-2,0,10
EUN1_3574152790',5,29,21,1,1,0,0,10,1,325,94,30605,29970,36411,6,38,16,1,0,1,0,5,317,86,29726,28638,35231,1,8,8,879,5,1332,1180,0,1,-1,0,5
EUN1_3573884668',8,32,20,1,0,3,0,8,1,387,85,31904,32895,43160,3,22,8,1,0,0,0,6,329,96,24763,29089,22969,1,58,-11,7141,12,3806,20191,0,0,3,0,2
EUN1_3573860531',1,46,6,0,0,0,0,13,1,349,77,24380,28336,29626,9,35,17,2,1,1,0,1,361,110,29879,31059,37074,0,-12,-33,-5499,-11,-2723,-7448,-2,-1,-1,0,12
EUN1_3573823896',3,66,11,2,0,2,0,10,0,355,96,28269,30160,34835,4,54,10,0,0,0,0,3,324,104,26319,29250,28580,0,31,-8,1950,1,910,6255,2,0,2,0,7
EUN1_3575806578',5,82,16,0,0,1,0,7,0,335,79,29597,29687,42507,3,26,14,2,0,0,0,4,320,88,27928,29277,33305,1,15,-9,1669,2,410,9202,-2,0,1,0,3
EUN1_3575785863',3,30,17,1,0,2,0,8,1,372,76,30653,31032,33480,2,26,8,0,0,1,0,9,310,66,24857,26527,29584,1,62,10,5796,9,4505,3896,1,0,1,0,-1
EUN1_3575306312',0,24,2,0,0,0,0,11,0,342,109,22402,27862,25808,3,101,15,1,0,2,0,3,383,70,30259,32286,36883,0,-41,39,-7857,-13,-4424,-11075,-1,0,-2,0,8
EUN1_3575234890',4,27,15,0,0,1,0,7,0,317,66,27518,26923,43915,1,24,12,1,0,0,0,5,317,104,26949,28224,34609,0,0,-38,569,3,-1301,9306,-1,0,1,0,2
EUN1_3575221583',4,51,13,1,0,1,0,10,1,339,70,27699,28398,32103,7,28,11,0,0,0,0,4,299,80,24091,27209,24234,1,40,-10,3608,2,1189,7869,1,0,1,0,6
EUN1_3575211326',5,36,16,1,0,0,0,14,0,319,82,28230,31172,40306,3,25,11,0,1,1,0,3,371,102,29513,30693,38943,0,-52,-20,-1283,5,479,1363,1,-1,-1,0,11
EUN1_3575191719',5,35,15,0,0,0,0,8,0,350,94,28865,31068,36443,1,26,16,2,0,0,0,4,306,97,28407,32099,35505,0,44,-3,458,-1,-1031,938,-2,0,0,0,4
EUN1_3574951735',2,25,15,1,1,0,0,5,0,353,76,29798,30718,38096,0,25,8,0,0,0,0,6,326,80,23711,26002,28077,1,27,-4,6087,7,4716,10019,1,1,0,0,-1
EUN1_3574926463',1,24,9,0,0,0,0,3,0,361,92,25617,28616,30606,5,26,10,1,0,0,0,3,391,73,25921,30954,30892,1,-30,19,-304,-1,-2338,-286,-1,0,0,0,0
EUN1_3574901137',3,22,12,1,0,1,0,9,1,370,105,28153,29136,31845,2,42,10,0,0,0,0,4,336,82,25477,29607,34755,1,34,23,2676,2,-471,-2910,1,0,1,0,5
EUN1_3574883316',4,27,12,1,1,0,0,11,1,317,90,26613,27499,27916,3,25,10,0,0,3,0,5,391,72,29171,28930,30323,1,-74,18,-2558,2,-1431,-2407,1,1,-3,0,6
EUN1_3574778268',3,25,21,2,1,0,0,7,0,331,78,30830,30287,40479,3,27,18,0,0,2,0,8,341,74,30650,30191,36694,1,-10,4,180,3,96,3785,2,1,-2,0,-1
EUN1_3574747725',5,48,9,1,0,0,0,5,1,323,81,24786,27498,29767,4,74,5,1,0,1,0,4,345,81,23622,28252,28659,1,-22,0,1164,4,-754,1108,0,0,-1,0,1
EUN1_3574725819',7,38,11,1,0,1,0,4,1,344,90,27180,29613,28189,5,28,6,1,0,0,0,6,383,102,24783,29272,28102,1,-39,-12,2397,5,341,87,0,0,1,0,-2
EUN1_3574483608',3,40,22,0,0,3,0,6,1,302,73,30216,30693,39304,1,22,6,1,0,1,0,8,317,92,24294,27912,34066,1,-15,-19,5922,16,2781,5238,-1,0,2,0,-2
EUN1_3574453350',1,26,24,2,0,2,0,9,1,328,109,33646,32236,40293,5,29,12,0,0,0,0,8,314,72,26933,27199,33314,1,14,37,6713,12,5037,6979,2,0,2,0,1
EUN1_3574421770',6,31,15,2,0,1,0,14,0,354,90,28418,30260,38732,1,22,12,0,0,2,0,4,365,72,27921,28668,22693,0,-11,18,497,3,1592,16039,2,0,-1,0,10
EUN1_3574312024',2,22,15,0,0,0,0,11,0,335,98,28696,30991,35262,5,30,27,2,0,3,0,2,377,76,35778,32582,42143,0,-42,22,-7082,-12,-1591,-6881,-2,0,-3,0,9
EUN1_3574302795',4,40,21,2,0,3,0,10,1,389,72,33116,31430,44648,2,150,9,0,0,1,0,8,279,84,24759,24937,33282,1,110,-12,8357,12,6493,11366,2,0,2,0,2
EUN1_3574284751',7,48,14,0,1,0,0,8,0,324,80,26268,29811,32449,3,44,9,1,0,2,0,2,363,84,28067,28975,33246,0,-39,-4,-1799,5,836,-797,-1,1,-2,0,6
EUN1_3573119580',7,76,9,1,0,2,0,4,1,389,104,28401,29508,30012,5,72,11,1,0,0,0,8,274,94,25701,27231,24661,1,115,10,2700,-2,2277,5351,0,0,2,0,-4
EUN1_3572932981',2,17,21,1,0,2,0,9,1,297,106,31616,30709,39421,5,30,12,0,0,0,0,6,316,68,25506,27857,40002,1,-19,38,6110,9,2852,-581,1,0,2,0,3
EUN1_3572350985',5,17,12,1,0,1,0,12,0,299,99,26239,27699,30512,1,22,7,0,0,1,0,3,347,76,25820,26691,29606,0,-48,23,419,5,1008,906,1,0,0,0,9
EUN1_3575932628',1,29,6,1,0,0,0,3,0,334,85,23696,28171,27051,2,25,11,0,0,1,0,2,365,102,26974,29668,27764,0,-31,-17,-3278,-5,-1497,-713,1,0,-1,0,1
EUN1_3574016974',3,65,10,0,0,1,0,12,0,375,84,27372,31445,31550,3,30,10,2,0,0,0,4,350,104,26940,28981,25286,0,25,-20,432,0,2464,6264,-2,0,1,0,8
EUN1_3574006534',4,26,14,0,1,2,0,8,1,381,82,30208,30280,37739,3,33,9,2,0,0,0,8,308,82,24561,27231,24190,1,73,0,5647,5,3049,13549,-2,1,2,0,0
EUN1_3573827256',5,24,8,0,0,1,0,8,0,351,90,25629,29718,29879,0,19,10,2,0,1,0,1,385,86,27339,29398,28641,0,-34,4,-1710,-2,320,1238,-2,0,0,0,7
EUN1_3573786547',3,161,7,0,0,0,0,14,0,279,56,22256,24047,27129,2,24,27,1,0,2,0,0,358,151,34764,35030,45650,0,-79,-95,-12508,-20,-10983,-18521,-1,0,-2,0,14
EUN1_3573753323',0,49,10,1,0,0,0,10,1,337,72,25130,27928,26950,3,26,15,1,0,2,0,0,366,128,30197,32006,34217,0,-29,-56,-5067,-5,-4078,-7267,0,0,-2,0,10
EUN1_3573726347',4,25,15,0,0,0,0,11,1,326,69,27638,28709,29564,4,28,16,2,0,0,0,2,383,99,30501,31278,37253,1,-57,-30,-2863,-1,-2569,-7689,-2,0,0,0,9
EUN1_3573317552',3,25,10,1,0,0,0,10,0,359,86,25226,29189,26006,3,29,16,1,0,0,0,1,346,118,28729,31503,35314,1,13,-32,-3503,-6,-2314,-9308,0,0,0,0,9
EUN1_3573291342',2,25,12,1,0,0,0,14,1,334,113,26786,30096,30609,4,30,10,1,0,1,0,2,337,93,26355,29065,27924,1,-3,20,431,2,1031,2685,0,0,-1,0,12
EUN1_3573255573',2,27,16,0,0,0,0,13,1,376,76,30537,32039,38096,4,45,19,2,0,0,0,2,340,76,30134,29884,38960,0,36,0,403,-3,2155,-864,-2,0,0,0,11
EUN1_3572788071',2,20,19,2,0,2,0,8,0,282,120,30711,29043,38445,1,19,8,0,0,0,0,11,327,68,24786,26747,34452,1,-45,52,5925,11,2296,3993,2,0,2,0,-3
EUN1_3572766894',2,24,7,0,0,1,0,10,0,366,112,26119,30018,22921,6,23,11,2,0,1,0,1,424,98,27862,32976,25289,0,-58,14,-1743,-4,-2958,-2368,-2,0,0,0,9
EUN1_3572754185',2,21,12,1,0,0,0,13,0,343,68,26013,28078,30955,2,24,22,0,0,2,0,3,363,92,32920,32468,40766,0,-20,-24,-6907,-10,-4390,-9811,1,0,-2,0,10
EUN1_3572708231',2,35,7,2,0,0,0,6,0,321,92,24876,26910,23692,7,35,16,0,0,0,0,4,337,107,28104,31306,32487,1,-16,-15,-3228,-9,-4396,-8795,2,0,0,0,2
EUN1_3572172451',4,22,8,0,0,0,0,8,0,326,84,23852,27785,30219,1,58,12,2,0,1,0,1,389,100,27735,31419,28936,0,-63,-16,-3883,-4,-3634,1283,-2,0,-1,0,7
EUN1_3572134834',1,19,12,2,0,1,0,6,1,373,103,27131,29726,26764,1,22,12,0,0,1,0,2,356,96,27438,31328,24299,1,17,7,-307,0,-1602,2465,2,0,0,0,4
EUN1_3572125350',4,44,23,1,0,1,0,4,1,329,98,31323,31423,42325,2,27,7,1,0,0,0,4,365,90,25319,27469,24988,1,-36,8,6004,16,3954,17337,0,0,1,0,0
EUN1_3570689598',6,30,18,2,0,1,0,7,1,356,88,30200,29618,39139,3,49,11,0,0,0,0,6,322,76,26195,27345,29348,0,34,12,4005,7,2273,9791,2,0,1,0,1
EUN1_3576217109',5,24,10,1,0,0,0,9,0,294,86,25055,26792,29589,2,19,12,1,0,1,0,6,351,94,28003,30293,27936,1,-57,-8,-2948,-2,-3501,1653,0,0,-1,0,3
EUN1_3576206712',4,22,17,2,0,0,0,5,0,357,83,28979,30550,39500,4,29,9,0,1,0,0,5,360,100,26598,30073,34351,1,-3,-17,2381,8,477,5149,2,-1,0,0,0
EUN1_3576211467',4,29,4,1,0,0,0,11,0,341,76,22995,28020,20929,10,105,14,1,1,1,0,1,375,96,29254,31026,23915,0,-34,-20,-6259,-10,-3006,-2986,0,-1,-1,0,10
EUN1_3576210197',4,29,11,1,1,0,0,12,1,338,114,26683,29824,23453,3,24,9,1,0,1,0,1,383,98,27423,29288,25092,0,-45,16,-740,2,536,-1639,0,1,-1,0,11
EUN1_3576198011',4,45,8,0,0,1,0,4,0,330,106,26376,28156,22835,4,30,12,1,0,0,0,6,354,88,26837,30377,28089,0,-24,18,-461,-4,-2221,-5254,-1,0,1,0,-2
EUN1_3576193721',4,27,11,1,0,1,0,13,0,341,76,26739,27749,32125,6,37,19,0,1,2,0,2,334,100,31119,30090,42413,0,7,-24,-4380,-8,-2341,-10288,1,-1,-1,0,11
EUN1_3576185499',6,32,11,1,0,1,0,11,1,324,80,25762,28097,27131,5,34,9,1,0,1,0,1,346,115,26632,29024,28078,1,-22,-35,-870,2,-927,-947,0,0,0,0,10
EUN1_3576200267',2,25,11,0,0,0,0,12,1,345,75,27250,29658,30281,2,27,20,1,0,2,0,3,340,88,30642,30794,39551,0,5,-13,-3392,-9,-1136,-9270,-1,0,-2,0,9
EUN1_3576156931',2,47,12,0,0,1,0,14,1,344,76,27745,28249,32743,4,22,22,2,0,1,0,3,333,100,31782,31623,39428,0,11,-24,-4037,-10,-3374,-6685,-2,0,0,0,11
EUN1_3576136633',1,19,9,0,0,0,0,12,0,307,91,24797,27020,25239,1,24,19,1,0,2,0,2,386,112,32648,33550,33129,0,-79,-21,-7851,-10,-6530,-7890,-1,0,-2,0,10
EUN1_3576113642',7,51,23,0,0,2,0,6,1,339,73,33081,30876,46112,5,23,14,1,0,1,0,10,323,90,27488,28013,32419,1,16,-17,5593,9,2863,13693,-1,0,1,0,-4
EUN1_3576081828',2,20,7,1,0,0,0,10,1,334,92,23574,28255,23320,1,19,12,1,0,1,0,0,355,102,27135,30851,37856,0,-21,-10,-3561,-5,-2596,-14536,0,0,-1,0,10
EUN1_3576057758',4,30,11,2,1,0,0,11,0,351,96,27122,29564,27941,3,60,15,0,0,1,0,4,372,80,29411,29708,40172,1,-21,16,-2289,-4,-144,-12231,2,1,-1,0,7
EUN1_3576027596',4,28,12,1,0,1,0,6,1,329,93,27963,29874,32591,8,31,12,0,0,0,0,5,404,78,27182,30012,34076,0,-75,15,781,0,-138,-1485,1,0,1,0,1
EUN1_3575967958',3,25,15,1,0,2,0,6,1,368,104,30548,32759,35306,5,32,6,0,0,2,0,6,352,79,23680,26958,27267,1,16,25,6868,9,5801,8039,1,0,0,0,0
EUN1_3575670784',4,25,15,2,0,0,0,10,1,347,105,29276,29685,33469,6,31,12,0,0,1,0,3,359,88,27435,28714,24899,1,-12,17,1841,3,971,8570,2,0,-1,0,7
EUN1_3575644057',3,25,9,0,0,0,0,12,0,284,84,24297,27251,23185,2,31,15,2,0,3,0,2,374,96,30604,30840,38914,0,-90,-12,-6307,-6,-3589,-15729,-2,0,-3,0,10
EUN1_3575662647',1,28,19,1,0,1,0,12,1,335,52,31069,27726,37971,2,210,13,1,0,3,0,3,361,85,28304,29144,28356,0,-26,-33,2765,6,-1418,9615,0,0,-2,0,9
EUN1_3575655646',3,21,11,1,0,1,0,6,0,336,64,25747,28976,26167,1,38,16,1,0,0,0,3,313,88,26749,30900,40782,0,23,-24,-1002,-5,-1924,-14615,0,0,1,0,3
EUN1_3575648868',5,126,15,1,0,1,0,8,1,346,88,28009,29817,30159,2,21,3,0,0,0,0,3,291,72,20858,25311,20067,1,55,16,7151,12,4506,10092,1,0,1,0,5
EUN1_3575571013',1,20,14,0,0,0,0,14,1,283,85,26564,29039,30568,5,33,20,2,0,3,0,1,413,93,34202,32234,38922,0,-130,-8,-7638,-6,-3195,-8354,-2,0,-3,0,13
EUN1_3575294917',3,77,10,0,0,0,0,17,0,281,82,26585,26212,38714,6,33,27,2,1,3,0,1,345,66,34879,30594,43054,0,-64,16,-8294,-17,-4382,-4340,-2,-1,-3,0,16
EUN1_3575746282',4,28,9,0,0,0,0,4,0,360,93,27097,29561,29465,8,38,9,1,0,1,0,6,304,70,23883,26228,24541,1,56,23,3214,0,3333,4924,-1,0,-1,0,-2
EUN1_3575429416',5,35,9,2,0,1,0,10,1,342,82,25209,27647,20014,6,37,12,0,1,1,0,1,398,78,28896,29857,26784,0,-56,4,-3687,-3,-2210,-6770,2,-1,0,0,9
EUN1_3575412578',2,18,8,0,0,0,0,15,0,343,80,25958,27148,28126,8,35,24,1,0,2,0,5,353,96,34105,32345,44681,0,-10,-16,-8147,-16,-5197,-16555,-1,0,-2,0,10
EUN1_3575382879',1,28,14,1,1,1,0,5,0,368,96,29220,31564,33647,3,27,12,1,0,1,0,8,353,79,27425,30369,27258,1,15,17,1795,2,1195,6389,0,1,0,0,-3
EUN1_3575363884',9,33,13,1,0,1,0,11,1,337,98,28178,29024,33072,4,31,12,1,0,1,0,5,348,84,27696,28895,34343,1,-11,14,482,1,129,-1271,0,0,0,0,6
EUN1_3575168505',6,39,7,1,0,0,0,7,0,305,82,24632,27003,25508,2,25,12,1,0,2,0,4,376,86,27872,31074,29357,0,-71,-4,-3240,-5,-4071,-3849,0,0,-2,0,3
EUN1_3574926671',4,30,20,2,0,1,0,7,0,342,78,30404,31792,38095,3,18,12,0,0,0,0,0,354,94,27054,28622,32286,1,-12,-16,3350,8,3170,5809,2,0,1,0,7
EUN1_3574903680',5,25,17,0,1,3,0,7,1,394,108,31987,33300,34866,2,26,9,2,0,2,0,8,330,104,26309,28363,25428,1,64,4,5678,8,4937,9438,-2,1,1,0,-1
EUN1_3574890235',6,29,7,0,0,1,0,11,1,386,86,27285,28766,27600,1,25,18,2,0,3,0,8,361,93,30520,31730,41552,1,25,-7,-3235,-11,-2964,-13952,-2,0,-2,0,3
EUN1_3574861732',4,25,18,0,0,0,0,8,1,339,99,29426,30822,34773,10,28,16,2,0,2,0,5,317,83,29045,28415,31391,1,22,16,381,2,2407,3382,-2,0,-2,0,3
EUN1_3574848449',1,22,10,0,0,0,0,12,0,355,87,26634,28910,28752,6,41,20,1,1,2,0,4,313,108,30750,31794,37450,0,42,-21,-4116,-10,-2884,-8698,-1,-1,-2,0,8
EUN1_3574818063',3,22,6,0,0,1,0,13,0,373,69,26015,28218,25852,4,33,15,2,1,2,0,3,377,119,30607,32058,29224,0,-4,-50,-4592,-9,-3840,-3372,-2,-1,-1,0,10
EUN1_3574808680',3,30,20,1,0,1,0,7,1,318,108,30741,31167,38998,4,27,16,1,1,0,0,4,302,97,28732,29620,33959,1,16,11,2009,4,1547,5039,0,-1,1,0,3
EUN1_3574795671',2,25,7,0,0,0,0,13,1,343,68,24968,27640,29377,4,35,18,1,0,3,0,1,392,108,31929,33532,36611,0,-49,-40,-6961,-11,-5892,-7234,-1,0,-3,0,12
EUN1_3574779707',5,61,17,0,0,1,0,8,1,321,69,29063,28515,37532,7,51,12,2,0,2,0,2,333,90,27893,29170,34194,1,-12,-21,1170,5,-655,3338,-2,0,-1,0,6
EUN1_3574770292',9,28,16,2,0,1,0,8,1,325,96,29592,29001,40317,5,34,12,0,0,1,0,5,277,76,26513,26417,26114,1,48,20,3079,4,2584,14203,2,0,0,0,3
EUN1_3574746696',4,31,17,2,1,2,0,8,1,336,102,31491,29300,40405,2,24,12,0,0,0,0,7,333,86,25794,29721,33479,1,3,16,5697,5,-421,6926,2,1,2,0,1
EUN1_3574264940',2,25,17,0,0,0,0,7,0,367,100,31026,31453,36191,4,29,14,1,0,1,0,4,329,100,26773,29531,32583,1,38,0,4253,3,1922,3608,-1,0,-1,0,3
EUN1_3574260143',1,21,5,0,0,0,0,14,0,314,82,22374,26201,30487,7,27,23,2,1,4,0,0,375,105,33890,33767,44218,0,-61,-23,-11516,-18,-7566,-13731,-2,-1,-4,0,14
EUN1_3576207683',3,25,13,0,0,1,0,2,1,383,102,28355,30044,30711,5,30,12,2,0,0,0,7,301,82,25113,26864,29126,1,82,20,3242,1,3180,1585,-2,0,1,0,-5
EUN1_3576214371',3,26,28,2,1,0,0,6,1,302,95,32264,28592,45472,3,27,14,0,0,0,0,3,327,76,29352,26199,36211,1,-25,19,2912,14,2393,9261,2,1,0,0,3
EUN1_3576197039',2,38,15,1,0,1,0,10,0,360,88,29156,30963,38866,3,29,14,1,1,0,0,2,333,66,26748,27114,32220,1,27,22,2408,1,3849,6646,0,-1,1,0,8
EUN1_3576191766',5,31,13,0,0,0,0,8,1,350,98,27976,29798,33702,4,29,14,2,0,1,0,1,351,85,28671,31906,33784,1,-1,13,-695,-1,-2108,-82,-2,0,-1,0,7
EUN1_3573519751',1,30,18,1,0,0,0,15,1,341,104,29591,30198,43586,10,32,20,0,1,1,0,1,340,76,30279,32210,36797,1,1,28,-688,-2,-2012,6789,1,-1,-1,0,14
EUN1_3573524287',1,26,14,1,0,2,0,6,0,361,96,28513,29728,35320,6,32,9,0,0,1,0,4,314,84,25523,26421,25466,1,47,12,2990,5,3307,9854,1,0,1,0,2
EUN1_3573064107',6,31,16,1,0,2,0,8,0,315,81,28594,29826,37079,3,44,14,0,0,0,0,9,335,80,27011,28155,34748,0,-20,1,1583,2,1671,2331,1,0,2,0,-1
EUN1_3573037464',4,44,15,2,0,1,0,5,1,340,82,27901,29535,32921,6,41,9,0,0,0,0,5,347,82,25852,30006,34755,1,-7,0,2049,6,-471,-1834,2,0,1,0,0
EUN1_3573030155',7,28,15,1,0,0,0,6,1,392,98,29258,30973,36643,3,304,5,0,0,0,0,5,336,74,22963,26441,25219,1,56,24,6295,10,4532,11424,1,0,0,0,1
EUN1_3568754392',0,23,21,0,0,1,0,8,1,320,74,30659,31785,33705,2,21,12,2,0,1,0,7,323,94,27562,28475,25500,1,-3,-20,3097,9,3310,8205,-2,0,0,0,1
EUN1_3568725689',8,32,27,0,1,2,0,14,1,360,67,35391,30915,39906,2,26,25,2,0,2,0,7,308,83,33014,29395,45527,1,52,-16,2377,2,1520,-5621,-2,1,0,0,7
EUN1_3568691057',2,29,7,0,0,0,0,11,0,356,92,24994,29348,24092,3,26,17,2,0,1,0,0,363,103,28906,29286,30564,0,-7,-11,-3912,-10,62,-6472,-2,0,-1,0,11
EUN1_3568129491',2,32,15,0,0,0,0,4,1,370,68,28340,30268,36577,4,39,10,1,0,0,0,3,340,88,26674,29741,30667,0,30,-20,1666,5,527,5910,-1,0,0,0,1
EUN1_3568113641',5,27,11,1,0,0,0,10,0,324,96,25332,27897,22498,4,25,9,1,0,0,0,1,376,86,26369,29640,23867,0,-52,10,-1037,2,-1743,-1369,0,0,0,0,9
EUN1_3568102328',5,31,10,0,0,0,0,9,1,341,87,25036,27771,26645,3,28,10,2,1,0,0,2,339,86,26302,28395,31701,0,2,1,-1266,0,-624,-5056,-2,-1,0,0,7
EUN1_3568085307',5,31,19,1,0,1,0,13,0,380,86,31517,33442,43702,2,20,19,1,0,1,0,2,369,90,30600,30965,42386,1,11,-4,917,0,2477,1316,0,0,0,0,11
EUN1_3568067693',7,36,28,2,0,0,0,12,0,351,82,34861,31970,46715,4,35,14,0,0,1,0,6,335,78,29812,27865,29780,1,16,4,5049,14,4105,16935,2,0,-1,0,6
EUN1_3567916414',7,31,20,1,0,0,0,6,1,343,79,30450,31013,36092,6,37,14,0,0,1,0,6,355,80,28186,29067,35528,1,-12,-1,2264,6,1946,564,1,0,-1,0,0
EUN1_3567904611',7,29,11,0,0,0,0,5,1,324,68,25639,27038,36784,6,29,17,2,0,0,0,2,296,112,27865,29414,38231,0,28,-44,-2226,-6,-2376,-1447,-2,0,0,0,3
EUN1_3571652674',3,19,13,2,1,2,0,4,1,336,108,28995,30281,26828,6,24,9,0,0,0,0,9,310,92,23939,28679,24809,1,26,16,5056,4,1602,2019,2,1,2,0,-5
EUN1_3571618411',8,65,18,0,0,0,0,11,0,347,64,29430,30197,36127,8,58,17,2,0,1,0,5,338,88,30466,29953,41102,1,9,-24,-1036,1,244,-4975,-2,0,-1,0,6
EUN1_3571046620',1,136,4,1,0,0,0,9,0,334,82,22730,26962,25458,7,25,15,1,0,1,0,3,357,86,28970,31158,31029,0,-23,-4,-6240,-11,-4196,-5571,0,0,-1,0,6
EUN1_3571010757',3,31,18,2,0,2,0,7,1,380,120,33064,32414,40380,0,25,12,0,1,1,0,9,315,75,27310,28634,26695,1,65,45,5754,6,3780,13685,2,-1,1,0,-2
EUN1_3570366429',1,28,8,0,0,0,0,12,1,318,71,25401,26513,31468,1,48,21,2,0,0,0,3,339,104,29723,31690,36779,0,-21,-33,-4322,-13,-5177,-5311,-2,0,0,0,9
EUN1_3570323064',2,33,19,1,1,0,0,7,0,298,91,29720,28039,32638,1,25,16,1,0,1,0,3,336,76,28212,27247,41114,1,-38,15,1508,3,792,-8476,0,1,-1,0,4
EUN1_3570292052',1,35,10,0,0,0,0,13,0,344,116,26087,31031,29478,4,26,15,2,0,2,0,2,333,96,29164,32650,39938,1,11,20,-3077,-5,-1619,-10460,-2,0,-2,0,11
EUN1_3570277212',2,39,15,0,0,0,0,6,1,289,87,27343,27567,30799,2,40,13,2,0,1,0,0,346,92,27699,28968,35078,0,-57,-5,-356,2,-1401,-4279,-2,0,-1,0,6
EUN1_3569892440',3,21,9,2,0,0,0,7,1,337,100,25163,29962,22360,3,38,10,0,0,1,0,4,355,116,27452,30424,29148,0,-18,-16,-2289,-1,-462,-6788,2,0,-1,0,3
EUN1_3569878184',6,31,10,2,0,0,0,5,0,387,115,27274,30827,31708,3,41,9,0,0,0,0,4,354,88,25809,29848,27017,1,33,27,1465,1,979,4691,2,0,0,0,1
EUN1_3569271179',5,39,15,0,1,0,0,12,0,348,106,30100,31938,36878,3,18,20,1,0,0,0,2,303,85,28677,30346,37751,0,45,21,1423,-5,1592,-873,-1,1,0,0,10
EUN1_3569237638',0,17,7,0,0,0,0,12,0,358,82,25245,29274,28731,4,30,13,1,0,1,0,4,356,97,27947,30293,37034,0,2,-15,-2702,-6,-1019,-8303,-1,0,-1,0,8
EUN1_3569210562',1,32,5,0,0,0,0,8,0,340,102,23440,27673,30123,8,27,15,2,0,2,0,0,423,94,30663,34114,35472,0,-83,8,-7223,-10,-6441,-5349,-2,0,-2,0,8
EUN1_3569186431',3,38,10,0,0,0,0,10,0,349,100,27789,28018,31111,1,21,15,1,0,0,0,5,304,80,27741,28404,36828,0,45,20,48,-5,-386,-5717,-1,0,0,0,5
EUN1_3567811691',2,22,16,2,0,1,0,12,1,329,76,27563,30357,31135,2,24,9,0,0,1,0,4,348,84,26873,28215,28031,1,-19,-8,690,7,2142,3104,2,0,0,0,8
EUN1_3567409531',4,50,23,1,0,1,0,12,1,348,90,32424,31675,35370,4,29,7,0,0,1,0,4,348,40,23409,25139,26912,1,0,50,9015,16,6536,8458,1,0,0,0,8
EUN1_3574584653',4,39,10,1,0,0,0,7,1,343,94,25991,29274,31282,4,20,11,1,1,1,0,1,353,94,28179,29948,28601,0,-10,0,-2188,-1,-674,2681,0,-1,-1,0,6
EUN1_3572814919',2,22,15,1,0,1,0,8,0,362,79,28793,31124,40239,5,39,13,1,0,1,0,2,333,84,28394,29292,30823,0,29,-5,399,2,1832,9416,0,0,0,0,6
EUN1_3571989824',3,29,15,0,0,0,0,14,0,318,85,28129,28247,32375,5,22,16,2,0,2,0,5,357,83,29767,30781,33593,0,-39,2,-1638,-1,-2534,-1218,-2,0,-2,0,9
EUN1_3571979655',4,66,8,0,0,0,0,12,0,321,77,23817,28820,28262,1,58,14,2,1,2,0,0,392,109,30276,32083,28429,0,-71,-32,-6459,-6,-3263,-167,-2,-1,-2,0,12
EUN1_3571815942',4,24,15,1,0,2,0,7,0,320,94,28903,30222,33058,3,20,12,0,0,0,0,7,294,80,26729,27180,31832,1,26,14,2174,3,3042,1226,1,0,2,0,0
EUN1_3571799977',4,32,12,2,0,2,0,10,1,399,76,29171,31749,31688,2,20,8,0,0,1,0,7,344,86,25817,27045,25569,1,55,-10,3354,4,4704,6119,2,0,1,0,3
EUN1_3571791579',4,23,13,0,0,0,0,8,0,344,82,27798,27872,37168,2,25,12,2,0,1,0,6,331,69,26761,27375,30876,0,13,13,1037,1,497,6292,-2,0,-1,0,2
EUN1_3571763895',3,23,20,0,0,3,0,7,1,345,100,32474,29022,40629,4,42,16,1,0,1,0,13,328,80,29484,29779,32058,1,17,20,2990,4,-757,8571,-1,0,2,0,-6
EUN1_3571690312',6,22,15,1,0,0,0,5,0,355,92,28846,29911,30451,2,26,4,0,0,0,0,4,316,84,21817,26520,23457,1,39,8,7029,11,3391,6994,1,0,0,0,1
EUN1_3568082776',5,27,5,0,0,1,0,3,0,382,84,24992,29015,29441,6,26,11,1,1,0,0,0,367,100,25793,31745,28033,1,15,-16,-801,-6,-2730,1408,-1,-1,1,0,3
EUN1_3567713380',3,35,14,1,0,0,0,9,1,318,69,26375,27011,32055,3,58,12,0,1,1,0,1,361,104,28070,29279,29174,0,-43,-35,-1695,2,-2268,2881,1,-1,-1,0,8
EUN1_3567680957',5,335,9,2,0,0,0,10,1,306,88,25266,27147,26288,6,28,14,0,0,1,0,3,337,84,27733,29576,28279,0,-31,4,-2467,-5,-2429,-1991,2,0,-1,0,7
EUN1_3567586083',2,29,13,0,0,1,0,15,0,340,86,27690,28384,35168,3,29,14,2,0,2,0,4,370,81,29339,29055,37209,0,-30,5,-1649,-1,-671,-2041,-2,0,-1,0,11
EUN1_3567290010',5,41,9,0,0,1,0,11,1,351,81,26952,27940,28606,5,28,14,1,0,1,0,2,341,86,29090,29679,30362,0,10,-5,-2138,-5,-1739,-1756,-1,0,0,0,9
EUN1_3567274610',3,22,14,0,0,0,0,7,1,353,90,28400,31085,37591,4,29,6,1,0,1,0,4,336,82,24026,28702,29363,1,17,8,4374,8,2383,8228,-1,0,-1,0,3
EUN1_3565005674',7,42,14,0,0,0,0,9,0,347,86,27618,27841,31466,6,29,11,2,0,0,0,3,316,86,25613,26778,30515,0,31,0,2005,3,1063,951,-2,0,0,0,6
EUN1_3564446735',3,57,7,0,0,0,0,7,0,346,70,24536,29912,26314,6,63,13,0,0,2,0,4,379,82,28068,31636,35142,0,-33,-12,-3532,-6,-1724,-8828,0,0,-2,0,3
EUN1_3564416878',4,29,8,1,0,0,0,4,1,381,88,25613,29535,29246,8,53,6,0,0,0,0,5,367,88,23121,29699,25128,1,14,0,2492,2,-164,4118,1,0,0,0,-1
EUN1_3561312001',2,33,8,0,0,1,0,12,1,369,37,26338,24903,29468,3,27,16,2,0,1,0,3,279,82,25315,25215,28433,0,90,-45,1023,-8,-312,1035,-2,0,0,0,9
EUN1_3560753925',4,27,8,0,0,0,0,13,0,284,72,22685,25234,29725,5,36,13,2,1,2,0,0,345,116,29961,29185,28205,0,-61,-44,-7276,-5,-3951,1520,-2,-1,-2,0,13
EUN1_3560749550',5,31,12,1,0,0,0,2,1,380,75,28208,30849,31940,4,24,14,1,0,1,0,7,353,115,28626,31133,37639,1,27,-40,-418,-2,-284,-5699,0,0,-1,0,-5
EUN1_3559774922',2,40,19,0,0,2,0,9,1,315,80,30752,29414,40287,11,46,11,1,0,1,0,8,305,100,27338,28533,36598,0,10,-20,3414,8,881,3689,-1,0,1,0,1
EUN1_3575771440',1,21,20,1,0,1,0,9,0,336,74,30403,30758,42785,2,17,17,1,0,0,0,2,336,81,29813,30264,36000,0,0,-7,590,3,494,6785,0,0,1,0,7
EUN1_3574169767',1,22,20,2,1,1,0,10,1,321,102,30296,31093,42812,1,24,14,0,0,1,0,5,300,78,27354,28652,34007,1,21,24,2942,6,2441,8805,2,1,0,0,5
EUN1_3573803141',2,26,17,2,0,1,0,8,0,341,77,29193,30564,33633,6,27,9,0,0,1,0,6,321,64,25762,27202,33665,1,20,13,3431,8,3362,-32,2,0,0,0,2
EUN1_3573769815',5,26,13,2,0,0,0,15,0,391,60,27113,28533,28837,3,30,10,0,0,2,0,2,415,96,30169,31312,26652,0,-24,-36,-3056,3,-2779,2185,2,0,-2,0,13
EUN1_3571446867',1,23,5,0,0,2,0,6,1,374,86,26351,29893,28913,7,30,7,1,0,1,0,11,342,82,25342,30503,27505,0,32,4,1009,-2,-610,1408,-1,0,1,0,-5
EUN1_3571429773',1,25,17,2,0,1,0,7,1,332,71,29123,30034,34569,7,30,8,0,0,1,0,6,293,89,24433,25725,37020,0,39,-18,4690,9,4309,-2451,2,0,0,0,1
EUN1_3571354130',9,31,15,2,0,1,0,7,0,303,95,27296,27582,28722,1,39,11,0,0,0,0,2,331,78,25404,27906,21112,1,-28,17,1892,4,-324,7610,2,0,1,0,5
EUN1_3571336736',6,32,18,1,0,1,0,2,1,363,98,30311,31715,37823,3,31,10,1,0,0,0,9,326,77,25454,28527,28245,1,37,21,4857,8,3188,9578,0,0,1,0,-7
EUN1_3569305066',6,33,15,2,0,1,0,11,1,357,76,30802,30173,37825,3,26,13,0,0,0,0,6,327,92,26888,29562,36617,0,30,-16,3914,2,611,1208,2,0,1,0,5
EUN1_3573231085',3,25,6,0,0,1,0,6,0,362,96,26050,28677,28855,3,22,12,2,0,0,0,7,361,74,27511,28968,27613,0,1,22,-1461,-6,-291,1242,-2,0,1,0,-1
EUN1_3573194730',3,27,6,1,0,0,0,10,1,342,82,24151,27999,20469,3,24,15,1,0,2,0,0,379,86,29080,29542,29255,0,-37,-4,-4929,-9,-1543,-8786,0,0,-2,0,10
EUN1_3572677185',1,21,18,2,0,1,0,6,0,410,96,31063,33126,42201,5,275,11,0,0,0,0,3,308,74,25347,28110,39762,1,102,22,5716,7,5016,2439,2,0,1,0,3
EUN1_3572560701',2,24,17,2,0,0,0,12,0,310,87,28712,30817,37122,0,22,22,0,0,1,0,3,367,80,30213,30216,36701,1,-57,7,-1501,-5,601,421,2,0,-1,0,9
EUN1_3572544719',5,21,10,2,0,0,0,13,0,332,76,26014,27082,30688,4,20,15,0,0,1,0,1,332,86,29830,28360,38390,0,0,-10,-3816,-5,-1278,-7702,2,0,-1,0,12
EUN1_3572357878',2,31,9,0,1,0,0,8,0,324,86,24493,29219,25640,6,31,13,2,0,0,0,2,344,93,26865,30328,30717,0,-20,-7,-2372,-4,-1109,-5077,-2,1,0,0,6
EUN1_3572163922',0,28,11,0,0,0,0,7,1,330,88,26891,27295,35945,4,42,12,1,0,0,0,1,320,69,25927,28257,26968,0,10,19,964,-1,-962,8977,-1,0,0,0,6
EUN1_3572129419',3,30,12,2,0,0,0,11,0,365,96,27148,30735,35535,6,25,14,0,0,1,0,2,284,92,27762,27502,26217,1,81,4,-614,-2,3233,9318,2,0,-1,0,9
EUN1_3572098490',5,26,12,1,0,0,0,7,0,293,104,26763,27705,29022,5,33,13,1,0,0,0,1,347,80,27316,27745,34326,0,-54,24,-553,-1,-40,-5304,0,0,0,0,6
EUN1_3571634557',3,26,23,2,0,2,0,5,1,336,94,32358,29645,42871,7,29,15,0,0,0,0,8,274,66,27256,25082,32824,1,62,28,5102,8,4563,10047,2,0,2,0,-3
EUN1_3569187460',3,27,12,1,0,1,0,15,1,342,72,28568,27733,30205,3,33,19,1,1,2,0,5,396,96,32725,33593,35097,0,-54,-24,-4157,-7,-5860,-4892,0,-1,-1,0,10
EUN1_3569115593',4,46,13,1,0,1,0,1,1,360,68,28528,29629,32440,8,28,9,1,0,1,0,8,266,80,23056,24598,26792,1,94,-12,5472,4,5031,5648,0,0,0,0,-7
EUN1_3569090259',8,34,11,1,0,0,0,9,1,304,94,26946,30190,29816,5,27,16,1,0,0,0,0,381,77,29091,31954,31575,0,-77,17,-2145,-5,-1764,-1759,0,0,0,0,9
EUN1_3569067358',5,37,12,0,0,0,0,12,0,313,84,25521,28125,32493,3,28,12,2,0,2,0,2,380,108,29394,29829,35543,0,-67,-24,-3873,0,-1704,-3050,-2,0,-2,0,10
EUN1_3569024312',3,29,17,1,1,0,0,6,1,357,80,28196,31353,27744,2,26,8,0,0,0,0,0,346,92,25061,29313,30392,1,11,-12,3135,9,2040,-2648,1,1,0,0,6
EUN1_3569004965',1,29,9,2,0,1,0,9,1,345,99,26052,28373,28943,3,89,6,0,0,0,0,7,341,90,24700,26907,32066,1,4,9,1352,3,1466,-3123,2,0,1,0,2
EUN1_3568988827',3,37,20,1,1,0,0,10,1,328,100,30983,30718,33071,4,28,13,1,0,2,0,3,352,75,29376,28862,30679,1,-24,25,1607,7,1856,2392,0,1,-2,0,7
EUN1_3568974671',4,78,12,0,1,0,0,8,0,330,96,26337,29668,35260,4,63,11,2,0,1,0,1,343,88,27598,29251,32497,0,-13,8,-1261,1,417,2763,-2,1,-1,0,7
EUN1_3568196739',2,28,14,0,0,1,0,10,0,386,84,28963,30558,31457,4,27,19,2,0,0,0,4,360,112,31210,32408,36905,1,26,-28,-2247,-5,-1850,-5448,-2,0,1,0,6
EUN1_3568151021',2,33,13,0,0,0,0,8,0,343,93,27430,30547,30318,4,26,14,1,0,0,0,1,369,91,27452,30460,30438,1,-26,2,-22,-1,87,-120,-1,0,0,0,7
EUN1_3575861367',5,29,14,0,1,1,0,13,1,366,104,29173,31786,27928,3,25,9,1,0,2,0,5,400,87,27990,30101,29934,1,-34,17,1183,5,1685,-2006,-1,1,-1,0,8
EUN1_3575819147',4,29,19,2,0,6,0,1,0,388,108,34177,32300,38252,3,28,5,0,0,0,0,15,308,71,22534,25913,23659,1,80,37,11643,14,6387,14593,2,0,6,0,-14
EUN1_3574157132',1,26,11,0,0,0,0,12,0,326,58,25463,27180,34388,0,18,29,2,0,2,0,3,347,90,33751,32489,50773,0,-21,-32,-8288,-18,-5309,-16385,-2,0,-2,0,9
EUN1_3570729160',3,27,10,1,0,1,0,4,1,356,70,25897,27406,28089,0,332,17,0,0,1,0,5,381,69,30468,31018,38565,0,-25,1,-4571,-7,-3612,-10476,1,0,0,0,-1
EUN1_3570702860',5,23,2,0,0,0,0,12,0,350,94,22209,26034,16622,6,24,20,2,0,3,0,1,407,78,33294,31997,36158,0,-57,16,-11085,-18,-5963,-19536,-2,0,-3,0,11
EUN1_3570658435',3,22,11,0,1,0,0,10,1,391,94,27499,31686,25468,4,28,7,2,0,1,0,3,413,101,27552,30890,27363,0,-22,-7,-53,4,796,-1895,-2,1,-1,0,7
EUN1_3570645082',4,25,6,0,0,0,0,9,0,347,100,25026,28861,25295,5,31,14,2,0,1,0,1,376,84,28057,31403,27320,1,-29,16,-3031,-8,-2542,-2025,-2,0,-1,0,8
EUN1_3570153095',8,35,5,1,0,0,0,8,0,353,104,23473,29434,24200,3,17,11,1,0,1,0,1,385,96,27825,30454,32886,0,-32,8,-4352,-6,-1020,-8686,0,0,-1,0,7
EUN1_3570092554',4,26,17,2,0,1,0,8,1,343,84,29237,30121,35960,4,25,13,0,0,0,0,5,329,80,26495,28170,27988,0,14,4,2742,4,1951,7972,2,0,1,0,3
EUN1_3570065048',5,23,18,0,0,1,0,10,0,315,84,30611,29291,37060,9,56,16,1,0,2,0,8,333,77,28482,28491,35344,1,-18,7,2129,2,800,1716,-1,0,-1,0,2
EUN1_3570043663',2,144,11,1,1,0,0,5,0,321,74,25734,28815,26897,3,24,11,0,0,0,0,2,340,94,25938,28506,30513,1,-19,-20,-204,0,309,-3616,1,1,0,0,3
EUN1_3568940021',2,40,17,1,0,2,0,8,0,331,94,29724,30328,37749,4,26,18,1,0,0,0,5,304,82,28936,29248,40822,0,27,12,788,-1,1080,-3073,0,0,2,0,3
EUN1_3568502234',4,29,10,0,0,0,0,10,0,343,76,24993,27712,24144,5,30,11,2,1,1,0,1,398,104,27535,29105,30460,0,-55,-28,-2542,-1,-1393,-6316,-2,-1,-1,0,9
EUN1_3567820124',0,30,12,1,0,0,0,7,1,326,89,27334,29942,30278,4,24,12,1,0,1,0,5,346,89,27614,28570,38074,0,-20,0,-280,0,1372,-7796,0,0,-1,0,2
EUN1_3567763942',6,31,18,2,0,1,0,6,1,341,106,32210,31758,35964,1,21,9,0,0,0,0,4,353,102,25718,30357,26985,1,-12,4,6492,9,1401,8979,2,0,1,0,2
EUN1_3567721753',4,28,22,1,0,1,0,9,1,301,75,30695,28642,42631,4,19,15,0,0,0,0,2,268,80,27080,26134,41325,1,33,-5,3615,7,2508,1306,1,0,1,0,7
EUN1_3567407652',1,42,5,1,0,0,0,7,0,390,92,23898,30247,21350,4,35,7,1,0,0,0,1,385,106,26554,30176,24415,0,5,-14,-2656,-2,71,-3065,0,0,0,0,6
EUN1_3567376889',3,61,11,1,0,0,0,11,0,346,89,27409,29498,35321,5,28,16,1,0,1,0,2,358,78,30942,29430,41327,0,-12,11,-3533,-5,68,-6006,0,0,-1,0,9
EUN1_3575262545',4,30,13,0,0,1,0,13,0,327,56,26848,25406,30495,3,40,28,2,0,2,0,4,274,96,33284,29628,41144,0,53,-40,-6436,-15,-4222,-10649,-2,0,-1,0,9
EUN1_3575250104',3,36,17,2,0,0,0,8,0,372,82,29363,31390,33024,2,119,9,0,0,2,0,4,368,101,26191,28953,28874,1,4,-19,3172,8,2437,4150,2,0,-2,0,4
EUN1_3575226014',2,22,9,1,0,0,0,15,1,330,73,24050,28340,22871,1,62,13,1,1,3,0,2,383,106,29706,31770,33006,0,-53,-33,-5656,-4,-3430,-10135,0,-1,-3,0,13
EUN1_3575215617',6,79,19,1,1,2,0,5,1,410,94,32576,31835,35048,5,28,10,1,0,1,0,7,332,74,26595,28836,27077,1,78,20,5981,9,2999,7971,0,1,1,0,-2
EUN1_3575194016',2,30,12,0,1,2,0,6,0,413,102,29048,33766,30155,3,22,4,2,0,1,0,8,391,106,24990,29332,23200,1,22,-4,4058,8,4434,6955,-2,1,1,0,-2
EUN1_3575187653',3,25,8,1,0,0,0,11,1,282,93,23636,25134,29466,2,28,24,1,0,1,0,5,314,74,29794,28325,44665,0,-32,19,-6158,-16,-3191,-15199,0,0,-1,0,6
EUN1_3575180489',2,29,25,2,0,2,0,9,1,326,111,33065,32566,41764,0,41,8,0,0,0,0,5,282,60,23538,24458,31347,1,44,51,9527,17,8108,10417,2,0,2,0,4
EUN1_3575163944',2,24,12,0,0,1,0,14,0,329,74,28306,29528,37336,1,23,24,2,0,2,0,3,358,101,32421,31788,45108,0,-29,-27,-4115,-12,-2260,-7772,-2,0,-1,0,11
EUN1_3575084865',1,18,9,0,0,2,0,3,1,390,98,28514,29819,26149,1,22,13,2,0,0,0,10,288,82,25029,28917,31710,1,102,16,3485,-4,902,-5561,-2,0,2,0,-7
EUN1_3575073966',2,25,6,0,0,0,0,11,0,397,90,24484,29472,26411,2,18,9,1,0,2,0,3,381,86,27555,28979,24760,0,16,4,-3071,-3,493,1651,-1,0,-2,0,8
EUN1_3575062012',3,24,23,2,0,2,0,6,0,346,78,31697,30096,43381,5,27,11,0,0,0,0,7,314,82,25529,26469,26455,1,32,-4,6168,12,3627,16926,2,0,2,0,-1
EUN1_3575040860',3,28,10,1,0,0,0,7,0,342,73,25281,28273,31581,2,29,7,0,0,0,0,6,351,70,23817,27859,20666,1,-9,3,1464,3,414,10915,1,0,0,0,1
EUN1_3572464764',1,30,11,1,1,1,0,5,1,371,99,28470,29880,29985,1,81,9,1,0,0,0,5,304,92,23709,26905,23544,1,67,7,4761,2,2975,6441,0,1,1,0,0
EUN1_3572453926',5,61,13,2,0,1,0,10,0,344,73,27357,28146,26533,3,36,6,0,0,4,0,6,359,96,25732,27574,21271,1,-15,-23,1625,7,572,5262,2,0,-3,0,4
EUN1_3572323538',8,38,7,1,0,1,0,6,1,377,94,25608,28611,32803,2,46,10,1,0,0,0,4,336,94,25690,28036,25561,0,41,0,-82,-3,575,7242,0,0,1,0,2
EUN1_3571968817',1,62,9,0,0,0,0,14,0,312,74,24364,27311,21641,4,69,19,2,0,3,0,2,394,121,33537,32736,39464,0,-82,-47,-9173,-10,-5425,-17823,-2,0,-3,0,12
EUN1_3575582565',4,22,14,2,0,1,0,8,1,364,96,29117,30296,36171,3,28,9,0,0,1,0,11,318,84,25866,29874,23937,1,46,12,3251,5,422,12234,2,0,0,0,-3
EUN1_3575497686',4,22,21,2,0,1,0,11,0,328,90,30622,31588,45609,0,24,11,0,0,0,0,2,344,66,26262,27560,33898,1,-16,24,4360,10,4028,11711,2,0,1,0,9
EUN1_3572845891',5,136,20,1,0,0,0,10,0,347,62,30698,30090,38690,4,25,17,1,0,2,0,4,345,114,30903,31189,38040,0,2,-52,-205,3,-1099,650,0,0,-2,0,6
EUN1_3572790071',5,22,14,1,0,0,0,10,1,368,83,29395,29641,32672,8,29,21,1,0,1,0,3,354,88,31928,33016,36309,0,14,-5,-2533,-7,-3375,-3637,0,0,-1,0,7
EUN1_3572764039',1,22,13,1,0,0,0,7,1,322,100,28161,29277,33493,6,45,13,0,1,0,0,2,366,87,27309,29311,32480,0,-44,13,852,0,-34,1013,1,-1,0,0,5
EUN1_3571152702',3,33,14,0,0,1,0,13,0,375,78,28370,29620,34847,6,28,10,2,0,1,0,3,348,82,26907,29298,28134,0,27,-4,1463,4,322,6713,-2,0,0,0,10
EUN1_3571134470',2,25,9,1,0,0,0,3,1,354,108,26170,31544,25371,3,39,5,0,0,0,0,3,326,99,22889,28739,27523,1,28,9,3281,4,2805,-2152,1,0,0,0,0
EUN1_3570436723',3,25,11,0,0,0,0,11,0,335,85,26527,28241,35174,3,31,18,1,0,1,0,0,357,96,31566,30319,40540,0,-22,-11,-5039,-7,-2078,-5366,-1,0,-1,0,11
EUN1_3570404773',2,28,7,1,0,0,0,8,0,336,92,24410,28780,30894,6,29,19,1,0,0,0,2,355,88,29722,30982,31655,0,-19,4,-5312,-12,-2202,-761,0,0,0,0,6
EUN1_3572835325',4,26,14,1,0,0,0,9,1,319,84,29024,28975,35777,2,20,19,1,0,2,0,5,365,92,30513,31755,39037,0,-46,-8,-1489,-5,-2780,-3260,0,0,-2,0,4
EUN1_3572806124',5,31,7,2,1,0,0,7,0,324,99,24069,28503,19507,8,35,5,0,0,0,0,2,361,91,23813,28173,25525,1,-37,8,256,2,330,-6018,2,1,0,0,5
EUN1_3572774205',4,23,3,2,0,0,0,11,0,323,92,21090,27900,20966,3,19,17,0,1,2,0,0,326,100,30465,32739,36852,0,-3,-8,-9375,-14,-4839,-15886,2,-1,-2,0,11
EUN1_3572735005',1,56,15,0,0,1,0,5,0,374,91,29219,30989,33249,8,171,12,2,0,0,0,5,317,72,25512,27734,36889,1,57,19,3707,3,3255,-3640,-2,0,1,0,0
EUN1_3572264847',6,26,8,1,0,0,0,5,1,383,68,24942,28346,29942,6,28,12,1,0,0,0,2,346,79,25992,29631,36870,0,37,-11,-1050,-4,-1285,-6928,0,0,0,0,3
EUN1_3572222892',3,27,11,0,0,1,0,13,1,290,74,24715,28542,24472,2,31,10,2,0,3,0,0,354,118,28492,31078,35868,0,-64,-44,-3777,1,-2536,-11396,-2,0,-2,0,13
EUN1_3572196946',0,79,9,1,0,1,0,13,0,317,88,25039,27228,22284,5,40,18,1,1,1,0,1,335,86,29400,29602,34052,0,-18,2,-4361,-9,-2374,-11768,0,-1,0,0,12
EUN1_3572174429',5,23,6,0,0,0,0,9,0,364,110,25077,29877,29971,1,24,15,2,0,1,0,2,339,86,28067,30666,29659,1,25,24,-2990,-9,-789,312,-2,0,-1,0,7
EUN1_3571699764',6,26,19,1,0,2,0,6,1,323,90,30000,28426,40418,6,29,12,0,0,1,0,5,311,70,27281,27474,30782,1,12,20,2719,7,952,9636,1,0,1,0,1
EUN1_3571667800',2,20,12,1,1,0,0,13,0,327,96,26303,29026,33403,4,28,11,1,0,1,0,0,361,88,27745,28235,28837,1,-34,8,-1442,1,791,4566,0,1,-1,0,13
EUN1_3571540999',1,19,14,0,0,0,0,9,1,354,88,27731,31626,28732,5,24,9,1,0,0,0,1,372,76,25050,28708,26982,1,-18,12,2681,5,2918,1750,-1,0,0,0,8
EUN1_3571451607',4,25,3,0,0,0,0,7,0,316,103,22238,27387,25965,5,32,14,2,0,1,0,3,355,92,27440,30716,33642,0,-39,11,-5202,-11,-3329,-7677,-2,0,-1,0,4
EUN1_3571438356',2,233,8,0,0,1,0,12,0,329,77,25104,28041,20589,5,65,11,2,0,1,0,5,354,84,28226,27823,30063,0,-25,-7,-3122,-3,218,-9474,-2,0,0,0,7
EUN1_3568921894',2,25,16,1,0,0,0,6,0,363,95,29481,32327,37939,3,30,9,0,0,1,0,4,343,78,25514,28154,29791,1,20,17,3967,7,4173,8148,1,0,-1,0,2
EUN1_3568908542',6,27,9,0,0,1,0,9,0,359,101,26846,29350,29500,7,38,12,2,0,1,0,7,335,94,27518,29025,27353,0,24,7,-672,-3,325,2147,-2,0,0,0,2
EUN1_3568778257',5,26,13,1,1,1,0,7,1,348,104,28448,29421,36626,1,28,7,1,0,0,0,6,293,75,23785,27012,29857,1,55,29,4663,6,2409,6769,0,1,1,0,1
EUN1_3568745168',2,26,7,0,1,0,0,11,1,329,64,24837,26687,21078,5,32,16,2,0,1,0,3,371,104,30263,30366,30431,0,-42,-40,-5426,-9,-3679,-9353,-2,1,-1,0,8
EUN1_3568724107',3,29,12,1,0,3,0,7,1,363,79,30548,29957,30757,3,22,15,0,0,0,0,11,308,76,26403,28603,35112,1,55,3,4145,-3,1354,-4355,1,0,3,0,-4
EUN1_3568689317',5,76,15,2,0,1,0,9,1,334,82,29315,30203,32286,2,25,12,0,0,0,0,5,331,98,27420,29201,36851,1,3,-16,1895,3,1002,-4565,2,0,1,0,4
EUN1_3568551088',4,48,10,1,1,0,0,5,1,364,109,27019,29491,38592,2,30,11,1,0,0,0,7,323,84,24991,28830,22502,0,41,25,2028,-1,661,16090,0,1,0,0,-2
EUN1_3575886481',1,42,19,1,0,0,0,12,1,311,70,28626,27211,36142,6,138,21,1,0,2,0,2,329,102,32235,30203,45538,0,-18,-32,-3609,-2,-2992,-9396,0,0,-2,0,10
EUN1_3575372392',3,29,17,2,0,3,0,5,1,419,94,32551,31884,34213,3,19,6,0,0,0,0,10,295,56,22697,26489,23029,1,124,38,9854,11,5395,11184,2,0,3,0,-5
EUN1_3575349430',2,159,15,0,0,2,0,8,0,340,106,28454,30048,33452,1,31,13,2,1,1,0,9,341,92,27549,29408,30452,0,-1,14,905,2,640,3000,-2,-1,1,0,-1
EUN1_3575270325',5,43,28,1,0,0,0,8,0,303,89,31844,30007,44367,0,18,21,1,1,1,0,2,300,110,31475,30038,52037,0,3,-21,369,7,-31,-7670,0,-1,-1,0,6
EUN1_3575254323',2,24,10,0,0,1,0,7,1,382,66,26902,28694,24408,2,26,13,2,0,0,0,4,360,106,28164,30642,38113,0,22,-40,-1262,-3,-1948,-13705,-2,0,1,0,3
EUN1_3575236430',3,47,8,2,0,0,0,7,0,374,72,24890,28628,28521,5,30,7,0,1,0,0,4,360,103,25384,28313,29631,1,14,-31,-494,1,315,-1110,2,-1,0,0,3
EUN1_3574876262',4,424,9,0,0,0,0,12,0,324,71,24390,27361,29363,0,58,19,2,0,2,0,0,325,96,29567,29566,39092,0,-1,-25,-5177,-10,-2205,-9729,-2,0,-2,0,12
EUN1_3574844978',5,27,20,0,1,1,0,12,1,383,96,30599,31511,35289,1,20,8,2,0,1,0,4,337,76,25225,28112,18086,1,46,20,5374,12,3399,17203,-2,1,0,0,8
EUN1_3574817688',1,25,17,1,0,1,0,5,1,397,88,30435,31212,29204,2,31,8,1,0,0,0,6,364,96,24629,29844,25201,0,33,-8,5806,9,1368,4003,0,0,1,0,-1
EUN1_3574767814',6,32,11,0,1,1,0,15,0,340,86,28410,28671,33704,1,24,17,2,0,3,0,3,331,106,31148,29716,35746,0,9,-20,-2738,-6,-1045,-2042,-2,1,-2,0,12
EUN1_3574655187',1,37,19,1,0,0,0,3,1,344,102,30198,32065,42542,2,22,16,1,0,1,0,1,322,82,28174,28440,34684,1,22,20,2024,3,3625,7858,0,0,-1,0,2
EUN1_3574563384',5,32,5,0,0,0,0,14,0,280,80,21297,26474,27701,1,36,23,1,0,3,0,1,396,112,33084,34272,38665,0,-116,-32,-11787,-18,-7798,-10964,-1,0,-3,0,13
EUN1_3574431973',3,27,13,0,0,0,0,13,0,316,90,27802,28038,28628,2,20,16,2,1,2,0,4,344,94,31592,30916,30921,0,-28,-4,-3790,-3,-2878,-2293,-2,-1,-2,0,9
EUN1_3574378958',0,72,6,1,0,0,0,11,0,325,80,23829,28781,26816,5,65,15,1,1,1,0,2,314,108,28708,31156,33324,1,11,-28,-4879,-9,-2375,-6508,0,-1,-1,0,9
EUN1_3570938379',1,47,14,0,0,1,0,9,1,292,87,28244,29226,32458,5,48,18,1,0,1,0,6,332,87,30631,30812,44358,0,-40,0,-2387,-4,-1586,-11900,-1,0,0,0,3
EUN1_3570877072',5,26,16,1,0,0,0,9,1,338,80,27548,30406,32749,5,28,10,0,0,0,0,1,397,76,26134,30700,26274,0,-59,4,1414,6,-294,6475,1,0,0,0,8
EUN1_3570667078',2,25,13,2,1,0,0,10,1,325,70,26966,29501,35850,2,23,9,0,0,2,0,5,383,110,26979,30519,30297,1,-58,-40,-13,4,-1018,5553,2,1,-2,0,5
EUN1_3570641429',3,23,8,0,0,0,0,13,0,345,65,24602,29450,27126,2,28,13,2,0,1,0,2,364,111,28694,30638,36205,1,-19,-46,-4092,-5,-1188,-9079,-2,0,-1,0,11
EUN1_3570505786',4,38,17,0,0,2,0,8,1,363,108,30874,30504,35631,1,24,10,1,1,1,0,8,287,84,25974,25592,24850,1,76,24,4900,7,4912,10781,-1,-1,1,0,0
EUN1_3573626112',4,25,6,0,0,0,0,7,0,364,106,25134,29951,31090,3,39,16,1,0,0,0,1,356,94,28794,32075,36019,0,8,12,-3660,-10,-2124,-4929,-1,0,0,0,6
EUN1_3572039917',2,28,10,0,0,0,0,9,0,338,68,25900,27307,27432,1,22,22,2,0,1,0,1,389,68,31021,31187,46363,0,-51,0,-5121,-12,-3880,-18931,-2,0,-1,0,8
EUN1_3568296928',6,31,11,2,0,2,0,7,1,408,98,28147,30418,22234,4,27,7,0,0,1,0,5,351,100,26068,30098,21043,0,57,-2,2079,4,320,1191,2,0,1,0,2
EUN1_3568283166',5,191,20,0,0,1,0,10,0,321,82,31525,31317,36881,4,294,18,1,0,2,0,7,281,69,29914,28104,38415,0,40,13,1611,2,3213,-1534,-1,0,-1,0,3
EUN1_3568200763',3,82,8,0,0,0,0,11,0,334,78,24466,28667,25213,2,52,12,1,1,1,0,2,342,102,27705,30020,32446,0,-8,-24,-3239,-4,-1353,-7233,-1,-1,-1,0,9
EUN1_3568177621',4,27,22,1,0,2,0,9,1,325,77,31732,30261,41697,9,29,13,0,0,1,0,9,329,73,28309,27723,32294,1,-4,4,3423,9,2538,9403,1,0,1,0,0
EUN1_3567822442',2,30,11,1,0,1,0,5,1,421,110,28795,32227,25603,5,34,5,0,0,0,0,6,353,88,24103,27981,17818,1,68,22,4692,6,4246,7785,1,0,1,0,-1
EUN1_3567773811',4,24,15,1,1,0,0,7,1,348,122,31821,31982,29729,2,22,11,1,0,2,0,9,316,72,26687,28612,29944,1,32,50,5134,4,3370,-215,0,1,-2,0,-2
EUN1_3567657167',5,28,8,0,0,0,0,7,1,359,102,26480,30222,26608,7,33,8,1,0,0,0,2,364,89,25663,29613,29679,1,-5,13,817,0,609,-3071,-1,0,0,0,5
EUN1_3567465764',5,23,11,1,0,0,0,4,1,355,110,27193,29968,22889,1,60,3,1,0,0,0,3,373,102,23730,28597,26379,1,-18,8,3463,8,1371,-3490,0,0,0,0,1
EUN1_3567440817',5,50,17,1,0,1,0,12,1,339,66,29464,29379,37604,5,27,16,1,0,2,0,7,357,114,30517,32073,34191,1,-18,-48,-1053,1,-2694,3413,0,0,-1,0,5
EUN1_3567385146',5,29,8,0,0,0,0,8,0,329,54,23186,26421,25833,5,40,7,2,0,0,0,2,349,84,24652,28319,23436,0,-20,-30,-1466,1,-1898,2397,-2,0,0,0,6
EUN1_3567186611',7,29,21,1,1,2,0,6,1,361,68,32361,32541,39467,2,135,9,0,0,0,0,8,284,120,24829,29294,30571,1,77,-52,7532,12,3247,8896,1,1,2,0,-2
EUN1_3567154497',3,32,10,0,0,0,0,9,0,335,75,25097,28165,33066,5,113,17,2,0,1,0,1,314,106,29474,29112,37507,0,21,-31,-4377,-7,-947,-4441,-2,0,-1,0,8
EUN1_3567134726',0,20,11,1,0,2,0,9,0,362,102,28172,30342,32534,1,27,10,1,0,0,0,5,330,95,26577,30313,28068,1,32,7,1595,1,29,4466,0,0,2,0,4
EUN1_3566635623',4,31,6,0,0,0,0,7,0,378,66,25707,28558,28740,2,26,11,2,0,1,0,5,361,82,25712,30107,26424,0,17,-16,-5,-5,-1549,2316,-2,0,-1,0,2
EUN1_3566289607',7,33,11,0,1,0,0,7,1,312,88,26129,29908,25058,5,32,9,2,0,0,0,0,365,95,26856,30471,28200,1,-53,-7,-727,2,-563,-3142,-2,1,0,0,7
EUN1_3566157479',2,26,13,0,0,2,0,10,1,361,91,30750,31243,41129,4,28,14,1,0,0,0,7,324,88,26696,28844,27355,1,37,3,4054,-1,2399,13774,-1,0,2,0,3
EUN1_3576142031',0,27,11,1,0,0,0,13,0,382,72,27447,29573,31768,4,29,25,1,0,2,0,1,410,108,35680,35197,35039,0,-28,-36,-8233,-14,-5624,-3271,0,0,-2,0,12
EUN1_3576141440',2,19,9,0,0,0,0,13,0,269,79,25817,23982,22562,4,30,25,2,0,4,0,2,382,88,34927,30623,39233,0,-113,-9,-9110,-16,-6641,-16671,-2,0,-4,0,11
EUN1_3576118848',5,33,10,0,0,0,0,5,0,326,90,25759,29021,25950,3,29,15,2,0,0,0,4,336,96,27383,31436,30834,0,-10,-6,-1624,-5,-2415,-4884,-2,0,0,0,1
EUN1_3575595041',4,27,13,1,0,3,0,7,1,376,99,29795,30530,28467,1,24,8,1,0,0,0,8,317,75,23536,26272,20623,1,59,24,6259,5,4258,7844,0,0,3,0,-1
EUN1_3575584163',3,66,17,1,0,1,0,10,0,313,101,28776,30570,35761,2,28,11,0,0,1,0,7,301,71,26038,25176,26828,1,12,30,2738,6,5394,8933,1,0,0,0,3
EUN1_3575021458',4,43,12,1,0,1,0,14,0,286,86,25896,26017,30361,1,27,17,0,0,2,0,4,326,110,31200,29339,31827,1,-40,-24,-5304,-5,-3322,-1466,1,0,-1,0,10
EUN1_3575003104',1,24,18,1,0,0,0,11,0,298,89,29067,28874,35577,0,32,21,1,0,0,0,3,339,90,30919,31496,37941,0,-41,-1,-1852,-3,-2622,-2364,0,0,0,0,8
EUN1_3574327367',5,21,11,1,0,0,0,7,0,338,101,26183,30635,30298,4,29,15,1,0,1,0,4,393,94,29042,32576,31147,0,-55,7,-2859,-4,-1941,-849,0,0,-1,0,3
EUN1_3574258824',4,24,16,2,0,1,0,5,1,360,91,29621,30886,36907,1,28,13,0,0,0,0,6,316,84,26899,29004,30490,1,44,7,2722,3,1882,6417,2,0,1,0,-1
EUN1_3574237447',1,26,17,1,0,1,0,1,0,343,96,30178,29705,35011,2,28,15,1,0,0,0,6,314,68,27132,26202,30341,1,29,28,3046,2,3503,4670,0,0,1,0,-5
EUN1_3571120900',2,40,7,1,0,1,0,9,0,397,94,26748,30995,25077,1,23,7,1,0,0,0,7,389,90,25314,29915,26758,0,8,4,1434,0,1080,-1681,0,0,1,0,2
EUN1_3570222957',4,26,10,1,0,0,0,12,0,325,84,26297,28764,28783,1,23,19,1,0,2,0,1,375,90,31791,31381,38241,0,-50,-6,-5494,-9,-2617,-9458,0,0,-2,0,11
EUN1_3568738665',3,21,8,0,0,0,0,15,0,314,80,23698,27012,26892,1,137,27,2,1,4,0,1,401,100,34916,35357,44903,0,-87,-20,-11218,-19,-8345,-18011,-2,-1,-4,0,14
EUN1_3568713164',1,23,11,1,0,1,0,5,1,305,110,26770,29235,31655,3,103,9,0,0,0,0,2,306,74,24157,26930,24910,1,-1,36,2613,2,2305,6745,1,0,1,0,3
EUN1_3568671544',3,30,13,0,0,1,0,8,1,367,80,28202,28782,31526,2,25,14,2,0,0,0,3,312,87,26602,30488,28745,0,55,-7,1600,-1,-1706,2781,-2,0,1,0,5
EUN1_3568581289',4,34,10,1,0,0,0,8,0,305,76,24588,26610,30281,0,26,20,1,0,2,0,4,325,103,30719,31048,36174,0,-20,-27,-6131,-10,-4438,-5893,0,0,-2,0,4
EUN1_3568557562',3,24,13,0,0,1,0,7,1,367,101,28159,30621,29570,4,26,9,1,0,0,0,6,356,98,26028,30699,27360,1,11,3,2131,4,-78,2210,-1,0,1,0,1
EUN1_3568150765',1,23,6,1,0,0,0,9,0,281,92,22897,28665,21330,4,26,15,0,0,1,0,0,402,78,29526,31724,34955,0,-121,14,-6629,-9,-3059,-13625,1,0,-1,0,9
EUN1_3568137137',2,20,17,1,0,1,0,5,0,343,82,29603,28511,39724,3,109,10,0,0,1,0,7,323,90,26838,28906,25306,1,20,-8,2765,7,-395,14418,1,0,0,0,-2
EUN1_3570314998',1,41,11,0,0,0,0,7,1,350,78,26169,27624,30707,6,24,12,2,0,1,0,5,343,91,27840,30533,39483,0,7,-13,-1671,-1,-2909,-8776,-2,0,-1,0,2
EUN1_3570291312',4,46,17,2,0,1,0,14,1,353,86,31006,29869,50917,3,25,21,0,0,2,0,3,294,42,29705,28951,45715,0,59,44,1301,-4,918,5202,2,0,-1,0,11
EUN1_3570249677',3,26,20,1,0,1,0,9,1,326,63,29639,28183,35190,1,31,13,1,0,2,0,3,317,68,27309,27146,41427,0,9,-5,2330,7,1037,-6237,0,0,-1,0,6
EUN1_3570228325',4,27,10,0,0,0,0,9,0,327,91,26337,29293,24092,7,29,14,2,0,1,0,4,363,95,28037,30224,27768,0,-36,-4,-1700,-4,-931,-3676,-2,0,-1,0,5
EUN1_3570205172',2,28,5,2,0,0,0,5,0,388,98,24151,30331,29783,4,23,6,0,0,0,0,0,338,80,22778,28498,27217,1,50,18,1373,-1,1833,2566,2,0,0,0,5
EUN1_3570140808',4,23,15,2,0,3,0,6,1,343,100,29651,29983,33607,4,28,13,0,0,0,0,10,355,64,26192,28652,36913,0,-12,36,3459,2,1331,-3306,2,0,3,0,-4
EUN1_3570123713',6,25,8,0,0,0,0,9,1,357,96,25686,27958,30094,5,26,17,1,0,0,0,3,384,80,28746,32210,35690,0,-27,16,-3060,-9,-4252,-5596,-1,0,0,0,6
EUN1_3570109081',5,44,13,2,0,0,0,14,1,333,92,26535,30841,36645,4,26,16,0,1,2,0,1,333,92,29416,32413,34922,0,0,0,-2881,-3,-1572,1723,2,-1,-2,0,13
EUN1_3570092232',2,30,6,0,0,0,0,10,0,388,76,24331,29528,26446,5,28,7,2,0,1,0,2,355,96,24976,28279,24793,0,33,-20,-645,-1,1249,1653,-2,0,-1,0,8
EUN1_3570061631',3,22,12,0,0,0,0,7,0,357,74,26610,28312,29373,6,30,19,2,0,0,0,5,384,73,29628,30524,39415,0,-27,1,-3018,-7,-2212,-10042,-2,0,0,0,2
EUN1_3570040585',3,23,12,0,0,0,0,5,0,284,96,26177,26224,25420,8,26,14,1,0,0,0,2,317,56,25895,26974,28088,0,-33,40,282,-2,-750,-2668,-1,0,0,0,3
EUN1_3569551997',2,26,12,0,0,0,0,11,0,370,88,26969,28602,29089,4,41,19,2,0,1,0,1,329,72,28916,29593,41158,0,41,16,-1947,-7,-991,-12069,-2,0,-1,0,10
EUN1_3569541352',4,28,15,2,0,1,0,4,1,358,95,28919,30410,35373,5,19,7,0,0,0,0,6,333,100,24324,30035,23867,1,25,-5,4595,8,375,11506,2,0,1,0,-2
EUN1_3569523555',6,40,17,0,0,0,0,10,1,355,95,27866,30855,36305,1,23,3,1,0,1,0,3,375,83,24170,27421,28751,1,-20,12,3696,14,3434,7554,-1,0,-1,0,7
EUN1_3569506506',5,26,12,1,0,0,0,9,0,337,59,25244,28038,32055,9,39,14,0,0,0,0,1,375,85,27550,29093,32353,1,-38,-26,-2306,-2,-1055,-298,1,0,0,0,8
EUN1_3569484832',2,22,11,1,0,0,0,15,0,292,90,25822,28720,28641,7,32,22,1,0,2,0,4,339,90,31548,31076,40819,0,-47,0,-5726,-11,-2356,-12178,0,0,-2,0,11
EUN1_3569180071',2,27,11,0,0,0,0,9,1,324,74,25825,27009,26175,1,21,12,2,1,1,0,2,388,110,28874,30915,34250,0,-64,-36,-3049,-1,-3906,-8075,-2,-1,-1,0,7
EUN1_3569122059',3,29,13,2,0,1,0,7,1,346,100,28103,29690,33268,7,27,14,0,0,0,0,8,373,104,28527,31797,34049,1,-27,-4,-424,-1,-2107,-781,2,0,1,0,-1
EUN1_3569107146',1,37,13,0,1,0,0,8,1,363,84,28767,29872,38301,4,24,11,1,0,1,0,4,382,75,27553,29603,29033,1,-19,9,1214,2,269,9268,-1,1,-1,0,4
EUN1_3574718916',6,28,14,1,0,2,0,5,1,382,92,30305,29403,28057,3,24,11,0,0,1,0,6,320,80,25159,26400,24389,1,62,12,5146,3,3003,3668,1,0,1,0,-1
EUN1_3572153063',3,60,18,0,0,0,0,7,0,332,97,29364,32115,37948,5,26,10,1,0,0,0,2,355,78,26302,29598,28166,1,-23,19,3062,8,2517,9782,-1,0,0,0,5
EUN1_3572124677',4,25,10,0,0,0,0,6,0,384,80,26794,30084,22543,4,28,10,0,0,0,0,0,430,88,27121,30069,24283,1,-46,-8,-327,0,15,-1740,0,0,0,0,6
EUN1_3570845353',3,25,14,1,1,0,0,11,1,350,107,28984,31425,35450,2,20,20,1,0,2,0,5,342,96,31524,32210,41132,0,8,11,-2540,-6,-785,-5682,0,1,-2,0,6
EUN1_3570399191',4,35,7,1,0,0,0,7,1,395,87,25047,28463,17658,5,31,5,0,0,0,0,2,355,78,23740,28536,19890,1,40,9,1307,2,-73,-2232,1,0,0,0,5
EUN1_3570331915',1,26,6,1,0,1,0,11,0,357,74,24580,28399,25890,3,27,18,0,0,0,0,1,366,90,29026,30808,34711,0,-9,-16,-4446,-12,-2409,-8821,1,0,1,0,10
EUN1_3576232481',1,31,7,2,0,0,0,8,0,328,104,23934,27993,24691,4,26,16,0,0,0,0,0,376,80,28998,30650,40582,0,-48,24,-5064,-9,-2657,-15891,2,0,0,0,8
EUN1_3576005307',3,31,5,0,0,0,0,18,1,329,67,22939,27348,21426,6,27,13,2,0,3,0,0,412,92,31043,31241,34655,0,-83,-25,-8104,-8,-3893,-13229,-2,0,-3,0,18
EUN1_3575967163',2,32,11,0,0,1,0,11,0,360,95,28308,30253,28745,8,33,16,2,0,1,0,2,329,76,28672,30260,30998,0,31,19,-364,-5,-7,-2253,-2,0,0,0,9
EUN1_3575942427',5,337,7,1,0,0,0,9,1,328,66,23432,27322,27253,2,27,12,1,0,1,0,3,371,100,27902,30497,24160,0,-43,-34,-4470,-5,-3175,3093,0,0,-1,0,6
EUN1_3575916637',2,29,4,0,1,0,0,12,0,319,84,22360,26886,23726,4,23,11,2,0,2,0,3,380,103,28878,29917,28088,1,-61,-19,-6518,-7,-3031,-4362,-2,1,-2,0,9
EUN1_3575896690',2,30,10,2,0,0,0,12,0,325,84,24568,26912,28466,3,40,10,0,0,2,0,0,391,104,28169,29920,27029,0,-66,-20,-3601,0,-3008,1437,2,0,-2,0,12
EUN1_3575734750',2,27,18,1,1,2,0,8,0,340,78,30771,29771,34210,2,31,10,0,0,0,0,8,280,86,25069,24803,33562,0,60,-8,5702,8,4968,648,1,1,2,0,0
EUN1_3575722017',4,80,16,2,0,2,0,9,0,400,86,31153,32197,42232,0,29,9,0,0,1,0,11,288,84,24559,27228,26904,1,112,2,6594,7,4969,15328,2,0,1,0,-2
EUN1_3575709745',3,28,6,1,0,0,0,3,0,354,108,23809,28369,23822,6,96,6,1,0,0,0,1,387,76,24251,29226,27443,0,-33,32,-442,0,-857,-3621,0,0,0,0,2
EUN1_3575615635',7,26,16,1,1,1,0,12,1,335,117,30266,29269,44752,5,32,14,1,0,1,0,2,282,70,26889,27928,32927,1,53,47,3377,2,1341,11825,0,1,0,0,10
EUN1_3575605328',5,25,16,1,0,1,0,5,0,343,91,28537,29318,31913,3,28,14,0,0,0,0,7,275,88,26264,28437,31834,0,68,3,2273,2,881,79,1,0,1,0,-2
EUN1_3575583446',4,44,21,1,0,2,0,9,1,328,108,31356,32529,40164,2,21,7,1,0,0,0,9,348,76,24707,26969,33717,1,-20,32,6649,14,5560,6447,0,0,2,0,0
EUN1_3575513936',2,16,11,1,0,0,0,5,1,301,69,23933,24604,33005,4,29,10,0,0,1,0,1,318,86,25922,30255,30560,1,-17,-17,-1989,1,-5651,2445,1,0,-1,0,4
EUN1_3575497415',5,29,17,1,1,1,0,4,1,371,99,31574,30937,34726,4,22,10,0,0,0,0,8,325,84,25691,30058,25275,1,46,15,5883,7,879,9451,1,1,1,0,-4
EUN1_3575460363',6,28,9,2,0,1,0,10,0,344,90,27406,29751,25414,7,45,11,0,0,1,0,4,352,82,26447,29583,26672,1,-8,8,959,-2,168,-1258,2,0,0,0,6
EUN1_3575438303',4,153,13,1,0,2,0,7,0,353,92,29656,30590,37698,7,33,15,1,0,1,0,8,354,86,29001,30975,29832,1,-1,6,655,-2,-385,7866,0,0,1,0,-1
EUN1_3575314876',3,28,14,1,0,0,0,12,1,379,107,31587,29353,32770,7,29,15,1,0,2,0,5,345,79,28459,28954,26094,1,34,28,3128,-1,399,6676,0,0,-2,0,7
EUN1_3575209586',7,33,13,0,0,1,0,7,1,341,100,30106,28439,29401,4,39,16,1,1,2,0,7,319,78,28417,28901,34348,1,22,22,1689,-3,-462,-4947,-1,-1,-1,0,0
EUN1_3576077353',5,25,8,0,0,0,0,4,1,355,112,26183,30827,30357,6,30,11,2,0,0,0,1,335,83,25300,29884,26938,0,20,29,883,-3,943,3419,-2,0,0,0,3
EUN1_3575808675',4,45,19,1,1,2,0,10,0,330,78,30138,31096,31340,1,25,7,1,0,0,0,6,347,97,24387,27643,31228,1,-17,-19,5751,12,3453,112,0,1,2,0,4
EUN1_3575797107',7,27,9,1,0,0,0,9,1,346,66,24222,26063,32440,5,139,17,1,0,1,0,1,368,90,27572,31654,36496,0,-22,-24,-3350,-8,-5591,-4056,0,0,-1,0,8
EUN1_3575783165',5,29,17,1,0,2,0,9,0,363,110,31597,31573,33836,5,24,12,1,0,0,0,10,311,75,25915,27229,26494,1,52,35,5682,5,4344,7342,0,0,2,0,-1
EUN1_3575600816',3,25,12,2,0,1,0,7,1,339,90,27900,28824,35505,5,92,17,0,0,1,0,9,303,70,27909,29696,38688,1,36,20,-9,-5,-872,-3183,2,0,0,0,-2
EUN1_3575515892',4,24,12,1,0,1,0,8,1,330,112,27504,30597,29758,3,24,15,1,0,1,0,2,356,100,29986,31147,35556,0,-26,12,-2482,-3,-550,-5798,0,0,0,0,6
EUN1_3575481013',3,39,13,1,0,0,0,6,1,396,108,27098,31124,31783,2,29,8,0,0,0,0,3,329,87,24359,27606,21635,1,67,21,2739,5,3518,10148,1,0,0,0,3
EUN1_3575053587',4,33,10,0,0,0,0,10,1,277,67,23947,25015,27869,5,27,20,1,1,2,0,2,347,80,32598,29709,41611,0,-70,-13,-8651,-10,-4694,-13742,-1,-1,-2,0,8
EUN1_3575032171',2,26,25,2,1,2,0,7,1,348,78,33093,33533,34909,1,38,7,0,0,0,0,6,297,90,23993,26340,30975,1,51,-12,9100,18,7193,3934,2,1,2,0,1
EUN1_3574981621',3,23,18,1,0,0,0,8,0,338,66,29060,30375,32861,10,35,16,0,0,1,0,2,339,101,29697,29385,28481,1,-1,-35,-637,2,990,4380,1,0,-1,0,6
EUN1_3574447650',4,28,16,1,0,2,0,8,0,348,120,31362,32836,30699,5,35,9,1,0,1,0,9,326,72,25512,27139,30135,1,22,48,5850,7,5697,564,0,0,1,0,-1
EUN1_3574411361',4,27,11,0,0,1,0,11,1,381,69,26464,28090,29848,6,34,13,1,0,1,0,3,410,91,29665,31477,43732,1,-29,-22,-3201,-2,-3387,-13884,-1,0,0,0,8
EUN1_3574369355',5,28,11,2,0,1,0,5,0,376,82,27513,28315,25995,4,83,13,0,0,1,0,5,347,84,27844,29290,34258,1,29,-2,-331,-2,-975,-8263,2,0,0,0,0
EUN1_3573975394',5,31,25,0,0,1,0,14,0,273,94,31364,30868,44599,7,23,22,1,0,1,0,6,312,59,30184,28231,39067,0,-39,35,1180,3,2637,5532,-1,0,0,0,8
EUN1_3573945844',2,98,12,0,0,0,0,10,1,347,100,26818,29816,31894,3,33,5,1,0,0,0,2,374,76,23689,29280,22573,1,-27,24,3129,7,536,9321,-1,0,0,0,8
EUN1_3576012021',6,35,16,1,0,1,0,10,1,294,79,28312,27402,34026,4,31,13,1,0,1,0,7,315,78,28026,28664,34710,0,-21,1,286,3,-1262,-684,0,0,0,0,3
EUN1_3573478286',3,25,9,1,0,0,0,12,0,340,88,26214,27994,29408,5,31,8,1,0,1,0,1,353,111,26755,28171,26584,1,-13,-23,-541,1,-177,2824,0,0,-1,0,11
EUN1_3573455032',3,30,19,2,0,2,0,9,0,333,88,31958,31209,34582,3,81,17,0,0,1,0,5,338,90,30132,29848,35188,1,-5,-2,1826,2,1361,-606,2,0,1,0,4
EUN1_3573437975',2,176,10,2,0,1,0,8,1,365,96,27254,30731,28515,7,36,8,0,0,0,0,1,342,108,25180,29537,28787,1,23,-12,2074,2,1194,-272,2,0,1,0,7
EUN1_3573224168',4,26,11,2,0,0,0,9,0,326,63,24957,27392,31907,3,24,14,0,0,2,0,0,384,75,29282,31413,38082,0,-58,-12,-4325,-3,-4021,-6175,2,0,-2,0,9
EUN1_3573197361',4,29,11,2,0,1,0,8,1,353,88,27810,29932,30613,1,33,14,0,0,0,0,5,350,103,28122,31283,35167,1,3,-15,-312,-3,-1351,-4554,2,0,1,0,3
EUN1_3575954857',3,58,7,1,0,0,0,11,0,365,98,25602,30130,22558,2,22,11,1,0,0,0,5,414,78,27483,31020,29339,0,-49,20,-1881,-4,-890,-6781,0,0,0,0,6
EUN1_3575783546',2,31,13,1,1,2,0,7,1,384,98,30759,30005,36715,5,33,14,1,0,0,0,6,280,90,26586,26709,39005,1,104,8,4173,-1,3296,-2290,0,1,2,0,1
EUN1_3575768624',2,40,19,1,0,0,0,5,0,350,75,29290,31896,41664,4,27,19,0,0,0,0,0,331,80,29467,29637,40844,0,19,-5,-177,0,2259,820,1,0,0,0,5
EUN1_3575406430',2,25,10,1,0,0,0,7,0,307,66,24914,29230,37105,4,27,19,0,0,0,0,2,368,86,28804,30784,38549,0,-61,-20,-3890,-9,-1554,-1444,1,0,0,0,5
EUN1_3575377686',0,18,16,2,0,1,0,13,0,362,88,30236,30784,31860,4,31,18,0,0,3,0,5,331,76,30135,27718,36081,1,31,12,101,-2,3066,-4221,2,0,-2,0,8
EUN1_3575331742',5,44,11,2,0,0,0,10,0,328,77,26002,27659,26561,6,30,19,0,0,2,0,1,353,74,30392,28991,35207,1,-25,3,-4390,-8,-1332,-8646,2,0,-2,0,9
EUN1_3575311847',2,26,20,1,0,1,0,8,1,323,72,31786,29112,35055,7,266,17,1,0,1,0,7,346,120,31510,31411,38120,1,-23,-48,276,3,-2299,-3065,0,0,0,0,1
EUN1_3575298510',4,70,21,0,0,2,0,9,1,372,84,32916,33231,38676,7,27,11,1,0,1,0,6,342,87,26571,28785,29661,1,30,-3,6345,10,4446,9015,-1,0,1,0,3
EUN1_3575285203',5,28,15,1,1,0,0,3,1,387,89,29349,31567,34365,11,31,10,0,0,0,0,4,355,94,25390,28396,30556,1,32,-5,3959,5,3171,3809,1,1,0,0,-1
EUN1_3575252904',8,25,19,0,0,1,0,10,1,318,70,29185,29354,34524,2,25,14,1,0,1,0,6,324,94,27925,28352,41160,1,-6,-24,1260,5,1002,-6636,-1,0,0,0,4
EUN1_3575240730',6,33,14,2,0,1,0,9,0,312,78,27298,28730,40283,1,20,20,0,0,2,0,7,358,102,30623,30559,41048,0,-46,-24,-3325,-6,-1829,-765,2,0,-1,0,2
EUN1_3575228559',1,25,13,2,0,0,0,12,1,363,66,26766,30463,33135,5,31,8,0,0,1,0,3,310,78,25818,27370,34189,1,53,-12,948,5,3093,-1054,2,0,-1,0,9
EUN1_3575192023',7,43,16,1,0,1,0,6,1,331,86,28788,28140,34596,4,30,15,1,0,1,0,7,326,77,28372,27964,36739,1,5,9,416,1,176,-2143,0,0,0,0,-1
EUN1_3575169847',7,51,13,0,0,0,0,10,1,322,68,26669,26443,26321,4,24,18,2,1,2,0,3,361,126,31278,32005,28691,0,-39,-58,-4609,-5,-5562,-2370,-2,-1,-2,0,7
EUN1_3575150400',4,25,6,0,1,0,0,9,0,375,84,24915,28678,26930,1,23,18,2,0,1,0,2,353,97,30685,32730,37795,0,22,-13,-5770,-12,-4052,-10865,-2,1,-1,0,7
EUN1_3574906100',2,227,13,2,0,0,0,9,0,337,116,28339,31335,33961,4,23,14,0,0,2,0,3,347,76,28134,29886,32902,1,-10,40,205,-1,1449,1059,2,0,-2,0,6
EUN1_3572695190',1,38,9,0,0,0,0,10,0,347,62,24974,27007,29180,5,28,18,2,0,1,0,2,374,102,31632,33249,41471,0,-27,-40,-6658,-9,-6242,-12291,-2,0,-1,0,8
EUN1_3576079066',4,45,13,1,0,1,0,8,0,386,106,27919,31955,28905,4,20,8,1,0,1,0,3,347,86,26037,26801,26357,0,39,20,1882,5,5154,2548,0,0,0,0,5
EUN1_3576054634',5,27,11,1,0,0,0,4,1,342,94,25185,29735,30159,4,28,8,1,0,0,0,4,369,98,25823,30115,30184,0,-27,-4,-638,3,-380,-25,0,0,0,0,0
EUN1_3576017189',2,35,11,1,0,0,0,8,1,398,85,27755,29921,31273,1,38,14,1,0,0,0,3,338,99,27987,29107,37429,0,60,-14,-232,-3,814,-6156,0,0,0,0,5
EUN1_3575966700',1,74,9,0,0,0,0,7,1,357,80,25877,28274,33243,5,27,17,1,0,0,0,1,332,71,28122,30436,33836,1,25,9,-2245,-8,-2162,-593,-1,0,0,0,6
EUN1_3575902203',3,40,9,0,0,0,0,7,0,347,98,26012,27579,30601,8,24,20,2,0,0,0,2,345,86,30323,31135,35705,0,2,12,-4311,-11,-3556,-5104,-2,0,0,0,5
EUN1_3575871055',1,24,14,1,0,0,0,14,0,347,90,27848,29622,31622,0,18,14,0,0,2,0,2,382,98,30272,32555,32416,0,-35,-8,-2424,0,-2933,-794,1,0,-2,0,12
EUN1_3575857738',2,39,13,0,1,1,0,10,0,333,102,26465,31410,34614,2,37,4,1,0,2,0,6,376,69,25488,28301,29510,1,-43,33,977,9,3109,5104,-1,1,-1,0,4
EUN1_3575839489',2,25,12,1,0,0,0,11,1,349,104,26941,30288,36994,4,31,14,0,0,2,0,1,398,87,30022,31416,36286,1,-49,17,-3081,-2,-1128,708,1,0,-2,0,10
EUN1_3574162345',6,55,14,0,0,0,0,9,0,335,77,28511,27971,32964,4,30,17,2,0,1,0,7,300,83,27712,27373,33907,0,35,-6,799,-3,598,-943,-2,0,-1,0,2
EUN1_3574144576',2,34,15,2,0,1,0,11,0,349,76,28062,30325,36312,3,266,8,0,0,1,0,3,337,96,25761,27483,36984,1,12,-20,2301,7,2842,-672,2,0,0,0,8
EUN1_3573633019',7,43,13,0,1,0,0,6,0,366,110,27479,32188,33211,1,24,13,2,0,0,0,4,361,90,26658,32066,32369,0,5,20,821,0,122,842,-2,1,0,0,2
EUN1_3573613960',2,94,18,2,0,0,0,14,1,338,74,29370,30425,44266,5,32,13,0,0,2,0,7,336,94,28435,28189,34585,1,2,-20,935,5,2236,9681,2,0,-2,0,7
EUN1_3573611134',1,30,5,0,0,0,0,14,0,356,84,23370,27854,16109,4,20,13,2,0,1,0,1,367,99,28141,30303,27430,0,-11,-15,-4771,-8,-2449,-11321,-2,0,-1,0,13
EUN1_3573577150',2,30,16,2,0,1,0,7,1,358,80,30179,29793,41234,5,29,15,0,0,0,0,7,328,88,28243,28145,35077,1,30,-8,1936,1,1648,6157,2,0,1,0,0
EUN1_3573555691',4,37,20,1,0,1,0,7,1,364,72,32096,29033,36436,3,29,7,0,0,0,0,6,304,80,23513,25372,26513,1,60,-8,8583,13,3661,9923,1,0,1,0,1
EUN1_3573168467',4,66,19,2,1,1,0,15,1,315,93,29363,30868,37944,0,28,10,0,0,1,0,1,384,127,30021,30701,29108,1,-69,-34,-658,9,167,8836,2,1,0,0,14
EUN1_3573150665',3,25,21,1,0,2,0,10,0,357,96,32569,30318,36257,0,28,10,0,0,2,0,5,297,102,25734,27869,35801,1,60,-6,6835,11,2449,456,1,0,0,0,5
EUN1_3573133714',2,27,8,0,0,0,0,9,1,314,104,25426,27793,33811,1,27,16,1,0,1,0,2,340,92,30090,28651,31398,0,-26,12,-4664,-8,-858,2413,-1,0,-1,0,7
EUN1_3576101754',0,25,14,1,0,0,0,13,1,312,66,27234,28104,35023,1,69,20,0,0,2,0,2,357,66,31325,32014,42234,0,-45,0,-4091,-6,-3910,-7211,1,0,-2,0,11
EUN1_3576086074',5,43,12,0,0,0,0,13,0,268,77,26204,26020,34205,3,35,21,0,0,2,0,4,330,92,30976,31006,39279,0,-62,-15,-4772,-9,-4986,-5074,0,0,-2,0,9
EUN1_3576054260',4,26,17,0,0,0,0,12,0,317,87,29739,29535,34352,4,23,19,1,0,2,0,3,329,73,29486,28817,39255,1,-12,14,253,-2,718,-4903,-1,0,-2,0,9
EUN1_3576005946',4,21,11,1,0,0,0,5,0,325,99,26218,29341,29595,1,21,13,1,0,1,0,3,379,64,27675,29098,33685,0,-54,35,-1457,-2,243,-4090,0,0,-1,0,2
EUN1_3575978040',2,33,15,0,0,0,0,8,1,334,68,27630,27673,29313,2,29,12,1,0,1,0,5,348,87,27961,28144,37323,1,-14,-19,-331,3,-471,-8010,-1,0,-1,0,3
EUN1_3575951947',5,29,10,0,0,0,0,6,0,335,108,25638,29533,26740,1,33,14,0,0,0,0,3,346,4,26098,25152,35413,1,-11,104,-460,-4,4381,-8673,0,0,0,0,3
EUN1_3575495930',2,306,13,1,0,1,0,10,0,349,74,28376,29726,35312,1,25,12,1,0,1,0,4,311,98,26201,30032,29343,1,38,-24,2175,1,-306,5969,0,0,0,0,6
EUN1_3575474534',0,26,8,1,0,0,0,12,0,298,88,23464,26825,23998,3,30,17,0,0,1,0,2,346,75,28273,31122,35930,0,-48,13,-4809,-9,-4297,-11932,1,0,-1,0,10
EUN1_3575439416',2,22,14,0,0,2,0,5,1,367,86,30263,30343,38273,3,25,15,1,0,0,0,10,351,78,28536,28094,32958,1,16,8,1727,-1,2249,5315,-1,0,2,0,-5
EUN1_3575409713',3,27,20,1,0,1,0,7,0,329,105,30341,30491,32143,1,27,14,0,0,0,0,7,339,94,28321,29287,36015,0,-10,11,2020,6,1204,-3872,1,0,1,0,0
EUN1_3574982529',7,30,10,0,0,1,0,6,1,380,76,27327,29617,27337,2,24,7,2,0,0,0,4,346,100,25166,29346,31063,1,34,-24,2161,3,271,-3726,-2,0,1,0,2
EUN1_3574957138',3,25,11,1,0,0,0,11,1,356,100,26663,29266,29695,6,35,11,1,0,0,0,2,370,96,27100,31843,41455,0,-14,4,-437,0,-2577,-11760,0,0,0,0,9
EUN1_3574936183',2,29,12,0,0,0,0,15,1,322,96,28984,27773,38638,1,26,26,2,0,1,0,4,330,96,32272,31891,39478,0,-8,0,-3288,-14,-4118,-840,-2,0,-1,0,11
EUN1_3574900903',5,62,7,1,0,0,0,10,0,291,84,23276,26348,33675,1,18,20,0,1,1,0,0,346,79,30784,31631,35883,0,-55,5,-7508,-13,-5283,-2208,1,-1,-1,0,10
EUN1_3574889122',2,22,17,0,0,3,0,13,1,290,82,30689,30442,34756,1,27,17,1,0,1,0,9,336,94,28878,29879,31377,1,-46,-12,1811,0,563,3379,-1,0,2,0,4
EUN1_3567982962',3,24,11,1,1,0,0,7,1,359,96,27953,30249,29318,3,22,11,0,0,0,0,5,353,79,26673,29531,30539,1,6,17,1280,0,718,-1221,1,1,0,0,2
EUN1_3567742065',2,24,12,1,0,0,0,11,0,302,86,26243,28906,30058,3,37,18,0,0,1,0,2,379,86,30595,31872,40036,0,-77,0,-4352,-6,-2966,-9978,1,0,-1,0,9
EUN1_3567713057',0,24,11,1,0,0,0,6,1,350,80,26523,27696,35464,5,52,14,1,0,0,0,2,308,100,27142,29741,24307,1,42,-20,-619,-3,-2045,11157,0,0,0,0,4
EUN1_3575903201',2,29,18,2,0,1,0,9,0,335,86,29737,31113,37581,8,34,11,0,0,0,0,2,350,76,26022,29349,36309,1,-15,10,3715,7,1764,1272,2,0,1,0,7
EUN1_3575876722',4,31,13,2,0,0,0,9,1,347,114,28290,29456,32403,8,31,16,0,1,1,0,3,352,74,30103,30744,35953,0,-5,40,-1813,-3,-1288,-3550,2,-1,-1,0,6
EUN1_3575368754',3,19,22,1,0,1,0,7,0,363,87,32560,31712,44214,5,72,13,1,0,1,0,4,263,84,25683,26271,37911,1,100,3,6877,9,5441,6303,0,0,0,0,3
EUN1_3575346759',2,24,11,1,0,0,0,11,0,353,109,27401,30224,26785,5,25,11,1,0,2,0,6,351,77,27528,28247,31216,0,2,32,-127,0,1977,-4431,0,0,-2,0,5
EUN1_3574877144',5,24,9,0,0,0,0,8,0,314,105,25956,29447,33568,3,84,19,1,0,1,0,3,332,114,30222,31912,37069,0,-18,-9,-4266,-10,-2465,-3501,-1,0,-1,0,5
EUN1_3574850592',4,25,18,2,0,1,0,8,1,367,98,31073,31956,35025,1,24,11,0,0,0,0,4,327,90,25150,28229,33678,1,40,8,5923,7,3727,1347,2,0,1,0,4
EUN1_3574838649',2,38,3,0,0,0,0,17,1,352,90,22533,28091,20819,2,25,18,2,1,3,0,1,406,122,33323,36797,33849,0,-54,-32,-10790,-15,-8706,-13030,-2,-1,-3,0,16
EUN1_3574828321',0,27,17,0,1,0,0,11,0,363,110,30552,31497,39818,3,98,15,2,0,3,0,8,323,81,28928,29617,34034,0,40,29,1624,2,1880,5784,-2,1,-3,0,3
EUN1_3574419368',2,25,7,0,0,0,0,11,1,367,86,25646,28441,26576,3,20,14,1,0,2,0,0,421,98,31117,34243,29667,0,-54,-12,-5471,-7,-5802,-3091,-1,0,-2,0,11
EUN1_3574401139',8,93,16,2,0,0,0,10,0,320,102,28284,30235,33302,2,48,8,0,0,0,0,3,351,96,25428,26097,30257,1,-31,6,2856,8,4138,3045,2,0,0,0,7
EUN1_3576044917',4,26,17,1,0,2,0,9,1,365,88,30899,31866,31775,2,162,12,1,1,0,0,10,329,81,27699,28486,31300,1,36,7,3200,5,3380,475,0,-1,2,0,-1
EUN1_3575843292',3,28,16,1,0,0,0,7,0,347,76,28483,30519,40425,8,35,15,0,0,1,0,6,346,75,29153,28915,35497,1,1,1,-670,1,1604,4928,1,0,-1,0,1
EUN1_3575822741',2,26,10,0,0,0,0,13,0,307,66,24519,28297,27760,3,21,16,1,0,2,0,0,388,102,31208,32232,34819,0,-81,-36,-6689,-6,-3935,-7059,-1,0,-2,0,13
EUN1_3575808906',3,24,13,0,0,0,0,8,1,391,79,28354,32133,38439,1,23,12,1,0,1,0,3,309,84,25851,29093,30940,1,82,-5,2503,1,3040,7499,-1,0,-1,0,5
EUN1_3575784329',4,32,10,1,0,1,0,7,1,361,97,27562,29483,32192,4,34,7,1,0,0,0,7,322,90,24686,28160,28539,1,39,7,2876,3,1323,3653,0,0,1,0,0
EUN1_3575764136',5,64,10,1,0,0,0,6,0,383,86,28420,30705,32104,7,61,21,1,0,1,0,4,352,74,29680,30720,46912,1,31,12,-1260,-11,-15,-14808,0,0,-1,0,2
EUN1_3575741529',4,33,7,0,0,0,0,13,0,301,66,23073,25603,29617,4,39,21,2,1,2,0,2,381,114,34322,31995,44297,0,-80,-48,-11249,-14,-6392,-14680,-2,-1,-2,0,11
EUN1_3575588621',5,29,13,0,0,1,0,9,1,299,82,26472,27897,27492,2,25,13,2,0,1,0,1,351,94,27504,30748,31031,0,-52,-12,-1032,0,-2851,-3539,-2,0,0,0,8
EUN1_3575432715',3,25,15,0,0,0,0,5,1,417,99,30264,32810,36088,8,89,14,2,0,1,0,1,382,101,27975,30736,32236,1,35,-2,2289,1,2074,3852,-2,0,-1,0,4
EUN1_3574280669',3,49,4,1,0,0,0,7,0,334,79,23107,26851,29161,2,29,19,1,0,1,0,2,340,95,29519,31078,38326,0,-6,-16,-6412,-15,-4227,-9165,0,0,-1,0,5
EUN1_3574221404',5,62,21,1,0,1,0,11,1,346,102,30837,30453,37873,3,28,10,0,0,0,0,3,294,77,25927,26715,32389,1,52,25,4910,11,3738,5484,1,0,1,0,8
EUN1_3574113366',3,20,13,1,0,0,0,17,1,321,92,27258,27672,32610,2,22,15,1,0,2,0,1,323,93,28944,29569,30663,0,-2,-1,-1686,-2,-1897,1947,0,0,-2,0,16
EUN1_3573970014',10,33,10,0,0,0,0,7,0,368,113,26623,29504,25774,4,23,14,2,0,1,0,5,383,90,29500,31226,34418,0,-15,23,-2877,-4,-1722,-8644,-2,0,-1,0,2
EUN1_3568933345',4,31,11,1,0,2,0,4,0,367,102,29130,31320,32164,2,26,13,1,0,1,0,5,356,74,26445,28401,27431,1,11,28,2685,-2,2919,4733,0,0,1,0,-1
EUN1_3568909864',4,213,9,1,1,0,0,6,1,329,102,25828,29466,27480,3,32,15,1,0,0,0,2,401,86,29665,30759,27596,1,-72,16,-3837,-6,-1293,-116,0,1,0,0,4
EUN1_3575992305',1,56,5,0,0,0,0,15,1,294,71,22273,25220,23289,4,41,25,2,0,2,0,1,344,98,32658,31860,37572,0,-50,-27,-10385,-20,-6640,-14283,-2,0,-2,0,14
EUN1_3575962627',3,31,18,1,0,0,0,6,0,344,71,27646,28598,33720,2,66,8,0,0,0,0,1,333,88,24480,28710,29220,0,11,-17,3166,10,-112,4500,1,0,0,0,5
EUN1_3575937904',2,21,16,2,1,1,0,4,1,358,80,29506,30728,36054,3,23,13,0,0,0,0,4,343,76,27306,28409,32008,1,15,4,2200,3,2319,4046,2,1,1,0,0
EUN1_3575912663',6,150,10,1,0,0,0,9,1,357,82,26582,29731,33706,5,27,16,1,1,1,0,1,333,110,29847,30875,28899,1,24,-28,-3265,-6,-1144,4807,0,-1,-1,0,8
EUN1_3575380622',5,29,12,1,0,1,0,6,1,358,86,28047,30809,29590,4,22,4,0,0,0,0,6,347,98,22859,27740,26704,1,11,-12,5188,8,3069,2886,1,0,1,0,0
EUN1_3570964139',3,24,10,0,0,0,0,7,1,315,78,25755,28733,34816,1,22,15,0,0,1,0,3,365,70,29228,31259,30130,0,-50,8,-3473,-5,-2526,4686,0,0,-1,0,4
EUN1_3567279779',4,134,14,2,1,1,0,8,1,387,103,28708,32297,34725,2,23,8,0,0,0,0,2,314,100,25477,30069,29561,1,73,3,3231,6,2228,5164,2,1,1,0,6
EUN1_3567217725',4,21,5,0,0,0,0,9,0,359,70,23642,27135,21194,7,31,16,2,0,1,0,0,397,78,29956,31658,35418,0,-38,-8,-6314,-11,-4523,-14224,-2,0,-1,0,9
EUN1_3567203112',5,38,15,0,0,0,0,8,1,341,92,28453,28243,31333,8,53,11,1,0,1,0,3,315,104,27654,29611,29941,1,26,-12,799,4,-1368,1392,-1,0,-1,0,5
EUN1_3567180177',2,24,5,0,1,1,0,9,1,379,94,26533,28426,29089,1,25,12,1,0,1,0,7,358,94,27465,30100,29105,1,21,0,-932,-7,-1674,-16,-1,1,0,0,2
EUN1_3567046008',3,89,4,0,0,0,0,8,0,333,100,22876,27963,26649,4,40,13,2,0,1,0,0,406,92,29883,31856,30962,0,-73,8,-7007,-9,-3893,-4313,-2,0,-1,0,8
EUN1_3567037944',3,22,7,0,0,0,0,10,0,294,86,23611,28899,21545,1,145,13,2,0,3,0,0,402,134,31457,33848,32837,0,-108,-48,-7846,-6,-4949,-11292,-2,0,-3,0,10
EUN1_3566835705',3,28,10,0,0,0,0,13,1,333,66,25392,28677,32782,4,26,11,1,0,1,0,0,377,94,27540,30274,29302,0,-44,-28,-2148,-1,-1597,3480,-1,0,-1,0,13
EUN1_3566811086',3,83,13,0,0,2,0,12,0,315,72,27148,28158,33786,4,27,13,1,0,0,0,2,316,75,27507,27053,35122,1,-1,-3,-359,0,1105,-1336,-1,0,2,0,10
EUN1_3566693512',3,27,16,2,0,0,0,6,0,342,93,26785,29070,39202,3,29,9,0,0,0,0,2,333,78,26108,28516,33745,1,9,15,677,7,554,5457,2,0,0,0,4
EUN1_3566510763',4,24,6,2,0,0,0,7,0,406,100,25148,30852,17813,5,28,5,0,0,0,0,3,421,88,24992,29632,21220,1,-15,12,156,1,1220,-3407,2,0,0,0,4
EUN1_3566460509',3,40,11,2,0,1,0,9,1,314,82,26835,28312,27456,2,24,13,0,0,1,0,4,371,92,28965,30133,32481,0,-57,-10,-2130,-2,-1821,-5025,2,0,0,0,5
EUN1_3566145762',4,37,13,2,1,0,0,6,1,392,94,27816,32672,29709,4,29,11,0,0,0,0,2,345,70,24950,28170,25822,1,47,24,2866,2,4502,3887,2,1,0,0,4
EUN1_3566123812',2,24,11,0,0,0,0,7,0,322,74,26196,27764,28645,3,26,16,1,0,0,0,0,355,94,28137,30256,37231,0,-33,-20,-1941,-5,-2492,-8586,-1,0,0,0,7
EUN1_3564908761',4,23,14,1,0,1,0,7,1,368,100,30060,32239,30685,1,34,7,1,0,0,0,5,375,76,24421,29218,25885,1,-7,24,5639,7,3021,4800,0,0,1,0,2
EUN1_3564394810',1,25,12,0,0,1,0,4,0,354,104,28153,31016,28851,4,27,9,2,0,0,0,6,368,83,25281,29311,26903,1,-14,21,2872,3,1705,1948,-2,0,1,0,-2
EUN1_3564377786',5,80,20,1,0,2,0,5,1,351,88,31248,32206,36414,2,32,12,0,0,0,0,6,337,83,27452,28721,30582,1,14,5,3796,8,3485,5832,1,0,2,0,-1
EUN1_3564359329',3,29,7,2,0,0,0,15,1,329,100,24047,27578,31361,4,26,14,0,1,2,0,0,342,92,29393,29359,37486,0,-13,8,-5346,-7,-1781,-6125,2,-1,-2,0,15
EUN1_3573957231',2,30,9,2,0,1,0,7,1,372,94,28863,30131,28762,0,17,10,0,0,1,0,11,346,100,26825,29768,30314,1,26,-6,2038,-1,363,-1552,2,0,0,0,-4
EUN1_3573631769',4,29,10,0,0,1,0,9,0,347,72,25737,28671,33421,3,23,16,1,0,1,0,4,369,112,29602,32043,32110,0,-22,-40,-3865,-6,-3372,1311,-1,0,0,0,5
EUN1_3573617256',6,24,4,0,0,0,0,10,1,371,81,23298,26779,20932,6,52,16,1,0,0,0,2,330,70,27744,29056,28427,0,41,11,-4446,-12,-2277,-7495,-1,0,0,0,8
EUN1_3567658075',4,59,11,1,0,1,0,6,1,380,95,27894,30830,26016,2,124,4,0,0,0,0,7,347,82,23583,28743,23337,1,33,13,4311,7,2087,2679,1,0,1,0,-1
EUN1_3567591910',5,27,13,1,0,1,0,14,0,288,90,28636,27290,26682,2,23,11,1,0,1,0,4,369,106,29829,29828,31414,1,-81,-16,-1193,2,-2538,-4732,0,0,0,0,10
EUN1_3567535928',3,27,16,0,0,1,0,5,1,333,108,31180,30077,31715,4,18,17,2,0,0,0,7,362,72,28120,30376,33381,1,-29,36,3060,-1,-299,-1666,-2,0,1,0,-2
EUN1_3554141738',3,34,9,0,0,0,0,15,0,277,60,24692,27668,31133,4,62,29,2,0,5,0,0,382,106,38012,32539,52717,0,-105,-46,-13320,-20,-4871,-21584,-2,0,-5,0,15
EUN1_3549335152',2,25,16,1,0,1,0,9,1,347,94,29467,30807,36665,4,32,12,0,0,0,0,5,338,70,27162,27574,29447,0,9,24,2305,4,3233,7218,1,0,1,0,4
EUN1_3543431464',6,33,15,1,1,0,0,11,0,347,97,29314,29772,31580,5,27,15,1,0,1,0,2,347,90,28660,29006,37472,1,0,7,654,0,766,-5892,0,1,-1,0,9
EUN1_3539218216',7,24,7,0,0,0,0,14,0,335,96,24840,27975,24439,4,26,14,1,1,1,0,1,351,86,28695,29193,30308,0,-16,10,-3855,-7,-1218,-5869,-1,-1,-1,0,13
EUN1_3539201102',5,32,25,2,0,1,0,5,1,387,90,33374,33786,40438,3,23,7,0,0,1,0,6,318,77,23959,25015,25322,1,69,13,9415,18,8771,15116,2,0,0,0,-1
EUN1_3537049766',1,29,9,1,0,0,0,5,1,352,84,25301,27033,28665,5,133,12,0,0,0,0,2,345,88,26198,29771,33786,1,7,-4,-897,-3,-2738,-5121,1,0,0,0,3
EUN1_3576238533',0,22,13,1,0,0,0,7,0,323,84,26508,29840,37564,2,23,14,1,0,0,0,1,354,84,27233,31748,38371,1,-31,0,-725,-1,-1908,-807,0,0,0,0,6
EUN1_3576223394',4,26,17,2,0,0,0,7,0,356,91,30492,30626,43767,3,153,21,0,1,0,0,3,301,78,30686,30670,42813,1,55,13,-194,-4,-44,954,2,-1,0,0,4
EUN1_3575913718',2,22,13,0,0,0,0,9,1,295,66,26626,27634,36757,5,22,21,1,0,2,0,0,330,94,29285,31906,37772,0,-35,-28,-2659,-8,-4272,-1015,-1,0,-2,0,9
EUN1_3575889911',1,23,13,0,0,1,0,8,1,351,96,29003,30128,37350,1,28,12,1,0,0,0,3,330,116,26413,30167,32456,0,21,-20,2590,1,-39,4894,-1,0,1,0,5
EUN1_3575857879',2,27,11,0,0,0,0,18,0,323,64,25765,27621,33007,1,26,28,2,1,6,0,3,371,108,37244,34261,49886,0,-48,-44,-11479,-17,-6640,-16879,-2,-1,-6,0,15
EUN1_3575845773',2,19,9,0,1,0,0,11,0,361,76,26786,28466,24642,2,28,17,2,0,3,0,3,367,108,31074,30995,37675,0,-6,-32,-4288,-8,-2529,-13033,-2,1,-3,0,8
EUN1_3575839195',4,34,11,1,0,0,0,13,0,333,76,25737,27404,28363,3,30,14,1,1,2,0,5,359,132,30592,32469,35439,0,-26,-56,-4855,-3,-5065,-7076,0,-1,-2,0,8
EUN1_3575819490',5,29,15,2,0,0,0,9,1,315,86,27375,27540,31772,0,33,16,0,0,1,0,2,349,85,28845,29823,38057,0,-34,1,-1470,-1,-2283,-6285,2,0,-1,0,7
EUN1_3575806133',2,31,10,0,0,1,0,14,0,324,88,28390,26406,32873,6,25,21,1,0,2,0,3,397,84,33316,31150,37440,0,-73,4,-4926,-11,-4744,-4567,-1,0,-1,0,11
EUN1_3575789242',2,25,17,1,0,0,0,9,1,345,78,29953,30197,35926,3,25,12,0,0,2,0,7,329,74,27698,26982,32966,0,16,4,2255,5,3215,2960,1,0,-2,0,2
EUN1_3575770344',3,28,8,0,0,0,0,9,1,324,58,22858,28149,19363,3,130,6,2,0,0,0,0,424,91,25562,29426,25611,0,-100,-33,-2704,2,-1277,-6248,-2,0,0,0,9
EUN1_3575735481',3,27,6,0,1,0,0,7,0,330,92,23988,25605,29138,5,27,15,2,0,1,0,1,375,90,28751,30494,36581,0,-45,2,-4763,-9,-4889,-7443,-2,1,-1,0,6
EUN1_3575713918',5,29,14,0,0,1,0,11,0,319,98,28322,30167,33261,2,24,11,2,0,2,0,8,334,106,28537,28985,35896,0,-15,-8,-215,3,1182,-2635,-2,0,-1,0,3
EUN1_3575713114',7,47,20,1,0,0,0,12,0,320,58,28142,29573,39908,2,25,21,1,1,1,0,2,329,120,31763,30685,41774,0,-9,-62,-3621,-1,-1112,-1866,0,-1,-1,0,10
EUN1_3575558615',0,19,18,1,0,1,0,9,1,360,99,31037,32929,34356,4,26,15,1,1,1,0,7,277,105,28087,29143,33498,1,83,-6,2950,3,3786,858,0,-1,0,0,2
EUN1_3575532890',1,24,16,1,0,1,0,8,0,357,118,30397,33152,34581,5,25,17,1,0,1,0,6,338,86,29761,28643,41064,1,19,32,636,-1,4509,-6483,0,0,0,0,2
EUN1_3575517227',0,69,19,1,0,2,0,8,1,349,98,31711,30768,46824,2,29,19,1,0,0,0,11,316,102,30363,32192,43063,1,33,-4,1348,0,-1424,3761,0,0,2,0,-3
EUN1_3575409880',3,45,11,0,1,1,0,11,1,385,91,29233,31143,34996,2,77,20,2,0,1,0,6,345,98,30780,31156,35024,0,40,-7,-1547,-9,-13,-28,-2,1,0,0,5
EUN1_3575289220',1,27,24,1,1,0,0,15,0,307,109,34250,31111,45799,6,44,24,1,0,1,0,6,339,75,33758,32024,47970,1,-32,34,492,0,-913,-2171,0,1,-1,0,9
EUN1_3575595843',6,38,16,2,0,4,0,8,0,428,118,32912,34168,32163,4,28,8,0,0,1,0,10,342,57,25908,26456,31797,1,86,61,7004,8,7712,366,2,0,3,0,-2
EUN1_3575571056',2,31,12,1,0,0,0,10,0,380,86,27157,29848,31397,5,34,13,0,0,0,0,1,354,80,27566,29318,32585,0,26,6,-409,-1,530,-1188,1,0,0,0,9
EUN1_3575501018',4,24,8,0,0,0,0,17,1,300,79,24313,27458,23951,3,29,17,2,0,4,0,2,387,124,32996,33933,38281,0,-87,-45,-8683,-9,-6475,-14330,-2,0,-4,0,15
EUN1_3575455061',1,24,6,1,0,0,0,5,1,388,82,24970,28949,34777,5,104,11,0,0,0,0,4,386,106,27514,33131,32708,0,2,-24,-2544,-5,-4182,2069,1,0,0,0,1
EUN1_3575373165',3,26,9,1,0,0,0,13,1,328,88,25580,29448,30044,5,81,8,1,0,2,0,4,329,91,26384,29234,31544,1,-1,-3,-804,1,214,-1500,0,0,-2,0,9
EUN1_3573128956',2,85,15,0,0,0,0,11,1,343,64,27823,29039,29135,4,28,12,2,0,1,0,0,370,132,29556,31044,33198,0,-27,-68,-1733,3,-2005,-4063,-2,0,-1,0,11
EUN1_3573110817',1,73,11,1,0,0,0,12,1,314,74,25030,28454,27720,1,38,13,1,0,1,0,1,387,90,28941,30989,31966,1,-73,-16,-3911,-2,-2535,-4246,0,0,-1,0,11
EUN1_3573099732',4,26,12,2,0,0,0,6,0,332,90,26343,29953,30329,2,77,15,0,0,0,0,3,343,93,28041,30673,31478,0,-11,-3,-1698,-3,-720,-1149,2,0,0,0,3
EUN1_3572680473',2,26,12,0,0,1,0,15,0,347,72,28937,29388,36252,4,74,26,2,0,4,0,5,353,115,37037,33362,42324,0,-6,-43,-8100,-14,-3974,-6072,-2,0,-3,0,10
EUN1_3572562449',0,20,10,1,0,0,0,7,0,371,96,27192,30807,26732,4,82,3,1,1,0,0,4,379,120,24361,28714,18060,1,-8,-24,2831,7,2093,8672,0,-1,0,0,3
EUN1_3572048104',2,24,6,0,0,0,0,12,0,315,70,22766,25791,26170,1,20,14,2,0,2,0,1,357,114,28694,31275,34980,0,-42,-44,-5928,-8,-5484,-8810,-2,0,-2,0,11
EUN1_3571994659',5,30,8,1,0,0,0,8,1,359,64,25337,27498,26001,4,31,14,1,0,1,0,1,351,88,26720,30083,25620,0,8,-24,-1383,-6,-2585,381,0,0,-1,0,7
EUN1_3571584480',3,24,14,2,0,0,0,5,1,333,95,27080,28430,27498,0,127,4,0,0,0,0,2,370,80,23519,27429,27736,1,-37,15,3561,10,1001,-238,2,0,0,0,3
EUN1_3571536589',2,29,16,1,0,2,0,4,1,347,110,30922,30937,35385,1,22,9,1,0,0,0,7,350,81,25520,26840,26141,1,-3,29,5402,7,4097,9244,0,0,2,0,-3
EUN1_3571432524',4,26,12,1,0,3,0,9,1,414,112,30701,31804,27792,5,29,9,1,1,1,0,11,338,92,25828,29475,20535,1,76,20,4873,3,2329,7257,0,-1,2,0,-2
EUN1_3571413534',2,81,7,0,0,1,0,9,0,351,84,24901,30860,25842,3,25,11,2,0,2,0,2,396,59,25724,29164,33615,0,-45,25,-823,-4,1696,-7773,-2,0,-1,0,7
EUN1_3569137621',6,54,13,0,0,0,0,4,1,365,67,27021,28724,30676,1,83,6,2,0,0,0,4,351,75,23267,26024,29315,1,14,-8,3754,7,2700,1361,-2,0,0,0,0
EUN1_3569075023',2,33,10,0,1,0,0,5,0,326,98,25784,29543,33903,1,106,8,2,0,0,0,4,330,121,24222,29017,32602,0,-4,-23,1562,2,526,1301,-2,1,0,0,1
EUN1_3576208839',1,23,5,1,0,0,0,12,0,353,99,24541,29583,26527,4,38,11,1,0,2,0,7,412,92,28545,32391,31378,0,-59,7,-4004,-6,-2808,-4851,0,0,-2,0,5
EUN1_3576210563',4,29,10,0,0,0,0,15,0,332,100,26290,27348,29627,2,24,24,2,0,2,0,6,352,64,32045,31294,44176,0,-20,36,-5755,-14,-3946,-14549,-2,0,-2,0,9
EUN1_3576204344',2,243,13,1,1,1,0,11,1,319,86,27357,30370,31072,1,25,10,1,0,1,0,4,319,98,25542,30577,29892,0,0,-12,1815,3,-207,1180,0,1,0,0,7
EUN1_3576187988',4,24,12,1,0,0,0,9,1,368,97,27369,31460,26720,2,24,12,0,0,0,0,2,336,87,25457,28767,23562,1,32,10,1912,0,2693,3158,1,0,0,0,7
EUN1_3576189823',7,31,6,0,0,0,0,10,0,383,88,25270,28851,21369,1,22,14,2,0,2,0,3,432,80,30184,32178,35226,0,-49,8,-4914,-8,-3327,-13857,-2,0,-2,0,7
EUN1_3576191632',6,28,11,2,0,0,0,16,1,348,83,27609,28899,29415,2,22,14,0,0,2,0,7,370,84,30159,31134,34663,1,-22,-1,-2550,-3,-2235,-5248,2,0,-2,0,9
EUN1_3576196352',4,26,11,0,0,1,0,11,0,321,83,27083,28597,28683,4,25,18,2,0,1,0,4,335,76,29045,29313,36881,1,-14,7,-1962,-7,-716,-8198,-2,0,0,0,7
EUN1_3576186180',3,18,20,1,0,1,0,9,0,320,96,30138,29482,44242,5,30,17,0,0,0,0,5,306,83,27677,29212,38202,1,14,13,2461,3,270,6040,1,0,1,0,4
EUN1_3575877164',1,73,15,1,0,0,0,14,1,323,95,27804,30569,31198,4,142,14,1,0,2,0,3,326,58,27965,28291,32968,0,-3,37,-161,1,2278,-1770,0,0,-2,0,11
EUN1_3575840624',5,25,18,1,0,0,0,3,1,328,86,28589,31298,34072,4,23,8,1,0,0,0,3,317,91,24596,26944,28038,1,11,-5,3993,10,4354,6034,0,0,0,0,0
EUN1_3575818907',2,31,12,0,0,0,0,7,0,335,78,26895,29484,35214,6,28,20,2,0,1,0,0,373,90,31013,31825,40125,0,-38,-12,-4118,-8,-2341,-4911,-2,0,-1,0,7
EUN1_3575804612',8,27,17,2,0,1,0,7,1,327,78,29523,27427,40840,3,132,11,0,0,2,0,6,304,80,26320,27171,31667,0,23,-2,3203,6,256,9173,2,0,-1,0,1
EUN1_3575778010',7,48,14,0,0,0,0,6,1,372,71,28044,29758,32708,3,142,11,2,1,1,0,4,320,79,25192,28201,32199,0,52,-8,2852,3,1557,509,-2,-1,-1,0,2
EUN1_3575766595',5,28,12,2,0,1,0,5,0,322,98,26456,28997,32257,9,24,10,0,0,0,0,1,333,82,24681,27848,27919,1,-11,16,1775,2,1149,4338,2,0,1,0,4
EUN1_3575752395',8,24,10,0,0,1,0,6,1,364,74,25682,28458,24614,3,23,14,1,0,1,0,1,333,118,27992,31310,34080,1,31,-44,-2310,-4,-2852,-9466,-1,0,0,0,5
EUN1_3575730729',3,26,7,1,0,1,0,9,1,334,88,24784,27352,23264,4,27,18,1,0,1,0,3,369,72,30129,29526,30817,0,-35,16,-5345,-11,-2174,-7553,0,0,0,0,6
EUN1_3575722504',2,18,9,0,0,0,0,9,1,320,95,24710,28990,25909,3,28,13,2,0,1,0,2,357,97,28604,29892,33029,0,-37,-2,-3894,-4,-902,-7120,-2,0,-1,0,7
EUN1_3575632350',5,31,11,0,0,2,0,9,0,332,95,28409,28701,33517,3,31,14,1,0,0,0,10,341,79,27661,29501,34079,1,-9,16,748,-3,-800,-562,-1,0,2,0,-1
EUN1_3575453678',2,23,17,1,0,1,0,5,1,351,102,28513,32421,32785,0,31,6,1,0,0,0,4,326,80,23505,26334,26109,1,25,22,5008,11,6087,6676,0,0,1,0,1
EUN1_3575431278',2,23,7,1,0,0,0,7,1,347,94,24439,28465,22878,6,24,12,1,1,0,0,0,392,102,27406,32770,36758,0,-45,-8,-2967,-5,-4305,-13880,0,-1,0,0,7
EUN1_3576117576',3,82,15,1,0,1,0,5,1,299,90,27062,27122,38919,2,31,13,0,0,0,0,2,309,74,26184,25955,32188,1,-10,16,878,2,1167,6731,1,0,1,0,3
EUN1_3575963353',2,19,12,0,0,0,0,10,0,345,83,27002,30757,31152,5,28,11,2,0,1,0,3,358,105,27805,30751,36735,0,-13,-22,-803,1,6,-5583,-2,0,-1,0,7
EUN1_3575951159',2,30,8,0,0,0,0,11,0,328,84,24856,28530,32504,4,21,19,2,0,1,0,1,327,92,29570,30098,28325,0,1,-8,-4714,-11,-1568,4179,-2,0,-1,0,10
EUN1_3575860708',3,32,7,2,0,1,0,8,1,362,90,25868,29217,33732,2,27,14,0,0,0,0,3,352,81,27974,30369,25537,0,10,9,-2106,-7,-1152,8195,2,0,1,0,5
EUN1_3575498347',0,24,12,1,0,1,0,8,0,352,96,28157,29347,32568,3,24,16,0,0,1,0,6,357,98,29972,31962,40068,0,-5,-2,-1815,-4,-2615,-7500,1,0,0,0,2
EUN1_3575402090',4,33,8,0,0,0,0,9,0,357,78,26652,27559,33089,1,29,12,2,0,1,0,4,330,70,25240,26162,35317,0,27,8,1412,-4,1397,-2228,-2,0,-1,0,5
EUN1_3575015988',3,26,14,1,0,1,0,8,1,348,87,29153,30806,38002,1,25,15,0,0,1,0,8,339,76,27015,29424,28223,1,9,11,2138,-1,1382,9779,1,0,0,0,0
EUN1_3574989909',4,30,20,2,0,2,0,10,1,346,108,31855,30934,37013,3,26,5,0,0,1,0,8,321,72,23765,25330,24649,1,25,36,8090,15,5604,12364,2,0,1,0,2
EUN1_3574518175',6,28,15,2,1,1,0,7,1,373,131,30379,32678,33521,2,29,9,0,0,0,0,8,338,72,24964,28340,32966,1,35,59,5415,6,4338,555,2,1,1,0,-1
EUN1_3574501240',4,62,15,2,0,1,0,8,1,365,91,29211,31286,31462,2,18,10,0,0,0,0,5,330,92,26203,27891,26349,1,35,-1,3008,5,3395,5113,2,0,1,0,3
EUN1_3574470722',3,48,7,0,0,0,0,7,0,331,70,24048,27401,25418,5,20,11,1,0,1,0,0,380,95,26963,30357,28029,1,-49,-25,-2915,-4,-2956,-2611,-1,0,-1,0,7
EUN1_3574447597',1,26,21,0,0,0,0,9,0,311,78,31372,28667,50277,4,27,19,1,0,2,0,7,308,86,30212,29543,35942,1,3,-8,1160,2,-876,14335,-1,0,-2,0,2
EUN1_3574301714',0,20,6,1,0,0,0,11,1,345,76,24931,26626,36812,0,38,17,1,0,2,0,3,320,103,29278,30234,30816,0,25,-27,-4347,-11,-3608,5996,0,0,-2,0,8
EUN1_3574295366',0,17,14,2,0,5,0,5,1,412,112,33155,32270,24585,0,26,4,0,0,1,0,10,310,60,21756,24250,19482,1,102,52,11399,10,8020,5103,2,0,4,0,-5
EUN1_3574422852',5,28,17,2,1,2,0,8,1,350,105,30160,30964,27608,3,29,5,0,0,0,0,5,382,74,23887,27461,25347,1,-32,31,6273,12,3503,2261,2,1,2,0,3
EUN1_3573569391',8,32,11,2,0,0,0,5,1,391,87,26829,28674,28095,3,33,6,0,1,0,0,3,362,104,25081,29471,25328,0,29,-17,1748,5,-797,2767,2,-1,0,0,2
EUN1_3572295853',6,73,21,2,0,0,0,12,1,327,65,30108,30685,37856,0,24,14,0,0,3,0,4,351,104,29895,29410,36565,0,-24,-39,213,7,1275,1291,2,0,-3,0,8
EUN1_3568950450',5,24,23,1,0,1,0,8,1,337,102,30551,31230,41331,2,23,9,1,1,0,0,3,311,70,24452,26752,24630,0,26,32,6099,14,4478,16701,0,-1,1,0,5
EUN1_3568937567',3,23,11,0,1,0,0,10,0,337,66,25734,28826,27408,7,32,14,2,0,1,0,0,329,86,27761,28943,34778,0,8,-20,-2027,-3,-117,-7370,-2,1,-1,0,10
EUN1_3576119275',4,28,18,1,1,0,0,7,1,333,85,29452,29030,41531,5,38,14,0,0,1,0,4,341,78,28452,29516,34301,0,-8,7,1000,4,-486,7230,1,1,-1,0,3
EUN1_3576063375',3,25,16,2,0,1,0,5,1,395,107,29364,32910,35000,3,27,10,0,0,0,0,7,346,84,26412,28331,23705,1,49,23,2952,6,4579,11295,2,0,1,0,-2
EUN1_3576031924',6,34,5,2,1,0,0,14,1,321,72,23097,27502,22597,4,28,11,0,0,3,0,0,417,92,30128,31532,38409,0,-96,-20,-7031,-6,-4030,-15812,2,1,-3,0,14
EUN1_3575932505',6,30,9,0,0,0,0,8,1,337,86,26190,28532,31357,3,38,14,2,0,1,0,3,373,113,28686,31706,37097,0,-36,-27,-2496,-5,-3174,-5740,-2,0,-1,0,5
EUN1_3575898531',5,23,17,0,0,0,0,6,0,362,70,28392,29077,42265,2,20,14,1,0,0,0,1,318,80,26328,30030,33718,0,44,-10,2064,3,-953,8547,-1,0,0,0,5
EUN1_3575575520',3,38,10,0,0,0,0,7,1,365,108,26600,29010,38055,3,43,17,2,0,1,0,3,360,52,28312,28902,33074,0,5,56,-1712,-7,108,4981,-2,0,-1,0,4
EUN1_3575506643',3,29,20,0,0,0,0,10,1,347,76,31756,29760,38087,0,28,22,1,0,1,0,7,297,74,30971,28155,43173,0,50,2,785,-2,1605,-5086,-1,0,-1,0,3
EUN1_3575465105',2,27,7,2,0,2,0,7,1,393,112,28735,30429,26501,1,36,6,0,0,1,0,9,311,75,22492,28407,20806,1,82,37,6243,1,2022,5695,2,0,1,0,-2
EUN1_3575440484',3,38,15,0,0,1,0,10,1,329,80,28279,27839,29865,2,31,11,1,0,0,0,8,311,83,25963,26828,29956,1,18,-3,2316,4,1011,-91,-1,0,1,0,2
EUN1_3575086947',1,32,27,0,0,0,0,14,1,317,84,31588,32748,41677,4,35,11,2,0,3,0,3,340,80,26798,27047,33137,1,-23,4,4790,16,5701,8540,-2,0,-3,0,11
EUN1_3575071782',5,112,18,2,0,3,0,10,0,365,126,33095,32845,35986,2,53,9,0,0,0,0,11,326,69,25744,28273,29980,1,39,57,7351,9,4572,6006,2,0,3,0,-1
EUN1_3575002297',5,23,10,0,0,0,0,7,0,374,102,27072,29944,34790,3,26,13,2,0,1,0,3,331,94,27262,28814,36217,1,43,8,-190,-3,1130,-1427,-2,0,-1,0,4
EUN1_3574977093',0,32,11,0,0,0,0,9,1,375,62,26753,30061,31653,2,31,9,2,0,1,0,5,330,94,26174,29412,25320,1,45,-32,579,2,649,6333,-2,0,-1,0,4
EUN1_3574543335',2,24,13,2,0,0,0,14,1,297,79,26170,28124,28775,1,18,21,0,1,2,0,1,333,98,32129,31039,39611,0,-36,-19,-5959,-8,-2915,-10836,2,-1,-2,0,13
EUN1_3574514782',2,40,7,2,0,0,0,9,0,333,84,25046,27069,27823,3,22,9,0,0,3,0,5,341,96,26521,29389,21151,0,-8,-12,-1475,-2,-2320,6672,2,0,-3,0,4
EUN1_3574449378',3,50,12,0,0,1,0,9,1,314,73,27288,26327,37508,4,28,11,2,0,0,0,4,328,69,25637,26379,29368,1,-14,4,1651,1,-52,8140,-2,0,1,0,5
EUN1_3576212167',3,26,17,2,1,3,0,6,1,320,128,31884,32767,39122,5,22,8,0,0,0,0,12,318,67,24645,26308,31332,1,2,61,7239,9,6459,7790,2,1,3,0,-6
EUN1_3576186981',2,42,11,0,0,0,0,11,0,296,87,24639,25897,21699,4,26,17,1,1,2,0,1,363,88,31082,30453,31519,0,-67,-1,-6443,-6,-4556,-9820,-1,-1,-2,0,10
EUN1_3576197788',4,27,18,0,0,1,0,7,1,322,100,30783,29499,35803,2,25,18,1,0,0,0,6,282,83,26971,27644,37512,1,40,17,3812,0,1855,-1709,-1,0,1,0,1
EUN1_3575643533',5,34,15,2,0,2,0,7,1,352,108,30329,31094,35010,1,29,6,0,0,0,0,7,295,76,23364,25925,19729,1,57,32,6965,9,5169,15281,2,0,2,0,0
EUN1_3575373718',2,34,5,0,0,0,0,7,1,387,84,24950,28558,21504,5,30,10,1,1,1,0,3,395,109,26676,32090,25600,1,-8,-25,-1726,-5,-3532,-4096,-1,-1,-1,0,4
EUN1_3575349699',2,39,6,1,0,0,0,6,1,371,84,24316,28013,27236,8,34,8,0,1,0,0,5,364,84,25263,29874,25649,0,7,0,-947,-2,-1861,1587,1,-1,0,0,1
EUN1_3575306515',0,17,9,0,0,0,0,6,1,293,72,23059,26125,25923,4,23,14,1,1,1,0,3,330,86,27025,28059,30133,0,-37,-14,-3966,-5,-1934,-4210,-1,-1,-1,0,3
EUN1_3575015078',0,60,1,0,0,0,0,10,0,295,70,19828,24244,20500,0,21,13,2,0,2,0,0,343,128,28754,30700,27613,0,-48,-58,-8926,-12,-6456,-7113,-2,0,-2,0,10
EUN1_3574877937',7,31,10,1,0,0,0,13,1,333,65,25648,27531,29555,2,24,18,0,0,4,0,3,394,98,33312,31752,34354,0,-61,-33,-7664,-8,-4221,-4799,1,0,-4,0,10
EUN1_3573575462',4,164,11,1,0,1,0,11,1,360,90,27941,29636,28936,3,35,10,0,0,0,0,3,303,84,24989,28422,25076,0,57,6,2952,1,1214,3860,1,0,1,0,8
EUN1_3573296659',3,28,17,2,0,2,0,8,1,295,95,29620,28483,34410,3,29,10,0,0,1,0,4,358,78,26871,27545,27306,1,-63,17,2749,7,938,7104,2,0,1,0,4
EUN1_3573119291',2,37,10,2,0,0,0,12,0,376,95,27355,29610,29356,1,21,8,0,0,1,0,4,369,96,26187,29181,23545,1,7,-1,1168,2,429,5811,2,0,-1,0,8
EUN1_3573104754',4,24,9,0,0,0,0,11,0,270,94,24517,24424,25942,6,30,29,2,0,1,0,0,350,88,33397,30608,46054,0,-80,6,-8880,-20,-6184,-20112,-2,0,-1,0,11
EUN1_3572905932',6,29,17,1,0,0,0,13,1,341,98,29228,29925,35450,3,24,17,0,0,2,0,1,329,86,30080,30452,33519,0,12,12,-852,0,-527,1931,1,0,-2,0,12
EUN1_3572784864',2,30,16,0,0,2,0,12,1,300,96,29405,29634,30304,6,62,15,1,0,1,0,6,335,76,28762,29942,29292,1,-35,20,643,1,-308,1012,-1,0,1,0,6
EUN1_3571866240',3,77,12,1,0,2,0,6,1,369,90,28093,29734,32423,1,28,6,1,0,0,0,7,334,82,23735,28324,33360,1,35,8,4358,6,1410,-937,0,0,2,0,-1
EUN1_3571822340',2,26,13,0,0,0,0,5,1,351,73,26393,28502,28050,3,30,6,1,0,0,0,3,347,76,23744,26331,20946,1,4,-3,2649,7,2171,7104,-1,0,0,0,2
EUN1_3571651061',1,26,21,1,1,2,0,5,1,338,80,32234,31381,44777,3,26,8,1,0,0,0,9,323,84,24324,27338,26984,1,15,-4,7910,13,4043,17793,0,1,2,0,-4
EUN1_3569736494',1,41,14,0,0,0,0,12,0,333,96,28337,30045,37869,3,29,24,2,1,1,0,4,306,81,31849,31860,37057,0,27,15,-3512,-10,-1815,812,-2,-1,-1,0,8
EUN1_3569705973',2,42,15,0,0,0,0,4,0,323,108,28629,30341,31681,4,26,11,2,0,0,0,3,366,80,25826,29545,26351,1,-43,28,2803,4,796,5330,-2,0,0,0,1
EUN1_3576131398',4,30,8,1,0,1,0,4,1,356,112,27445,30276,27820,3,21,4,1,0,0,0,2,383,99,23554,28612,22003,1,-27,13,3891,4,1664,5817,0,0,1,0,2
EUN1_3576105777',4,40,14,1,0,0,0,9,0,329,86,27139,28138,28069,4,33,16,1,0,1,0,1,387,65,29955,29227,30817,1,-58,21,-2816,-2,-1089,-2748,0,0,-1,0,8
EUN1_3576084658',2,25,4,0,0,0,0,7,1,373,80,23415,27618,22273,7,46,13,2,0,0,0,4,332,108,26293,30992,29598,0,41,-28,-2878,-9,-3374,-7325,-2,0,0,0,3
EUN1_3576047487',6,31,17,0,0,0,0,7,1,309,80,27744,29187,35798,8,33,9,2,0,2,0,4,379,86,27011,28127,26285,1,-70,-6,733,8,1060,9513,-2,0,-2,0,3
EUN1_3576029296',0,21,13,1,0,1,0,12,1,336,84,27999,25709,35058,3,26,18,1,1,1,0,3,377,112,32477,31109,37159,0,-41,-28,-4478,-5,-5400,-2101,0,-1,0,0,9
EUN1_3575882245',2,18,14,0,1,0,0,10,1,372,87,29209,31149,31979,5,26,11,2,0,1,0,3,357,76,26563,29580,29652,1,15,11,2646,3,1569,2327,-2,1,-1,0,7
EUN1_3575860688',3,114,6,1,0,0,0,8,0,335,78,22595,26479,21644,5,146,13,1,0,1,0,3,391,86,29106,30598,31023,0,-56,-8,-6511,-7,-4119,-9379,0,0,-1,0,5
EUN1_3575843796',4,36,13,2,0,0,0,13,0,340,97,27238,31621,27935,7,101,13,0,0,2,0,2,368,118,29777,31853,34156,1,-28,-21,-2539,0,-232,-6221,2,0,-2,0,11
EUN1_3575815286',1,27,10,2,0,0,0,12,1,362,103,26370,28899,29930,6,25,9,0,0,1,0,1,345,88,25337,29625,23885,0,17,15,1033,1,-726,6045,2,0,-1,0,11
EUN1_3575797184',6,27,9,0,0,1,0,7,0,319,82,25986,27881,29115,3,28,14,1,0,1,0,4,389,75,28735,29531,31566,0,-70,7,-2749,-5,-1650,-2451,-1,0,0,0,3
EUN1_3575422210',6,30,19,1,0,0,0,7,1,298,77,27837,27705,39018,4,30,10,1,0,0,0,1,301,74,25195,26553,39600,1,-3,3,2642,9,1152,-582,0,0,0,0,6
EUN1_3575359616',2,25,3,1,0,0,0,7,0,358,82,22720,27341,16504,6,32,7,1,0,0,0,0,403,98,25243,28823,18316,0,-45,-16,-2523,-4,-1482,-1812,0,0,0,0,7
EUN1_3575335425',3,27,10,0,0,0,0,12,1,315,80,25232,27541,28812,4,27,21,2,0,1,0,2,315,100,30247,30060,38417,1,0,-20,-5015,-11,-2519,-9605,-2,0,-1,0,10
EUN1_3575295653',4,57,10,1,1,1,0,5,1,339,95,26179,31023,19568,1,22,8,1,0,0,0,3,356,108,24953,29371,21259,0,-17,-13,1226,2,1652,-1691,0,1,1,0,2
EUN1_3573453693',5,29,13,1,0,0,0,10,1,354,92,27980,30975,31965,7,30,15,1,0,1,0,6,352,98,28957,30647,31528,0,2,-6,-977,-2,328,437,0,0,-1,0,4
EUN1_3573420015',4,25,23,1,0,2,0,9,0,340,79,34038,31234,41591,2,21,21,0,0,0,0,10,318,68,30232,28709,41382,0,22,11,3806,2,2525,209,1,0,2,0,-1
EUN1_3573407450',3,27,19,1,0,1,0,9,1,329,83,30464,30924,39068,4,22,6,0,0,1,0,7,326,76,22620,25753,32613,1,3,7,7844,13,5171,6455,1,0,0,0,2
EUN1_3573384258',3,22,15,0,0,0,0,11,1,338,76,27547,28530,32915,0,18,16,2,0,0,0,0,358,92,29690,33132,35642,0,-20,-16,-2143,-1,-4602,-2727,-2,0,0,0,11
EUN1_3573347349',4,22,21,1,0,0,0,12,1,226,72,25380,27981,37972,2,20,16,1,0,2,0,0,362,90,30246,30301,43260,0,-136,-18,-4866,5,-2320,-5288,0,0,-2,0,12
EUN1_3575660806',2,14,4,0,0,0,0,16,0,306,56,21740,25308,19934,5,32,12,2,1,4,0,5,369,116,30895,31362,35828,0,-63,-60,-9155,-8,-6054,-15894,-2,-1,-4,0,11
EUN1_3573751513',1,189,17,2,0,1,0,10,0,359,90,29600,30613,30501,7,38,12,0,0,1,0,5,332,87,27262,29844,37334,1,27,3,2338,5,769,-6833,2,0,0,0,5
EUN1_3573585967',6,32,14,0,0,0,0,12,0,412,129,31449,33245,36952,3,135,13,2,0,1,0,1,341,86,26699,28767,30729,1,71,43,4750,1,4478,6223,-2,0,-1,0,11
EUN1_3573577974',2,30,6,0,0,0,0,16,0,327,94,22996,28192,31022,4,28,16,2,0,2,0,2,342,78,29381,31541,38452,0,-15,16,-6385,-10,-3349,-7430,-2,0,-2,0,14
EUN1_3571544185',4,43,16,1,0,0,0,7,0,342,76,29346,29900,36462,5,25,15,1,0,0,0,5,320,112,27442,29529,32609,0,22,-36,1904,1,371,3853,0,0,0,0,2
EUN1_3571036869',4,41,21,1,0,0,0,4,1,346,94,30049,30155,34296,3,31,11,0,0,1,0,4,283,78,25284,27135,31763,1,63,16,4765,10,3020,2533,1,0,-1,0,0
EUN1_3570920542',2,29,8,0,0,0,0,9,1,327,84,24595,27771,22583,4,41,13,1,0,1,0,1,344,66,27190,28030,37144,0,-17,18,-2595,-5,-259,-14561,-1,0,-1,0,8
EUN1_3570893573',1,21,6,2,0,0,0,15,0,350,76,24968,26461,28461,5,28,22,0,1,3,0,4,362,94,33381,32833,32921,0,-12,-18,-8413,-16,-6372,-4460,2,-1,-3,0,11
EUN1_3570864530',3,50,20,1,1,1,0,6,1,328,83,30793,31368,41101,3,26,13,0,0,0,0,4,335,80,27238,29404,31809,1,-7,3,3555,7,1964,9292,1,1,1,0,2
EUN1_3570828231',5,16,19,1,0,2,0,10,0,358,86,31130,31595,41497,1,18,11,1,0,1,0,5,301,82,24713,26814,34123,0,57,4,6417,8,4781,7374,0,0,1,0,5
EUN1_3570282747',1,29,24,1,0,1,0,13,0,364,90,33721,31973,55520,7,28,16,0,0,1,0,5,354,82,29563,28754,36040,1,10,8,4158,8,3219,19480,1,0,0,0,8
EUN1_3570250067',5,20,18,0,0,1,0,13,0,347,89,30010,31245,35623,2,23,15,1,0,1,0,5,331,107,29269,30154,34899,0,16,-18,741,3,1091,724,-1,0,0,0,8
EUN1_3570220032',5,28,10,2,0,0,0,7,1,398,78,25872,29633,20351,3,28,8,0,1,0,0,0,397,104,27022,30560,27215,1,1,-26,-1150,2,-927,-6864,2,-1,0,0,7
EUN1_3567665465',1,24,14,0,0,0,0,12,0,311,60,27032,27107,36316,1,81,23,1,0,2,0,2,326,82,32307,29700,43733,0,-15,-22,-5275,-9,-2593,-7417,-1,0,-2,0,10
EUN1_3566685198',4,22,20,1,0,2,0,6,1,390,80,33679,30936,41250,2,40,11,0,0,0,0,12,326,93,26857,29664,38975,1,64,-13,6822,9,1272,2275,1,0,2,0,-6
EUN1_3564919997',3,30,21,0,1,1,0,7,1,342,112,32471,31689,33011,8,44,14,2,0,0,0,4,334,80,27412,29261,33111,1,8,32,5059,7,2428,-100,-2,1,1,0,3
EUN1_3564847328',6,28,15,2,0,0,0,7,0,372,114,29026,32970,39827,3,22,8,0,0,0,0,4,358,97,25692,28078,26859,1,14,17,3334,7,4892,12968,2,0,0,0,3
EUN1_3563454157',2,47,16,1,0,2,0,12,0,355,75,31159,29138,36985,8,33,15,1,0,1,0,8,315,76,27759,26733,37902,0,40,-1,3400,1,2405,-917,0,0,1,0,4
EUN1_3563417155',2,66,10,1,0,0,0,10,0,350,125,27782,31699,29051,3,166,9,1,0,1,0,3,341,66,25302,28996,27252,1,9,59,2480,1,2703,1799,0,0,-1,0,7
EUN1_3571948019',2,31,12,2,0,2,0,4,1,328,110,29176,30615,30981,3,21,9,0,0,0,0,8,336,82,26068,28202,29339,1,-8,28,3108,3,2413,1642,2,0,2,0,-4
EUN1_3571351568',3,24,16,2,0,2,0,6,1,351,73,30920,29821,31120,3,31,17,0,0,0,0,6,372,70,29488,30464,34303,1,-21,3,1432,-1,-643,-3183,2,0,2,0,0
EUN1_3571334897',6,33,11,0,0,1,0,6,0,308,81,26252,26375,32324,8,29,14,1,0,0,0,8,348,106,29636,30310,34689,0,-40,-25,-3384,-3,-3935,-2365,-1,0,1,0,-2
EUN1_3570769078',1,22,18,2,0,1,0,12,1,373,90,29973,32504,34921,5,35,7,0,0,2,0,8,342,73,24856,28778,27252,1,31,17,5117,11,3726,7669,2,0,-1,0,4
EUN1_3570736329',4,65,18,1,0,2,0,4,0,328,86,30342,30371,38493,1,29,20,1,0,0,0,5,305,86,29304,30845,36824,0,23,0,1038,-2,-474,1669,0,0,2,0,-1
EUN1_3570432526',8,30,5,1,0,0,0,6,0,394,98,25227,30181,25151,0,31,12,0,0,0,0,1,420,64,27110,30105,28471,0,-26,34,-1883,-7,76,-3320,1,0,0,0,5
EUN1_3570398408',3,26,9,1,1,0,0,8,0,331,100,24597,28798,22403,3,30,15,1,0,1,0,3,355,76,28790,28488,33023,0,-24,24,-4193,-6,310,-10620,0,1,-1,0,5
EUN1_3570200264',2,28,9,0,0,0,0,7,1,344,81,24762,28912,23861,2,147,11,2,1,0,0,0,369,127,28051,32350,30447,0,-25,-46,-3289,-2,-3438,-6586,-2,-1,0,0,7
EUN1_3576113830',0,26,15,0,0,2,0,7,1,326,70,28475,30456,34980,1,22,4,1,0,0,0,5,309,82,21733,25693,24919,1,17,-12,6742,11,4763,10061,-1,0,2,0,2
EUN1_3576092761',5,29,9,0,0,0,0,17,1,324,90,26004,29442,38734,4,22,19,2,1,2,0,2,369,104,31778,32093,42783,0,-45,-14,-5774,-10,-2651,-4049,-2,-1,-2,0,15
EUN1_3575997656',5,66,9,1,0,0,0,9,1,364,64,26863,27340,27571,1,27,14,1,0,2,0,5,299,96,27608,29072,23693,1,65,-32,-745,-5,-1732,3878,0,0,-2,0,4
EUN1_3575959956',7,33,17,1,0,2,0,6,0,355,85,30610,30086,37678,4,25,10,0,0,0,0,2,274,70,24796,25154,32385,0,81,15,5814,7,4932,5293,1,0,2,0,4
EUN1_3575891996',0,17,7,0,0,0,0,14,0,308,80,24872,26162,27447,1,90,26,1,1,2,0,7,321,91,32230,30972,45994,0,-13,-11,-7358,-19,-4810,-18547,-1,-1,-2,0,7
EUN1_3575874500',2,33,15,0,0,0,0,8,0,337,122,27777,31774,35667,3,25,20,2,0,1,0,0,341,68,29014,31335,35698,0,-4,54,-1237,-5,439,-31,-2,0,-1,0,8
EUN1_3575850038',4,44,14,1,0,0,0,9,1,279,90,26208,25518,42695,4,25,29,0,0,1,0,2,343,62,33321,31461,50166,0,-64,28,-7113,-15,-5943,-7471,1,0,-1,0,7
EUN1_3575804472',4,26,11,1,0,0,0,5,0,361,80,26977,30533,35111,0,25,11,1,0,0,0,4,294,100,25566,29426,26136,0,67,-20,1411,0,1107,8975,0,0,0,0,1
EUN1_3575742391',5,35,13,2,0,0,0,5,0,341,70,26681,27579,32335,3,41,14,0,0,0,0,2,341,86,27666,28233,30748,0,0,-16,-985,-1,-654,1587,2,0,0,0,3
EUN1_3575722988',2,25,18,1,0,3,0,8,1,401,81,32068,33053,37280,4,22,13,0,0,0,0,8,307,94,26244,27972,29819,1,94,-13,5824,5,5081,7461,1,0,3,0,0
EUN1_3575580929',7,30,15,2,0,2,0,7,1,357,108,30019,31685,30260,2,19,6,0,0,0,0,9,329,84,23023,28217,23090,1,28,24,6996,9,3468,7170,2,0,2,0,-2
EUN1_3575557504',4,27,13,1,0,1,0,4,1,354,88,27866,29237,30619,6,27,12,1,1,0,0,4,312,80,26761,28693,31007,1,42,8,1105,1,544,-388,0,-1,1,0,0
EUN1_3575386075',3,29,12,2,0,0,0,9,0,309,92,26207,29379,29483,1,26,12,0,0,0,0,0,346,100,26318,28946,30568,1,-37,-8,-111,0,433,-1085,2,0,0,0,9
EUN1_3575357763',1,42,16,2,0,1,0,8,1,318,86,28989,27758,27807,5,33,8,0,0,0,0,7,320,80,24086,25825,22987,1,-2,6,4903,8,1933,4820,2,0,1,0,1
EUN1_3575333006',1,31,8,1,0,0,0,10,1,334,90,25740,28670,29411,4,24,10,1,0,0,0,1,355,78,25758,27248,33162,0,-21,12,-18,-2,1422,-3751,0,0,0,0,9
EUN1_3575319883',5,175,17,2,0,2,0,9,1,351,97,31224,31955,34024,5,29,10,0,0,0,0,7,345,71,26606,27617,27606,1,6,26,4618,7,4338,6418,2,0,2,0,2
EUN1_3575311298',1,77,13,0,0,1,0,10,0,352,102,28466,31216,28938,3,31,17,1,0,1,0,3,288,93,28835,29306,31244,0,64,9,-369,-4,1910,-2306,-1,0,0,0,7
EUN1_3575286008',3,32,15,1,0,0,0,5,1,361,84,30434,29571,31054,5,28,8,1,0,1,0,5,340,92,24259,27822,30259,1,21,-8,6175,7,1749,795,0,0,-1,0,0
EUN1_3575275240',4,22,19,0,1,0,0,6,0,298,98,30089,29090,42066,8,37,9,1,0,1,0,4,312,80,24439,25501,33788,1,-14,18,5650,10,3589,8278,-1,1,-1,0,2
EUN1_3575020482',2,22,11,1,0,0,0,6,1,332,81,26639,28877,27051,1,22,16,0,0,0,0,4,347,85,28173,30735,36585,0,-15,-4,-1534,-5,-1858,-9534,1,0,0,0,2
EUN1_3572943706',5,42,13,0,0,0,0,12,0,338,71,26897,28567,29469,2,32,20,1,0,3,0,0,394,80,34219,30669,39044,0,-56,-9,-7322,-7,-2102,-9575,-1,0,-3,0,12
EUN1_3572946308',1,21,10,0,0,1,0,7,0,312,80,27052,30480,25985,3,26,19,2,0,1,0,4,346,88,29821,30720,42204,1,-34,-8,-2769,-9,-240,-16219,-2,0,0,0,3
EUN1_3572935774',3,63,10,0,0,0,0,7,0,323,92,26464,29864,30104,2,24,11,2,0,1,0,5,336,92,27088,27642,29667,1,-13,0,-624,-1,2222,437,-2,0,-1,0,2
EUN1_3572936126',5,34,20,1,0,2,0,5,1,309,100,31421,31047,41101,0,16,9,1,0,0,0,10,330,90,24922,27479,30215,1,-21,10,6499,11,3568,10886,0,0,2,0,-5
EUN1_3572912418',5,28,12,1,0,0,0,8,0,316,106,27083,28995,30030,5,45,9,1,0,0,0,7,329,78,25336,27397,28922,0,-13,28,1747,3,1598,1108,0,0,0,0,1
EUN1_3572683724',6,28,14,0,0,0,0,9,1,345,92,28790,28539,39229,8,36,16,1,0,1,0,5,322,74,28788,29092,33443,0,23,18,2,-2,-553,5786,-1,0,-1,0,4
EUN1_3572392918',6,43,6,0,0,0,0,10,0,308,88,23348,26956,30277,5,85,19,1,0,1,0,4,336,104,29456,32860,33685,0,-28,-16,-6108,-13,-5904,-3408,-1,0,-1,0,6
EUN1_3572380877',4,276,9,0,0,0,0,9,0,344,57,24793,27797,21722,3,26,14,2,0,2,0,2,314,106,28339,28127,31884,0,30,-49,-3546,-5,-330,-10162,-2,0,-2,0,7
EUN1_3572383106',6,29,19,2,0,2,0,3,1,364,93,31743,31315,33860,2,20,6,0,0,1,0,8,324,78,23164,26293,24475,1,40,15,8579,13,5022,9385,2,0,1,0,-5
EUN1_3572356989',4,27,7,0,0,0,0,17,0,280,52,22361,24039,31132,3,23,27,2,0,5,0,1,353,119,37825,34465,44208,0,-73,-67,-15464,-20,-10426,-13076,-2,0,-5,0,16
EUN1_3572354109',3,20,7,0,0,0,0,11,0,327,86,24269,27756,17218,5,24,7,2,0,1,0,2,376,90,25689,29174,26456,0,-49,-4,-1420,0,-1418,-9238,-2,0,-1,0,9
EUN1_3572322392',2,26,20,0,0,0,0,7,1,357,64,30832,29300,43121,5,26,15,1,0,0,0,5,315,86,27879,28316,39816,1,42,-22,2953,5,984,3305,-1,0,0,0,2
EUN1_3572297261',1,25,16,1,0,1,0,10,0,341,92,30389,31479,33704,5,26,10,1,0,1,0,6,342,88,27016,29136,33056,1,-1,4,3373,6,2343,648,0,0,0,0,4
EUN1_3572272271',6,26,6,1,0,0,0,5,0,365,94,24231,29252,24051,5,32,8,1,0,1,0,0,354,102,25158,28825,27383,0,11,-8,-927,-2,427,-3332,0,0,-1,0,5
EUN1_3572215894',4,43,15,1,0,0,0,8,0,286,78,26368,27819,35324,0,23,16,1,0,0,0,3,303,88,27641,27622,32363,1,-17,-10,-1273,-1,197,2961,0,0,0,0,5
EUN1_3571855554',4,26,20,2,0,0,0,13,0,316,100,30728,32311,40786,3,20,18,0,0,2,0,1,365,72,31180,30390,42922,0,-49,28,-452,2,1921,-2136,2,0,-2,0,12
EUN1_3571851374',5,24,13,1,0,2,0,8,0,390,68,29494,31652,32038,4,41,12,1,0,0,0,4,332,84,25747,27712,30840,1,58,-16,3747,1,3940,1198,0,0,2,0,4
EUN1_3571843426',1,24,18,1,0,1,0,5,1,324,56,28950,29167,38954,4,19,15,1,0,0,0,6,317,88,28221,28918,42438,1,7,-32,729,3,249,-3484,0,0,1,0,-1
EUN1_3575746885',8,34,8,2,0,2,0,8,1,403,130,28717,30445,29589,4,30,9,0,0,1,0,6,350,56,23811,28490,24561,1,53,74,4906,-1,1955,5028,2,0,1,0,2
EUN1_3575729575',2,22,5,0,0,0,0,15,0,327,66,22974,25165,22672,6,34,13,2,0,3,0,1,383,100,31308,28873,34578,0,-56,-34,-8334,-8,-3708,-11906,-2,0,-3,0,14
EUN1_3575624891',0,28,28,0,0,4,0,5,1,353,90,34984,32083,44557,1,15,5,0,0,0,0,11,278,40,22151,25073,28219,1,75,50,12833,23,7010,16338,0,0,4,0,-6
EUN1_3575621091',5,33,7,0,0,1,0,7,1,393,84,26126,29258,35750,8,100,7,2,0,0,0,2,339,96,23930,30481,22144,1,54,-12,2196,0,-1223,13606,-2,0,1,0,5
EUN1_3575582719',4,30,15,0,0,1,0,10,1,278,75,28424,29802,38477,2,30,26,2,0,2,0,3,327,76,31707,31926,47288,0,-49,-1,-3283,-11,-2124,-8811,-2,0,-1,0,7
EUN1_3573779258',2,74,8,1,0,0,0,11,0,371,102,25401,29944,29501,2,27,14,1,0,2,0,2,374,98,29588,30892,35621,0,-3,4,-4187,-6,-948,-6120,0,0,-2,0,9
EUN1_3573625950',0,26,6,1,0,0,0,8,1,379,86,24481,28641,28223,8,35,13,1,0,1,0,3,409,77,27930,30494,28869,0,-30,9,-3449,-7,-1853,-646,0,0,-1,0,5
EUN1_3573609617',2,62,19,1,0,1,0,5,1,332,76,29885,30214,38872,0,53,7,0,0,0,0,4,329,80,24020,27888,27056,0,3,-4,5865,12,2326,11816,1,0,1,0,1
EUN1_3573594568',5,31,13,2,0,0,0,11,1,292,84,26237,26156,32534,6,30,18,0,0,1,0,1,333,64,30131,29082,36942,1,-41,20,-3894,-5,-2926,-4408,2,0,-1,0,10
EUN1_3573576822',1,25,2,0,0,1,0,17,0,341,74,22463,25859,24510,1,387,24,1,0,4,0,3,385,98,34646,32801,39927,0,-44,-24,-12183,-22,-6942,-15417,-1,0,-3,0,14
EUN1_3573564430',7,32,9,1,0,0,0,4,1,316,82,25061,28127,33736,4,27,14,1,0,0,0,4,324,70,26056,28137,32689,0,-8,12,-995,-5,-10,1047,0,0,0,0,0
EUN1_3573546903',6,84,8,0,0,0,0,8,1,334,63,24372,25436,30791,6,32,20,2,0,2,0,1,362,80,30536,32388,43051,0,-28,-17,-6164,-12,-6952,-12260,-2,0,-2,0,7
EUN1_3573475286',3,41,11,1,1,0,0,8,0,325,80,25789,29079,29456,1,20,7,0,0,1,0,7,343,80,25671,28648,28195,0,-18,0,118,4,431,1261,1,1,-1,0,1
EUN1_3573449655',2,27,17,1,0,0,0,8,1,320,42,27924,28186,36301,2,30,18,0,0,0,0,3,327,71,29524,29630,43600,0,-7,-29,-1600,-1,-1444,-7299,1,0,0,0,5
EUN1_3573432324',0,24,5,0,0,0,0,6,0,414,92,25240,29927,25725,2,297,15,2,0,0,0,3,377,84,27879,31524,36223,0,37,8,-2639,-10,-1597,-10498,-2,0,0,0,3
EUN1_3572603304',4,26,8,0,0,0,0,6,0,318,64,24113,27692,33455,4,27,12,1,0,0,0,2,349,80,27152,29428,37190,0,-31,-16,-3039,-4,-1736,-3735,-1,0,0,0,4
EUN1_3572182473',3,21,8,0,1,0,0,5,1,329,112,25200,29544,30898,6,30,11,2,0,0,0,4,391,72,25573,30647,28162,0,-62,40,-373,-3,-1103,2736,-2,1,0,0,1
EUN1_3572169179',7,76,16,1,0,5,0,3,1,422,104,34582,33826,35039,3,22,6,0,0,0,0,13,323,70,20810,26870,21766,1,99,34,13772,10,6956,13273,1,0,5,0,-10
EUN1_3568629893',5,37,17,0,0,2,0,13,0,328,100,30866,31019,41703,2,27,13,2,0,1,0,7,309,88,27957,28265,34192,0,19,12,2909,4,2754,7511,-2,0,1,0,6
EUN1_3568568742',6,141,15,1,0,0,0,6,1,359,99,28298,32073,37627,3,30,8,1,0,0,0,3,337,84,24177,28776,26333,1,22,15,4121,7,3297,11294,0,0,0,0,3
EUN1_3568110817',2,27,13,0,1,0,0,4,0,360,70,28942,30688,28609,5,107,15,2,0,1,0,6,316,90,27698,29096,32017,1,44,-20,1244,-2,1592,-3408,-2,1,-1,0,-2
EUN1_3568058951',3,26,9,0,1,0,0,12,0,346,80,26654,29589,26089,3,23,16,2,0,2,0,4,391,92,30384,31068,29802,0,-45,-12,-3730,-7,-1479,-3713,-2,1,-2,0,8
EUN1_3567648657',4,25,12,0,0,0,0,9,1,263,62,25043,25729,27384,3,81,14,2,0,1,0,2,355,74,28152,29417,42274,0,-92,-12,-3109,-2,-3688,-14890,-2,0,-1,0,7
EUN1_3570754600',4,20,12,1,0,0,0,10,0,371,96,28207,30751,25412,4,31,10,0,0,0,0,1,349,84,26831,29444,30911,1,22,12,1376,2,1307,-5499,1,0,0,0,9
EUN1_3567821388',4,29,14,1,1,0,0,13,1,382,92,29986,29946,31789,4,148,14,1,0,4,0,4,325,80,28786,30394,32990,1,57,12,1200,0,-448,-1201,0,1,-4,0,9
EUN1_3567637461',8,33,15,0,0,0,0,9,0,322,88,29228,27636,29690,5,54,15,1,1,2,0,3,359,76,29780,28135,30554,0,-37,12,-552,0,-499,-864,-1,-1,-2,0,6
EUN1_3565858344',8,33,20,1,0,0,0,3,1,356,74,30878,30061,39827,2,23,11,0,0,0,0,4,297,98,25408,26505,25326,1,59,-24,5470,9,3556,14501,1,0,0,0,-1
EUN1_3565831576',5,20,18,0,0,2,0,8,0,369,113,32503,32357,37547,3,226,12,2,0,0,0,10,320,74,25636,27284,37357,1,49,39,6867,6,5073,190,-2,0,2,0,-2
EUN1_3565671970',3,40,6,0,0,0,0,9,0,341,92,24915,28298,32802,7,30,12,1,0,1,0,3,352,72,26467,29913,29388,0,-11,20,-1552,-6,-1615,3414,-1,0,-1,0,6
EUN1_3565673122',4,30,11,0,0,0,0,10,1,326,86,26389,28408,26698,6,46,16,2,0,1,0,2,351,93,30423,30667,34163,0,-25,-7,-4034,-5,-2259,-7465,-2,0,-1,0,8
EUN1_3564916235',6,34,15,0,0,1,0,8,1,357,76,30876,29867,32525,6,30,13,2,0,1,0,7,291,76,26061,28274,26778,1,66,0,4815,2,1593,5747,-2,0,0,0,1
EUN1_3564844707',7,140,4,0,0,0,0,5,0,323,80,22133,26754,24137,7,33,17,0,0,0,0,1,357,98,29083,30576,30088,0,-34,-18,-6950,-13,-3822,-5951,0,0,0,0,4
EUN1_3564829528',3,23,10,2,1,0,0,11,0,355,103,26245,31698,35097,5,25,7,0,0,1,0,0,403,86,27464,29699,24843,0,-48,17,-1219,3,1999,10254,2,1,-1,0,11
EUN1_3563939379',4,33,16,2,1,1,0,8,1,319,94,29281,29823,37057,6,27,10,0,0,0,0,7,329,74,25341,26498,33582,1,-10,20,3940,6,3325,3475,2,1,1,0,1
EUN1_3573347880',4,29,9,0,0,1,0,11,0,323,84,26039,29099,27585,2,23,15,2,0,1,0,2,370,100,28803,29680,36327,0,-47,-16,-2764,-6,-581,-8742,-2,0,0,0,9
EUN1_3573289082',3,162,7,0,0,0,0,8,0,393,99,25933,30432,28329,6,34,6,2,0,1,0,2,400,108,25906,28950,21579,1,-7,-9,27,1,1482,6750,-2,0,-1,0,6
EUN1_3573261675',3,21,20,2,0,2,0,8,1,385,110,32022,33089,39440,3,26,9,0,0,1,0,7,300,78,24793,27806,30727,1,85,32,7229,11,5283,8713,2,0,1,0,1
EUN1_3573222968',8,44,13,0,0,0,0,9,1,353,84,27485,30703,33703,4,30,11,1,0,0,0,4,307,88,25357,29033,28620,0,46,-4,2128,2,1670,5083,-1,0,0,0,5
EUN1_3573195045',6,24,9,1,0,0,0,9,1,402,88,26425,29901,22568,4,37,5,1,0,1,0,3,372,104,24950,30343,19663,1,30,-16,1475,4,-442,2905,0,0,-1,0,6
EUN1_3572893784',1,20,7,0,1,0,0,9,0,316,102,24341,27309,25390,5,193,15,1,0,1,0,2,350,64,27543,29056,30080,0,-34,38,-3202,-8,-1747,-4690,-1,1,-1,0,7
EUN1_3572659929',3,26,15,1,0,0,0,8,0,311,84,27907,29552,37291,4,29,9,1,0,0,0,1,334,92,25584,29368,29748,1,-23,-8,2323,6,184,7543,0,0,0,0,7
EUN1_3574045472',4,28,19,1,0,0,0,12,0,275,84,28019,28104,48228,4,28,21,0,0,1,0,2,303,80,31205,29686,41239,1,-28,4,-3186,-2,-1582,6989,1,0,-1,0,10
EUN1_3574044100',1,22,11,1,1,0,0,10,1,352,84,26880,29787,31698,2,20,10,0,0,2,0,1,332,82,25005,28583,26104,1,20,2,1875,1,1204,5594,1,1,-2,0,9
EUN1_3571240999',3,24,13,0,0,1,0,9,0,315,79,27607,28665,25374,4,25,13,2,0,2,0,6,351,100,28448,29365,38846,1,-36,-21,-841,0,-700,-13472,-2,0,-1,0,3
EUN1_3571236487',1,19,14,0,0,0,0,16,0,265,80,27784,25972,39475,6,26,28,1,1,4,0,7,331,102,35435,31048,49432,0,-66,-22,-7651,-14,-5076,-9957,-1,-1,-4,0,9
EUN1_3571220917',2,24,8,0,0,0,0,8,1,338,76,24510,27416,27181,4,26,11,1,0,1,0,2,342,76,26799,28584,33627,0,-4,0,-2289,-3,-1168,-6446,-1,0,-1,0,6
EUN1_3571216087',3,30,13,0,0,2,0,11,1,359,94,28389,29563,36427,1,31,12,1,0,0,0,2,326,70,26569,28075,33962,1,33,24,1820,1,1488,2465,-1,0,2,0,9
EUN1_3569881603',4,29,9,2,1,0,0,7,0,322,94,24721,27876,20305,0,45,12,0,0,1,0,3,333,118,27621,30356,26371,0,-11,-24,-2900,-3,-2480,-6066,2,1,-1,0,4
EUN1_3569859550',4,25,12,1,0,0,0,6,0,344,71,26347,29069,29753,3,24,15,1,0,0,0,3,347,98,27598,29531,36076,0,-3,-27,-1251,-3,-462,-6323,0,0,0,0,3
EUN1_3569092607',3,25,14,2,0,1,0,8,0,388,92,28806,31236,28172,3,25,12,0,0,0,0,6,330,96,26535,28496,28286,1,58,-4,2271,2,2740,-114,2,0,1,0,2
EUN1_3569074529',6,32,9,0,0,1,0,11,1,355,108,25863,30335,18060,5,30,7,2,0,2,0,4,376,94,26500,29363,24590,0,-21,14,-637,2,972,-6530,-2,0,-1,0,7
EUN1_3574335584',8,51,12,1,0,0,0,6,1,331,88,26761,28384,30736,3,29,11,0,0,0,0,2,319,92,25830,27584,27711,1,12,-4,931,1,800,3025,1,0,0,0,4
EUN1_3574313456',3,19,10,0,0,0,0,15,1,345,70,26124,27645,24495,3,42,18,2,1,2,0,2,349,120,32121,30950,38141,0,-4,-50,-5997,-8,-3305,-13646,-2,-1,-2,0,13
EUN1_3574291717',3,23,11,2,0,1,0,9,1,340,86,27154,28584,30334,6,33,19,0,1,2,0,7,341,117,30391,32895,37018,1,-1,-31,-3237,-8,-4311,-6684,2,-1,-1,0,2
EUN1_3573599530',3,23,13,1,0,0,0,15,1,315,90,26751,26225,36494,1,23,20,0,0,3,0,3,318,70,30656,29737,39693,0,-3,20,-3905,-7,-3512,-3199,1,0,-3,0,12
EUN1_3573352262',3,29,10,0,0,2,0,6,1,354,82,27767,27174,31161,4,28,18,1,0,1,0,7,279,97,28434,28514,32559,0,75,-15,-667,-8,-1340,-1398,-1,0,1,0,-1
EUN1_3573319855',6,43,12,1,0,0,0,6,1,388,99,27690,33163,30230,5,40,2,1,0,0,0,5,408,84,23425,29827,16853,1,-20,15,4265,10,3336,13377,0,0,0,0,1
EUN1_3573005281',6,26,13,2,0,0,0,6,1,376,92,29074,30528,30327,1,26,15,0,0,0,0,3,367,80,28425,31504,32014,1,9,12,649,-2,-976,-1687,2,0,0,0,3
EUN1_3572988694',4,39,8,2,0,1,0,14,0,401,92,25600,29191,21457,8,349,10,0,0,2,0,1,411,79,29740,29700,31149,1,-10,13,-4140,-2,-509,-9692,2,0,-1,0,13
EUN1_3572919417',5,31,18,0,0,0,0,10,1,353,73,28300,29648,32388,3,21,10,2,0,0,0,2,341,94,24957,28359,34960,1,12,-21,3343,8,1289,-2572,-2,0,0,0,8
EUN1_3572903397',2,30,15,1,1,2,0,7,0,346,96,29204,30516,31567,1,30,4,1,0,0,0,8,291,84,22700,26417,29081,1,55,12,6504,11,4099,2486,0,1,2,0,-1
EUN1_3572881064',2,26,10,2,0,0,0,10,0,362,100,27029,30301,26237,5,47,11,0,0,1,0,5,379,64,27040,28815,30323,1,-17,36,-11,-1,1486,-4086,2,0,-1,0,5
EUN1_3572866410',1,19,16,1,0,0,0,11,0,308,68,27576,29613,30412,5,31,17,1,0,0,0,2,296,87,28148,27864,39703,0,12,-19,-572,-1,1749,-9291,0,0,0,0,9
EUN1_3572833134',6,42,11,1,0,0,0,9,0,381,90,27065,29362,32561,3,17,14,0,0,1,0,1,394,78,29703,32018,34868,0,-13,12,-2638,-3,-2656,-2307,1,0,-1,0,8
EUN1_3572614009',8,28,17,1,0,0,0,11,0,313,90,28120,30017,33701,5,44,11,1,0,1,0,2,326,90,27493,27237,30913,1,-13,0,627,6,2780,2788,0,0,-1,0,9
EUN1_3572590823',2,27,11,0,0,1,0,12,1,343,74,26251,29497,30563,1,36,9,1,0,1,0,1,366,82,25813,28142,29297,1,-23,-8,438,2,1355,1266,-1,0,0,0,11
EUN1_3572536309',2,22,15,1,0,0,0,9,1,304,80,26881,26351,27639,5,25,20,1,1,3,0,0,360,116,33332,31271,39581,0,-56,-36,-6451,-5,-4920,-11942,0,-1,-3,0,9
EUN1_3572509868',3,26,11,0,1,1,0,9,0,334,98,27795,30033,29828,5,148,11,2,0,0,0,4,365,101,26517,30927,29193,1,-31,-3,1278,0,-894,635,-2,1,1,0,5
EUN1_3572492764',2,30,12,1,0,1,0,6,1,297,72,26699,27468,35067,4,35,14,0,0,0,0,4,340,86,27191,28758,41630,0,-43,-14,-492,-2,-1290,-6563,1,0,1,0,2
EUN1_3572485945',2,26,8,0,0,0,0,9,0,369,102,25425,30823,29932,2,22,10,1,0,1,0,1,366,93,26711,30404,31460,0,3,9,-1286,-2,419,-1528,-1,0,-1,0,8
EUN1_3574295562',2,40,7,0,0,1,0,10,0,313,71,24744,24446,30543,0,27,20,2,0,0,0,7,317,93,29184,26968,38982,0,-4,-22,-4440,-13,-2522,-8439,-2,0,1,0,3
EUN1_3574272413',2,35,11,2,0,0,0,7,1,370,101,27383,29774,28868,2,27,14,0,0,0,0,4,339,86,27377,27814,34954,0,31,15,6,-3,1960,-6086,2,0,0,0,3
EUN1_3574255418',2,254,24,1,0,2,0,6,1,343,120,33127,32336,46877,3,67,11,1,0,0,0,5,350,76,27975,27695,25959,1,-7,44,5152,13,4641,20918,0,0,2,0,1
EUN1_3574237460',2,27,13,1,0,0,0,8,0,344,76,26799,27263,31489,3,25,14,1,0,1,0,4,371,104,29915,29823,26777,0,-27,-28,-3116,-1,-2560,4712,0,0,-1,0,4
EUN1_3574213040',3,21,26,1,0,3,0,8,0,328,100,34391,30055,46203,1,19,15,0,0,1,0,12,284,76,28415,27145,35062,1,44,24,5976,11,2910,11141,1,0,2,0,-4
EUN1_3574200529',0,20,17,0,0,1,0,7,1,347,86,29076,29539,42301,2,24,17,2,0,0,0,6,252,90,26763,26851,38572,1,95,-4,2313,0,2688,3729,-2,0,1,0,1
EUN1_3574188241',6,232,12,2,0,2,0,4,1,378,118,29598,30729,27910,1,26,12,0,1,0,0,13,353,78,27513,29993,28653,1,25,40,2085,0,736,-743,2,-1,2,0,-9
EUN1_3574166881',3,28,11,1,0,0,0,7,0,348,90,27338,27666,28004,1,26,11,1,0,0,0,4,337,106,26092,28942,30208,0,11,-16,1246,0,-1276,-2204,0,0,0,0,3
EUN1_3574155692',4,31,16,0,1,0,0,9,1,350,85,29374,31599,40879,4,26,12,2,0,2,0,3,352,84,27709,28331,33461,0,-2,1,1665,4,3268,7418,-2,1,-2,0,6
EUN1_3574141106',2,19,13,0,0,0,0,11,0,333,78,26692,29698,33469,1,22,16,2,0,1,0,0,413,92,30868,32543,39592,0,-80,-14,-4176,-3,-2845,-6123,-2,0,-1,0,11
EUN1_3573875075',5,24,13,1,0,0,0,4,1,381,85,29159,30556,34550,4,21,13,1,0,1,0,3,370,74,27779,29543,28774,0,11,11,1380,0,1013,5776,0,0,-1,0,1
EUN1_3573829730',4,28,7,0,0,0,0,9,0,353,94,25265,27848,27210,7,31,13,2,0,1,0,6,352,86,28845,28559,26889,0,1,8,-3580,-6,-711,321,-2,0,-1,0,3
EUN1_3573813508',1,25,20,1,0,2,0,5,1,399,80,31946,32126,41397,2,27,9,0,0,0,0,8,313,90,24622,28115,27541,1,86,-10,7324,11,4011,13856,1,0,2,0,-3
EUN1_3573795136',2,79,11,1,0,0,0,6,1,320,90,27000,27693,37410,5,71,19,1,0,0,0,5,343,93,29691,30724,42791,0,-23,-3,-2691,-8,-3031,-5381,0,0,0,0,1
EUN1_3573767760',6,62,16,2,0,1,0,7,1,332,108,28479,29785,34687,5,87,9,0,0,1,0,7,367,79,25994,29867,31214,1,-35,29,2485,7,-82,3473,2,0,0,0,0
EUN1_3573758604',3,26,24,2,0,3,0,14,1,333,100,34618,32961,38768,3,23,13,0,0,1,0,9,310,79,28373,26731,27927,1,23,21,6245,11,6230,10841,2,0,2,0,5
EUN1_3573742659',1,25,3,1,0,0,0,11,0,356,67,22078,28029,23251,5,30,13,1,0,3,0,1,396,99,29805,31703,31298,0,-40,-32,-7727,-10,-3674,-8047,0,0,-3,0,10
EUN1_3573078696',2,28,8,1,0,0,0,6,0,384,90,25833,30296,34432,2,32,12,1,0,1,0,1,358,88,26784,29295,37000,1,26,2,-951,-4,1001,-2568,0,0,-1,0,5
EUN1_3573055460',4,21,6,1,0,0,0,7,1,365,82,24868,29335,27112,7,102,10,1,0,1,0,4,376,109,27038,32229,31650,1,-11,-27,-2170,-4,-2894,-4538,0,0,-1,0,3
EUN1_3573045282',3,36,12,0,0,0,0,11,0,346,86,26871,30600,33468,2,23,12,1,0,0,0,1,339,85,27146,30938,34080,1,7,1,-275,0,-338,-612,-1,0,0,0,10
EUN1_3567654284',5,28,10,1,0,3,0,3,1,391,126,30237,32211,32548,4,43,2,1,0,0,0,9,395,85,22774,28171,17712,1,-4,41,7463,8,4040,14836,0,0,3,0,-6
EUN1_3567634207',3,30,20,1,0,0,0,5,1,340,62,29287,28816,42270,6,30,15,1,0,0,0,2,321,94,28273,28987,33926,0,19,-32,1014,5,-171,8344,0,0,0,0,3
EUN1_3564285850',5,21,9,1,0,0,0,11,0,364,72,25954,30460,27966,6,30,6,1,0,1,0,2,349,112,25426,29315,29815,0,15,-40,528,3,1145,-1849,0,0,-1,0,9
EUN1_3564279330',2,28,13,0,0,0,0,5,1,351,86,27090,29796,34794,6,28,7,1,0,0,0,2,335,84,24393,28269,28875,0,16,2,2697,6,1527,5919,-1,0,0,0,3
EUN1_3564256844',4,18,14,0,0,0,0,6,1,316,116,28263,30450,32125,6,26,13,1,0,1,0,5,328,64,27093,29186,31654,0,-12,52,1170,1,1264,471,-1,0,-1,0,1
EUN1_3564253455',7,405,13,1,0,2,0,10,1,320,70,27960,30392,38148,3,24,12,1,0,1,0,6,343,100,29208,30620,30707,0,-23,-30,-1248,1,-228,7441,0,0,1,0,4
EUN1_3564233879',3,213,16,1,0,1,0,5,0,350,86,30018,28916,34448,4,24,9,1,0,1,0,7,331,90,25462,27926,25386,1,19,-4,4556,7,990,9062,0,0,0,0,-2
EUN1_3571043108',4,33,13,2,1,0,0,5,1,380,100,27956,30809,28766,3,96,7,0,0,0,0,4,372,96,25034,30209,30960,1,8,4,2922,6,600,-2194,2,1,0,0,1
EUN1_3560766891',2,27,14,0,0,0,0,5,1,357,83,28142,29507,33744,4,18,15,2,0,0,0,2,341,92,28138,31249,32867,0,16,-9,4,-1,-1742,877,-2,0,0,0,3
EUN1_3560763299',4,67,9,0,0,1,0,8,1,277,74,25194,25991,34384,4,73,22,1,0,1,0,4,351,84,30708,32606,42999,0,-74,-10,-5514,-13,-6615,-8615,-1,0,0,0,4
EUN1_3560737974',2,31,9,0,0,1,0,9,1,321,84,25464,28415,29179,6,29,8,2,0,1,0,5,324,91,25686,28634,29796,0,-3,-7,-222,1,-219,-617,-2,0,0,0,4
EUN1_3547956044',4,29,17,0,0,1,0,12,1,329,92,29096,29602,36346,5,30,13,2,0,1,0,7,318,102,28017,29492,31739,0,11,-10,1079,4,110,4607,-2,0,0,0,5
EUN1_3540639880',6,34,6,0,0,0,0,8,0,332,94,24287,27291,25726,1,26,12,2,0,0,0,5,316,105,27268,30188,33235,0,16,-11,-2981,-6,-2897,-7509,-2,0,0,0,3
EUN1_3534632936',5,36,5,1,0,1,0,11,1,352,111,25350,28611,26836,4,24,18,0,1,2,0,7,353,82,29921,32054,35164,0,-1,29,-4571,-13,-3443,-8328,1,-1,-1,0,4
EUW1_6882902180',5,28,10,1,0,0,0,10,0,356,87,25850,28553,23874,1,49,11,1,0,0,0,1,387,104,26817,30658,30816,1,-31,-17,-967,-1,-2105,-6942,0,0,0,0,9
EUW1_6882862572',4,25,11,0,0,2,0,6,0,358,78,27646,28365,34429,3,40,8,2,0,0,0,5,322,88,24286,26499,34887,1,36,-10,3360,3,1866,-458,-2,0,2,0,1
EUW1_6882797795',2,61,9,2,0,0,0,12,0,370,70,26462,26943,35246,1,57,23,0,0,2,0,7,359,104,33218,32713,36877,0,11,-34,-6756,-14,-5770,-1631,2,0,-2,0,5
EUW1_6882726305',1,20,9,2,1,1,0,4,1,373,106,27064,29000,32451,2,38,7,0,0,0,0,8,328,103,24092,28298,29025,1,45,3,2972,2,702,3426,2,1,1,0,-4
EUW1_6882697079',3,27,14,0,0,0,0,4,1,361,119,28076,33552,30194,6,27,6,0,0,0,0,2,340,66,23605,27152,26090,1,21,53,4471,8,6400,4104,0,0,0,0,2
EUW1_6882665502',3,22,13,0,0,0,0,9,1,369,104,28362,30770,35388,4,24,3,1,0,1,0,3,323,68,22801,25392,24893,1,46,36,5561,10,5378,10495,-1,0,-1,0,6
EUW1_6882567130',3,24,9,0,0,0,0,13,1,349,96,26904,28478,24963,5,26,6,2,1,2,0,6,361,116,26508,29413,30265,0,-12,-20,396,3,-935,-5302,-2,-1,-2,0,7
EUW1_6873872011',3,27,12,1,1,0,0,5,0,358,132,28957,31853,33733,2,24,11,1,0,1,0,8,338,80,25472,29814,34228,1,20,52,3485,1,2039,-495,0,1,-1,0,-3
EUW1_6873845135',5,38,11,0,0,1,0,5,1,338,100,27274,29576,30339,3,26,12,2,0,2,0,1,351,87,26864,30114,28384,0,-13,13,410,-1,-538,1955,-2,0,-1,0,4
EUW1_6873814994',6,76,8,0,0,0,0,12,0,332,92,25240,29189,24558,9,33,17,2,0,2,0,2,390,88,30826,31250,30341,0,-58,4,-5586,-9,-2061,-5783,-2,0,-2,0,10
EUW1_6873330693',6,28,13,1,0,0,0,7,1,360,83,27405,30301,29532,7,29,11,1,0,0,0,3,331,77,25327,28531,25322,1,29,6,2078,2,1770,4210,0,0,0,0,4
EUW1_6873149846',5,50,6,0,0,1,0,9,1,357,104,25037,28898,28763,3,24,8,0,0,0,0,4,361,75,25502,31169,25625,1,-4,29,-465,-2,-2271,3138,0,0,1,0,5
EUW1_6873082455',6,41,5,2,0,0,0,3,1,347,110,23894,29180,26006,3,100,5,0,0,0,0,3,324,94,23541,28811,13929,1,23,16,353,0,369,12077,2,0,0,0,0
EUW1_6873028398',2,27,17,0,1,2,0,5,1,355,104,31350,32984,32136,4,26,12,1,0,0,0,11,367,68,26933,29565,25266,1,-12,36,4417,5,3419,6870,-1,1,2,0,-6
EUW1_6872981519',2,21,10,2,1,1,0,7,0,366,83,26328,30375,26251,4,28,11,0,0,0,0,2,322,84,25280,28475,29131,1,44,-1,1048,-1,1900,-2880,2,1,1,0,5
EUW1_6871689242',7,33,13,1,0,0,0,6,0,317,83,26454,28864,30679,1,25,15,1,0,0,0,1,394,108,28554,31336,33058,0,-77,-25,-2100,-2,-2472,-2379,0,0,0,0,5
EUW1_6871586829',4,24,11,1,0,0,0,8,0,302,64,25324,27168,30304,6,29,21,0,0,0,0,2,350,93,30687,32493,36543,0,-48,-29,-5363,-10,-5325,-6239,1,0,0,0,6
EUW1_6871065835',6,30,8,1,0,1,0,6,1,349,101,27966,28058,23689,6,35,8,1,0,0,0,3,356,88,24461,28537,23070,1,-7,13,3505,0,-479,619,0,0,1,0,3
EUW1_6871051525',4,57,20,1,0,1,0,7,1,330,94,29428,33105,36322,5,170,9,1,0,1,0,4,326,58,24661,27113,30263,1,4,36,4767,11,5992,6059,0,0,0,0,3
EUN1_3576233876',4,27,8,0,0,0,0,15,0,315,86,24585,27558,28467,5,33,24,2,0,2,0,0,293,89,30136,30897,40001,0,22,-3,-5551,-16,-3339,-11534,-2,0,-2,0,15
EUN1_3575747646',3,124,11,1,0,0,0,14,0,329,102,25485,29407,31679,6,60,11,1,0,2,0,1,363,86,28557,29602,26140,0,-34,16,-3072,0,-195,5539,0,0,-2,0,13
EUN1_3575734827',4,57,9,0,0,0,0,7,0,342,114,26466,30111,36572,5,37,12,2,0,0,0,2,382,87,27533,30589,41103,0,-40,27,-1067,-3,-478,-4531,-2,0,0,0,5
EUN1_3575453255',6,33,12,2,1,2,0,8,0,401,106,28520,31822,22598,8,33,8,0,0,0,0,4,382,97,25414,29563,28786,1,19,9,3106,4,2259,-6188,2,1,2,0,4
EUN1_3575431292',2,30,16,1,0,1,0,7,0,370,108,29951,32748,32785,2,31,3,1,0,2,0,7,347,80,22268,26407,21822,1,23,28,7683,13,6341,10963,0,0,-1,0,0
EUN1_3575406198',6,47,17,1,0,0,0,6,1,345,76,30133,30290,33369,2,30,9,0,0,0,0,5,369,76,26275,28478,30370,1,-24,0,3858,8,1812,2999,1,0,0,0,1
EUN1_3575214674',6,32,14,1,0,0,0,8,0,381,80,27112,30466,35691,4,26,5,1,0,0,0,1,312,96,23359,28175,32016,1,69,-16,3753,9,2291,3675,0,0,0,0,7
EUN1_3575190487',6,27,17,0,0,2,0,6,1,340,88,31055,29526,33462,4,32,11,1,0,0,0,10,325,92,26527,27690,25228,1,15,-4,4528,6,1836,8234,-1,0,2,0,-4
EUN1_3575178465',4,29,14,0,0,0,0,10,0,369,81,27027,30274,36674,1,47,11,2,0,1,0,2,359,109,28228,29824,33769,0,10,-28,-1201,3,450,2905,-2,0,-1,0,8
EUN1_3575168562',3,23,16,1,0,1,0,9,1,377,82,29481,30931,30179,3,24,10,0,0,0,0,5,351,86,27029,29165,33765,1,26,-4,2452,6,1766,-3586,1,0,1,0,4
EUN1_3575151902',3,30,22,2,0,0,0,14,0,286,76,31161,27833,40382,7,57,21,0,0,1,0,1,324,73,31633,27324,47389,0,-38,3,-472,1,509,-7007,2,0,-1,0,13
EUN1_3575001657',1,16,9,0,0,0,0,16,0,282,63,23929,25400,25691,1,35,28,2,0,4,0,1,362,104,35138,32258,39783,0,-80,-41,-11209,-19,-6858,-14092,-2,0,-4,0,15
EUN1_3574739268',3,74,12,0,1,0,0,7,0,292,72,25613,26303,33578,3,59,20,1,0,0,0,0,323,82,28975,29045,30525,0,-31,-10,-3362,-8,-2742,3053,-1,1,0,0,7
EUN1_3574277096',5,32,15,1,1,0,0,6,0,349,92,28227,31463,37349,4,28,12,1,0,0,0,3,395,92,27899,30641,36089,1,-46,0,328,3,822,1260,0,1,0,0,3
EUN1_3574244644',3,29,12,1,0,2,0,9,1,356,80,27775,29802,33354,2,84,5,0,0,1,0,6,302,104,23744,27323,30845,0,54,-24,4031,7,2479,2509,1,0,1,0,3
EUN1_3574236220',4,22,13,1,1,1,0,7,1,302,111,27343,30366,27551,3,60,10,1,0,1,0,4,346,88,25424,29578,30274,1,-44,23,1919,3,788,-2723,0,1,0,0,3
EUN1_3574187862',4,34,7,2,1,0,0,8,1,347,94,24360,27266,20564,3,23,6,0,0,0,0,1,388,82,24786,27958,19289,0,-41,12,-426,1,-692,1275,2,1,0,0,7
EUN1_3574162062',4,59,8,0,0,1,0,8,0,328,85,25155,28649,23988,3,21,9,2,0,0,0,7,303,94,24116,26636,29044,1,25,-9,1039,-1,2013,-5056,-2,0,1,0,1
EUN1_3572030251',4,51,12,2,1,1,0,7,1,361,76,28127,29574,36118,5,28,14,0,0,1,0,6,356,71,28730,29894,35639,1,5,5,-603,-2,-320,479,2,1,0,0,1
EUN1_3572009311',3,159,6,0,0,0,0,13,1,315,92,24068,27037,22667,4,71,18,1,0,2,0,2,380,80,31034,32038,38934,0,-65,12,-6966,-12,-5001,-16267,-1,0,-2,0,11
EUN1_3575225410',3,32,7,2,0,1,0,6,1,359,94,25328,27584,26640,5,56,14,0,0,0,0,6,388,98,28157,31561,30667,0,-29,-4,-2829,-7,-3977,-4027,2,0,1,0,0
EUN1_3575207181',6,276,9,1,0,0,0,11,1,353,88,24560,28848,25908,4,29,7,1,0,1,0,1,343,100,26303,28331,28484,1,10,-12,-1743,2,517,-2576,0,0,-1,0,10
EUN1_3575188635',1,24,6,0,0,1,0,7,0,374,75,24802,28615,23309,4,25,9,1,0,0,0,4,365,76,25342,29520,24750,1,9,-1,-540,-3,-905,-1441,-1,0,1,0,3
EUN1_3574649754',5,34,13,1,0,2,0,13,1,334,77,29274,28664,30664,4,24,15,1,0,1,0,3,329,80,28425,27124,34167,0,5,-3,849,-2,1540,-3503,0,0,1,0,10
EUN1_3574255352',4,46,9,1,0,1,0,12,0,366,92,26149,29142,33027,2,19,12,1,0,2,0,1,371,110,30156,31131,27647,1,-5,-18,-4007,-3,-1989,5380,0,0,-1,0,11
EUN1_3574235688',5,33,8,2,0,1,0,9,0,389,81,26650,29538,22335,4,36,10,0,0,1,0,3,366,106,27071,29889,20971,1,23,-25,-421,-2,-351,1364,2,0,0,0,6
EUN1_3574221668',6,28,14,0,0,3,0,14,1,349,81,30098,30811,37863,4,26,18,2,0,0,0,7,345,82,29692,31430,31941,0,4,-1,406,-4,-619,5922,-2,0,3,0,7
EUN1_3574175473',2,28,16,1,0,1,0,7,1,342,90,29068,30542,39475,3,29,12,0,0,0,0,3,336,84,27139,28976,32774,1,6,6,1929,4,1566,6701,1,0,1,0,4
EUN1_3574165456',4,26,20,2,1,2,0,5,1,370,114,32839,33535,38013,3,26,9,0,0,1,0,6,303,82,25020,27350,29981,1,67,32,7819,11,6185,8032,2,1,1,0,-1
EUN1_3574153439',3,25,14,1,0,2,0,10,1,334,104,29340,30884,32817,4,32,16,1,0,1,0,8,354,68,28755,29458,41189,1,-20,36,585,-2,1426,-8372,0,0,1,0,2
EUN1_3573936002',1,25,9,0,1,0,0,10,0,341,102,25378,29155,31936,5,30,14,2,0,0,0,1,363,74,27305,31629,30165,0,-22,28,-1927,-5,-2474,1771,-2,1,0,0,9
EUN1_3573670228',6,30,13,1,1,1,0,7,1,325,92,27638,29423,38236,1,29,8,1,0,1,0,9,363,76,25878,27873,31152,1,-38,16,1760,5,1550,7084,0,1,0,0,-2
EUN1_3575866170',2,99,16,1,0,0,0,14,0,340,67,27686,29341,33747,5,36,9,0,0,2,0,0,377,87,27881,28689,34413,1,-37,-20,-195,7,652,-666,1,0,-2,0,14
EUN1_3575845866',1,28,7,0,0,0,0,10,1,311,91,23961,27645,24315,3,29,21,2,0,3,0,2,372,100,33294,32261,43806,0,-61,-9,-9333,-14,-4616,-19491,-2,0,-3,0,8
EUN1_3573709948',2,75,18,1,0,1,0,8,1,353,110,29499,32105,31717,2,16,8,1,0,0,0,7,346,90,24474,26764,26386,1,7,20,5025,10,5341,5331,0,0,1,0,1
EUN1_3573397257',4,26,13,1,0,0,0,3,1,349,106,26957,28843,29920,3,20,14,1,0,0,0,2,357,98,28736,30769,27310,0,-8,8,-1779,-1,-1926,2610,0,0,0,0,1
EUN1_3573372223',4,29,10,0,0,0,0,12,1,379,96,26375,30472,30951,10,159,14,2,0,1,0,2,366,72,28655,30059,33502,1,13,24,-2280,-4,413,-2551,-2,0,-1,0,10
EUN1_3573337339',4,21,15,1,0,1,0,10,1,343,68,28804,28954,34573,4,29,11,1,0,0,0,6,318,84,26503,28824,34127,1,25,-16,2301,4,130,446,0,0,1,0,4
EUN1_3573284518',4,29,10,0,0,1,0,7,0,385,88,27902,29743,29600,2,54,14,1,0,0,0,7,349,87,28011,28932,29443,1,36,1,-109,-4,811,157,-1,0,1,0,0
EUN1_3573271232',1,21,24,1,0,3,0,4,1,355,103,33803,32374,42523,2,22,11,0,0,1,0,12,310,64,25330,26416,32984,1,45,39,8473,13,5958,9539,1,0,2,0,-8
EUN1_3573243087',5,28,15,1,0,0,0,6,1,318,80,27150,27604,34484,2,138,12,0,0,1,0,2,367,95,28815,30081,36403,1,-49,-15,-1665,3,-2477,-1919,1,0,-1,0,4
EUN1_3575915254',3,25,14,0,0,2,0,11,1,386,88,29533,31015,33685,6,28,13,1,0,0,0,4,287,114,25895,29640,35132,0,99,-26,3638,1,1375,-1447,-1,0,2,0,7
EUN1_3575876559',3,24,10,0,1,0,0,8,0,354,114,28131,29576,26868,0,92,10,1,0,2,0,6,329,94,25552,28153,27023,1,25,20,2579,0,1423,-155,-1,1,-2,0,2
EUN1_3575537428',3,26,10,1,0,0,0,6,1,388,123,26755,31912,26792,5,27,5,1,0,0,0,4,382,71,23273,28515,24152,0,6,52,3482,5,3397,2640,0,0,0,0,2
EUN1_3575501292',4,27,12,0,1,2,0,7,0,374,125,30217,31948,35293,3,21,7,1,0,1,0,7,273,70,22086,23556,23536,1,101,55,8131,5,8392,11757,-1,1,1,0,0
EUN1_3574918835',3,65,19,1,0,1,0,9,1,377,132,33152,34071,34428,6,28,17,1,0,0,0,8,364,79,29494,29337,31226,1,13,53,3658,2,4734,3202,0,0,1,0,1
EUN1_3574897708',1,19,12,2,0,0,0,11,1,396,122,28991,33007,25858,3,21,7,0,0,1,0,2,336,88,24466,27549,26890,0,60,34,4525,5,5458,-1032,2,0,-1,0,9
EUN1_3574882127',3,38,11,0,0,1,0,17,0,322,80,26478,27950,30797,3,26,22,1,0,3,0,1,366,92,33115,33381,40602,0,-44,-12,-6637,-11,-5431,-9805,-1,0,-2,0,16
EUN1_3574798334',4,24,12,1,1,0,0,10,0,338,88,27126,28438,33192,4,147,18,0,0,1,0,4,309,90,29644,29468,37105,0,29,-2,-2518,-6,-1030,-3913,1,1,-1,0,6
EUN1_3574768809',4,22,18,0,0,0,0,6,1,361,116,29836,31326,36791,1,31,18,1,0,0,0,3,366,84,30066,32778,36411,1,-5,32,-230,0,-1452,380,-1,0,0,0,3
EUN1_3574463846',5,28,19,0,0,0,0,16,1,309,90,29069,29087,31450,3,34,9,1,0,1,0,3,367,105,28231,29230,34304,0,-58,-15,838,10,-143,-2854,-1,0,-1,0,13
EUN1_3574405548',0,30,19,2,0,1,0,6,1,322,103,29594,32074,37488,2,36,13,0,0,0,0,4,322,90,26801,29051,35747,1,0,13,2793,6,3023,1741,2,0,1,0,2
EUN1_3574361991',2,21,27,0,0,2,0,11,1,326,106,33978,34269,44139,1,50,10,1,0,1,0,6,319,62,26984,26648,38525,1,7,44,6994,17,7621,5614,-1,0,1,0,5
EUN1_3574344326',2,20,17,1,0,0,0,7,0,301,84,28069,28609,39344,4,22,23,1,0,1,0,1,320,76,30940,29815,43547,0,-19,8,-2871,-6,-1206,-4203,0,0,-1,0,6
EUN1_3574319639',5,26,12,1,0,0,0,7,0,303,132,26042,30255,34401,5,33,10,1,0,0,0,2,369,80,26586,28972,31956,1,-66,52,-544,2,1283,2445,0,0,0,0,5
EUN1_3574269831',5,30,16,1,1,0,0,8,0,318,99,27732,29996,33945,3,321,13,1,0,0,0,2,338,72,26744,28350,34268,1,-20,27,988,3,1646,-323,0,1,0,0,6
EUN1_3574255134',9,33,10,2,0,1,0,8,0,322,84,26905,26828,26412,5,109,10,0,0,1,0,5,354,74,26351,27734,27461,1,-32,10,554,0,-906,-1049,2,0,0,0,3
EUN1_3574227900',3,26,11,0,0,0,0,12,0,353,84,26860,28953,30364,4,27,16,1,0,2,0,2,379,90,30531,32155,30146,0,-26,-6,-3671,-5,-3202,218,-1,0,-2,0,10
EUN1_3574212772',2,24,17,1,0,0,0,14,1,316,68,28911,29197,40363,1,25,17,1,0,1,0,2,352,95,30188,30945,43894,1,-36,-27,-1277,0,-1748,-3531,0,0,-1,0,12
EUN1_3574199182',1,21,5,1,0,0,0,9,1,304,66,21466,25676,28911,0,28,11,1,0,0,0,0,356,79,24933,29399,37360,0,-52,-13,-3467,-6,-3723,-8449,0,0,0,0,9
EUN1_3573966376',3,133,10,0,0,1,0,4,1,353,100,26862,31216,32395,2,19,11,2,0,0,0,4,366,112,26781,32267,26293,0,-13,-12,81,-1,-1051,6102,-2,0,1,0,0
EUN1_3573933839',0,94,12,0,0,0,0,8,0,381,82,27418,29817,28048,5,24,12,2,0,1,0,2,392,106,28643,31135,27651,0,-11,-24,-1225,0,-1318,397,-2,0,-1,0,6
EUN1_3568040565',6,28,17,2,0,1,0,11,0,405,102,31107,33000,33097,3,27,11,0,0,1,0,6,369,102,29470,29284,29689,1,36,0,1637,6,3716,3408,2,0,0,0,5
EUN1_3568003082',3,27,11,2,0,0,0,7,1,361,91,27491,30413,34704,4,30,20,0,0,0,0,6,356,80,31567,30829,40506,0,5,11,-4076,-9,-416,-5802,2,0,0,0,1
EUN1_3567985661',4,62,24,2,0,2,0,8,1,371,93,33901,33911,49327,3,60,11,0,0,0,0,11,324,66,26749,27196,33888,1,47,27,7152,13,6715,15439,2,0,2,0,-3
EUN1_3567869103',4,34,7,0,0,0,0,9,0,335,89,24839,27663,36250,3,28,9,2,0,0,0,1,349,74,25809,28262,30817,0,-14,15,-970,-2,-599,5433,-2,0,0,0,8
EUN1_3567652428',3,26,15,1,0,0,0,4,1,385,92,29043,31705,31003,2,26,9,1,0,1,0,4,358,100,24914,29196,22457,1,27,-8,4129,6,2509,8546,0,0,-1,0,0
EUN1_3567636352',4,25,22,1,1,0,0,8,1,358,76,33528,30945,43775,6,343,18,0,0,1,0,5,344,76,28991,30153,42263,1,14,0,4537,4,792,1512,1,1,-1,0,3
EUN1_3567615740',5,22,18,1,0,1,0,8,0,355,74,31087,31733,48075,4,21,19,0,0,0,0,2,332,74,30682,30932,38294,1,23,0,405,-1,801,9781,1,0,1,0,6
EUN1_3567604607',7,29,22,1,0,2,0,9,1,341,98,32057,31506,48892,1,26,13,0,0,0,0,9,334,74,28065,30847,35295,0,7,24,3992,9,659,13597,1,0,2,0,0
EUN1_3567596273',0,13,11,0,0,0,0,10,1,350,78,27326,29012,30226,0,18,18,2,0,1,0,5,345,104,30412,31146,35835,0,5,-26,-3086,-7,-2134,-5609,-2,0,-1,0,5
EUN1_3566296301',2,29,19,0,0,2,0,4,0,353,80,31305,30655,34341,4,25,8,2,0,0,0,9,348,84,25177,27367,22353,1,5,-4,6128,11,3288,11988,-2,0,2,0,-5
EUN1_3566273691',1,20,10,0,0,0,0,13,0,367,72,25650,29152,27632,1,20,22,1,0,2,0,0,382,116,33826,34487,37287,0,-15,-44,-8176,-12,-5335,-9655,-1,0,-2,0,13
EUN1_3566042700',5,22,14,0,0,3,0,9,0,359,76,29887,30290,39013,3,22,12,2,0,0,0,7,323,112,27859,29572,32076,1,36,-36,2028,2,718,6937,-2,0,3,0,2
EUN1_3565963644',1,38,15,2,0,2,0,7,0,362,106,29710,32145,38163,5,23,13,0,0,0,0,5,348,104,27481,30327,29727,1,14,2,2229,2,1818,8436,2,0,2,0,2
EUN1_3565942803',8,25,9,0,0,0,0,13,0,344,85,25314,28469,23918,0,25,14,2,0,2,0,1,375,106,29594,32263,36511,0,-31,-21,-4280,-5,-3794,-12593,-2,0,-2,0,12
EUN1_3565701496',4,20,14,1,0,2,0,11,0,364,100,30451,31343,35480,0,22,10,1,0,1,0,2,357,75,27962,28702,33314,0,7,25,2489,4,2641,2166,0,0,1,0,9
EUN1_3565690126',4,28,11,1,1,0,0,7,1,367,96,28684,29609,27243,4,62,14,0,0,2,0,5,352,80,28742,30308,35139,1,15,16,-58,-3,-699,-7896,1,1,-2,0,2
EUN1_3564712569',1,24,11,0,0,1,0,9,1,312,82,26659,26530,27985,3,29,17,2,0,1,0,5,325,102,28795,29354,34541,1,-13,-20,-2136,-6,-2824,-6556,-2,0,0,0,4
EUN1_3576146160',3,29,18,1,1,1,0,4,1,345,96,30093,29231,35842,5,74,8,1,0,0,0,7,296,66,24140,25623,29660,1,49,30,5953,10,3608,6182,0,1,1,0,-3
EUN1_3576124580',3,66,13,2,0,1,0,9,1,401,78,29236,30658,35626,5,46,8,0,0,1,0,4,356,92,25249,29309,28603,1,45,-14,3987,5,1349,7023,2,0,0,0,5
EUN1_3575549881',8,27,19,0,0,0,0,6,1,365,62,29931,32299,36455,3,24,7,2,0,1,0,4,329,80,24277,27681,27862,1,36,-18,5654,12,4618,8593,-2,0,-1,0,2
EUN1_3575470658',3,22,13,0,0,0,0,10,1,357,82,28424,31103,35386,5,23,13,2,0,1,0,1,345,68,27980,29727,34882,0,12,14,444,0,1376,504,-2,0,-1,0,9
EUN1_3575445452',8,60,10,0,0,0,0,7,1,346,78,26073,28660,28761,5,37,10,2,0,1,0,4,341,92,26364,30085,38301,0,5,-14,-291,0,-1425,-9540,-2,0,-1,0,3
EUN1_3575015909',1,38,12,1,0,0,0,11,1,350,80,26487,29815,25009,4,26,10,0,0,1,0,0,421,108,28375,31096,30037,0,-71,-28,-1888,2,-1281,-5028,1,0,-1,0,11
EUN1_3574903604',7,25,19,2,0,0,0,6,1,327,85,29410,30238,38758,4,19,15,0,1,0,0,6,294,90,27323,28081,35468,1,33,-5,2087,4,2157,3290,2,-1,0,0,0
EUN1_3574887188',7,27,14,1,0,0,0,3,1,358,81,28262,29320,31026,9,31,11,1,0,0,0,2,321,94,25696,28646,29618,1,37,-13,2566,3,674,1408,0,0,0,0,1
EUN1_3574771127',3,26,12,1,0,1,0,7,1,367,104,28527,30981,31969,6,24,11,1,0,0,0,6,367,88,27014,29464,24799,0,0,16,1513,1,1517,7170,0,0,1,0,1
EUN1_3574743256',1,39,12,1,1,0,0,12,1,350,117,28206,31518,30830,5,23,5,1,0,0,0,7,368,78,24543,27254,28161,1,-18,39,3663,7,4264,2669,0,1,0,0,5
EUN1_3574720549',5,65,12,1,0,0,0,7,1,313,76,25314,27912,32830,4,19,15,0,0,1,0,8,357,88,28661,31978,33740,0,-44,-12,-3347,-3,-4066,-910,1,0,-1,0,-1
EUN1_3574702441',1,23,10,2,0,0,0,8,0,362,81,25451,28458,28903,8,43,11,0,1,1,0,4,341,94,27217,30325,33173,0,21,-13,-1766,-1,-1867,-4270,2,-1,-1,0,4
EUN1_3574474135',3,26,20,2,0,2,0,6,0,330,84,31760,31766,35259,5,23,15,0,0,0,0,10,309,84,27507,27029,34298,1,21,0,4253,5,4737,961,2,0,2,0,-4
EUN1_3574433781',3,22,13,2,0,1,0,6,1,335,100,29514,29856,34106,3,26,8,0,1,1,0,7,361,76,24924,27371,26348,1,-26,24,4590,5,2485,7758,2,-1,0,0,-1
EUN1_3574416221',4,25,13,0,0,1,0,13,1,379,84,29371,30244,29557,5,114,12,2,0,1,0,4,342,72,26307,28719,30356,0,37,12,3064,1,1525,-799,-2,0,0,0,9
EUN1_3574362701',2,22,19,1,0,0,0,7,0,354,82,29473,31009,42505,8,28,10,1,0,0,0,1,363,74,26496,27757,24206,1,-9,8,2977,9,3252,18299,0,0,0,0,6
EUN1_3574350112',3,24,9,0,0,0,0,8,0,372,92,26465,27465,26343,3,24,19,1,0,0,0,5,366,100,28824,32691,38450,0,6,-8,-2359,-10,-5226,-12107,-1,0,0,0,3
EUN1_3574092011',4,64,7,0,0,0,0,5,0,369,76,24729,27872,24928,4,28,7,2,0,0,0,2,381,92,25038,29211,24884,1,-12,-16,-309,0,-1339,44,-2,0,0,0,3
EUN1_3574086786',2,23,6,0,0,0,0,7,0,374,92,23724,28502,28804,5,40,12,2,0,1,0,2,357,96,27529,29652,30743,0,17,-4,-3805,-6,-1150,-1939,-2,0,-1,0,5
EUN1_3574084570',3,31,6,1,0,1,0,8,1,371,104,25266,29454,30125,2,25,10,0,0,0,0,3,340,84,25364,29836,24221,1,31,20,-98,-4,-382,5904,1,0,1,0,5
EUN1_3574073594',3,24,12,1,0,1,0,7,0,374,88,28021,29660,32084,5,25,10,1,0,0,0,6,335,96,26563,27501,29731,0,39,-8,1458,2,2159,2353,0,0,1,0,1
EUN1_3574080096',2,25,16,1,0,0,0,5,1,339,100,29037,29013,31283,3,20,19,1,0,0,0,1,325,76,29644,29505,39486,0,14,24,-607,-3,-492,-8203,0,0,0,0,4
EUN1_3574071658',1,22,14,1,0,0,0,11,1,338,96,28836,29620,29476,2,20,17,1,1,2,0,3,331,80,30531,32215,38855,0,7,16,-1695,-3,-2595,-9379,0,-1,-2,0,8
EUN1_3574051574',7,32,9,0,0,0,0,10,0,348,74,25700,27364,27841,5,29,20,1,1,1,0,2,324,94,30566,31926,39445,0,24,-20,-4866,-11,-4562,-11604,-1,-1,-1,0,8
EUN1_3574041788',6,30,8,1,0,0,0,9,1,372,74,25806,29530,23623,6,29,9,0,0,0,0,2,391,102,26695,30106,26221,1,-19,-28,-889,-1,-576,-2598,1,0,0,0,7
EUN1_3574035320',4,26,21,0,0,0,0,4,0,311,73,29974,30582,38370,1,23,14,1,0,0,0,6,322,98,28152,29372,39262,1,-11,-25,1822,7,1210,-892,-1,0,0,0,-2
EUN1_3574022547',4,47,14,2,0,2,0,9,1,352,107,29636,28994,32165,3,23,10,0,0,2,0,9,308,80,26182,27633,29320,1,44,27,3454,4,1361,2845,2,0,0,0,0
EUN1_3574005440',2,22,13,1,0,0,0,11,1,375,74,27867,30533,32588,2,25,8,1,0,2,0,3,377,90,26229,27918,31076,1,-2,-16,1638,5,2615,1512,0,0,-2,0,8
EUN1_3573899880',6,28,18,1,0,0,0,10,0,296,80,29247,28111,37376,1,55,18,1,0,1,0,2,363,100,31236,30458,41751,1,-67,-20,-1989,0,-2347,-4375,0,0,-1,0,8
EUN1_3573876950',1,21,9,0,1,0,0,4,1,345,80,25354,28513,23997,3,25,15,2,0,1,0,0,381,112,29137,31622,35708,0,-36,-32,-3783,-6,-3109,-11711,-2,1,-1,0,4
EUN1_3573068260',3,21,13,0,0,0,0,5,1,309,78,26289,26571,37386,1,20,18,1,0,0,0,2,309,93,27578,31906,34062,1,0,-15,-1289,-5,-5335,3324,-1,0,0,0,3
EUN1_3573049812',0,140,15,1,1,0,0,8,1,335,60,26555,30667,31447,7,27,6,1,0,0,0,1,389,84,24151,29192,23889,1,-54,-24,2404,9,1475,7558,0,1,0,0,7
EUN1_3572752189',2,24,7,1,0,0,0,9,0,298,84,22715,24773,21621,4,44,10,1,0,1,0,3,319,88,25000,28118,24357,0,-21,-4,-2285,-3,-3345,-2736,0,0,-1,0,6
EUN1_3572725151',2,17,13,1,0,0,0,9,1,355,84,27143,28628,33954,4,32,13,1,0,1,0,3,372,92,28044,32673,41906,0,-17,-8,-901,0,-4045,-7952,0,0,-1,0,6
EUN1_3572581504',2,22,12,2,0,1,0,4,1,361,102,27973,32206,37198,0,20,12,0,0,0,0,7,356,82,27912,29809,29273,1,5,20,61,0,2397,7925,2,0,1,0,-3
EUN1_3572520716',4,28,12,1,0,0,0,8,0,310,83,26410,27175,28223,5,28,16,1,0,1,0,0,329,89,28854,29019,30875,0,-19,-6,-2444,-4,-1844,-2652,0,0,-1,0,8
EUN1_3572514194',6,27,11,1,0,0,0,11,0,317,96,26722,28889,34724,3,29,9,1,0,1,0,6,354,88,26485,28954,25762,0,-37,8,237,2,-65,8962,0,0,-1,0,5
EUN1_3572503207',4,28,19,0,0,2,0,6,0,356,72,30836,28748,36587,0,26,15,1,0,0,0,7,301,80,26908,27795,36091,1,55,-8,3928,4,953,496,-1,0,2,0,-1
EUN1_3572489341',4,326,9,1,0,1,0,10,1,341,94,25723,28675,39852,0,29,13,1,0,1,0,6,393,90,30470,31244,48446,0,-52,4,-4747,-4,-2569,-8594,0,0,0,0,4
EUN1_3572471555',4,27,11,2,1,0,0,11,1,347,88,26458,31017,34831,2,22,12,0,0,1,0,2,326,88,27732,30554,31038,1,21,0,-1274,-1,463,3793,2,1,-1,0,9
EUN1_3572201361',2,25,2,1,0,0,0,16,0,272,84,20656,24295,21939,3,28,24,1,1,7,1,1,389,128,36991,33945,40005,0,-117,-44,-16335,-22,-9650,-18066,0,-1,-7,-1,15
EUN1_3572157663',4,37,15,1,0,0,0,5,0,370,55,28273,30685,34598,6,32,5,0,0,1,0,5,352,74,22727,27474,22602,1,18,-19,5546,10,3211,11996,1,0,-1,0,0
EUN1_3572088966',5,31,16,0,0,0,0,8,1,346,58,29277,29376,28226,5,29,15,2,0,1,0,1,419,108,30161,31315,36980,1,-73,-50,-884,1,-1939,-8754,-2,0,-1,0,7
EUN1_3571997784',3,27,16,0,0,0,0,6,1,354,80,27507,29061,35556,6,27,13,2,0,1,0,9,316,92,28104,29122,33816,1,38,-12,-597,3,-61,1740,-2,0,-1,0,-3
EUN1_3571958935',2,25,13,1,0,0,0,9,0,344,76,28343,27776,31473,4,17,12,1,1,1,0,5,314,88,27633,28658,31487,1,30,-12,710,1,-882,-14,0,-1,-1,0,4
EUN1_3571371803',4,79,6,2,0,0,0,10,0,347,94,24680,27721,28201,3,22,11,0,0,0,0,0,343,66,25815,28752,32801,0,4,28,-1135,-5,-1031,-4600,2,0,0,0,10
EUN1_3571360845',4,22,14,1,0,3,0,2,0,416,108,32790,33023,27826,5,21,3,0,0,0,0,11,306,66,22296,27139,22045,1,110,42,10494,11,5884,5781,1,0,3,0,-9
EUN1_3571034553',1,31,11,1,0,0,0,6,1,384,114,26657,31246,28190,2,24,9,1,0,1,0,2,351,85,24564,29852,22342,1,33,29,2093,2,1394,5848,0,0,-1,0,4
EUN1_3569722955',5,33,15,1,0,1,0,6,0,354,98,28790,31949,35453,3,17,12,1,0,0,0,6,314,78,25971,29130,36586,1,40,20,2819,3,2819,-1133,0,0,1,0,0
EUN1_3575689762',2,30,10,1,0,0,0,9,0,288,90,23794,27571,28669,4,23,14,1,0,1,0,3,269,54,25716,27577,28307,1,19,36,-1922,-4,-6,362,0,0,-1,0,6
EUN1_3575686604',1,23,19,1,0,0,0,5,1,270,82,27558,27683,36391,3,22,12,0,0,0,0,3,275,80,25063,27338,30718,1,-5,2,2495,7,345,5673,1,0,0,0,2
EUN1_3575691199',4,21,10,1,0,0,0,8,0,268,69,25202,27568,26911,1,27,16,0,0,1,0,5,307,88,26563,30037,31602,0,-39,-19,-1361,-6,-2469,-4691,1,0,-1,0,3
EUN1_3575677002',1,29,8,1,1,0,0,9,1,246,74,21846,26573,20634,0,26,6,0,0,0,0,2,299,64,22092,26893,22542,0,-53,10,-246,2,-320,-1908,1,1,0,0,7
EUN1_3572953601',2,344,8,1,0,1,0,8,0,267,45,23017,25710,25397,4,23,15,0,0,1,0,5,282,86,26933,27006,33562,0,-15,-41,-3916,-7,-1296,-8165,1,0,0,0,3
EUN1_3572948060',2,64,6,0,0,0,0,5,1,280,62,22490,26640,29232,2,24,9,2,1,1,0,3,302,58,24284,27105,27326,0,-22,4,-1794,-3,-465,1906,-2,-1,-1,0,2
EUN1_3572944514',0,264,23,1,0,2,0,7,0,254,68,30324,27819,35447,1,32,17,1,0,0,0,7,232,79,27664,26374,34546,0,22,-11,2660,6,1445,901,0,0,2,0,0
EUN1_3572935850',1,31,23,0,0,0,0,8,0,238,48,28774,26379,38484,3,34,20,1,0,2,0,6,250,36,28013,26131,33593,0,-12,12,761,3,248,4891,-1,0,-2,0,2
EUN1_3572387663',1,37,19,0,0,2,0,9,0,288,68,28680,27758,36165,0,28,16,2,0,0,0,2,228,68,24285,25442,31782,1,60,0,4395,3,2316,4383,-2,0,2,0,7
EUN1_3568549424',4,336,12,2,0,3,0,10,0,274,88,28041,28872,29658,3,25,19,0,0,0,0,8,248,78,26384,27569,32833,1,26,10,1657,-7,1303,-3175,2,0,3,0,2
EUN1_3568358064',2,24,17,2,0,0,0,10,1,284,68,27603,28107,35522,4,40,18,0,0,1,0,1,286,76,29010,29025,32527,1,-2,-8,-1407,-1,-918,2995,2,0,-1,0,9
EUN1_3568356072',4,29,16,0,0,0,0,10,1,267,58,26997,25872,32969,3,22,17,1,0,3,0,4,332,86,30772,29930,34845,0,-65,-28,-3775,-1,-4058,-1876,-1,0,-3,0,6
EUN1_3568130000',1,37,10,0,0,0,0,6,0,273,62,24049,27809,28160,3,30,20,2,0,0,0,2,283,98,29364,31362,34627,0,-10,-36,-5315,-10,-3553,-6467,-2,0,0,0,4
EUN1_3575116541',3,40,16,1,0,1,0,7,0,388,83,29289,33178,29939,4,26,9,0,0,0,0,5,343,72,26270,29316,22739,1,45,11,3019,7,3862,7200,1,0,1,0,2
EUN1_3575017645',0,20,18,1,0,0,0,7,1,347,64,27709,28426,36800,0,45,12,1,0,1,0,5,291,96,27281,28385,31224,1,56,-32,428,6,41,5576,0,0,-1,0,2
EUN1_3574842671',1,37,17,1,0,0,0,5,1,300,92,27310,30603,31842,2,25,15,0,0,0,0,3,298,76,27394,30136,32144,1,2,16,-84,2,467,-302,1,0,0,0,2
EUN1_3574805215',2,25,13,2,0,0,0,6,1,338,76,26803,29422,30130,3,33,9,0,0,1,0,4,311,80,25228,28332,28167,1,27,-4,1575,4,1090,1963,2,0,-1,0,2
EUN1_3574769939',2,21,16,2,0,0,0,15,0,290,100,28305,29253,36064,2,26,16,0,0,2,0,5,333,78,29921,29316,44624,1,-43,22,-1616,0,-63,-8560,2,0,-2,0,10
EUN1_3568354910',1,23,14,0,0,0,0,5,1,317,74,27331,28688,33472,4,43,17,2,0,0,0,0,302,114,27426,29156,31056,1,15,-40,-95,-3,-468,2416,-2,0,0,0,5
EUN1_3567681725',2,127,10,1,0,0,0,5,0,358,88,26262,29455,33531,3,24,13,1,0,0,0,1,320,96,26544,29832,34813,0,38,-8,-282,-3,-377,-1282,0,0,0,0,4
EUN1_3567660983',3,24,8,0,0,0,0,10,0,338,88,25011,28336,26575,2,23,13,2,0,0,0,4,311,80,26386,29569,33837,1,27,8,-1375,-5,-1233,-7262,-2,0,0,0,6
EUN1_3566465523',2,12,12,0,0,1,0,11,0,318,78,29073,27897,33684,4,26,21,2,1,1,0,7,300,80,30203,29920,33891,1,18,-2,-1130,-9,-2023,-207,-2,-1,0,0,4
EUN1_3566462113',3,37,17,1,0,0,0,4,1,280,94,27728,28023,38456,1,41,16,0,0,0,0,3,285,69,27730,27680,39231,0,-5,25,-2,1,343,-775,1,0,0,0,1
EUN1_3565970611',3,25,12,1,0,0,0,5,0,308,90,25527,28717,27966,3,27,14,1,0,0,0,4,296,82,26145,29683,31908,0,12,8,-618,-2,-966,-3942,0,0,0,0,1
EUN1_3565514668',4,224,14,2,0,1,0,7,0,367,98,29034,30977,29699,5,31,7,0,0,1,0,4,317,86,24331,26469,23025,1,50,12,4703,7,4508,6674,2,0,0,0,3
EUN1_3565084823',4,21,13,0,0,0,0,8,0,323,84,28424,28863,35931,1,24,18,1,0,1,0,5,278,63,25889,27805,36849,0,45,21,2535,-5,1058,-918,-1,0,-1,0,3
EUN1_3565081215',3,30,19,0,1,0,0,6,1,330,84,30544,30050,40111,1,22,15,2,0,1,0,4,309,92,28628,28100,39923,0,21,-8,1916,4,1950,188,-2,1,-1,0,2
EUN1_3565040827',1,140,8,0,0,0,0,11,0,340,92,25529,28589,25341,3,24,18,2,0,1,0,2,357,76,29704,30253,32846,0,-17,16,-4175,-10,-1664,-7505,-2,0,-1,0,9
EUN1_3564642156',1,28,15,1,0,0,0,10,0,315,64,26972,27891,32183,7,33,17,0,0,0,0,1,301,84,28214,28519,39729,1,14,-20,-1242,-2,-628,-7546,1,0,0,0,9
EUN1_3573221387',6,30,17,1,0,1,0,15,0,379,68,31750,30334,41864,5,25,23,0,0,1,0,5,356,92,31781,30045,45309,1,23,-24,-31,-6,289,-3445,1,0,0,0,10
EUN1_3569534746',2,26,24,2,0,3,0,3,1,338,78,33060,30972,52237,1,27,11,0,0,0,0,8,288,82,26269,26736,37738,1,50,-4,6791,13,4236,14499,2,0,3,0,-5
EUN1_3569493878',0,23,10,0,0,0,0,10,1,321,74,25455,28589,31177,1,19,15,2,0,0,0,2,417,102,29041,31998,30940,0,-96,-28,-3586,-5,-3409,237,-2,0,0,0,8
EUN1_3567990214',4,36,16,1,0,1,0,11,0,327,90,29752,29204,32855,2,29,19,1,0,1,0,2,309,78,30179,29440,38081,1,18,12,-427,-3,-236,-5226,0,0,0,0,9
EUN1_3567977608',0,29,4,0,0,0,0,6,0,292,102,22370,28166,25963,4,23,16,2,0,1,0,1,396,94,29193,31882,30072,0,-104,8,-6823,-12,-3716,-4109,-2,0,-1,0,5
EUN1_3567969887',4,28,18,0,0,0,0,18,0,255,89,29328,27689,34627,2,33,28,1,0,3,0,2,355,82,37553,31796,48653,0,-100,7,-8225,-10,-4107,-14026,-1,0,-3,0,16
EUN1_3566741578',2,25,11,1,0,0,0,11,1,354,70,26600,29532,27552,6,26,10,0,0,1,0,3,381,96,28313,29795,30583,1,-27,-26,-1713,1,-263,-3031,1,0,-1,0,8
EUN1_3566724284',3,26,12,1,0,1,0,10,0,364,62,28237,29794,33137,5,266,8,0,0,0,0,2,363,110,26632,30407,35692,1,1,-48,1605,4,-613,-2555,1,0,1,0,8
EUN1_3566693914',3,27,20,1,0,1,0,10,0,301,106,32015,30625,36118,4,39,14,0,0,1,0,4,332,86,27075,28969,39992,1,-31,20,4940,6,1656,-3874,1,0,0,0,6
EUN1_3566394420',3,144,10,1,0,0,0,15,0,345,83,26603,30064,29486,3,30,19,1,0,1,0,1,346,112,31161,33794,40826,1,-1,-29,-4558,-9,-3730,-11340,0,0,-1,0,14
EUN1_3565497266',3,21,15,0,0,1,0,10,0,379,100,29922,31050,31620,2,96,10,1,0,1,0,3,340,89,26342,29547,25095,1,39,11,3580,5,1503,6525,-1,0,0,0,7
EUN1_3576031904',4,33,7,1,0,0,0,9,0,335,92,23648,28840,25410,4,42,14,1,0,0,0,2,363,86,27288,30077,28508,0,-28,6,-3640,-7,-1237,-3098,0,0,0,0,7
EUN1_3575445120',5,27,23,1,0,1,0,11,1,341,96,30856,32038,37983,1,224,11,0,0,1,0,8,289,76,26952,29613,32235,1,52,20,3904,12,2425,5748,1,0,0,0,3
EUN1_3575387432',6,26,11,1,1,1,0,8,0,358,94,26859,30990,26853,1,182,10,1,0,0,0,3,330,76,25514,29403,23194,1,28,18,1345,1,1587,3659,0,1,1,0,5
EUN1_3575320468',0,27,15,0,0,0,0,9,0,299,76,27078,28767,28857,5,54,12,1,0,1,0,2,335,84,27266,26489,31276,1,-36,-8,-188,3,2278,-2419,-1,0,-1,0,7
EUN1_3571911883',2,25,18,2,0,1,0,7,1,344,76,29863,31886,33764,5,26,16,0,0,0,0,6,322,80,27471,29244,32234,1,22,-4,2392,2,2642,1530,2,0,1,0,1
EUN1_3576006232',6,29,16,1,0,1,0,10,0,295,72,27303,28915,35036,2,24,13,0,0,1,0,1,307,92,27143,27907,25304,1,-12,-20,160,3,1008,9732,1,0,0,0,9
EUN1_3575967730',4,29,16,0,0,0,0,6,1,311,77,27202,26862,35583,2,271,11,1,0,1,0,1,305,60,25976,27370,35122,0,6,17,1226,5,-508,461,-1,0,-1,0,5
EUN1_3575889672',0,25,9,0,0,0,0,13,0,286,82,24254,27788,31717,2,28,9,1,0,1,0,1,330,78,25863,29518,33535,0,-44,4,-1609,0,-1730,-1818,-1,0,-1,0,12
EUN1_3575870303',6,29,11,2,0,1,0,6,1,351,90,27703,29289,26376,4,26,6,0,0,0,0,4,326,80,23050,26182,25877,1,25,10,4653,5,3107,499,2,0,1,0,2
EUN1_3575936668',1,24,9,1,0,0,0,5,1,345,62,25146,29418,26950,4,27,6,1,0,1,0,4,305,72,22063,26000,20918,1,40,-10,3083,3,3418,6032,0,0,-1,0,1
EUN1_3575467077',3,26,20,1,0,0,0,8,0,294,88,27462,29977,35416,5,17,10,1,1,0,0,3,269,92,25159,27533,31362,0,25,-4,2303,10,2444,4054,0,-1,0,0,5
EUN1_3575408573',6,42,19,1,0,2,0,9,1,347,94,31560,31133,37881,5,30,14,0,0,1,0,7,259,64,26532,26735,34932,1,88,30,5028,5,4398,2949,1,0,1,0,2
EUN1_3575381403',5,24,22,1,0,1,0,7,1,347,74,31192,31082,38955,2,144,10,0,0,1,0,10,261,72,25780,26704,32674,1,86,2,5412,12,4378,6281,1,0,0,0,-3
EUN1_3574918289',6,23,18,1,0,0,0,6,1,332,64,27690,27637,32723,2,23,18,1,0,1,0,0,315,90,30861,30540,37920,0,17,-26,-3171,0,-2903,-5197,0,0,-1,0,6
EUN1_3574877935',0,21,6,0,1,1,0,5,1,383,78,25506,30091,25019,4,22,15,2,0,0,0,4,329,118,27772,31425,34434,0,54,-40,-2266,-9,-1334,-9415,-2,1,1,0,1
EUN1_3574859253',1,23,12,0,0,0,0,8,0,339,68,25880,28778,32297,4,22,17,0,1,0,0,5,304,111,29011,29141,32218,0,35,-43,-3131,-5,-363,79,0,-1,0,0,3
EUN1_3574821136',2,24,11,0,0,1,0,10,0,292,54,25093,25418,26671,5,17,20,2,1,2,0,3,331,100,31146,30643,36552,0,-39,-46,-6053,-9,-5225,-9881,-2,-1,-1,0,7
EUN1_3574671443',3,61,18,1,0,1,0,10,1,318,56,29631,30111,31248,3,25,14,0,0,2,0,7,303,104,27113,30719,32826,1,15,-48,2518,4,-608,-1578,1,0,-1,0,3
EUN1_3574650926',3,27,12,1,0,0,0,13,0,312,79,26000,28042,34391,3,27,16,0,0,2,0,6,298,92,28756,30621,34786,0,14,-13,-2756,-4,-2579,-395,1,0,-2,0,7
EUN1_3575372584',7,34,9,2,0,0,0,7,0,403,90,27249,31045,26425,3,28,4,0,0,0,0,4,358,94,23200,28234,22653,1,45,-4,4049,5,2811,3772,2,0,0,0,3
EUN1_3575347811',3,25,17,0,0,1,0,8,0,381,88,31058,32653,34400,4,22,16,2,0,1,0,7,349,96,30010,31922,35959,1,32,-8,1048,1,731,-1559,-2,0,0,0,1
EUN1_3575333512',5,43,5,0,0,0,0,15,0,279,20,20277,22156,18061,5,66,23,2,0,4,0,0,378,117,34721,31878,38342,0,-99,-97,-14444,-18,-9722,-20281,-2,0,-4,0,15
EUN1_3575312702',2,28,13,2,0,0,0,14,0,349,67,27247,29489,27057,5,28,14,0,1,3,0,3,356,96,29245,30615,34016,0,-7,-29,-1998,-1,-1126,-6959,2,-1,-3,0,11
EUN1_3575295542',3,33,19,1,0,1,0,3,0,365,102,31573,32423,47376,1,17,14,0,0,0,0,5,325,82,26877,29379,27113,1,40,20,4696,5,3044,20263,1,0,1,0,-2
EUN1_3575265553',8,33,28,2,0,3,0,7,1,352,90,36888,31078,49013,2,22,12,0,0,0,0,10,287,84,26118,26949,35932,1,65,6,10770,16,4129,13081,2,0,3,0,-3
EUN1_3574976431',2,37,21,2,0,0,0,7,1,381,88,31772,31342,53876,3,26,11,0,0,1,0,2,341,79,25881,27522,28189,1,40,9,5891,10,3820,25687,2,0,-1,0,5
EUN1_3573337581',3,29,13,0,0,1,0,5,1,368,86,27414,29315,35082,5,27,12,1,0,0,0,5,322,94,26227,29242,36822,1,46,-8,1187,1,73,-1740,-1,0,1,0,0
EUN1_3573313637',2,20,8,0,0,2,0,9,0,374,109,27582,30176,26124,1,41,19,2,1,1,0,7,319,82,29292,29378,38733,0,55,27,-1710,-11,798,-12609,-2,-1,1,0,2
EUN1_3571716445',2,25,11,0,0,0,0,12,1,381,86,26818,29653,22687,1,40,15,2,0,1,0,5,349,86,29261,29296,33913,0,32,0,-2443,-4,357,-11226,-2,0,-1,0,7
EUN1_3570809104',3,26,8,1,0,0,0,7,0,327,95,25356,29303,20897,5,49,15,1,1,0,0,2,363,84,26847,29876,40641,0,-36,11,-1491,-7,-573,-19744,0,-1,0,0,5
EUN1_3570668540',1,199,24,2,1,1,0,9,1,318,82,31932,30808,42594,8,31,16,0,0,1,0,9,351,70,30115,28117,35123,0,-33,12,1817,8,2691,7471,2,1,0,0,0
EUN1_3570629924',2,20,15,1,0,3,0,12,1,285,121,30465,29607,34024,5,28,14,1,1,2,0,13,371,78,30962,29747,35597,0,-86,43,-497,1,-140,-1573,0,-1,1,0,-1
EUN1_3569796402',2,25,8,1,0,0,0,9,0,312,100,24224,26855,32444,5,32,16,1,0,3,0,8,364,100,30536,32301,31075,0,-52,0,-6312,-8,-5446,1369,0,0,-3,0,1
EUN1_3573239847',2,17,7,0,0,0,0,12,1,371,93,24745,30729,25841,1,18,16,1,0,1,0,2,355,101,30383,31936,31809,0,16,-8,-5638,-9,-1207,-5968,-1,0,-1,0,10
EUN1_3573036961',2,23,4,1,0,0,0,11,1,271,72,20900,24915,18467,5,48,24,1,0,3,0,0,372,116,32898,33625,37522,0,-101,-44,-11998,-20,-8710,-19055,0,0,-3,0,11
EUN1_3570080186',4,45,8,0,0,1,0,8,1,331,81,25735,26610,30166,4,104,10,2,0,1,0,8,321,81,25630,26538,34629,0,10,0,105,-2,72,-4463,-2,0,0,0,0
EUN1_3570048393',2,23,19,1,0,1,0,8,1,332,91,30368,29436,41797,1,22,13,0,0,0,0,8,273,69,26385,28422,28513,0,59,22,3983,6,1014,13284,1,0,1,0,0
EUN1_3569865859',7,24,25,2,0,1,0,13,1,359,71,33643,29885,46269,2,27,13,0,0,2,0,3,321,80,29691,27421,29577,1,38,-9,3952,12,2464,16692,2,0,-1,0,10
EUN1_3569845121',4,32,14,2,0,0,0,5,1,298,88,26516,29204,37783,5,29,11,0,0,0,0,0,289,56,24521,25930,37130,1,9,32,1995,3,3274,653,2,0,0,0,5
EUN1_3569709874',4,24,21,1,0,0,0,6,1,372,87,32096,31494,37752,3,41,8,0,0,1,0,9,326,84,24827,28224,32181,1,46,3,7269,13,3270,5571,1,0,-1,0,-3
EUN1_3569681645',3,24,7,1,0,0,0,15,0,353,80,24660,27594,29037,4,282,23,1,0,4,0,3,368,76,34248,31870,46156,0,-15,4,-9588,-16,-4276,-17119,0,0,-4,0,12
EUN1_3576138818',1,41,15,1,0,0,0,10,0,320,79,26982,28843,25556,8,32,9,1,0,1,0,5,380,96,28235,29632,27407,0,-60,-17,-1253,6,-789,-1851,0,0,-1,0,5
EUN1_3575934315',3,28,12,0,0,0,0,7,0,298,93,26289,27094,32325,6,30,19,2,1,1,0,3,365,86,30917,30880,33295,0,-67,7,-4628,-7,-3786,-970,-2,-1,-1,0,4
EUN1_3575899684',3,26,9,0,0,0,0,11,0,334,85,25487,27777,29503,2,24,19,2,0,2,0,1,348,102,31799,31514,36487,0,-14,-17,-6312,-10,-3737,-6984,-2,0,-2,0,10
EUN1_3575877573',2,28,8,0,0,0,0,7,0,306,90,24109,26984,25688,6,41,13,2,0,1,0,1,393,90,28511,30413,29998,0,-87,0,-4402,-5,-3429,-4310,-2,0,-1,0,6
EUN1_3575647412',2,32,16,0,0,0,0,11,0,254,90,26772,28774,29872,4,33,19,1,0,1,0,1,373,66,30062,30524,41282,0,-119,24,-3290,-3,-1750,-11410,-1,0,-1,0,10
EUN1_3575084596',3,28,12,1,0,0,0,8,1,349,88,26636,29608,28627,5,24,10,1,0,2,0,1,360,76,27244,29185,32711,0,-11,12,-608,2,423,-4084,0,0,-2,0,7
EUN1_3573199246',1,23,8,1,0,1,0,7,0,363,85,25596,28686,23632,0,20,13,1,0,0,0,3,390,82,28363,29999,28713,0,-27,3,-2767,-5,-1313,-5081,0,0,1,0,4
EUN1_3573160526',1,25,10,0,0,0,0,9,0,320,86,25241,29343,29799,2,30,18,2,0,1,0,0,371,96,30312,32017,38868,0,-51,-10,-5071,-8,-2674,-9069,-2,0,-1,0,9
EUN1_3572839089',1,18,11,0,0,0,0,13,0,383,80,26754,28419,34233,0,21,16,2,0,2,0,2,368,92,28997,33190,36458,0,15,-12,-2243,-5,-4771,-2225,-2,0,-2,0,11
EUN1_3575949746',2,26,19,2,0,3,0,5,1,337,116,31493,30637,38972,4,26,9,0,0,0,0,8,307,60,24609,27442,26807,1,30,56,6884,10,3195,12165,2,0,3,0,-3
EUN1_3574878471',2,21,12,0,0,1,0,12,1,365,68,27255,30267,27065,5,24,7,2,0,0,0,4,365,92,24801,30595,25996,1,0,-24,2454,5,-328,1069,-2,0,1,0,8
EUN1_3574211388',7,36,19,2,0,2,0,6,1,348,115,29614,31678,39215,1,43,9,0,0,0,0,8,302,62,23887,25771,26330,1,46,53,5727,10,5907,12885,2,0,2,0,-2
EUN1_3574192564',3,20,10,0,0,0,0,12,0,290,60,24414,27348,35644,9,29,22,1,0,0,0,2,324,74,29269,29447,42363,0,-34,-14,-4855,-12,-2099,-6719,-1,0,0,0,10
EUN1_3573987471',2,200,23,1,1,0,0,13,1,324,114,31499,33099,39971,0,18,14,1,0,1,0,4,328,74,28791,28684,38606,1,-4,40,2708,9,4415,1365,0,1,-1,0,9
EUN1_3573963133',6,42,12,1,0,0,0,4,1,378,66,26850,27141,29484,9,33,13,1,1,0,0,3,370,99,28788,29634,31499,0,8,-33,-1938,-1,-2493,-2015,0,-1,0,0,1
EUN1_3572527026',5,24,14,1,1,1,0,5,1,363,98,28696,29711,32978,6,29,7,1,0,0,0,7,294,74,23006,25030,20885,1,69,24,5690,7,4681,12093,0,1,1,0,-2
EUN1_3572524112',2,25,22,2,1,4,0,3,1,373,89,33970,32590,42357,5,22,5,0,0,0,0,8,287,106,23158,26753,24407,1,86,-17,10812,17,5837,17950,2,1,4,0,-5
EUN1_3572510074',4,22,6,0,0,1,0,16,0,347,85,25427,27021,29060,8,33,20,2,1,2,0,4,346,95,31187,32129,36911,0,1,-10,-5760,-14,-5108,-7851,-2,-1,-1,0,12
EUN1_3568231935',3,34,16,0,0,0,0,9,0,344,80,28676,29219,31284,1,33,19,2,0,1,0,0,358,84,31068,30431,36553,0,-14,-4,-2392,-3,-1212,-5269,-2,0,-1,0,9
EUN1_3567615368',10,31,4,1,0,0,0,13,1,332,66,22918,26100,21440,2,40,19,1,0,3,0,3,406,94,32667,33083,32702,0,-74,-28,-9749,-15,-6983,-11262,0,0,-3,0,10
EUN1_3567599886',4,24,10,0,0,0,0,8,0,348,76,25769,27976,28114,4,27,23,2,0,1,0,2,354,86,32740,30949,40969,0,-6,-10,-6971,-13,-2973,-12855,-2,0,-1,0,6
EUN1_3567589299',5,31,6,1,0,0,0,8,0,327,102,24980,28493,26920,4,27,9,0,0,1,0,6,344,77,25091,29575,29109,0,-17,25,-111,-3,-1082,-2189,1,0,-1,0,2
EUN1_3567561176',3,26,15,1,0,0,0,13,0,346,88,28940,28931,30315,4,27,24,0,0,1,0,3,355,88,33756,31411,45997,1,-9,0,-4816,-9,-2480,-15682,1,0,-1,0,10
EUN1_3566930636',2,30,6,1,1,0,0,9,0,392,94,26706,30813,25183,7,27,9,1,0,0,0,5,369,94,26085,29833,29277,1,23,0,621,-3,980,-4094,0,1,0,0,4
EUN1_3566908408',3,25,19,0,0,1,0,9,0,339,68,30685,28576,35951,4,26,22,1,0,2,0,5,327,72,32040,28971,42799,0,12,-4,-1355,-3,-395,-6848,-1,0,-1,0,4
EUN1_3566881951',6,50,12,1,0,1,0,9,0,382,97,29819,30009,36622,3,29,13,1,1,0,0,3,326,114,28082,30704,30551,0,56,-17,1737,-1,-695,6071,0,-1,1,0,6
EUN1_3566863373',4,24,11,0,0,1,0,11,1,319,96,27566,28142,31450,4,31,13,2,0,1,0,8,338,100,29067,29555,32876,0,-19,-4,-1501,-2,-1413,-1426,-2,0,0,0,3
EUN1_3566844076',2,59,7,1,0,1,0,8,0,360,98,27445,29591,26347,1,64,17,1,0,1,0,7,375,100,29507,32006,33944,0,-15,-2,-2062,-10,-2415,-7597,0,0,0,0,1
EUN1_3576032776',0,20,4,0,0,1,0,8,0,367,90,24479,28345,22303,5,28,14,2,0,1,0,3,342,102,28010,28767,32210,0,25,-12,-3531,-10,-422,-9907,-2,0,0,0,5
EUN1_3575995850',3,25,10,1,0,0,0,17,1,339,92,26298,29862,29664,6,30,20,1,0,2,0,1,339,91,31906,33546,39438,1,0,1,-5608,-10,-3684,-9774,0,0,-2,0,16
EUN1_3575961574',4,54,15,1,0,3,0,5,1,351,84,30143,30052,35706,1,23,8,0,0,0,0,8,337,68,24392,27307,33354,1,14,16,5751,7,2745,2352,1,0,3,0,-3
EUN1_3575945129',1,25,18,1,0,0,0,8,1,349,86,29301,30673,33240,6,35,13,1,0,0,0,2,343,78,26413,29611,35460,1,6,8,2888,5,1062,-2220,0,0,0,0,6
EUN1_3575912909',3,30,8,1,0,0,0,11,0,356,85,25862,29639,32917,4,28,20,0,1,1,0,2,309,98,29542,30234,39115,1,47,-13,-3680,-12,-595,-6198,1,-1,-1,0,9
EUN1_3575903152',4,25,9,1,0,0,0,7,0,349,79,25741,28982,27117,4,28,15,0,0,0,0,2,368,80,28324,31172,30980,1,-19,-1,-2583,-6,-2190,-3863,1,0,0,0,5
EUN1_3575503266',4,24,17,1,0,2,0,6,0,382,88,32702,30756,30083,6,25,13,1,0,0,0,7,301,68,25719,26164,32959,1,81,20,6983,4,4592,-2876,0,0,2,0,-1
EUN1_3575470539',4,26,10,1,0,0,0,11,0,333,120,26186,31945,32068,4,71,11,0,0,1,0,3,368,80,27699,30224,29411,0,-35,40,-1513,-1,1721,2657,1,0,-1,0,8
EUN1_3574481073',8,28,10,1,0,0,0,6,1,354,85,25783,29592,35848,2,25,12,1,0,2,0,4,350,90,27939,29602,31712,1,4,-5,-2156,-2,-10,4136,0,0,-2,0,2
EUN1_3574453377',5,25,14,2,0,1,0,10,1,379,90,29653,30589,32741,6,30,7,0,0,1,0,6,355,96,23964,28142,26163,1,24,-6,5689,7,2447,6578,2,0,0,0,4
EUN1_3574404558',5,34,6,0,0,0,0,9,1,311,79,24086,28380,27869,2,25,12,1,0,0,0,1,387,122,27349,31428,28973,1,-76,-43,-3263,-6,-3048,-1104,-1,0,0,0,8
EUN1_3574383427',3,40,21,2,1,0,0,5,0,342,72,30309,31379,35571,2,146,14,0,0,0,0,3,309,71,27061,27438,33424,1,33,1,3248,7,3941,2147,2,1,0,0,2
EUN1_3574365169',7,26,20,0,0,1,0,10,1,326,108,31655,30184,43926,1,21,17,1,0,1,0,5,313,72,27869,27875,43797,1,13,36,3786,3,2309,129,-1,0,0,0,5
EUN1_3574336765',4,22,16,1,0,0,0,12,1,294,82,28064,27651,27264,3,31,14,0,0,3,0,5,353,70,29484,29215,29622,0,-59,12,-1420,2,-1564,-2358,1,0,-3,0,7
EUN1_3574317667',3,128,7,0,0,0,0,8,0,373,95,24557,29440,25626,1,27,11,2,0,1,0,0,338,108,27074,29065,30615,0,35,-13,-2517,-4,375,-4989,-2,0,-1,0,8
EUN1_3574294876',3,28,16,1,0,1,0,11,1,364,74,29414,30145,30295,5,26,9,1,0,0,0,5,360,124,27210,30631,22806,1,4,-50,2204,7,-486,7489,0,0,1,0,6
EUN1_3574005637',7,280,16,0,1,2,0,8,0,339,61,27919,29530,31022,2,25,12,2,0,1,0,3,333,81,27352,28437,34443,1,6,-20,567,4,1093,-3421,-2,1,1,0,5
EUN1_3573997193',2,25,6,1,0,0,0,15,1,344,76,24383,26803,24575,1,23,11,0,0,1,0,3,368,80,28125,29013,30317,0,-24,-4,-3742,-5,-2210,-5742,1,0,-1,0,12
EUN1_3573961584',6,60,10,1,0,0,0,8,0,342,91,26211,29503,31532,4,61,12,1,0,0,0,3,327,72,25339,28204,32196,1,15,19,872,-2,1299,-664,0,0,0,0,5
EUN1_3573942418',3,45,20,0,0,0,0,12,0,262,49,29341,25464,37112,2,30,26,1,0,2,0,3,297,80,32884,28850,44215,0,-35,-31,-3543,-6,-3386,-7103,-1,0,-2,0,9
EUN1_3576135512',7,23,9,0,0,1,0,5,1,358,80,25958,27388,27358,7,34,12,1,1,0,0,7,379,91,27442,30436,32351,0,-21,-11,-1484,-3,-3048,-4993,-1,-1,1,0,-2
EUN1_3576114720',3,28,5,0,0,0,0,9,0,328,102,23701,27549,31183,6,29,17,1,0,1,0,2,346,88,29645,30580,30452,0,-18,14,-5944,-12,-3031,731,-1,0,-1,0,7
EUN1_3576092980',5,26,14,0,0,1,0,12,0,318,87,26669,27406,31658,1,19,17,1,0,1,0,1,383,92,30569,31199,33347,0,-65,-5,-3900,-3,-3793,-1689,-1,0,0,0,11
EUN1_3576077367',4,28,9,0,1,1,0,13,1,362,78,27537,27482,26652,11,273,14,1,0,2,0,5,303,98,28833,27367,34590,1,59,-20,-1296,-5,115,-7938,-1,1,-1,0,8
EUN1_3576054472',2,20,33,1,0,2,0,6,0,370,78,36382,32352,58666,3,41,22,0,0,0,0,10,274,84,31456,30550,37506,1,96,-6,4926,11,1802,21160,1,0,2,0,-4
EUN1_3575988807',2,29,22,0,0,0,0,9,0,297,99,30660,29593,41529,7,22,18,1,0,2,0,7,291,63,28035,26858,33998,0,6,36,2625,4,2735,7531,-1,0,-2,0,2
EUN1_3575957735',4,28,15,2,0,0,0,5,1,398,78,28844,32870,39268,2,24,7,0,0,0,0,4,379,109,26435,30891,28160,0,19,-31,2409,8,1979,11108,2,0,0,0,1
EUN1_3575926837',2,26,9,0,1,2,0,9,1,297,85,25535,27472,26460,0,28,7,1,0,0,0,1,338,90,24705,27307,25838,0,-41,-5,830,2,165,622,-1,1,2,0,8
EUN1_3575902994',7,29,11,1,0,0,0,4,1,365,100,27665,29446,38722,1,30,14,1,0,0,0,4,332,80,26097,28261,33865,0,33,20,1568,-3,1185,4857,0,0,0,0,0
EUN1_3575590221',4,22,23,2,0,1,0,5,1,323,76,31887,31715,31602,4,27,10,0,0,0,0,2,332,88,26723,29060,29799,1,-9,-12,5164,13,2655,1803,2,0,1,0,3
EUN1_3575561781',1,23,19,1,1,1,0,8,1,391,100,32126,34333,39752,1,29,7,0,0,0,0,6,311,94,24023,26683,23314,1,80,6,8103,12,7650,16438,1,1,1,0,2
EUN1_3575543535',3,336,21,1,0,2,0,4,1,399,84,32960,33812,45584,3,34,8,1,0,0,0,6,308,82,23845,26752,30987,1,91,2,9115,13,7060,14597,0,0,2,0,-2
EUN1_3575519140',1,25,22,0,0,1,0,14,0,290,78,30567,28812,37610,2,20,21,1,0,4,0,4,355,81,33520,29994,38406,0,-65,-3,-2953,1,-1182,-796,-1,0,-3,0,10
EUN1_3575453348',3,34,12,2,0,1,0,4,1,394,102,29651,31325,29829,2,24,6,0,0,1,0,10,338,84,23223,29344,25295,0,56,18,6428,6,1981,4534,2,0,0,0,-6
EUN1_3575407699',0,23,15,1,0,1,0,6,1,336,73,28526,28828,37715,3,28,14,0,0,0,0,5,282,82,25805,28835,30495,1,54,-9,2721,1,-7,7220,1,0,1,0,1
EUN1_3575366306',2,29,11,0,0,1,0,8,1,341,86,26659,29751,39574,4,32,11,1,0,1,0,5,362,82,26891,30099,34032,1,-21,4,-232,0,-348,5542,-1,0,0,0,3
EUN1_3575100410',4,26,11,1,0,0,0,11,1,344,102,27080,27787,32220,3,24,13,1,0,0,0,4,301,84,26325,29958,28350,1,43,18,755,-2,-2171,3870,0,0,0,0,7
EUN1_3575727092',6,40,22,2,0,2,0,9,1,386,84,35830,34325,38583,2,80,18,0,0,2,0,5,357,79,29477,30952,35084,1,29,5,6353,4,3373,3499,2,0,0,0,4
EUN1_3575199815',2,24,13,2,0,0,0,8,0,367,104,27883,30856,35175,2,23,16,0,0,1,0,1,316,83,28512,28418,28551,0,51,21,-629,-3,2438,6624,2,0,-1,0,7
EUN1_3573852488',1,20,10,0,0,0,0,12,1,339,74,24241,29052,36440,4,24,13,1,0,1,0,0,378,81,28538,30492,33291,0,-39,-7,-4297,-3,-1440,3149,-1,0,-1,0,12
EUN1_3573823010',4,23,7,0,0,0,0,8,0,337,87,23553,28380,29344,4,204,19,2,1,1,0,2,359,100,29829,30671,35294,0,-22,-13,-6276,-12,-2291,-5950,-2,-1,-1,0,6
EUN1_3573035690',1,25,6,0,0,1,0,6,0,384,91,26570,29059,20967,1,93,12,2,0,0,0,8,369,92,27007,30873,28565,0,15,-1,-437,-6,-1814,-7598,-2,0,1,0,-2
EUN1_3573027110',2,27,19,1,0,3,0,8,1,364,96,31727,32522,44925,6,23,11,0,0,1,0,8,271,72,25609,26663,33568,1,93,24,6118,8,5859,11357,1,0,2,0,0
EUN1_3572511809',5,30,15,0,0,0,0,7,0,320,71,26712,28583,36402,2,21,15,1,1,1,0,1,350,86,29995,30141,42877,0,-30,-15,-3283,0,-1558,-6475,-1,-1,-1,0,6
EUN1_3572497986',2,28,14,2,0,2,0,13,1,338,88,29953,28984,31642,3,27,13,0,0,1,0,6,345,78,28530,27960,28788,1,-7,10,1423,1,1024,2854,2,0,1,0,7
EUN1_3572497234',6,171,10,1,0,1,0,10,1,400,90,26934,30813,32954,1,24,6,1,1,1,0,3,363,112,26047,31987,24253,0,37,-22,887,4,-1174,8701,0,-1,0,0,7
EUN1_3572486442',4,34,7,1,0,1,0,7,0,359,70,26040,29424,22585,3,37,9,0,0,0,0,7,346,78,25779,27639,31291,1,13,-8,261,-2,1785,-8706,1,0,1,0,0
EUN1_3572336114',1,26,10,0,0,0,0,8,0,325,96,25528,29959,32426,3,43,12,2,0,0,0,2,360,92,26977,30116,33260,1,-35,4,-1449,-2,-157,-834,-2,0,0,0,6
EUN1_3572307059',0,19,20,0,0,1,0,12,1,271,110,30084,31047,42670,1,24,18,1,0,1,0,5,327,86,29932,30362,38673,0,-56,24,152,2,685,3997,-1,0,0,0,7
EUN1_3572290654',2,24,19,0,1,1,0,10,0,343,80,30107,30446,35041,2,30,19,2,0,1,0,3,314,100,30518,30997,40687,0,29,-20,-411,0,-551,-5646,-2,1,0,0,7
EUN1_3572254516',1,26,15,0,0,1,0,2,1,373,80,29536,31805,30457,2,21,13,2,0,0,0,6,348,80,27331,29855,33638,1,25,0,2205,2,1950,-3181,-2,0,1,0,-4
EUN1_3572201830',2,20,10,0,1,0,0,6,1,359,99,27313,31512,28122,3,27,11,1,0,0,0,2,375,79,26532,29807,26639,0,-16,20,781,-1,1705,1483,-1,1,0,0,4
EUN1_3572177650',1,17,9,0,0,0,0,11,1,305,63,24634,26028,24744,3,222,12,1,0,1,0,3,351,96,28546,29050,25572,0,-46,-33,-3912,-3,-3022,-828,-1,0,-1,0,8
EUN1_3572155397',2,68,5,0,0,1,0,6,0,360,74,24051,29035,22935,5,80,14,1,0,0,0,1,356,91,26984,30271,29464,0,4,-17,-2933,-9,-1236,-6529,-1,0,1,0,5
EUN1_3572117057',5,22,10,2,0,0,0,9,0,321,84,24689,30048,31905,2,18,16,0,0,1,0,1,375,92,30070,31274,29651,0,-54,-8,-5381,-6,-1226,2254,2,0,-1,0,8
EUN1_3571601922',2,26,8,1,0,0,0,10,0,356,93,24777,30927,23768,0,29,15,0,0,1,0,2,408,88,29315,32355,48510,0,-52,5,-4538,-7,-1428,-24742,1,0,-1,0,8
EUN1_3571517139',1,28,17,1,0,2,0,6,1,361,110,31841,34130,36801,3,21,8,1,0,0,0,7,319,81,24259,28283,29356,1,42,29,7582,9,5847,7445,0,0,2,0,-1
EUN1_3569713338',9,36,12,0,0,1,0,8,1,336,74,26959,28665,26602,3,39,10,1,0,1,0,3,343,86,25951,28239,32271,0,-7,-12,1008,2,426,-5669,-1,0,0,0,5
EUN1_3569318908',5,27,22,2,0,2,0,8,1,360,104,33829,32180,34093,1,23,10,0,0,0,0,5,337,68,25885,27472,29678,1,23,36,7944,12,4708,4415,2,0,2,0,3
EUN1_3575932190',3,70,19,1,1,3,0,7,1,383,76,32878,32334,35240,5,65,9,1,0,0,0,9,327,102,25260,28468,26261,1,56,-26,7618,10,3866,8979,0,1,3,0,-2
EUN1_3575890763',3,249,0,0,0,0,0,11,0,342,88,20421,26543,19733,2,24,15,1,0,2,0,0,402,92,30003,31229,29321,0,-60,-4,-9582,-15,-4686,-9588,-1,0,-2,0,11
EUN1_3575492788',2,29,15,2,0,0,0,3,1,350,94,27660,30929,43490,2,24,9,0,0,0,0,4,319,94,23720,28596,31735,1,31,0,3940,6,2333,11755,2,0,0,0,-1
EUN1_3575469487',5,28,17,1,0,2,0,7,1,354,88,30064,31445,35202,4,25,4,1,0,0,0,8,373,100,23183,29408,20651,1,-19,-12,6881,13,2037,14551,0,0,2,0,-1
EUN1_3575411217',1,18,13,1,0,0,0,9,1,328,82,25845,28784,28357,1,51,11,0,0,1,0,2,342,98,26370,31445,33618,0,-14,-16,-525,2,-2661,-5261,1,0,-1,0,7
EUN1_3575341983',4,30,21,1,0,0,0,7,0,342,106,30229,31399,41398,4,32,14,1,0,1,0,4,318,88,27296,27917,34361,1,24,18,2933,7,3482,7037,0,0,-1,0,3
EUN1_3575321432',4,24,8,0,0,0,0,8,0,312,59,23681,26239,27695,3,26,13,1,0,1,0,1,358,100,27343,31058,31220,0,-46,-41,-3662,-5,-4819,-3525,-1,0,-1,0,7
EUN1_3573546441',1,29,11,2,0,0,0,8,0,340,96,26096,31070,32546,4,30,10,0,0,1,0,3,357,76,24701,28049,29621,0,-17,20,1395,1,3021,2925,2,0,-1,0,5
EUN1_3573542159',2,20,11,0,0,1,0,8,1,327,77,26598,26475,35295,5,49,21,2,0,2,0,3,289,90,30699,30043,47076,0,38,-13,-4101,-10,-3568,-11781,-2,0,-1,0,5
EUN1_3573539236',6,34,15,1,0,1,0,12,0,304,82,29041,29490,36802,1,28,17,1,0,0,0,6,374,90,29057,30707,35830,1,-70,-8,-16,-2,-1217,972,0,0,1,0,6
EUN1_3573524941',2,127,5,1,0,0,0,9,1,370,84,23318,28706,21481,6,41,8,0,1,2,0,0,383,106,28066,30364,28855,0,-13,-22,-4748,-3,-1658,-7374,1,-1,-2,0,9
EUN1_3573518793',2,23,15,1,1,1,0,9,1,370,116,29434,32768,35299,4,25,5,1,0,1,0,7,357,83,24277,27999,35850,1,13,33,5157,10,4769,-551,0,1,0,0,2
EUN1_3573022681',5,25,7,0,0,1,0,8,0,341,72,24667,28209,23316,3,28,7,2,0,0,0,3,366,92,25119,29523,24874,0,-25,-20,-452,0,-1314,-1558,-2,0,1,0,5
EUN1_3573012517',1,17,14,2,0,3,0,2,1,387,128,31799,32018,23819,3,25,3,0,0,0,0,15,328,32,19664,23132,22926,1,59,96,12135,11,8886,893,2,0,3,0,-13
EUN1_3573008541',2,52,11,0,0,0,0,12,0,318,72,25364,27432,32725,4,25,21,1,1,2,0,2,351,114,32749,31242,40235,0,-33,-42,-7385,-10,-3810,-7510,-1,-1,-2,0,10
EUN1_3572991605',4,22,11,0,0,0,0,11,1,372,95,27142,30807,36926,5,25,12,2,0,1,0,3,342,104,27309,29952,33432,1,30,-9,-167,-1,855,3494,-2,0,-1,0,8
EUN1_3572518655',3,26,12,0,0,2,0,8,0,348,84,27544,28504,22232,3,32,13,2,0,0,0,6,364,88,27972,29599,25415,1,-16,-4,-428,-1,-1095,-3183,-2,0,2,0,2
EUN1_3572158862',5,46,11,0,0,0,0,9,0,319,84,25464,28322,30033,4,141,9,1,0,1,0,3,354,84,26359,28613,31575,0,-35,0,-895,2,-291,-1542,-1,0,-1,0,6
EUN1_3572022155',1,25,18,0,0,0,0,8,1,357,85,31289,32735,34131,1,49,20,2,0,1,0,3,345,90,30351,31781,33449,0,12,-5,938,-2,954,682,-2,0,-1,0,5
EUN1_3571628989',3,31,19,1,0,0,0,8,1,361,114,30715,31368,37099,0,24,7,0,0,1,0,5,332,90,24673,28032,28089,1,29,24,6042,12,3336,9010,1,0,-1,0,3
EUN1_3570867797',5,41,12,0,0,0,0,10,0,340,92,27399,30824,38911,4,34,14,2,0,1,0,1,382,94,29466,30759,35347,1,-42,-2,-2067,-2,65,3564,-2,0,-1,0,9
EUN1_3570806790',1,22,11,1,0,0,0,6,1,368,88,27564,29599,26145,6,29,13,1,1,0,0,6,364,88,27516,29931,35571,0,4,0,48,-2,-332,-9426,0,-1,0,0,0
EUN1_3570748158',5,23,17,2,0,0,0,7,1,352,86,28819,31797,32093,2,33,14,0,0,1,0,1,377,97,28611,31790,34470,1,-25,-11,208,3,7,-2377,2,0,-1,0,6
EUN1_3570722455',3,27,20,2,0,2,0,6,1,378,117,31929,31604,39133,4,55,12,0,0,0,0,7,289,67,25227,26149,39447,1,89,50,6702,8,5455,-314,2,0,2,0,-1
EUN1_3572031862',5,25,11,0,0,0,0,4,1,346,72,26007,27920,27954,5,28,9,1,0,0,0,3,361,87,26452,28485,26992,0,-15,-15,-445,2,-565,962,-1,0,0,0,1
EUN1_3571954797',3,79,21,1,0,2,0,17,1,332,68,30123,28640,37918,2,33,7,1,0,0,0,5,279,91,24355,25641,26894,1,53,-23,5768,14,2999,11024,0,0,2,0,12
EUN1_3567264206',1,19,10,1,0,0,0,10,0,329,71,25818,29704,29115,4,26,13,0,0,0,0,0,383,93,28164,30838,34826,1,-54,-22,-2346,-3,-1134,-5711,1,0,0,0,10
EUN1_3567161564',3,59,6,0,0,0,0,11,1,330,82,24363,29020,29810,2,55,10,1,0,1,0,0,423,86,28662,32933,29518,0,-93,-4,-4299,-4,-3913,292,-1,0,-1,0,11
EUN1_3567135885',1,24,28,1,0,1,0,11,1,306,73,32693,30934,50105,0,19,12,0,0,2,0,4,325,88,28575,28136,33158,1,-19,-15,4118,16,2798,16947,1,0,-1,0,7
EUN1_3565804779',1,21,7,1,0,0,0,8,0,369,83,24941,30391,27052,2,21,17,1,0,0,0,2,373,88,29726,31809,37489,0,-4,-5,-4785,-10,-1418,-10437,0,0,0,0,6
EUN1_3565453037',1,20,22,1,0,2,0,8,1,393,86,33015,33604,39837,3,20,7,1,0,0,0,4,321,77,24370,26876,30379,1,72,9,8645,15,6728,9458,0,0,2,0,4
EUN1_3565165925',4,32,9,0,0,0,0,10,0,354,69,27068,28246,30711,1,20,18,2,1,2,0,2,341,110,30763,31960,32193,0,13,-41,-3695,-9,-3714,-1482,-2,-1,-2,0,8
EUN1_3564872915',1,26,12,0,0,0,0,9,0,324,62,26070,28266,27193,2,23,18,0,0,1,0,2,377,97,31056,32151,35836,0,-53,-35,-4986,-6,-3885,-8643,0,0,-1,0,7
EUN1_3563846062',7,23,18,2,0,1,0,8,1,259,80,28777,28154,38215,6,28,14,0,0,0,0,5,286,72,25686,25253,38933,1,-27,8,3091,4,2901,-718,2,0,1,0,3
EUN1_3562490638',2,24,8,0,0,0,0,9,0,318,97,26345,28235,29328,1,24,16,2,0,1,0,7,375,90,30535,32828,30440,0,-57,7,-4190,-8,-4593,-1112,-2,0,-1,0,2
EUN1_3562421338',0,20,12,1,0,1,0,11,1,384,86,28468,31535,25284,5,31,4,1,0,0,0,3,365,86,24087,27197,18788,1,19,0,4381,8,4338,6496,0,0,1,0,8
EUN1_3562384676',1,55,11,0,0,0,0,14,0,264,66,25623,28258,31268,3,26,23,2,0,4,0,1,386,86,34530,33564,44777,0,-122,-20,-8907,-12,-5306,-13509,-2,0,-4,0,13
EUN1_3562063820',3,85,18,1,0,2,0,12,1,310,90,30571,30518,35808,4,22,7,0,0,0,0,5,299,82,24557,27823,25223,1,11,8,6014,11,2695,10585,1,0,2,0,7
EUN1_3561140904',4,374,12,1,0,1,0,17,0,320,68,26927,27642,30523,3,24,23,1,1,4,0,5,365,99,34158,33089,36446,0,-45,-31,-7231,-11,-5447,-5923,0,-1,-3,0,12
EUN1_3561140293',2,32,23,2,0,0,0,7,1,360,72,32073,31091,47661,3,25,17,0,0,1,0,9,288,92,28997,29156,37753,0,72,-20,3076,6,1935,9908,2,0,-1,0,-2
EUN1_3561024473',4,26,12,2,0,0,0,9,1,367,94,27919,28885,31265,3,22,10,0,0,1,0,6,308,84,25633,29805,28785,1,59,10,2286,2,-920,2480,2,0,-1,0,3
EUN1_3558914145',2,89,20,2,0,2,0,11,1,348,92,32352,32307,41246,2,21,8,0,0,2,0,4,321,80,24981,27470,26194,1,27,12,7371,12,4837,15052,2,0,0,0,7
EUN1_3558764168',3,27,12,0,0,1,0,9,1,309,92,28024,28509,33523,2,24,14,1,0,1,0,2,322,84,27484,28459,35620,0,-13,8,540,-2,50,-2097,-1,0,0,0,7
EUN1_3563951504',6,141,22,0,0,1,0,13,1,319,86,32062,30417,45033,3,291,16,2,1,2,0,4,345,78,30528,30193,38780,0,-26,8,1534,6,224,6253,-2,-1,-1,0,9
EUN1_3561598034',1,18,11,1,0,0,0,6,1,326,90,27124,27806,32969,8,99,12,1,0,0,0,4,333,78,27135,28841,29334,0,-7,12,-11,-1,-1035,3635,0,0,0,0,2
EUN1_3561588579',3,28,8,0,0,0,0,8,0,297,59,24294,26341,33119,0,25,18,0,0,1,0,2,358,96,30347,31485,37650,0,-61,-37,-6053,-10,-5144,-4531,0,0,-1,0,6
EUN1_3576019833',2,25,19,1,0,0,0,10,1,302,62,29867,27408,40900,1,25,19,0,0,1,0,1,349,81,31992,30779,40050,1,-47,-19,-2125,0,-3371,850,1,0,-1,0,9
EUN1_3575445811',5,31,14,1,0,1,0,9,1,382,69,29132,29376,36977,2,28,11,1,0,1,0,4,324,86,26404,28110,29530,1,58,-17,2728,3,1266,7447,0,0,0,0,5
EUN1_3575305467',9,31,11,1,0,0,0,8,0,325,95,25940,29068,33599,1,26,13,0,0,2,0,0,392,86,28756,32003,37328,0,-67,9,-2816,-2,-2935,-3729,1,0,-2,0,8
EUN1_3575287456',2,17,12,0,0,0,0,9,1,288,80,25862,26791,34098,1,20,15,2,0,0,0,2,375,82,29014,31379,29859,0,-87,-2,-3152,-3,-4588,4239,-2,0,0,0,7
EUN1_3575257821',3,21,16,2,0,0,0,10,0,333,85,29284,30417,37844,3,20,18,0,1,0,0,3,321,108,29625,30357,41158,0,12,-23,-341,-2,60,-3314,2,-1,0,0,7
EUN1_3575181173',0,24,14,0,0,0,0,8,0,379,106,27870,30429,35329,5,34,14,1,0,1,0,4,386,102,30556,31761,33924,0,-7,4,-2686,0,-1332,1405,-1,0,-1,0,4
EUN1_3574438972',3,25,18,1,0,1,0,6,1,358,98,29450,29840,30763,1,24,10,1,0,1,0,8,309,94,25937,26448,31979,1,49,4,3513,8,3392,-1216,0,0,0,0,-2
EUN1_3574171762',2,19,19,2,0,0,0,4,1,347,84,29025,29816,42121,2,20,14,0,0,1,0,6,331,83,28645,29944,33729,0,16,1,380,5,-128,8392,2,0,-1,0,-2
EUN1_3573204494',1,26,18,1,0,1,0,4,1,348,96,31004,30046,41970,1,15,15,1,0,1,0,9,330,72,29070,29040,35593,0,18,24,1934,3,1006,6377,0,0,0,0,-5
EUN1_3573183155',0,24,15,0,0,2,0,10,1,314,61,29815,28159,32383,5,37,20,2,0,1,0,3,370,82,30659,30959,42323,0,-56,-21,-844,-5,-2800,-9940,-2,0,1,0,7
EUN1_3573132858',0,24,9,1,0,0,0,11,0,301,78,24474,28324,29181,4,38,13,1,0,1,0,1,391,102,28534,31256,29688,0,-90,-24,-4060,-4,-2932,-507,0,0,-1,0,10
EUN1_3573115412',4,21,20,1,0,2,0,8,0,320,80,32042,28734,49389,3,23,23,1,0,1,0,7,324,83,32065,31078,41211,1,-4,-3,-23,-3,-2344,8178,0,0,1,0,1
EUN1_3573088859',4,27,9,0,0,0,0,10,1,352,70,25500,28769,32946,5,67,10,2,0,2,0,4,394,90,28472,32344,29857,0,-42,-20,-2972,-1,-3575,3089,-2,0,-2,0,6
EUN1_3573029514',1,19,7,0,0,0,0,11,1,312,80,23638,27388,27025,4,27,16,2,0,1,0,1,376,88,29432,31468,33286,0,-64,-8,-5794,-9,-4080,-6261,-2,0,-1,0,10
EUN1_3573011562',6,62,11,2,0,0,0,10,0,313,96,24961,28271,31988,3,58,10,0,1,1,0,2,347,82,27611,27701,29427,0,-34,14,-2650,1,570,2561,2,-1,-1,0,8
EUN1_3572999748',3,24,3,0,0,0,0,9,1,365,95,23165,27541,23180,2,25,13,2,0,2,0,1,394,104,29286,31127,29994,0,-29,-9,-6121,-10,-3586,-6814,-2,0,-2,0,8
EUN1_3572799823',5,112,15,1,0,0,0,10,1,365,90,27932,30304,38570,2,22,4,0,0,1,0,1,343,58,24269,25646,21637,1,22,32,3663,11,4658,16933,1,0,-1,0,9
EUN1_3572778829',4,23,18,1,0,2,0,10,0,362,88,30370,30205,36669,5,29,10,1,0,0,0,7,336,73,26316,29650,22351,1,26,15,4054,8,555,14318,0,0,2,0,3
EUN1_3572756057',5,25,20,1,1,2,0,10,1,359,87,31533,31043,38726,2,25,8,0,0,0,0,7,332,62,24649,26386,21692,1,27,25,6884,12,4657,17034,1,1,2,0,3
EUN1_3572794083',2,29,11,1,0,1,0,3,0,372,75,28067,29816,33026,3,38,16,1,0,0,0,6,342,80,27004,28616,32914,0,30,-5,1063,-5,1200,112,0,0,1,0,-3
EUN1_3572745910',3,34,16,1,0,2,0,4,1,389,97,29839,31917,39088,4,36,8,0,0,0,0,1,328,81,24719,26699,25223,1,61,16,5120,8,5218,13865,1,0,2,0,3
EUN1_3572725877',4,23,16,2,0,2,0,8,0,399,103,32197,31778,35015,4,39,11,0,0,2,0,6,322,76,26509,28626,33351,1,77,27,5688,5,3152,1664,2,0,0,0,2
EUN1_3571713866',4,39,14,2,0,1,0,6,1,379,94,28458,30965,32497,3,31,7,0,0,0,0,7,308,86,24066,27258,27430,1,71,8,4392,7,3707,5067,2,0,1,0,-1
EUN1_3571171227',5,29,3,0,0,0,0,7,0,355,72,22071,27200,25167,5,41,11,2,1,2,0,2,398,104,28561,31967,28505,0,-43,-32,-6490,-8,-4767,-3338,-2,-1,-2,0,5
EUN1_3571142395',2,26,9,0,0,0,0,9,0,376,90,24996,28693,29280,5,27,16,1,0,0,0,0,356,90,28734,30489,33001,0,20,0,-3738,-7,-1796,-3721,-1,0,0,0,9
EUN1_3571084118',1,25,8,1,0,0,0,8,1,393,84,26427,29374,24989,4,29,11,0,0,1,0,4,355,84,25903,29317,28302,0,38,0,524,-3,57,-3313,1,0,-1,0,4
EUN1_3571046350',3,183,11,2,0,0,0,4,0,388,114,27850,32494,28382,6,44,6,0,0,0,0,10,357,82,23705,28117,24756,1,31,32,4145,5,4377,3626,2,0,0,0,-6
EUN1_3571007245',4,29,6,1,0,1,0,10,0,398,82,25988,29338,23167,6,38,12,1,0,0,0,4,367,86,26530,28134,32344,0,31,-4,-542,-6,1204,-9177,0,0,1,0,6
EUN1_3570978180',7,36,22,1,0,1,0,3,0,327,98,30321,31075,37781,4,25,7,0,0,1,0,5,350,94,25383,27751,26068,1,-23,4,4938,15,3324,11713,1,0,0,0,-2
EUN1_3570932180',4,26,13,2,0,0,0,6,1,374,82,27465,32348,38524,6,29,8,0,0,0,0,3,370,98,26380,30099,26670,1,4,-16,1085,5,2249,11854,2,0,0,0,3
EUN1_3570035850',2,26,10,1,0,1,0,5,1,356,98,28354,30512,35659,4,55,10,0,0,0,0,6,373,85,26114,31056,26734,1,-17,13,2240,0,-544,8925,1,0,1,0,-1
EUN1_3570020415',5,23,12,0,1,0,0,7,1,339,69,25898,29583,27471,1,22,4,2,0,0,0,4,379,93,24918,28688,27746,0,-40,-24,980,8,895,-275,-2,1,0,0,3
EUN1_3569999622',2,21,12,2,0,0,0,10,0,371,68,27210,27515,32746,4,37,12,0,1,1,0,3,364,108,28279,28750,33597,0,7,-40,-1069,0,-1235,-851,2,-1,-1,0,7
EUN1_3574806840',4,19,21,1,1,1,0,5,0,364,111,33774,32378,43151,3,134,10,0,0,0,0,8,338,72,26082,27149,32319,1,26,39,7692,11,5229,10832,1,1,1,0,-3
EUN1_3567804883',2,30,12,1,0,1,0,9,1,344,89,27726,29530,24128,4,361,6,1,0,2,0,4,331,94,25185,28602,28970,1,13,-5,2541,6,928,-4842,0,0,-1,0,5
EUN1_3567366975',5,59,14,1,0,1,0,4,1,357,75,28484,28050,33717,3,24,7,0,0,0,0,4,356,72,25052,26951,32183,1,1,3,3432,7,1099,1534,1,0,1,0,0
EUN1_3567116484',3,18,12,0,0,0,0,12,1,278,94,25897,26529,33471,1,27,18,2,0,1,0,0,367,82,30262,32060,32539,0,-89,12,-4365,-6,-5531,932,-2,0,-1,0,12
EUN1_3569088020',2,23,11,0,0,0,0,12,0,280,101,26173,27716,27931,4,33,20,2,0,2,0,3,322,90,31496,29395,38787,0,-42,11,-5323,-9,-1679,-10856,-2,0,-2,0,9
EUN1_3569060202',0,27,16,0,0,0,0,9,1,287,92,27715,26043,32506,4,30,14,1,0,1,0,2,334,82,28700,29169,41456,0,-47,10,-985,2,-3126,-8950,-1,0,-1,0,7
EUN1_3569036317',5,40,20,1,0,1,0,8,1,365,101,31217,32101,40886,1,21,14,1,0,1,0,7,349,78,28325,29835,32372,1,16,23,2892,6,2266,8514,0,0,0,0,1
EUN1_3569019525',3,27,13,0,0,1,0,6,1,337,86,28109,28985,34704,2,29,8,0,0,0,0,10,334,76,24351,27976,23018,1,3,10,3758,5,1009,11686,0,0,1,0,-4
EUN1_3568859199',2,25,12,2,0,1,0,12,0,354,83,27261,29328,27061,7,31,12,0,0,0,0,3,351,103,26518,32524,28616,0,3,-20,743,0,-3196,-1555,2,0,1,0,9
EUN1_3568838458',2,25,5,1,1,0,0,6,0,386,104,24884,29245,20307,0,19,13,1,0,1,0,6,383,96,27355,31479,22226,0,3,8,-2471,-8,-2234,-1919,0,1,-1,0,0
EUN1_3568815046',5,31,11,2,0,0,0,8,0,410,100,27374,30774,30733,5,31,8,0,0,0,0,3,335,88,25063,27306,29835,1,75,12,2311,3,3468,898,2,0,0,0,5
EUN1_3568331618',4,20,19,2,0,0,0,6,1,284,74,29218,29927,35431,1,20,12,0,0,0,0,3,343,96,26513,28718,38358,1,-59,-22,2705,7,1209,-2927,2,0,0,0,3
EUN1_3566980101',3,31,10,2,0,1,0,6,1,405,94,29394,29738,31843,5,30,11,0,1,0,0,5,351,86,26425,29069,30474,1,54,8,2969,-1,669,1369,2,-1,1,0,1
EUN1_3566963594',4,26,9,0,0,0,0,13,1,351,88,27140,29269,30868,4,27,17,2,0,1,0,4,367,107,31177,31469,33619,1,-16,-19,-4037,-8,-2200,-2751,-2,0,-1,0,9
EUN1_3566958356',2,28,8,1,0,0,0,13,0,319,89,24400,25807,27692,5,25,17,1,0,1,0,4,377,96,30970,31565,40551,0,-58,-7,-6570,-9,-5758,-12859,0,0,-1,0,9
EUN1_3566441697',3,21,22,2,0,1,0,7,1,327,100,32037,31180,35906,1,24,11,0,0,0,0,9,301,108,26413,29439,28942,1,26,-8,5624,11,1741,6964,2,0,1,0,-2
EUN1_3566416944',3,27,27,1,0,2,0,1,1,369,83,34460,33207,47588,1,20,9,1,0,0,0,7,352,88,27073,28611,29762,1,17,-5,7387,18,4596,17826,0,0,2,0,-6
EUN1_3565948648',1,25,14,1,0,0,0,3,1,345,70,28896,30148,28702,5,101,8,0,0,1,0,6,346,92,25120,29019,31274,1,-1,-22,3776,6,1129,-2572,1,0,-1,0,-3
EUN1_3565926239',1,24,6,1,0,0,0,7,0,327,79,23166,27019,27818,6,31,12,0,0,0,0,2,355,108,27141,30206,26015,1,-28,-29,-3975,-6,-3187,1803,1,0,0,0,5
EUN1_3565890060',5,32,14,1,0,0,0,14,1,328,88,27592,30098,38290,3,91,10,0,0,1,0,3,357,90,26561,29646,30960,0,-29,-2,1031,4,452,7330,1,0,-1,0,11
EUN1_3565864777',3,23,5,0,1,0,0,8,1,343,84,24029,27665,22460,3,24,19,2,0,0,0,1,373,114,28615,33723,33691,0,-30,-30,-4586,-14,-6058,-11231,-2,1,0,0,7
EUN1_3565836536',2,24,10,0,0,0,0,12,0,374,82,27019,28559,28685,2,30,14,2,1,1,0,2,349,113,29574,30270,37449,1,25,-31,-2555,-4,-1711,-8764,-2,-1,-1,0,10
EUN1_3565806642',2,50,11,0,0,0,0,6,1,359,86,28142,31030,31561,4,22,9,1,0,1,0,7,354,78,25194,27485,26576,1,5,8,2948,2,3545,4985,-1,0,-1,0,-1
EUN1_3565786319',2,26,10,1,0,0,0,11,1,335,72,25536,26119,28921,4,31,17,1,1,2,0,2,341,92,31183,29790,36778,0,-6,-20,-5647,-7,-3671,-7857,0,-1,-2,0,9
EUN1_3568001756',2,20,12,0,0,1,0,7,0,357,67,27326,29789,30407,4,22,10,1,0,0,0,7,351,96,25918,28530,26556,1,6,-29,1408,2,1259,3851,-1,0,1,0,0
EUN1_3567990964',2,24,8,1,1,0,0,5,1,379,94,26005,30651,21328,5,25,6,1,0,1,0,3,342,97,23389,28692,24422,1,37,-3,2616,2,1959,-3094,0,1,-1,0,2
EUN1_3567984672',6,35,12,1,0,0,0,6,0,352,87,27427,29367,36288,8,38,11,1,0,0,0,3,330,78,26317,28466,32157,1,22,9,1110,1,901,4131,0,0,0,0,3
EUN1_3567692581',3,28,12,0,0,0,0,10,0,301,76,26169,26718,39091,2,24,17,2,1,1,0,2,329,80,29085,29394,42384,0,-28,-4,-2916,-5,-2676,-3293,-2,-1,-1,0,8
EUN1_3567576208',6,46,19,1,1,0,0,7,1,330,85,30618,30555,33325,2,26,12,0,0,2,0,1,378,85,28718,30288,33790,0,-48,0,1900,7,267,-465,1,1,-2,0,6
EUN1_3567558056',4,23,8,0,0,0,0,15,0,304,98,24349,29263,27302,4,64,20,2,1,3,0,0,396,110,33767,32540,36502,0,-92,-12,-9418,-12,-3277,-9200,-2,-1,-3,0,15
EUN1_3565185078',3,31,14,0,0,1,0,11,1,330,79,27850,28394,32356,5,26,12,2,1,1,0,6,335,78,27942,27411,27410,1,-5,1,-92,2,983,4946,-2,-1,0,0,5
EUN1_3564700567',3,137,19,1,0,1,0,5,0,334,92,30688,29074,42394,2,19,18,0,0,0,0,4,318,72,28659,29480,33769,1,16,20,2029,1,-406,8625,1,0,1,0,1
EUN1_3564691009',4,42,12,2,0,0,0,10,1,362,110,26302,29973,23055,6,26,6,0,0,1,0,0,380,78,25542,29425,22726,0,-18,32,760,6,548,329,2,0,-1,0,10
EUN1_3564679003',1,22,12,2,1,0,0,7,0,358,92,28076,29433,29297,3,28,11,0,0,0,0,4,326,100,26780,29423,27992,1,32,-8,1296,1,10,1305,2,1,0,0,3
EUN1_3564598572',5,26,15,1,1,0,0,9,0,325,88,27247,30660,29542,4,33,10,1,0,0,0,2,368,108,27103,30131,35831,0,-43,-20,144,5,529,-6289,0,1,0,0,7
EUN1_3564445089',2,22,22,1,1,3,0,7,1,336,88,34594,29739,42725,3,27,14,1,0,0,0,8,331,88,27726,27653,33037,1,5,0,6868,8,2086,9688,0,1,3,0,-1
EUN1_3564238306',1,18,15,0,0,1,0,8,1,372,73,28470,28575,35907,3,23,22,2,0,0,0,12,328,106,31513,32877,40125,0,44,-33,-3043,-7,-4302,-4218,-2,0,1,0,-4
EUN1_3564232090',3,29,17,1,0,2,0,11,1,400,99,32718,33435,36337,6,33,9,1,0,1,0,8,370,89,27565,29779,25968,1,30,10,5153,8,3656,10369,0,0,1,0,3
EUN1_3564221565',4,22,19,1,0,2,0,10,1,378,105,32030,33990,43443,6,27,5,1,1,0,0,6,309,81,23924,26310,30317,1,69,24,8106,14,7680,13126,0,-1,2,0,4
EUN1_3564034411',2,25,15,1,0,1,0,9,1,397,80,31109,29715,34826,5,24,10,0,0,1,0,4,339,88,26185,29670,29308,1,58,-8,4924,5,45,5518,1,0,0,0,5
EUN1_3563676408',4,32,11,1,0,0,0,7,0,340,72,26173,26848,33666,4,37,17,0,0,1,0,2,391,92,29765,31643,43276,0,-51,-20,-3592,-6,-4795,-9610,1,0,-1,0,5
EUN1_3563659934',5,34,15,1,0,1,0,11,1,315,71,28878,29582,33417,4,26,11,1,0,1,0,6,364,80,27043,29502,34059,1,-49,-9,1835,4,80,-642,0,0,0,0,5
EUN1_3572753946',3,21,9,1,0,0,0,12,0,363,79,25541,29547,36675,4,24,17,1,0,1,0,0,316,104,28598,30926,35473,0,47,-25,-3057,-8,-1379,1202,0,0,-1,0,12
EUN1_3572726605',7,32,17,1,0,1,0,12,0,332,82,29501,29057,37339,2,25,10,1,0,1,0,7,325,82,25356,27192,26991,1,7,0,4145,7,1865,10348,0,0,0,0,5
EUN1_3571801963',4,35,19,2,0,0,0,9,1,355,82,28530,29694,37574,4,30,7,0,0,1,0,0,345,62,23847,26503,30391,0,10,20,4683,12,3191,7183,2,0,-1,0,9
EUN1_3571790980',4,20,17,0,0,2,0,7,1,379,113,30912,33007,32489,2,29,9,1,0,1,0,6,331,85,26252,28704,27913,1,48,28,4660,8,4303,4576,-1,0,1,0,1
EUN1_3571786146',3,23,10,0,0,1,0,12,1,312,98,26585,27312,26497,6,35,18,2,0,2,0,8,360,86,31054,30230,34828,0,-48,12,-4469,-8,-2918,-8331,-2,0,-1,0,4
EUN1_3571760510',2,35,6,1,0,0,0,10,0,349,56,23644,25898,26441,3,25,20,0,0,4,0,0,381,112,33005,30877,35695,0,-32,-56,-9361,-14,-4979,-9254,1,0,-4,0,10
EUN1_3571745462',3,21,6,0,0,0,0,14,0,279,82,23372,24857,27034,1,22,26,2,1,2,0,2,402,105,34343,34701,45224,0,-123,-23,-10971,-20,-9844,-18190,-2,-1,-2,0,12
EUN1_3571717593',4,25,12,1,0,1,0,5,0,378,80,27628,29802,26149,3,25,9,1,0,0,0,7,382,92,25578,29537,30152,0,-4,-12,2050,3,265,-4003,0,0,1,0,-2
EUN1_3571689031',5,30,15,1,0,0,0,9,1,322,97,27194,27189,36694,6,22,14,0,0,2,0,2,308,94,28771,26207,34452,0,14,3,-1577,1,982,2242,1,0,-2,0,7
EUN1_3571661856',7,107,9,0,0,0,0,7,1,287,78,23010,27090,24255,2,33,9,1,0,0,0,1,358,70,25090,28901,28172,0,-71,8,-2080,0,-1811,-3917,-1,0,0,0,6
EUN1_3571636781',3,247,16,0,0,1,0,13,0,334,78,29949,29867,38227,3,26,19,1,0,2,0,3,356,92,30934,31399,37203,1,-22,-14,-985,-3,-1532,1024,-1,0,-1,0,10
EUN1_3571624123',5,29,19,2,0,1,0,11,0,332,109,32513,32237,37691,0,18,10,0,0,3,0,6,314,91,25327,27193,28215,1,18,18,7186,9,5044,9476,2,0,-2,0,5
EUN1_3571600346',2,21,19,1,0,4,0,5,1,401,114,34263,33048,36903,2,24,5,1,0,1,0,12,326,82,23043,25109,31931,1,75,32,11220,14,7939,4972,0,0,3,0,-7
EUN1_3569322105',5,23,10,1,1,0,0,9,0,326,86,25835,27849,25929,1,21,17,1,0,1,0,1,384,90,29952,31280,35867,0,-58,-4,-4117,-7,-3431,-9938,0,1,-1,0,8
EUN1_3569291764',1,23,11,1,0,0,0,12,1,336,91,26034,29142,33450,4,25,15,1,0,3,0,4,282,104,29714,30267,30864,1,54,-13,-3680,-4,-1125,2586,0,0,-3,0,8
EUN1_3569276584',1,20,7,0,0,0,0,17,0,260,75,21818,23850,21291,2,30,19,2,0,6,1,0,375,95,33724,30699,28190,0,-115,-20,-11906,-12,-6849,-6899,-2,0,-6,-1,17
EUN1_3570829431',3,30,9,1,0,0,0,6,0,370,78,25873,31030,29963,3,30,21,1,0,1,0,1,366,99,31268,33377,40712,0,4,-21,-5395,-12,-2347,-10749,0,0,-1,0,5
EUN1_3570808108',8,33,19,1,0,0,0,10,0,278,64,28786,28145,40758,0,23,17,1,0,2,0,4,304,121,29631,29920,32407,1,-26,-57,-845,2,-1775,8351,0,0,-2,0,6
EUN1_3570775279',2,17,4,0,0,1,0,5,0,388,100,25344,28890,25356,4,81,14,2,0,0,0,6,336,128,27305,30565,24345,0,52,-28,-1961,-10,-1675,1011,-2,0,1,0,-1
EUN1_3570123695',4,20,12,0,0,1,0,7,1,349,108,29383,30091,43592,3,44,14,2,1,0,0,7,361,80,28429,31452,35452,1,-12,28,954,-2,-1361,8140,-2,-1,1,0,0
EUN1_3570034919',5,285,20,0,0,1,0,7,1,337,90,31423,29230,44250,2,21,11,2,0,0,0,2,327,90,26137,28234,36992,1,10,0,5286,9,996,7258,-2,0,1,0,5
EUN1_3570032102',1,18,14,0,0,0,0,9,1,281,94,27018,26826,31179,4,33,23,2,0,2,0,0,373,98,32666,32429,39975,0,-92,-4,-5648,-9,-5603,-8796,-2,0,-2,0,9
EUN1_3569447998',6,28,8,1,0,0,0,7,0,381,88,24419,29150,30160,3,29,10,1,0,0,0,1,340,84,25863,29403,28657,0,41,4,-1444,-2,-253,1503,0,0,0,0,6
EUN1_3569439888',2,26,8,1,0,1,0,7,1,348,96,26077,29562,28560,4,25,9,0,0,1,0,5,388,102,28149,30794,34855,0,-40,-6,-2072,-1,-1232,-6295,1,0,0,0,2
EUN1_3569269828',5,62,9,1,0,0,0,7,1,359,73,26200,28973,32866,4,62,14,1,0,0,0,2,319,97,26881,27618,32359,1,40,-24,-681,-5,1355,507,0,0,0,0,5
EUN1_3569253078',5,25,18,2,1,0,0,4,1,322,96,28279,31401,43224,0,71,7,0,0,0,0,2,359,88,23964,28017,33569,1,-37,8,4315,11,3384,9655,2,1,0,0,2
EUN1_3567879345',5,25,18,2,1,2,0,6,1,420,96,32156,32562,37894,2,22,7,0,0,1,0,7,364,96,25896,28730,18658,1,56,0,6260,11,3832,19236,2,1,1,0,-1
EUN1_3567715462',3,207,13,1,0,0,0,13,1,308,75,27824,28096,29978,2,28,17,1,0,2,0,4,347,100,30398,30867,41738,0,-39,-25,-2574,-4,-2771,-11760,0,0,-2,0,9
EUN1_3567643464',1,73,24,2,0,1,0,9,1,298,91,32183,30331,35230,2,36,11,0,1,1,0,4,386,100,28793,29552,33084,1,-88,-9,3390,13,779,2146,2,-1,0,0,5
EUN1_3567587427',4,31,9,2,0,0,0,9,1,334,98,25214,28096,29118,3,24,9,0,0,1,0,2,327,80,25916,28743,30705,1,7,18,-702,0,-647,-1587,2,0,-1,0,7
EUN1_3567298235',6,144,14,1,0,0,0,7,0,326,88,26715,27828,33306,5,28,9,1,0,0,0,3,364,94,27037,28481,29856,0,-38,-6,-322,5,-653,3450,0,0,0,0,4
EUN1_3567274370',3,27,10,1,0,0,0,11,0,320,92,26001,30736,25953,2,38,10,1,0,2,0,3,356,88,27301,29537,37790,0,-36,4,-1300,0,1199,-11837,0,0,-2,0,8
EUN1_3574640040',2,27,13,2,0,0,0,9,0,321,84,26005,29858,24849,1,20,15,0,0,1,0,1,360,112,29194,30393,31619,0,-39,-28,-3189,-2,-535,-6770,2,0,-1,0,8
EUN1_3574386469',4,37,16,1,0,0,0,13,0,257,84,27779,26879,48044,3,25,28,1,1,3,0,2,309,104,35838,32647,54206,1,-52,-20,-8059,-12,-5768,-6162,0,-1,-3,0,11
EUN1_3574360828',6,30,8,1,1,1,0,4,1,388,84,26570,29845,32350,3,26,3,0,0,0,0,5,348,91,22212,27819,19606,1,40,-7,4358,5,2026,12744,1,1,1,0,-1
EUN1_3573878105',2,39,12,0,0,0,0,11,0,338,80,27220,29674,42510,3,23,21,1,0,1,0,2,365,86,31588,32517,43571,0,-27,-6,-4368,-9,-2843,-1061,-1,0,-1,0,9
EUN1_3573862107',3,25,27,1,0,4,0,11,1,346,98,35639,32783,45459,4,23,13,1,0,1,0,9,283,82,27340,28417,34208,1,63,16,8299,14,4366,11251,0,0,3,0,2
EUN1_3573821002',5,26,17,2,0,1,0,8,0,330,92,30289,30349,35411,4,26,13,0,0,1,0,6,322,100,27084,27225,27583,1,8,-8,3205,4,3124,7828,2,0,0,0,2
EUN1_3573807152',4,28,13,0,0,1,0,8,1,383,80,29399,30307,30064,3,138,11,2,0,0,0,5,333,100,26602,28130,28907,1,50,-20,2797,2,2177,1157,-2,0,1,0,3
EUN1_3573790309',1,17,16,1,0,1,0,10,1,341,91,29021,32796,34623,2,40,10,1,0,1,0,5,331,96,25033,30636,34119,1,10,-5,3988,6,2160,504,0,0,0,0,5
EUN1_3573161972',7,28,14,1,0,1,0,7,1,367,83,29457,29875,41577,1,29,10,1,0,0,0,4,344,84,24694,28975,29114,1,23,-1,4763,4,900,12463,0,0,1,0,3
EUN1_3571475196',2,26,12,1,1,2,0,7,1,387,106,30249,31357,27238,5,32,12,1,0,1,0,6,343,85,26573,28967,26548,1,44,21,3676,0,2390,690,0,1,1,0,1
EUN1_3569724217',5,28,9,1,0,0,0,11,1,361,77,25977,28002,25021,3,20,14,0,0,2,0,1,386,90,27641,30678,34292,0,-25,-13,-1664,-5,-2676,-9271,1,0,-2,0,10
EUN1_3569700292',0,25,10,2,0,0,0,8,1,398,108,26521,30226,25305,1,31,5,0,0,0,0,4,340,76,22615,28201,20773,1,58,32,3906,5,2025,4532,2,0,0,0,4
EUN1_3576203185',4,88,6,1,0,0,0,4,0,357,96,24218,28809,32648,5,38,9,1,0,0,0,3,354,70,24823,27919,26429,0,3,26,-605,-3,890,6219,0,0,0,0,1
EUN1_3576196999',5,41,13,0,0,1,0,12,1,335,94,27384,30386,28469,1,16,7,1,0,1,0,7,321,89,25613,27898,32560,1,14,5,1771,6,2488,-4091,-1,0,0,0,5
EUN1_3575693608',2,28,12,1,0,0,0,9,1,326,72,25288,28733,29736,3,26,15,1,0,1,0,3,372,96,29289,30902,32049,0,-46,-24,-4001,-3,-2169,-2313,0,0,-1,0,6
EUN1_3575687624',2,29,9,1,0,1,0,6,0,384,105,26570,31516,25087,4,30,9,0,0,0,0,3,357,76,25261,26895,23423,1,27,29,1309,0,4621,1664,1,0,1,0,3
EUN1_3574717217',4,26,10,1,1,1,0,9,1,342,87,25840,28881,28983,4,21,4,1,0,0,0,4,375,54,22562,27304,25266,0,-33,33,3278,6,1577,3717,0,1,1,0,5
EUN1_3574695495',2,26,19,0,0,1,0,8,0,407,84,32209,32768,37258,2,37,11,1,0,0,0,7,338,64,25530,28027,30585,1,69,20,6679,8,4741,6673,-1,0,1,0,1
EUN1_3574680262',3,32,10,0,0,0,0,11,0,366,80,26040,28054,32158,4,38,23,2,0,1,0,1,364,116,33333,33284,40227,0,2,-36,-7293,-13,-5230,-8069,-2,0,-1,0,10
EUN1_3574653932',6,39,12,1,0,3,0,5,1,341,79,28853,30578,38240,6,39,5,0,0,0,0,9,328,92,22593,27456,17004,1,13,-13,6260,7,3122,21236,1,0,3,0,-4
EUN1_3574313472',3,19,21,1,0,1,0,12,0,325,85,30112,30897,39985,7,32,23,1,0,2,0,3,346,99,34158,31920,47982,1,-21,-14,-4046,-2,-1023,-7997,0,0,-1,0,9
EUN1_3573887622',5,31,10,0,0,0,0,8,0,339,82,26058,26075,35668,4,39,21,2,0,0,0,1,302,97,28413,29427,45531,0,37,-15,-2355,-11,-3352,-9863,-2,0,0,0,7
EUN1_3575496181',1,126,8,1,1,1,0,6,1,381,73,25587,29471,26057,3,28,9,1,0,0,0,3,350,82,25072,29201,22060,1,31,-9,515,-1,270,3997,0,1,1,0,3
EUN1_3575428000',1,99,5,0,0,0,0,13,1,322,88,22925,26527,20401,3,30,13,2,0,3,0,1,383,112,30747,31286,30408,0,-61,-24,-7822,-8,-4759,-10007,-2,0,-3,0,12
EUN1_3575373771',2,53,16,0,0,1,0,10,1,335,101,29847,29516,39938,3,44,19,2,0,1,0,5,313,98,31280,30783,36720,1,22,3,-1433,-3,-1267,3218,-2,0,0,0,5
EUN1_3575354620',4,30,24,1,0,0,0,8,0,324,73,31448,31178,43009,1,26,19,0,0,1,0,2,316,97,30413,27742,46989,1,8,-24,1035,5,3436,-3980,1,0,-1,0,6
EUN1_3575327230',2,21,19,2,0,2,0,10,1,385,112,31443,33264,46338,3,21,10,0,0,0,0,5,304,72,25231,28986,34366,1,81,40,6212,9,4278,11972,2,0,2,0,5
EUN1_3575260507',3,48,11,0,0,1,0,8,1,337,70,26932,28411,28494,4,29,12,1,0,0,0,2,309,102,26388,26009,32140,0,28,-32,544,-1,2402,-3646,-1,0,1,0,6
EUN1_3575229241',4,32,7,1,0,1,0,8,0,385,100,27132,30231,25082,6,28,5,1,0,0,0,7,364,80,23374,28580,24656,1,21,20,3758,2,1651,426,0,0,1,0,1
EUN1_3574846999',3,47,19,1,0,1,0,8,1,379,72,31762,31208,36787,7,31,16,1,0,1,0,8,366,104,29868,30330,34358,1,13,-32,1894,3,878,2429,0,0,0,0,0
EUN1_3574701915',0,23,11,0,0,1,0,10,1,321,76,25753,28249,25054,2,41,10,2,0,0,0,5,370,100,26287,29279,26334,0,-49,-24,-534,1,-1030,-1280,-2,0,1,0,5
EUN1_3573853979',1,57,17,1,1,1,0,11,0,398,74,31532,33088,37864,3,30,10,0,0,1,0,6,368,91,27220,28946,28704,1,30,-17,4312,7,4142,9160,1,1,0,0,5
EUN1_3576233418',5,24,9,0,0,0,0,11,0,322,77,24163,26145,29155,0,32,15,1,0,2,0,1,370,86,29242,32117,37474,0,-48,-9,-5079,-6,-5972,-8319,-1,0,-2,0,10
EUN1_3576221903',3,22,14,1,0,0,0,7,0,338,88,28242,30347,39371,0,20,9,1,0,1,0,2,331,72,24579,28392,31283,1,7,16,3663,5,1955,8088,0,0,-1,0,5
EUN1_3576206900',5,30,8,0,0,0,0,14,0,245,60,22637,25044,41176,8,52,24,2,0,2,0,2,319,104,32896,30716,53058,0,-74,-44,-10259,-16,-5672,-11882,-2,0,-2,0,12
EUN1_3576214454',3,27,17,1,0,0,0,8,1,337,76,28512,30723,39834,4,30,13,0,0,0,0,4,330,96,26263,28544,33993,1,7,-20,2249,4,2179,5841,1,0,0,0,4
EUN1_3576212284',7,23,16,1,0,1,0,10,1,363,118,31444,31428,33626,3,66,8,0,0,0,0,6,391,64,25063,29493,29443,1,-28,54,6381,8,1935,4183,1,0,1,0,4
EUN1_3575269791',2,32,13,1,0,3,0,10,1,396,102,31117,32099,34666,3,57,7,1,0,0,0,7,322,106,24647,29912,23379,0,74,-4,6470,6,2187,11287,0,0,3,0,3
EUN1_3575258445',3,241,19,0,0,1,0,9,0,332,92,29999,29301,38208,7,30,13,2,0,1,0,3,352,100,28293,30258,32941,1,-20,-8,1706,6,-957,5267,-2,0,0,0,6
EUN1_3567601480',7,32,7,0,1,1,0,6,0,334,84,25272,27123,24952,3,25,11,2,0,0,0,6,367,92,26520,27574,29974,0,-33,-8,-1248,-4,-451,-5022,-2,1,1,0,0
EUN1_3567589510',1,33,5,0,1,0,0,7,0,358,90,24213,27890,18979,6,35,6,2,0,0,0,4,379,97,25081,28790,29909,0,-21,-7,-868,-1,-900,-10930,-2,1,0,0,3
EUN1_3567580365',7,36,5,0,0,0,0,4,0,352,78,23181,27226,24474,3,28,6,1,0,0,0,1,390,94,24701,29352,20819,0,-38,-16,-1520,-1,-2126,3655,-1,0,0,0,3
EUN1_3567575258',4,26,11,1,0,1,0,5,0,410,104,28632,32814,33689,4,34,5,1,0,1,0,4,354,84,23655,28535,17845,1,56,20,4977,6,4279,15844,0,0,0,0,1
EUN1_3567432845',6,26,16,0,0,1,0,4,0,375,72,30720,29543,37990,4,48,17,1,0,0,0,11,310,88,28474,29883,33771,1,65,-16,2246,-1,-340,4219,-1,0,1,0,-7
EUN1_3567238595',4,28,15,2,0,1,0,5,1,405,98,31291,31887,24917,2,17,4,0,0,1,0,6,335,88,23588,28086,26945,1,70,10,7703,11,3801,-2028,2,0,0,0,-1
EUN1_3567213910',4,48,11,1,0,1,0,9,1,373,84,27931,28313,36092,4,37,13,0,1,0,0,6,357,80,27669,28618,28391,1,16,4,262,-2,-305,7701,1,-1,1,0,3
EUN1_3567168198',5,32,11,1,0,2,0,8,0,386,80,28927,30666,42461,2,39,18,0,0,0,0,6,364,83,29098,29754,39952,1,22,-3,-171,-7,912,2509,1,0,2,0,2
EUN1_3567138838',6,38,12,2,0,0,0,10,1,381,92,27826,30712,34718,3,26,10,0,0,2,0,5,398,82,29417,31557,25309,1,-17,10,-1591,2,-845,9409,2,0,-2,0,5
EUN1_3567120625',4,25,17,1,1,0,0,9,0,347,144,30179,32718,37574,3,35,7,1,0,1,0,5,328,74,24269,26307,25350,1,19,70,5910,10,6411,12224,0,1,-1,0,4
EUN1_3567097924',3,25,11,0,0,0,0,2,1,365,88,26256,28669,34381,4,28,9,2,0,0,0,2,315,79,24520,26219,31368,1,50,9,1736,2,2450,3013,-2,0,0,0,0
EUN1_3566964920',3,23,8,1,0,2,0,11,1,365,100,27605,29058,31823,2,31,11,1,0,0,0,4,357,99,26183,29380,27066,1,8,1,1422,-3,-322,4757,0,0,2,0,7
EUN1_3566958148',7,33,19,1,0,0,0,8,0,300,70,28615,29369,41515,2,69,17,1,0,1,0,2,340,84,29787,26702,37397,1,-40,-14,-1172,2,2667,4118,0,0,-1,0,6
EUN1_3566945192',2,24,13,1,0,2,0,7,0,326,80,27832,29191,36657,3,23,10,0,0,0,0,7,315,108,25051,28647,30601,1,11,-28,2781,3,544,6056,1,0,2,0,0
EUN1_3566929466',2,25,5,0,0,0,0,12,0,346,74,23071,25786,25621,4,24,20,1,0,2,0,0,365,90,31692,31669,42101,0,-19,-16,-8621,-15,-5883,-16480,-1,0,-2,0,12
EUN1_3566909341',6,30,9,2,0,1,0,12,1,361,94,27234,29316,28142,3,27,13,0,1,1,0,1,328,94,28025,30127,32120,0,33,0,-791,-4,-811,-3978,2,-1,0,0,11
EUN1_3566871047',2,25,15,0,0,1,0,11,0,345,80,29533,29741,31888,4,29,14,2,0,0,0,5,376,95,28830,29203,38710,0,-31,-15,703,1,538,-6822,-2,0,1,0,6
EUN1_3575607902',5,37,11,0,0,0,0,10,0,325,76,25576,29251,32700,2,24,17,2,0,2,0,1,377,80,29952,30468,35406,0,-52,-4,-4376,-6,-1217,-2706,-2,0,-2,0,9
EUN1_3575601155',5,31,30,2,1,4,0,6,0,350,97,38372,32929,55124,2,26,12,0,0,0,0,11,296,78,26523,28092,34218,1,54,19,11849,18,4837,20906,2,1,4,0,-5
EUN1_3575573800',4,27,15,2,0,2,0,7,0,338,112,29427,32005,41366,4,33,15,0,0,0,0,5,299,56,26072,26889,33386,1,39,56,3355,0,5116,7980,2,0,2,0,2
EUN1_3575552834',2,24,7,0,1,1,0,8,0,368,81,25278,29878,25477,7,31,14,2,0,0,0,3,354,81,27142,31108,29658,0,14,0,-1864,-7,-1230,-4181,-2,1,1,0,5
EUN1_3575542202',2,22,20,1,0,1,0,7,1,410,127,32234,34469,34631,3,27,1,0,0,1,0,5,348,72,21086,25545,23191,1,62,55,11148,19,8924,11440,1,0,0,0,2
EUN1_3575516095',1,18,5,1,0,0,0,14,0,339,79,23611,27404,26370,4,47,15,1,0,2,0,1,350,112,30334,31180,30217,0,-11,-33,-6723,-10,-3776,-3847,0,0,-2,0,13
EUN1_3575484521',1,42,18,0,0,0,0,6,0,351,86,28263,31404,43642,1,28,12,2,0,0,0,5,339,93,26220,30102,33424,1,12,-7,2043,6,1302,10218,-2,0,0,0,1
EUN1_3575463115',6,29,19,1,1,2,0,14,0,357,92,31935,32588,37875,3,21,5,1,0,0,0,6,390,88,25073,28639,31000,1,-33,4,6862,14,3949,6875,0,1,2,0,8
EUN1_3575268811',3,21,8,1,0,1,0,10,0,331,94,25421,29701,22415,3,93,14,0,0,0,0,7,352,94,28670,30862,35731,0,-21,0,-3249,-6,-1161,-13316,1,0,1,0,3
EUN1_3575167940',3,34,11,2,1,0,0,2,0,388,102,27102,32439,26527,4,32,6,0,0,0,0,6,375,84,24471,29071,24191,1,13,18,2631,5,3368,2336,2,1,0,0,-4
EUN1_3575172131',4,22,25,1,0,1,0,6,1,358,104,33752,33192,41004,6,30,7,1,0,0,0,9,323,67,22825,24605,27123,1,35,37,10927,18,8587,13881,0,0,1,0,-3
EUN1_3575060322',3,22,7,0,0,0,0,5,1,354,80,24414,27645,25287,2,23,9,2,0,0,0,5,375,80,25861,30022,24774,1,-21,0,-1447,-2,-2377,513,-2,0,0,0,0
EUN1_3575037553',5,24,12,2,0,0,0,10,1,380,100,28819,30868,32777,5,29,10,0,0,2,0,4,364,88,27376,30804,26754,1,16,12,1443,2,64,6023,2,0,-2,0,6
EUN1_3568863695',3,34,21,2,1,2,0,4,1,371,116,32153,32742,42375,5,96,10,0,0,0,0,7,280,72,24308,25873,32187,1,91,44,7845,11,6869,10188,2,1,2,0,-3
EUN1_3568864201',3,23,17,2,0,0,0,4,1,358,108,29324,31479,38507,4,28,8,0,0,1,0,6,316,79,24476,26247,22147,1,42,29,4848,9,5232,16360,2,0,-1,0,-2
EUN1_3568760230',3,29,8,1,0,1,0,5,1,362,86,26920,28518,24265,4,27,8,0,0,0,0,5,373,80,25303,29172,25000,1,-11,6,1617,0,-654,-735,1,0,1,0,0
EUN1_3568321872',4,76,13,1,1,2,0,8,0,349,74,28450,30692,35199,3,27,10,0,0,0,0,6,324,82,25650,27566,29996,1,25,-8,2800,3,3126,5203,1,1,2,0,2
EUN1_3567916552',2,28,15,0,0,1,0,7,0,358,66,29379,28982,32842,6,42,13,2,1,0,0,6,333,78,27075,28684,32800,1,25,-12,2304,2,298,42,-2,-1,1,0,1
EUN1_3567634785',3,29,20,2,0,2,0,8,1,381,106,32305,33243,41534,5,27,10,0,0,1,0,7,355,70,26671,26794,30231,1,26,36,5634,10,6449,11303,2,0,1,0,1
EUN1_3567584279',7,32,9,1,0,0,0,7,0,347,85,25569,27617,26526,3,27,9,1,0,1,0,2,363,90,27642,29902,28891,0,-16,-5,-2073,0,-2285,-2365,0,0,-1,0,5
EUN1_3567474837',5,28,14,0,0,1,0,12,1,323,59,28425,29082,31323,5,33,14,2,0,2,0,5,358,103,29581,30079,31767,0,-35,-44,-1156,0,-997,-444,-2,0,-1,0,7
EUN1_3567406443',4,308,7,1,0,0,0,7,0,363,80,24625,28405,27592,4,47,9,0,0,0,0,3,326,64,23437,25870,24925,0,37,16,1188,-2,2535,2667,1,0,0,0,4
EUN1_3566447748',2,25,14,2,0,4,0,7,1,367,102,31752,31859,25937,2,18,5,0,0,0,0,11,338,93,22681,27708,28325,1,29,9,9071,9,4151,-2388,2,0,4,0,-4
EUN1_3566437831',2,24,16,2,0,1,0,6,1,309,107,29332,29438,36073,4,27,8,0,0,0,0,3,371,48,24457,27384,33700,1,-62,59,4875,8,2054,2373,2,0,1,0,3
EUN1_3566428425',3,23,12,1,0,0,0,10,1,350,66,26778,27458,28530,4,28,14,1,0,1,0,0,336,86,28341,28724,33644,1,14,-20,-1563,-2,-1266,-5114,0,0,-1,0,10
EUN1_3566414371',4,29,7,1,0,1,0,7,0,356,80,24939,29100,28747,2,186,6,1,0,1,0,1,362,80,24715,28505,25097,0,-6,0,224,1,595,3650,0,0,0,0,6
EUN1_3575964502',5,27,9,1,0,0,0,11,1,308,82,24494,26864,31104,2,25,15,0,0,0,0,3,355,84,28303,33041,36877,0,-47,-2,-3809,-6,-6177,-5773,1,0,0,0,8
EUN1_3575909445',2,25,8,1,0,0,0,7,0,351,84,25109,28564,22998,4,25,16,1,0,2,0,2,349,104,30651,31694,33613,0,2,-20,-5542,-8,-3130,-10615,0,0,-2,0,5
EUN1_3575879897',8,41,14,2,0,0,0,10,1,316,76,27081,28698,30922,1,25,12,0,0,2,0,3,369,95,28971,30864,30749,0,-53,-19,-1890,2,-2166,173,2,0,-2,0,7
EUN1_3575593557',1,19,10,1,0,0,0,15,1,259,118,26081,27376,24644,5,31,19,1,1,3,0,4,398,98,31883,31515,36864,0,-139,20,-5802,-9,-4139,-12220,0,-1,-3,0,11
EUN1_3575575268',6,24,19,1,1,1,0,16,1,336,99,31432,30927,37670,7,36,16,1,0,2,0,3,288,78,28667,27884,33339,1,48,21,2765,3,3043,4331,0,1,-1,0,13
EUN1_3575549493',2,24,20,1,0,1,0,8,1,301,73,31247,30565,36031,7,26,14,1,0,0,0,2,328,76,26302,26787,32727,1,-27,-3,4945,6,3778,3304,0,0,1,0,6
EUN1_3575061216',0,25,14,0,0,0,0,7,1,334,86,27418,29169,34514,1,26,11,0,0,0,0,3,336,88,26692,28708,32936,0,-2,-2,726,3,461,1578,0,0,0,0,4
EUN1_3575034842',5,27,21,0,0,0,0,10,1,323,78,30454,30198,42810,2,25,15,2,0,2,0,6,350,84,30264,30035,42693,0,-27,-6,190,6,163,117,-2,0,-2,0,4
EUN1_3574547563',5,27,15,1,1,0,0,10,1,344,90,28333,31155,36714,2,43,15,1,0,1,0,4,366,110,29776,30522,31746,0,-22,-20,-1443,0,633,4968,0,1,-1,0,6
EUN1_3574519862',3,29,7,1,0,0,0,14,0,305,78,25131,26738,26430,4,30,16,1,0,2,0,0,381,90,30162,31922,33698,1,-76,-12,-5031,-9,-5184,-7268,0,0,-2,0,14
EUN1_3576151985',4,25,12,0,0,1,0,5,0,365,79,27358,28343,37395,6,32,8,2,1,0,0,2,336,96,25019,30565,24605,1,29,-17,2339,4,-2222,12790,-2,-1,1,0,3
EUN1_3575928873',6,30,19,1,0,2,0,13,1,388,96,33587,32945,36688,2,29,9,0,0,1,0,4,323,91,25956,27791,30162,1,65,5,7631,10,5154,6526,1,0,1,0,9
EUN1_3575870116',5,24,23,0,0,3,0,9,1,357,96,35468,31110,47528,4,20,16,2,1,2,0,11,287,84,29554,30234,40590,0,70,12,5914,7,876,6938,-2,-1,1,0,-2
EUN1_3575502278',6,33,22,0,0,1,0,7,0,307,82,31970,30431,43368,5,30,16,2,0,1,0,8,274,79,28018,28525,38208,1,33,3,3952,6,1906,5160,-2,0,0,0,-1
EUN1_3575410602',0,119,15,0,1,2,0,12,1,373,98,30364,30665,32987,5,20,14,2,0,2,0,7,328,114,28366,27959,31610,1,45,-16,1998,1,2706,1377,-2,1,0,0,5
EUN1_3574245251',5,47,13,0,0,1,0,8,0,336,70,28112,27289,37848,5,32,12,2,0,0,0,8,283,58,24380,24902,27788,0,53,12,3732,1,2387,10060,-2,0,1,0,0
EUN1_3574186474',2,29,13,1,0,1,0,9,0,385,90,28439,28414,28565,2,29,16,1,1,1,0,5,340,100,30389,29704,31394,1,45,-10,-1950,-3,-1290,-2829,0,-1,0,0,4
EUN1_3573724747',8,25,20,0,0,2,0,10,1,383,57,31079,31267,37489,4,26,13,1,1,1,0,6,327,88,28298,28981,32795,0,56,-31,2781,7,2286,4694,-1,-1,1,0,4
EUN1_3573667565',2,32,9,0,0,3,0,3,1,369,88,28923,27749,25784,3,97,10,2,0,0,0,13,312,76,25106,27779,19613,1,57,12,3817,-1,-30,6171,-2,0,3,0,-10
EUN1_3573645058',5,25,5,0,0,0,0,13,0,327,90,24267,27581,20986,4,36,15,2,0,2,0,4,383,89,29784,30375,31586,0,-56,1,-5517,-10,-2794,-10600,-2,0,-2,0,9
EUN1_3573341422',6,25,12,1,0,0,0,9,1,283,91,26972,27825,30527,6,34,7,0,0,2,0,8,358,91,26180,29344,29169,0,-75,0,792,5,-1519,1358,1,0,-2,0,1
EUN1_3573312242',4,25,15,2,0,0,0,10,0,310,90,28011,29095,40404,2,18,21,0,0,2,0,3,288,82,30722,29637,39715,1,22,8,-2711,-6,-542,689,2,0,-2,0,7
EUN1_3573284177',8,30,10,0,0,0,0,6,1,360,80,25732,29307,31870,7,29,13,2,0,0,0,1,369,100,26929,30786,26556,0,-9,-20,-1197,-3,-1479,5314,-2,0,0,0,5
EUN1_3573250284',5,30,19,1,0,0,0,14,0,325,94,29525,30652,40903,1,29,15,1,0,2,0,2,316,63,28331,27891,31189,1,9,31,1194,4,2761,9714,0,0,-2,0,12
EUN1_3576231168',6,26,14,0,0,0,0,9,0,333,92,27478,29609,34171,2,31,18,2,0,1,0,4,355,88,29416,30622,36808,0,-22,4,-1938,-4,-1013,-2637,-2,0,-1,0,5
EUN1_3576143408',2,27,22,1,0,0,0,7,0,287,92,30828,31127,41121,3,34,17,1,0,0,0,2,320,68,28630,29351,41236,1,-33,24,2198,5,1776,-115,0,0,0,0,5
EUN1_3576122325',6,29,11,1,0,1,0,11,0,365,98,27579,30273,35171,0,18,13,1,0,1,0,4,348,126,28830,31885,24806,0,17,-28,-1251,-2,-1612,10365,0,0,0,0,7
EUN1_3576098568',2,23,10,0,0,1,0,8,0,342,94,27447,29044,29241,4,25,17,1,0,2,0,5,343,70,29646,31076,30166,1,-1,24,-2199,-7,-2032,-925,-1,0,-1,0,3
EUN1_3576078658',4,29,28,1,0,3,0,8,0,341,83,35745,32534,47614,3,332,22,1,0,0,0,8,296,99,31667,29866,40269,1,45,-16,4078,6,2668,7345,0,0,3,0,0
EUN1_3576042226',4,26,11,1,0,1,0,8,1,358,69,27911,27533,29016,3,32,18,1,0,2,0,6,367,110,30875,31896,36718,0,-9,-41,-2964,-7,-4363,-7702,0,0,-1,0,2
EUN1_3575809229',4,35,9,0,0,0,0,8,0,304,88,24641,25702,32943,4,272,20,1,0,1,0,1,375,88,31070,30241,38887,1,-71,0,-6429,-11,-4539,-5944,-1,0,-1,0,7
EUN1_3575783547',4,23,9,1,1,1,0,7,1,395,102,27912,30314,27798,2,78,11,0,0,0,0,6,356,98,27984,30352,24544,1,39,4,-72,-2,-38,3254,1,1,1,0,1
EUN1_3575764632',0,39,13,1,0,1,0,11,0,361,116,30231,31899,29029,4,20,16,0,0,1,0,5,324,84,27281,29537,31663,1,37,32,2950,-3,2362,-2634,1,0,0,0,6
EUN1_3575750748',5,29,23,2,0,2,0,7,1,385,116,34022,34370,39961,0,25,3,0,0,1,0,9,304,64,22312,25564,22450,1,81,52,11710,20,8806,17511,2,0,1,0,-2
EUN1_3575657296',5,30,5,1,0,1,0,12,0,400,78,25423,27750,24403,5,26,17,1,0,2,0,6,372,75,29219,30269,27426,0,28,3,-3796,-12,-2519,-3023,0,0,-1,0,6
EUN1_3575646164',2,17,20,2,0,2,0,9,1,360,96,34031,29285,41980,3,24,12,0,0,1,0,6,287,86,26670,25405,36842,1,73,10,7361,8,3880,5138,2,0,1,0,3
EUN1_3575627552',1,24,30,1,0,2,0,8,1,342,110,37827,33977,43783,2,32,15,0,0,0,0,9,344,86,29088,29439,34331,1,-2,24,8739,15,4538,9452,1,0,2,0,-1
EUN1_3575598872',2,31,22,0,0,1,0,12,1,385,98,32446,31743,36387,6,32,11,1,0,1,0,5,315,90,27845,29025,30612,1,70,8,4601,11,2718,5775,-1,0,0,0,7
EUN1_3575579926',3,29,22,1,0,2,0,14,1,351,90,32833,32841,38431,5,74,11,0,0,1,0,5,345,74,27134,28808,35155,1,6,16,5699,11,4033,3276,1,0,1,0,9
EUN1_3575543874',0,36,11,0,0,0,0,11,1,339,86,26540,28857,32787,1,27,18,2,0,2,0,0,390,102,32318,32807,34299,1,-51,-16,-5778,-7,-3950,-1512,-2,0,-2,0,11
EUN1_3572918753',5,97,17,0,1,0,0,6,1,354,106,28906,31120,33330,4,58,12,2,0,0,0,2,307,86,26418,27437,28655,0,47,20,2488,5,3683,4675,-2,1,0,0,4
EUN1_3572907240',3,28,13,1,0,1,0,15,1,341,86,28976,27972,34490,4,27,17,1,0,2,0,6,306,82,30585,29497,40002,0,35,4,-1609,-4,-1525,-5512,0,0,-1,0,9
EUN1_3566042448',2,28,8,0,0,0,0,9,1,324,102,24563,29049,24675,5,29,19,2,0,1,0,2,349,94,31306,31300,43716,0,-25,8,-6743,-11,-2251,-19041,-2,0,-1,0,7
EUN1_3566036467',1,50,20,1,1,0,0,9,0,350,92,31306,31409,39572,4,26,14,1,0,0,0,5,345,71,27954,27966,35395,0,5,21,3352,6,3443,4177,0,1,0,0,4
EUN1_3566029461',3,32,22,1,0,1,0,6,0,319,80,31640,30208,39791,4,77,17,0,0,1,0,5,267,76,27064,26024,31725,1,52,4,4576,5,4184,8066,1,0,0,0,1
EUN1_3566030105',2,35,22,1,0,1,0,6,0,353,70,30773,31454,46560,3,27,11,1,1,0,0,3,313,78,25327,27634,34439,1,40,-8,5446,11,3820,12121,0,-1,1,0,3
EUN1_3565438537',2,26,9,0,0,0,0,5,0,297,80,24702,27163,30071,5,30,20,2,0,1,0,2,313,96,30453,29413,34030,0,-16,-16,-5751,-11,-2250,-3959,-2,0,-1,0,3
EUN1_3565404227',1,42,17,1,0,1,0,9,1,339,86,30090,29605,35585,1,28,14,0,0,0,0,4,305,94,27028,27995,38173,1,34,-8,3062,3,1610,-2588,1,0,1,0,5
EUN1_3564409314',2,27,8,0,0,0,0,13,1,262,92,24024,25618,30546,4,23,18,2,1,3,0,0,380,79,31477,30955,39450,0,-118,13,-7453,-10,-5337,-8904,-2,-1,-3,0,13
EUN1_3564374971',5,51,12,1,0,1,0,9,1,355,78,29158,29165,30692,2,26,14,0,0,0,0,6,322,90,28016,29173,34489,1,33,-12,1142,-2,-8,-3797,1,0,1,0,3
EUN1_3564356854',3,25,11,0,0,0,0,9,1,351,80,25609,29030,27565,1,23,13,2,0,1,0,0,351,76,27482,28819,29706,0,0,4,-1873,-2,211,-2141,-2,0,-1,0,9
EUN1_3564258955',1,27,11,0,0,0,0,9,1,279,80,24322,25157,36757,6,95,14,2,1,0,0,0,344,76,27573,29699,39718,0,-65,4,-3251,-3,-4542,-2961,-2,-1,0,0,9
EUN1_3563468630',3,28,6,1,0,0,0,8,0,371,90,25125,28393,21734,4,28,8,0,0,0,0,3,351,82,25215,28959,31747,1,20,8,-90,-2,-566,-10013,1,0,0,0,5
EUN1_3563445340',3,38,16,1,0,1,0,10,1,316,96,29892,28807,31423,4,63,16,0,0,1,0,4,324,84,29486,28141,36571,1,-8,12,406,0,666,-5148,1,0,0,0,6
EUN1_3561466091',3,41,19,2,0,1,0,9,1,349,86,30682,31168,36753,2,26,12,0,0,0,0,5,298,70,26033,27703,25876,1,51,16,4649,7,3465,10877,2,0,1,0,4
EUN1_3575979999',1,42,17,1,0,0,0,13,0,336,72,28667,28137,36304,5,29,19,1,1,0,0,2,305,112,30286,29332,41263,1,31,-40,-1619,-2,-1195,-4959,0,-1,0,0,11
EUN1_3575957290',2,20,10,0,0,0,0,10,1,330,94,25756,28274,25023,2,29,16,1,0,1,0,2,385,76,29647,31619,36886,1,-55,18,-3891,-6,-3345,-11863,-1,0,-1,0,8
EUN1_3575920390',2,22,8,0,0,0,0,12,0,331,98,25052,28002,25999,2,21,15,1,0,2,0,1,385,74,30428,31604,37181,0,-54,24,-5376,-7,-3602,-11182,-1,0,-2,0,11
EUN1_3575523675',2,22,7,1,0,0,0,10,0,307,64,23310,26829,35737,8,36,12,1,0,1,0,4,330,112,27980,30547,38089,0,-23,-48,-4670,-5,-3718,-2352,0,0,-1,0,6
EUN1_3573729375',4,45,14,2,0,0,0,9,1,360,78,27236,29870,33269,2,24,11,0,0,1,0,1,344,106,28276,30221,38318,1,16,-28,-1040,3,-351,-5049,2,0,-1,0,8
EUN1_3570719796',2,21,7,1,0,0,0,9,0,355,104,24704,28607,22305,3,19,12,1,0,1,0,1,363,92,27896,31006,34462,0,-8,12,-3192,-5,-2399,-12157,0,0,-1,0,8
EUN1_3568613135',2,20,22,2,1,2,0,8,1,374,100,31979,33586,49855,3,26,7,0,0,0,0,4,311,72,23221,26602,28509,1,63,28,8758,15,6984,21346,2,1,2,0,4
EUN1_3568210049',8,26,9,1,0,0,0,12,0,345,84,24792,28509,28056,4,28,12,0,0,1,0,1,342,92,27012,29830,28812,0,3,-8,-2220,-3,-1321,-756,1,0,-1,0,11
EUN1_3568161991',3,27,15,0,0,1,0,8,0,296,96,29027,28984,46047,2,35,19,2,0,0,0,6,292,88,29724,29474,35707,1,4,8,-697,-4,-490,10340,-2,0,1,0,2
EUN1_3567887927',3,33,18,1,0,2,0,10,1,344,70,30237,30095,36498,8,256,8,0,0,0,0,3,355,90,24880,28570,31033,1,-11,-20,5357,10,1525,5465,1,0,2,0,7
EUN1_3567861753',3,22,13,1,0,0,0,9,0,344,78,26659,28487,33603,1,25,16,1,0,1,0,2,372,81,29842,31330,31957,0,-28,-3,-3183,-3,-2843,1646,0,0,-1,0,7
EUN1_3567834564',5,24,12,0,0,0,0,7,1,319,92,27525,28690,24310,4,35,12,1,0,1,0,1,347,76,26438,28794,28257,1,-28,16,1087,0,-104,-3947,-1,0,-1,0,6
EUN1_3567723266',4,27,11,1,0,1,0,9,1,362,68,27382,29580,31353,4,38,13,0,0,1,0,1,337,83,28773,29776,31484,1,25,-15,-1391,-2,-196,-131,1,0,0,0,8
EUN1_3567708119',2,30,15,0,1,3,0,10,1,375,99,31360,31245,32687,7,38,7,2,0,1,0,5,326,73,23250,27211,31195,1,49,26,8110,8,4034,1492,-2,1,2,0,5
EUN1_3567688153',0,39,12,0,0,0,0,7,1,334,91,27962,28880,37365,3,22,18,2,1,1,0,0,370,99,30520,31563,38389,0,-36,-8,-2558,-6,-2683,-1024,-2,-1,-1,0,7
EUN1_3567363391',2,34,11,0,0,0,0,14,1,349,82,27704,28157,27445,2,30,13,1,1,2,0,7,322,98,29231,29716,33994,1,27,-16,-1527,-2,-1559,-6549,-1,-1,-2,0,7
EUN1_3567333763',3,24,12,1,0,0,0,10,0,346,109,26854,31212,36135,7,97,10,0,0,2,0,2,383,82,28516,28751,34338,1,-37,27,-1662,2,2461,1797,1,0,-2,0,8
EUN1_3567304557',4,262,9,2,0,1,0,12,1,352,94,26437,29953,37756,3,38,9,0,0,2,0,0,392,85,27874,31134,27915,0,-40,9,-1437,0,-1181,9841,2,0,-1,0,12
EUN1_3575778796',7,29,18,0,0,1,0,11,1,331,84,30178,31290,40110,0,31,15,1,0,1,0,6,342,98,29882,31719,35466,0,-11,-14,296,3,-429,4644,-1,0,0,0,5
EUN1_3575776244',3,34,22,2,0,2,0,13,1,376,117,34300,34533,37033,0,20,8,0,0,1,0,5,346,79,25714,27562,20965,1,30,38,8586,14,6971,16068,2,0,1,0,8
EUN1_3575758278',3,64,17,0,0,1,0,11,1,378,80,31228,32068,31419,2,59,7,2,0,1,0,5,336,92,24218,28183,29544,1,42,-12,7010,10,3885,1875,-2,0,0,0,6
EUN1_3569708181',5,27,13,1,0,0,0,16,1,324,96,27325,30247,35148,6,24,14,0,0,3,0,2,380,92,30484,30247,32641,1,-56,4,-3159,-1,0,2507,1,0,-3,0,14
EUN1_3568937911',6,27,17,1,0,1,0,7,1,335,71,29083,28886,34874,2,23,11,0,0,0,0,7,357,77,26453,29648,34989,1,-22,-6,2630,6,-762,-115,1,0,1,0,0
EUN1_3568062345',4,28,14,0,0,2,0,10,0,394,86,29730,31770,33388,3,25,9,1,0,1,0,5,326,94,26015,28281,29332,1,68,-8,3715,5,3489,4056,-1,0,1,0,5
EUN1_3568048556',2,22,10,1,1,0,0,1,1,384,88,26735,30558,22396,5,30,5,1,0,0,0,3,335,103,24347,29007,25272,1,49,-15,2388,5,1551,-2876,0,1,0,0,-2
EUN1_3568044179',3,28,9,0,0,0,0,9,0,327,74,24546,29021,29682,2,131,13,2,0,1,0,0,361,100,28718,30025,35166,0,-34,-26,-4172,-4,-1004,-5484,-2,0,-1,0,9
EUN1_3568029575',2,83,7,0,0,0,0,19,0,324,79,24646,27135,27226,2,32,21,2,1,3,0,2,380,105,33368,34899,42467,0,-56,-26,-8722,-14,-7764,-15241,-2,-1,-3,0,17
EUN1_3566606764',5,28,25,0,0,1,0,12,1,387,91,32286,34036,53035,4,34,10,2,0,1,0,3,282,76,23112,27610,29612,1,105,15,9174,15,6426,23423,-2,0,0,0,9
EUN1_3566597200',4,250,16,1,0,1,0,8,1,405,114,31378,32111,33730,1,31,10,1,0,0,0,5,312,82,25542,28289,28068,1,93,32,5836,6,3822,5662,0,0,1,0,3
EUN1_3566290730',7,32,13,1,0,0,0,9,1,374,91,28434,31912,30998,2,30,9,1,0,1,0,2,386,112,28771,30641,27646,0,-12,-21,-337,4,1271,3352,0,0,-1,0,7
EUN1_3566273507',2,25,10,0,0,1,0,7,0,377,92,27668,30925,30446,0,202,16,2,1,0,0,3,330,96,28415,29430,32968,0,47,-4,-747,-6,1495,-2522,-2,-1,1,0,4
EUN1_3576149647',3,22,5,0,0,0,0,5,1,396,90,24624,29410,28196,5,35,7,2,0,1,0,1,361,78,24657,28746,25804,1,35,12,-33,-2,664,2392,-2,0,-1,0,4
EUN1_3575622189',4,24,7,1,0,0,0,5,1,359,94,24893,29681,31418,1,27,9,1,0,0,0,1,341,86,25455,29771,28253,0,18,8,-562,-2,-90,3165,0,0,0,0,4
EUN1_3575596564',5,26,13,1,1,0,0,11,1,308,78,26628,28148,28758,2,26,14,1,0,1,0,2,364,86,28530,28699,26956,0,-56,-8,-1902,-1,-551,1802,0,1,-1,0,9
EUN1_3575568464',4,23,11,0,0,0,0,9,1,346,93,25660,28252,24684,4,23,9,1,0,0,0,2,420,106,27031,31457,25124,0,-74,-13,-1371,2,-3205,-440,-1,0,0,0,7
EUN1_3574423718',0,24,3,0,0,0,0,16,0,328,72,21004,25247,19785,3,31,19,2,0,3,0,1,409,115,33057,33983,36422,0,-81,-43,-12053,-16,-8736,-16637,-2,0,-3,0,15
EUN1_3573273992',5,27,18,2,0,2,0,6,1,353,124,30881,32422,33787,0,21,2,0,0,0,0,8,323,96,22137,27035,18262,1,30,28,8744,16,5387,15525,2,0,2,0,-2
EUN1_3573247230',3,44,19,0,0,0,0,7,1,350,57,29252,30973,40668,3,22,10,2,0,1,0,3,324,98,25965,27897,31794,1,26,-41,3287,9,3076,8874,-2,0,-1,0,4
EUN1_3573026212',4,31,13,2,0,0,0,7,0,375,79,28677,28896,26322,5,103,17,0,0,1,0,5,359,83,29977,29685,41305,0,16,-4,-1300,-4,-789,-14983,2,0,-1,0,2
EUN1_3572704663',5,236,9,2,0,1,0,5,1,397,79,28199,29327,24428,1,33,11,0,0,0,0,8,366,74,25692,29830,24103,1,31,5,2507,-2,-503,325,2,0,1,0,-3
EUN1_3572683823',2,30,10,1,1,0,0,6,0,369,84,26509,29896,26844,5,23,14,0,0,1,0,4,374,84,27238,29914,34776,1,-5,0,-729,-4,-18,-7932,1,1,-1,0,2
EUN1_3572665116',4,26,16,2,0,0,0,11,0,355,108,29263,31044,37647,8,34,11,0,0,2,0,2,372,88,28570,30496,32455,0,-17,20,693,5,548,5192,2,0,-2,0,9
EUN1_3572515467',5,28,15,1,0,2,0,3,1,383,106,30808,30774,31865,4,22,5,1,0,0,0,8,338,102,22427,28336,23985,1,45,4,8381,10,2438,7880,0,0,2,0,-5
EUN1_3572420491',4,38,16,0,0,0,0,12,1,365,77,29709,29239,33414,5,34,18,2,0,1,0,5,370,78,28900,30748,32425,0,-5,-1,809,-2,-1509,989,-2,0,-1,0,7
EUN1_3571897274',3,25,9,0,1,1,0,8,1,419,91,27805,30650,31299,3,77,12,2,0,0,0,6,350,103,27416,30361,28627,0,69,-12,389,-3,289,2672,-2,1,1,0,2
EUN1_3571875665',2,19,17,0,0,2,0,4,0,315,84,29797,29403,35887,5,25,16,2,1,0,0,8,299,92,26460,27868,31342,0,16,-8,3337,1,1535,4545,-2,-1,2,0,-4
EUN1_3571869525',2,22,9,2,0,1,0,10,0,326,100,26960,29015,25198,3,24,16,0,0,1,0,4,337,80,28673,30445,32444,1,-11,20,-1713,-7,-1430,-7246,2,0,0,0,6
EUN1_3571864528',4,22,15,1,0,0,0,16,0,311,68,27680,28054,37068,2,25,21,0,0,4,0,3,387,84,34935,31592,39081,0,-76,-16,-7255,-6,-3538,-2013,1,0,-4,0,13
EUN1_3571767565',6,28,12,1,1,1,0,5,0,371,112,27627,31156,33488,3,18,3,1,0,0,0,5,389,95,23827,29259,19383,1,-18,17,3800,9,1897,14105,0,1,1,0,0
EUN1_3571743597',5,30,8,1,0,0,0,3,0,342,90,24091,28919,24242,3,21,11,1,0,0,0,2,355,96,26056,30614,28173,1,-13,-6,-1965,-3,-1695,-3931,0,0,0,0,1
EUN1_3571285022',4,55,13,0,0,0,0,3,1,373,92,29918,28807,33855,7,26,13,1,0,1,0,8,286,76,25960,26774,42175,0,87,16,3958,0,2033,-8320,-1,0,-1,0,-5
EUN1_3568092366',3,31,16,1,0,0,0,17,1,313,68,28316,27921,33030,4,216,17,0,1,3,0,4,345,92,31499,29157,46009,1,-32,-24,-3183,-1,-1236,-12979,1,-1,-3,0,13
EUN1_3568082125',5,32,18,2,0,0,0,3,1,394,116,32426,31979,37673,2,32,9,0,0,1,0,8,349,81,25573,28500,27051,1,45,35,6853,9,3479,10622,2,0,-1,0,-5
EUN1_3567611407',6,26,14,0,0,1,0,10,1,362,78,29043,30284,34966,1,163,5,1,0,0,0,3,362,106,24242,28480,28375,1,0,-28,4801,9,1804,6591,-1,0,1,0,7
EUN1_3567601138',2,23,12,0,0,2,0,8,1,350,92,27859,28984,34840,6,23,10,1,0,0,0,3,279,76,24903,26073,25880,0,71,16,2956,2,2911,8960,-1,0,2,0,5
EUN1_3566566374',5,30,18,0,0,0,0,4,1,281,82,29868,27843,33952,3,24,20,1,0,1,0,1,368,82,30737,30795,37803,1,-87,0,-869,-2,-2952,-3851,-1,0,-1,0,3
EUN1_3566532763',3,30,17,2,0,2,0,7,1,370,112,31074,33211,36368,4,24,5,0,0,0,0,6,349,80,23249,28126,23444,0,21,32,7825,12,5085,12924,2,0,2,0,1
EUN1_3565368454',3,25,17,1,0,0,0,7,1,296,69,29137,28282,39536,3,50,22,0,1,0,0,5,293,86,29987,28317,43798,1,3,-17,-850,-5,-35,-4262,1,-1,0,0,2
EUN1_3565014910',6,27,8,2,0,0,0,7,1,345,88,24094,29211,32629,3,31,10,0,0,1,0,1,380,104,27187,30999,33598,0,-35,-16,-3093,-2,-1788,-969,2,0,-1,0,6
EUN1_3564759482',7,30,13,0,0,0,0,10,0,328,96,27813,29274,32179,3,20,21,1,1,0,0,5,328,87,31119,30575,38332,0,0,9,-3306,-8,-1301,-6153,-1,-1,0,0,5
EUN1_3564742991',4,23,10,2,0,0,0,10,0,377,98,26029,31771,28423,3,21,14,0,0,1,0,6,353,98,29444,30289,24779,1,24,0,-3415,-4,1482,3644,2,0,-1,0,4
EUN1_3564731989',2,20,16,0,1,2,0,10,1,392,89,29579,31487,31535,5,22,6,2,0,1,0,7,317,114,25870,28161,24477,1,75,-25,3709,10,3326,7058,-2,1,1,0,3
EUN1_3564723785',3,31,6,1,0,0,0,9,0,312,114,23523,27676,25941,5,23,10,1,0,2,0,2,356,90,26722,30651,29755,0,-44,24,-3199,-4,-2975,-3814,0,0,-2,0,7
EUN1_3564716796',2,79,19,1,0,2,0,8,1,289,82,29788,28865,35612,3,25,5,0,0,0,0,4,320,91,23316,25925,26466,1,-31,-9,6472,14,2940,9146,1,0,2,0,4
EUN1_3564415627',6,25,14,1,1,0,0,3,1,412,116,28993,32216,29536,1,25,7,0,0,0,0,5,372,91,25125,29411,22204,1,40,25,3868,7,2805,7332,1,1,0,0,-2
EUN1_3576154275',6,33,15,1,0,0,0,7,1,341,104,27692,30742,32760,3,25,14,1,0,0,0,4,373,76,27456,30296,41455,1,-32,28,236,1,446,-8695,0,0,0,0,3
EUN1_3576117837',4,31,11,0,0,0,0,14,0,316,82,25189,28819,27612,1,53,22,1,0,2,0,1,394,89,32573,34405,44486,0,-78,-7,-7384,-11,-5586,-16874,-1,0,-2,0,13
EUN1_3576087968',6,36,14,1,0,0,0,6,0,330,73,27101,28193,34619,1,32,11,1,0,1,0,3,371,94,27791,29393,37652,1,-41,-21,-690,3,-1200,-3033,0,0,-1,0,3
EUN1_3576060835',7,31,12,0,0,0,0,1,1,319,84,25430,29027,38697,2,25,12,1,0,0,0,2,321,100,25905,29449,33121,0,-2,-16,-475,0,-422,5576,-1,0,0,0,-1
EUN1_3576040515',3,38,17,0,0,0,0,11,1,320,81,29639,30341,38144,5,25,14,2,0,3,0,5,334,53,27478,27887,30291,0,-14,28,2161,3,2454,7853,-2,0,-3,0,6
EUN1_3575798594',2,28,21,1,1,0,0,11,0,305,76,30022,30291,39725,4,27,16,0,0,2,0,4,357,90,30169,29719,43489,1,-52,-14,-147,5,572,-3764,1,1,-2,0,7
EUN1_3575785243',4,67,12,0,0,1,0,7,1,353,86,27725,29046,29677,4,19,20,1,0,0,0,2,339,90,31017,31893,40245,0,14,-4,-3292,-8,-2847,-10568,-1,0,1,0,5
EUN1_3575676137',4,27,14,1,0,1,0,8,1,354,116,29514,30635,32701,3,88,9,1,0,1,0,4,286,71,23446,28431,27407,1,68,45,6068,5,2204,5294,0,0,0,0,4
EUN1_3575662737',3,82,17,1,0,0,0,15,0,289,87,27083,29147,32152,0,29,16,0,0,1,0,3,374,80,31905,31052,37356,1,-85,7,-4822,1,-1905,-5204,1,0,-1,0,12
EUN1_3575659195',4,23,16,1,0,1,0,4,1,288,87,28097,28746,32495,0,23,10,1,0,0,0,8,329,92,25885,29356,34235,0,-41,-5,2212,6,-610,-1740,0,0,1,0,-4
EUN1_3575639950',1,37,9,0,0,0,0,7,0,358,110,26015,28464,27020,9,36,17,2,0,1,0,3,360,98,30335,30921,33721,0,-2,12,-4320,-8,-2457,-6701,-2,0,-1,0,4
EUN1_3575626864',5,28,15,1,0,0,0,12,1,307,88,27945,28587,34946,2,24,13,0,0,2,0,4,324,87,27873,27715,32704,0,-17,1,72,2,872,2242,1,0,-2,0,8
EUN1_3575611716',1,17,9,0,0,1,0,7,1,353,74,26952,29316,32439,6,23,7,2,0,1,0,6,331,91,23854,28302,27569,1,22,-17,3098,2,1014,4870,-2,0,0,0,1
EUN1_3575599184',3,27,15,1,0,0,0,11,0,341,72,26973,30565,26670,3,26,8,1,0,2,0,2,360,94,27089,31328,34130,0,-19,-22,-116,7,-763,-7460,0,0,-2,0,9
EUN1_3575567069',4,27,23,2,0,1,0,8,1,322,77,31326,29685,38112,1,27,12,0,0,0,0,3,306,75,25075,26998,30854,1,16,2,6251,11,2687,7258,2,0,1,0,5
EUN1_3575542843',3,21,16,2,0,1,0,15,1,315,79,28839,30371,37060,4,18,11,0,0,1,0,2,328,76,26645,28319,33688,1,-13,3,2194,5,2052,3372,2,0,0,0,13
EUN1_3575127865',4,26,12,1,0,1,0,4,1,408,116,28427,32313,30336,5,26,4,1,0,0,0,4,341,95,23244,28374,23206,0,67,21,5183,8,3939,7130,0,0,1,0,0
EUN1_3575122927',9,36,12,0,0,0,0,9,0,329,95,26091,30837,29376,2,24,6,2,0,0,0,3,343,76,23972,28027,24859,0,-14,19,2119,6,2810,4517,-2,0,0,0,6
EUN1_3575961225',4,27,23,1,0,1,0,7,1,331,88,29849,30953,46269,5,40,16,0,0,1,0,7,332,60,28471,29043,37332,1,-1,28,1378,7,1910,8937,1,0,0,0,0
EUN1_3575871417',5,42,7,2,0,0,0,6,1,317,100,24059,27780,23549,4,23,10,0,0,1,0,1,361,88,26126,31119,24910,0,-44,12,-2067,-3,-3339,-1361,2,0,-1,0,5
EUN1_3572715058',2,19,17,1,1,3,0,9,1,343,83,29138,30884,37311,3,25,6,0,0,0,0,4,341,85,24301,28521,25398,1,2,-2,4837,11,2363,11913,1,1,3,0,5
EUN1_3571942135',1,21,9,1,0,0,0,13,1,402,78,26767,31095,27612,5,28,8,1,0,0,0,2,342,90,25904,28066,30457,1,60,-12,863,1,3029,-2845,0,0,0,0,11
EUN1_3571925467',2,20,16,1,0,1,0,8,1,350,94,28500,31335,36439,6,28,11,0,0,1,0,2,335,66,26523,29269,36994,1,15,28,1977,5,2066,-555,1,0,0,0,6
EUN1_3571515613',5,27,12,2,0,3,0,12,0,377,103,29821,30352,39534,4,40,8,0,0,1,0,7,350,63,25253,28777,28850,1,27,40,4568,4,1575,10684,2,0,2,0,5
EUN1_3571492793',4,31,10,0,0,0,0,8,0,329,83,25271,27153,32180,5,30,16,2,0,1,0,2,346,80,28554,29173,36173,0,-17,3,-3283,-6,-2020,-3993,-2,0,-1,0,6
EUN1_3570270210',2,28,11,0,0,0,0,9,0,399,90,27864,31889,27932,4,88,7,1,0,0,0,5,367,100,25374,29871,23529,0,32,-10,2490,4,2018,4403,-1,0,0,0,4
EUN1_3570020669',6,27,15,2,0,1,0,6,1,360,111,29424,31008,31800,2,38,12,0,0,0,0,9,328,88,26286,29751,30012,1,32,23,3138,3,1257,1788,2,0,1,0,-3
EUN1_3568953312',1,24,15,0,0,0,0,8,1,346,100,29389,29709,37339,3,23,12,1,0,1,0,8,343,71,25509,26069,32349,1,3,29,3880,3,3640,4990,-1,0,-1,0,0
EUN1_3568938238',1,23,18,2,0,2,0,11,1,356,86,31279,30720,43490,0,27,12,0,0,0,0,5,328,82,27381,29853,30393,1,28,4,3898,6,867,13097,2,0,2,0,6
EUN1_3568150910',1,23,8,1,1,1,0,8,0,336,76,25499,29754,25045,0,39,10,1,0,0,0,0,393,92,26103,32496,36229,1,-57,-16,-604,-2,-2742,-11184,0,1,1,0,8
EUN1_3568070546',2,21,9,2,0,0,0,7,1,361,89,26648,30779,33790,1,27,8,0,0,1,0,5,360,90,25062,28679,34316,1,1,-1,1586,1,2100,-526,2,0,-1,0,2
EUN1_3576028331',1,22,13,0,0,2,0,7,0,350,90,29114,29409,30732,1,87,17,2,1,0,0,9,351,70,29327,29256,41999,0,-1,20,-213,-4,153,-11267,-2,-1,2,0,-2
EUN1_3575423277',1,79,16,1,0,0,0,11,1,349,78,28022,28666,34527,7,203,18,1,0,1,0,2,358,80,30895,30529,38922,0,-9,-2,-2873,-2,-1863,-4395,0,0,-1,0,9
EUN1_3574959344',1,77,13,1,1,1,0,8,1,334,92,29883,29789,41592,5,31,14,1,0,1,0,5,307,76,26986,27415,29820,0,27,16,2897,-1,2374,11772,0,1,0,0,3
EUN1_3573272783',3,26,13,1,0,1,0,6,1,374,107,28511,31358,27035,3,23,11,1,0,0,0,1,337,71,25450,29279,32440,0,37,36,3061,2,2079,-5405,0,0,1,0,5
EUN1_3573235758',2,33,14,0,0,1,0,10,1,342,100,29852,28814,30757,4,27,8,2,0,2,0,7,367,71,25671,29630,27362,0,-25,29,4181,6,-816,3395,-2,0,-1,0,3
EUN1_3573183298',4,22,11,2,1,2,0,9,1,365,94,28095,31186,35657,1,19,5,0,0,0,0,5,328,94,23380,28745,21802,1,37,0,4715,6,2441,13855,2,1,2,0,4
EUN1_3573162324',2,23,7,0,0,0,0,10,1,346,98,23635,28331,29500,4,25,17,1,0,1,0,2,372,114,30838,34022,31591,0,-26,-16,-7203,-10,-5691,-2091,-1,0,-1,0,8
EUN1_3571645644',5,340,13,2,0,0,0,6,0,333,84,26933,30227,39740,5,32,9,0,0,0,0,3,363,72,25546,28658,30744,1,-30,12,1387,4,1569,8996,2,0,0,0,3
EUN1_3568441407',8,35,16,2,0,0,0,4,1,349,73,28377,30091,34104,2,26,11,0,0,0,0,3,337,101,26318,29450,27568,1,12,-28,2059,5,641,6536,2,0,0,0,1
EUN1_3568352692',2,22,13,1,0,1,0,9,1,334,90,29282,29630,40019,4,72,18,1,0,2,0,6,333,81,29906,30222,46789,1,1,9,-624,-5,-592,-6770,0,0,-1,0,3
EUN1_3567559075',4,19,8,1,0,0,0,4,1,378,82,25227,29451,31063,6,29,16,1,0,1,0,3,364,70,28346,30470,36429,0,14,12,-3119,-8,-1019,-5366,0,0,-1,0,1
EUN1_3567436362',1,23,12,1,0,0,0,6,1,389,90,26983,31421,34657,6,43,12,0,0,0,0,0,334,77,26454,30201,34027,0,55,13,529,0,1220,630,1,0,0,0,6
EUN1_3566382582',2,27,9,0,0,0,0,8,0,359,84,25820,30237,26741,6,315,16,2,1,1,0,3,351,120,31073,32247,33698,0,8,-36,-5253,-7,-2010,-6957,-2,-1,-1,0,5
EUN1_3566137554',5,31,18,1,0,0,0,10,1,320,106,29803,30734,40160,1,24,7,0,0,1,0,1,343,86,24975,28891,31035,1,-23,20,4828,11,1843,9125,1,0,-1,0,9
EUN1_3565241980',4,26,15,0,0,1,0,7,0,373,76,28869,30524,30447,2,34,10,1,0,1,0,9,348,68,26276,26852,23930,0,25,8,2593,5,3672,6517,-1,0,0,0,-2
EUN1_3565226905',4,141,16,2,0,0,0,8,1,329,84,28732,31338,41092,3,66,13,0,0,1,0,4,306,96,26945,27545,34040,1,23,-12,1787,3,3793,7052,2,0,-1,0,4
EUN1_3565197038',1,30,19,1,0,2,0,10,1,365,88,31952,31660,39401,4,31,15,1,0,0,0,7,371,82,28396,29963,30833,1,-6,6,3556,4,1697,8568,0,0,2,0,3
EUN1_3551037623',5,24,10,0,0,0,0,13,1,330,79,25515,27969,30885,1,74,13,2,0,2,0,2,380,112,30609,31361,36074,0,-50,-33,-5094,-3,-3392,-5189,-2,0,-2,0,11
EUN1_3551004805',3,65,6,1,0,0,0,4,0,371,88,23797,29068,21939,6,50,12,1,0,0,0,3,391,82,27351,30946,28262,0,-20,6,-3554,-6,-1878,-6323,0,0,0,0,1
EUN1_3550978311',3,33,13,0,0,3,0,8,1,359,86,29291,30203,35952,4,22,17,1,0,0,0,7,322,94,28256,30441,31896,0,37,-8,1035,-4,-238,4056,-1,0,3,0,1
EUN1_3550931253',2,23,17,1,0,0,0,6,1,321,85,28841,31322,30995,7,136,6,0,1,1,0,3,324,100,25199,28411,32456,1,-3,-15,3642,11,2911,-1461,1,-1,-1,0,3
EUN1_3550899719',4,67,9,0,0,0,0,15,1,340,73,26418,27082,25962,5,63,17,1,0,3,0,5,390,92,31759,31537,39673,0,-50,-19,-5341,-8,-4455,-13711,-1,0,-3,0,10
EUN1_3550888174',3,29,14,2,0,2,0,10,0,362,91,29063,30764,35091,4,33,15,0,0,0,0,3,369,72,27924,29856,34266,1,-7,19,1139,-1,908,825,2,0,2,0,7
EUN1_3550871074',4,58,17,1,0,2,0,6,0,386,114,31608,31937,32913,5,23,8,1,0,1,0,8,351,67,25497,28684,29161,1,35,47,6111,9,3253,3752,0,0,1,0,-2
EUN1_3550847736',5,27,14,1,0,0,0,6,0,355,92,28347,31253,30727,3,46,10,0,0,0,0,4,353,77,25148,27111,28002,1,2,15,3199,4,4142,2725,1,0,0,0,2
EUN1_3550834205',2,73,25,1,0,0,0,8,1,373,80,32807,32702,40981,3,22,14,0,0,2,0,7,282,96,28391,27696,36166,1,91,-16,4416,11,5006,4815,1,0,-2,0,1
EUN1_3550793900',3,25,12,1,0,0,0,6,0,311,94,26199,29189,30531,3,29,14,1,0,0,0,4,327,80,26734,31048,34428,1,-16,14,-535,-2,-1859,-3897,0,0,0,0,2
EUN1_3550778748',6,29,15,2,0,1,0,7,1,356,104,28063,29362,31524,2,26,9,0,0,1,0,3,323,87,26435,28503,29592,0,33,17,1628,6,859,1932,2,0,0,0,4
EUN1_3550423820',5,25,11,0,0,0,0,8,1,334,83,26820,27495,34619,2,17,27,2,0,3,0,4,389,82,34912,33970,46816,0,-55,1,-8092,-16,-6475,-12197,-2,0,-3,0,4
EUN1_3550399531',9,32,21,1,0,1,0,9,1,364,86,32400,31803,36162,7,260,12,0,0,2,0,5,374,69,29170,29469,34472,1,-10,17,3230,9,2334,1690,1,0,-1,0,4
EUN1_3550366433',3,20,14,2,0,2,0,5,1,374,73,29483,29654,34115,7,31,12,0,0,0,0,7,329,109,26847,31056,29658,0,45,-36,2636,2,-1402,4457,2,0,2,0,-2
EUN1_3550345293',5,27,17,1,0,2,0,9,1,337,80,30574,30306,40523,3,29,6,0,0,1,0,4,331,79,23674,27346,28460,1,6,1,6900,11,2960,12063,1,0,1,0,5
EUN1_3550315327',3,25,20,1,0,1,0,5,1,338,101,30883,31549,40073,0,22,13,1,0,0,0,4,323,76,25882,28602,30230,0,15,25,5001,7,2947,9843,0,0,1,0,1
EUN1_3575343131',4,31,10,2,0,1,0,7,1,390,85,27185,29320,25566,4,28,12,0,0,0,0,3,399,80,28105,30545,26737,1,-9,5,-920,-2,-1225,-1171,2,0,1,0,4
EUN1_3575316672',2,26,16,2,0,1,0,9,0,337,92,29558,30247,35963,3,31,12,0,0,2,0,3,349,90,28323,28815,28855,1,-12,2,1235,4,1432,7108,2,0,-1,0,6
EUN1_3575027970',1,75,9,1,0,0,0,11,0,346,74,24882,28690,34351,6,56,16,1,0,1,0,2,378,78,29716,31695,36327,0,-32,-4,-4834,-7,-3005,-1976,0,0,-1,0,9
EUN1_3574596249',1,26,12,0,0,0,0,14,1,313,74,25836,27944,28870,8,25,21,2,0,1,0,0,382,122,34633,33124,36452,0,-69,-48,-8797,-9,-5180,-7582,-2,0,-1,0,14
EUN1_3574578994',6,35,9,0,0,0,0,10,0,284,70,23921,25733,33373,3,52,18,1,0,1,0,0,356,106,30296,31481,39502,0,-72,-36,-6375,-9,-5748,-6129,-1,0,-1,0,10
EUN1_3574584489',5,34,14,2,1,1,0,7,1,368,98,30057,31225,32265,5,317,9,0,0,2,0,4,349,74,24757,28937,26261,1,19,24,5300,5,2288,6004,2,1,-1,0,3
EUN1_3574572581',5,29,12,0,0,0,0,9,0,343,86,26543,27190,30404,4,32,19,2,0,3,0,3,378,79,32635,32936,36631,0,-35,7,-6092,-7,-5746,-6227,-2,0,-3,0,6
EUN1_3574263410',1,28,16,0,0,0,0,6,0,335,95,28871,30308,36504,2,28,14,1,0,0,0,0,333,76,26179,27684,27995,1,2,19,2692,2,2624,8509,-1,0,0,0,6
EUN1_3573880973',4,30,8,2,0,2,0,10,1,379,100,28142,29604,28889,1,25,8,0,0,0,0,10,356,96,26020,30354,26889,1,23,4,2122,0,-750,2000,2,0,2,0,0
EUN1_3573804360',6,355,16,2,0,1,0,7,0,347,78,29076,30765,32971,5,33,12,0,0,0,0,4,329,85,27610,27126,31526,0,18,-7,1466,4,3639,1445,2,0,1,0,3
EUN1_3573135500',6,75,9,1,0,0,0,8,1,332,76,24989,28732,27846,6,76,9,1,1,1,0,2,395,118,27711,32410,31513,0,-63,-42,-2722,0,-3678,-3667,0,-1,-1,0,6
EUN1_3573123388',7,29,27,2,0,3,0,10,1,360,86,34450,33818,50744,2,20,12,0,0,0,0,10,325,81,27039,28306,36804,1,35,5,7411,15,5512,13940,2,0,3,0,0
EUN1_3572509656',2,26,11,1,0,0,0,8,0,361,90,26826,29983,27982,1,24,16,1,0,1,0,3,339,70,28860,28107,32046,0,22,20,-2034,-5,1876,-4064,0,0,-1,0,5
EUN1_3572199342',4,283,11,0,0,0,0,13,0,321,79,26124,26563,31808,2,26,20,2,0,2,0,3,341,100,31478,30330,45439,0,-20,-21,-5354,-9,-3767,-13631,-2,0,-2,0,10
EUN1_3572048065',7,29,7,0,0,0,0,11,0,357,88,24126,28545,24879,3,30,17,2,0,2,0,1,381,88,30426,32078,35388,0,-24,0,-6300,-10,-3533,-10509,-2,0,-2,0,10
EUN1_3570871623',5,29,15,1,0,2,0,12,0,329,92,29657,29615,37839,5,22,11,1,0,0,0,6,346,84,25424,28578,25813,1,-17,8,4233,4,1037,12026,0,0,2,0,6
EUN1_3570844538',7,33,24,2,0,2,0,5,1,322,88,30521,30304,39911,5,24,8,0,0,0,0,4,312,80,24153,26170,32345,1,10,8,6368,16,4134,7566,2,0,2,0,1
EUN1_3570815865',5,31,12,0,0,0,0,3,1,378,76,25899,28628,30217,2,24,13,2,0,0,0,0,366,88,26757,30716,33070,0,12,-12,-858,-1,-2088,-2853,-2,0,0,0,3
EUN1_3576242614',2,26,15,1,0,1,0,10,0,390,75,29748,32208,28039,5,35,9,1,0,0,0,4,359,100,25457,27560,24713,1,31,-25,4291,6,4648,3326,0,0,1,0,6
EUN1_3575890611',5,33,16,2,0,0,0,8,1,312,80,26612,28068,30685,3,35,13,0,0,2,0,0,384,84,29796,31195,33341,0,-72,-4,-3184,3,-3127,-2656,2,0,-2,0,8
EUN1_3575760415',1,29,10,0,0,0,0,15,0,343,58,25446,27668,25722,4,29,13,2,1,3,0,3,390,126,32355,32000,39717,0,-47,-68,-6909,-3,-4332,-13995,-2,-1,-3,0,12
EUN1_3575745217',3,26,8,0,0,0,0,7,1,362,79,25491,28578,29222,0,22,9,2,0,0,0,6,371,93,26406,30330,34736,0,-9,-14,-915,-1,-1752,-5514,-2,0,0,0,1
EUN1_3574681812',5,24,9,0,0,0,0,12,0,381,98,26920,30451,28676,7,29,13,1,0,2,0,2,389,90,28343,31302,27479,0,-8,8,-1423,-4,-851,1197,-1,0,-2,0,10
EUN1_3574311494',4,24,5,1,0,0,0,6,0,405,79,23930,29616,27415,7,33,14,1,0,0,0,3,376,100,28924,30951,34800,0,29,-21,-4994,-9,-1335,-7385,0,0,0,0,3
EUN1_3574290484',6,30,16,1,0,0,0,7,1,339,95,28246,29926,38971,0,25,10,0,0,0,0,3,344,83,26592,29869,31047,1,-5,12,1654,6,57,7924,1,0,0,0,4
EUN1_3573751316',3,47,11,1,0,0,0,11,1,354,68,26673,28779,31697,4,34,17,1,1,2,0,1,383,84,30912,30323,30871,0,-29,-16,-4239,-6,-1544,826,0,-1,-2,0,10
EUN1_3573569632',4,24,5,1,1,1,0,11,0,346,108,24497,28050,23820,4,27,11,1,0,2,0,5,384,112,28737,33061,22379,0,-38,-4,-4240,-6,-5011,1441,0,1,-1,0,6
EUN1_3573131631',3,29,4,1,0,0,0,7,0,375,86,23758,28039,17678,4,25,8,1,0,0,0,3,390,114,27672,29948,26363,0,-15,-28,-3914,-4,-1909,-8685,0,0,0,0,4
EUN1_3573116622',3,50,14,0,0,2,0,10,0,330,83,31049,27125,36122,2,28,21,2,0,2,0,8,339,88,30507,29426,38025,1,-9,-5,542,-7,-2301,-1903,-2,0,0,0,2
EUN1_3572112905',2,22,9,0,0,0,0,10,0,303,80,24171,26063,31234,4,42,24,2,0,1,0,0,356,92,31875,31659,42572,0,-53,-12,-7704,-15,-5596,-11338,-2,0,-1,0,10
EUN1_3571580013',2,22,15,0,0,1,0,10,1,325,104,29024,30488,35439,1,19,15,2,0,1,0,6,388,78,29922,32477,34657,0,-63,26,-898,0,-1989,782,-2,0,0,0,4
EUN1_3571565266',3,28,10,0,0,1,0,12,1,369,78,27607,28224,27863,5,23,14,2,0,1,0,4,377,102,29382,29678,31604,0,-8,-24,-1775,-4,-1454,-3741,-2,0,0,0,8
EUN1_3570786932',4,30,6,0,0,1,0,8,0,383,66,25621,27837,31576,6,31,14,2,1,0,0,0,338,88,27604,29453,29697,0,45,-22,-1983,-8,-1616,1879,-2,-1,1,0,8
EUW1_6883331728',4,30,8,0,0,0,0,5,1,349,83,24788,28133,31228,5,27,15,2,0,1,0,0,326,87,27057,28565,31434,1,23,-4,-2269,-7,-432,-206,-2,0,-1,0,5
EUW1_6881014633',5,34,11,1,0,1,0,14,0,319,74,26677,27736,31466,2,134,14,0,1,2,0,3,367,100,30916,30756,35277,1,-48,-26,-4239,-3,-3020,-3811,1,-1,-1,0,11
EUW1_6880645430',4,30,18,1,0,0,0,4,0,370,77,29103,32014,32356,8,34,12,0,0,0,0,2,357,83,26676,29926,28529,1,13,-6,2427,6,2088,3827,1,0,0,0,2
EUW1_6880604646',4,65,10,0,1,1,0,6,1,388,67,27732,29380,31169,4,30,15,2,0,0,0,8,362,100,29377,31127,27041,1,26,-33,-1645,-5,-1747,4128,-2,1,1,0,-2
EUN1_3573770697',5,23,8,0,0,0,0,12,0,333,68,24734,28851,26107,4,25,13,2,0,1,0,2,349,100,28512,29178,40485,1,-16,-32,-3778,-5,-327,-14378,-2,0,-1,0,10
EUN1_3572635724',2,19,15,1,1,1,0,16,0,361,72,29394,30819,31431,5,27,9,0,0,2,0,3,294,82,25463,25458,28799,1,67,-10,3931,6,5361,2632,1,1,-1,0,13
EUN1_3572166069',1,27,11,0,0,0,0,8,0,288,82,25431,27988,32537,3,37,23,2,0,1,0,2,333,88,31394,30309,39266,1,-45,-6,-5963,-12,-2321,-6729,-2,0,-1,0,6
EUN1_3572073097',5,47,13,1,0,0,0,9,0,384,104,28081,32986,33743,2,27,14,1,0,0,0,2,351,103,28602,31479,30590,0,33,1,-521,-1,1507,3153,0,0,0,0,7
EUN1_3571628600',6,30,9,0,0,1,0,11,0,321,92,26934,29856,27833,1,43,15,2,0,1,0,4,375,108,30252,31515,34421,0,-54,-16,-3318,-6,-1659,-6588,-2,0,0,0,7
EUN1_3571611474',3,28,21,2,0,2,0,10,0,352,106,35544,31462,41665,5,28,10,0,0,1,0,8,314,86,24932,27775,22140,1,38,20,10612,11,3687,19525,2,0,1,0,2
EUN1_3575967353',3,25,15,0,0,1,0,8,1,356,116,29215,30166,32723,4,169,16,1,0,1,0,5,357,64,28160,29234,30865,1,-1,52,1055,-1,932,1858,-1,0,0,0,3
EUN1_3575931264',6,30,21,1,0,1,0,11,0,339,84,30315,31507,34363,1,22,11,1,0,2,0,3,345,116,28968,29990,37455,0,-6,-32,1347,10,1517,-3092,0,0,-1,0,8
EUN1_3575906207',5,23,10,0,0,1,0,7,0,381,89,27704,29668,26877,4,25,11,1,0,1,0,4,349,63,26418,28919,31123,1,32,26,1286,-1,749,-4246,-1,0,0,0,3
EUN1_3575804665',1,22,10,0,0,0,0,10,1,351,96,26358,28609,28058,1,20,19,1,0,2,0,5,325,120,29565,31477,35940,0,26,-24,-3207,-9,-2868,-7882,-1,0,-2,0,5
EUN1_3575786534',2,261,14,1,0,1,0,10,0,308,72,27059,27264,33932,5,23,27,0,0,1,0,3,361,80,34104,32082,51755,0,-53,-8,-7045,-13,-4818,-17823,1,0,0,0,7
EUN1_3575772537',2,22,5,1,0,0,0,9,0,356,80,23501,29271,21567,4,23,9,0,0,0,0,2,402,112,27279,32330,23089,0,-46,-32,-3778,-4,-3059,-1522,1,0,0,0,7
EUN1_3575743944',2,24,13,0,0,0,0,8,1,329,78,26946,28370,33056,5,30,16,1,0,0,0,6,316,94,28144,28988,32845,0,13,-16,-1198,-3,-618,211,-1,0,0,0,2
EUN1_3575419401',2,21,20,0,0,1,0,10,1,394,80,31418,31779,35375,2,21,15,1,0,1,0,7,317,95,28023,30172,35188,1,77,-15,3395,5,1607,187,-1,0,0,0,3
EUN1_3575396301',3,38,12,1,0,1,0,11,1,348,118,27379,30247,24988,3,27,15,1,0,1,0,0,358,89,29592,32208,35807,1,-10,29,-2213,-3,-1961,-10819,0,0,0,0,11
EUN1_3575348909',2,26,9,0,0,0,0,7,0,344,99,25948,29853,28626,1,24,14,2,0,1,0,3,366,88,28162,30513,29500,0,-22,11,-2214,-5,-660,-874,-2,0,-1,0,4
EUN1_3575335317',3,25,13,0,0,0,0,7,0,289,91,26043,26763,28718,4,27,16,2,0,0,0,0,295,74,27750,26458,32453,0,-6,17,-1707,-3,305,-3735,-2,0,0,0,7
EUN1_3575286973',5,29,18,0,0,0,0,10,0,319,86,28773,28921,42314,2,17,16,1,0,2,0,4,342,66,29464,30160,43816,1,-23,20,-691,2,-1239,-1502,-1,0,-2,0,6
EUN1_3575277406',3,60,10,1,0,0,0,7,1,387,76,26287,29317,28161,5,59,11,0,0,0,0,4,382,80,26593,30735,33006,0,5,-4,-306,-1,-1418,-4845,1,0,0,0,3
EUN1_3575252996',3,32,18,2,0,0,0,6,0,333,86,29111,29504,33932,0,17,16,0,0,0,0,2,342,94,29205,27568,31840,1,-9,-8,-94,2,1936,2092,2,0,0,0,4
EUN1_3575181686',2,36,10,0,0,0,0,8,1,321,58,25054,27963,29473,2,23,12,1,0,1,0,1,368,98,27440,29999,31247,1,-47,-40,-2386,-2,-2036,-1774,-1,0,-1,0,7
EUN1_3575170730',3,23,18,1,0,2,0,6,1,379,100,32408,32005,35695,2,38,14,1,0,1,0,8,347,103,27700,31336,32211,1,32,-3,4708,4,669,3484,0,0,1,0,-2
EUN1_3575163675',4,26,16,1,0,0,0,10,1,351,80,29514,30854,33113,3,30,11,1,0,2,0,3,326,80,25125,26535,32056,1,25,0,4389,5,4319,1057,0,0,-2,0,7
EUN1_3575161398',3,35,10,0,0,0,0,12,1,334,66,25532,26194,24064,4,34,17,1,0,1,0,0,415,86,30687,29864,31591,0,-81,-20,-5155,-7,-3670,-7527,-1,0,-1,0,12
EUN1_3575827638',2,25,16,0,0,0,0,6,1,325,61,27718,28238,30418,3,43,10,2,0,1,0,3,353,90,27332,27825,30653,1,-28,-29,386,6,413,-235,-2,0,-1,0,3
EUN1_3575774010',2,248,15,1,0,2,0,8,0,381,93,29760,31351,36663,5,31,11,1,0,0,0,8,353,92,26431,29242,31854,1,28,1,3329,4,2109,4809,0,0,2,0,0
EUN1_3575722710',3,22,15,1,0,0,0,12,0,323,86,27456,27524,30751,4,22,15,0,0,1,0,3,317,78,28139,29078,33492,0,6,8,-683,0,-1554,-2741,1,0,-1,0,9
EUN1_3575360894',7,45,13,0,0,1,0,11,0,386,88,28885,29176,34459,8,21,16,2,0,1,0,4,341,120,29919,31196,37658,1,45,-32,-1034,-3,-2020,-3199,-2,0,0,0,7
EUN1_3575338788',3,39,8,1,0,1,0,4,0,372,96,26690,28928,32547,8,21,13,0,0,0,0,4,326,76,27615,28456,30808,1,46,20,-925,-5,472,1739,1,0,1,0,0
EUN1_3575244138',4,25,6,1,0,0,0,9,0,375,76,24324,27837,21093,5,44,13,1,0,1,0,0,364,106,28639,32397,35714,0,11,-30,-4315,-7,-4560,-14621,0,0,-1,0,9
EUN1_3575067707',1,46,22,1,0,3,0,5,1,343,107,33370,31612,45970,3,22,10,0,0,0,0,8,296,95,25863,27434,31977,1,47,12,7507,12,4178,13993,1,0,3,0,-3
EUN1_3575038974',2,29,20,1,0,0,0,7,0,358,78,31212,29506,43171,7,35,27,0,0,1,0,6,314,98,33376,31703,49013,1,44,-20,-2164,-7,-2197,-5842,1,0,-1,0,1
EUN1_3574909765',7,20,14,2,0,0,0,16,1,326,82,27757,29290,40404,4,25,13,0,0,3,0,2,381,102,30748,31970,36076,1,-55,-20,-2991,1,-2680,4328,2,0,-3,0,14
EUN1_3574569758',4,36,17,1,0,0,0,6,1,372,82,29557,31384,36479,2,26,13,1,0,1,0,7,353,86,26298,29259,29959,1,19,-4,3259,4,2125,6520,0,0,-1,0,-1
EUN1_3574552491',3,48,12,0,0,0,0,11,0,354,91,27609,28519,36701,3,22,14,2,0,1,0,4,317,87,27253,29346,28794,1,37,4,356,-2,-827,7907,-2,0,-1,0,7
EUN1_3574275812',3,31,7,1,1,1,0,8,0,329,95,26094,28479,28248,1,86,12,0,0,0,0,2,326,62,24439,29202,29849,1,3,33,1655,-5,-723,-1601,1,1,1,0,6
EUN1_3574070510',1,23,17,0,0,0,0,11,0,336,77,28937,30056,36500,2,25,13,2,0,1,0,5,330,90,28067,28050,34913,1,6,-13,870,4,2006,1587,-2,0,-1,0,6
EUN1_3573466076',3,29,20,1,0,1,0,9,1,362,78,33145,31807,37432,2,37,14,1,0,1,0,3,333,90,29197,31295,31893,1,29,-12,3948,6,512,5539,0,0,0,0,6
EUN1_3572620045',3,23,15,2,1,0,0,11,1,376,102,29859,32785,42217,3,20,16,0,0,0,0,3,359,94,28331,32217,41141,0,17,8,1528,-1,568,1076,2,1,0,0,8
EUN1_3571936344',3,29,19,1,0,0,0,11,0,301,82,28488,29720,39706,3,46,10,1,0,0,0,4,281,70,25266,24471,40279,1,20,12,3222,9,5249,-573,0,0,0,0,7
EUN1_3571695022',6,28,7,0,0,1,0,9,0,384,82,26450,28228,23580,1,44,16,2,1,1,0,4,352,98,27915,31027,29070,0,32,-16,-1465,-9,-2799,-5490,-2,-1,0,0,5
EUN1_3570962813',0,22,17,0,0,1,0,9,1,301,62,28962,28127,42677,2,44,22,1,0,0,0,4,305,97,31231,30385,43637,0,-4,-35,-2269,-5,-2258,-960,-1,0,1,0,5
EUN1_3570821850',2,26,10,2,0,0,0,9,1,356,74,27376,28520,35754,5,44,14,0,0,0,0,5,347,94,27258,28717,38172,0,9,-20,118,-4,-197,-2418,2,0,0,0,4
EUN1_3570790642',0,245,6,1,0,0,0,10,0,361,78,24962,28424,25969,3,50,13,0,0,1,0,4,358,84,27020,30338,33129,1,3,-6,-2058,-7,-1914,-7160,1,0,-1,0,6
EUN1_3566896168',2,45,6,0,0,0,0,11,0,306,104,23980,28032,22812,2,24,15,2,0,1,0,2,326,100,28360,30585,30320,0,-20,4,-4380,-9,-2553,-7508,-2,0,-1,0,9
EUN1_3566521367',5,29,11,2,0,2,0,6,0,376,120,28969,31617,34436,5,29,9,0,0,0,0,5,324,72,24676,28706,27731,1,52,48,4293,2,2911,6705,2,0,2,0,1
EUN1_3566340018',3,25,8,0,0,0,0,9,1,353,106,25297,28684,29668,1,24,14,1,0,1,0,5,286,90,26874,28065,32101,1,67,16,-1577,-6,619,-2433,-1,0,-1,0,4
EUN1_3566330474',1,60,15,1,0,0,0,4,0,350,112,28207,31445,34025,5,32,7,1,1,0,0,2,347,80,23857,27988,24661,1,3,32,4350,8,3457,9364,0,-1,0,0,2
EUN1_3575324348',5,25,13,1,0,0,0,8,0,361,90,28307,31822,30181,3,45,10,1,0,2,0,5,346,86,25376,28996,32639,1,15,4,2931,3,2826,-2458,0,0,-2,0,3
EUN1_3574922727',3,30,20,0,0,2,0,11,1,342,80,30217,30628,37722,3,21,14,2,1,1,0,5,342,83,28200,29174,34401,0,0,-3,2017,6,1454,3321,-2,-1,1,0,6
EUN1_3574244812',5,148,7,1,0,0,0,7,1,366,98,24665,29623,25454,0,23,8,1,0,0,0,2,381,90,25818,31337,26014,1,-15,8,-1153,-1,-1714,-560,0,0,0,0,5
EUN1_3574234693',3,23,3,0,0,0,0,9,0,306,82,21115,24557,22102,2,23,13,1,0,3,0,3,367,90,29782,29426,29768,0,-61,-8,-8667,-10,-4869,-7666,-1,0,-3,0,6
EUN1_3574224137',3,17,7,1,0,0,0,10,0,287,92,22344,29116,22670,4,19,9,0,0,1,0,0,392,83,26133,31068,37514,0,-105,9,-3789,-2,-1952,-14844,1,0,-1,0,10
EUN1_3574190690',3,32,11,1,0,0,0,7,0,333,100,26381,29047,32068,3,44,11,0,0,0,0,7,352,72,26770,28770,33218,0,-19,28,-389,0,277,-1150,1,0,0,0,0
EUN1_3574172728',5,44,15,0,0,1,0,10,0,281,67,27990,27842,36781,3,370,18,2,0,0,0,3,288,97,28301,27752,37690,0,-7,-30,-311,-3,90,-909,-2,0,1,0,7
EUN1_3573569591',2,29,14,2,1,2,0,7,0,360,122,28977,32855,35987,3,22,6,0,0,0,0,10,323,87,22929,27718,25358,1,37,35,6048,8,5137,10629,2,1,2,0,-3
EUN1_3568040588',3,29,24,1,0,3,0,5,1,385,91,34868,31953,42511,0,35,7,0,0,1,0,11,336,75,24227,26846,26074,1,49,16,10641,17,5107,16437,1,0,2,0,-6
EUN1_3568026103',8,31,11,0,0,0,0,10,0,360,86,26848,29148,33792,4,20,17,2,0,1,0,3,357,86,29109,30691,37308,0,3,0,-2261,-6,-1543,-3516,-2,0,-1,0,7
EUN1_3568006069',5,24,17,1,0,2,0,1,0,351,90,29845,32130,32826,2,18,7,0,0,0,0,6,324,85,24155,27747,24049,1,27,5,5690,10,4383,8777,1,0,2,0,-5
EUN1_3567639536',2,23,10,0,0,0,0,7,0,330,70,25081,27174,31604,3,19,14,2,0,3,0,2,365,106,29309,30052,31420,0,-35,-36,-4228,-4,-2878,184,-2,0,-3,0,5
EUN1_3567616869',3,25,18,0,0,0,0,9,0,307,107,30028,30123,40598,4,32,17,1,0,2,0,2,304,84,28886,29366,37173,1,3,23,1142,1,757,3425,-1,0,-2,0,7
EUN1_3565960062',3,22,11,0,0,1,0,7,1,356,114,28206,29607,28065,6,27,12,2,0,1,0,3,364,82,28089,31801,27553,0,-8,32,117,-1,-2194,512,-2,0,0,0,4
EUN1_3565655441',5,28,17,1,1,1,0,5,1,333,64,29490,29995,36007,3,26,14,0,0,0,0,5,348,108,28418,31101,31842,0,-15,-44,1072,3,-1106,4165,1,1,1,0,0
EUN1_3565644583',6,25,11,1,1,2,0,7,1,377,120,30015,30353,31288,1,21,9,1,0,1,0,9,331,88,25926,26612,29254,1,46,32,4089,2,3741,2034,0,1,1,0,-2
EUN1_3565240021',5,31,16,1,0,3,0,7,1,352,95,30478,31344,36626,3,22,12,1,0,0,0,9,342,88,26190,29279,28216,1,10,7,4288,4,2065,8410,0,0,3,0,-2
EUN1_3565238281',3,51,16,0,0,0,0,10,0,312,90,28440,27203,32489,8,34,18,1,0,1,0,1,339,72,29956,29077,41066,0,-27,18,-1516,-2,-1874,-8577,-1,0,-1,0,9
EUN1_3565210882',4,23,11,1,0,1,0,6,1,353,86,27711,27288,30564,4,23,12,0,0,0,0,7,326,98,26199,29102,27065,1,27,-12,1512,-1,-1814,3499,1,0,1,0,-1
EUN1_3565204436',5,435,19,2,0,1,0,7,1,364,78,30314,31708,37139,2,37,11,0,0,1,0,6,363,89,27396,29669,37221,1,1,-11,2918,8,2039,-82,2,0,0,0,1
EUN1_3564825906',1,17,13,0,0,1,0,13,1,341,82,27338,29904,33447,2,45,13,1,0,1,0,3,390,86,28474,30504,30259,0,-49,-4,-1136,0,-600,3188,-1,0,0,0,10
EUN1_3564735807',1,15,9,0,0,1,0,10,0,359,92,27247,28801,31528,2,23,13,2,0,1,0,7,382,80,29126,31321,30093,0,-23,12,-1879,-4,-2520,1435,-2,0,0,0,3
EUN1_3564727699',2,24,15,1,0,1,0,14,0,321,93,29944,28280,37208,4,32,13,0,0,1,0,7,295,65,27824,26036,33805,1,26,28,2120,2,2244,3403,1,0,0,0,7
EUN1_3564392320',7,32,16,0,0,1,0,7,0,360,96,29596,31456,41524,0,18,11,1,0,1,0,4,334,76,27203,29634,29164,1,26,20,2393,5,1822,12360,-1,0,0,0,3
EUN1_3564358230',2,30,8,2,0,0,0,5,0,308,94,24119,27121,25690,3,26,16,0,0,0,0,3,355,94,28724,31285,34822,1,-47,0,-4605,-8,-4164,-9132,2,0,0,0,2
EUN1_3564340490',6,30,26,2,1,3,0,6,0,336,104,33737,33392,48430,1,31,10,0,0,0,0,7,297,84,25221,28295,27347,1,39,20,8516,16,5097,21083,2,1,3,0,-1
EUN1_3574923663',3,30,22,1,0,2,0,10,1,317,102,31331,30771,34851,5,31,9,0,0,0,0,9,319,72,26451,27048,29187,0,-2,30,4880,13,3723,5664,1,0,2,0,1
EUN1_3574823501',2,21,12,0,0,0,0,11,0,357,71,26705,27820,38143,4,29,24,2,0,3,0,1,353,120,35537,34724,49127,0,4,-49,-8832,-12,-6904,-10984,-2,0,-3,0,10
EUN1_3574802378',0,25,15,2,0,0,0,10,1,320,96,27178,28897,31752,7,100,8,0,0,1,0,4,328,80,24903,27972,28592,1,-8,16,2275,7,925,3160,2,0,-1,0,6
EUN1_3574769972',4,24,12,0,0,0,0,4,0,335,94,26012,29336,29254,4,24,9,1,0,0,0,3,339,94,25387,28531,29292,0,-4,0,625,3,805,-38,-1,0,0,0,1
EUN1_3574753738',4,30,23,1,1,1,0,6,1,379,73,34745,33357,38125,5,23,18,1,0,1,0,9,349,78,29000,29492,34349,1,30,-5,5745,5,3865,3776,0,1,0,0,-3
EUN1_3574080505',3,36,9,2,0,1,0,11,1,372,100,28341,29778,27813,4,27,7,0,0,1,0,6,365,100,25315,28915,24550,1,7,0,3026,2,863,3263,2,0,0,0,5
EUN1_3574063033',1,24,11,1,0,0,0,6,1,322,66,25987,25074,28682,7,86,13,0,0,1,0,6,294,62,24909,26675,25722,1,28,4,1078,-2,-1601,2960,1,0,-1,0,0
EUN1_3574060851',3,23,6,0,0,0,0,9,1,347,86,24776,28658,23522,4,27,13,2,1,2,0,5,362,102,27615,30559,32914,1,-15,-16,-2839,-7,-1901,-9392,-2,-1,-2,0,4
EUN1_3574066352',3,28,13,0,0,0,0,11,0,314,52,26239,26305,32451,3,23,20,1,0,2,0,3,379,72,30530,32172,37629,0,-65,-20,-4291,-7,-5867,-5178,-1,0,-2,0,8
EUN1_3571159149',2,30,12,1,0,0,0,16,0,312,67,26290,28213,33512,2,32,27,1,0,3,0,2,375,92,35361,34165,50650,0,-63,-25,-9071,-15,-5952,-17138,0,0,-3,0,14
EUN1_3571117062',3,34,14,2,0,0,0,3,1,358,84,27461,28617,32835,4,29,4,0,0,2,0,5,372,92,23932,28224,30080,1,-14,-8,3529,10,393,2755,2,0,-2,0,-2
EUN1_3570580121',6,28,15,1,0,3,0,4,1,387,103,30695,32489,32510,3,30,5,1,0,0,0,7,287,71,21563,25937,19287,1,100,32,9132,10,6552,13223,0,0,3,0,-3
EUN1_3570568618',6,30,8,0,0,0,0,13,0,319,96,24946,28630,33087,3,30,13,1,1,2,0,2,361,82,29185,29857,34853,0,-42,14,-4239,-5,-1227,-1766,-1,-1,-2,0,11
EUN1_3570565512',4,28,11,0,0,1,0,11,0,319,60,25891,27777,25153,5,19,18,2,1,1,0,4,311,96,29516,28822,34139,0,8,-36,-3625,-7,-1045,-8986,-2,-1,0,0,7
EUN1_3574535737',6,65,9,0,0,0,0,9,0,357,80,25565,28570,24787,5,158,8,1,0,1,0,6,368,90,26291,30135,33903,0,-11,-10,-726,1,-1565,-9116,-1,0,-1,0,3
EUN1_3573951937',2,43,17,2,0,0,0,9,1,333,75,28597,28803,42552,3,130,16,0,0,3,0,3,348,88,28442,30232,35239,0,-15,-13,155,1,-1429,7313,2,0,-3,0,6
EUN1_3573920885',1,22,12,1,0,1,0,14,1,326,82,28928,28448,41441,4,29,23,0,0,2,0,4,310,84,31937,30928,47669,0,16,-2,-3009,-11,-2480,-6228,1,0,-1,0,10
EUN1_3573875594',4,23,20,1,0,0,0,6,1,349,104,30847,31899,39625,4,31,12,1,0,0,0,4,349,84,26876,28987,38257,1,0,20,3971,8,2912,1368,0,0,0,0,2
EUN1_3573844872',3,35,6,1,0,0,0,14,0,316,66,23773,26458,26035,1,203,15,1,0,2,0,2,376,92,30721,30156,30852,0,-60,-26,-6948,-9,-3698,-4817,0,0,-2,0,12
EUN1_3573817260',4,30,16,1,0,0,0,10,0,333,78,28157,29735,36469,0,23,15,1,0,1,0,3,316,102,28250,30229,34277,0,17,-24,-93,1,-494,2192,0,0,-1,0,7
EUN1_3573785491',3,23,7,1,0,1,0,8,0,377,93,25906,29058,30593,3,20,13,1,0,0,0,2,367,84,27390,30840,29320,0,10,9,-1484,-6,-1782,1273,0,0,1,0,6
EUN1_3573773412',2,17,15,0,0,0,0,9,1,354,86,30330,29204,35785,7,37,21,2,0,2,0,3,343,88,31272,30327,36145,0,11,-2,-942,-6,-1123,-360,-2,0,-2,0,6
EUN1_3573747820',3,80,9,1,0,0,0,9,1,302,88,25138,27767,36948,2,25,17,1,0,2,0,3,370,80,28830,31294,38125,1,-68,8,-3692,-8,-3527,-1177,0,0,-2,0,6
EUN1_3573344507',3,21,17,1,0,0,0,8,1,335,94,28490,29243,38079,1,27,20,0,0,1,0,1,339,65,29727,30394,38339,1,-4,29,-1237,-3,-1151,-260,1,0,-1,0,7
EUN1_3573303327',4,27,13,0,0,1,0,4,1,356,91,27974,29980,33074,5,36,10,2,0,0,0,1,318,67,24244,27927,25817,0,38,24,3730,3,2053,7257,-2,0,1,0,3
EUN1_3573224064',2,17,17,2,0,1,0,10,0,374,99,30281,30733,40913,6,31,16,0,0,0,0,7,320,88,29136,29634,37068,1,54,11,1145,1,1099,3845,2,0,1,0,3
EUN1_3573216708',2,22,12,1,0,0,0,16,1,324,85,24734,26531,31956,4,29,22,0,0,3,0,0,369,88,34688,30006,37530,0,-45,-3,-9954,-10,-3475,-5574,1,0,-3,0,16
EUN1_3573186998',5,25,11,1,1,0,0,13,0,322,76,26576,29225,27277,6,31,13,1,0,0,0,0,374,80,25712,28608,26627,1,-52,-4,864,-2,617,650,0,1,0,0,13
EUN1_3566016075',3,23,11,0,0,1,0,10,1,318,79,26665,26955,26530,3,28,13,1,0,0,0,1,314,96,26570,29362,31633,0,4,-17,95,-2,-2407,-5103,-1,0,1,0,9
EUN1_3565656899',4,30,7,1,0,0,0,10,0,326,96,24562,29174,30741,5,27,12,0,1,1,0,0,341,80,27551,28802,37321,0,-15,16,-2989,-5,372,-6580,1,-1,-1,0,10
EUN1_3565654094',1,19,11,2,1,4,0,3,1,399,106,30843,32196,30980,2,24,4,0,0,0,0,10,325,78,22527,28094,19227,1,74,28,8316,7,4102,11753,2,1,4,0,-7
EUN1_3565637580',5,33,6,0,0,0,0,11,1,307,84,23085,25776,25573,3,33,12,2,0,2,0,1,378,88,29075,30534,28675,0,-71,-4,-5990,-6,-4758,-3102,-2,0,-2,0,10
EUN1_3565259851',2,31,14,0,0,0,0,10,1,323,70,26589,28392,35905,5,30,17,2,0,1,0,1,360,114,31145,32327,36534,0,-37,-44,-4556,-3,-3935,-629,-2,0,-1,0,9
EUN1_3565215780',2,21,18,1,0,0,0,7,0,343,97,29146,30447,38052,8,31,16,1,0,1,0,6,313,83,30431,31131,39006,0,30,14,-1285,2,-684,-954,0,0,-1,0,1
EUN1_3565197895',6,29,15,1,0,2,0,11,1,313,87,28894,28927,35111,2,59,18,1,0,1,0,6,334,84,30440,28586,37468,0,-21,3,-1546,-3,341,-2357,0,0,1,0,5
EUN1_3565195202',2,25,17,0,0,2,0,13,0,331,90,30928,30129,39167,4,24,17,1,0,2,0,9,318,64,30092,28384,37156,0,13,26,836,0,1745,2011,-1,0,0,0,4
EUN1_3564300991',3,45,21,1,0,2,0,7,1,347,118,32326,31784,38752,2,46,6,1,0,2,0,8,363,68,25297,27459,24791,1,-16,50,7029,15,4325,13961,0,0,0,0,-1
EUN1_3564273891',5,49,16,2,0,1,0,8,1,354,117,31121,31336,31173,5,38,11,0,0,1,0,8,336,68,27201,28106,25384,1,18,49,3920,5,3230,5789,2,0,0,0,0
EUN1_3564269273',4,32,18,1,0,0,0,12,0,299,80,29206,28109,34760,4,47,13,0,0,1,0,7,375,85,28765,29621,39532,1,-76,-5,441,5,-1512,-4772,1,0,-1,0,5
EUN1_3564247767',7,24,17,1,0,1,0,6,1,353,86,30356,32640,37621,6,23,11,1,0,1,0,7,356,98,27428,28649,31565,1,-3,-12,2928,6,3991,6056,0,0,0,0,-1
EUN1_3564242784',2,26,8,2,0,2,0,7,1,383,96,27822,31284,25293,2,24,3,0,0,0,0,5,344,100,22038,27983,23628,1,39,-4,5784,5,3301,1665,2,0,2,0,2
EUN1_3562818799',6,69,14,1,0,0,0,5,1,339,79,27513,28013,38173,2,25,11,1,0,0,0,5,347,78,26060,29539,29854,1,-8,1,1453,3,-1526,8319,0,0,0,0,0
EUN1_3562804268',4,30,6,0,0,0,0,9,1,330,94,23509,26995,27576,5,26,20,1,0,1,0,1,349,80,29940,30216,30095,0,-19,14,-6431,-14,-3221,-2519,-1,0,-1,0,8
EUN1_3562784594',4,24,14,2,0,0,0,7,1,334,126,28393,33757,32269,1,22,11,0,0,1,0,2,357,73,28200,28571,30890,1,-23,53,193,3,5186,1379,2,0,-1,0,5
EUN1_3562764484',9,22,16,0,1,0,0,13,0,359,88,28773,30925,32329,5,211,15,1,0,2,0,0,388,102,31260,32317,42672,1,-29,-14,-2487,1,-1392,-10343,-1,1,-2,0,13
EUN1_3566660845',4,20,12,1,0,2,0,9,1,342,116,27901,30083,36745,3,21,7,1,0,1,0,5,344,63,24383,28971,22247,1,-2,53,3518,5,1112,14498,0,0,1,0,4
EUN1_3566218858',5,29,2,1,1,0,0,8,0,365,80,22646,28508,20673,3,23,9,0,0,0,0,3,394,104,26468,31860,28168,1,-29,-24,-3822,-7,-3352,-7495,1,1,0,0,5
EUN1_3565251238',3,27,16,1,0,3,0,6,0,384,98,32763,34380,39442,8,31,13,0,0,1,0,8,369,80,28979,31380,31435,1,15,18,3784,3,3000,8007,1,0,2,0,-2
EUN1_3565143947',4,28,6,0,0,0,0,7,0,318,76,24163,26292,29005,3,26,21,2,0,1,0,8,345,84,30004,30507,40715,0,-27,-8,-5841,-15,-4215,-11710,-2,0,-1,0,-1
EUN1_3564964454',4,23,10,0,0,0,0,7,0,313,84,25672,29575,29052,2,26,15,1,0,0,0,2,372,88,28428,30107,47871,0,-59,-4,-2756,-5,-532,-18819,-1,0,0,0,5
EUN1_3564953135',2,31,1,0,0,0,0,13,0,279,70,19913,23795,20520,2,30,15,2,0,5,0,1,398,106,31745,30870,30147,0,-119,-36,-11832,-14,-7075,-9627,-2,0,-5,0,12
EUN1_3576066882',6,28,11,2,1,0,0,10,0,407,104,29022,32093,27607,4,28,9,0,0,2,0,4,347,104,26062,30183,25698,0,60,0,2960,2,1910,1909,2,1,-2,0,6
EUN1_3576060121',0,18,12,0,0,0,0,13,1,300,64,25620,26872,36757,2,25,26,1,0,2,0,0,378,102,35397,32474,53466,0,-78,-38,-9777,-14,-5602,-16709,-1,0,-2,0,13
EUN1_3575861069',6,37,20,0,1,3,0,9,1,399,92,33460,30673,42565,4,48,11,2,0,0,0,9,282,72,25767,25956,28389,1,117,20,7693,9,4717,14176,-2,1,3,0,0
EUN1_3575836035',5,37,18,2,0,1,0,8,1,362,110,31119,31414,32146,1,26,14,0,0,1,0,6,284,62,26597,27701,34595,1,78,48,4522,4,3713,-2449,2,0,0,0,2
EUN1_3575818016',5,27,14,1,0,0,0,12,0,332,82,27456,29712,33211,3,31,21,0,1,3,0,0,344,102,33044,32235,46149,0,-12,-20,-5588,-7,-2523,-12938,1,-1,-3,0,12
EUN1_3575778945',4,25,12,2,1,1,0,10,0,366,112,28196,30412,35764,1,32,15,0,0,2,0,5,395,79,29764,31874,29495,0,-29,33,-1568,-3,-1462,6269,2,1,-1,0,5
EUN1_3575531003',2,31,20,1,0,1,0,6,1,340,98,31254,29936,41868,4,21,16,1,0,1,0,7,290,98,27606,28397,31207,1,50,0,3648,4,1539,10661,0,0,0,0,-1
EUN1_3575492902',0,30,17,1,0,1,0,4,0,364,106,30946,31723,41241,2,68,9,1,0,2,0,6,319,50,24001,26337,29786,1,45,56,6945,8,5386,11455,0,0,-1,0,-2
EUN1_3575456855',1,24,12,0,0,2,0,13,0,349,93,28947,27220,32417,1,25,23,2,0,1,0,5,340,98,32399,31737,46260,0,9,-5,-3452,-11,-4517,-13843,-2,0,1,0,8
EUN1_3575419671',5,28,11,1,0,0,0,9,1,326,86,26238,27657,34727,2,27,19,1,0,1,0,1,334,106,30898,29851,36656,0,-8,-20,-4660,-8,-2194,-1929,0,0,-1,0,8
EUN1_3575327392',6,95,16,2,0,1,0,11,1,336,86,29972,30501,33317,2,27,10,0,0,2,0,7,300,86,25388,27588,29316,1,36,0,4584,6,2913,4001,2,0,-1,0,4
EUN1_3575290485',4,33,12,1,0,0,0,9,0,350,99,26058,30696,42244,2,25,10,1,0,0,0,1,371,90,26788,30214,37193,1,-21,9,-730,2,482,5051,0,0,0,0,8
EUN1_3575232286',2,24,17,1,1,1,0,10,0,331,84,30117,27357,37019,0,21,12,0,0,1,0,6,299,88,27991,25614,33760,1,32,-4,2126,5,1743,3259,1,1,0,0,4
EUN1_3575207052',4,24,26,1,0,0,0,6,1,362,60,32972,31328,41749,2,20,11,0,0,1,0,10,315,84,25400,27099,31806,1,47,-24,7572,15,4229,9943,1,0,-1,0,-4
EUN1_3572380814',3,25,12,0,0,0,0,12,1,290,90,26574,25995,37151,2,21,28,1,0,1,0,2,348,60,33693,31907,52282,0,-58,30,-7119,-16,-5912,-15131,-1,0,-1,0,10
EUN1_3565291086',7,31,13,0,0,0,0,5,0,358,100,29093,30832,31557,3,31,11,0,0,1,0,6,337,84,26628,29763,32138,1,21,16,2465,2,1069,-581,0,0,-1,0,-1
EUN1_3565263546',4,22,10,1,0,1,0,12,1,381,90,26551,30945,24530,1,32,5,1,0,0,0,5,348,90,24291,27864,22048,0,33,0,2260,5,3081,2482,0,0,1,0,7
EUN1_3565220303',3,28,12,1,0,0,0,10,1,308,100,26227,28699,35762,3,35,10,0,0,1,0,2,342,80,26215,27489,36334,0,-34,20,12,2,1210,-572,1,0,-1,0,8
EUN1_3564310022',2,223,12,2,0,1,0,10,1,380,81,28730,30360,30558,7,24,11,0,0,0,0,3,315,101,26284,29964,27529,1,65,-20,2446,1,396,3029,2,0,1,0,7
EUN1_3564302094',5,22,13,1,0,1,0,15,0,310,80,28032,27866,36814,4,21,18,1,0,1,0,3,310,110,29638,30964,33932,0,0,-30,-1606,-5,-3098,2882,0,0,0,0,12
EUN1_3564273814',4,40,15,1,0,0,0,6,1,343,84,28354,30823,35461,4,28,16,1,0,0,0,3,351,80,28753,30949,37842,1,-8,4,-399,-1,-126,-2381,0,0,0,0,3
EUN1_3564092179',2,25,2,0,0,0,0,10,0,329,100,21553,26200,22797,4,67,18,2,0,4,0,1,386,100,31375,33217,30624,0,-57,0,-9822,-16,-7017,-7827,-2,0,-4,0,9
EUN1_3564050916',3,39,15,2,0,2,0,7,1,323,100,31731,30024,33517,3,17,7,0,0,0,0,8,335,76,24424,27205,24893,1,-12,24,7307,8,2819,8624,2,0,2,0,-1
EUN1_3563749060',2,27,12,0,0,0,0,7,0,321,80,26453,27895,29772,4,29,20,1,0,1,0,1,348,92,30610,30286,32440,1,-27,-12,-4157,-8,-2391,-2668,-1,0,-1,0,6
EUN1_3563576243',5,19,8,0,1,0,0,12,1,359,94,27116,28425,25257,0,25,14,0,0,2,0,3,377,110,29679,30913,34318,0,-18,-16,-2563,-6,-2488,-9061,0,1,-2,0,9
EUN1_3563536956',2,23,10,1,0,0,0,12,0,328,112,26158,31028,30493,4,29,17,0,0,3,0,3,322,92,29728,33109,44830,0,6,20,-3570,-7,-2081,-14337,1,0,-3,0,9
EUN1_3563069004',6,30,15,0,0,0,0,9,0,365,94,29428,30012,29267,4,25,20,1,0,1,0,1,352,94,30805,31851,37686,0,13,0,-1377,-5,-1839,-8419,-1,0,-1,0,8
EUN1_3563070440',3,63,14,0,0,1,0,13,1,325,82,27886,29633,33577,1,66,11,2,0,1,0,5,331,83,27187,29547,33749,1,-6,-1,699,3,86,-172,-2,0,0,0,8
EUN1_3575879065',2,33,18,0,0,0,0,6,1,370,83,30158,30900,45196,5,25,16,1,0,0,0,3,329,90,27460,29544,35732,1,41,-7,2698,2,1356,9464,-1,0,0,0,3
EUN1_3575850028',6,53,9,1,0,1,0,5,0,392,78,26201,29149,32049,5,30,14,0,0,0,0,9,344,98,26322,29535,32763,0,48,-20,-121,-5,-386,-714,1,0,1,0,-4
EUN1_3575837297',2,21,15,0,0,0,0,6,0,356,108,27966,30209,32500,2,39,11,2,0,1,0,5,346,84,26760,29958,31644,1,10,24,1206,4,251,856,-2,0,-1,0,1
EUN1_3575799426',3,29,20,1,0,1,0,6,1,302,80,30295,30185,36580,5,29,10,0,0,0,0,8,355,75,25359,28762,31476,1,-53,5,4936,10,1423,5104,1,0,1,0,-2
EUN1_3573749235',2,26,21,1,0,1,0,9,0,344,114,33759,31072,47555,1,103,18,1,0,2,0,9,255,66,28013,25154,37771,1,89,48,5746,3,5918,9784,0,0,-1,0,0
EUN1_3573724371',2,283,21,2,0,2,0,5,1,360,98,33632,33419,50752,2,22,13,0,0,0,0,5,308,84,26663,29564,33807,1,52,14,6969,8,3855,16945,2,0,2,0,0
EUN1_3573618768',4,30,13,1,1,1,0,3,1,352,86,28002,28314,27979,3,88,7,0,0,0,0,2,275,77,22517,24552,27666,1,77,9,5485,6,3762,313,1,1,1,0,1
EUN1_3573607443',4,28,14,0,0,0,0,9,1,313,83,26831,28381,32391,8,26,19,1,0,0,0,3,369,96,30348,32608,42577,0,-56,-13,-3517,-5,-4227,-10186,-1,0,0,0,6
EUN1_3573407394',5,27,17,1,0,1,0,6,0,306,78,28347,31042,37669,3,81,14,1,0,0,0,1,290,98,27166,29280,37214,1,16,-20,1181,3,1762,455,0,0,1,0,5
EUN1_3573340704',1,26,16,0,0,0,0,11,0,344,80,27203,28292,38869,1,31,21,1,0,1,0,3,333,66,30311,30675,38621,1,11,14,-3108,-5,-2383,248,-1,0,-1,0,8
EUN1_3572700257',3,48,18,2,0,0,0,8,1,331,74,28641,30977,29998,3,28,10,0,0,0,0,6,357,73,26362,28727,28453,1,-26,1,2279,8,2250,1545,2,0,0,0,2
EUN1_3572669724',5,24,27,1,0,4,0,8,0,326,68,33935,32356,54721,0,17,15,1,0,0,0,12,302,88,28393,27466,36191,1,24,-20,5542,12,4890,18530,0,0,4,0,-4
EUN1_3572617959',6,30,34,2,0,1,0,10,1,332,96,36222,32878,51756,2,30,17,0,0,1,0,7,323,67,29544,27982,37775,1,9,29,6678,17,4896,13981,2,0,0,0,3
EUN1_3572603196',5,28,10,1,0,0,0,10,1,340,100,27369,30205,29751,6,50,14,1,0,1,0,1,336,86,28184,28522,38301,1,4,14,-815,-4,1683,-8550,0,0,-1,0,9
EUN1_3572570937',5,29,16,0,0,1,0,7,0,354,75,28119,29443,35990,4,37,9,1,0,0,0,4,329,86,26581,27530,29568,0,25,-11,1538,7,1913,6422,-1,0,1,0,3
EUN1_3572082207',1,25,14,0,0,0,0,4,1,368,98,28823,31085,32985,1,22,15,1,1,0,0,5,361,98,29356,30877,31043,1,7,0,-533,-1,208,1942,-1,-1,0,0,-1
EUN1_3572056511',4,30,16,0,0,0,0,7,1,366,100,29647,29731,35331,4,30,19,2,0,0,0,3,313,60,26821,28589,36425,1,53,40,2826,-3,1142,-1094,-2,0,0,0,4
EUN1_3571472537',6,32,11,0,1,0,0,10,1,356,78,26033,27307,24645,2,25,11,1,0,1,0,3,354,88,28075,29118,31437,0,2,-10,-2042,0,-1811,-6792,-1,1,-1,0,7
EUN1_3571349938',4,30,19,0,0,0,0,5,1,330,78,31851,29992,45633,2,72,16,1,0,1,0,4,362,74,28530,30571,40091,0,-32,4,3321,3,-579,5542,-1,0,-1,0,1
EUN1_3571139000',4,26,11,0,0,0,0,10,0,306,124,26167,29663,32020,3,28,17,2,1,2,0,3,348,87,30960,30842,38811,0,-42,37,-4793,-6,-1179,-6791,-2,-1,-2,0,7
EUN1_3572637219',2,27,12,0,0,0,0,6,1,382,112,27757,30826,27945,2,23,4,2,0,0,0,4,377,64,23389,29837,21756,1,5,48,4368,8,989,6189,-2,0,0,0,2
EUN1_3572599164',3,26,5,0,0,0,0,9,1,337,87,23663,26470,20850,5,29,13,2,0,1,0,2,317,100,27354,28902,31932,0,20,-13,-3691,-8,-2432,-11082,-2,0,-1,0,7
EUN1_3572570884',2,25,14,0,0,1,0,10,0,342,80,27732,29905,29226,4,399,14,1,0,0,0,4,377,68,28027,31467,32579,0,-35,12,-295,0,-1562,-3353,-1,0,1,0,6
EUN1_3572550661',3,32,15,1,0,2,0,11,0,343,85,29234,31764,33348,5,25,13,1,0,0,0,5,367,89,27460,28472,34011,1,-24,-4,1774,2,3292,-663,0,0,2,0,6
EUN1_3572539447',4,30,12,1,0,0,0,9,1,311,85,26944,26387,31890,4,21,14,1,0,1,0,3,369,84,29222,28256,31668,1,-58,1,-2278,-2,-1869,222,0,0,-1,0,6
EUN1_3572520313',3,24,13,0,0,0,0,9,0,357,80,27541,29200,29966,4,27,13,1,0,1,0,3,330,76,27398,28974,32680,0,27,4,143,0,226,-2714,-1,0,-1,0,6
EUN1_3572511164',5,28,11,0,0,0,0,11,0,302,82,24981,27007,30704,5,30,13,2,0,1,0,2,331,106,28105,30065,28186,0,-29,-24,-3124,-2,-3058,2518,-2,0,-1,0,9
EUN1_3571814725',7,44,13,1,0,2,0,9,0,350,76,28329,30628,31905,4,30,15,1,0,1,0,7,346,75,28773,30885,35044,0,4,1,-444,-2,-257,-3139,0,0,1,0,2
EUN1_3571794963',6,28,12,2,0,0,0,7,1,321,96,26567,28250,31313,2,23,10,0,0,1,0,2,363,86,27208,29045,34408,1,-42,10,-641,2,-795,-3095,2,0,-1,0,5
EUN1_3571780699',0,25,5,0,0,0,0,4,1,340,79,22836,27868,23863,2,22,12,2,0,1,0,5,374,89,26868,29805,28100,0,-34,-10,-4032,-7,-1937,-4237,-2,0,-1,0,-1
EUN1_3571764486',3,28,14,1,0,0,0,6,1,366,105,28504,29530,34421,4,29,13,1,0,0,0,4,306,70,25527,29483,35023,1,60,35,2977,1,47,-602,0,0,0,0,2
EUN1_3571733867',9,33,13,0,0,0,0,9,1,328,99,27493,28440,35995,2,27,14,1,0,2,0,2,363,84,30245,29175,37815,0,-35,15,-2752,-1,-735,-1820,-1,0,-2,0,7
EUN1_3571206187',1,28,13,0,0,1,0,9,0,314,96,27681,28164,35839,6,101,14,2,0,0,0,5,330,60,26781,28820,35052,0,-16,36,900,-1,-656,787,-2,0,1,0,4
EUN1_3571179465',2,18,15,2,0,2,0,6,1,378,108,30527,31280,29078,2,24,7,0,0,0,0,8,340,76,23722,28636,28255,1,38,32,6805,8,2644,823,2,0,2,0,-2
EUN1_3574861555',0,32,11,2,0,0,0,10,1,323,82,26229,27039,26444,3,27,16,0,0,0,0,3,340,74,27542,31093,32477,1,-17,8,-1313,-5,-4054,-6033,2,0,0,0,7
EUN1_3574853175',6,32,6,0,1,1,0,8,0,339,86,24535,30247,20324,4,26,11,2,0,0,0,3,358,81,26307,30767,32814,0,-19,5,-1772,-5,-520,-12490,-2,1,1,0,5
EUN1_3574821769',11,57,6,0,0,0,0,9,1,351,78,23882,27115,28183,3,22,13,2,0,1,0,7,314,92,27062,29930,22574,1,37,-14,-3180,-7,-2815,5609,-2,0,-1,0,2
EUN1_3572526080',5,28,13,0,0,1,0,8,0,320,78,27303,27453,27657,5,29,12,0,0,1,0,5,353,70,27783,28741,37887,0,-33,8,-480,1,-1288,-10230,0,0,0,0,3
EUN1_3572500820',7,33,16,2,0,0,0,9,1,351,94,29512,30185,32663,3,28,9,0,0,1,0,5,360,82,25354,28548,26393,1,-9,12,4158,7,1637,6270,2,0,-1,0,4
EUN1_3568852183',3,29,8,1,1,1,0,11,1,312,78,24546,28688,22249,2,70,8,1,0,1,0,1,409,90,26845,30503,28935,1,-97,-12,-2299,0,-1815,-6686,0,1,0,0,10
EUN1_3568840146',2,25,13,0,0,1,0,12,0,373,102,28615,30850,32102,3,24,11,1,0,1,0,2,364,102,27970,30312,26923,0,9,0,645,2,538,5179,-1,0,0,0,10
EUN1_3573475686',0,19,16,0,0,0,0,4,1,369,107,29581,32706,37219,2,24,9,1,0,0,0,7,360,72,25518,29578,30085,1,9,35,4063,7,3128,7134,-1,0,0,0,-3
EUN1_3573462502',4,27,12,1,0,0,0,11,0,344,64,25826,30126,31973,5,39,12,1,0,1,0,2,383,104,29326,30277,30974,0,-39,-40,-3500,0,-151,999,0,0,-1,0,9
EUN1_3573455213',4,26,19,2,0,1,0,6,1,338,75,30202,30072,32429,0,19,11,0,0,0,0,5,329,81,25867,28263,25844,1,9,-6,4335,8,1809,6585,2,0,1,0,1
EUN1_3573435278',4,25,18,2,0,1,0,4,1,411,110,31238,33339,36475,7,29,7,0,0,0,0,4,348,82,23621,28083,26995,1,63,28,7617,11,5256,9480,2,0,1,0,0
EUN1_3573401360',5,22,15,0,0,0,0,10,1,372,93,28862,29091,36071,5,32,19,2,0,1,0,3,337,95,31580,33002,39239,0,35,-2,-2718,-4,-3911,-3168,-2,0,-1,0,7
EUN1_3573365541',4,28,9,1,0,0,0,7,0,359,88,25955,31220,25185,4,27,9,1,0,1,0,2,387,86,26550,29868,30697,1,-28,2,-595,0,1352,-5512,0,0,-1,0,5
EUN1_3573338733',3,26,25,0,1,1,0,5,1,308,88,31924,29596,42548,6,33,13,0,0,0,0,7,336,68,27791,27927,35502,1,-28,20,4133,12,1669,7046,0,1,1,0,-2
EUN1_3573326328',1,24,14,1,0,1,0,9,1,352,94,29479,30666,34855,0,15,7,0,0,0,0,4,356,87,23756,28702,22773,1,-4,7,5723,7,1964,12082,1,0,1,0,5
EUN1_3573305117',0,18,13,0,0,1,0,6,0,309,75,26964,28763,33834,5,26,17,1,1,1,0,0,339,120,29947,31320,36501,0,-30,-45,-2983,-4,-2557,-2667,-1,-1,0,0,6
EUN1_3573212721',4,57,12,1,0,0,0,5,0,348,85,27048,31660,33363,4,278,11,1,0,0,0,4,357,90,26576,30230,38026,1,-9,-5,472,1,1430,-4663,0,0,0,0,1
EUN1_3573181706',6,34,11,1,0,0,0,12,1,320,88,25220,26322,26835,2,25,17,1,0,2,0,0,368,86,30479,30723,34732,1,-48,2,-5259,-6,-4401,-7897,0,0,-2,0,12
EUN1_3572651873',5,28,14,0,0,0,0,9,0,312,81,28559,28509,33357,4,24,18,1,0,2,0,7,334,87,29146,30005,46647,0,-22,-6,-587,-4,-1496,-13290,-1,0,-2,0,2
EUN1_3572636089',4,26,6,0,0,0,0,7,1,355,69,23188,27339,27501,4,24,10,2,0,1,0,1,385,98,26920,32182,35416,1,-30,-29,-3732,-4,-4843,-7915,-2,0,-1,0,6
EUN1_3572581183',3,16,12,0,0,0,0,15,0,341,63,26565,28833,30538,3,17,22,2,0,1,0,3,368,108,31794,32886,41635,0,-27,-45,-5229,-10,-4053,-11097,-2,0,-1,0,12
EUN1_3572562161',7,131,9,0,0,0,0,11,0,339,84,24933,29353,28658,4,22,16,2,0,1,0,4,365,112,29022,32357,30725,0,-26,-28,-4089,-7,-3004,-2067,-2,0,-1,0,7
EUN1_3576242236',3,24,20,2,0,0,0,6,1,328,88,29915,29992,45600,7,34,11,0,0,0,0,3,299,60,25634,26411,33758,0,29,28,4281,9,3581,11842,2,0,0,0,3
EUN1_3576139303',4,27,12,2,1,1,0,8,1,365,94,28780,28974,37097,1,23,14,0,0,1,0,7,304,110,26838,27988,27332,1,61,-16,1942,-2,986,9765,2,1,0,0,1
EUN1_3576109567',4,21,19,1,0,0,0,10,1,316,104,29480,28271,38914,5,42,17,0,0,1,0,2,346,54,29340,28269,34486,1,-30,50,140,2,2,4428,1,0,-1,0,8
EUN1_3575738614',4,29,11,2,0,0,0,7,1,364,98,27811,32639,32937,5,30,8,0,0,1,0,3,360,85,25910,29471,25268,1,4,13,1901,3,3168,7669,2,0,-1,0,4
EUN1_3575630635',5,26,11,0,0,0,0,11,0,352,84,26809,30380,27828,4,72,12,2,0,1,0,1,412,92,28126,30621,39903,0,-60,-8,-1317,-1,-241,-12075,-2,0,-1,0,10
EUN1_3575613801',3,23,8,0,0,0,0,10,0,320,72,24772,27805,24814,6,25,13,2,0,0,0,2,369,116,27576,29969,31287,0,-49,-44,-2804,-5,-2164,-6473,-2,0,0,0,8
EUN1_3573044939',3,24,0,0,0,0,0,15,0,243,67,17719,22418,16294,3,23,17,2,1,4,0,0,382,109,33474,31390,30421,0,-139,-42,-15755,-17,-8972,-14127,-2,-1,-4,0,15
EUN1_3573036922',4,34,8,0,0,1,0,7,0,357,90,26705,28499,30944,6,95,15,2,1,0,0,5,351,97,27376,32157,32417,1,6,-7,-671,-7,-3658,-1473,-2,-1,1,0,2
EUN1_3572567189',4,88,16,1,0,1,0,11,1,337,66,28713,28937,36777,2,23,15,0,0,1,0,1,358,90,29262,28561,35715,1,-21,-24,-549,1,376,1062,1,0,0,0,10
EUN1_3572537781',1,174,10,1,0,0,0,12,0,321,58,25326,26346,19342,7,28,18,1,0,3,0,4,392,94,32908,31150,40540,1,-71,-36,-7582,-8,-4804,-21198,0,0,-3,0,8
EUN1_3572531860',5,30,8,0,0,0,0,3,1,382,80,26255,29203,30676,2,94,16,2,0,0,0,5,366,76,28257,32101,35862,0,16,4,-2002,-8,-2898,-5186,-2,0,0,0,-2
EUN1_3572345119',0,21,15,1,0,0,0,6,0,314,98,27517,30733,31608,0,23,15,1,0,0,0,2,371,98,28934,32324,37622,1,-57,0,-1417,0,-1591,-6014,0,0,0,0,4
EUN1_3572144240',2,126,6,2,0,0,0,6,1,350,88,23707,27035,23474,3,24,14,0,0,2,0,1,364,100,28139,30750,31584,1,-14,-12,-4432,-8,-3715,-8110,2,0,-2,0,5
EUN1_3571459078',6,30,13,0,1,0,0,8,1,276,85,26625,26962,30810,2,21,18,2,0,1,0,3,356,90,29544,29136,33954,1,-80,-5,-2919,-5,-2174,-3144,-2,1,-1,0,5
EUN1_3571216866',2,145,12,0,0,0,0,7,0,335,68,25653,29036,27940,2,23,14,2,0,0,0,4,338,88,28335,28382,35139,0,-3,-20,-2682,-2,654,-7199,-2,0,0,0,3
EUN1_3570722772',5,28,9,2,0,0,0,12,1,313,76,25211,28340,23021,1,27,10,0,1,0,0,1,369,92,25829,29005,27477,1,-56,-16,-618,-1,-665,-4456,2,-1,0,0,11
EUN1_3570704196',3,25,22,2,0,1,0,9,1,343,96,30613,30572,38202,3,102,10,0,0,1,0,4,298,62,25540,25895,20799,1,45,34,5073,12,4677,17403,2,0,0,0,5
EUN1_3567668755',4,25,20,1,0,1,0,6,0,378,100,30791,32547,29895,5,45,8,1,0,0,0,7,352,72,25284,26676,26418,1,26,28,5507,12,5871,3477,0,0,1,0,-1
EUN1_3567121122',4,31,10,0,0,0,0,15,0,314,102,25667,26991,27960,1,28,20,2,0,3,0,1,381,110,33853,32308,40722,0,-67,-8,-8186,-10,-5317,-12762,-2,0,-3,0,14
EUN1_3565635599',4,29,13,0,0,0,0,6,1,381,88,28545,30686,31353,8,240,9,1,0,1,0,4,332,92,25890,28251,30615,1,49,-4,2655,4,2435,738,-1,0,-1,0,2
EUN1_3565591594',5,55,15,2,0,1,0,3,0,354,92,30068,32311,34531,4,32,9,0,0,1,0,5,357,87,26351,30202,29615,0,-3,5,3717,6,2109,4916,2,0,0,0,-2
EUN1_3565444907',3,28,8,2,0,0,0,7,1,323,75,26162,28455,33234,5,104,11,0,0,1,0,1,291,72,24303,26030,32987,1,32,3,1859,-3,2425,247,2,0,-1,0,6
EUN1_3565419506',5,174,10,1,0,0,0,5,0,364,80,25702,30314,29579,2,25,11,1,1,0,0,4,375,124,27284,32556,31323,0,-11,-44,-1582,-1,-2242,-1744,0,-1,0,0,1
EUN1_3565304135',3,35,6,1,0,0,0,7,0,363,74,24608,27430,23216,6,34,11,1,0,1,0,3,335,88,26967,29438,28487,0,28,-14,-2359,-5,-2008,-5271,0,0,-1,0,4
EUN1_3565209501',3,21,15,1,0,1,0,8,1,341,86,30138,29402,34270,5,24,14,0,0,1,0,4,331,82,26987,29433,26492,1,10,4,3151,1,-31,7778,1,0,0,0,4
EUN1_3565199159',7,30,17,1,0,0,0,8,1,323,64,28490,28347,38246,4,24,16,1,0,1,0,1,328,100,29113,30854,38258,1,-5,-36,-623,1,-2507,-12,0,0,-1,0,7
EUN1_3564743658',3,210,13,2,1,1,0,8,1,371,94,29064,31187,31022,0,22,7,0,0,1,0,3,381,94,26087,29579,27481,1,-10,0,2977,6,1608,3541,2,1,0,0,5
EUN1_3564480882',8,47,10,2,0,0,0,8,0,333,81,25392,27183,25876,9,37,13,0,0,1,0,6,357,98,27757,28914,27798,0,-24,-17,-2365,-3,-1731,-1922,2,0,-1,0,2
EUN1_3564461575',3,30,8,2,0,0,0,15,0,290,89,25572,27449,30925,7,249,22,0,0,4,0,1,372,101,34922,31460,41404,0,-82,-12,-9350,-14,-4011,-10479,2,0,-4,0,14
EUN1_3562904128',5,149,10,2,0,2,0,4,1,419,122,29301,32220,28584,7,31,4,0,0,0,0,6,396,85,23642,29257,22028,1,23,37,5659,6,2963,6556,2,0,2,0,-2
EUN1_3562607550',1,25,10,0,0,0,0,3,0,360,86,27236,28713,33633,6,90,17,1,0,0,0,5,343,66,27925,28599,38080,0,17,20,-689,-7,114,-4447,-1,0,0,0,-2
EUN1_3562139697',7,26,13,0,0,0,0,6,1,358,68,26609,29972,28721,4,23,10,2,1,1,0,1,367,102,26520,30725,28389,0,-9,-34,89,3,-753,332,-2,-1,-1,0,5
EUN1_3562136418',1,19,16,0,0,1,0,10,1,329,95,30991,30567,34413,3,173,19,1,0,2,0,7,346,80,32349,30230,40343,0,-17,15,-1358,-3,337,-5930,-1,0,-1,0,3
EUN1_3561669268',2,101,12,1,0,1,0,9,0,313,89,27301,30625,26483,2,27,13,1,1,1,0,3,397,102,29313,31280,29633,0,-84,-13,-2012,-1,-655,-3150,0,-1,0,0,6
EUN1_3561654020',1,92,17,1,0,0,0,11,1,337,86,29162,29437,33507,3,162,10,1,0,2,0,2,322,81,27284,26927,28402,1,15,5,1878,7,2510,5105,0,0,-2,0,9
EUN1_3561387736',5,213,5,1,0,0,0,10,0,348,78,22714,27425,26829,7,70,14,1,0,1,0,1,405,102,29394,33050,34484,0,-57,-24,-6680,-9,-5625,-7655,0,0,-1,0,9
EUN1_3561265139',2,114,11,2,0,2,0,3,0,358,89,28099,29320,27082,3,104,8,0,0,0,0,6,355,78,25526,28169,22899,0,3,11,2573,3,1151,4183,2,0,2,0,-3
EUN1_3574571655',4,22,8,0,0,0,0,11,0,372,80,25524,29686,22890,2,26,11,2,0,1,0,1,402,88,28528,30327,23087,0,-30,-8,-3004,-3,-641,-197,-2,0,-1,0,10
EUN1_3574559615',4,81,17,0,0,3,0,5,1,355,84,30184,30983,34244,4,69,11,1,0,0,0,6,312,108,25818,28806,25023,0,43,-24,4366,6,2177,9221,-1,0,3,0,-1
EUN1_3574517794',3,30,12,1,0,1,0,7,1,363,78,26979,29009,34038,5,28,11,1,0,0,0,7,323,90,25813,29334,26348,1,40,-12,1166,1,-325,7690,0,0,1,0,0
EUN1_3574498945',2,81,18,1,0,1,0,9,1,334,98,30704,31497,39197,4,34,7,1,0,2,0,5,305,90,24203,27650,28780,1,29,8,6501,11,3847,10417,0,0,-1,0,4
EUN1_3574491135',2,31,9,1,0,0,0,6,0,312,82,23780,26946,27133,1,20,18,1,0,2,0,1,349,89,30648,31745,36676,0,-37,-7,-6868,-9,-4799,-9543,0,0,-2,0,5
EUN1_3574470275',4,28,14,2,1,0,0,8,0,385,83,28606,30317,28122,2,30,9,0,0,0,0,3,325,91,25054,27868,19716,1,60,-8,3552,5,2449,8406,2,1,0,0,5
EUN1_3573700081',3,28,20,1,0,1,0,8,1,384,93,31475,32561,39851,4,30,12,0,0,0,0,4,307,78,26069,29810,29849,1,77,15,5406,8,2751,10002,1,0,1,0,4
EUN1_3573648252',1,28,13,0,0,0,0,6,0,337,94,27226,28997,34194,4,156,13,1,0,0,0,2,328,81,27600,29029,33036,0,9,13,-374,0,-32,1158,-1,0,0,0,4
EUN1_3573625239',5,27,12,0,0,0,0,8,1,334,82,25875,28075,28152,6,27,10,1,0,1,0,2,355,70,26787,29524,31160,0,-21,12,-912,2,-1449,-3008,-1,0,-1,0,6
EUN1_3573613243',8,33,18,1,0,0,0,3,0,337,76,27475,30913,39840,3,32,8,0,0,0,0,0,344,70,24062,28711,35395,1,-7,6,3413,10,2202,4445,1,0,0,0,3
EUN1_3573593924',4,33,13,2,0,0,0,15,0,301,84,25465,28501,33834,3,22,17,0,0,2,0,1,331,74,30846,30770,39173,1,-30,10,-5381,-4,-2269,-5339,2,0,-2,0,14
EUN1_3573585273',3,34,11,1,0,0,0,8,1,340,99,26012,28792,27348,2,25,7,0,0,2,0,1,371,68,26054,28812,28657,0,-31,31,-42,4,-20,-1309,1,0,-2,0,7
EUN1_3573571325',7,24,20,1,0,0,0,12,1,373,90,32831,30942,39567,3,29,15,0,0,2,0,6,341,61,28469,29009,33091,0,32,29,4362,5,1933,6476,1,0,-2,0,6
EUN1_3573557370',3,23,13,2,0,0,0,12,1,335,96,28038,29156,36900,1,22,12,0,0,1,0,3,306,88,25365,30733,30986,1,29,8,2673,1,-1577,5914,2,0,-1,0,9
EUN1_3571436083',1,31,6,1,0,0,0,10,1,347,84,24651,27546,33209,4,26,21,1,1,3,0,3,332,92,31597,31952,37018,0,15,-8,-6946,-15,-4406,-3809,0,-1,-3,0,7
EUN1_3571356911',3,26,7,1,0,0,0,7,1,406,93,25952,30745,26795,2,92,3,1,0,1,0,3,372,94,23554,29005,23650,0,34,-1,2398,4,1740,3145,0,0,-1,0,4
EUN1_3574209525',4,28,13,0,0,1,0,11,0,366,78,28118,30428,23279,2,135,9,2,0,1,0,8,379,94,28376,30274,29591,1,-13,-16,-258,4,154,-6312,-2,0,0,0,3
EUN1_3574186409',2,29,17,1,1,1,0,5,0,340,99,29870,31565,35600,3,33,17,0,0,0,0,9,334,84,29204,29025,40038,1,6,15,666,0,2540,-4438,1,1,1,0,-4
EUN1_3572329791',3,145,8,0,0,2,0,9,1,374,65,26579,26684,34546,3,24,18,2,1,1,0,7,356,73,29066,31080,33270,0,18,-8,-2487,-10,-4396,1276,-2,-1,1,0,2
EUN1_3568925472',4,26,17,1,0,1,0,4,1,389,82,30094,30082,34108,5,22,5,1,0,0,0,6,288,86,22397,26350,23598,1,101,-4,7697,12,3732,10510,0,0,1,0,-2
EUN1_3568532160',1,17,3,0,0,0,0,15,1,308,68,20710,24777,20226,3,27,20,1,0,3,0,2,402,101,32617,34044,46129,0,-94,-33,-11907,-17,-9267,-25903,-1,0,-3,0,13
EUN1_3568511406',4,78,14,2,0,1,0,9,0,370,108,29309,31791,35654,2,22,10,0,0,1,0,5,326,91,25664,28436,28798,1,44,17,3645,4,3355,6856,2,0,0,0,4
EUN1_3568501376',4,24,16,1,0,2,0,11,1,386,92,30403,31003,40978,2,27,10,1,0,0,0,5,334,94,25248,29624,31145,1,52,-2,5155,6,1379,9833,0,0,2,0,6
EUN1_3568351544',8,89,29,2,0,2,0,5,1,336,100,36720,31747,46033,2,39,10,0,0,1,0,10,337,76,27712,26415,29511,1,-1,24,9008,19,5332,16522,2,0,1,0,-5
EUN1_3568340306',1,26,6,0,0,0,0,13,0,327,76,23870,26356,19499,5,30,13,2,0,2,0,4,376,100,29617,30284,29325,0,-49,-24,-5747,-7,-3928,-9826,-2,0,-2,0,9
EUN1_3568211881',3,53,6,1,0,1,0,6,0,363,84,25499,28800,30261,5,29,15,1,0,0,0,7,316,96,27743,30271,27755,1,47,-12,-2244,-9,-1471,2506,0,0,1,0,-1
EUN1_3568188647',4,25,15,0,0,0,0,8,0,299,90,26982,28568,33891,4,31,11,1,0,1,0,2,349,82,27696,29501,33066,1,-50,8,-714,4,-933,825,-1,0,-1,0,6
EUN1_3568118834',4,39,15,1,0,0,0,3,1,335,74,28646,29638,32367,6,30,15,1,0,0,0,2,304,74,27862,28580,36840,0,31,0,784,0,1058,-4473,0,0,0,0,1
EUN1_3568110261',4,26,10,0,0,0,0,8,0,323,79,25207,30163,29412,2,26,10,2,0,1,0,1,384,92,27340,30223,26421,0,-61,-13,-2133,0,-60,2991,-2,0,-1,0,7
EUN1_3576233543',4,36,10,1,0,0,0,7,0,386,108,27049,30238,27864,9,28,10,1,0,0,0,3,364,92,26590,29983,28839,1,22,16,459,0,255,-975,0,0,0,0,4
EUN1_3576225042',3,27,15,0,0,0,0,15,1,330,80,27892,30003,36514,3,33,16,2,0,0,0,1,349,103,30165,31469,31763,1,-19,-23,-2273,-1,-1466,4751,-2,0,0,0,14
EUN1_3576102425',7,29,19,2,0,3,0,9,0,321,100,31105,30530,44102,2,26,12,0,0,1,0,4,327,81,28510,28672,36870,1,-6,19,2595,7,1858,7232,2,0,2,0,5
EUN1_3576074669',6,29,4,1,0,0,0,11,0,384,68,23486,27929,19112,8,36,12,0,0,1,0,1,378,124,29159,34517,29334,0,6,-56,-5673,-8,-6588,-10222,1,0,-1,0,10
EUN1_3575971478',2,20,17,1,0,1,0,5,1,345,120,30447,32158,38916,2,30,8,1,0,0,0,4,348,68,25014,28521,34744,1,-3,52,5433,9,3637,4172,0,0,1,0,1
EUN1_3575954296',5,102,10,0,1,0,0,10,1,338,66,26023,27108,34039,2,23,19,2,0,1,0,3,333,86,28805,31485,36287,0,5,-20,-2782,-9,-4377,-2248,-2,1,-1,0,7
EUN1_3575933407',3,26,5,1,0,2,0,7,1,368,72,26024,27355,28711,10,33,14,1,0,0,0,4,314,120,27090,29972,32014,1,54,-48,-1066,-9,-2617,-3303,0,0,2,0,3
EUN1_3575897660',6,30,20,2,0,1,0,8,1,370,106,32315,32754,39130,4,38,10,0,0,2,0,9,349,70,26323,28249,30042,1,21,36,5992,10,4505,9088,2,0,-1,0,-1
EUN1_3575878902',3,26,18,2,1,2,0,7,1,374,120,31678,33242,37137,3,25,8,0,0,0,0,5,310,91,24792,29288,29775,1,64,29,6886,10,3954,7362,2,1,2,0,2
EUN1_3575859820',1,79,10,1,0,0,0,8,1,320,84,24601,27271,25467,3,20,9,1,0,1,0,0,351,115,27300,30666,26386,0,-31,-31,-2699,1,-3395,-919,0,0,-1,0,8
EUN1_3575845348',6,122,9,2,0,0,0,11,0,372,92,24779,29273,28348,4,27,10,0,0,1,0,1,357,94,27584,29219,27702,0,15,-2,-2805,-1,54,646,2,0,-1,0,10
EUN1_3575833192',2,21,10,0,0,0,0,10,0,341,105,26471,29186,28666,1,20,14,2,1,1,0,3,383,102,28940,32784,37944,0,-42,3,-2469,-4,-3598,-9278,-2,-1,-1,0,7
EUN1_3575809263',4,28,8,0,1,0,0,7,0,304,110,24610,29701,22514,4,28,9,2,0,0,0,2,398,98,26339,30287,31351,0,-94,12,-1729,-1,-586,-8837,-2,1,0,0,5
EUN1_3575784891',5,23,10,2,0,2,0,8,1,383,104,28257,30554,33115,4,257,7,0,0,0,0,9,333,95,23791,27507,23357,0,50,9,4466,3,3047,9758,2,0,2,0,-1
EUN1_3575769993',5,22,16,1,1,3,0,6,1,416,100,31824,33026,33160,2,17,4,0,0,0,0,8,339,94,23163,28539,24557,1,77,6,8661,12,4487,8603,1,1,3,0,-2
EUN1_3575471132',2,26,8,0,0,0,0,15,0,294,88,25821,27535,27299,4,25,30,1,0,4,0,5,352,75,34614,32013,44543,0,-58,13,-8793,-22,-4478,-17244,-1,0,-4,0,10
EUN1_3575432695',3,26,17,2,0,0,0,11,0,354,88,28491,29414,34962,5,28,14,0,0,2,0,1,356,80,29448,30582,34022,1,-2,8,-957,3,-1168,940,2,0,-2,0,10
EUN1_3575410774',2,33,21,2,0,2,0,7,1,362,86,31911,31727,38007,2,27,8,0,0,0,0,5,305,86,24439,27294,27544,1,57,0,7472,13,4433,10463,2,0,2,0,2
EUN1_3575369988',3,20,21,2,0,3,0,14,1,395,92,32844,31436,55242,6,30,14,0,0,1,0,6,362,88,28772,30854,33716,1,33,4,4072,7,582,21526,2,0,2,0,8
EUN1_3575351865',4,78,8,1,1,0,0,4,1,363,125,26021,31661,20532,4,24,3,1,0,0,0,3,367,84,22551,29369,18393,1,-4,41,3470,5,2292,2139,0,1,0,0,1
EUN1_3576234524',3,25,5,0,0,0,0,6,0,322,92,22873,26997,23611,3,44,19,1,1,1,0,0,353,92,30395,32101,34277,0,-31,0,-7522,-14,-5104,-10666,-1,-1,-1,0,6
EUN1_3576084097',4,155,12,1,0,1,0,8,0,336,100,27561,28954,36949,8,32,11,1,1,1,0,2,308,60,25601,27875,28666,1,28,40,1960,1,1079,8283,0,-1,0,0,6
EUN1_3576058856',2,19,14,2,0,0,0,16,0,316,68,27634,26030,30221,1,40,24,0,0,2,0,3,337,100,33800,31033,37726,0,-21,-32,-6166,-10,-5003,-7505,2,0,-2,0,13
EUN1_3576045448',4,47,18,2,1,3,0,6,1,349,89,31556,30770,34047,4,24,7,0,0,0,0,7,285,88,23981,26714,21296,1,64,1,7575,11,4056,12751,2,1,3,0,-1
EUN1_3576010023',1,25,10,1,0,1,0,8,1,380,96,27475,30144,27654,1,17,5,0,0,0,0,5,339,88,22761,28139,24718,0,41,8,4714,5,2005,2936,1,0,1,0,3
EUN1_3575990264',5,23,12,0,0,0,0,12,1,322,74,26332,28939,36420,1,30,16,1,0,1,0,3,318,69,28609,30364,35385,1,4,5,-2277,-4,-1425,1035,-1,0,-1,0,9
EUN1_3575969350',13,151,20,2,0,2,0,12,1,336,102,31566,30855,39392,6,42,12,0,0,0,0,2,312,60,25632,26750,31005,1,24,42,5934,8,4105,8387,2,0,2,0,10
EUN1_3575936463',1,22,7,0,0,0,0,10,1,329,96,24855,29229,28088,1,44,16,1,0,0,0,1,354,84,28951,31172,35443,0,-25,12,-4096,-9,-1943,-7355,-1,0,0,0,9
EUN1_3575915267',2,27,8,1,0,0,0,4,1,380,84,26483,30116,23523,4,30,10,0,0,1,0,4,360,78,25395,27939,21866,0,20,6,1088,-2,2177,1657,1,0,-1,0,0
EUN1_3575881929',5,139,9,1,0,0,0,11,0,291,80,24927,28074,24233,4,26,11,1,0,2,0,1,384,88,27612,28230,26829,1,-93,-8,-2685,-2,-156,-2596,0,0,-2,0,10
EUN1_3575859360',3,49,15,1,0,0,0,7,1,371,74,29117,31282,36249,1,23,13,1,0,0,0,4,367,93,27901,29446,32086,0,4,-19,1216,2,1836,4163,0,0,0,0,3
EUN1_3575832918',4,69,13,1,1,0,0,11,0,342,82,27465,29260,24950,1,21,16,1,0,2,0,3,329,76,29823,32536,32489,0,13,6,-2358,-3,-3276,-7539,0,1,-2,0,8
EUN1_3575810895',6,28,17,1,0,1,0,6,1,361,96,31522,32057,35044,8,35,13,1,0,0,0,5,370,102,28780,32564,36419,1,-9,-6,2742,4,-507,-1375,0,0,1,0,1
EUN1_3575731867',3,31,11,0,0,0,0,11,1,370,101,26199,30569,27105,3,27,11,2,0,2,0,1,357,93,27849,29924,29760,0,13,8,-1650,0,645,-2655,-2,0,-2,0,10
EUN1_3575576675',4,171,18,0,0,1,0,8,0,343,82,28030,30268,35008,4,32,7,1,0,0,0,2,315,74,24957,26180,23687,0,28,8,3073,11,4088,11321,-1,0,1,0,6
EUN1_3575557333',4,31,11,0,0,0,0,14,0,309,70,24822,27963,33511,2,21,15,1,0,2,0,1,370,86,30193,31563,36888,0,-61,-16,-5371,-4,-3600,-3377,-1,0,-2,0,13
EUN1_3575474710',3,135,10,1,0,0,0,13,0,323,63,25454,28870,36887,4,27,23,1,0,2,0,1,309,104,31670,33136,40703,0,14,-41,-6216,-13,-4266,-3816,0,0,-2,0,12
EUN1_3575423432',2,43,12,1,0,0,0,7,0,413,134,29701,34088,34698,4,28,6,1,0,1,0,6,354,82,23813,27765,21716,1,59,52,5888,6,6323,12982,0,0,-1,0,1
EUN1_3575387820',6,46,15,0,0,0,0,11,0,333,82,28484,29219,35449,3,23,20,2,0,0,0,2,333,105,30887,31583,40278,1,0,-23,-2403,-5,-2364,-4829,-2,0,0,0,9
EUN1_3571593880',11,36,13,0,0,0,0,8,1,314,80,26974,30261,32382,4,30,14,2,0,0,0,1,358,88,27447,29559,35171,0,-44,-8,-473,-1,702,-2789,-2,0,0,0,7
EUN1_3568762861',5,23,14,2,0,1,0,6,1,379,96,29055,30282,29334,2,33,10,0,0,0,0,5,356,72,26861,28087,26093,1,23,24,2194,4,2195,3241,2,0,1,0,1
EUN1_3568742431',7,25,11,2,0,1,0,3,1,433,128,29313,34276,27339,5,26,6,0,0,1,0,7,399,64,23507,29077,23886,1,34,64,5806,5,5199,3453,2,0,0,0,-4
EUN1_3568019706',3,23,10,1,0,0,0,8,0,330,58,25357,27699,34727,1,23,16,0,0,0,0,3,336,106,29340,32941,35291,0,-6,-48,-3983,-6,-5242,-564,1,0,0,0,5
EUN1_3567746776',4,28,9,1,0,0,0,7,0,305,107,26056,27885,28098,7,33,7,0,0,1,0,3,328,88,24304,28504,25387,1,-23,19,1752,2,-619,2711,1,0,-1,0,4
EUN1_3567605295',2,22,12,2,0,0,0,4,1,339,92,26983,31414,29878,3,24,5,0,0,1,0,5,352,88,24035,28664,30371,1,-13,4,2948,7,2750,-493,2,0,-1,0,-1
EUN1_3567598203',5,30,10,1,0,0,0,13,1,331,100,26678,27830,29302,4,21,17,0,0,1,0,2,308,79,29007,29527,30500,0,23,21,-2329,-7,-1697,-1198,1,0,-1,0,11
EUN1_3572593812',2,34,9,0,0,0,0,6,1,346,86,26378,28868,31682,5,208,13,2,0,0,0,3,314,94,26230,29969,27178,0,32,-8,148,-4,-1101,4504,-2,0,0,0,3
EUN1_3572578482',3,24,6,0,0,0,0,3,0,402,66,24151,28670,24066,3,27,11,2,0,1,0,3,374,98,27162,29077,28344,0,28,-32,-3011,-5,-407,-4278,-2,0,-1,0,0
EUN1_3572573228',2,18,8,1,0,0,0,10,0,330,80,23903,28485,27316,3,26,22,1,0,2,0,2,395,123,33034,34949,41024,0,-65,-43,-9131,-14,-6464,-13708,0,0,-2,0,8
EUN1_3572556295',4,30,15,1,0,1,0,15,0,279,71,28057,26523,37571,3,26,20,0,0,2,0,4,345,124,32700,32320,42042,0,-66,-53,-4643,-5,-5797,-4471,1,0,-1,0,11
EUN1_3572508128',5,54,11,1,0,0,0,7,1,363,101,25787,29341,19849,3,43,4,1,0,1,0,2,371,106,24352,29172,20050,0,-8,-5,1435,7,169,-201,0,0,-1,0,5
EUN1_3572477195',8,179,23,2,0,0,0,2,1,364,86,31948,32235,43874,8,30,16,0,0,1,0,5,286,78,26339,27657,36780,1,78,8,5609,7,4578,7094,2,0,-1,0,-3
EUN1_3571472878',3,25,10,0,0,0,0,10,0,291,82,25172,28051,30608,3,39,19,2,1,3,0,6,359,78,30039,33516,36019,0,-68,4,-4867,-9,-5465,-5411,-2,-1,-3,0,4
EUN1_3571373958',7,34,1,1,0,0,0,10,0,386,82,22357,27984,20641,4,100,15,0,0,1,0,1,402,70,28453,32315,31093,0,-16,12,-6096,-14,-4331,-10452,1,0,-1,0,9
EUN1_3576242631',5,31,14,1,0,0,0,13,1,299,76,27386,28138,39351,3,26,19,1,0,3,0,4,401,97,33243,33925,45563,0,-102,-21,-5857,-5,-5787,-6212,0,0,-3,0,9
EUN1_3576222988',1,144,5,0,0,0,0,12,0,358,64,23566,27828,31021,3,25,15,2,0,1,0,3,362,88,28677,32096,39241,1,-4,-24,-5111,-10,-4268,-8220,-2,0,-1,0,9
EUN1_3575759301',5,29,19,1,0,1,0,7,0,358,97,30949,30640,45199,1,22,16,0,0,1,0,5,318,74,28929,29649,36240,1,40,23,2020,3,991,8959,1,0,0,0,2
EUN1_3575741360',5,29,9,1,0,0,0,6,1,394,80,26218,29920,30794,1,19,16,1,0,0,0,1,373,80,27370,32788,35476,0,21,0,-1152,-7,-2868,-4682,0,0,0,0,5
EUN1_3575724721',6,36,9,2,0,0,0,10,1,394,82,26508,30368,27991,2,221,7,0,1,1,0,6,347,86,25199,28767,32001,1,47,-4,1309,2,1601,-4010,2,-1,-1,0,4
EUN1_3575397563',1,23,9,1,0,0,0,17,0,275,84,24289,26043,27541,8,48,18,1,0,5,0,2,395,116,34812,32674,37450,0,-120,-32,-10523,-9,-6631,-9909,0,0,-5,0,15
EUN1_3575383126',3,30,8,0,0,0,0,8,1,406,77,26358,30181,34385,4,28,12,2,0,0,0,1,382,95,26782,29909,25078,0,24,-18,-424,-4,272,9307,-2,0,0,0,7
EUN1_3575350677',4,32,9,2,0,1,0,6,1,374,94,26882,29556,29572,2,152,5,0,0,1,0,4,349,86,24119,26359,30571,1,25,8,2763,4,3197,-999,2,0,0,0,2
EUN1_3575338367',4,30,15,0,1,1,0,6,0,367,84,30052,29870,39296,6,29,17,1,0,1,0,2,356,78,29312,28109,40634,1,11,6,740,-2,1761,-1338,-1,1,0,0,4
EUN1_3575310463',1,24,10,0,0,1,0,10,1,370,84,26503,29871,39198,4,88,17,1,0,2,0,5,384,100,30761,32108,43809,1,-14,-16,-4258,-7,-2237,-4611,-1,0,-1,0,5
EUN1_3574289816',2,149,12,1,0,1,0,12,1,345,75,28174,28370,29660,2,26,10,1,0,0,0,5,322,108,27063,27777,32030,0,23,-33,1111,2,593,-2370,0,0,1,0,7
EUN1_3574273040',4,25,14,2,0,1,0,10,1,318,78,29054,28348,34708,1,25,15,0,0,0,0,6,304,76,27455,27750,32330,1,14,2,1599,-1,598,2378,2,0,1,0,4
EUN1_3574125524',2,21,10,1,0,1,0,15,0,337,99,26548,30447,30761,3,133,13,1,0,1,0,2,371,91,28190,30993,34675,0,-34,8,-1642,-3,-546,-3914,0,0,0,0,13
EUN1_3574112781',2,20,7,0,0,0,0,12,0,318,56,24170,27670,28124,3,28,14,2,0,2,0,4,394,108,30096,31517,30247,0,-76,-52,-5926,-7,-3847,-2123,-2,0,-2,0,8
EUN1_3573934117',7,41,15,0,0,0,0,8,1,369,84,28384,29041,34228,5,27,11,1,0,1,0,3,396,92,28658,32495,33130,0,-27,-8,-274,4,-3454,1098,-1,0,-1,0,5
EUN1_3573909151',3,27,12,0,0,0,0,6,1,325,74,26595,26817,36490,6,42,20,2,0,0,0,3,321,90,29080,30393,43753,0,4,-16,-2485,-8,-3576,-7263,-2,0,0,0,3
EUN1_3573877402',3,60,14,0,0,1,0,7,1,338,86,29348,30376,33525,1,68,13,2,0,1,0,5,337,94,28173,29520,33979,1,1,-8,1175,1,856,-454,-2,0,0,0,2
EUN1_3573845741',3,24,7,0,0,0,0,14,0,311,84,24128,27896,28364,1,28,13,2,0,2,0,4,372,88,28665,31060,35510,1,-61,-4,-4537,-6,-3164,-7146,-2,0,-2,0,10
EUN1_3576229050',2,20,12,0,0,2,0,10,0,381,84,28242,30876,39845,4,28,16,1,0,0,0,4,360,100,28774,31369,39511,0,21,-16,-532,-4,-493,334,-1,0,2,0,6
EUN1_3575252284',3,31,15,2,0,1,0,4,0,366,95,30192,32041,35710,3,25,12,0,0,1,0,7,346,71,26085,27933,34857,1,20,24,4107,3,4108,853,2,0,0,0,-3
EUN1_3575204220',3,66,13,1,0,0,0,7,1,368,86,28418,30672,40040,0,25,6,0,0,1,0,7,318,94,23985,28748,27237,1,50,-8,4433,7,1924,12803,1,0,-1,0,0
EUN1_3575183703',3,24,14,2,0,0,0,10,0,358,94,27612,31446,27617,3,30,12,0,0,1,0,2,331,89,26747,29783,28650,1,27,5,865,2,1663,-1033,2,0,-1,0,8
EUN1_3575166985',1,137,15,1,0,2,0,9,1,366,85,30355,31462,34887,3,26,7,1,0,1,0,6,366,90,26553,28416,33281,0,0,-5,3802,8,3046,1606,0,0,1,0,3
EUN1_3574669365',3,35,2,0,0,0,0,6,1,399,89,22910,28853,19617,3,30,9,2,0,0,0,3,407,71,24933,30394,21062,1,-8,18,-2023,-7,-1541,-1445,-2,0,0,0,3
EUN1_3574647957',1,34,8,0,0,1,0,6,0,345,76,25336,28240,25327,6,31,14,1,0,0,0,2,345,92,27080,30512,31498,0,0,-16,-1744,-6,-2272,-6171,-1,0,1,0,4
EUN1_3574248398',8,32,5,1,0,0,0,10,1,371,82,22605,29759,22894,5,28,10,1,0,1,0,0,400,113,28323,32416,28824,0,-29,-31,-5718,-5,-2657,-5930,0,0,-1,0,10
EUN1_3574121828',5,26,6,0,0,0,0,12,0,313,68,22852,25738,27805,2,23,20,2,0,2,0,5,345,82,31327,30394,36729,0,-32,-14,-8475,-14,-4656,-8924,-2,0,-2,0,7
EUN1_3574110804',8,30,14,0,0,1,0,7,0,353,82,28757,29014,39437,6,31,10,2,0,1,0,4,394,86,26918,28962,29698,0,-41,-4,1839,4,52,9739,-2,0,0,0,3
EUN1_3576093285',1,25,10,0,1,0,0,12,0,363,82,25831,29295,25995,1,29,15,2,0,1,0,3,334,93,29741,31337,31586,0,29,-11,-3910,-5,-2042,-5591,-2,1,-1,0,9
EUN1_3576020619',6,26,15,1,0,3,0,8,1,373,96,31259,29387,27927,2,21,10,1,0,0,0,11,266,76,23929,21898,24202,1,107,20,7330,5,7489,3725,0,0,3,0,-3
EUN1_3575478334',3,23,17,2,0,2,0,4,1,393,90,29986,31297,36395,4,28,4,0,0,0,0,3,340,94,22552,28185,24371,1,53,-4,7434,13,3112,12024,2,0,2,0,1
EUN1_3575444214',4,30,14,0,0,0,0,9,0,338,80,27428,30680,33875,3,254,14,2,0,1,0,3,353,86,28547,29657,31645,0,-15,-6,-1119,0,1023,2230,-2,0,-1,0,6
EUN1_3575381914',3,29,10,1,0,1,0,6,1,362,92,27571,29623,39658,5,79,12,1,0,0,0,5,353,87,26198,30202,34397,0,9,5,1373,-2,-579,5261,0,0,1,0,1
EUN1_3575322348',2,29,7,0,0,0,0,7,1,383,98,25362,28751,19078,3,25,9,2,0,1,0,3,398,85,27474,30388,20159,0,-15,13,-2112,-2,-1637,-1081,-2,0,-1,0,4
EUN1_3575297805',6,33,9,2,0,1,0,9,1,355,100,26583,29961,28165,4,39,12,0,1,1,0,2,335,92,27080,29309,24576,0,20,8,-497,-3,652,3589,2,-1,0,0,7
EUN1_3575285234',5,27,7,0,0,0,0,6,0,334,88,24171,26353,28669,3,110,10,2,0,0,0,1,329,68,24419,25175,28779,0,5,20,-248,-3,1178,-110,-2,0,0,0,5
EUN1_3575266329',4,32,12,1,0,0,0,9,1,340,84,26363,28251,32224,2,142,11,1,0,1,0,0,324,103,27386,29160,29036,0,16,-19,-1023,1,-909,3188,0,0,-1,0,9
EUN1_3575234831',5,87,10,0,0,1,0,8,1,331,72,25818,28197,35468,6,68,12,2,0,1,0,3,335,76,26713,28837,32426,0,-4,-4,-895,-2,-640,3042,-2,0,0,0,5
EUN1_3575210979',4,228,12,2,0,1,0,11,1,344,94,27965,29933,33537,2,28,18,0,0,2,0,4,326,82,30263,31120,37065,1,18,12,-2298,-6,-1187,-3528,2,0,-1,0,7
EUN1_3576159143',1,20,11,1,0,0,0,15,1,351,69,27134,29772,33011,4,189,14,1,0,3,0,4,374,82,30672,31038,33056,1,-23,-13,-3538,-3,-1266,-45,0,0,-3,0,11
EUN1_3576132698',2,27,22,1,0,2,0,8,1,357,93,34038,31556,37471,2,23,18,1,0,1,0,10,302,70,29721,28633,30973,1,55,23,4317,4,2923,6498,0,0,1,0,-2
EUN1_3576118142',1,19,8,0,0,0,0,14,0,362,51,24287,27909,29999,5,31,26,1,0,2,0,1,317,116,34872,32469,41919,0,45,-65,-10585,-18,-4560,-11920,-1,0,-2,0,13
EUN1_3574974902',3,21,6,1,0,0,0,4,0,401,81,25288,30971,26526,2,43,8,1,0,0,0,1,381,102,25464,30698,23347,1,20,-21,-176,-2,273,3179,0,0,0,0,3
EUN1_3574946688',3,22,21,0,0,0,0,9,1,359,74,30291,30433,36174,2,34,16,1,0,2,0,6,317,102,29030,30963,33586,0,42,-28,1261,5,-530,2588,-1,0,-2,0,3
EUN1_3574913756',5,33,12,1,0,1,0,9,0,312,85,26319,29400,31100,5,33,14,0,0,2,0,6,342,78,28484,28834,36546,1,-30,7,-2165,-2,566,-5446,1,0,-1,0,3
EUN1_3574893678',1,26,3,0,0,0,0,7,0,414,98,24692,29121,25808,5,25,15,2,0,2,0,3,395,101,30554,32551,30403,0,19,-3,-5862,-12,-3430,-4595,-2,0,-2,0,4
EUN1_3574872482',7,49,25,1,1,0,0,11,1,337,96,31170,30494,36340,4,23,10,1,0,0,0,6,325,71,26097,27345,37148,1,12,25,5073,15,3149,-808,0,1,0,0,5
EUN1_3574855524',5,27,14,2,0,0,0,15,0,330,78,26850,29815,28985,5,32,8,0,0,2,0,1,370,102,28333,29558,31289,0,-40,-24,-1483,6,257,-2304,2,0,-2,0,14
EUN1_3574838428',6,47,13,0,0,0,0,14,1,314,72,26700,27518,34284,4,25,21,2,0,4,0,3,379,120,35379,34347,43917,0,-65,-48,-8679,-8,-6829,-9633,-2,0,-4,0,11
EUN1_3574806850',1,152,15,0,0,1,0,6,0,363,90,28151,31235,40975,3,32,9,1,0,0,0,6,270,75,23696,26079,34598,0,93,15,4455,6,5156,6377,-1,0,1,0,0
EUN1_3574788758',2,28,13,1,0,0,0,9,0,292,66,25947,27381,32465,1,27,24,1,0,1,0,3,316,96,31719,30014,40221,0,-24,-30,-5772,-11,-2633,-7756,0,0,-1,0,6
EUN1_3574459849',4,29,16,1,0,2,0,9,1,351,110,31052,30822,36030,1,77,12,0,0,0,0,9,315,70,26178,27748,31005,1,36,40,4874,4,3074,5025,1,0,2,0,0
EUN1_3574444247',5,29,8,1,0,0,0,5,0,374,101,25677,29895,20860,4,34,14,1,0,1,0,2,366,80,28251,30434,29697,0,8,21,-2574,-6,-539,-8837,0,0,-1,0,3
EUN1_3574412750',7,22,7,0,0,0,0,11,1,309,76,22977,26670,31321,4,26,17,1,1,2,0,1,374,86,30987,32588,42625,0,-65,-10,-8010,-10,-5918,-11304,-1,-1,-2,0,10
EUN1_3574365680',8,21,16,1,0,3,0,10,0,357,80,30489,30163,37057,3,20,11,0,0,1,0,11,310,62,25578,26841,26728,1,47,18,4911,5,3322,10329,1,0,2,0,-1
EUN1_3574347610',3,29,9,1,0,0,0,17,0,365,80,26146,28509,22392,6,30,16,1,0,2,0,1,357,91,30930,29983,31387,0,8,-11,-4784,-7,-1474,-8995,0,0,-2,0,16
EUN1_3573833997',1,51,13,1,0,2,0,11,0,331,102,28021,29095,27169,6,25,8,0,0,2,0,4,359,88,26478,28030,23622,1,-28,14,1543,5,1065,3547,1,0,0,0,7
EUN1_3573808757',3,27,12,1,0,2,0,7,1,373,110,28497,32032,31656,1,28,13,1,0,1,0,4,326,82,27464,29246,35120,0,47,28,1033,-1,2786,-3464,0,0,1,0,3
EUN1_3573781026',5,25,11,1,0,0,0,10,0,377,80,26363,29460,26890,2,59,9,1,0,2,0,2,387,65,28180,28415,26185,0,-10,15,-1817,2,1045,705,0,0,-2,0,8
EUN1_3575811691',4,26,21,2,0,2,0,5,0,331,82,32316,28421,39093,3,38,13,0,0,1,0,10,289,94,27784,27257,36460,0,42,-12,4532,8,1164,2633,2,0,1,0,-5
EUN1_3575742776',4,130,11,1,0,0,0,17,1,305,88,26262,28627,34956,0,22,16,1,0,2,0,1,371,80,30419,32422,41360,0,-66,8,-4157,-5,-3795,-6404,0,0,-2,0,16
EUN1_3575726869',6,142,15,0,0,0,0,9,1,359,82,29900,31002,35477,7,60,17,2,0,1,0,3,348,102,28891,31148,35210,0,11,-20,1009,-2,-146,267,-2,0,-1,0,6
EUN1_3575711188',4,100,13,0,0,0,0,8,0,360,80,27031,30346,37210,4,148,14,2,0,1,0,2,324,103,27419,30154,29228,0,36,-23,-388,-1,192,7982,-2,0,-1,0,6
EUN1_3575700368',5,23,8,0,0,0,0,16,0,319,84,23503,28140,22975,5,185,14,2,1,3,0,0,364,112,31379,31464,31527,0,-45,-28,-7876,-6,-3324,-8552,-2,-1,-3,0,16
EUN1_3575692682',3,174,13,0,1,0,0,6,0,330,105,26735,28285,32110,0,80,13,2,0,0,0,6,338,84,27919,30073,38119,0,-8,21,-1184,0,-1788,-6009,-2,1,0,0,0
EUN1_3575689445',5,34,8,0,0,0,0,6,0,353,70,24581,26950,31246,5,39,13,2,0,0,0,3,329,109,26828,30372,25337,0,24,-39,-2247,-5,-3422,5909,-2,0,0,0,3
EUN1_3575685462',4,32,18,1,0,0,0,10,1,304,84,27898,28301,30087,2,22,17,1,1,2,0,4,354,88,30393,29668,34986,1,-50,-4,-2495,1,-1367,-4899,0,-1,-2,0,6
EUN1_3575394501',3,33,20,2,0,1,0,6,0,322,98,31664,30577,36364,5,25,14,0,0,2,0,8,316,66,26524,27295,40106,1,6,32,5140,6,3282,-3742,2,0,-1,0,-2
EUN1_3575165821',6,163,12,1,1,0,0,12,1,337,98,27845,29660,30269,5,31,7,1,0,1,0,2,334,94,24774,28906,24457,0,3,4,3071,5,754,5812,0,1,-1,0,10
EUN1_3575159767',3,138,11,2,0,1,0,10,0,334,80,28018,28935,34012,5,40,18,0,0,2,0,5,329,104,30579,31751,38295,0,5,-24,-2561,-7,-2816,-4283,2,0,-1,0,5
EUN1_3567197814',3,24,4,1,0,0,0,12,0,315,78,21700,26760,24129,3,23,16,1,0,2,0,2,387,94,30631,33125,28873,0,-72,-16,-8931,-12,-6365,-4744,0,0,-2,0,10
EUN1_3566295141',1,31,10,1,0,1,0,8,1,376,85,27668,28805,28304,2,31,12,1,0,1,0,6,348,98,27473,30788,27680,1,28,-13,195,-2,-1983,624,0,0,0,0,2
EUN1_3566276074',0,24,14,1,0,2,0,8,1,360,86,28407,31479,26671,5,38,4,1,0,0,0,4,332,82,22162,26204,20618,1,28,4,6245,10,5275,6053,0,0,2,0,4
EUN1_3565519053',0,28,20,2,0,0,0,9,0,328,85,29059,32232,41852,4,23,11,0,0,0,0,1,367,110,27915,31641,33126,1,-39,-25,1144,9,591,8726,2,0,0,0,8
EUN1_3565511230',1,20,7,0,0,0,0,7,0,265,82,24120,26973,29851,6,42,20,2,0,2,0,3,332,86,28999,31150,43111,0,-67,-4,-4879,-13,-4177,-13260,-2,0,-2,0,4
EUN1_3565487876',9,31,5,0,0,0,0,10,0,348,86,23067,29309,26466,4,23,14,2,1,0,0,1,360,109,28532,32778,32459,0,-12,-23,-5465,-9,-3469,-5993,-2,-1,0,0,9
EUN1_3565169190',2,140,12,1,0,0,0,6,1,364,94,27808,30779,37355,6,26,11,1,0,0,0,3,355,80,26941,29978,31147,0,9,14,867,1,801,6208,0,0,0,0,3
EUN1_3565154542',3,33,5,2,0,1,0,2,1,418,93,27770,30204,24653,0,52,5,0,1,0,0,7,392,82,23677,30239,19357,1,26,11,4093,0,-35,5296,2,-1,1,0,-5
EUN1_3565150156',7,53,11,0,0,0,0,12,0,369,98,26751,30344,22155,5,33,11,2,0,1,0,3,396,110,29453,31808,22673,0,-27,-12,-2702,0,-1464,-518,-2,0,-1,0,9
EUN1_3565140606',7,29,19,0,1,3,0,6,1,394,94,30836,32445,33562,2,23,6,1,0,0,0,4,329,73,24423,27273,26403,1,65,21,6413,13,5172,7159,-1,1,3,0,2
EUN1_3565084277',2,26,17,1,0,1,0,8,0,360,78,31208,29998,38840,2,93,14,0,0,1,0,3,305,98,27453,28010,35332,1,55,-20,3755,3,1988,3508,1,0,0,0,5
EUN1_3565065558',4,76,9,0,0,0,0,11,0,330,77,24070,30411,26795,2,59,9,2,0,1,0,0,359,102,27649,28542,29413,1,-29,-25,-3579,0,1869,-2618,-2,0,-1,0,11
EUN1_3565026891',0,23,12,1,0,0,0,11,0,287,100,25100,28005,28713,6,40,14,0,0,1,0,0,380,86,28934,29982,32819,0,-93,14,-3834,-2,-1977,-4106,1,0,-1,0,11
EUN1_3564711130',3,23,7,0,0,1,0,6,0,414,89,27241,30089,32714,3,28,14,2,0,0,0,4,362,83,27456,29146,31968,0,52,6,-215,-7,943,746,-2,0,1,0,2
EUN1_3564690947',3,24,8,1,1,1,0,7,0,339,91,25227,29018,26989,2,27,12,0,0,1,0,5,319,79,26272,27547,28268,1,20,12,-1045,-4,1471,-1279,1,1,0,0,2
EUN1_3564692215',7,28,11,1,0,0,0,6,1,338,77,26024,27237,32771,11,37,17,1,0,0,0,3,328,87,28761,30135,37075,1,10,-10,-2737,-6,-2898,-4304,0,0,0,0,3
EUN1_3564634278',3,21,17,1,0,2,0,5,0,343,60,28665,29623,37559,2,24,8,0,0,0,0,3,290,92,23949,26584,26926,1,53,-32,4716,9,3039,10633,1,0,2,0,2
EUN1_3564616502',3,222,19,2,0,0,0,10,0,296,98,29758,29547,41119,1,31,15,0,0,1,0,5,305,106,29954,29219,41288,1,-9,-8,-196,4,328,-169,2,0,-1,0,5
EUN1_3564594520',3,24,8,1,0,0,0,7,0,372,98,26029,28334,28803,5,31,15,1,0,1,0,2,284,78,27774,26772,32013,0,88,20,-1745,-7,1562,-3210,0,0,-1,0,5
EUN1_3575247219',5,29,11,1,1,0,0,6,1,297,73,25444,27990,35244,1,93,12,0,0,0,0,0,367,82,27173,29791,30741,1,-70,-9,-1729,-1,-1801,4503,1,1,0,0,6
EUN1_3572754862',1,19,9,0,0,0,0,11,0,349,82,26175,28555,33398,4,22,13,2,0,1,0,1,328,94,27370,31530,31554,0,21,-12,-1195,-4,-2975,1844,-2,0,-1,0,10
EUN1_3572723080',2,32,20,1,0,2,0,6,0,370,88,31538,28803,37023,3,28,18,1,0,0,0,8,299,104,28634,28676,38149,1,71,-16,2904,2,127,-1126,0,0,2,0,-2
EUN1_3572684410',0,27,17,1,0,1,0,7,1,344,97,30007,30680,37530,4,24,12,1,0,0,0,5,331,98,26908,29079,31909,1,13,-1,3099,5,1601,5621,0,0,1,0,2
EUN1_3569230793',2,29,12,0,0,1,0,11,0,389,86,28862,30615,35429,4,98,14,2,0,0,0,4,320,88,26936,30738,28824,1,69,-2,1926,-2,-123,6605,-2,0,1,0,7
EUN1_3569200545',5,66,12,1,0,0,0,6,0,328,70,26384,28405,34364,5,64,14,1,0,2,0,2,369,106,29331,30264,33594,0,-41,-36,-2947,-2,-1859,770,0,0,-2,0,4
EUN1_3567205765',1,18,12,0,0,0,0,8,0,350,119,28580,29888,30223,2,28,9,1,0,1,0,4,341,82,25004,28421,28395,1,9,37,3576,3,1467,1828,-1,0,-1,0,4
EUN1_3567188351',2,212,10,1,0,1,0,9,1,356,102,27209,30692,32344,7,43,8,1,0,0,0,2,313,82,24973,28905,27820,1,43,20,2236,2,1787,4524,0,0,1,0,7
EUN1_3566147550',5,25,15,1,0,1,0,11,1,322,103,29462,29394,40246,1,19,18,1,0,1,0,5,347,88,32212,32055,38835,1,-25,15,-2750,-3,-2661,1411,0,0,0,0,6
EUN1_3565426340',3,21,6,0,0,0,0,12,0,344,74,24079,28110,29110,9,40,15,2,0,2,0,1,360,102,30532,31964,36029,0,-16,-28,-6453,-9,-3854,-6919,-2,0,-2,0,11
EUN1_3565393257',2,17,18,2,0,1,0,6,1,380,98,30172,30969,44005,2,22,10,0,0,2,0,3,327,74,25548,29181,36601,0,53,24,4624,8,1788,7404,2,0,-1,0,3
EUN1_3565351961',8,25,18,2,0,2,0,8,1,340,100,30613,30908,37990,0,22,6,0,0,0,0,6,351,90,24831,28941,24180,1,-11,10,5782,12,1967,13810,2,0,2,0,2
EUN1_3565336735',3,46,20,1,0,3,0,10,1,354,108,32864,33278,39210,3,24,8,0,0,0,0,5,324,80,25260,28253,29794,1,30,28,7604,12,5025,9416,1,0,3,0,5
EUN1_3565320816',8,31,23,2,0,2,0,11,1,386,85,33538,32357,42102,2,152,11,0,0,2,0,9,287,79,25826,26372,40535,1,99,6,7712,12,5985,1567,2,0,0,0,2
EUN1_3565180044',4,23,13,2,0,2,0,10,1,343,100,28786,31738,31959,2,27,7,0,0,0,0,8,383,88,25433,29837,30356,1,-40,12,3353,6,1901,1603,2,0,2,0,2
EUN1_3565182075',5,23,20,1,0,2,0,9,0,374,72,31558,30916,37207,2,20,14,1,0,0,0,5,358,82,28817,30149,34234,0,16,-10,2741,6,767,2973,0,0,2,0,4
EUN1_3565124947',1,23,14,0,0,1,0,14,0,364,91,29080,31467,32394,2,33,20,2,0,1,0,6,356,84,31721,32402,43868,0,8,7,-2641,-6,-935,-11474,-2,0,0,0,8
EUN1_3565122675',3,28,16,0,1,0,0,11,1,330,110,29833,31885,34172,2,18,15,2,0,1,0,2,314,90,28307,29920,32690,0,16,20,1526,1,1965,1482,-2,1,-1,0,9
EUN1_3565115947',7,29,7,0,0,0,0,11,0,329,90,23639,27287,26086,1,23,14,1,0,2,0,3,395,96,30175,32244,31912,0,-66,-6,-6536,-7,-4957,-5826,-1,0,-2,0,8
EUN1_3576111447',4,28,15,1,0,0,0,13,1,313,94,26580,28537,35604,7,29,11,0,0,1,0,1,316,62,27744,26728,30739,1,-3,32,-1164,4,1809,4865,1,0,-1,0,12
EUN1_3576082990',0,22,5,0,0,0,0,11,0,359,107,24657,27117,33141,3,23,23,2,1,3,0,1,417,116,34109,36178,33372,0,-58,-9,-9452,-18,-9061,-231,-2,-1,-3,0,10
EUN1_3576069543',8,33,19,2,0,2,0,9,1,389,86,31655,32683,43526,3,19,11,0,0,0,0,7,350,94,26947,29469,30041,1,39,-8,4708,8,3214,13485,2,0,2,0,2
EUN1_3575853379',2,23,18,2,0,0,0,14,0,304,93,28054,26148,33006,0,31,12,0,0,1,0,0,363,74,28768,27887,24513,1,-59,19,-714,6,-1739,8493,2,0,-1,0,14
EUN1_3575809969',2,20,9,0,0,1,0,11,0,292,76,25461,24639,31646,4,45,22,1,0,2,0,6,313,86,31289,30332,38228,0,-21,-10,-5828,-13,-5693,-6582,-1,0,-1,0,5
EUN1_3575788369',7,28,16,2,1,1,0,6,1,329,92,29647,28857,33773,11,33,12,0,0,0,0,5,346,76,27477,27851,24241,0,-17,16,2170,4,1006,9532,2,1,1,0,1
EUN1_3575764215',4,31,16,1,0,0,0,8,1,257,98,28703,27811,33580,4,107,20,1,0,1,0,3,367,77,31992,31504,48402,0,-110,21,-3289,-4,-3693,-14822,0,0,-1,0,5
EUN1_3575672290',4,28,13,1,1,1,0,8,0,375,97,30551,32019,33953,11,44,19,1,0,1,0,6,318,65,29177,28617,43040,0,57,32,1374,-6,3402,-9087,0,1,0,0,2
EUN1_3575664855',4,21,9,1,0,0,0,4,1,368,94,25952,29622,23996,3,34,9,1,0,0,0,0,380,94,26388,29011,30762,0,-12,0,-436,0,611,-6766,0,0,0,0,4
EUN1_3575655240',0,71,9,1,0,1,0,7,1,363,88,26298,29639,33083,1,23,11,0,0,0,0,3,348,102,26221,30614,29092,0,15,-14,77,-2,-975,3991,1,0,1,0,4
EUN1_3575638635',3,44,16,1,0,1,0,12,0,320,74,28031,27582,35128,0,28,16,0,0,4,0,8,324,81,30852,27598,37166,1,-4,-7,-2821,0,-16,-2038,1,0,-3,0,4
EUN1_3575508042',2,26,16,0,0,1,0,6,0,347,94,30012,29829,41571,4,28,14,1,0,0,0,1,339,72,27095,27928,38730,0,8,22,2917,2,1901,2841,-1,0,1,0,5
EUN1_3575484625',4,43,22,2,0,1,0,5,0,352,74,32375,31562,40307,3,30,10,0,0,1,0,7,317,72,25041,25728,29597,1,35,2,7334,12,5834,10710,2,0,0,0,-2
EUN1_3575465652',4,33,10,1,0,0,0,18,0,284,66,25179,25614,31320,1,25,33,1,1,3,0,7,353,108,37182,34616,51840,0,-69,-42,-12003,-23,-9002,-20520,0,-1,-3,0,11
EUN1_3575438582',5,32,11,0,0,1,0,7,1,327,108,26731,30710,31868,5,30,12,2,0,1,0,5,339,80,26088,29616,32478,0,-12,28,643,-1,1094,-610,-2,0,0,0,2
EUN1_3575415482',4,30,15,1,0,0,0,11,0,285,82,25962,26974,26728,5,26,12,1,0,0,0,2,349,94,28242,30140,28272,0,-64,-12,-2280,3,-3166,-1544,0,0,0,0,9
EUN1_3574055182',4,22,11,1,0,0,0,5,1,322,78,27393,27900,33710,3,27,11,1,0,1,0,7,306,66,25501,26559,32827,1,16,12,1892,0,1341,883,0,0,-1,0,-2
EUN1_3574034801',2,196,10,0,0,0,0,19,0,324,134,27786,30887,31719,4,27,22,2,1,3,0,4,342,68,32309,32543,40695,0,-18,66,-4523,-12,-1656,-8976,-2,-1,-3,0,15
EUN1_3574010157',4,21,9,0,0,0,0,12,0,350,86,25475,31056,24816,2,82,9,2,0,2,0,4,382,118,28468,32310,33393,1,-32,-32,-2993,0,-1254,-8577,-2,0,-2,0,8
EUN1_3573991110',1,23,9,1,0,0,0,11,0,335,103,25880,28824,27758,2,30,23,1,0,2,0,2,353,96,31747,31869,32991,0,-18,7,-5867,-14,-3045,-5233,0,0,-2,0,9
EUN1_3571259702',1,24,6,0,0,0,0,9,0,353,76,24753,29280,27589,2,20,18,1,0,2,0,5,370,83,30550,32589,37104,0,-17,-7,-5797,-12,-3309,-9515,-1,0,-2,0,4
EUN1_3570537212',8,43,9,2,0,0,0,6,1,363,87,26822,28594,28186,5,31,10,0,0,1,0,3,333,100,25821,29119,21765,0,30,-13,1001,-1,-525,6421,2,0,-1,0,3
EUN1_3570525273',2,22,9,0,0,1,0,10,0,312,94,25211,29297,20157,4,138,11,2,1,2,0,5,365,110,27666,31104,29324,0,-53,-16,-2455,-2,-1807,-9167,-2,-1,-1,0,5
EUN1_3573298544',5,24,13,0,0,0,0,7,0,356,78,27135,29401,43717,5,38,19,2,0,0,0,5,351,94,28914,31998,40345,0,5,-16,-1779,-6,-2597,3372,-2,0,0,0,2
EUN1_3572896724',0,23,15,1,0,3,0,8,1,362,106,30798,31424,31502,3,79,11,0,0,1,0,8,312,67,25685,29115,27067,1,50,39,5113,4,2309,4435,1,0,2,0,0
EUN1_3572871663',3,26,26,2,0,1,0,6,0,346,90,33165,31786,48736,4,23,15,0,0,0,0,6,281,78,28282,27092,45923,1,65,12,4883,11,4694,2813,2,0,1,0,0
EUN1_3572846703',2,64,12,0,0,0,0,9,0,339,70,26112,29118,28584,5,59,18,2,0,1,0,1,383,118,32220,34578,36794,0,-44,-48,-6108,-6,-5460,-8210,-2,0,-1,0,8
EUN1_3572814978',5,28,14,2,0,1,0,2,1,362,94,28608,29118,31843,6,26,10,0,0,0,0,11,300,85,25223,27886,25883,1,62,9,3385,4,1232,5960,2,0,1,0,-9
EUN1_3572786633',3,40,14,0,0,0,0,13,0,348,68,26954,28315,28040,2,30,17,2,1,1,0,4,339,78,29680,29710,32453,0,9,-10,-2726,-3,-1395,-4413,-2,-1,-1,0,9
EUN1_3571652640',3,24,14,1,0,0,0,11,0,316,92,26591,29419,30989,3,32,12,1,0,1,0,3,336,103,27061,28984,35730,1,-20,-11,-470,2,435,-4741,0,0,-1,0,8
EUN1_3571625256',5,69,9,1,0,1,0,15,0,309,84,25901,29436,31288,0,54,15,1,0,1,0,5,342,83,29111,30469,38360,0,-33,1,-3210,-6,-1033,-7072,0,0,0,0,10
EUN1_3575621399',4,47,11,1,0,1,0,11,0,370,80,28118,30026,29888,4,25,11,1,0,0,0,5,334,84,25348,27773,32408,1,36,-4,2770,0,2253,-2520,0,0,1,0,6
EUN1_3575593937',2,22,10,0,0,1,0,11,1,366,102,27220,30518,27379,4,33,10,2,0,0,0,3,313,90,25214,28877,32221,0,53,12,2006,0,1641,-4842,-2,0,1,0,8
EUN1_3575574469',3,29,9,1,1,0,0,12,0,365,109,26453,30665,24331,3,27,9,1,0,2,0,3,343,93,28125,29444,31730,0,22,16,-1672,0,1221,-7399,0,1,-2,0,9
EUN1_3573974833',4,22,7,0,0,0,0,11,1,330,75,23515,26831,21298,4,32,15,2,0,2,0,2,344,99,27838,29580,34940,0,-14,-24,-4323,-8,-2749,-13642,-2,0,-2,0,9
EUN1_3573946974',0,25,20,1,0,2,0,8,1,415,96,34245,33711,40350,4,27,14,1,0,0,0,5,297,89,25922,28462,29319,1,118,7,8323,6,5249,11031,0,0,2,0,3
EUN1_3573930635',1,84,25,2,0,3,0,10,1,360,109,34583,33082,40524,3,32,3,0,0,1,0,4,285,78,20220,24313,23784,1,75,31,14363,22,8769,16740,2,0,2,0,6
EUN1_3573444018',0,23,26,2,1,2,0,4,1,338,100,35228,31496,51758,3,28,16,0,0,0,0,10,292,50,26308,25469,37216,1,46,50,8920,10,6027,14542,2,1,2,0,-6
EUN1_3573393950',4,27,13,1,0,1,0,4,0,340,96,27753,30064,34623,8,28,15,1,0,0,0,2,363,93,27187,31749,37036,0,-23,3,566,-2,-1685,-2413,0,0,1,0,2
EUN1_3573351998',5,27,11,0,0,1,0,5,1,394,74,26701,29591,24417,5,63,4,2,0,0,0,2,376,96,23004,29095,22888,0,18,-22,3697,7,496,1529,-2,0,1,0,3
EUN1_3572633706',0,17,13,0,0,0,0,15,1,354,72,27646,29282,33175,4,23,14,1,0,2,0,3,359,80,29662,30399,31717,0,-5,-8,-2016,-1,-1117,1458,-1,0,-2,0,12
EUN1_3572618201',2,23,13,2,0,0,0,8,1,341,94,26035,29081,29667,2,25,6,0,0,0,0,3,357,84,24706,27489,31529,1,-16,10,1329,7,1592,-1862,2,0,0,0,5
EUN1_3572399452',4,62,11,0,0,0,0,5,0,362,87,26241,29143,32519,6,68,12,1,0,0,0,2,354,77,26059,29230,33036,1,8,10,182,-1,-87,-517,-1,0,0,0,3
EUN1_3572389667',3,27,13,2,0,0,0,7,0,282,96,25598,26972,35439,3,27,16,0,0,0,0,1,343,94,29026,28769,39805,0,-61,2,-3428,-3,-1797,-4366,2,0,0,0,6
EUN1_3572377898',9,28,19,2,0,2,0,4,1,377,132,32528,33786,35713,3,22,5,0,0,0,0,10,323,76,21876,26356,24110,1,54,56,10652,14,7430,11603,2,0,2,0,-6
EUN1_3572310694',2,31,10,1,0,0,0,13,0,340,82,25199,28180,31163,5,47,16,0,0,1,0,3,322,102,28766,28739,41007,0,18,-20,-3567,-6,-559,-9844,1,0,-1,0,10
EUN1_3572288497',3,23,6,1,0,0,0,7,1,334,82,23113,26731,22384,3,29,13,1,0,0,0,0,381,114,27733,31640,33626,0,-47,-32,-4620,-7,-4909,-11242,0,0,0,0,7
EUN1_3571762789',2,19,11,1,0,0,0,10,1,376,80,26374,29205,28962,3,22,12,1,0,2,0,2,384,112,28698,31050,31792,1,-8,-32,-2324,-1,-1845,-2830,0,0,-2,0,8
EUN1_3571750490',7,32,16,0,0,1,0,9,0,280,82,28322,25779,43823,4,24,26,2,0,1,0,7,318,74,32733,29186,43996,0,-38,8,-4411,-10,-3407,-173,-2,0,0,0,2
EUN1_3573441265',1,22,8,1,0,1,0,9,1,330,106,25140,29656,24031,2,19,6,0,0,0,0,4,362,78,23872,29009,26278,0,-32,28,1268,2,647,-2247,1,0,1,0,5
EUN1_3573412456',5,44,16,0,0,0,0,10,1,347,86,28527,29734,30705,1,22,11,0,0,1,0,3,346,94,27786,28540,33523,1,1,-8,741,5,1194,-2818,0,0,-1,0,7
EUN1_3572916096',2,18,7,0,0,1,0,14,1,337,66,24194,27011,25283,6,32,17,1,0,2,0,3,360,94,30709,29392,37423,0,-23,-28,-6515,-10,-2381,-12140,-1,0,-1,0,11
EUN1_3568119863',1,21,10,1,0,0,0,12,0,320,108,25921,27430,34071,0,18,16,1,0,1,0,2,344,76,27983,30802,29069,0,-24,32,-2062,-6,-3372,5002,0,0,-1,0,10
EUN1_3568102794',3,21,19,0,0,0,0,13,1,312,122,29226,31674,35451,2,25,10,1,0,2,0,3,349,76,27767,28169,26956,0,-37,46,1459,9,3505,8495,-1,0,-2,0,10
EUN1_3568085097',2,60,16,1,0,1,0,10,0,330,88,28843,30724,30539,4,90,14,0,0,1,0,7,303,90,27145,28042,32651,1,27,-2,1698,2,2682,-2112,1,0,0,0,3
EUN1_3568069141',3,50,8,1,0,0,0,9,0,386,72,26087,29180,23542,2,24,9,1,0,0,0,4,359,94,25912,28757,21013,0,27,-22,175,-1,423,2529,0,0,0,0,5
EUN1_3568055439',2,25,27,0,0,2,0,8,1,389,77,34514,30994,48675,3,30,11,1,0,0,0,7,299,74,25130,26262,31295,1,90,3,9384,16,4732,17380,-1,0,2,0,1
EUN1_3567924543',4,24,11,0,0,0,0,7,0,355,78,27244,29532,32310,3,47,14,2,0,1,0,4,318,84,26338,27861,35094,0,37,-6,906,-3,1671,-2784,-2,0,-1,0,3
EUN1_3567913167',3,24,11,0,0,0,0,4,0,337,86,26747,29285,27465,3,42,16,0,0,0,0,3,356,82,27477,29853,32485,0,-19,4,-730,-5,-568,-5020,0,0,0,0,1
EUN1_3565506379',0,135,14,1,0,0,0,9,1,342,94,29059,29652,35588,2,21,11,1,0,1,0,7,316,106,27157,28597,29055,1,26,-12,1902,3,1055,6533,0,0,-1,0,2
EUN1_3565484405',2,27,24,1,0,3,0,10,1,366,96,34189,32408,38221,0,19,12,0,0,0,0,5,329,80,27769,28029,29526,1,37,16,6420,12,4379,8695,1,0,3,0,5
EUN1_3565465281',6,33,10,0,1,1,0,6,0,395,106,27481,31732,39334,5,45,9,2,0,0,0,4,364,64,24553,29233,23942,1,31,42,2928,1,2499,15392,-2,1,1,0,2
EUN1_3565080591',1,20,6,0,0,0,0,7,1,341,82,24519,27418,28864,2,27,9,2,0,0,0,1,345,94,26211,29237,29597,0,-4,-12,-1692,-3,-1819,-733,-2,0,0,0,6
EUN1_3565075091',3,29,9,0,0,2,0,3,0,392,79,28649,30138,31621,4,44,15,1,1,0,0,7,356,84,26803,31091,30309,0,36,-5,1846,-6,-953,1312,-1,-1,2,0,-4
EUN1_3565050863',5,30,13,1,0,0,0,6,1,355,110,27735,29613,34981,0,24,13,0,0,0,0,5,347,78,26230,30707,31551,0,8,32,1505,0,-1094,3430,1,0,0,0,1
EUN1_3575830673',4,33,14,1,0,1,0,8,0,350,114,28486,30967,33996,2,23,6,0,0,0,0,5,322,74,23666,28265,27132,1,28,40,4820,8,2702,6864,1,0,1,0,3
EUN1_3573883596',3,33,8,0,0,1,0,12,1,346,77,26160,27974,28629,3,29,12,1,0,1,0,7,357,76,27366,28752,32376,0,-11,1,-1206,-4,-778,-3747,-1,0,0,0,5
EUN1_3575364117',1,19,14,1,0,2,0,8,1,292,90,28372,26594,46711,2,24,18,0,0,0,0,4,311,105,28317,28553,35662,0,-19,-15,55,-4,-1959,11049,1,0,2,0,4
EUN1_3575278986',6,26,13,1,1,0,0,9,0,349,94,27929,29336,37945,2,266,18,1,0,0,0,3,382,94,29409,31792,34028,0,-33,0,-1480,-5,-2456,3917,0,1,0,0,6
EUN1_3573852291',5,29,17,1,0,0,0,10,1,362,83,29810,29825,31499,2,44,8,1,0,0,0,3,384,116,26112,30349,38278,1,-22,-33,3698,9,-524,-6779,0,0,0,0,7
EUN1_3573152530',2,25,11,0,0,0,0,11,0,348,80,26432,27885,33354,4,27,17,1,0,1,0,1,355,84,30129,31181,35585,0,-7,-4,-3697,-6,-3296,-2231,-1,0,-1,0,10
EUN1_3572577014',4,24,12,0,0,1,0,9,0,328,85,26697,27967,24821,4,24,8,2,0,0,0,3,337,83,24473,27159,24308,1,-9,2,2224,4,808,513,-2,0,1,0,6
EUN1_3572564464',7,61,10,1,0,0,0,5,1,349,98,25672,29547,28491,4,59,7,1,0,0,0,1,351,86,24685,30606,24706,0,-2,12,987,3,-1059,3785,0,0,0,0,4
EUN1_3567206365',2,17,15,2,0,0,0,6,0,324,96,28508,29144,35529,0,24,18,0,0,0,0,3,336,76,28113,29530,37888,0,-12,20,395,-3,-386,-2359,2,0,0,0,3
EUN1_3566605398',2,35,7,0,0,0,0,5,1,356,84,24396,28706,34505,2,25,9,2,0,0,0,4,343,70,24604,27353,32989,1,13,14,-208,-2,1353,1516,-2,0,0,0,1
EUN1_3566576879',0,25,14,1,0,0,0,11,0,355,102,28516,30811,33693,5,34,7,0,0,0,0,0,343,78,25338,28496,24740,1,12,24,3178,7,2315,8953,1,0,0,0,11
EUN1_3566280990',3,33,8,1,0,0,0,6,0,325,72,24199,25939,21491,2,26,16,1,0,0,0,2,345,80,28664,30465,31357,0,-20,-8,-4465,-8,-4526,-9866,0,0,0,0,4
EUN1_3566266909',4,33,8,1,0,0,0,9,0,318,72,24104,26184,31594,2,25,21,0,0,0,0,1,331,100,29939,30596,39756,0,-13,-28,-5835,-13,-4412,-8162,1,0,0,0,8
EUN1_3565723763',2,18,17,1,0,2,0,11,0,339,92,31286,30762,41150,0,33,20,0,0,1,0,6,327,88,31093,31108,42249,1,12,4,193,-3,-346,-1099,1,0,1,0,5
EUN1_3565717258',5,32,6,1,0,0,0,7,1,333,80,23817,26886,21339,3,46,17,1,0,2,0,3,346,103,29833,32104,34195,0,-13,-23,-6016,-11,-5218,-12856,0,0,-2,0,4
EUN1_3565504015',6,20,14,0,0,1,0,4,1,295,90,27672,27178,29283,4,35,15,2,0,0,0,4,315,90,26494,30746,35525,0,-20,0,1178,-1,-3568,-6242,-2,0,1,0,0
EUN1_3565488032',3,35,15,1,1,2,0,4,0,393,107,29831,34100,28877,3,20,6,1,0,0,0,8,341,109,24833,29410,23851,1,52,-2,4998,9,4690,5026,0,1,2,0,-4
EUN1_3576080825',3,22,13,2,0,0,0,10,0,377,89,28080,31347,30713,3,40,6,0,0,1,0,4,348,70,24701,26501,30177,1,29,19,3379,7,4846,536,2,0,-1,0,6
EUN1_3568930159',7,33,14,2,0,2,0,10,1,364,86,28868,30575,32763,2,30,9,0,0,1,0,6,359,74,25191,27136,24676,1,5,12,3677,5,3439,8087,2,0,1,0,4
EUN1_3568920446',0,41,8,1,0,1,0,3,1,366,92,25151,30306,22114,2,20,2,0,0,0,0,3,394,80,22235,29262,24660,1,-28,12,2916,6,1044,-2546,1,0,1,0,0
EUN1_3568034160',2,34,10,0,0,0,0,13,0,329,80,27371,29274,34725,1,22,16,1,1,3,0,3,359,74,28642,29073,31840,0,-30,6,-1271,-6,201,2885,-1,-1,-3,0,10
EUN1_3567646172',6,44,12,1,1,0,0,5,0,304,80,26517,28285,34697,4,24,15,0,0,0,0,0,347,96,28440,30956,31029,0,-43,-16,-1923,-3,-2671,3668,1,1,0,0,5
EUN1_3567628258',7,48,13,2,0,0,0,9,1,360,91,27389,31328,31583,4,29,10,0,0,0,0,2,367,96,26514,31016,26191,1,-7,-5,875,3,312,5392,2,0,0,0,7
EUN1_3566597712',3,73,5,0,0,0,0,12,0,307,60,22103,24568,25399,7,33,14,2,0,2,0,1,380,112,29985,31154,33376,0,-73,-52,-7882,-9,-6586,-7977,-2,0,-2,0,11
EUN1_3566546082',4,56,15,1,0,1,0,14,0,306,86,28275,29158,35359,6,44,14,0,0,3,0,4,351,102,30447,30529,38179,1,-45,-16,-2172,1,-1371,-2820,1,0,-2,0,10
EUN1_3566441914',4,40,11,0,0,0,0,9,0,341,98,26424,28574,28823,6,28,18,1,0,2,0,5,337,66,29098,31749,40167,0,4,32,-2674,-7,-3175,-11344,-1,0,-2,0,4
EUN1_3566427904',3,40,14,1,0,3,0,7,1,376,107,30588,32074,40168,3,37,7,0,0,1,0,8,360,77,25388,27670,29950,1,16,30,5200,7,4404,10218,1,0,2,0,-1
EUN1_3566249690',2,22,11,1,0,0,0,6,0,376,126,27499,32259,30231,5,40,9,1,0,0,0,5,348,78,24988,28144,24114,1,28,48,2511,2,4115,6117,0,0,0,0,1
EUN1_3565910372',1,19,8,1,0,0,0,8,0,401,84,26197,29818,23722,3,40,9,0,0,0,0,4,354,88,25765,29379,24541,0,47,-4,432,-1,439,-819,1,0,0,0,4
EUN1_3565885736',4,17,5,0,0,1,0,13,0,358,65,23800,28174,25759,4,111,11,1,0,2,0,2,391,109,29560,31975,34585,0,-33,-44,-5760,-6,-3801,-8826,-1,0,-1,0,11
EUN1_3565848946',3,40,11,1,0,0,0,12,0,336,98,27691,28769,41561,3,26,20,0,0,1,0,2,352,72,29779,30684,36655,1,-16,26,-2088,-9,-1915,4906,1,0,-1,0,10
EUN1_3565722047',4,40,7,1,0,0,0,13,0,356,81,24636,27767,27880,4,25,13,1,0,3,0,1,408,74,29101,31739,33248,0,-52,7,-4465,-6,-3972,-5368,0,0,-3,0,12
EUN1_3570446830',9,78,20,1,1,1,0,4,0,319,70,30097,31541,36443,1,24,9,1,0,1,0,5,330,94,25306,28093,30996,1,-11,-24,4791,11,3448,5447,0,1,0,0,-1
EUN1_3570421644',1,29,23,2,0,3,0,10,1,337,80,33542,32960,38572,5,30,14,0,0,0,0,9,319,94,27499,30127,28672,1,18,-14,6043,9,2833,9900,2,0,3,0,1
EUN1_3570385955',3,21,7,0,0,0,0,10,1,317,95,23540,27610,25378,3,26,13,2,0,1,0,1,348,96,27736,29639,31413,0,-31,-1,-4196,-6,-2029,-6035,-2,0,-1,0,9
EUN1_3565496167',3,26,14,1,0,0,0,8,0,311,96,27082,29232,32632,2,18,12,1,0,0,0,1,314,94,25932,28434,35724,1,-3,2,1150,2,798,-3092,0,0,0,0,7
EUN1_3565471440',3,25,7,0,0,0,0,11,0,320,99,24088,28965,23709,4,155,10,2,0,0,0,3,384,104,26895,31466,33210,1,-64,-5,-2807,-3,-2501,-9501,-2,0,0,0,8
EUN1_3565447898',3,24,17,2,0,2,0,8,1,365,103,31121,31864,31315,4,117,7,0,0,0,0,7,342,76,24355,26566,27474,1,23,27,6766,10,5298,3841,2,0,2,0,1
EUN1_3565036677',3,30,4,0,0,0,0,16,1,306,72,21570,25466,24356,1,18,20,2,0,3,0,3,383,107,32226,33557,35808,0,-77,-35,-10656,-16,-8091,-11452,-2,0,-3,0,13
EUN1_3565016648',2,24,7,0,0,0,0,15,0,359,83,25919,29274,23989,2,31,20,2,0,3,0,3,395,92,31601,31839,31932,0,-36,-9,-5682,-13,-2565,-7943,-2,0,-3,0,12
EUN1_3563775910',2,30,16,0,0,1,0,11,0,332,86,30554,29587,38407,1,154,18,1,0,1,0,3,317,90,30612,27803,34812,0,15,-4,-58,-2,1784,3595,-1,0,0,0,8
EUN1_3563754836',5,23,17,1,0,0,0,6,1,345,90,29353,30352,34060,1,27,7,1,0,0,0,1,348,81,24847,27403,30591,1,-3,9,4506,10,2949,3469,0,0,0,0,5
EUN1_3562333142',4,30,9,1,0,0,0,9,0,355,90,26187,29371,26918,3,53,10,1,0,1,0,2,365,114,27399,30155,30435,0,-10,-24,-1212,-1,-784,-3517,0,0,-1,0,7
EUN1_3567061581',7,194,10,2,0,2,0,8,1,344,110,28263,30677,29011,4,25,12,0,0,0,0,5,350,83,26682,30775,37789,1,-6,27,1581,-2,-98,-8778,2,0,2,0,3
EUN1_3573480404',5,259,8,2,0,2,0,9,0,317,68,25890,27348,28082,5,41,11,0,0,0,0,5,289,92,24760,27566,29865,1,28,-24,1130,-3,-218,-1783,2,0,2,0,4
EUN1_3573454285',0,39,16,1,0,1,0,8,1,329,96,30472,29681,34000,3,29,14,1,0,1,0,8,305,84,26728,29287,39567,0,24,12,3744,2,394,-5567,0,0,0,0,0
EUN1_3573430320',6,26,15,0,0,1,0,7,1,354,84,28533,28953,35476,2,31,13,1,0,0,0,5,320,80,26472,28646,31655,1,34,4,2061,2,307,3821,-1,0,1,0,2
EUN1_3573387874',1,24,21,2,0,0,0,12,0,301,76,29595,29699,45240,3,40,19,0,0,2,0,1,320,76,30788,27400,47621,0,-19,0,-1193,2,2299,-2381,2,0,-2,0,11
EUN1_3573334042',1,17,10,0,0,1,0,11,1,281,80,24714,26886,21713,2,24,7,2,0,0,0,4,348,96,25310,28875,27189,1,-67,-16,-596,3,-1989,-5476,-2,0,1,0,7
EUN1_3572932490',5,28,10,0,0,2,0,6,1,355,70,27846,27711,32506,3,21,12,1,0,0,0,8,326,78,25493,28330,30369,1,29,-8,2353,-2,-619,2137,-1,0,2,0,-2
EUN1_3572352586',2,123,10,0,0,0,0,9,0,329,84,25907,28333,37027,1,26,17,2,0,1,0,1,320,98,28610,30434,34972,0,9,-14,-2703,-7,-2101,2055,-2,0,-1,0,8
EUN1_3569730059',1,64,14,1,0,0,0,13,0,253,74,25655,26335,37799,5,151,22,1,0,3,0,0,363,98,34089,31748,45658,0,-110,-24,-8434,-8,-5413,-7859,0,0,-3,0,13
EUN1_3569140286',1,20,14,1,0,1,0,10,0,338,104,29665,30121,34389,1,27,14,1,0,0,0,6,345,100,27866,31827,35278,1,-7,4,1799,0,-1706,-889,0,0,1,0,4
EUN1_3568603335',7,39,10,1,0,0,0,5,1,298,96,24542,27209,25787,2,26,11,0,0,0,0,2,369,84,25795,30786,31147,0,-71,12,-1253,-1,-3577,-5360,1,0,0,0,3
EUN1_3568246310',5,27,8,1,0,0,0,9,0,325,76,25071,26620,28368,2,29,16,1,0,1,0,2,383,87,28847,30061,30874,0,-58,-11,-3776,-8,-3441,-2506,0,0,-1,0,7
EUN1_3567715608',7,155,10,0,0,1,0,6,1,316,72,25905,27449,26477,3,27,11,2,0,0,0,4,363,104,26045,28947,25413,0,-47,-32,-140,-1,-1498,1064,-2,0,1,0,2
EUN1_3567294733',8,31,20,1,0,2,0,5,1,360,106,32768,32018,38573,0,27,10,1,0,0,0,5,299,66,25031,28688,24992,1,61,40,7737,10,3330,13581,0,0,2,0,0
EUN1_3575981269',3,34,10,1,0,0,0,5,1,363,108,25626,31871,28035,4,33,5,0,0,0,0,3,350,72,23181,26857,24579,1,13,36,2445,5,5014,3456,1,0,0,0,2
EUN1_3575943101',8,33,16,2,0,0,0,8,1,308,78,25866,29633,37488,2,22,11,0,0,0,0,1,313,82,26024,29462,36920,0,-5,-4,-158,5,171,568,2,0,0,0,7
EUN1_3575468232',5,26,11,0,0,0,0,4,1,315,78,25181,27784,33765,2,25,16,2,0,0,0,1,362,92,28090,29950,34080,0,-47,-14,-2909,-5,-2166,-315,-2,0,0,0,3
EUN1_3575428657',2,21,9,2,0,1,0,13,0,367,98,27242,31309,31070,5,29,11,0,0,1,0,4,380,93,27059,29960,26434,0,-13,5,183,-2,1349,4636,2,0,0,0,9
EUN1_3575254265',5,28,16,0,0,2,0,11,1,361,94,30472,30278,32633,0,43,8,2,0,0,0,3,329,82,24173,28020,30036,0,32,12,6299,8,2258,2597,-2,0,2,0,8
EUN1_3575156633',2,24,13,0,0,1,0,13,1,355,73,29158,29703,32564,6,35,15,2,0,1,0,4,316,91,28117,30758,32198,0,39,-18,1041,-2,-1055,366,-2,0,0,0,9
EUN1_3574968888',7,29,12,1,0,1,0,9,0,340,86,27535,30181,35893,1,20,13,1,0,1,0,4,379,90,27631,32161,37053,0,-39,-4,-96,-1,-1980,-1160,0,0,0,0,5
EUN1_3574947492',1,31,8,0,1,1,0,9,1,349,105,25440,29624,22826,8,27,15,1,0,1,0,3,308,74,27841,27808,27777,0,41,31,-2401,-7,1816,-4951,-1,1,0,0,6
EUN1_3572300824',0,40,10,0,0,0,0,13,0,284,83,25767,27651,28011,4,28,15,1,0,3,0,1,385,88,30561,30776,37064,0,-101,-5,-4794,-5,-3125,-9053,-1,0,-3,0,12
EUN1_3571783502',3,28,17,0,0,0,0,10,1,314,94,28783,28510,35286,5,28,19,1,0,0,0,4,373,79,30313,31663,37417,0,-59,15,-1530,-2,-3153,-2131,-1,0,0,0,6
EUN1_3571073769',1,22,13,2,0,1,0,9,1,338,96,27238,28740,34282,7,38,12,0,0,1,0,4,337,80,28319,29899,35919,0,1,16,-1081,1,-1159,-1637,2,0,0,0,5
EUN1_3570141451',3,31,13,1,0,0,0,7,1,373,102,27790,30005,31764,3,139,7,0,1,2,0,7,387,66,26298,29324,29226,1,-14,36,1492,6,681,2538,1,-1,-2,0,0
EUN1_3570086698',4,36,12,2,0,0,0,9,1,353,88,26631,28323,36639,4,281,11,0,0,0,0,1,327,84,25966,26635,37295,1,26,4,665,1,1688,-656,2,0,0,0,8
EUN1_3570015239',3,247,18,1,0,2,0,7,0,348,84,31203,30565,36306,3,23,12,1,1,0,0,7,355,99,25926,28956,37839,1,-7,-15,5277,6,1609,-1533,0,-1,2,0,0
EUN1_3570001093',2,324,18,2,0,1,0,4,0,369,83,29762,32107,42802,2,28,12,0,0,0,0,5,336,84,27049,28647,30311,1,33,-1,2713,6,3460,12491,2,0,1,0,-1
EUN1_3569828598',1,29,9,2,0,0,0,11,0,354,82,25082,29973,30720,4,24,16,0,0,1,0,1,336,84,28913,31050,33776,0,18,-2,-3831,-7,-1077,-3056,2,0,-1,0,10
EUN1_3569723216',3,23,12,0,0,0,0,7,0,355,54,26584,29062,24868,3,21,11,1,1,2,0,3,356,86,27118,29402,35955,0,-1,-32,-534,1,-340,-11087,-1,-1,-2,0,4
EUN1_3568710009',5,25,19,1,0,0,0,11,1,334,82,30432,28699,32977,2,20,3,1,0,2,0,4,318,86,23001,25458,23859,1,16,-4,7431,16,3241,9118,0,0,-2,0,7
EUN1_3568255019',2,227,9,1,0,1,0,7,0,344,88,25733,29536,30670,1,22,5,1,0,0,0,5,347,76,23469,26732,23984,1,-3,12,2264,4,2804,6686,0,0,1,0,2
EUN1_3575624503',4,25,14,2,0,0,0,8,1,397,100,27665,31014,30019,3,142,3,0,0,0,0,2,367,84,23418,29420,26186,1,30,16,4247,11,1594,3833,2,0,0,0,6
EUN1_3575605849',3,48,14,1,0,1,0,8,0,387,84,29723,31289,31954,3,25,8,0,0,2,0,7,360,64,25472,28412,28525,1,27,20,4251,6,2877,3429,1,0,-1,0,1
EUN1_3575587862',3,28,16,0,0,1,0,8,0,313,69,28416,29702,34754,3,18,14,2,0,2,0,8,296,76,28311,30583,30739,0,17,-7,105,2,-881,4015,-2,0,-1,0,0
EUN1_3575557964',7,27,10,0,0,1,0,18,0,309,89,25855,27490,34489,4,34,20,2,1,3,0,1,385,74,32988,32289,37324,1,-76,15,-7133,-10,-4799,-2835,-2,-1,-2,0,17
EUN1_3575535806',2,23,19,2,0,3,0,7,1,397,67,32100,31420,34668,1,23,3,0,0,0,0,11,302,94,21920,25157,15558,1,95,-27,10180,16,6263,19110,2,0,3,0,-4
EUN1_3575518248',0,84,20,1,0,2,0,12,0,331,92,30867,32296,33354,3,24,4,1,0,1,0,5,319,88,23375,26717,25089,1,12,4,7492,16,5579,8265,0,0,1,0,7
EUN1_3575486368',1,21,13,1,0,2,0,7,0,398,100,30388,31631,29010,5,21,12,0,0,2,0,9,333,84,26427,28457,25253,1,65,16,3961,1,3174,3757,1,0,0,0,-2
EUN1_3575443985',5,29,15,1,0,1,0,11,1,378,72,29000,29428,29649,2,26,17,0,0,0,0,3,399,79,30353,33138,34337,1,-21,-7,-1353,-2,-3710,-4688,1,0,1,0,8
EUN1_3575320047',2,58,13,2,0,0,0,9,0,344,88,26939,29669,33466,2,31,13,0,0,1,0,4,339,108,28261,31647,35948,0,5,-20,-1322,0,-1978,-2482,2,0,-1,0,5
EUN1_3575307650',7,31,13,1,0,0,0,6,1,394,104,30486,30761,29907,1,54,9,1,0,2,0,10,351,84,24790,28775,26446,1,43,20,5696,4,1986,3461,0,0,-2,0,-4
EUN1_3575289729',5,27,11,0,0,0,0,8,1,380,86,26763,30462,34240,5,28,12,0,0,1,0,2,380,85,27273,29993,30730,1,0,1,-510,-1,469,3510,0,0,-1,0,6
EUN1_3575260345',5,35,14,1,0,0,0,8,1,387,84,29372,31353,37723,2,25,20,1,0,0,0,3,384,76,29896,31751,35777,0,3,8,-524,-6,-398,1946,0,0,0,0,5
EUN1_3575227611',7,40,10,1,0,1,0,7,1,393,77,27737,31058,25485,3,25,8,0,0,0,0,4,368,88,24735,29064,25982,0,25,-11,3002,2,1994,-497,1,0,1,0,3
EUN1_3575180470',0,30,17,0,0,2,0,7,1,339,78,29884,30766,36752,6,33,11,1,0,0,0,8,302,75,25176,26569,31805,0,37,3,4708,6,4197,4947,-1,0,2,0,-1
EUN1_3575167860',1,20,21,2,0,0,0,11,1,318,92,29956,32194,36964,3,41,9,0,0,2,0,3,317,96,25751,28096,25793,1,1,-4,4205,12,4098,11171,2,0,-2,0,8
EUN1_3575156998',2,17,4,2,0,0,0,7,0,397,113,25153,30470,20367,2,22,12,0,0,2,0,5,404,82,28347,32097,31278,0,-7,31,-3194,-8,-1627,-10911,2,0,-2,0,2
EUN1_3574017962',3,28,15,0,0,2,0,12,0,341,86,29194,31352,28554,2,25,14,2,0,2,0,7,340,82,28590,29158,35404,0,1,4,604,1,2194,-6850,-2,0,0,0,5
EUN1_3574009635',4,34,16,1,0,0,0,7,1,372,106,28725,31327,35580,5,34,12,0,0,0,0,2,345,66,27050,30199,31181,1,27,40,1675,4,1128,4399,1,0,0,0,5
EUN1_3573991137',1,25,15,1,0,1,0,8,1,301,74,28272,26829,33368,9,33,15,1,0,0,0,9,327,69,27295,26888,37812,0,-26,5,977,0,-59,-4444,0,0,1,0,-1
EUN1_3576136413',6,50,14,1,0,3,0,7,1,397,106,30535,31743,36722,4,35,11,0,0,0,0,10,342,82,25687,28669,29294,1,55,24,4848,3,3074,7428,1,0,3,0,-3
EUN1_3576106400',1,25,17,2,0,1,0,7,0,348,88,30381,29322,41290,3,25,11,0,0,1,0,8,302,68,25168,25884,28581,1,46,20,5213,6,3438,12709,2,0,0,0,-1
EUN1_3575527891',2,23,25,1,1,1,0,9,1,338,103,32609,32855,43054,1,26,5,0,0,1,0,5,320,72,22771,26036,28253,1,18,31,9838,20,6819,14801,1,1,0,0,4
EUN1_3575501798',4,34,14,0,0,0,0,15,0,303,93,28492,28262,39441,1,27,20,1,1,4,0,6,344,78,31906,31434,38592,0,-41,15,-3414,-6,-3172,849,-1,-1,-4,0,9
EUN1_3575474654',4,27,12,1,1,0,0,11,0,347,82,27382,27555,31530,0,56,19,1,0,2,0,8,297,94,30398,27859,37785,1,50,-12,-3016,-7,-304,-6255,0,1,-2,0,3
EUN1_3572816841',2,45,15,1,0,1,0,4,1,367,102,28209,32295,32923,2,45,6,1,0,0,0,6,316,106,23791,28942,29773,1,51,-4,4418,9,3353,3150,0,0,1,0,-2
EUN1_3572798024',5,193,14,2,1,2,0,7,0,368,124,30230,32858,34459,2,34,7,0,0,0,0,9,357,85,24207,27724,27345,1,11,39,6023,7,5134,7114,2,1,2,0,-2
EUN1_3572725832',2,38,15,0,0,2,0,7,1,375,74,29986,30634,34012,1,25,13,2,0,0,0,6,347,76,26446,27884,34709,1,28,-2,3540,2,2750,-697,-2,0,2,0,1
EUN1_3572673953',2,22,10,1,0,1,0,6,0,377,111,27764,31900,27706,4,92,11,0,0,0,0,4,333,95,26274,29829,31108,1,44,16,1490,-1,2071,-3402,1,0,1,0,2
EUN1_3572551180',1,26,12,0,0,0,0,4,1,361,109,28274,30572,32322,3,25,7,2,0,0,0,7,370,98,25271,30164,28545,1,-9,11,3003,5,408,3777,-2,0,0,0,-3
EUN1_3572318175',1,18,14,0,0,0,0,7,0,310,84,25342,28674,34314,0,25,15,2,0,1,0,0,364,100,29428,30776,36524,0,-54,-16,-4086,-1,-2102,-2210,-2,0,-1,0,7
EUN1_3572280419',9,45,15,1,0,0,0,15,0,324,66,26994,28172,33635,1,52,13,0,0,3,0,1,362,85,30747,29376,30270,1,-38,-19,-3753,2,-1204,3365,1,0,-3,0,14
EUN1_3572256297',6,28,11,0,0,0,0,9,0,307,58,24642,27769,25534,2,236,20,2,0,1,0,0,350,94,31756,29834,46837,0,-43,-36,-7114,-9,-2065,-21303,-2,0,-1,0,9
EUN1_3572220691',2,18,20,2,0,1,0,7,1,318,96,29573,29443,38078,1,14,8,0,0,0,0,7,298,95,24087,26572,27167,1,20,1,5486,12,2871,10911,2,0,1,0,0
EUN1_3572108961',4,24,14,1,0,0,0,7,1,358,96,28304,29584,36643,0,28,13,0,0,0,0,5,335,76,27294,30062,41621,1,23,20,1010,1,-478,-4978,1,0,0,0,2
EUN1_3572096340',5,30,8,0,0,0,0,7,0,371,102,25973,28987,27954,1,25,16,2,0,2,0,2,368,98,29743,32902,29616,0,3,4,-3770,-8,-3915,-1662,-2,0,-2,0,5
EUN1_3572021474',4,29,14,2,0,0,0,6,1,357,86,27402,29920,30260,5,30,6,0,0,0,0,0,356,97,24444,28792,23952,1,1,-11,2958,8,1128,6308,2,0,0,0,6
EUN1_3572010171',3,33,20,2,0,0,0,11,1,325,92,30001,31177,41479,1,576,14,0,0,1,0,0,339,76,28223,27967,38201,1,-14,16,1778,6,3210,3278,2,0,-1,0,11
EUN1_3575731053',2,62,7,0,0,2,0,9,1,406,97,27559,31760,28067,6,59,13,2,0,0,0,4,340,86,26409,30512,26456,0,66,11,1150,-6,1248,1611,-2,0,2,0,5
EUN1_3575413361',2,28,5,0,0,0,0,9,0,318,90,22633,26156,22811,4,34,21,2,1,1,0,0,397,93,32498,34095,36584,0,-79,-3,-9865,-16,-7939,-13773,-2,-1,-1,0,9
EUN1_3575377005',4,27,14,0,0,1,0,7,0,355,96,28167,29326,34452,3,30,15,2,0,0,0,4,378,92,29297,30398,38923,0,-23,4,-1130,-1,-1072,-4471,-2,0,1,0,3
EUN1_3575308861',5,28,17,1,0,2,0,8,0,364,83,32185,31837,27516,5,28,13,1,0,1,0,9,357,75,28361,29329,30784,1,7,8,3824,4,2508,-3268,0,0,1,0,-1
EUN1_3565145195',5,136,12,2,0,0,0,7,1,315,75,27047,28322,30663,5,25,14,0,0,2,0,5,357,70,27886,31196,33719,1,-42,5,-839,-2,-2874,-3056,2,0,-2,0,2
EUN1_3565019746',4,32,13,0,0,3,0,4,0,339,84,29126,29032,30027,3,28,19,1,0,0,0,7,325,84,28911,31197,36798,0,14,0,215,-6,-2165,-6771,-1,0,3,0,-3
EUN1_3564994888',4,29,21,2,0,2,0,7,1,341,72,30680,30537,47359,4,339,10,0,0,0,0,6,308,68,24827,26446,38844,1,33,4,5853,11,4091,8515,2,0,2,0,1
EUN1_3564895876',2,39,13,1,0,0,0,5,1,313,71,26739,28641,28016,3,23,13,0,0,0,0,2,352,96,27319,29973,37605,0,-39,-25,-580,0,-1332,-9589,1,0,0,0,3
EUN1_3564740018',3,141,25,1,1,1,0,7,1,343,83,33252,31468,41418,5,26,12,1,0,1,0,6,278,97,26383,26997,31543,1,65,-14,6869,13,4471,9875,0,1,0,0,1
EUN1_3564503873',3,38,5,0,0,0,0,5,0,291,94,22854,26712,26192,4,29,17,2,0,1,0,1,349,74,28241,30647,37876,0,-58,20,-5387,-12,-3935,-11684,-2,0,-1,0,4
EUN1_3564449021',5,30,18,2,0,2,0,11,0,318,64,29179,29772,35192,2,26,14,0,1,0,0,5,316,88,26069,28282,31054,0,2,-24,3110,4,1490,4138,2,-1,2,0,6
EUN1_3564418750',3,38,10,1,0,1,0,8,0,322,84,26619,27570,34109,6,37,12,0,0,1,0,1,358,92,27306,29076,27898,1,-36,-8,-687,-2,-1506,6211,1,0,0,0,7
EUN1_3564381645',2,18,21,2,0,0,0,10,1,323,88,30485,28960,44172,9,32,20,0,0,1,0,5,330,96,32681,31070,41931,1,-7,-8,-2196,1,-2110,2241,2,0,-1,0,5
EUN1_3564342725',2,31,17,2,1,1,0,4,1,368,100,29660,30812,30700,4,33,13,0,0,1,0,5,338,99,27833,28309,30972,0,30,1,1827,4,2503,-272,2,1,0,0,-1
EUN1_3564270805',5,23,9,0,0,0,0,15,0,339,71,25425,26968,27052,7,33,16,1,0,2,0,1,363,85,29727,30893,37861,0,-24,-14,-4302,-7,-3925,-10809,-1,0,-2,0,14
EUN1_3564265171',2,24,13,1,0,0,0,8,1,320,86,28522,28936,30276,3,28,17,1,1,1,0,3,379,86,30216,33246,38646,0,-59,0,-1694,-4,-4310,-8370,0,-1,-1,0,5
EUN1_3563671763',1,20,19,1,0,1,0,9,0,302,82,29431,28360,39041,0,24,17,1,0,1,0,8,316,86,30185,29296,39046,0,-14,-4,-754,2,-936,-5,0,0,0,0,1
EUN1_3563654191',4,241,13,1,0,3,0,7,1,352,100,29470,31388,24325,2,26,6,0,0,0,0,8,317,68,23939,26190,26198,1,35,32,5531,7,5198,-1873,1,0,3,0,-1
EUN1_3563640765',6,28,8,1,1,1,0,7,1,350,81,25565,28605,23373,3,27,8,1,0,1,0,5,322,95,25515,28672,25462,1,28,-14,50,0,-67,-2089,0,1,0,0,2
EUN1_3563532842',1,30,16,0,0,2,0,6,1,405,109,31117,33096,39953,5,33,4,1,0,0,0,6,313,70,21396,25840,24590,1,92,39,9721,12,7256,15363,-1,0,2,0,0
EUN1_3563512068',4,22,4,0,0,0,0,11,1,337,87,22800,27062,26127,6,31,18,2,0,2,0,2,346,100,30929,31478,37998,0,-9,-13,-8129,-14,-4416,-11871,-2,0,-2,0,9
EUN1_3574322075',1,22,9,1,0,0,0,4,0,310,100,24980,27289,29511,4,45,12,1,0,1,0,2,343,80,26639,29092,33686,0,-33,20,-1659,-3,-1803,-4175,0,0,-1,0,2
EUN1_3574307134',1,97,12,0,0,1,0,6,1,339,96,28052,30929,31672,2,30,12,2,0,1,0,7,329,100,27377,32434,32623,0,10,-4,675,0,-1505,-951,-2,0,0,0,-1
EUN1_3574216694',7,28,13,1,0,0,0,7,1,343,76,26467,29016,33418,4,27,10,0,0,0,0,2,377,92,26937,31616,31341,1,-34,-16,-470,3,-2600,2077,1,0,0,0,5
EUN1_3574126940',1,23,7,1,0,0,0,5,0,339,87,24725,32028,24361,3,24,8,1,0,0,0,6,361,90,25500,30494,32901,1,-22,-3,-775,-1,1534,-8540,0,0,0,0,-1
EUN1_3573601078',5,22,11,1,0,0,0,10,1,366,102,27964,30930,25026,5,72,11,0,0,1,0,6,362,77,26225,31497,31495,0,4,25,1739,0,-567,-6469,1,0,-1,0,4
EUN1_3574581759',4,30,10,2,0,1,0,10,1,326,86,26497,28419,32279,2,25,10,0,0,1,0,4,311,95,25737,28195,25888,1,15,-9,760,0,224,6391,2,0,0,0,6
EUN1_3574578256',2,21,14,0,0,0,0,6,1,329,74,27270,30242,36634,8,38,11,2,0,1,0,2,354,90,27184,29876,27258,1,-25,-16,86,3,366,9376,-2,0,-1,0,4
EUN1_3574569580',5,28,4,0,0,0,0,14,1,287,69,20750,22771,24324,0,99,13,2,1,4,0,0,372,106,30178,31472,27732,0,-85,-37,-9428,-9,-8701,-3408,-2,-1,-4,0,14
EUN1_3574537378',7,69,10,0,0,3,0,9,0,381,46,28523,28942,35767,0,27,18,1,0,1,0,3,301,40,27558,27948,36265,0,80,6,965,-8,994,-498,-1,0,2,0,6
EUN1_3574521131',5,71,12,1,0,0,0,10,0,369,84,26336,30343,27542,3,159,12,1,0,0,0,4,331,84,27980,28347,29119,0,38,0,-1644,0,1996,-1577,0,0,0,0,6
EUN1_3572297785',0,29,3,0,0,0,0,11,0,337,70,22528,26626,23331,4,27,12,2,1,2,0,1,371,110,28231,30089,29221,0,-34,-40,-5703,-9,-3463,-5890,-2,-1,-2,0,10
EUN1_3571709272',4,24,20,1,0,0,0,5,1,338,62,29349,27469,40143,4,28,18,1,0,0,0,6,332,84,29458,29128,35890,0,6,-22,-109,2,-1659,4253,0,0,0,0,-1
EUN1_3571667817',4,24,14,0,0,0,0,11,0,337,86,27943,29955,33734,7,28,14,2,1,1,0,3,347,75,28636,29217,32414,1,-10,11,-693,0,738,1320,-2,-1,-1,0,8
EUN1_3571635796',7,51,14,1,0,0,0,10,1,362,83,26943,29528,30443,5,27,11,1,0,0,0,1,373,80,27560,30297,31713,1,-11,3,-617,3,-769,-1270,0,0,0,0,9
EUN1_3569239453',2,24,10,1,0,0,0,11,1,387,109,26412,30834,29056,3,22,10,1,0,1,0,0,389,84,26944,31243,23142,1,-2,25,-532,0,-409,5914,0,0,-1,0,11
EUN1_3569203349',3,66,11,0,0,1,0,11,1,343,72,26421,27561,30564,3,21,5,2,0,0,0,4,347,91,23825,28137,22665,1,-4,-19,2596,6,-576,7899,-2,0,1,0,7
EUN1_3568795128',3,33,6,1,0,0,0,8,0,349,76,23347,26821,20857,2,31,9,1,0,0,0,1,337,105,25566,27821,24631,1,12,-29,-2219,-3,-1000,-3774,0,0,0,0,7
EUN1_3568758504',5,143,16,0,0,1,0,9,1,288,84,28623,29177,41231,3,22,17,2,0,1,0,3,326,74,28361,28946,42606,1,-38,10,262,-1,231,-1375,-2,0,0,0,6
EUN1_3572477450',1,229,18,1,0,0,0,8,0,345,74,28892,29971,30424,3,32,15,1,0,0,0,4,375,84,29726,29994,34744,0,-30,-10,-834,3,-23,-4320,0,0,0,0,4
EUN1_3571532670',2,86,16,0,0,0,0,14,0,288,72,27855,29484,38827,2,459,14,2,0,1,0,3,366,92,29425,29522,38586,1,-78,-20,-1570,2,-38,241,-2,0,-1,0,11
EUN1_3571509305',4,20,10,0,0,0,0,6,1,346,86,25464,29924,29103,2,280,8,2,0,0,0,1,372,114,25831,30517,25194,0,-26,-28,-367,2,-593,3909,-2,0,0,0,5
EUN1_3571436711',4,265,11,2,0,1,0,4,1,387,76,27150,30116,33164,3,26,7,0,0,0,0,6,350,90,23959,26897,27638,0,37,-14,3191,4,3219,5526,2,0,1,0,-2
EUN1_3571418514',1,24,11,1,1,1,0,8,0,342,88,26557,30872,34121,1,24,20,1,0,2,0,2,326,111,31407,32291,36727,1,16,-23,-4850,-9,-1419,-2606,0,1,-1,0,6
EUN1_3571395885',1,22,12,0,0,0,0,5,0,367,94,26985,31498,34503,3,31,16,1,0,0,0,4,329,90,28275,32120,35660,0,38,4,-1290,-4,-622,-1157,-1,0,0,0,1
EUN1_3570861859',3,16,11,1,0,0,0,8,0,370,86,25415,29708,22511,1,27,6,1,0,0,0,2,337,86,23159,27813,23329,0,33,0,2256,5,1895,-818,0,0,0,0,6
EUN1_3573801183',3,30,13,1,0,0,0,7,1,288,74,26800,28095,29168,4,142,17,1,0,1,0,1,342,86,28576,30650,39114,0,-54,-12,-1776,-4,-2555,-9946,0,0,-1,0,6
EUN1_3573771755',5,30,18,1,0,1,0,9,0,333,89,30054,29126,37802,7,29,13,0,1,1,0,5,318,78,27125,28980,29033,0,15,11,2929,5,146,8769,1,-1,0,0,4
EUN1_3573698171',2,23,12,1,0,1,0,13,1,285,83,26711,27981,35487,3,21,23,1,0,2,0,4,319,72,31083,30052,39105,0,-34,11,-4372,-11,-2071,-3618,0,0,-1,0,9
EUN1_3575936908',2,28,16,0,0,2,0,8,0,321,82,29279,29623,35170,6,26,13,0,0,0,0,5,294,66,24768,25085,33795,1,27,16,4511,3,4538,1375,0,0,2,0,3
EUN1_3575915291',1,76,9,0,0,0,0,10,0,348,82,25837,28385,36013,4,24,16,1,0,1,0,6,336,90,29338,32922,39701,0,12,-8,-3501,-7,-4537,-3688,-1,0,-1,0,4
EUN1_3575454156',1,72,23,1,0,3,0,3,0,310,96,33834,29943,40179,6,134,19,1,0,0,0,9,264,76,27662,27432,37561,0,46,20,6172,4,2511,2618,0,0,3,0,-6
EUN1_3573194208',4,25,21,1,0,1,0,10,0,320,88,31377,30697,37558,3,139,13,1,0,2,0,4,343,80,28057,28698,37573,1,-23,8,3320,8,1999,-15,0,0,-1,0,6
EUN1_3571952168',2,18,7,1,0,0,0,14,0,285,94,23046,27625,23975,3,100,14,1,0,2,0,1,353,106,29088,31272,30405,0,-68,-12,-6042,-7,-3647,-6430,0,0,-2,0,13
EUN1_3569592537',0,21,10,1,0,0,0,13,0,276,96,24045,28194,27948,2,27,13,1,0,2,0,2,338,96,28770,28896,32294,0,-62,0,-4725,-3,-702,-4346,0,0,-2,0,11
EUN1_3569549562',3,23,5,0,0,0,0,10,1,299,94,22996,28124,21875,4,24,13,1,0,2,0,1,400,104,29907,32387,30771,0,-101,-10,-6911,-8,-4263,-8896,-1,0,-2,0,9
EUN1_3569466407',2,326,12,2,0,0,0,8,1,345,72,27725,28611,31068,4,27,13,0,0,0,0,3,319,112,27250,28741,30006,1,26,-40,475,-1,-130,1062,2,0,0,0,5
EUN1_3568561755',3,31,16,1,0,0,0,11,1,284,72,27750,28259,35920,8,30,21,0,0,1,0,1,333,93,30551,30100,39962,0,-49,-21,-2801,-5,-1841,-4042,1,0,-1,0,10
EUN1_3568557184',1,24,13,2,0,1,0,6,0,340,96,27937,30798,36123,1,22,10,0,0,1,0,8,325,84,26254,28032,25161,0,15,12,1683,3,2766,10962,2,0,0,0,-2
EUN1_3567391698',2,27,8,0,0,0,0,8,1,332,75,25075,25922,29073,3,387,18,1,0,1,0,2,346,74,29540,30441,35133,0,-14,1,-4465,-10,-4519,-6060,-1,0,-1,0,6
EUN1_3567372963',4,23,18,2,0,2,0,3,1,358,60,30584,30594,43077,2,30,13,0,0,0,0,7,306,76,25774,26452,40911,1,52,-16,4810,5,4142,2166,2,0,2,0,-4
EUN1_3566786486',6,26,18,0,0,1,0,9,1,353,71,29927,29534,36739,2,32,15,2,0,0,0,6,316,92,28970,28953,31644,1,37,-21,957,3,581,5095,-2,0,1,0,3
EUN1_3566698121',2,136,9,1,0,0,0,12,1,340,88,26241,30953,28524,3,18,12,1,0,2,0,2,376,114,28515,31508,28896,0,-36,-26,-2274,-3,-555,-372,0,0,-2,0,10
EUN1_3566516611',5,137,7,0,1,1,0,10,0,318,78,25448,28366,28306,6,26,13,2,0,1,0,4,371,90,27831,31336,26867,1,-53,-12,-2383,-6,-2970,1439,-2,1,0,0,6
EUN1_3576087022',5,29,12,1,0,0,0,7,1,372,71,28544,30485,35669,3,29,15,1,0,0,0,7,338,108,28691,30665,29875,0,34,-37,-147,-3,-180,5794,0,0,0,0,0
EUN1_3575969793',2,25,9,2,0,0,0,9,0,320,96,24228,29893,32999,5,32,9,0,0,1,0,1,373,84,26440,28974,30315,0,-53,12,-2212,0,919,2684,2,0,-1,0,8
EUN1_3575612114',5,30,24,0,0,3,0,13,1,343,89,33385,31757,44925,2,21,11,1,0,1,0,11,298,70,28570,26407,35120,1,45,19,4815,13,5350,9805,-1,0,2,0,2
EUN1_3575590105',2,25,12,0,0,1,0,9,0,313,40,26037,24946,38756,4,28,22,1,0,1,0,4,305,99,31076,31219,36893,0,8,-59,-5039,-10,-6273,1863,-1,0,0,0,5
EUN1_3575561561',4,27,3,1,0,0,0,10,0,345,87,22332,28231,21441,4,22,12,1,0,2,0,1,391,100,28763,32829,27869,0,-46,-13,-6431,-9,-4598,-6428,0,0,-2,0,9
EUN1_3574971859',6,36,19,2,0,0,0,11,1,355,78,28823,30769,39049,4,44,14,0,0,1,0,4,287,81,26791,28445,31590,1,68,-3,2032,5,2324,7459,2,0,-1,0,7
EUN1_3575669577',2,21,17,0,0,1,0,10,1,276,72,29661,27133,37266,3,21,15,1,0,1,0,5,294,76,27564,25312,30452,1,-18,-4,2097,2,1821,6814,-1,0,0,0,5
EUN1_3575351504',7,67,11,0,0,0,0,9,1,345,82,26060,28220,29476,5,26,19,2,0,1,0,3,377,56,29385,31874,40914,1,-32,26,-3325,-8,-3654,-11438,-2,0,-1,0,6
EUN1_3575244062',3,45,12,2,0,0,0,7,1,324,70,26119,27861,32713,5,32,9,0,0,0,0,3,349,80,25085,27830,32181,1,-25,-10,1034,3,31,532,2,0,0,0,4
EUN1_3575231385',4,29,15,0,0,0,0,12,0,335,98,27334,33566,35814,2,55,12,1,0,1,0,3,343,82,26914,30626,27741,1,-8,16,420,3,2940,8073,-1,0,-1,0,9
EUN1_3575110083',5,159,14,2,0,1,0,9,1,326,72,28079,28282,30695,5,44,12,0,0,2,0,4,304,89,25970,27545,29334,1,22,-17,2109,2,737,1361,2,0,-1,0,5
EUN1_3575074401',4,24,11,0,0,0,0,6,1,335,69,25919,28655,28285,3,28,12,1,0,1,0,4,350,102,27488,29685,22679,0,-15,-33,-1569,-1,-1030,5606,-1,0,-1,0,2
EUN1_3575058378',3,27,4,0,0,0,0,9,0,300,78,21571,26893,26563,2,32,11,2,0,2,0,0,420,106,30350,31893,34992,0,-120,-28,-8779,-7,-5000,-8429,-2,0,-2,0,9
EUN1_3575007547',6,37,10,1,0,0,0,12,0,281,78,23959,26340,28819,1,21,11,0,0,1,0,0,386,85,29050,29103,29720,0,-105,-7,-5091,-1,-2763,-901,1,0,-1,0,12
EUN1_3574593573',3,25,9,0,1,0,0,10,0,369,86,25328,30893,30162,4,27,7,2,0,0,0,2,363,93,25145,29502,23105,1,6,-7,183,2,1391,7057,-2,1,0,0,8
EUN1_3574594273',4,29,25,0,0,2,0,14,1,300,102,32193,30457,43081,4,22,13,2,0,1,0,6,321,84,27585,28312,38315,1,-21,18,4608,12,2145,4766,-2,0,1,0,8
EUN1_3574553904',3,26,15,1,1,1,0,14,0,317,100,29033,31438,34298,4,16,14,1,0,1,0,6,346,68,28893,30012,39207,1,-29,32,140,1,1426,-4909,0,1,0,0,8
EUN1_3574522239',5,28,6,1,0,1,0,7,0,338,87,25391,28738,26944,3,25,11,1,0,0,0,8,335,76,25677,28545,23138,0,3,11,-286,-5,193,3806,0,0,1,0,-1
EUN1_3574506196',3,28,15,0,0,0,0,13,0,328,72,27747,28246,33105,2,29,17,1,0,2,0,1,320,84,29596,29639,39776,0,8,-12,-1849,-2,-1393,-6671,-1,0,-2,0,12
EUN1_3574055689',2,24,5,0,0,0,0,16,0,307,88,22639,27915,15731,6,28,14,2,1,3,0,3,400,102,30548,32592,29907,0,-93,-14,-7909,-9,-4677,-14176,-2,-1,-3,0,13
EUN1_3574034113',1,19,18,2,0,2,0,6,1,351,64,30750,31194,32900,2,26,15,0,0,0,0,8,300,104,27410,29330,27459,1,51,-40,3340,3,1864,5441,2,0,2,0,-2
EUN1_3574021250',3,25,8,1,0,0,0,4,1,410,86,26244,29888,31621,6,27,10,1,0,0,0,3,346,90,25931,30379,28636,1,64,-4,313,-2,-491,2985,0,0,0,0,1
EUN1_3572978987',2,22,7,0,0,2,0,11,1,354,84,26579,27536,19979,3,132,16,2,1,1,0,4,302,95,28664,30229,33190,0,52,-11,-2085,-9,-2693,-13211,-2,-1,1,0,7
EUN1_3572878980',1,21,12,0,0,2,0,12,0,368,94,30781,28245,28761,7,56,14,1,0,1,0,7,334,81,28710,30110,34594,1,34,13,2071,-2,-1865,-5833,-1,0,1,0,5
EUN1_3572493329',0,29,15,0,0,2,0,9,0,346,100,30263,29068,27295,1,21,19,2,0,1,0,7,327,71,30753,29061,39162,1,19,29,-490,-4,7,-11867,-2,0,1,0,2
EUN1_3572143058',3,37,9,0,0,0,0,12,0,329,89,25704,29624,32566,3,25,17,1,0,1,0,0,381,82,30000,32737,38527,1,-52,7,-4296,-8,-3113,-5961,-1,0,-1,0,12
EUN1_3572119362',7,24,13,1,0,2,0,7,0,349,101,30190,30945,37892,2,25,15,1,0,0,0,9,306,90,27315,29070,35985,0,43,11,2875,-2,1875,1907,0,0,2,0,-2
EUN1_3572096259',1,39,7,0,0,0,0,11,1,357,96,25113,28936,26407,5,24,11,2,0,2,0,5,346,92,28244,31183,34214,0,11,4,-3131,-4,-2247,-7807,-2,0,-2,0,6
EUN1_3572063956',2,29,14,1,0,0,0,11,0,294,84,26544,29208,31463,1,27,16,1,0,1,0,2,307,88,28037,27514,30758,0,-13,-4,-1493,-2,1694,705,0,0,-1,0,9
EUN1_3572022694',5,25,13,0,0,0,0,7,1,312,91,26886,27615,33022,4,26,14,2,0,2,0,3,378,92,29492,32260,35498,1,-66,-1,-2606,-1,-4645,-2476,-2,0,-2,0,4
EUN1_3572006678',4,26,11,0,0,0,0,17,1,324,76,25935,27133,26448,1,22,13,2,0,1,0,3,337,96,27506,29193,28188,0,-13,-20,-1571,-2,-2060,-1740,-2,0,-1,0,14
EUN1_3571981982',9,36,11,1,0,0,0,9,0,380,108,26770,29963,25848,7,43,13,1,0,0,0,2,361,98,29106,30887,29441,1,19,10,-2336,-2,-924,-3593,0,0,0,0,7
EUN1_3571984157',3,35,19,2,1,4,0,5,0,383,121,33928,35828,35566,1,87,7,0,0,0,0,10,302,90,24290,27491,22518,1,81,31,9638,12,8337,13048,2,1,4,0,-5
EUN1_3571959071',4,138,12,1,0,0,0,13,1,354,91,27303,29001,30354,4,32,13,1,0,1,0,4,319,80,27667,28856,30104,1,35,11,-364,-1,145,250,0,0,-1,0,9
EUN1_3571951500',4,141,15,1,0,2,0,12,1,327,96,29400,30080,39678,2,19,12,1,0,0,0,2,297,88,24540,26096,27093,1,30,8,4860,3,3984,12585,0,0,2,0,10
EUN1_3567794776',6,32,7,1,0,0,0,7,1,345,98,24602,28468,21558,7,29,4,1,1,0,0,0,388,102,24057,29884,24728,0,-43,-4,545,3,-1416,-3170,0,-1,0,0,7
EUN1_3567771726',4,30,19,1,1,1,0,4,1,347,80,31739,30936,32166,1,28,13,1,0,0,0,4,305,84,27212,27443,28937,1,42,-4,4527,6,3493,3229,0,1,1,0,0
EUN1_3567689117',4,26,18,1,0,1,0,7,0,336,96,32426,31171,39789,6,36,11,0,0,0,0,10,302,76,25594,28625,31438,1,34,20,6832,7,2546,8351,1,0,1,0,-3
EUN1_3567673374',2,31,19,0,0,3,0,7,1,332,98,32152,29716,39874,3,20,18,1,0,0,0,8,309,74,29062,28564,31868,1,23,24,3090,1,1152,8006,-1,0,3,0,-1
EUN1_3567648959',3,252,23,1,0,4,0,9,0,283,100,33243,29550,37659,4,26,11,0,0,0,0,9,302,76,26482,27687,30637,1,-19,24,6761,12,1863,7022,1,0,4,0,0
EUN1_3566584019',1,23,8,0,0,0,0,6,0,301,88,24780,28767,19291,3,33,11,1,0,1,0,2,367,72,26425,29792,32014,0,-66,16,-1645,-3,-1025,-12723,-1,0,-1,0,4
EUN1_3566436616',6,29,14,2,1,0,0,14,0,373,96,28463,30218,29521,0,24,5,0,0,1,0,0,392,88,25324,29698,28104,0,-19,8,3139,9,520,1417,2,1,-1,0,14
EUN1_3566414709',6,31,16,0,0,0,0,8,0,350,86,30502,31319,35912,1,23,14,2,0,1,0,6,293,100,27475,29960,33475,1,57,-14,3027,2,1359,2437,-2,0,-1,0,2
EUN1_3566399776',6,24,17,1,1,1,0,9,1,350,94,29004,32962,32111,1,89,3,0,0,0,0,7,332,86,22313,27923,25400,1,18,8,6691,14,5039,6711,1,1,1,0,2
EUN1_3575895173',1,27,10,0,0,0,0,7,1,290,95,26255,28395,28014,2,26,14,2,0,1,0,6,342,84,27475,30959,34002,0,-52,11,-1220,-4,-2564,-5988,-2,0,-1,0,1
EUN1_3575858236',7,36,18,2,0,0,0,9,1,345,100,28162,30855,37878,5,23,11,0,0,0,0,2,359,95,26954,29611,31750,0,-14,5,1208,7,1244,6128,2,0,0,0,7
EUN1_3575612702',4,32,15,1,0,0,0,10,0,359,78,30145,30406,38844,2,42,21,1,0,0,0,1,325,90,29819,31313,35411,0,34,-12,326,-6,-907,3433,0,0,0,0,9
EUN1_3575111864',3,38,13,1,0,1,0,10,1,348,84,28542,30442,34790,2,52,18,1,0,3,0,6,281,60,28764,29265,32518,0,67,24,-222,-5,1177,2272,0,0,-2,0,4
EUN1_3575114132',3,53,18,1,0,1,0,7,1,331,73,29649,28779,31925,5,60,17,1,0,1,0,7,324,82,30297,28199,33913,1,7,-9,-648,1,580,-1988,0,0,0,0,0
EUN1_3575108125',5,32,16,2,0,0,0,12,1,331,88,28754,27425,36645,4,32,11,0,0,0,0,3,330,73,26313,26877,33014,1,1,15,2441,5,548,3631,2,0,0,0,9
EUN1_3575088259',6,34,24,1,0,3,0,9,1,362,75,34546,31662,47803,4,41,8,0,0,1,0,8,322,72,24371,27406,22816,1,40,3,10175,16,4256,24987,1,0,2,0,1
EUN1_3573975155',3,24,12,1,1,1,0,9,1,348,111,28604,31081,37545,1,20,10,0,0,0,0,5,353,94,26583,29171,32942,1,-5,17,2021,2,1910,4603,1,1,1,0,4
EUN1_3573920752',4,24,24,2,0,3,0,6,1,362,97,33705,33115,41082,1,28,10,0,0,0,0,10,264,58,23951,26407,25800,1,98,39,9754,14,6708,15282,2,0,3,0,-4
EUN1_3573888295',1,22,15,2,0,1,0,6,0,338,96,28529,29878,37375,0,31,17,0,0,0,0,3,330,67,28070,28319,36410,0,8,29,459,-2,1559,965,2,0,1,0,3
EUN1_3573847910',3,28,20,2,0,2,0,6,0,366,108,31807,32020,35701,1,21,11,0,0,0,0,5,275,77,24441,26126,22862,1,91,31,7366,9,5894,12839,2,0,2,0,1
EUN1_3573820173',3,23,18,1,0,1,0,9,0,322,97,29723,29295,37714,6,73,14,1,0,0,0,4,322,86,27429,28907,36416,0,0,11,2294,4,388,1298,0,0,1,0,5
EUN1_3573788594',5,30,15,0,1,1,0,5,0,312,78,29737,28118,31294,2,26,17,1,0,1,0,9,256,90,29734,26651,39547,0,56,-12,3,-2,1467,-8253,-1,1,0,0,-4
EUN1_3573662566',3,23,18,0,0,1,0,7,0,345,92,29576,31942,37088,7,30,16,1,0,0,0,4,318,64,27089,28208,35512,1,27,28,2487,2,3734,1576,-1,0,1,0,3
EUN1_3576240470',3,27,14,1,0,0,0,7,0,365,86,28132,30976,32404,2,29,8,1,0,1,0,1,338,82,26371,27123,30667,1,27,4,1761,6,3853,1737,0,0,-1,0,6
EUN1_3575944949',3,26,16,1,0,3,0,8,0,383,92,32094,30804,34744,6,33,12,1,0,0,0,8,336,64,26475,26918,29457,1,47,28,5619,4,3886,5287,0,0,3,0,0
EUN1_3575933259',0,21,13,0,0,0,0,6,1,330,73,26038,28500,34147,3,35,13,1,0,0,0,1,345,111,27759,31014,31360,0,-15,-38,-1721,0,-2514,2787,-1,0,0,0,5
EUN1_3575908409',8,33,16,0,0,1,0,6,0,334,71,28865,28915,39373,5,22,20,2,0,0,0,6,288,94,28849,28844,35847,0,46,-23,16,-4,71,3526,-2,0,1,0,0
EUN1_3575872746',6,25,18,1,0,0,0,9,1,317,78,27923,28531,37421,6,253,21,0,0,0,0,1,310,74,29007,30957,38309,1,7,4,-1084,-3,-2426,-888,1,0,0,0,8
EUN1_3575857831',4,24,6,0,0,0,0,13,1,342,78,24701,27023,22565,1,29,23,2,1,2,0,3,358,101,33261,33448,42596,0,-16,-23,-8560,-17,-6425,-20031,-2,-1,-2,0,10
EUN1_3575786391',4,21,12,1,0,1,0,7,1,333,100,28331,30605,34058,3,24,17,1,0,0,0,6,325,88,28867,30427,36331,1,8,12,-536,-5,178,-2273,0,0,1,0,1
EUN1_3575616663',3,23,19,1,0,2,0,11,1,356,104,31737,31099,35139,3,69,11,1,0,0,0,5,332,104,26173,30275,31071,1,24,0,5564,8,824,4068,0,0,2,0,6
EUN1_3575603077',4,24,13,0,0,0,0,9,0,286,78,26253,30614,31219,6,28,11,2,1,0,0,1,340,105,26670,29980,37561,0,-54,-27,-417,2,634,-6342,-2,-1,0,0,8
EUN1_3575579886',10,36,9,2,0,0,0,7,1,326,110,25082,29263,25014,4,22,15,0,1,2,0,2,347,84,29279,31720,32012,0,-21,26,-4197,-6,-2457,-6998,2,-1,-2,0,5
EUN1_3575416531',2,27,9,1,0,0,0,8,1,351,85,25223,29293,26685,2,24,17,1,1,0,0,1,357,102,29100,32151,35044,0,-6,-17,-3877,-8,-2858,-8359,0,-1,0,0,7
EUN1_3575391023',4,21,9,0,0,0,0,10,0,338,90,25540,30173,31951,1,21,22,2,0,2,0,0,421,102,34755,34655,38740,0,-83,-12,-9215,-13,-4482,-6789,-2,0,-2,0,10
EUN1_3575365460',2,25,12,1,1,0,0,11,1,331,92,27355,29064,25843,2,21,12,1,0,1,0,2,374,98,28923,30461,30553,0,-43,-6,-1568,0,-1397,-4710,0,1,-1,0,9
EUN1_3575350226',4,26,10,1,0,0,0,14,0,320,76,25305,27565,25382,4,21,17,1,0,3,0,6,356,88,32193,32108,31239,0,-36,-12,-6888,-7,-4543,-5857,0,0,-3,0,8
EUN1_3575321693',2,27,9,0,1,0,0,7,0,333,96,25908,30766,32496,3,28,12,2,0,1,0,1,359,98,27557,30140,31394,0,-26,-2,-1649,-3,626,1102,-2,1,-1,0,6
EUN1_3575303523',5,26,12,1,0,1,0,4,1,345,88,27960,28616,32698,6,40,13,1,0,0,0,6,318,84,25913,29404,33992,0,27,4,2047,-1,-788,-1294,0,0,1,0,-2
EUN1_3575234826',1,21,13,2,0,0,0,9,0,345,100,28893,29658,32900,5,33,18,0,0,1,0,6,301,76,28534,28251,35841,1,44,24,359,-5,1407,-2941,2,0,-1,0,3
EUN1_3575183982',2,137,25,1,1,1,0,7,1,320,86,30228,30296,43837,1,29,9,1,0,0,0,7,299,86,25254,24582,25831,0,21,0,4974,16,5714,18006,0,1,1,0,0
EUN1_3575072198',6,29,16,0,0,0,0,8,1,306,66,29100,29922,33402,6,32,17,2,0,1,0,3,351,94,30503,30640,34486,0,-45,-28,-1403,-1,-718,-1084,-2,0,-1,0,5
EUN1_3575046660',3,22,8,1,1,1,0,10,0,335,72,27207,27884,30669,7,29,21,1,0,0,0,6,368,84,29675,31324,40430,0,-33,-12,-2468,-13,-3440,-9761,0,1,1,0,4
EUN1_3576087648',1,31,10,2,0,1,0,8,1,301,98,26151,27057,23881,1,24,6,0,0,1,0,6,341,82,25231,26937,23905,1,-40,16,920,4,120,-24,2,0,0,0,2
EUN1_3576059872',4,33,11,1,0,0,0,12,1,371,81,26656,29607,34639,5,33,9,1,0,0,0,2,339,86,24737,27787,28979,1,32,-5,1919,2,1820,5660,0,0,0,0,10
EUN1_3576034528',2,79,19,0,0,0,0,8,0,310,82,29521,28702,42203,8,38,19,1,1,0,0,4,328,98,29737,30694,38723,0,-18,-16,-216,0,-1992,3480,-1,-1,0,0,4
EUN1_3576020152',4,22,11,1,0,0,0,10,1,322,82,25687,27142,43292,5,28,17,1,0,1,0,3,362,85,29955,31629,36401,0,-40,-3,-4268,-6,-4487,6891,0,0,-1,0,7
EUN1_3575998511',3,24,7,0,0,0,0,15,0,362,84,24604,28063,24626,3,50,18,2,1,2,0,0,337,102,31158,32935,33525,0,25,-18,-6554,-11,-4872,-8899,-2,-1,-2,0,15
EUN1_3575967424',2,19,10,1,0,0,0,14,0,290,90,24234,23911,27713,5,92,26,0,0,2,0,0,330,74,31984,31920,47639,0,-40,16,-7750,-16,-8009,-19926,1,0,-2,0,14
EUN1_3575859709',3,23,9,0,0,0,0,4,1,396,87,26830,32700,31861,2,23,13,1,0,0,0,6,337,74,25719,30281,29996,0,59,13,1111,-4,2419,1865,-1,0,0,0,-2
EUN1_3575846231',2,22,15,1,1,0,0,8,1,326,104,29195,30012,35296,11,28,20,0,0,0,0,5,318,96,29452,30546,32479,1,8,8,-257,-5,-534,2817,1,1,0,0,3
EUN1_3575735897',5,17,8,0,0,0,0,14,1,384,60,26215,28442,27485,7,82,13,2,0,2,0,3,348,108,27873,30420,35663,0,36,-48,-1658,-5,-1978,-8178,-2,0,-2,0,11
EUN1_3575720917',3,27,17,0,1,1,0,9,1,379,93,30227,31051,32935,6,25,10,2,0,0,0,4,302,94,24954,27794,24965,0,77,-1,5273,7,3257,7970,-2,1,1,0,5
EUN1_3575640029',1,31,15,1,0,1,0,15,1,301,86,29284,27585,33337,3,27,20,0,0,3,0,7,366,74,31821,30882,47386,1,-65,12,-2537,-5,-3297,-14049,1,0,-2,0,8
EUN1_3575631485',2,50,17,0,0,1,0,14,1,360,76,29472,30175,37163,3,24,15,2,0,0,0,3,363,70,27810,29357,34358,1,-3,6,1662,2,818,2805,-2,0,1,0,11
EUN1_3575621441',3,26,6,0,0,1,0,11,0,340,89,24192,27850,22310,6,25,9,2,0,1,0,2,353,90,25818,29698,24043,0,-13,-1,-1626,-3,-1848,-1733,-2,0,0,0,9
EUN1_3575595555',0,151,9,1,0,0,0,6,0,373,110,26910,30423,29909,3,48,16,1,0,1,0,2,392,77,29898,32992,36864,0,-19,33,-2988,-7,-2569,-6955,0,0,-1,0,4
EUN1_3575578223',6,39,8,0,0,0,0,14,0,354,86,24583,29854,28591,3,18,7,1,1,2,0,1,365,105,26712,29981,24498,0,-11,-19,-2129,1,-127,4093,-1,-1,-2,0,13
EUN1_3575546538',5,23,14,1,1,1,0,9,1,353,72,28907,30753,38200,6,27,16,1,0,1,0,5,319,75,28425,28715,39925,1,34,-3,482,-2,2038,-1725,0,1,0,0,4
EUN1_3575522665',6,57,9,0,0,1,0,15,1,315,76,26061,28102,29543,4,27,12,2,1,0,0,2,391,108,28933,33354,28469,0,-76,-32,-2872,-3,-5252,1074,-2,-1,1,0,13
EUN1_3575338173',4,45,11,0,0,0,0,5,1,362,85,27014,29457,31622,3,48,9,1,0,0,0,5,355,93,25591,29677,27342,1,7,-8,1423,2,-220,4280,-1,0,0,0,0
EUN1_3575306601',4,48,15,1,0,0,0,10,0,348,51,26430,28948,38720,3,23,12,1,0,0,0,0,367,90,27289,28828,35815,0,-19,-39,-859,3,120,2905,0,0,0,0,10
EUN1_3575659088',4,279,15,1,0,1,0,8,0,370,77,29719,30578,36287,2,99,12,1,0,0,0,5,302,80,26149,28228,31811,1,68,-3,3570,3,2350,4476,0,0,1,0,3
EUN1_3575640661',1,35,14,1,0,1,0,14,1,324,80,27754,30159,28326,0,24,14,0,0,1,0,5,356,82,28335,30596,31976,0,-32,-2,-581,0,-437,-3650,1,0,0,0,9
EUN1_3574588461',3,27,16,0,0,2,0,11,1,349,70,30092,29846,32841,2,22,16,1,0,0,0,6,361,104,29457,32795,37192,0,-12,-34,635,0,-2949,-4351,-1,0,2,0,5
EUN1_3574306992',3,37,15,2,1,1,0,8,1,371,94,29414,31677,32199,6,26,12,0,0,0,0,6,335,78,26167,29043,28335,0,36,16,3247,3,2634,3864,2,1,1,0,2
EUN1_3573693679',1,24,15,1,0,0,0,9,0,384,91,28715,30580,34332,2,36,12,1,1,0,0,1,391,86,28158,31229,30947,0,-7,5,557,3,-649,3385,0,-1,0,0,8
EUN1_3573673487',5,69,14,2,0,0,0,6,0,336,112,27691,32930,33599,5,29,10,0,0,0,0,2,367,60,25056,31744,34549,0,-31,52,2635,4,1186,-950,2,0,0,0,4
EUN1_3572997127',2,17,12,0,0,1,0,10,0,321,46,27250,29297,40429,5,24,24,1,0,1,0,4,261,88,27978,29566,41648,0,60,-42,-728,-12,-269,-1219,-1,0,0,0,6
EUN1_3572984234',2,22,10,0,0,0,0,13,0,317,78,24903,25992,35673,4,30,17,1,1,4,0,3,352,69,31631,30011,34474,0,-35,9,-6728,-7,-4019,1199,-1,-1,-4,0,10
EUN1_3572968735',3,27,8,2,0,0,0,8,0,357,90,25218,28759,32099,2,25,10,0,0,0,0,2,367,69,25582,28965,22203,1,-10,21,-364,-2,-206,9896,2,0,0,0,6
EUN1_3572979102',2,29,16,1,0,0,0,9,0,351,91,30375,31284,38207,5,24,19,1,0,0,0,4,339,92,30519,29324,35524,0,12,-1,-144,-3,1960,2683,0,0,0,0,5
EUW1_6877986491',7,73,9,1,0,1,0,12,1,311,87,25315,27432,28188,2,27,10,1,0,1,0,3,339,82,26625,28299,30514,1,-28,5,-1310,-1,-867,-2326,0,0,0,0,9
EUW1_6877000077',4,42,9,0,0,0,0,10,1,361,84,25328,30576,30865,2,30,12,1,0,1,0,1,387,76,27976,29905,29059,0,-26,8,-2648,-3,671,1806,-1,0,-1,0,9
EUN1_3571323482',5,26,12,2,0,0,0,2,1,373,106,28812,30034,26592,3,32,5,0,0,2,0,7,359,86,23141,28017,23026,1,14,20,5671,7,2017,3566,2,0,-2,0,-5
EUN1_3570840985',4,52,18,1,0,0,0,9,1,318,82,29375,28969,28862,3,29,9,0,0,3,0,4,336,86,26637,29984,36368,1,-18,-4,2738,9,-1015,-7506,1,0,-3,0,5
EUN1_3566114492',0,56,10,0,0,0,0,14,0,289,110,26498,28263,35856,3,60,25,1,0,3,0,2,402,61,35458,33801,43654,0,-113,49,-8960,-15,-5538,-7798,-1,0,-3,0,12
EUN1_3566106306',0,59,17,1,0,0,0,7,0,317,106,29009,31053,36485,2,64,8,1,0,0,0,0,368,70,25159,27645,28135,1,-51,36,3850,9,3408,8350,0,0,0,0,7
EUN1_3566083269',2,28,4,0,0,0,0,6,0,328,74,23048,27426,22064,2,83,15,2,0,2,0,3,350,97,28657,29441,28045,0,-22,-23,-5609,-11,-2015,-5981,-2,0,-2,0,3
EUN1_3566082440',4,27,17,2,0,0,0,7,1,337,78,31276,30331,41188,5,26,19,0,0,1,0,4,337,94,30058,29757,43695,1,0,-16,1218,-2,574,-2507,2,0,-1,0,3
EUN1_3565788468',3,60,10,0,0,0,0,14,0,311,65,24579,27069,30291,3,57,17,2,1,3,0,0,358,111,31530,31501,37975,0,-47,-46,-6951,-7,-4432,-7684,-2,-1,-3,0,14
EUN1_3564736048',3,24,12,1,0,0,0,6,0,320,98,26155,29108,28244,5,29,15,1,0,0,0,3,349,90,27761,29512,32890,0,-29,8,-1606,-3,-404,-4646,0,0,0,0,3
EUN1_3576105790',3,21,13,1,0,1,0,11,1,356,94,28732,30855,40619,10,38,12,1,0,2,0,6,294,82,26015,29106,33473,1,62,12,2717,1,1749,7146,0,0,-1,0,5
EUN1_3576063662',1,64,15,1,1,0,0,13,1,329,101,29800,29153,38688,5,27,16,0,0,2,0,4,283,78,28096,25271,31062,0,46,23,1704,-1,3882,7626,1,1,-2,0,9
EUN1_3575815273',1,45,17,1,0,0,0,9,1,348,102,29513,29579,28902,4,23,19,1,0,1,0,4,371,76,30341,29971,40836,1,-23,26,-828,-2,-392,-11934,0,0,-1,0,5
EUN1_3575781862',5,67,9,1,0,0,0,16,0,347,72,25778,28294,28051,4,59,18,0,0,2,0,2,357,103,30756,32069,36359,0,-10,-31,-4978,-9,-3775,-8308,1,0,-2,0,14
EUN1_3574981869',2,21,6,0,0,0,0,13,0,330,82,24204,25960,27131,5,108,27,2,0,3,0,6,346,85,34571,31505,47758,0,-16,-3,-10367,-21,-5545,-20627,-2,0,-3,0,7
EUN1_3574961297',4,20,9,1,0,0,0,12,1,351,83,25177,27421,25527,1,28,14,1,0,2,0,2,358,88,28283,30387,32219,0,-7,-5,-3106,-5,-2966,-6692,0,0,-2,0,10
EUN1_3574916970',9,30,23,1,0,0,0,9,1,300,108,31616,28475,34477,1,24,8,1,0,1,0,7,330,60,25501,28019,22428,1,-30,48,6115,15,456,12049,0,0,-1,0,2
EUN1_3574742987',1,27,15,2,1,0,0,13,1,368,88,28093,31376,28982,2,22,14,0,0,2,0,1,322,96,29334,30048,27995,1,46,-8,-1241,1,1328,987,2,1,-2,0,12
EUN1_3574722272',2,23,7,0,0,0,0,3,0,360,82,24076,26934,30404,8,31,16,2,0,1,0,1,360,74,27602,30018,38430,1,0,8,-3526,-9,-3084,-8026,-2,0,-1,0,2
EUN1_3574693951',6,31,14,1,0,0,0,9,1,320,60,27515,28916,34708,1,17,20,0,0,1,0,0,329,88,29549,29646,42250,1,-9,-28,-2034,-6,-730,-7542,1,0,-1,0,9
EUN1_3574531657',2,29,9,0,0,0,0,14,0,317,75,25311,26691,23787,4,25,21,2,0,3,0,1,383,121,32541,33906,40881,0,-66,-46,-7230,-12,-7215,-17094,-2,0,-3,0,13
EUN1_3574504898',1,31,14,1,0,0,0,7,0,329,74,26408,28119,39090,5,26,13,0,0,0,0,3,346,95,28018,29699,31418,0,-17,-21,-1610,1,-1580,7672,1,0,0,0,4
EUN1_3574197205',0,26,9,1,0,0,0,12,1,360,84,25186,28753,24500,6,27,10,1,1,1,0,1,351,100,26917,29746,25118,0,9,-16,-1731,-1,-993,-618,0,-1,-1,0,11
EUN1_3574178370',4,144,12,2,0,1,0,7,1,354,110,27690,31205,29472,3,21,5,0,0,0,0,6,357,89,24393,29563,26983,1,-3,21,3297,7,1642,2489,2,0,1,0,1
EUN1_3574156959',1,25,15,1,0,1,0,3,0,391,74,28844,31711,36712,0,18,14,0,0,0,0,4,313,90,26405,30513,26603,1,78,-16,2439,1,1198,10109,1,0,1,0,-1
EUN1_3574139866',3,27,13,0,0,1,0,10,1,391,66,28455,29345,29087,4,145,10,2,1,0,0,5,361,98,25743,29811,31931,1,30,-32,2712,3,-466,-2844,-2,-1,1,0,5
EUN1_3573959784',2,43,15,2,0,5,0,7,0,368,74,30090,30260,34479,3,19,10,0,0,1,0,7,323,94,25547,27233,24701,1,45,-20,4543,5,3027,9778,2,0,4,0,0
EUN1_3573925710',3,28,9,0,0,1,0,3,1,306,86,25589,26949,29233,1,25,12,0,0,0,0,5,377,74,26050,29696,30638,1,-71,12,-461,-3,-2747,-1405,0,0,1,0,-2
EUN1_3573837480',2,14,5,0,0,0,0,9,0,350,86,24361,28506,17975,4,32,15,2,0,1,0,1,354,94,28069,31202,35299,0,-4,-8,-3708,-10,-2696,-17324,-2,0,-1,0,8
EUN1_3573813835',3,340,16,2,0,2,0,5,1,390,104,30027,31766,36613,5,25,6,0,0,0,0,6,319,87,24077,26816,33161,1,71,17,5950,10,4950,3452,2,0,2,0,-1
EUN1_3576226982',1,31,20,1,0,2,0,10,1,351,80,32206,31148,34813,2,31,11,1,0,2,0,4,383,72,27093,27940,35021,1,-32,8,5113,9,3208,-208,0,0,0,0,6
EUN1_3575961487',1,28,15,1,0,1,0,10,1,306,82,27348,28920,33116,4,27,17,1,0,2,0,5,365,110,30161,31611,34091,1,-59,-28,-2813,-2,-2691,-975,0,0,-1,0,5
EUN1_3575824524',0,16,8,0,0,0,0,14,1,347,82,25326,27658,27976,3,23,22,2,0,2,0,1,411,99,33681,34299,38767,0,-64,-17,-8355,-14,-6641,-10791,-2,0,-2,0,13
EUN1_3575797572',3,23,20,2,0,1,0,6,1,349,86,31394,29714,36699,4,24,11,0,0,1,0,2,293,73,25095,27165,37586,1,56,13,6299,9,2549,-887,2,0,0,0,4
EUN1_3575791217',4,23,18,0,0,2,0,9,0,443,64,31912,33022,41139,4,47,13,2,0,1,0,8,366,102,29038,30655,26002,1,77,-38,2874,5,2367,15137,-2,0,1,0,1
EUN1_3575749311',4,27,8,0,0,0,0,8,1,356,88,25135,28846,23592,4,47,11,2,0,1,0,6,372,103,26635,29488,25367,1,-16,-15,-1500,-3,-642,-1775,-2,0,-1,0,2
EUN1_3575741158',6,174,28,1,0,2,0,8,1,345,103,35310,32835,46266,4,22,13,1,1,0,0,6,317,76,27984,28297,31490,1,28,27,7326,15,4538,14776,0,-1,2,0,2
EUN1_3575487485',5,37,14,1,0,0,0,12,0,366,66,27899,30042,34685,4,24,14,1,0,2,0,3,363,73,28151,29331,32250,0,3,-7,-252,0,711,2435,0,0,-2,0,9
EUN1_3575448803',6,23,9,0,0,0,0,11,0,326,68,24295,26800,27453,4,27,20,2,0,1,0,3,375,84,30745,32259,41793,0,-49,-16,-6450,-11,-5459,-14340,-2,0,-1,0,8
EUN1_3575436173',2,18,16,1,0,0,0,9,1,324,77,28253,30339,35561,4,42,10,0,0,1,0,3,318,80,25159,28098,36419,1,6,-3,3094,6,2241,-858,1,0,-1,0,6
EUN1_3575403586',5,24,9,2,0,0,0,6,1,323,84,24322,29028,19438,3,24,3,0,0,0,0,0,379,84,23378,28846,22010,1,-56,0,944,6,182,-2572,2,0,0,0,6
EUN1_3575306074',5,23,15,1,1,1,0,9,1,357,92,30355,31666,38651,6,35,5,1,0,3,0,4,329,68,23360,28045,22753,1,28,24,6995,10,3621,15898,0,1,-2,0,5
EUN1_3575237348',5,28,15,0,0,2,0,5,1,365,83,29846,30883,30233,2,34,10,2,0,0,0,10,336,80,25233,28579,24720,1,29,3,4613,5,2304,5513,-2,0,2,0,-5
EUN1_3575221500',5,40,12,0,0,0,0,12,0,309,80,25610,28124,27522,6,132,18,2,1,3,0,0,343,86,30864,31312,40244,0,-34,-6,-5254,-6,-3188,-12722,-2,-1,-3,0,12
EUN1_3575210545',5,31,22,1,0,2,0,12,0,378,94,31708,33115,44279,7,51,6,0,0,0,0,8,353,76,23943,26600,33630,1,25,18,7765,16,6515,10649,1,0,2,0,4
EUN1_3575200093',3,30,10,1,0,2,0,11,1,352,78,27607,27758,34441,6,45,21,1,0,2,0,3,295,94,31224,29919,37901,0,57,-16,-3617,-11,-2161,-3460,0,0,0,0,8
EUN1_3574695359',1,23,11,2,0,0,0,6,1,285,96,24585,27915,27263,2,39,14,0,0,1,0,2,373,70,28016,30089,31003,0,-88,26,-3431,-3,-2174,-3740,2,0,-1,0,4
EUN1_3574670707',3,23,16,0,0,0,0,10,0,276,68,27043,27894,32005,3,22,25,2,1,1,0,1,352,93,32684,31669,47942,0,-76,-25,-5641,-9,-3775,-15937,-2,-1,-1,0,9
EUN1_3575987911',2,23,20,0,0,1,0,12,1,324,104,31136,32667,38775,2,23,14,1,0,0,0,1,308,92,26684,28313,30400,1,16,12,4452,6,4354,8375,-1,0,1,0,11
EUN1_3575980191',1,21,23,1,1,2,0,9,1,364,81,31935,32719,41067,0,20,6,0,0,0,0,7,304,82,22390,24316,25786,1,60,-1,9545,17,8403,15281,1,1,2,0,2
EUN1_3573826638',4,43,19,0,0,0,0,4,1,379,79,30211,30450,40009,2,41,9,0,0,1,0,4,299,60,24279,28771,24982,1,80,19,5932,10,1679,15027,0,0,-1,0,0
EUN1_3573798851',5,43,12,2,0,1,0,9,1,374,78,27547,30381,31592,5,25,13,0,0,0,0,3,357,86,27834,30614,31899,1,17,-8,-287,-1,-233,-307,2,0,1,0,6
EUN1_3573564625',8,43,13,1,1,0,0,9,0,310,84,26923,28100,34455,2,16,17,1,0,1,0,2,344,96,29891,31032,41681,0,-34,-12,-2968,-4,-2932,-7226,0,1,-1,0,7
EUN1_3573550595',3,23,13,0,1,0,0,6,1,333,64,26017,32002,24210,2,25,8,1,0,0,0,2,380,94,25666,29371,26486,1,-47,-30,351,5,2631,-2276,-1,1,0,0,4
EUN1_3573537900',1,22,7,0,0,1,0,12,0,293,94,24406,28164,29351,5,27,17,2,1,1,0,2,306,116,29678,30453,33220,1,-13,-22,-5272,-10,-2289,-3869,-2,-1,0,0,10
EUN1_3573537540',5,29,9,0,0,0,0,8,0,341,70,24853,28302,34544,5,188,11,1,0,2,0,3,346,86,28168,29599,26801,0,-5,-16,-3315,-2,-1297,7743,-1,0,-2,0,5
EUN1_3573525933',8,24,9,1,0,1,0,8,1,338,74,26044,27006,31961,0,21,11,1,0,0,0,7,405,84,28014,30681,28212,1,-67,-10,-1970,-2,-3675,3749,0,0,1,0,1
EUN1_3573287648',5,37,14,0,0,0,0,16,0,231,64,25180,25048,38394,1,67,19,1,0,3,0,1,342,92,32091,29647,41791,1,-111,-28,-6911,-5,-4599,-3397,-1,0,-3,0,15
EUN1_3573258045',4,107,10,0,0,0,0,11,1,248,90,24222,26083,28715,5,69,16,2,1,1,0,1,320,90,29260,29360,33240,0,-72,0,-5038,-6,-3277,-4525,-2,-1,-1,0,10
EUN1_3573246789',4,41,7,1,0,0,0,6,0,304,90,23874,27775,31532,2,27,10,0,0,0,0,3,316,75,24001,29354,26062,0,-12,15,-127,-3,-1579,5470,1,0,0,0,3
EUN1_3576141052',7,30,11,0,1,0,0,7,1,361,102,26846,30662,27940,4,38,9,0,0,1,0,3,357,86,25717,28272,22959,1,4,16,1129,2,2390,4981,0,1,-1,0,4
EUN1_3576137351',4,64,14,0,0,1,0,13,0,267,64,26406,23438,34258,7,35,23,2,0,2,0,3,346,75,33440,29117,40838,0,-79,-11,-7034,-9,-5679,-6580,-2,0,-1,0,10
EUN1_3576109957',7,31,14,1,0,0,0,7,1,350,90,27778,30328,34672,4,30,14,1,0,0,0,4,311,76,27840,28449,34700,1,39,14,-62,0,1879,-28,0,0,0,0,3
EUN1_3576097450',4,25,15,2,0,1,0,4,0,334,91,27421,30557,32234,2,26,3,0,0,0,0,2,351,76,22555,27702,18963,1,-17,15,4866,12,2855,13271,2,0,1,0,2
EUN1_3576073278',2,187,9,2,0,0,0,7,0,340,88,24428,29209,22518,7,29,9,0,0,0,0,1,378,80,25666,29548,30969,0,-38,8,-1238,0,-339,-8451,2,0,0,0,6
EUN1_3576045341',1,23,16,1,0,0,0,11,1,386,92,29486,31701,39973,6,28,10,1,0,2,0,5,368,76,28085,29274,27846,1,18,16,1401,6,2427,12127,0,0,-2,0,6
EUN1_3576009728',2,31,10,0,0,0,0,9,1,312,72,24981,26839,33100,4,32,18,2,0,1,0,2,366,88,29935,29979,37419,0,-54,-16,-4954,-8,-3140,-4319,-2,0,-1,0,7
EUN1_3575986795',4,34,11,1,0,0,0,8,0,350,93,25770,28704,25081,4,268,7,1,0,0,0,2,368,87,25337,29511,24894,0,-18,6,433,4,-807,187,0,0,0,0,6
EUN1_3575959012',5,28,29,2,0,0,0,14,1,322,85,33120,30452,51359,1,22,10,0,0,1,0,3,296,65,26264,24841,38452,1,26,20,6856,19,5611,12907,2,0,-1,0,11
EUN1_3575947247',4,380,17,1,0,0,0,5,1,341,92,28202,31414,45697,3,27,10,1,0,0,0,2,342,84,25707,27884,24920,1,-1,8,2495,7,3530,20777,0,0,0,0,3
EUN1_3575918537',1,13,12,0,0,1,0,15,0,280,27,24202,27769,29727,3,24,28,2,0,4,0,4,369,96,34658,33913,46145,1,-89,-69,-10456,-16,-6144,-16418,-2,0,-3,0,11
EUN1_3575888860',5,40,17,1,0,2,0,6,0,328,66,29754,27982,45698,5,23,19,0,0,0,0,9,286,69,28559,27452,35838,0,42,-3,1195,-2,530,9860,1,0,2,0,-3
EUN1_3575862569',2,17,4,0,0,0,0,12,1,325,76,23176,26942,28965,4,31,28,2,0,2,0,2,347,70,32757,31724,43652,0,-22,6,-9581,-24,-4782,-14687,-2,0,-2,0,10
EUN1_3575828863',7,35,11,0,0,0,0,9,0,316,46,25065,27229,27835,1,28,23,1,1,1,0,2,340,92,31241,29838,34511,0,-24,-46,-6176,-12,-2609,-6676,-1,-1,-1,0,7
EUN1_3575822113',2,25,20,0,0,1,0,9,1,334,78,30278,29368,44560,4,31,11,1,0,1,0,6,344,90,27040,27702,33401,1,-10,-12,3238,9,1666,11159,-1,0,0,0,3
EUN1_3575808082',1,26,9,1,0,1,0,10,0,294,99,24428,28007,39604,2,29,14,1,0,1,0,3,332,86,27911,30563,41357,0,-38,13,-3483,-5,-2556,-1753,0,0,0,0,7
EUN1_3575787375',3,27,10,0,0,0,0,14,1,337,96,26752,29800,24298,4,26,11,1,0,3,0,2,335,108,28282,30798,32962,0,2,-12,-1530,-1,-998,-8664,-1,0,-3,0,12
EUN1_3575772320',3,27,8,0,0,0,0,9,1,299,92,25433,28847,25976,3,20,9,2,0,1,0,4,337,91,26080,29625,37568,0,-38,1,-647,-1,-778,-11592,-2,0,-1,0,5
EUN1_3573956655',5,28,12,1,0,1,0,7,0,376,94,28107,29613,31084,1,26,10,1,0,0,0,6,340,90,26377,27799,30538,0,36,4,1730,2,1814,546,0,0,1,0,1
EUN1_3573042928',6,35,3,0,0,0,0,10,0,343,88,22751,26292,24032,7,41,9,2,0,1,0,1,362,76,25730,27785,29715,0,-19,12,-2979,-6,-1493,-5683,-2,0,-1,0,9
EUN1_3573025987',3,38,10,1,0,0,0,10,1,374,92,27388,29278,33948,4,260,9,1,0,1,0,4,337,99,25589,30327,24958,0,37,-7,1799,1,-1049,8990,0,0,-1,0,6
EUN1_3573015024',6,31,13,1,0,2,0,9,1,377,90,29878,31040,32846,3,29,11,1,0,0,0,7,316,74,25127,27367,28966,1,61,16,4751,2,3673,3880,0,0,2,0,2
EUN1_3572648511',4,240,2,0,0,0,0,13,0,325,80,21163,24612,21367,6,38,22,2,1,3,0,1,381,118,33616,32243,34763,0,-56,-38,-12453,-20,-7631,-13396,-2,-1,-3,0,12
EUN1_3572620909',4,27,11,2,0,2,0,4,1,358,112,28427,32147,26902,1,24,5,0,0,0,0,6,338,80,22943,28068,28152,0,20,32,5484,6,4079,-1250,2,0,2,0,-2
EUN1_3572333561',4,34,20,0,0,0,0,8,0,381,90,31618,33278,43790,1,19,15,1,0,1,0,5,320,74,27266,29026,34675,1,61,16,4352,5,4252,9115,-1,0,-1,0,3
EUN1_3572311878',3,34,11,2,0,3,0,12,1,351,96,29447,29478,29598,7,28,8,0,0,0,0,9,338,80,23960,27423,25725,1,13,16,5487,3,2055,3873,2,0,3,0,3
EUN1_3572293647',2,29,15,1,0,1,0,13,0,293,87,26962,28160,37099,3,40,19,1,0,3,0,2,341,61,29736,27656,36374,0,-48,26,-2774,-4,504,725,0,0,-2,0,11
EUN1_3572265820',4,28,12,0,0,1,0,8,0,364,72,26902,29323,39011,5,29,7,2,0,1,0,1,379,104,26110,29540,29077,0,-15,-32,792,5,-217,9934,-2,0,0,0,7
EUN1_3572010017',6,28,13,1,1,0,0,4,1,382,106,28396,31177,37111,3,25,8,1,0,1,0,6,321,74,24512,29193,31102,1,61,32,3884,5,1984,6009,0,1,-1,0,-2
EUN1_3572002613',2,27,10,0,0,0,0,10,0,326,76,24885,27892,29167,6,36,14,1,0,2,0,0,399,104,30290,31733,28172,0,-73,-28,-5405,-4,-3841,995,-1,0,-2,0,10
EUN1_3571542550',4,24,9,0,0,0,0,6,1,384,92,27937,31382,28586,2,26,15,2,0,1,0,5,367,76,27807,30918,33527,1,17,16,130,-6,464,-4941,-2,0,-1,0,1
EUN1_3571509054',3,29,10,1,0,1,0,6,1,370,84,28255,32049,34608,1,26,11,1,0,1,0,9,355,92,25809,29779,35302,0,15,-8,2446,-1,2270,-694,0,0,0,0,-3
EUN1_3571499330',1,21,12,1,0,1,0,11,1,374,80,28041,31158,30716,2,31,7,0,0,1,0,2,363,68,24032,27953,29103,1,11,12,4009,5,3205,1613,1,0,0,0,9
EUN1_3571470443',6,27,8,1,1,0,0,9,0,366,104,26793,30880,29776,4,57,11,1,0,1,0,5,374,80,26435,29674,29510,1,-8,24,358,-3,1206,266,0,1,-1,0,4
EUN1_3571447352',2,29,4,0,0,1,0,10,1,356,90,24645,28031,22125,8,66,12,1,1,0,0,3,369,73,26151,31438,34902,0,-13,17,-1506,-8,-3407,-12777,-1,-1,1,0,7
EUN1_3571422968',5,29,11,1,1,1,0,6,1,343,106,27456,29964,35046,7,27,9,1,0,0,0,5,335,85,25062,28560,28268,1,8,21,2394,2,1404,6778,0,1,1,0,1
EUN1_3571415146',4,27,7,1,0,1,0,7,1,392,92,25819,30834,31591,7,33,9,1,0,0,0,4,412,100,27318,32459,28904,1,-20,-8,-1499,-2,-1625,2687,0,0,1,0,3
EUN1_3571399252',2,29,15,1,0,0,0,14,1,363,84,28946,30630,31538,5,157,8,1,0,1,0,4,378,84,27305,30411,35200,1,-15,0,1641,7,219,-3662,0,0,-1,0,10
EUN1_3576238661',7,26,14,0,0,0,0,9,1,355,107,27880,31646,27150,2,15,5,1,0,0,0,3,342,72,24349,28893,25466,1,13,35,3531,9,2753,1684,-1,0,0,0,6
EUN1_3576232360',2,28,5,0,0,0,0,13,0,338,84,23136,28664,19467,4,27,11,2,1,2,0,3,377,90,28952,30680,31007,0,-39,-6,-5816,-6,-2016,-11540,-2,-1,-2,0,10
EUN1_3576220737',0,33,16,1,0,0,0,9,0,332,79,28650,28922,33483,4,27,10,1,0,3,0,5,325,76,25968,27606,30465,0,7,3,2682,6,1316,3018,0,0,-3,0,4
EUN1_3576212053',9,40,16,2,0,1,0,8,0,361,96,29057,31413,35746,5,33,12,0,0,0,0,3,275,74,25268,27946,29689,1,86,22,3789,4,3467,6057,2,0,1,0,5
EUN1_3576206756',3,158,14,1,0,1,0,5,0,304,98,27424,28231,33574,4,20,11,1,0,0,0,7,254,86,23584,26190,30935,1,50,12,3840,3,2041,2639,0,0,1,0,-2
EUN1_3575914984',3,29,10,0,0,0,0,7,0,328,88,27114,27915,37288,4,30,24,2,0,0,0,1,331,87,28755,30533,39067,0,-3,1,-1641,-14,-2618,-1779,-2,0,0,0,6
EUN1_3575891965',4,39,10,1,0,0,0,11,0,322,99,25697,29110,29067,4,48,17,0,0,0,0,1,360,92,29446,30654,37360,0,-38,7,-3749,-7,-1544,-8293,1,0,0,0,10
EUN1_3575855600',6,29,14,0,0,0,0,7,1,324,92,27787,28075,29707,2,25,12,1,0,1,0,2,335,86,26266,28924,29482,1,-11,6,1521,2,-849,225,-1,0,-1,0,5
EUN1_3575741699',3,31,11,1,0,0,0,7,0,374,80,26618,31659,27389,4,37,10,1,0,0,0,2,370,102,28142,30005,34628,0,4,-22,-1524,1,1654,-7239,0,0,0,0,5
EUN1_3575722992',5,153,11,0,0,0,0,6,0,285,96,24738,29659,29623,6,43,13,2,0,0,0,0,343,80,25514,28170,36923,1,-58,16,-776,-2,1489,-7300,-2,0,0,0,6
EUN1_3575723301',3,25,17,1,0,1,0,6,0,365,84,29835,31181,39426,4,50,12,1,0,0,0,8,312,72,26031,27828,36527,1,53,12,3804,5,3353,2899,0,0,1,0,-2
EUN1_3575704971',5,29,10,0,0,0,0,7,0,299,88,24709,28542,29665,8,39,15,1,0,1,0,1,353,100,28342,32046,33909,0,-54,-12,-3633,-5,-3504,-4244,-1,0,-1,0,6
EUN1_3575698951',5,201,27,2,0,1,0,5,1,358,115,32120,32655,40191,6,372,14,0,0,0,0,6,320,72,26785,28272,32004,1,38,43,5335,13,4383,8187,2,0,1,0,-1
EUN1_3575427995',2,24,13,1,0,1,0,13,0,342,60,27235,30208,25271,4,149,11,0,0,1,0,2,367,92,28021,31436,28831,1,-25,-32,-786,2,-1228,-3560,1,0,0,0,11
EUN1_3575410077',4,26,16,2,0,0,0,5,0,292,85,27602,27216,34865,4,300,17,0,0,0,0,3,289,77,26828,27397,36923,1,3,8,774,-1,-181,-2058,2,0,0,0,2
EUN1_3575174649',4,25,15,2,0,0,0,13,0,293,98,26620,27299,29704,3,42,16,0,0,1,0,5,362,94,30389,30963,37493,0,-69,4,-3769,-1,-3664,-7789,2,0,-1,0,8
EUN1_3575167551',3,24,9,0,0,0,0,10,0,334,56,24610,27350,30747,4,24,20,1,0,2,0,1,367,92,32109,33581,37763,0,-33,-36,-7499,-11,-6231,-7016,-1,0,-2,0,9
EUN1_3574865571',3,27,15,0,0,0,0,7,1,376,90,28398,30979,29398,4,33,8,1,0,0,0,1,339,85,25241,29265,24723,0,37,5,3157,7,1714,4675,-1,0,0,0,6
EUN1_3574847464',6,44,7,2,0,0,0,11,0,360,86,24423,27528,18562,7,35,13,0,0,2,0,0,399,90,29826,31636,35574,0,-39,-4,-5403,-6,-4108,-17012,2,0,-2,0,11
EUN1_3575918027',5,28,16,0,0,2,0,13,1,363,92,29903,29305,44147,1,29,18,2,0,0,0,5,275,94,29831,31207,35210,0,88,-2,72,-2,-1902,8937,-2,0,2,0,8
EUN1_3575908090',2,21,9,0,0,0,0,10,1,327,90,24966,27886,25245,3,26,13,2,0,0,0,5,345,89,26872,31014,24393,0,-18,1,-1906,-4,-3128,852,-2,0,0,0,5
EUN1_3572379792',4,27,8,0,0,0,0,9,0,330,88,23978,29348,22421,2,81,13,2,0,1,0,2,351,92,27318,28204,30332,0,-21,-4,-3340,-5,1144,-7911,-2,0,-1,0,7
EUN1_3572370351',1,47,12,0,0,1,0,6,0,342,83,26806,26842,24916,6,30,12,2,0,0,0,6,300,94,25860,27756,21620,0,42,-11,946,0,-914,3296,-2,0,1,0,0
EUN1_3572307986',2,81,18,1,0,2,0,9,1,349,104,30927,32892,40080,4,18,12,0,0,0,0,6,357,70,27099,28584,38835,1,-8,34,3828,6,4308,1245,1,0,2,0,3
EUN1_3572283562',3,25,6,1,0,0,0,13,0,303,86,23011,26743,30240,1,22,15,0,0,3,0,0,368,81,29444,30624,37735,0,-65,5,-6433,-9,-3881,-7495,1,0,-3,0,13
EUN1_3572252752',4,32,15,1,0,1,0,8,1,347,88,29666,30691,38203,3,29,11,0,0,0,0,4,317,99,25685,27725,29296,1,30,-11,3981,4,2966,8907,1,0,1,0,4
EUN1_3572197959',3,69,11,0,0,0,0,15,1,358,72,26865,29253,28541,5,354,15,2,0,1,0,2,353,84,27325,30055,32803,1,5,-12,-460,-4,-802,-4262,-2,0,-1,0,13
EUN1_3571869924',3,28,10,0,0,1,0,15,0,341,82,26452,30231,27707,3,38,18,2,0,2,0,4,344,102,30446,30702,37018,0,-3,-20,-3994,-8,-471,-9311,-2,0,-1,0,11
EUN1_3571866229',2,29,12,1,0,0,0,6,0,329,102,26251,29120,29487,2,22,6,1,0,0,0,2,372,93,24938,29093,28060,1,-43,9,1313,6,27,1427,0,0,0,0,4
EUN1_3571856796',6,68,17,1,1,1,0,8,1,373,84,30932,31493,39451,2,23,19,1,0,0,0,6,346,87,29437,29307,36544,1,27,-3,1495,-2,2186,2907,0,1,1,0,2
EUN1_3571862358',1,25,19,2,0,0,0,8,0,367,77,31528,29575,45539,7,30,19,0,0,1,0,4,286,70,29356,28510,35809,1,81,7,2172,0,1065,9730,2,0,-1,0,4
EUN1_3571854583',4,27,13,2,0,1,0,3,1,327,80,27260,28062,31145,2,26,9,0,0,1,0,3,333,75,25244,28122,38021,1,-6,5,2016,4,-60,-6876,2,0,0,0,0
EUN1_3571842097',2,21,18,0,0,2,0,5,0,325,92,29405,29319,34499,3,27,17,1,1,0,0,9,320,80,28570,29369,38653,0,5,12,835,1,-50,-4154,-1,-1,2,0,-4
EUN1_3575846357',1,24,18,2,0,1,0,7,1,383,106,32130,32309,43370,4,17,9,0,0,2,0,5,311,72,24862,29390,31319,0,72,34,7268,9,2919,12051,2,0,-1,0,2
EUN1_3575827243',1,24,20,1,0,0,0,10,1,314,90,28641,30238,39045,1,26,18,1,0,0,0,2,297,86,28967,30400,37904,1,17,4,-326,2,-162,1141,0,0,0,0,8
EUN1_3575805386',4,63,7,1,0,0,0,10,0,334,86,24010,27057,31660,7,63,15,1,0,2,0,0,381,98,29190,31578,36618,0,-47,-12,-5180,-8,-4521,-4958,0,0,-2,0,10
EUN1_3575759395',1,24,15,1,0,3,0,8,0,388,111,30866,34283,28357,0,23,8,0,0,0,0,8,383,88,26171,30055,21263,1,5,23,4695,7,4228,7094,1,0,3,0,0
EUN1_3575097255',2,49,9,0,0,0,0,10,0,296,79,24923,27007,21413,1,24,17,2,0,2,0,3,359,102,28969,29633,35070,0,-63,-23,-4046,-8,-2626,-13657,-2,0,-2,0,7
EUN1_3575084283',2,153,20,0,0,3,0,9,0,372,115,32787,32724,37587,5,30,13,2,0,1,0,8,325,68,26783,28497,33088,1,47,47,6004,7,4227,4499,-2,0,2,0,1
EUN1_3574634205',2,30,7,1,0,1,0,11,1,341,73,25563,26783,23735,3,31,16,1,0,3,0,4,315,94,30276,30152,28195,0,26,-21,-4713,-9,-3369,-4460,0,0,-2,0,7
EUN1_3574630178',3,26,11,2,0,2,0,10,1,375,76,28810,29639,45874,2,31,11,0,0,0,0,6,264,80,25113,25504,28096,1,111,-4,3697,0,4135,17778,2,0,2,0,4
EUN1_3574521742',2,24,17,1,0,0,0,12,1,308,80,29023,30074,33379,4,37,13,0,0,0,0,3,363,80,28553,32213,39455,1,-55,0,470,4,-2139,-6076,1,0,0,0,9
EUN1_3574374330',3,80,10,1,1,0,0,6,0,343,94,26000,31174,27751,3,27,7,1,0,0,0,3,337,86,25148,29084,30642,1,6,8,852,3,2090,-2891,0,1,0,0,3
EUN1_3574342922',0,35,5,1,0,0,0,6,0,340,112,23057,31206,23040,2,29,7,1,0,0,0,1,343,88,23701,29367,17954,1,-3,24,-644,-2,1839,5086,0,0,0,0,5
EUN1_3573799292',2,20,2,0,0,0,0,10,1,334,79,21210,26524,17955,5,211,12,1,0,2,0,1,394,108,29045,32305,31569,0,-60,-29,-7835,-10,-5781,-13614,-1,0,-2,0,9
EUN1_3564758288',3,19,14,0,0,0,0,12,0,321,64,27830,29132,32764,2,23,10,1,0,1,0,4,382,108,27806,29759,30858,1,-61,-44,24,4,-627,1906,-1,0,-1,0,8
EUN1_3564739880',4,24,7,0,0,0,0,15,0,319,108,23843,27245,27375,2,20,20,2,0,1,0,0,359,109,31199,33405,33689,0,-40,-1,-7356,-13,-6160,-6314,-2,0,-1,0,15
EUN1_3564730913',0,27,9,0,0,0,0,10,0,341,80,25707,27736,30760,6,29,17,2,0,2,0,4,360,92,30377,31659,39220,0,-19,-12,-4670,-8,-3923,-8460,-2,0,-2,0,6
EUN1_3560852079',1,52,12,1,0,1,0,7,1,328,93,28180,29076,32834,1,137,11,0,0,1,0,5,342,87,27150,31171,27489,1,-14,6,1030,1,-2095,5345,1,0,0,0,2
EUN1_3560825942',3,25,11,1,0,0,0,15,1,274,78,25420,24861,23650,1,43,18,1,0,3,0,2,369,122,33112,30559,33059,0,-95,-44,-7692,-7,-5698,-9409,0,0,-3,0,13
EUN1_3560797152',1,25,15,2,0,0,0,8,1,291,100,27983,30313,33709,2,51,14,0,1,0,0,0,335,100,27524,30282,33928,1,-44,0,459,1,31,-219,2,-1,0,0,8
EUN1_3560779221',2,25,13,2,0,1,0,6,1,362,100,27879,30067,29246,10,33,7,0,0,1,0,6,364,92,25537,28925,30733,0,-2,8,2342,6,1142,-1487,2,0,0,0,0
EUN1_3559174961',2,22,9,0,0,0,0,9,0,296,90,24810,25977,34994,3,28,13,2,1,0,0,5,313,98,27600,29581,28907,1,-17,-8,-2790,-4,-3604,6087,-2,-1,0,0,4
EUN1_3558108889',1,26,6,1,0,0,0,5,1,393,112,25629,31246,22280,8,43,12,1,0,0,0,2,323,103,26580,30134,26827,1,70,9,-951,-6,1112,-4547,0,0,0,0,3
EUN1_3558098743',3,25,10,1,0,0,0,5,1,337,76,26988,28672,33113,2,100,21,1,0,0,0,3,344,104,29993,32718,39170,0,-7,-28,-3005,-11,-4046,-6057,0,0,0,0,2
EUN1_3558077716',3,30,16,1,0,1,0,7,1,349,92,29794,31979,36952,1,20,13,1,0,1,0,7,345,92,27432,30612,34472,0,4,0,2362,3,1367,2480,0,0,0,0,0
EUN1_3558057707',2,26,19,1,1,1,0,3,1,387,81,30501,31591,35657,3,22,10,0,0,0,0,6,353,90,25852,28720,26639,1,34,-9,4649,9,2871,9018,1,1,1,0,-3
EUN1_3575982986',4,26,16,1,0,2,0,9,1,369,96,29184,31273,36605,2,32,5,1,0,0,0,3,316,69,21164,25676,22612,1,53,27,8020,11,5597,13993,0,0,2,0,6
EUN1_3575924742',2,25,11,0,0,1,0,14,0,350,82,26997,29516,30392,3,25,11,1,0,1,0,6,395,90,28445,31060,30511,1,-45,-8,-1448,0,-1544,-119,-1,0,0,0,8
EUN1_3575768870',1,65,15,2,0,0,0,16,1,383,84,28119,31377,33092,7,149,14,0,0,3,0,1,357,95,30806,28713,41668,0,26,-11,-2687,1,2664,-8576,2,0,-3,0,15
EUN1_3575482340',6,282,19,1,0,1,0,3,1,332,78,29253,31024,44795,1,28,15,0,0,0,0,8,333,90,27806,30545,40807,1,-1,-12,1447,4,479,3988,1,0,1,0,-5
EUN1_3574758534',7,39,9,0,0,0,0,5,0,353,86,25436,30506,33795,1,28,9,2,0,0,0,4,407,106,26494,31026,33727,0,-54,-20,-1058,0,-520,68,-2,0,0,0,1
EUN1_3574624748',3,27,11,1,0,1,0,9,1,339,100,27400,27791,27201,4,158,13,1,1,0,0,5,327,102,27156,29873,31344,0,12,-2,244,-2,-2082,-4143,0,-1,1,0,4
EUN1_3574620378',2,61,16,1,0,0,0,11,0,319,63,27908,28989,33676,7,150,19,1,0,1,0,1,349,82,29761,30508,39880,1,-30,-19,-1853,-3,-1519,-6204,0,0,-1,0,10
EUN1_3574613750',3,22,10,0,1,1,0,5,1,353,92,26690,30073,33484,7,26,16,2,0,2,0,8,359,76,29760,31458,34955,0,-6,16,-3070,-6,-1385,-1471,-2,1,-1,0,-3
EUN1_3574313253',5,29,15,1,0,0,0,4,1,361,88,27403,31278,32465,2,25,6,1,0,0,0,2,357,88,23602,27826,31784,1,4,0,3801,9,3452,681,0,0,0,0,2
EUN1_3574292608',4,30,12,1,0,0,0,8,1,358,88,27454,31470,31120,3,28,11,1,0,1,0,4,335,83,25822,30099,24934,1,23,5,1632,1,1371,6186,0,0,-1,0,4
EUN1_3574268691',6,28,18,1,1,3,0,8,1,358,86,30028,30566,44314,3,30,4,1,0,0,0,9,260,86,21727,23922,25325,1,98,0,8301,14,6644,18989,0,1,3,0,-1
EUN1_3574127860',5,24,21,1,0,2,0,7,1,354,104,33078,31248,41905,2,35,12,0,0,0,0,6,316,52,25822,27194,33244,1,38,52,7256,9,4054,8661,1,0,2,0,1
EUN1_3574116449',5,24,18,1,0,1,0,7,1,365,80,29610,31648,34304,3,143,5,1,0,1,0,7,295,88,23854,26242,31487,1,70,-8,5756,13,5406,2817,0,0,0,0,0
EUN1_3573272096',1,23,14,2,0,2,0,4,1,370,106,29623,32308,31046,6,29,7,0,0,0,0,9,346,80,24546,29715,24618,1,24,26,5077,7,2593,6428,2,0,2,0,-5
EUN1_3573222086',0,23,10,1,0,0,0,8,1,364,75,25925,30710,27656,8,43,6,1,0,0,0,2,343,92,23790,28004,20147,1,21,-17,2135,4,2706,7509,0,0,0,0,6
EUN1_3573167849',3,59,13,1,0,0,0,12,0,326,87,26595,27159,33854,3,23,18,0,0,0,0,4,332,72,27521,27496,40000,1,-6,15,-926,-5,-337,-6146,1,0,0,0,8
EUN1_3572348376',2,20,7,1,0,0,0,10,0,334,96,24867,29277,26217,4,23,15,0,0,1,0,0,357,88,27938,31786,32961,1,-23,8,-3071,-8,-2509,-6744,1,0,-1,0,10
EUN1_3572335242',2,20,24,1,0,1,0,13,1,306,96,32487,29810,38312,5,350,15,0,0,1,0,5,367,58,29555,29261,38881,1,-61,38,2932,9,549,-569,1,0,0,0,8
EUN1_3572315342',1,237,16,1,0,2,0,7,0,393,84,30539,30305,33557,2,23,5,1,0,0,0,6,318,96,23717,27903,29640,1,75,-12,6822,11,2402,3917,0,0,2,0,1
EUN1_3572276960',2,29,11,1,0,1,0,7,0,367,87,27596,29622,27002,3,23,8,1,0,0,0,6,337,92,24399,27434,25737,0,30,-5,3197,3,2188,1265,0,0,1,0,1
EUN1_3572243833',5,26,11,0,0,2,0,9,0,320,84,26993,27721,26013,4,34,9,1,0,0,0,5,335,103,25919,29095,22186,1,-15,-19,1074,2,-1374,3827,-1,0,2,0,4
EUN1_3571196751',1,21,13,0,0,0,0,13,1,339,62,27388,26341,30229,2,174,25,1,0,3,0,1,389,94,36731,31248,40872,0,-50,-32,-9343,-12,-4907,-10643,-1,0,-3,0,12
EUN1_3571174781',4,30,26,0,0,2,0,9,1,340,96,33809,32131,44564,1,22,15,2,0,0,0,8,316,107,29523,31415,36758,1,24,-11,4286,11,716,7806,-2,0,2,0,1
EUN1_3571145996',3,29,14,0,1,0,0,9,0,340,94,27987,31668,35694,4,25,18,1,0,1,0,3,391,93,30546,30797,39418,0,-51,1,-2559,-4,871,-3724,-1,1,-1,0,6
EUN1_3571125143',3,26,16,2,0,1,0,8,1,382,86,30477,30962,32765,4,24,10,0,0,1,0,7,318,80,25836,29178,27120,1,64,6,4641,6,1784,5645,2,0,0,0,1
EUN1_3569561724',3,26,17,0,1,2,0,8,1,381,96,32519,31028,29695,2,29,9,2,0,0,0,8,347,85,25379,28200,30611,1,34,11,7140,8,2828,-916,-2,1,2,0,0
EUN1_3569541932',3,29,18,1,0,3,0,7,0,370,112,31808,33184,35908,5,41,9,1,0,0,0,6,344,92,24958,28764,26542,1,26,20,6850,9,4420,9366,0,0,3,0,1
EUN1_3569534297',4,20,23,0,0,1,0,12,0,339,94,31256,31237,37378,4,149,13,1,0,2,0,3,316,86,27869,29133,29611,1,23,8,3387,10,2104,7767,-1,0,-1,0,9
EUN1_3569516537',3,30,11,0,0,0,0,15,0,350,98,27149,30563,29249,6,27,15,2,0,3,0,2,365,93,29934,31401,30762,0,-15,5,-2785,-4,-838,-1513,-2,0,-3,0,13
EUN1_3576111607',3,22,15,1,0,1,0,5,1,320,82,28325,29945,30385,2,60,8,1,0,0,0,4,331,86,24326,27508,27037,1,-11,-4,3999,7,2437,3348,0,0,1,0,1
EUN1_3576086478',1,24,10,2,0,1,0,10,0,301,66,25125,27409,26533,1,25,14,0,0,1,0,7,356,102,27517,29559,30544,0,-55,-36,-2392,-4,-2150,-4011,2,0,0,0,3
EUN1_3576057634',3,31,7,0,0,0,0,7,0,354,100,24724,29377,30887,3,24,12,1,0,0,0,0,326,76,26030,28827,30654,0,28,24,-1306,-5,550,233,-1,0,0,0,7
EUN1_3576037075',1,22,9,0,0,0,0,10,0,362,80,25958,30800,28853,3,42,21,2,0,1,0,1,334,119,30702,33958,37316,0,28,-39,-4744,-12,-3158,-8463,-2,0,-1,0,9
EUN1_3576003419',6,27,23,1,0,0,0,11,1,294,74,31661,27155,39401,5,24,17,0,0,1,0,4,319,86,30884,27733,41272,1,-25,-12,777,6,-578,-1871,1,0,-1,0,7
EUN1_3575967443',8,30,13,1,0,0,0,8,1,327,80,25633,28359,27256,5,33,16,1,0,2,0,0,328,98,28463,31475,38271,1,-1,-18,-2830,-3,-3116,-11015,0,0,-2,0,8
EUN1_3575937689',3,29,9,2,0,0,0,13,1,330,94,25904,28372,33042,2,144,15,0,0,1,0,2,391,74,28568,32092,29190,0,-61,20,-2664,-6,-3720,3852,2,0,-1,0,11
EUN1_3575914929',3,26,15,2,0,3,0,5,1,389,84,30234,32668,27686,4,26,8,0,0,0,0,3,339,72,23988,27516,22194,1,50,12,6246,7,5152,5492,2,0,3,0,2
EUN1_3575856365',6,33,11,0,0,0,0,7,1,299,84,24674,26846,27766,1,21,13,2,0,1,0,4,378,82,26987,29422,30027,0,-79,2,-2313,-2,-2576,-2261,-2,0,-1,0,3
EUN1_3575799444',2,23,17,0,0,0,0,7,1,328,96,28039,31257,30191,2,21,9,2,0,1,0,1,353,76,25722,26551,26818,0,-25,20,2317,8,4706,3373,-2,0,-1,0,6
EUN1_3575780920',4,28,7,1,0,0,0,16,0,293,78,22658,25626,24577,3,30,22,1,1,3,0,1,299,104,32362,30919,40333,0,-6,-26,-9704,-15,-5293,-15756,0,-1,-3,0,15
EUN1_3575770473',4,21,12,1,0,1,0,3,1,380,108,29643,31210,31805,2,20,4,1,0,1,0,8,346,84,23912,30123,18717,1,34,24,5731,8,1087,13088,0,0,0,0,-5
EUN1_3575595281',3,28,3,1,0,0,0,8,0,343,92,22004,26924,24949,7,36,14,1,0,1,0,3,363,96,28842,32458,24925,0,-20,-4,-6838,-11,-5534,24,0,0,-1,0,5
EUN1_3575559770',2,25,11,1,0,0,0,7,0,327,70,25930,29018,33114,5,46,8,0,0,0,0,2,320,58,24182,27120,23554,0,7,12,1748,3,1898,9560,1,0,0,0,5
EUN1_3575531671',5,22,10,0,1,0,0,8,0,326,101,26171,29963,29070,2,62,10,0,0,0,0,2,372,87,25574,30322,30076,0,-46,14,597,0,-359,-1006,0,1,0,0,6
EUN1_3575506568',9,44,16,1,0,1,0,11,1,349,69,28623,27987,29488,2,125,15,0,0,0,0,3,360,86,28854,29792,37646,0,-11,-17,-231,1,-1805,-8158,1,0,1,0,8
EUN1_3575455494',1,25,13,2,0,0,0,16,0,275,113,27146,27702,31709,2,20,15,0,1,3,0,4,356,90,30236,28943,29090,0,-81,23,-3090,-2,-1241,2619,2,-1,-3,0,12
EUN1_3575341517',7,31,8,1,1,1,0,8,0,308,82,24451,28771,22284,4,27,9,1,0,2,0,5,384,78,26786,28981,31989,1,-76,4,-2335,-1,-210,-9705,0,1,-1,0,3
EUN1_3566458745',5,212,17,2,0,1,0,15,1,315,112,29785,30867,33568,2,27,14,0,0,1,0,4,322,80,28013,31454,34392,1,-7,32,1772,3,-587,-824,2,0,0,0,11
EUN1_3566458118',5,34,7,2,0,1,0,12,0,345,112,26534,30275,33184,2,20,12,0,0,2,0,6,328,72,26816,28511,29506,0,17,40,-282,-5,1764,3678,2,0,-1,0,6
EUN1_3566448125',2,153,15,2,0,0,0,12,1,335,103,29127,31586,35745,2,25,17,0,0,1,0,1,348,82,29991,33305,35770,0,-13,21,-864,-2,-1719,-25,2,0,-1,0,11
EUN1_3566419996',6,28,14,1,0,0,0,7,0,356,94,28273,32296,31775,4,297,9,1,0,0,0,2,330,86,24807,29963,27018,1,26,8,3466,5,2333,4757,0,0,0,0,5
EUN1_3566402907',1,28,9,0,0,2,0,9,0,355,84,27895,29109,38814,5,319,16,1,0,1,0,9,300,80,27074,30694,32785,0,55,4,821,-7,-1585,6029,-1,0,1,0,0
EUN1_3565980183',8,412,23,1,1,1,0,9,1,365,88,33593,33903,43963,4,44,14,1,0,1,0,5,324,88,27048,28368,31771,1,41,0,6545,9,5535,12192,0,1,0,0,4
EUN1_3565964392',1,23,15,0,0,1,0,10,0,345,84,28560,29075,33058,5,26,14,2,0,1,0,3,347,88,29042,29713,31827,1,-2,-4,-482,1,-638,1231,-2,0,0,0,7
EUN1_3565953109',4,221,9,0,0,0,0,9,1,360,85,26002,29576,20877,3,29,11,1,0,1,0,4,417,66,27553,31329,32934,0,-57,19,-1551,-2,-1753,-12057,-1,0,-1,0,5
EUN1_3565925171',6,27,5,1,0,0,0,9,0,345,72,23403,27910,17685,5,30,11,1,0,2,0,1,389,108,29013,32160,28810,1,-44,-36,-5610,-6,-4250,-11125,0,0,-2,0,8
EUN1_3565837359',2,32,17,0,0,0,0,8,0,278,80,27320,26901,36918,3,235,25,1,0,1,0,0,323,100,31345,30012,40811,0,-45,-20,-4025,-8,-3111,-3893,-1,0,-1,0,8
EUN1_3565802563',2,20,11,0,0,0,0,9,0,323,86,25850,29289,29996,2,197,12,2,0,0,0,2,370,86,27086,29144,30728,0,-47,0,-1236,-1,145,-732,-2,0,0,0,7
EUN1_3564637520',7,357,13,1,0,0,0,15,0,333,86,26769,27366,36611,2,27,18,0,0,2,0,1,320,62,30384,28919,35020,1,13,24,-3615,-5,-1553,1591,1,0,-2,0,14
EUN1_3564623754',4,259,5,1,0,0,0,13,1,258,79,20848,26354,23884,7,26,17,1,0,3,0,0,403,96,32435,33429,34291,0,-145,-17,-11587,-12,-7075,-10407,0,0,-3,0,13
EUN1_3564612589',4,24,15,2,0,1,0,9,1,434,95,30833,31957,42479,3,25,6,0,0,1,0,6,345,72,24487,26916,29522,1,89,23,6346,9,5041,12957,2,0,0,0,3
EUN1_3564586792',2,362,18,1,0,1,0,15,1,298,94,29208,28405,33791,5,30,19,1,1,3,0,4,360,82,33919,31102,40086,0,-62,12,-4711,-1,-2697,-6295,0,-1,-2,0,11
EUN1_3564559451',4,212,16,2,0,0,0,11,0,333,92,29398,31743,36535,3,25,12,0,0,3,0,2,346,75,28174,29053,34335,1,-13,17,1224,4,2690,2200,2,0,-3,0,9
EUN1_3564128609',4,52,14,1,0,1,0,5,0,344,91,28301,29124,36811,2,28,14,0,0,0,0,4,344,72,26916,29012,29863,1,0,19,1385,0,112,6948,1,0,1,0,1
EUN1_3564103025',4,240,20,1,1,3,0,3,1,365,100,32913,32004,40321,2,24,9,1,0,0,0,11,292,75,23477,26119,28847,1,73,25,9436,11,5885,11474,0,1,3,0,-8
EUN1_3570791192',5,29,11,0,0,0,0,9,0,356,68,25215,29794,30915,5,24,8,1,0,1,0,3,361,80,26108,29867,34350,0,-5,-12,-893,3,-73,-3435,-1,0,-1,0,6
EUN1_3570754709',2,28,8,0,0,1,0,7,1,359,81,25667,30071,29834,5,25,6,0,0,0,0,1,342,77,23213,27962,23400,1,17,4,2454,2,2109,6434,0,0,1,0,6
EUN1_3569862073',2,29,4,1,0,1,0,8,1,400,76,24996,27975,20742,4,28,7,1,0,0,0,3,387,92,24967,30384,20385,1,13,-16,29,-3,-2409,357,0,0,1,0,5
EUN1_3569822728',3,34,14,2,0,0,0,2,1,361,76,27791,29888,36333,5,31,13,0,0,1,0,3,319,86,26489,28519,29702,1,42,-10,1302,1,1369,6631,2,0,-1,0,-1
EUN1_3569797101',0,23,10,0,0,1,0,7,1,389,96,27729,32202,35521,4,28,6,2,0,2,0,5,351,69,24496,29964,24584,0,38,27,3233,4,2238,10937,-2,0,-1,0,2
EUN1_3569759789',7,26,10,1,0,0,0,7,0,367,82,26078,29554,30827,2,42,17,0,0,1,0,1,366,86,29667,30069,35316,1,1,-4,-3589,-7,-515,-4489,1,0,-1,0,6
EUN1_3569619633',6,29,12,1,0,1,0,4,1,354,72,27018,29219,30903,2,28,4,1,0,0,0,6,329,96,23297,28979,27888,1,25,-24,3721,8,240,3015,0,0,1,0,-2
EUN1_3569521271',3,28,14,1,0,0,0,12,1,333,91,27669,28671,39821,2,33,16,1,0,1,0,3,307,71,27343,27865,34337,0,26,20,326,-2,806,5484,0,0,-1,0,9
EUN1_3569500455',4,33,10,0,0,0,0,7,1,320,76,24190,28732,30029,1,72,5,0,0,0,0,2,353,72,23206,28527,25647,1,-33,4,984,5,205,4382,0,0,0,0,5
EUN1_3569345711',4,31,11,0,0,0,0,7,0,279,67,24182,23120,25769,7,22,24,2,1,1,0,0,362,84,32265,30286,36438,1,-83,-17,-8083,-13,-7166,-10669,-2,-1,-1,0,7
EUN1_3568339310',3,30,12,2,0,1,0,13,1,359,106,28401,30663,37162,3,31,12,0,0,1,0,3,322,76,26885,27538,29733,1,37,30,1516,0,3125,7429,2,0,0,0,10
EUN1_3568315696',2,23,6,0,0,0,0,5,0,347,82,24120,27427,16340,4,33,15,2,0,0,0,3,362,86,27478,30431,31596,0,-15,-4,-3358,-9,-3004,-15256,-2,0,0,0,2
EUN1_3568294348',4,33,11,0,0,0,0,9,1,338,60,25269,28141,29387,7,207,9,2,0,1,0,3,351,100,26789,29740,29267,0,-13,-40,-1520,2,-1599,120,-2,0,-1,0,6
EUN1_3568263505',1,24,15,0,0,1,0,5,1,352,62,28497,29817,33504,3,68,13,1,0,0,0,5,339,72,26587,28177,32073,1,13,-10,1910,2,1640,1431,-1,0,1,0,0
EUN1_3568171040',6,32,10,0,0,1,0,8,1,362,70,27187,28897,29930,2,30,12,2,0,0,0,2,307,93,27210,29727,33983,1,55,-23,-23,-2,-830,-4053,-2,0,1,0,6
EUN1_3567603696',2,146,18,1,0,0,0,15,1,332,68,29536,27697,41958,3,32,13,0,1,2,0,4,325,80,28997,28822,35806,1,7,-12,539,5,-1125,6152,1,-1,-2,0,11
EUN1_3567488742',2,25,14,2,0,0,0,3,1,333,80,26593,29916,47735,0,20,12,0,0,0,0,2,311,72,25008,28674,34244,1,22,8,1585,2,1242,13491,2,0,0,0,1
EUN1_3567483592',8,37,17,0,0,0,0,6,0,259,83,27969,27194,34199,3,27,20,2,0,0,0,3,314,84,30215,29258,39243,0,-55,-1,-2246,-3,-2064,-5044,-2,0,0,0,3
EUN1_3567474568',3,26,9,1,0,0,0,11,0,379,87,25975,28315,38617,4,25,18,1,0,0,0,3,309,76,28983,31187,41320,0,70,11,-3008,-9,-2872,-2703,0,0,0,0,8
EUN1_3567468112',4,35,8,2,1,0,0,5,1,305,106,24289,28215,24584,5,28,9,0,0,0,0,1,328,65,24290,27763,27345,1,-23,41,-1,-1,452,-2761,2,1,0,0,4
EUN1_3576154462',3,25,13,0,0,1,0,6,0,350,79,27964,28420,28240,7,31,17,2,0,1,0,4,334,98,28525,29993,32928,0,16,-19,-561,-4,-1573,-4688,-2,0,0,0,2
EUN1_3576131945',6,27,12,1,0,0,0,13,1,316,95,26770,27376,30155,6,26,22,1,0,2,0,3,311,89,32289,30822,36542,1,5,6,-5519,-10,-3446,-6387,0,0,-2,0,10
EUN1_3576107040',2,31,12,1,0,0,0,16,1,313,96,28536,27054,25302,3,25,21,1,0,3,0,2,350,108,33136,30384,44819,0,-37,-12,-4600,-9,-3330,-19517,0,0,-3,0,14
EUN1_3576086955',3,18,8,1,0,0,0,13,0,321,100,25039,29188,28778,2,22,16,1,0,1,0,1,334,80,29579,29020,32255,0,-13,20,-4540,-8,168,-3477,0,0,-1,0,12
EUN1_3576073131',1,23,3,0,0,0,0,7,0,342,88,22087,27867,20110,3,28,5,1,0,0,0,1,383,95,24563,30213,18923,1,-41,-7,-2476,-2,-2346,1187,-1,0,0,0,6
EUN1_3576021701',3,31,2,0,0,0,0,6,0,368,92,22505,28258,25555,3,31,7,2,0,0,0,3,389,92,25819,30065,27536,0,-21,0,-3314,-5,-1807,-1981,-2,0,0,0,3
EUN1_3576002608',8,22,10,0,0,0,0,16,0,310,68,25637,27812,31116,2,23,21,2,0,2,0,3,354,103,33627,31763,52326,0,-44,-35,-7990,-11,-3951,-21210,-2,0,-2,0,13
EUN1_3575980307',5,29,6,0,0,0,0,9,0,368,70,23960,26542,22603,7,30,10,2,0,1,0,1,353,79,25710,26681,26698,0,15,-9,-1750,-4,-139,-4095,-2,0,-1,0,8
EUN1_3575954587',2,17,13,0,0,0,0,13,0,321,68,27307,27735,32454,4,25,18,1,1,2,0,4,382,80,31502,30587,38898,0,-61,-12,-4195,-5,-2852,-6444,-1,-1,-2,0,9
EUN1_3575910188',1,23,13,1,0,0,0,9,0,350,108,28112,30364,30401,3,24,10,1,0,1,0,4,358,91,27353,28838,29908,0,-8,17,759,3,1526,493,0,0,-1,0,5
EUN1_3575841334',5,350,8,1,0,1,0,7,1,308,80,25297,26067,28421,1,20,18,1,0,2,0,6,364,96,30012,31944,39051,0,-56,-16,-4715,-10,-5877,-10630,0,0,-1,0,1
EUN1_3575820439',5,34,11,0,0,0,0,9,0,312,86,25391,28864,28790,4,27,14,1,0,1,0,1,381,78,28433,30096,35606,0,-69,8,-3042,-3,-1232,-6816,-1,0,-1,0,8
EUN1_3575666246',2,27,11,0,0,0,0,7,1,355,88,26087,29209,28712,4,24,14,1,0,1,0,2,368,88,30005,30365,28422,0,-13,0,-3918,-3,-1156,290,-1,0,-1,0,5
EUN1_3575647667',3,29,12,0,0,0,0,8,0,329,86,26399,30651,28087,4,24,13,2,1,0,0,1,382,120,28731,31989,35118,0,-53,-34,-2332,-1,-1338,-7031,-2,-1,0,0,7
EUN1_3575623651',2,42,12,1,0,1,0,10,1,342,82,27962,28433,35245,4,28,17,0,0,2,0,4,337,82,30298,29156,35709,1,5,0,-2336,-5,-723,-464,1,0,-1,0,6
EUN1_3575606531',2,150,20,1,0,1,0,8,1,375,112,31847,31617,32656,1,25,5,0,0,0,0,2,359,98,23852,27589,28021,1,16,14,7995,15,4028,4635,1,0,1,0,6
EUN1_3575578968',5,26,11,0,0,0,0,11,0,340,102,26278,31012,31297,2,26,11,1,0,1,0,3,380,93,27645,29735,32784,1,-40,9,-1367,0,1277,-1487,-1,0,-1,0,8
EUN1_3576221426',4,34,10,0,0,0,0,7,1,375,131,27481,32039,25758,5,27,6,1,0,0,0,4,362,84,24407,30297,29128,1,13,47,3074,4,1742,-3370,-1,0,0,0,3
EUN1_3576210912',1,23,12,2,0,0,0,6,0,347,92,27154,28714,23823,3,26,9,0,0,0,0,4,354,80,25745,29633,31853,0,-7,12,1409,3,-919,-8030,2,0,0,0,2
EUN1_3576209435',4,24,9,0,0,0,0,4,0,389,62,25656,30305,27198,5,264,10,2,0,0,0,4,336,94,25313,30606,20112,0,53,-32,343,-1,-301,7086,-2,0,0,0,0
EUN1_3576081372',10,36,14,0,0,1,0,13,1,350,71,27995,28908,33995,0,25,13,1,0,1,0,3,345,100,28505,30415,34236,0,5,-29,-510,1,-1507,-241,-1,0,0,0,10
EUN1_3576054724',5,28,9,0,0,0,0,9,1,265,74,23481,24860,31521,1,526,12,2,0,1,0,1,350,78,26709,30349,32760,0,-85,-4,-3228,-3,-5489,-1239,-2,0,-1,0,8
EUN1_3575968866',1,16,15,1,0,0,0,13,1,313,71,27916,29506,39427,5,364,16,0,0,2,0,5,319,96,29073,29630,43752,1,-6,-25,-1157,-1,-124,-4325,1,0,-2,0,8
EUN1_3575938557',5,28,18,1,0,2,0,3,1,371,110,30771,32000,36726,2,17,10,0,0,0,0,5,338,62,25933,28057,32275,1,33,48,4838,8,3943,4451,1,0,2,0,-2
EUN1_3575879817',4,27,12,1,0,1,0,5,0,315,94,26697,30999,35559,3,20,12,1,0,0,0,6,325,94,26346,29672,37377,1,-10,0,351,0,1327,-1818,0,0,1,0,-1
EUN1_3575782963',5,55,21,0,0,0,0,8,1,313,80,28626,27814,44606,3,404,12,1,0,0,0,2,315,44,26374,26035,34993,0,-2,36,2252,9,1779,9613,-1,0,0,0,6
EUN1_3575719523',3,31,18,0,0,0,0,11,0,326,104,28908,29685,35008,2,31,12,2,0,0,0,2,324,76,25871,28485,28475,1,2,28,3037,6,1200,6533,-2,0,0,0,9
EUN1_3575698719',3,21,7,0,0,0,0,1,0,371,108,26419,29792,26205,5,27,8,2,1,1,0,4,349,92,25319,28945,26064,0,22,16,1100,-1,847,141,-2,-1,-1,0,-3
EUN1_3575696460',3,31,12,0,0,0,0,10,0,340,62,26937,26985,25551,3,23,13,2,0,2,0,4,344,93,28665,29637,30130,1,-4,-31,-1728,-1,-2652,-4579,-2,0,-2,0,6
EUN1_3575308268',4,20,17,2,0,2,0,5,1,389,88,31180,33519,44851,2,21,15,0,0,0,0,4,358,88,28299,33355,33556,0,31,0,2881,2,164,11295,2,0,2,0,1
EUN1_3575273497',2,24,13,0,0,0,0,9,0,314,92,28671,31073,29208,5,144,23,2,0,2,0,5,313,72,28480,30874,43547,0,1,20,191,-10,199,-14339,-2,0,-2,0,4
EUN1_3575236953',7,36,13,2,0,0,0,10,0,305,96,27213,27535,33970,3,27,17,0,0,2,0,1,329,99,29131,30761,35363,1,-24,-3,-1918,-4,-3226,-1393,2,0,-2,0,9
EUN1_3575183099',2,80,11,2,0,0,0,10,0,344,80,26475,29320,28207,0,142,14,0,0,1,0,4,345,104,28219,29293,34798,1,-1,-24,-1744,-3,27,-6591,2,0,-1,0,6
EUN1_3575152516',1,22,9,0,0,0,0,12,0,394,82,25814,30589,28881,4,32,15,2,0,1,0,3,387,110,31197,32983,31986,0,7,-28,-5383,-6,-2394,-3105,-2,0,-1,0,9
EUN1_3574975731',3,35,16,2,0,0,0,5,0,337,80,28065,30022,34793,4,47,14,0,0,0,0,4,325,73,27155,28096,41655,1,12,7,910,2,1926,-6862,2,0,0,0,1
EUN1_3574924703',4,29,13,1,0,0,0,11,1,344,94,27512,28221,36947,1,26,18,1,0,1,0,2,315,90,29209,29395,37967,1,29,4,-1697,-5,-1174,-1020,0,0,-1,0,9
EUN1_3576161170',4,25,13,1,1,0,0,6,1,358,108,27623,30854,32420,5,33,8,1,0,1,0,3,392,99,26125,30469,24731,1,-34,9,1498,5,385,7689,0,1,-1,0,3
EUN1_3576137878',5,30,14,0,0,0,0,14,1,304,76,26685,27190,30016,3,62,13,2,0,3,0,1,364,67,29053,27954,33937,1,-60,9,-2368,1,-764,-3921,-2,0,-3,0,13
EUN1_3576128290',5,28,12,2,0,0,0,6,1,337,96,25997,30690,33699,3,31,14,0,0,0,0,1,379,81,27132,30499,33841,1,-42,15,-1135,-2,191,-142,2,0,0,0,5
EUN1_3576107569',4,22,21,1,0,1,0,8,1,374,85,33405,30874,34920,0,27,11,1,0,1,0,6,285,82,25572,26050,23918,1,89,3,7833,10,4824,11002,0,0,0,0,2
EUN1_3576097195',3,24,22,0,0,0,0,6,1,358,78,31421,31374,44409,3,18,13,1,0,1,0,4,307,80,26332,27579,28174,1,51,-2,5089,9,3795,16235,-1,0,-1,0,2
EUN1_3576063019',4,47,8,2,0,0,0,11,0,341,87,23971,27566,27524,3,53,12,0,0,0,0,3,391,88,27523,29484,35641,0,-50,-1,-3552,-4,-1918,-8117,2,0,0,0,8
EUN1_3575611749',5,28,9,0,0,0,0,9,0,379,80,25534,28644,29595,6,29,18,1,0,2,0,3,364,91,30161,31544,33872,0,15,-11,-4627,-9,-2900,-4277,-1,0,-2,0,6
EUN1_3575582766',3,151,16,1,0,0,0,7,1,318,77,29286,25276,37675,0,29,27,1,0,1,0,6,298,67,32171,28721,43070,0,20,10,-2885,-11,-3445,-5395,0,0,-1,0,1
EUN1_3575565584',3,28,16,0,0,1,0,11,0,352,80,29147,29214,39825,2,48,21,1,0,1,0,3,275,79,29624,28750,38685,0,77,1,-477,-5,464,1140,-1,0,0,0,8
EUN1_3576055443',3,372,21,1,0,1,0,9,0,369,93,32749,32499,46988,6,32,14,0,0,2,0,7,293,58,25961,26612,38613,1,76,35,6788,7,5887,8375,1,0,-1,0,2
EUN1_3576016296',3,22,14,1,0,0,0,9,0,308,80,25798,26896,32274,5,24,13,1,1,1,0,4,314,84,28033,29851,33569,1,-6,-4,-2235,1,-2955,-1295,0,-1,-1,0,5
EUN1_3575897175',1,22,13,0,0,0,0,11,0,342,84,26239,29800,31409,3,29,21,2,1,1,0,2,367,103,31806,34547,41916,0,-25,-19,-5567,-8,-4747,-10507,-2,-1,-1,0,9
EUN1_3575312149',11,32,15,2,0,0,0,5,0,354,93,27477,29582,34282,1,38,19,0,0,1,0,6,308,93,29479,30215,39424,1,46,0,-2002,-4,-633,-5142,2,0,-1,0,-1
EUN1_3575276406',6,145,15,1,0,0,0,9,1,343,88,27630,31337,41508,3,32,13,0,0,1,0,2,320,67,26499,28069,30305,1,23,21,1131,2,3268,11203,1,0,-1,0,7
EUN1_3575249944',2,28,12,0,0,3,0,10,0,343,86,29701,30180,37868,7,36,16,2,0,3,0,5,368,94,30588,31842,33275,0,-25,-8,-887,-4,-1662,4593,-2,0,0,0,5
EUN1_3575080400',5,28,6,1,0,0,0,6,0,322,61,22677,27004,28067,3,23,9,1,0,0,0,2,341,102,24644,28465,32282,1,-19,-41,-1967,-3,-1461,-4215,0,0,0,0,4
EUN1_3575054748',6,28,13,2,0,0,0,11,1,327,88,28601,29292,27877,1,24,11,0,0,2,0,1,351,84,26954,30273,30677,1,-24,4,1647,2,-981,-2800,2,0,-2,0,10
EUN1_3574959489',6,26,19,0,0,0,0,6,0,321,85,28973,30502,38053,8,37,12,1,0,2,0,9,259,78,25273,26555,40805,1,62,7,3700,7,3947,-2752,-1,0,-2,0,-3
EUN1_3574927806',3,25,12,1,1,1,0,10,0,327,98,27140,29969,35295,2,19,17,1,0,0,0,5,307,70,27669,29042,38113,1,20,28,-529,-5,927,-2818,0,1,1,0,5
EUN1_3574911284',6,26,13,1,1,2,0,6,1,338,115,28239,32030,27361,2,20,11,1,0,1,0,6,350,89,26164,29426,28284,1,-12,26,2075,2,2604,-923,0,1,1,0,0
EUN1_3574828311',3,41,14,1,0,0,0,13,0,306,72,26989,29273,32175,3,26,24,0,0,2,0,2,305,76,30187,29652,32910,1,1,-4,-3198,-10,-379,-735,1,0,-2,0,11
EUN1_3574807867',3,141,1,0,0,0,0,13,0,301,87,20172,24686,30211,3,21,23,2,1,3,0,1,376,94,31961,32775,41566,0,-75,-7,-11789,-22,-8089,-11355,-2,-1,-3,0,12
EUN1_3574329931',3,22,15,1,0,1,0,12,1,293,72,27349,28023,41361,3,26,15,0,0,1,0,4,332,78,28647,29038,34316,0,-39,-6,-1298,0,-1015,7045,1,0,0,0,8
EUN1_3574313320',5,23,13,0,0,0,0,12,1,300,51,25803,27103,29567,3,30,22,2,0,1,0,4,332,87,31081,29686,43409,0,-32,-36,-5278,-9,-2583,-13842,-2,0,-1,0,8
EUN1_3574188509',5,43,11,0,0,0,0,9,1,330,86,25272,28688,30268,1,21,14,2,0,0,0,3,353,97,27433,30060,34052,0,-23,-11,-2161,-3,-1372,-3784,-2,0,0,0,6
EUN1_3574180121',3,24,9,0,0,0,0,10,1,298,97,25633,28650,26966,3,27,18,2,0,1,0,1,337,90,28967,30118,33092,0,-39,7,-3334,-9,-1468,-6126,-2,0,-1,0,9
EUN1_3574157880',3,48,24,2,1,5,0,2,1,385,135,37472,36600,34757,0,16,4,0,0,2,1,13,317,42,20845,23120,24222,1,68,93,16627,20,13480,10535,2,1,3,-1,-11
EUN1_3575934995',0,23,14,1,0,0,0,7,0,295,77,27075,26793,39793,2,22,19,0,0,2,0,2,334,86,30567,29433,38404,0,-39,-9,-3492,-5,-2640,1389,1,0,-2,0,5
EUN1_3575574932',4,27,15,0,0,0,0,10,0,362,69,27902,29809,42180,4,31,20,1,0,0,0,4,344,74,30239,30109,39704,0,18,-5,-2337,-5,-300,2476,-1,0,0,0,6
EUN1_3575554452',3,21,12,2,0,0,0,8,0,342,90,27592,29565,36660,0,26,12,0,0,1,0,4,383,89,28059,29616,34652,0,-41,1,-467,0,-51,2008,2,0,-1,0,4
EUN1_3575536457',2,24,7,1,0,0,0,15,0,298,85,23520,27187,24487,1,22,21,1,0,4,0,2,366,111,33028,32700,36670,0,-68,-26,-9508,-14,-5513,-12183,0,0,-4,0,13
EUN1_3573710818',2,67,12,0,0,1,0,9,0,358,90,26889,29244,28735,4,25,10,1,0,1,0,5,366,65,27313,27948,32957,0,-8,25,-424,2,1296,-4222,-1,0,0,0,4
EUN1_3573696614',3,27,9,0,0,0,0,9,0,361,91,27681,29420,29897,4,28,18,2,0,2,0,3,369,80,29875,31066,32903,0,-8,11,-2194,-9,-1646,-3006,-2,0,-2,0,6
EUN1_3573647412',4,25,19,2,0,1,0,10,1,328,96,30477,32799,37330,5,33,4,0,0,1,0,4,383,92,24117,29675,26160,0,-55,4,6360,15,3124,11170,2,0,0,0,6
EUN1_3572886562',3,25,14,0,0,1,0,9,0,376,74,29206,30772,30607,2,24,11,2,1,1,0,3,346,88,26828,28474,34554,1,30,-14,2378,3,2298,-3947,-2,-1,0,0,6
EUN1_3572863848',1,26,14,0,0,1,0,11,0,295,116,28225,29466,32807,1,23,20,1,0,2,0,4,358,80,30764,31139,30158,0,-63,36,-2539,-6,-1673,2649,-1,0,-1,0,7
EUN1_3572832200',1,18,15,1,0,0,0,6,1,337,80,27956,30219,32637,0,27,16,1,0,0,0,0,361,88,28668,29781,34426,1,-24,-8,-712,-1,438,-1789,0,0,0,0,6
EUN1_3572769529',2,24,16,2,0,2,0,8,0,386,86,29684,31699,32222,1,17,6,0,0,0,0,2,360,80,23957,28941,27697,1,26,6,5727,10,2758,4525,2,0,2,0,6
EUN1_3566014807',4,29,10,2,0,1,0,5,0,384,100,27727,31686,28981,1,32,4,0,0,0,0,5,339,96,23123,27386,23617,0,45,4,4604,6,4300,5364,2,0,1,0,0
EUN1_3566009952',6,28,23,1,0,2,0,7,1,332,66,31240,28372,37473,3,30,13,0,0,0,0,10,271,69,27261,26631,35930,1,61,-3,3979,10,1741,1543,1,0,2,0,-3
EUN1_3564855249',5,27,13,2,0,1,0,12,0,336,87,28171,29073,33597,2,20,11,0,0,1,0,6,343,75,27997,28213,31404,1,-7,12,174,2,860,2193,2,0,0,0,6
EUN1_3564641102',3,22,7,2,0,0,0,12,1,318,96,24517,28624,26222,6,35,13,0,0,2,0,3,383,92,29896,32085,36192,1,-65,4,-5379,-6,-3461,-9970,2,0,-2,0,9
EUN1_3564634106',3,19,10,1,0,0,0,9,0,298,70,25697,24839,32071,5,25,22,1,0,1,0,3,296,73,29912,30218,41082,0,2,-3,-4215,-12,-5379,-9011,0,0,-1,0,6
EUN1_3564616457',1,34,8,1,0,1,0,10,1,349,90,26402,27530,35479,5,19,8,0,0,1,0,4,312,74,24994,28957,30207,1,37,16,1408,0,-1427,5272,1,0,0,0,6
EUN1_3564587743',2,32,8,0,0,0,0,11,1,298,64,23436,27408,24602,2,19,10,1,0,1,0,3,367,92,27424,30243,30432,0,-69,-28,-3988,-2,-2835,-5830,-1,0,-1,0,8
EUN1_3564572304',3,19,15,0,0,1,0,13,0,338,83,29381,29957,35905,3,25,15,2,0,2,0,2,331,81,29561,28063,35057,0,7,2,-180,0,1894,848,-2,0,-1,0,11
EUN1_3564537564',3,27,19,1,0,1,0,7,1,363,90,31724,31724,42030,2,21,19,1,0,0,0,8,307,90,29420,29515,38932,0,56,0,2304,0,2209,3098,0,0,1,0,-1
EUN1_3564509486',7,27,13,1,0,0,0,8,1,310,68,26468,28470,35425,3,34,12,0,0,0,0,5,348,99,28398,30215,38439,0,-38,-31,-1930,1,-1745,-3014,1,0,0,0,3
EUN1_3564484907',4,36,19,1,0,2,0,8,1,382,80,30984,32431,37622,6,192,4,0,0,0,0,5,324,91,22830,26690,25677,1,58,-11,8154,15,5741,11945,1,0,2,0,3
EUN1_3564142689',3,25,14,2,0,2,0,7,0,374,90,31249,29488,36334,5,37,7,0,0,0,0,7,300,82,24019,26057,34390,1,74,8,7230,7,3431,1944,2,0,2,0,0
EUN1_3564130694',4,29,12,0,0,1,0,11,0,302,78,28983,26115,33971,0,34,19,1,1,1,0,8,318,102,31215,30336,34602,0,-16,-24,-2232,-7,-4221,-631,-1,-1,0,0,3
EUN1_3564115562',5,54,11,0,0,1,0,7,1,273,84,26037,28070,31911,3,65,10,2,0,0,0,3,361,83,26891,28370,35653,0,-88,1,-854,1,-300,-3742,-2,0,1,0,4
EUN1_3564103613',2,25,4,0,0,0,0,16,0,342,93,23878,27345,23398,1,33,18,1,0,3,0,2,406,87,32680,34241,30750,0,-64,6,-8802,-14,-6896,-7352,-1,0,-3,0,14
EUN1_3564083523',5,136,14,1,0,0,0,9,0,359,78,28441,29665,31057,4,46,10,1,0,0,0,4,314,77,25937,25740,34257,1,45,1,2504,4,3925,-3200,0,0,0,0,5
EUN1_3564054813',3,24,8,0,0,0,0,13,0,331,68,24845,28702,28859,3,23,24,2,0,3,0,3,404,108,34731,34345,43274,0,-73,-40,-9886,-16,-5643,-14415,-2,0,-3,0,10
EUN1_3562129764',2,52,15,0,0,1,0,7,1,341,68,28879,29064,38264,4,27,11,2,0,0,0,7,329,84,25381,28005,34272,0,12,-16,3498,4,1059,3992,-2,0,1,0,0
EUN1_3562128715',3,20,10,0,0,0,0,4,1,375,103,26428,31881,29402,1,60,8,2,0,0,0,2,327,88,25684,28467,30449,1,48,15,744,2,3414,-1047,-2,0,0,0,2
EUN1_3566364756',4,21,17,2,0,0,0,7,0,354,92,28128,30324,46213,3,38,17,0,0,0,0,2,331,75,29046,29383,35433,1,23,17,-918,0,941,10780,2,0,0,0,5
EUN1_3566338578',2,26,10,0,0,0,0,13,0,359,94,26694,28756,28718,3,25,9,1,1,2,0,3,361,86,27881,29562,28240,0,-2,8,-1187,1,-806,478,-1,-1,-2,0,10
EUN1_3565938522',5,24,13,0,0,0,0,6,1,371,92,26735,31613,32185,1,24,11,0,0,0,0,3,308,72,24174,29458,22530,1,63,20,2561,2,2155,9655,0,0,0,0,3
EUN1_3574263540',7,25,22,1,0,0,0,11,0,347,92,31247,33502,36910,0,19,9,0,0,2,0,3,321,39,25615,26197,30173,1,26,53,5632,13,7305,6737,1,0,-2,0,8
EUN1_3574135759',3,132,13,0,0,0,0,12,1,305,84,26217,28427,39431,8,26,31,1,1,3,0,4,355,76,35610,33194,51494,0,-50,8,-9393,-18,-4767,-12063,-1,-1,-3,0,8
EUN1_3574120759',2,22,15,1,0,0,0,7,1,311,86,26059,28653,31505,4,25,8,1,0,0,0,2,372,54,24352,28343,31124,1,-61,32,1707,7,310,381,0,0,0,0,5
EUN1_3573292428',1,36,8,0,0,0,0,12,0,275,79,23899,26686,22864,4,24,21,2,0,3,0,2,377,92,33332,31941,43093,0,-102,-13,-9433,-13,-5255,-20229,-2,0,-3,0,10
EUN1_3571400915',4,27,18,0,0,1,0,10,1,373,92,31945,30039,45848,4,24,12,2,0,2,0,8,353,68,28043,28103,33045,0,20,24,3902,6,1936,12803,-2,0,-1,0,2
EUN1_3570679315',5,26,19,1,0,2,0,5,1,368,86,30854,31786,33251,4,28,10,1,1,0,0,6,298,72,23655,27937,29092,1,70,14,7199,9,3849,4159,0,-1,2,0,-1
EUN1_3570659470',2,33,5,1,0,0,0,6,0,327,96,23360,28715,23386,2,20,15,1,0,0,0,2,368,85,27717,31174,31107,0,-41,11,-4357,-10,-2459,-7721,0,0,0,0,4
EUN1_3570109012',4,71,13,1,0,2,0,10,0,396,83,28914,32193,34653,2,387,9,1,0,0,0,8,348,68,25065,27888,36014,1,48,15,3849,4,4305,-1361,0,0,2,0,2
EUN1_3570093915',7,30,13,0,0,0,0,9,1,334,85,26248,31415,37639,5,24,11,0,0,1,0,3,319,78,25811,27107,37783,1,15,7,437,2,4308,-144,0,0,-1,0,6
EUN1_3570063755',3,27,12,1,0,0,0,5,0,325,60,26151,29522,33208,5,56,19,1,1,0,0,2,336,114,29258,30521,34420,1,-11,-54,-3107,-7,-999,-1212,0,-1,0,0,3
EUN1_3574508199',4,33,11,1,0,2,0,9,1,317,78,27521,27613,29962,3,49,19,1,0,1,0,9,330,76,27653,28860,39930,0,-13,2,-132,-8,-1247,-9968,0,0,1,0,0
EUN1_3574484345',3,34,10,0,0,0,0,11,1,300,80,25191,27040,40642,4,28,10,1,0,1,0,5,346,79,26905,28922,31849,1,-46,1,-1714,0,-1882,8793,-1,0,-1,0,6
EUN1_3573599921',9,32,20,2,1,0,0,11,1,315,103,29734,31758,38173,3,20,13,0,0,0,0,1,322,75,26414,28530,35082,1,-7,28,3320,7,3228,3091,2,1,0,0,10
EUN1_3573584630',5,42,18,0,0,0,0,12,1,321,96,29150,30164,36236,1,26,11,1,0,1,0,2,354,72,27323,29285,31334,1,-33,24,1827,7,879,4902,-1,0,-1,0,10
EUN1_3572709179',4,42,19,1,1,0,0,7,1,353,84,29927,31710,42037,0,379,8,1,0,1,0,7,313,80,23859,26577,31700,1,40,4,6068,11,5133,10337,0,1,-1,0,0
EUN1_3572686626',5,21,12,1,0,1,0,8,1,386,111,29827,31978,30795,3,29,5,0,0,2,0,7,382,80,24522,28922,30041,1,4,31,5305,7,3056,754,1,0,-1,0,1
EUN1_3571972309',5,42,18,0,1,0,0,4,1,327,104,29763,31271,34045,2,96,13,1,0,0,0,5,310,79,25494,27588,27039,1,17,25,4269,5,3683,7006,-1,1,0,0,-1
EUN1_3571759058',6,27,7,2,0,0,0,10,0,358,90,25148,28296,24001,4,62,11,0,0,2,0,3,388,78,29245,29918,30046,1,-30,12,-4097,-4,-1622,-6045,2,0,-2,0,7
EUN1_3571750193',4,28,15,1,1,1,0,2,1,345,93,28631,30588,39331,2,24,10,1,0,0,0,8,306,86,24668,27668,31644,1,39,7,3963,5,2920,7687,0,1,1,0,-6
EUN1_3575410006',8,25,11,0,0,0,0,8,0,313,81,26429,25844,31694,6,26,16,1,0,1,0,3,393,66,30116,29601,30676,1,-80,15,-3687,-5,-3757,1018,-1,0,-1,0,5
EUN1_3575304147',4,26,10,0,1,1,0,4,0,402,117,27841,33997,21509,1,39,8,1,0,0,0,4,402,74,24813,29216,22524,1,0,43,3028,2,4781,-1015,-1,1,1,0,0
EUN1_3575286157',2,19,9,0,0,0,0,11,0,380,78,26542,30895,31074,6,31,6,2,0,4,0,6,393,102,28259,30692,32330,0,-13,-24,-1717,3,203,-1256,-2,0,-4,0,5
EUN1_3574776467',2,22,14,1,0,0,0,9,1,313,96,26556,29864,31002,2,27,14,0,0,1,0,2,364,95,29376,30930,33211,0,-51,1,-2820,0,-1066,-2209,1,0,-1,0,7
EUN1_3574707646',5,29,14,1,0,1,0,4,1,348,97,28860,29605,32399,0,24,15,1,0,0,0,4,292,81,26965,28513,34188,0,56,16,1895,-1,1092,-1789,0,0,1,0,0
EUN1_3574691436',6,21,18,1,0,1,0,8,1,326,82,30103,28636,34296,5,26,13,1,0,0,0,4,297,109,25862,27945,32087,0,29,-27,4241,5,691,2209,0,0,1,0,4
EUN1_3574137253',8,266,17,1,0,1,0,7,1,365,84,29130,30240,34268,5,26,11,0,0,0,0,4,335,88,26843,28161,26320,1,30,-4,2287,6,2079,7948,1,0,1,0,3
EUN1_3573627054',7,36,11,1,1,1,0,6,1,359,76,28011,28146,34712,3,27,15,1,0,0,0,7,297,96,26512,28680,34191,0,62,-20,1499,-4,-534,521,0,1,1,0,-1
EUN1_3573569816',5,33,11,1,0,2,0,5,1,378,80,27328,28871,35362,0,24,10,1,1,0,0,4,354,105,26989,30339,26534,1,24,-25,339,1,-1468,8828,0,-1,2,0,1
EUN1_3568846055',0,264,13,2,0,1,0,5,0,321,60,26334,27311,32524,3,23,10,0,0,0,0,5,296,96,24401,25078,32172,0,25,-36,1933,3,2233,352,2,0,1,0,0
EUN1_3568845227',2,25,21,2,0,0,0,6,1,320,99,29727,31516,36918,0,23,8,0,0,0,0,4,343,96,26082,28021,36667,1,-23,3,3645,13,3495,251,2,0,0,0,2
EUN1_3568827341',5,25,11,1,0,0,0,10,1,320,80,24813,30177,25829,1,144,11,1,0,0,0,1,374,92,26811,30983,28808,0,-54,-12,-1998,0,-806,-2979,0,0,0,0,9
EUN1_3568816122',1,19,10,0,0,0,0,4,1,397,74,26266,29686,35913,1,29,7,1,0,0,0,5,322,80,23296,27630,27121,1,75,-6,2970,3,2056,8792,-1,0,0,0,-1
EUN1_3568783729',2,34,19,2,0,0,0,5,1,303,84,29673,28883,38661,4,26,19,0,0,0,0,2,275,68,28224,27264,40068,1,28,16,1449,0,1619,-1407,2,0,0,0,3
EUN1_3568738009',7,32,6,2,0,0,0,8,1,348,84,23472,29529,32360,5,26,9,0,1,1,0,2,349,92,26306,28796,31355,0,-1,-8,-2834,-3,733,1005,2,-1,-1,0,6
EUN1_3568491062',3,434,13,2,0,1,0,10,1,328,98,27461,29035,29891,2,25,13,0,0,1,0,5,310,84,26561,28929,26985,1,18,14,900,0,106,2906,2,0,0,0,5
EUN1_3568485777',1,15,17,2,0,0,0,7,1,343,88,29515,32261,35229,0,33,9,0,0,0,0,4,280,95,24338,27002,24853,1,63,-7,5177,8,5259,10376,2,0,0,0,3
EUN1_3568358502',2,24,13,0,0,3,0,5,1,390,76,30321,32624,26792,2,17,8,1,0,1,0,5,322,94,24057,28861,24292,1,68,-18,6264,5,3763,2500,-1,0,2,0,0
EUN1_3568345290',5,25,15,1,0,0,0,12,1,337,68,28083,27217,37644,4,393,20,1,0,2,0,1,337,92,31096,30133,43661,0,0,-24,-3013,-5,-2916,-6017,0,0,-2,0,11
EUN1_3568319383',5,28,19,1,0,0,0,5,1,342,92,29524,32166,42884,2,143,9,1,0,0,0,3,310,88,25074,28455,27745,1,32,4,4450,10,3711,15139,0,0,0,0,2
EUN1_3568293588',6,28,10,1,0,2,0,6,1,338,90,26712,27739,28356,2,29,10,0,0,0,0,8,310,78,24451,27546,33160,0,28,12,2261,0,193,-4804,1,0,2,0,-2
EUN1_3568275202',0,22,9,0,0,1,0,5,1,372,86,27388,29793,28669,4,17,11,1,0,0,0,6,347,82,25700,29815,30853,1,25,4,1688,-2,-22,-2184,-1,0,1,0,-1
EUN1_3568121340',6,25,11,2,0,2,0,5,1,365,106,28905,29245,28797,4,65,9,0,0,0,0,6,303,82,23842,27602,29239,1,62,24,5063,2,1643,-442,2,0,2,0,-1
EUN1_3568096963',4,42,16,1,1,2,0,3,1,349,89,29562,31406,39394,1,19,6,0,0,0,0,7,349,90,25191,27918,30478,0,0,-1,4371,10,3488,8916,1,1,2,0,-4
EUN1_3568090508',1,28,9,1,0,0,0,9,0,313,74,24640,26961,28773,2,86,24,1,0,2,0,3,328,89,31741,32006,39344,0,-15,-15,-7101,-15,-5045,-10571,0,0,-2,0,6
EUN1_3568060504',5,278,13,1,0,0,0,9,0,300,76,25287,28815,31752,2,24,13,1,0,0,0,0,339,86,27279,29798,34130,0,-39,-10,-1992,0,-983,-2378,0,0,0,0,9
EUN1_3568055084',4,26,11,0,0,1,0,9,0,394,88,27978,30420,29189,3,25,9,1,0,1,0,4,308,92,26123,29978,27783,1,86,-4,1855,2,442,1406,-1,0,0,0,5
EUN1_3568040385',4,129,13,0,0,0,0,9,0,330,58,26774,29013,31079,3,40,20,1,1,1,0,4,395,90,31479,31474,47691,0,-65,-32,-4705,-7,-2461,-16612,-1,-1,-1,0,5
EUN1_3567906718',3,26,14,1,0,1,0,6,1,359,77,29924,28830,30246,2,26,14,0,0,2,0,6,354,70,27926,29388,33594,1,5,7,1998,0,-558,-3348,1,0,-1,0,0
EUN1_3574746521',1,22,10,0,0,0,0,10,1,304,94,24649,27801,25176,7,30,16,2,0,3,0,3,376,78,30351,32847,27681,0,-72,16,-5702,-6,-5046,-2505,-2,0,-3,0,7
EUN1_3574727935',3,23,9,0,0,0,0,14,0,366,82,26249,28627,28171,3,261,19,2,0,2,0,3,375,78,31798,31652,38274,0,-9,4,-5549,-10,-3025,-10103,-2,0,-2,0,11
EUN1_3574146545',2,43,13,0,0,0,0,6,1,333,99,26194,30108,32478,1,27,5,1,0,1,0,5,363,65,23809,27978,30549,1,-30,34,2385,8,2130,1929,-1,0,-1,0,1
EUN1_3573726151',1,21,8,1,1,0,0,4,0,378,80,25513,30047,25150,3,31,11,1,0,0,0,1,326,88,26117,31550,29354,1,52,-8,-604,-3,-1503,-4204,0,1,0,0,3
EUN1_3573699767',6,34,21,2,1,4,0,9,1,304,108,32386,30761,35030,0,22,7,0,0,1,0,11,323,91,26129,27933,27801,1,-19,17,6257,14,2828,7229,2,1,3,0,-2
EUN1_3573606745',2,83,9,1,0,0,0,16,0,258,92,23493,24870,29166,3,24,22,1,0,4,0,0,335,88,31502,30742,41279,1,-77,4,-8009,-13,-5872,-12113,0,0,-4,0,16
EUN1_3573589491',5,31,13,1,0,0,0,11,0,333,85,27030,30937,37083,0,19,14,1,0,0,0,2,321,82,27657,29233,29056,0,12,3,-627,-1,1704,8027,0,0,0,0,9
EUN1_3573178887',1,20,6,0,0,0,0,14,0,324,90,24267,28416,24110,2,26,12,1,0,2,0,4,378,84,28344,31625,30397,0,-54,6,-4077,-6,-3209,-6287,-1,0,-2,0,10
EUN1_3573169574',4,42,23,2,0,1,0,8,1,350,102,33556,31859,42774,1,21,9,0,0,2,0,6,273,77,24338,26678,25629,1,77,25,9218,14,5181,17145,2,0,-1,0,2
EUN1_3573138051',4,30,10,0,0,0,0,5,0,343,68,25106,29692,24682,6,23,13,2,0,0,0,0,359,81,26910,29968,29100,0,-16,-13,-1804,-3,-276,-4418,-2,0,0,0,5
EUN1_3572599781',3,23,13,2,0,1,0,7,0,339,74,28060,29318,39398,5,265,16,0,0,1,0,7,366,81,28851,30568,35216,1,-27,-7,-791,-3,-1250,4182,2,0,0,0,0
EUN1_3570793723',0,28,15,0,0,1,0,9,0,350,82,27145,28258,38939,5,34,12,1,0,2,0,4,334,74,28203,26375,33077,0,16,8,-1058,3,1883,5862,-1,0,-1,0,5
EUN1_3570770925',3,23,6,0,0,0,0,15,1,335,78,23536,27104,25652,4,25,19,2,0,2,0,0,382,88,30894,31873,35697,0,-47,-10,-7358,-13,-4769,-10045,-2,0,-2,0,15
EUN1_3570071550',3,26,11,0,0,0,0,6,1,328,93,26158,26244,32203,6,28,14,2,0,1,0,2,316,106,27851,30351,35681,0,12,-13,-1693,-3,-4107,-3478,-2,0,-1,0,4
EUN1_3570026786',1,21,9,1,0,0,0,6,1,372,90,26136,29341,26712,3,22,11,1,0,2,0,5,372,116,27389,32369,32994,0,0,-26,-1253,-2,-3028,-6282,0,0,-2,0,1
EUN1_3568579813',5,32,16,0,0,0,0,8,1,361,88,29881,32124,40012,4,26,11,1,0,1,0,5,335,84,26826,29429,39939,1,26,4,3055,5,2695,73,-1,0,-1,0,3
EUN1_3565180131',3,317,9,0,0,0,0,7,0,377,72,25846,30196,27983,3,26,10,2,0,0,0,4,340,90,25921,29621,25113,0,37,-18,-75,-1,575,2870,-2,0,0,0,3
EUN1_3565167490',3,21,7,0,1,0,0,4,0,376,108,25319,31221,27534,3,24,9,2,0,0,0,2,316,96,24671,28436,30048,1,60,12,648,-2,2785,-2514,-2,1,0,0,2
EUN1_3565147885',2,22,17,2,0,1,0,10,1,359,98,29146,32297,34393,2,24,8,0,1,0,0,1,325,85,25001,27048,32169,1,34,13,4145,9,5249,2224,2,-1,1,0,9
EUN1_3564322786',4,30,5,2,0,0,0,8,0,353,96,23470,28921,28513,2,26,13,0,0,0,0,1,341,96,27997,30917,32912,0,12,0,-4527,-8,-1996,-4399,2,0,0,0,7
EUN1_3564311349',2,31,13,1,0,2,0,8,0,362,96,30312,30244,29850,0,24,10,0,0,0,0,7,321,70,25651,25984,32615,1,41,26,4661,3,4260,-2765,1,0,2,0,1
EUN1_3576243196',3,26,22,0,0,1,0,15,0,308,78,31665,29417,42285,7,38,23,1,0,4,0,3,322,84,34471,30504,42869,0,-14,-6,-2806,-1,-1087,-584,-1,0,-3,0,12
EUN1_3576219695',2,24,11,0,0,2,0,6,1,384,91,28913,30055,30667,2,29,11,1,0,0,0,4,361,104,25739,29495,30075,1,23,-13,3174,0,560,592,-1,0,2,0,2
EUN1_3576221232',2,28,12,0,0,0,0,7,1,328,74,25706,29746,35639,5,24,15,1,0,2,0,1,372,98,28599,30458,30338,0,-44,-24,-2893,-3,-712,5301,-1,0,-2,0,6
EUN1_3576134278',1,53,18,2,0,1,0,6,1,320,112,30290,31591,38987,4,28,14,0,0,0,0,5,342,64,26791,28499,35045,1,-22,48,3499,4,3092,3942,2,0,1,0,1
EUN1_3576081951',3,25,10,2,0,0,0,7,0,375,71,26141,29916,34223,2,28,10,0,0,1,0,4,383,100,27290,30077,26277,0,-8,-29,-1149,0,-161,7946,2,0,-1,0,3
EUN1_3576061962',3,23,5,0,0,0,0,16,0,334,92,22867,27786,24520,2,22,16,2,0,4,0,2,381,108,32250,32016,36502,0,-47,-16,-9383,-11,-4230,-11982,-2,0,-4,0,14
EUN1_3576028808',7,35,10,2,1,1,0,9,0,367,92,27817,29018,28979,1,19,8,0,0,2,0,7,346,92,25419,28820,34687,0,21,0,2398,2,198,-5708,2,1,-1,0,2
EUN1_3575994060',6,118,20,2,1,2,0,7,0,344,94,31158,31777,39952,3,24,9,0,0,0,0,8,326,90,25423,28734,26976,1,18,4,5735,11,3043,12976,2,1,2,0,-1
EUN1_3575972955',3,22,19,2,0,1,0,7,0,374,105,29690,32315,38763,6,28,7,0,0,0,0,5,334,77,23602,28099,29173,1,40,28,6088,12,4216,9590,2,0,1,0,2
EUN1_3575662460',1,23,19,0,0,0,0,12,0,343,68,30517,29351,37720,5,20,17,1,0,2,0,4,341,74,29149,28811,33434,1,2,-6,1368,2,540,4286,-1,0,-2,0,8
EUN1_3575647877',3,21,11,2,0,1,0,14,1,328,70,26101,28380,30071,5,34,18,0,0,2,0,4,376,114,31933,33193,38381,1,-48,-44,-5832,-7,-4813,-8310,2,0,-1,0,10
EUN1_3575633950',7,30,11,2,0,0,0,7,1,362,84,26458,31286,34328,1,23,8,0,0,0,0,3,371,90,25268,29892,27928,1,-9,-6,1190,3,1394,6400,2,0,0,0,4
EUN1_3575618896',4,30,9,2,0,0,0,14,1,373,123,26764,31201,25787,4,24,3,0,0,1,0,1,385,100,24803,27686,18766,1,-12,23,1961,6,3515,7021,2,0,-1,0,13
EUN1_3575233139',4,31,11,0,0,0,0,14,1,360,64,26529,29098,34255,2,27,14,1,0,3,0,3,350,92,29093,30900,34181,1,10,-28,-2564,-3,-1802,74,-1,0,-3,0,11
EUN1_3575083743',2,21,10,0,0,0,0,8,0,412,92,28349,30507,25813,5,48,15,2,1,0,0,5,370,96,29154,30492,32566,1,42,-4,-805,-5,15,-6753,-2,-1,0,0,3
EUN1_3575075375',4,24,13,0,0,1,0,7,0,417,88,30558,33068,42078,5,27,12,2,0,0,0,9,357,120,28802,30297,31235,0,60,-32,1756,1,2771,10843,-2,0,1,0,-2
EUN1_3575033797',3,43,16,1,0,0,0,14,0,355,70,26987,28208,32445,1,20,20,1,0,1,0,3,380,118,32073,33282,40073,0,-25,-48,-5086,-4,-5074,-7628,0,0,-1,0,11
EUN1_3576094926',2,25,17,1,0,2,0,6,1,397,80,30156,31727,32610,3,34,5,1,0,0,0,8,349,95,24076,28234,18994,0,48,-15,6080,12,3493,13616,0,0,2,0,-2
EUN1_3572218941',5,29,15,2,0,1,0,4,1,403,96,30635,33374,38717,3,25,4,0,0,1,0,8,346,85,22744,28762,19430,1,57,11,7891,11,4612,19287,2,0,0,0,-4
EUN1_3572181982',2,24,24,0,0,3,0,5,0,348,60,33693,29275,38129,5,84,17,1,1,0,0,10,322,69,28769,27452,37793,1,26,-9,4924,7,1823,336,-1,-1,3,0,-5
EUN1_3572160268',2,25,8,0,0,0,0,8,1,367,73,25100,28740,27272,4,137,13,2,0,1,0,3,411,95,29607,32277,33166,0,-44,-22,-4507,-5,-3537,-5894,-2,0,-1,0,5
EUN1_3571617751',1,18,19,1,0,2,0,11,1,305,78,30854,29669,39990,5,31,23,0,0,3,0,5,354,98,33323,33423,44218,0,-49,-20,-2469,-4,-3754,-4228,1,0,-1,0,6
EUN1_3571470082',4,31,18,0,0,0,0,9,1,338,83,29622,28926,33067,5,25,18,2,0,2,0,5,359,88,31147,31063,33498,0,-21,-5,-1525,0,-2137,-431,-2,0,-2,0,4
EUN1_3570517211',1,37,19,0,1,1,0,7,1,355,105,29959,31420,34519,3,30,7,1,0,0,0,4,306,88,24104,26786,30110,0,49,17,5855,12,4634,4409,-1,1,1,0,3
EUN1_3569029257',0,38,12,2,0,1,0,11,0,334,88,27377,29401,33635,3,16,13,0,0,0,0,5,284,87,25777,26902,33974,0,50,1,1600,-1,2499,-339,2,0,1,0,6
EUN1_3569010139',3,144,20,0,0,1,0,7,1,358,100,32115,33724,36999,3,38,14,2,0,1,0,7,324,64,26682,28336,38381,1,34,36,5433,6,5388,-1382,-2,0,0,0,0
EUN1_3568277790',2,26,9,0,0,0,0,9,0,337,87,25414,31019,28914,8,170,11,2,0,1,0,0,389,104,28183,30274,35028,0,-52,-17,-2769,-2,745,-6114,-2,0,-1,0,9
EUN1_3573581958',1,23,11,0,0,0,0,5,1,348,88,26839,29393,30563,5,33,17,1,0,0,0,1,329,72,27810,30620,35634,0,19,16,-971,-6,-1227,-5071,-1,0,0,0,4
EUN1_3571978068',4,29,14,0,0,1,0,9,0,330,102,28154,31409,29337,3,25,16,2,0,1,0,0,415,102,31646,32717,36235,0,-85,0,-3492,-2,-1308,-6898,-2,0,0,0,9
EUN1_3569980937',2,26,6,0,0,0,0,11,0,326,96,23502,27767,18090,2,142,12,1,0,2,0,0,359,92,28765,28850,29368,0,-33,4,-5263,-6,-1083,-11278,-1,0,-2,0,11
EUN1_3569570854',2,30,15,0,0,0,0,8,0,360,73,27584,30478,36791,1,22,11,1,0,1,0,3,340,106,27356,28173,35069,1,20,-33,228,4,2305,1722,-1,0,-1,0,5
EUN1_3569524774',3,26,13,2,0,1,0,9,1,382,102,28892,30301,27797,4,23,9,0,0,0,0,3,319,110,26296,30947,27338,1,63,-8,2596,4,-646,459,2,0,1,0,6
EUN1_3569518421',1,29,8,1,0,0,0,9,0,373,78,24269,28320,24392,5,34,8,1,0,2,0,1,386,82,26516,31100,26742,1,-13,-4,-2247,0,-2780,-2350,0,0,-2,0,8
EUN1_3569496881',4,32,16,2,0,2,0,7,1,375,83,29516,31892,29490,1,16,8,0,0,0,0,9,307,100,24061,27312,26629,1,68,-17,5455,8,4580,2861,2,0,2,0,-2
EUN1_3569454320',2,27,13,0,0,1,0,5,1,398,80,28829,28744,35694,5,200,17,2,0,0,0,4,362,79,29499,31369,32376,0,36,1,-670,-4,-2625,3318,-2,0,1,0,1
EUN1_3569442567',7,29,21,1,0,2,0,9,1,352,94,32421,30702,37927,3,25,5,0,0,0,0,8,327,77,24091,25993,30066,1,25,17,8330,16,4709,7861,1,0,2,0,1
EUN1_3569168530',3,18,11,0,0,0,0,6,0,331,96,26151,29743,29890,2,29,10,2,1,1,0,6,313,96,25878,30931,31984,0,18,0,273,1,-1188,-2094,-2,-1,-1,0,0
EUN1_3569133613',2,22,10,0,0,0,0,10,0,339,84,24367,28382,28147,2,27,14,1,0,1,0,1,347,100,28236,31156,32279,1,-8,-16,-3869,-4,-2774,-4132,-1,0,-1,0,9
EUN1_3569000246',4,38,14,0,0,3,0,6,1,342,84,30197,27592,33604,3,25,15,2,0,0,0,10,273,88,26331,26188,35791,1,69,-4,3866,-1,1404,-2187,-2,0,3,0,-4
EUN1_3568972999',1,21,12,1,0,0,0,10,1,376,107,29895,30006,33699,3,29,14,1,0,1,0,4,311,96,26846,28282,28396,0,65,11,3049,-2,1724,5303,0,0,-1,0,6
EUN1_3568961341',4,26,7,0,0,0,0,10,0,352,82,24325,28916,29442,7,38,18,2,0,1,0,4,313,102,28965,31979,39486,0,39,-20,-4640,-11,-3063,-10044,-2,0,-1,0,6
EUN1_3568914350',6,251,13,2,0,0,0,14,0,333,96,26875,29135,32492,3,26,20,0,0,2,0,2,342,76,30960,30842,44466,0,-9,20,-4085,-7,-1707,-11974,2,0,-2,0,12
EUN1_3568908074',6,140,7,0,0,0,0,6,0,345,94,24109,27881,26195,2,33,15,1,0,1,0,0,323,74,27363,29433,31687,0,22,20,-3254,-8,-1552,-5492,-1,0,-1,0,6
EUN1_3568694137',2,26,26,0,0,2,0,9,1,346,92,32961,32001,44112,3,133,10,1,0,0,0,4,333,84,25825,28268,31724,1,13,8,7136,16,3733,12388,-1,0,2,0,5
EUN1_3568643718',2,35,14,1,0,0,0,4,1,373,80,28287,30082,34501,2,67,11,0,0,0,0,4,341,88,26533,27627,25334,1,32,-8,1754,3,2455,9167,1,0,0,0,0
EUN1_3568253899',2,22,9,1,0,0,0,8,1,343,70,25665,28069,28243,3,28,8,1,0,1,0,5,351,84,26488,29411,28022,1,-8,-14,-823,1,-1342,221,0,0,-1,0,3
EUN1_3575934390',6,21,11,1,0,0,0,14,0,340,76,25468,29058,29682,8,28,13,1,0,2,0,3,333,104,29842,30776,33659,1,7,-28,-4374,-2,-1718,-3977,0,0,-2,0,11
EUN1_3575838962',3,33,11,1,0,0,0,9,0,369,86,26794,29088,32147,4,106,13,1,0,0,0,4,374,72,27691,30766,38030,0,-5,14,-897,-2,-1678,-5883,0,0,0,0,5
EUN1_3575783413',5,29,17,0,0,0,0,11,0,304,69,28257,29874,36631,4,27,16,1,0,1,0,3,358,88,30325,30441,39571,0,-54,-19,-2068,1,-567,-2940,-1,0,-1,0,8
EUN1_3575712069',3,18,12,0,0,0,0,11,0,313,72,27218,27855,33930,1,29,23,1,0,2,0,3,310,84,31446,29899,37565,0,3,-12,-4228,-11,-2044,-3635,-1,0,-2,0,8
EUN1_3575568669',2,23,16,1,0,1,0,6,0,330,88,29228,30904,40947,3,27,8,0,0,0,0,8,383,84,25266,29276,31444,1,-53,4,3962,8,1628,9503,1,0,1,0,-2
EUN1_3575399956',2,146,16,2,0,1,0,5,1,329,71,28571,28561,35713,2,49,17,0,0,1,0,5,287,94,28733,28124,33902,1,42,-23,-162,-1,437,1811,2,0,0,0,0
EUN1_3575383312',3,23,12,1,0,0,0,10,1,310,84,27377,29263,34285,1,277,12,1,0,0,0,5,336,82,26044,29672,32805,0,-26,2,1333,0,-409,1480,0,0,0,0,5
EUN1_3575305264',2,21,9,1,0,0,0,7,0,309,97,26462,27240,33306,2,28,16,1,0,2,0,3,318,74,26906,29897,31175,0,-9,23,-444,-7,-2657,2131,0,0,-2,0,4
EUN1_3575200575',3,28,14,2,1,1,0,6,1,357,88,29491,30123,37603,0,18,10,0,0,1,0,8,299,72,25340,27733,24335,1,58,16,4151,4,2390,13268,2,1,0,0,-2
EUN1_3574932947',4,33,14,2,0,0,0,8,0,305,88,26021,27800,29608,0,27,16,0,0,1,0,1,345,70,29142,29512,36543,1,-40,18,-3121,-2,-1712,-6935,2,0,-1,0,7
EUN1_3574904680',3,132,10,0,0,0,0,12,0,313,76,25209,28759,22902,1,30,11,2,0,1,0,0,362,92,27020,29395,31798,1,-49,-16,-1811,-1,-636,-8896,-2,0,-1,0,12
EUN1_3574736911',3,23,21,2,0,1,0,7,0,350,78,31141,30489,40712,3,24,8,0,0,0,0,4,259,79,24366,26457,26261,1,91,-1,6775,13,4032,14451,2,0,1,0,3
EUN1_3574163908',2,29,12,1,0,1,0,12,0,297,74,27017,27294,33090,5,30,22,1,0,1,0,3,344,89,31750,31381,36381,0,-47,-15,-4733,-10,-4087,-3291,0,0,0,0,9
EUN1_3574146697',6,29,12,1,0,0,0,11,0,299,90,25382,27967,29944,3,137,17,1,1,1,0,0,309,90,29013,29707,32001,0,-10,0,-3631,-5,-1740,-2057,0,-1,-1,0,11
EUN1_3574129955',6,27,17,0,0,0,0,7,1,320,70,27887,30042,35479,8,54,11,1,0,1,0,6,294,95,26292,30225,35719,0,26,-25,1595,6,-183,-240,-1,0,-1,0,1
EUN1_3573578282',4,28,7,0,0,0,0,11,0,312,83,23902,27284,24806,3,24,17,1,0,0,0,1,362,96,29017,30679,37508,0,-50,-13,-5115,-10,-3395,-12702,-1,0,0,0,10
EUN1_3573554857',5,34,8,1,0,0,0,6,0,370,93,25654,29752,27510,4,27,9,0,0,0,0,3,341,80,24471,29096,26497,1,29,13,1183,-1,656,1013,1,0,0,0,3
EUN1_3573553128',1,27,12,1,1,1,0,8,0,337,92,28049,28777,34319,2,22,5,0,0,0,0,5,282,72,22396,25531,27761,1,55,20,5653,7,3246,6558,1,1,1,0,3
EUN1_3573451413',3,27,16,0,0,0,0,6,1,376,86,28349,32187,39343,2,21,7,0,0,0,0,1,290,102,23930,29286,28102,1,86,-16,4419,9,2901,11241,0,0,0,0,5
EUN1_3573539450',3,12,11,1,0,0,0,6,1,379,84,26841,30042,25941,3,24,11,1,1,0,0,1,354,117,27269,31053,27746,0,25,-33,-428,0,-1011,-1805,0,-1,0,0,5
EUN1_3572635996',3,25,12,0,0,0,0,7,0,367,102,27287,30760,26225,4,26,15,1,0,0,0,4,335,74,27448,29762,32815,0,32,28,-161,-3,998,-6590,-1,0,0,0,3
EUN1_3572113172',2,200,16,0,0,2,0,8,0,343,92,29794,30024,39169,3,92,12,2,1,1,0,6,303,72,26554,26923,28904,0,40,20,3240,4,3101,10265,-2,-1,1,0,2
EUN1_3571648171',0,20,11,0,0,1,0,11,0,323,102,27394,30245,28552,1,139,14,2,1,1,0,6,312,106,27694,30792,29514,0,11,-4,-300,-3,-547,-962,-2,-1,0,0,5
EUN1_3570909098',6,31,19,1,0,2,0,4,1,339,88,29447,28431,38589,2,139,12,0,0,0,0,3,323,20,23987,25976,29032,1,16,68,5460,7,2455,9557,1,0,2,0,1
EUN1_3570861734',0,38,6,0,0,1,0,9,0,348,88,24584,29052,27021,4,154,11,2,0,0,0,1,338,80,24545,28083,26172,0,10,8,39,-5,969,849,-2,0,1,0,8
EUN1_3570795195',4,28,14,2,1,1,0,5,1,391,100,31112,31557,30161,4,19,3,0,0,1,0,10,374,96,23407,29076,24714,1,17,4,7705,11,2481,5447,2,1,0,0,-5
EUN1_3570771669',1,25,5,0,0,0,0,12,1,316,88,22162,26077,32258,2,32,18,2,0,2,0,0,391,100,32219,32135,38385,0,-75,-12,-10057,-13,-6058,-6127,-2,0,-2,0,12
EUN1_3570756447',2,24,11,1,0,1,0,4,1,412,82,27527,32132,24853,5,104,7,0,0,0,0,5,325,75,23428,28976,26239,1,87,7,4099,4,3156,-1386,1,0,1,0,-1
EUN1_3570713492',6,32,7,2,1,0,0,4,1,374,88,24490,30583,34660,4,25,3,0,0,1,0,1,377,88,23661,29476,25838,1,-3,0,829,4,1107,8822,2,1,-1,0,3
EUN1_3570640042',3,23,11,0,0,0,0,11,0,324,66,26218,27127,32176,4,25,24,2,0,1,0,4,348,92,31677,30747,45720,0,-24,-26,-5459,-13,-3620,-13544,-2,0,-1,0,7
EUN1_3570627817',1,21,6,2,0,0,0,7,0,309,85,23389,26103,30180,1,18,31,0,1,1,0,3,339,98,34378,32677,46817,0,-30,-13,-10989,-25,-6574,-16637,2,-1,-1,0,4
EUN1_3570621232',4,29,12,0,0,0,0,14,0,298,72,24924,27930,30566,3,21,15,2,0,2,0,0,377,84,30613,30895,35844,0,-79,-12,-5689,-3,-2965,-5278,-2,0,-2,0,14
EUN1_3570605488',7,29,15,0,0,0,0,7,0,353,68,27952,30468,40441,4,332,16,2,0,1,0,1,347,76,28620,29608,38011,0,6,-8,-668,-1,860,2430,-2,0,-1,0,6
EUN1_3570582609',4,27,15,2,0,1,0,7,0,324,78,28753,29548,39599,12,143,15,0,0,0,0,4,304,65,27111,27353,33700,1,20,13,1642,0,2195,5899,2,0,1,0,3
EUN1_3568034424',7,29,12,1,0,0,0,9,1,336,92,26560,29517,26590,6,27,12,1,1,0,0,0,372,88,25962,29911,27551,1,-36,4,598,0,-394,-961,0,-1,0,0,9
EUN1_3568008980',8,32,4,0,0,0,0,9,1,383,100,23131,28825,29687,3,27,11,2,0,1,0,1,366,96,27596,33759,27860,0,17,4,-4465,-7,-4934,1827,-2,0,-1,0,8
EUN1_3568008298',3,23,14,0,0,0,0,6,1,345,78,28043,29271,28237,2,16,7,1,0,1,0,8,337,94,24272,29210,16795,1,8,-16,3771,7,61,11442,-1,0,-1,0,-2
EUN1_3565108747',4,27,4,0,0,0,0,7,0,316,82,22573,27343,19472,1,38,11,0,0,0,0,3,382,104,26357,30430,27553,1,-66,-22,-3784,-7,-3087,-8081,0,0,0,0,4
EUN1_3565107450',4,23,18,1,0,0,0,9,0,329,56,28150,29836,33602,1,20,14,0,0,1,0,3,293,74,27443,28338,33416,1,36,-18,707,4,1498,186,1,0,-1,0,6
EUN1_3565107145',2,27,12,0,0,0,0,15,0,353,56,26446,29570,33086,6,173,18,2,0,4,0,0,387,108,32936,32234,36493,0,-34,-52,-6490,-6,-2664,-3407,-2,0,-4,0,15
EUN1_3564805189',6,24,16,2,1,0,0,7,0,327,68,28321,29940,32259,5,31,9,0,0,1,0,2,363,80,26747,28491,33682,0,-36,-12,1574,7,1449,-1423,2,1,-1,0,5
EUN1_3564779650',2,23,15,0,1,1,0,10,0,364,89,29255,30122,35099,2,18,16,2,0,2,0,2,372,86,31161,30884,32276,0,-8,3,-1906,-1,-762,2823,-2,1,-1,0,8
EUN1_3564754647',2,27,5,0,0,0,0,8,0,370,84,23771,28703,24010,7,28,11,2,0,0,0,3,378,93,26959,30398,30989,1,-8,-9,-3188,-6,-1695,-6979,-2,0,0,0,5
EUN1_3564488567',2,25,15,1,0,0,0,8,0,324,93,28505,30339,32646,3,21,17,0,0,1,0,2,372,74,30339,29765,39553,1,-48,19,-1834,-2,574,-6907,1,0,-1,0,6
EUN1_3564462578',5,27,10,1,0,0,0,8,1,288,90,25945,26764,25453,2,178,17,0,0,0,0,1,353,98,28509,30573,29337,0,-65,-8,-2564,-7,-3809,-3884,1,0,0,0,7
EUN1_3564431140',3,22,10,1,0,1,0,5,0,391,98,27752,30061,25203,1,25,11,1,0,0,0,6,322,93,26779,28990,28132,1,69,5,973,-1,1071,-2929,0,0,1,0,-1
EUN1_3564399511',1,16,16,2,0,0,0,7,1,377,86,29723,32420,38982,4,31,11,0,0,2,0,5,349,83,27353,29159,29114,1,28,3,2370,5,3261,9868,2,0,-2,0,2
EUN1_3564334766',1,18,7,0,0,0,0,10,0,392,84,25476,29764,26844,5,35,11,2,0,1,0,3,382,99,28251,30437,23568,0,10,-15,-2775,-4,-673,3276,-2,0,-1,0,7
EUN1_3564322123',4,31,12,0,0,0,0,13,0,372,80,26330,30194,30576,4,29,13,1,0,2,0,2,380,78,29138,29732,29988,0,-8,2,-2808,-1,462,588,-1,0,-2,0,11
EUN1_3564287009',4,27,9,1,0,0,0,4,0,383,78,25936,29746,30599,5,26,8,1,0,0,0,2,405,102,26144,29890,28268,1,-22,-24,-208,1,-144,2331,0,0,0,0,2
EUN1_3574569934',4,22,8,1,0,0,0,12,0,285,96,25119,26190,27567,7,21,18,1,0,3,0,2,337,84,29332,29218,37910,0,-52,12,-4213,-10,-3028,-10343,0,0,-3,0,10
EUN1_3574560442',8,33,9,1,0,0,0,8,0,330,86,24495,27129,24251,0,23,10,0,0,1,0,2,416,80,27689,30334,29424,0,-86,6,-3194,-1,-3205,-5173,1,0,-1,0,6
EUN1_3574543498',5,34,16,0,0,0,0,6,0,370,78,28161,31375,35996,4,33,11,1,0,0,0,3,330,58,25230,29651,27756,0,40,20,2931,5,1724,8240,-1,0,0,0,3
EUN1_3566087993',7,34,10,0,0,0,0,7,1,310,74,25278,27717,32971,6,29,7,1,0,0,0,1,352,121,25197,29601,31336,1,-42,-47,81,3,-1884,1635,-1,0,0,0,6
EUN1_3566081659',6,34,10,0,0,0,0,12,0,323,102,27464,29076,31699,2,14,22,2,1,2,0,6,362,91,31509,33091,45989,0,-39,11,-4045,-12,-4015,-14290,-2,-1,-2,0,6
EUN1_3566076292',3,29,13,0,0,1,0,8,1,293,78,26572,26312,34444,8,37,20,2,0,0,0,1,338,86,30494,31563,45578,0,-45,-8,-3922,-7,-5251,-11134,-2,0,1,0,7
EUN1_3566070130',1,144,16,2,1,0,0,3,1,356,98,28867,31579,34408,3,27,5,0,0,0,0,2,331,92,24033,28923,23766,1,25,6,4834,11,2656,10642,2,1,0,0,1
EUN1_3566063074',3,27,6,0,0,0,0,6,0,353,77,24440,28372,23573,2,26,20,2,0,0,0,2,380,110,29376,32714,39314,0,-27,-33,-4936,-14,-4342,-15741,-2,0,0,0,4
EUN1_3566042808',6,30,13,0,0,2,0,10,1,376,96,31230,32624,29268,6,40,6,1,0,1,0,6,427,114,27037,30488,25242,1,-51,-18,4193,7,2136,4026,-1,0,1,0,4
EUN1_3566040466',4,28,9,0,0,0,0,1,0,403,82,26964,32045,29179,2,28,6,2,0,1,0,3,385,100,25603,29713,28247,0,18,-18,1361,3,2332,932,-2,0,-1,0,-2
EUN1_3566026441',5,24,18,0,0,0,0,10,0,376,70,30752,31431,35846,2,20,14,1,0,1,0,3,381,64,29747,29671,34805,1,-5,6,1005,4,1760,1041,-1,0,-1,0,7
EUN1_3565622262',4,25,7,2,0,0,0,2,1,340,82,23892,28154,27829,4,123,11,0,0,0,0,3,310,90,25560,30939,32339,1,30,-8,-1668,-4,-2785,-4510,2,0,0,0,-1
EUN1_3565608504',4,25,12,2,0,0,0,11,1,345,75,25765,28816,28121,2,25,11,0,0,1,0,2,393,88,28567,29983,32459,1,-48,-13,-2802,1,-1167,-4338,2,0,-1,0,9
EUN1_3575797519',2,25,9,1,0,0,0,5,1,333,64,24866,27142,26847,3,21,19,0,0,0,0,6,336,87,27778,30152,36480,0,-3,-23,-2912,-10,-3010,-9633,1,0,0,0,-1
EUN1_3575781382',3,25,17,2,0,0,0,13,1,351,72,28885,28996,29386,2,23,9,0,0,1,0,3,311,108,26910,28502,27310,1,40,-36,1975,8,494,2076,2,0,-1,0,10
EUN1_3574857042',3,27,15,2,0,1,0,9,1,332,96,29125,30842,32656,5,30,14,0,0,0,0,5,401,108,28980,32196,32398,1,-69,-12,145,1,-1354,258,2,0,1,0,4
EUN1_3574843462',6,21,8,1,0,0,0,5,0,354,88,24973,28349,26274,2,28,13,1,0,0,0,3,372,71,26753,30954,33534,0,-18,17,-1780,-5,-2605,-7260,0,0,0,0,2
EUN1_3574826628',6,30,17,1,0,0,0,7,1,358,87,29213,32083,33964,4,26,8,1,0,1,0,5,327,88,24879,27787,24725,1,31,-1,4334,9,4296,9239,0,0,-1,0,2
EUN1_3573194671',3,27,14,2,0,0,0,6,1,361,106,27282,29947,35430,4,93,10,0,0,0,0,2,321,76,24553,28833,29730,1,40,30,2729,4,1114,5700,2,0,0,0,4
EUN1_3572630766',2,19,10,0,0,0,0,6,0,321,69,24368,27817,24340,2,20,8,2,0,0,0,2,376,111,26199,27892,28094,0,-55,-42,-1831,2,-75,-3754,-2,0,0,0,4
EUN1_3572620097',5,181,4,0,0,0,0,12,0,290,70,21554,24987,21044,2,24,20,2,0,3,0,3,396,90,32573,31889,32206,0,-106,-20,-11019,-16,-6902,-11162,-2,0,-3,0,9
EUN1_3572556997',4,20,17,2,0,2,0,6,1,343,90,28448,31362,37054,2,32,10,0,0,0,0,7,309,72,24809,27071,27742,1,34,18,3639,7,4291,9312,2,0,2,0,-1
EUN1_3572528182',2,22,14,0,0,1,0,8,1,334,82,27631,28866,45035,0,20,11,1,0,0,0,3,334,82,25701,28688,38443,1,0,0,1930,3,178,6592,-1,0,1,0,5
EUN1_3572494031',3,130,18,2,1,0,0,5,1,333,90,28938,29653,36539,3,33,11,0,0,0,0,3,313,85,25755,27490,33791,0,20,5,3183,7,2163,2748,2,1,0,0,2
EUN1_3572497102',6,48,13,2,0,0,0,8,0,335,98,26367,29971,26494,2,26,10,0,0,1,0,1,355,104,28454,30662,28268,1,-20,-6,-2087,3,-691,-1774,2,0,-1,0,7
EUN1_3572117261',3,29,13,1,0,1,0,3,1,345,68,28548,29148,35034,5,27,11,1,0,0,0,5,325,88,24491,29699,28006,0,20,-20,4057,2,-551,7028,0,0,1,0,-2
EUN1_3572092397',0,23,12,0,0,0,0,5,1,296,82,24764,28327,27321,2,29,7,2,0,0,0,2,317,88,22426,26041,20327,1,-21,-6,2338,5,2286,6994,-2,0,0,0,3
EUN1_3572024510',1,146,9,0,0,0,0,11,0,322,88,24791,28476,34103,1,21,16,2,1,2,0,1,346,96,29154,33874,38338,0,-24,-8,-4363,-7,-5398,-4235,-2,-1,-2,0,10
EUN1_3573586242',1,25,15,0,0,0,0,5,1,268,87,27543,30112,32877,4,28,11,2,0,3,0,0,362,72,25875,28067,34588,1,-94,15,1668,4,2045,-1711,-2,0,-3,0,5
EUN1_3572231295',1,23,14,0,0,2,0,6,0,312,84,28647,29509,35246,4,20,16,1,0,0,0,9,323,92,29279,30564,34451,0,-11,-8,-632,-2,-1055,795,-1,0,2,0,-3
EUN1_3564988410',6,29,16,1,0,0,0,9,1,273,84,28244,28967,36252,3,19,16,1,0,0,0,3,376,92,30106,32164,43437,1,-103,-8,-1862,0,-3197,-7185,0,0,0,0,6
EUN1_3564352340',2,22,10,1,0,0,0,9,0,391,92,27313,30630,37365,0,18,9,1,0,1,0,3,352,102,26865,28841,25039,1,39,-10,448,1,1789,12326,0,0,-1,0,6
EUN1_3564276742',2,44,15,1,0,1,0,8,0,346,104,29257,31070,33798,3,89,11,1,0,1,0,6,335,84,27688,29843,28504,0,11,20,1569,4,1227,5294,0,0,0,0,2
EUN1_3564263044',3,19,23,2,0,1,0,8,1,364,78,33239,32124,46895,8,34,7,0,0,1,0,7,316,66,23813,26207,27442,1,48,12,9426,16,5917,19453,2,0,0,0,1
EUN1_3564039755',4,23,9,0,0,0,0,4,1,345,88,25553,28514,26238,9,28,10,2,0,0,0,3,329,92,25824,28143,29922,1,16,-4,-271,-1,371,-3684,-2,0,0,0,1
EUN1_3564012485',1,20,8,0,0,1,0,11,1,346,100,26035,28611,33849,5,23,12,2,0,3,0,3,373,84,29872,30540,28788,1,-27,16,-3837,-4,-1929,5061,-2,0,-2,0,8
EUN1_3563926299',2,25,14,1,0,0,0,10,1,334,78,28374,28378,37584,6,27,17,1,1,2,0,7,335,85,28889,30816,31346,0,-1,-7,-515,-3,-2438,6238,0,-1,-2,0,3
EUN1_3563906131',0,29,10,1,0,0,0,10,0,315,102,26204,29688,25999,4,26,10,1,0,3,0,2,331,86,28510,27945,24920,0,-16,16,-2306,0,1743,1079,0,0,-3,0,8
EUN1_3563403142',2,21,15,1,0,0,0,9,1,386,90,28249,30039,28762,1,23,9,1,0,0,0,1,342,110,26056,27806,32898,1,44,-20,2193,6,2233,-4136,0,0,0,0,8
EUN1_3562742903',2,45,11,1,0,1,0,12,0,340,134,28026,31118,26340,5,22,14,1,1,1,0,3,379,70,29377,31124,31944,1,-39,64,-1351,-3,-6,-5604,0,-1,0,0,9
EUN1_3562736100',4,28,16,0,0,0,0,8,0,368,80,28858,31180,32867,8,200,19,2,0,1,0,0,357,80,30728,30457,35769,0,11,0,-1870,-3,723,-2902,-2,0,-1,0,8
EUN1_3562206833',2,49,9,1,0,1,0,3,0,389,100,28300,30979,32227,5,21,14,1,0,0,0,5,329,79,27153,31484,33730,0,60,21,1147,-5,-505,-1503,0,0,1,0,-2
EUN1_3561917595',9,55,14,2,0,2,0,9,1,372,85,30262,31172,42313,2,23,14,0,0,0,0,6,327,86,26935,29466,23541,1,45,-1,3327,0,1706,18772,2,0,2,0,3
EUN1_3561884162',4,27,11,0,0,1,0,5,0,326,60,26202,26719,27010,3,42,17,2,0,0,0,3,328,88,28156,29666,32283,0,-2,-28,-1954,-6,-2947,-5273,-2,0,1,0,2
EUN1_3561859408',4,30,20,1,0,1,0,9,1,348,89,30003,31208,38881,2,20,15,0,0,2,0,5,349,90,29457,32307,36781,0,-1,-1,546,5,-1099,2100,1,0,-1,0,4
EUN1_3561800539',4,27,15,1,0,0,0,8,1,369,105,28475,30578,32701,3,31,11,1,1,0,0,0,293,100,26369,29780,25783,1,76,5,2106,4,798,6918,0,-1,0,0,8
EUN1_3561783386',4,30,8,1,0,0,0,10,1,339,73,25043,28127,27900,5,25,10,1,0,1,0,0,337,94,26132,29311,30883,1,2,-21,-1089,-2,-1184,-2983,0,0,-1,0,10
EUN1_3561773377',3,35,5,0,0,0,0,14,0,342,90,24134,27582,23615,3,22,15,2,0,2,0,0,380,86,29699,30492,32752,0,-38,4,-5565,-10,-2910,-9137,-2,0,-2,0,14
EUN1_3576226331',4,30,14,1,0,0,0,8,0,322,92,27754,30646,34910,5,25,15,0,0,1,0,1,360,58,27851,31347,34006,1,-38,34,-97,-1,-701,904,1,0,-1,0,7
EUN1_3576096107',7,32,14,0,0,1,0,6,0,365,66,27631,30396,30025,4,29,8,1,0,1,0,4,312,94,24273,27877,23778,1,53,-28,3358,6,2519,6247,-1,0,0,0,2
EUN1_3575898199',1,17,8,1,0,0,0,8,0,329,108,24040,29334,24280,6,28,11,1,0,1,0,2,335,100,27424,29383,29781,0,-6,8,-3384,-3,-49,-5501,0,0,-1,0,6
EUN1_3575872596',2,25,16,2,0,1,0,9,0,290,78,27986,29239,33640,5,29,9,0,1,2,0,4,374,86,27402,29138,26080,0,-84,-8,584,7,101,7560,2,-1,-1,0,5
EUN1_3575843526',3,261,12,0,0,0,0,7,1,317,95,26366,29781,35804,0,24,11,1,0,2,0,1,325,100,26041,30369,32659,0,-8,-5,325,1,-588,3145,-1,0,-2,0,6
EUN1_3575824558',1,26,14,1,0,0,0,12,1,330,78,27050,28822,33969,3,66,13,1,0,1,0,5,362,74,28339,30735,33623,0,-32,4,-1289,1,-1913,346,0,0,-1,0,7
EUN1_3575765649',5,29,16,1,0,0,0,9,0,330,82,27951,30956,30991,1,22,15,1,0,1,0,4,327,98,27294,29434,34384,1,3,-16,657,1,1522,-3393,0,0,-1,0,5
EUN1_3575425526',6,50,10,1,0,0,0,7,0,355,79,26392,29122,32200,9,31,10,1,0,0,0,2,363,99,25715,30279,21439,0,-8,-20,677,0,-1157,10761,0,0,0,0,5
EUN1_3575369141',5,50,17,1,0,0,0,7,0,314,83,28744,29537,35364,3,29,9,1,0,1,0,4,341,77,25477,28943,27660,1,-27,6,3267,8,594,7704,0,0,-1,0,3
EUN1_3575341475',2,23,7,1,0,0,0,5,0,349,78,23660,29554,26987,3,27,10,1,0,0,0,2,360,88,26130,31305,23731,0,-11,-10,-2470,-3,-1751,3256,0,0,0,0,3
EUN1_3575321073',3,24,10,0,0,0,0,10,1,355,86,27044,28180,33193,5,25,18,1,0,0,0,3,342,85,29093,30651,31800,1,13,1,-2049,-8,-2471,1393,-1,0,0,0,7
EUN1_3575291680',5,26,15,1,0,0,0,15,1,318,70,27092,29292,33260,3,34,11,1,0,3,0,4,287,90,27153,28261,35044,1,31,-20,-61,4,1031,-1784,0,0,-3,0,11
EUN1_3575283184',5,36,11,0,0,0,0,11,0,378,76,25630,29594,30723,4,141,15,1,0,2,0,1,354,96,30349,31240,34616,0,24,-20,-4719,-4,-1646,-3893,-1,0,-2,0,10
EUN1_3574942907',2,17,9,1,1,2,0,6,1,408,105,28545,32104,24986,4,23,3,0,0,0,0,4,307,95,21178,25849,17071,1,101,10,7367,6,6255,7915,1,1,2,0,2
EUN1_3574928186',3,149,19,2,0,1,0,11,1,314,86,29626,28981,40237,1,23,15,0,0,1,0,6,290,71,29324,26742,33307,1,24,15,302,4,2239,6930,2,0,0,0,5
EUN1_3574902355',2,27,20,1,1,2,0,8,1,357,97,31784,33052,40659,3,31,6,1,0,0,0,6,317,62,22160,25287,24309,1,40,35,9624,14,7765,16350,0,1,2,0,2
EUN1_3574875025',4,36,16,1,1,1,0,6,1,350,100,29894,30951,31179,6,34,8,1,0,0,0,5,349,72,24400,28333,25642,1,1,28,5494,8,2618,5537,0,1,1,0,1
EUN1_3574859710',3,22,14,2,0,1,0,8,0,329,92,28245,29130,33149,3,78,13,0,0,0,0,5,321,77,26684,29626,32430,1,8,15,1561,1,-496,719,2,0,1,0,3
EUN1_3575568835',3,23,17,0,0,1,0,7,0,366,64,30157,29385,31229,3,22,16,2,0,0,0,5,337,96,28433,30165,32362,1,29,-32,1724,1,-780,-1133,-2,0,1,0,2
EUN1_3575389892',2,22,11,2,0,0,0,11,1,305,92,25509,27095,28165,3,29,18,0,0,1,0,4,358,84,29757,32047,32528,0,-53,8,-4248,-7,-4952,-4363,2,0,-1,0,7
EUN1_3575216405',1,22,14,0,0,0,0,10,1,328,91,26546,27994,32255,4,25,13,2,0,0,0,1,370,64,26860,29823,33682,1,-42,27,-314,1,-1829,-1427,-2,0,0,0,9
EUN1_3575207130',1,55,14,1,0,0,0,15,0,321,72,28135,29998,29290,2,58,19,0,1,1,0,3,337,116,31894,31692,35829,0,-16,-44,-3759,-5,-1694,-6539,1,-1,-1,0,12
EUN1_3574908346',2,24,16,1,0,0,0,7,0,390,88,30446,32684,30937,3,42,8,0,0,1,0,7,354,100,25509,28930,29628,1,36,-12,4937,8,3754,1309,1,0,-1,0,0
EUN1_3574776201',3,24,10,0,1,2,0,12,0,369,80,28545,28903,31689,5,25,17,2,0,0,0,7,318,102,28748,30702,37156,1,51,-22,-203,-7,-1799,-5467,-2,1,2,0,5
EUN1_3574688508',5,29,10,1,0,0,0,10,1,356,66,26059,28499,28760,0,30,17,1,0,1,0,3,364,110,29478,33984,40252,0,-8,-44,-3419,-7,-5485,-11492,0,0,-1,0,7
EUN1_3574669013',2,26,11,1,0,0,0,9,1,375,82,26795,30081,24251,4,21,7,1,0,0,0,2,415,98,26043,30491,23733,1,-40,-16,752,4,-410,518,0,0,0,0,7
EUN1_3574668176',5,27,10,2,0,1,0,8,1,349,111,27083,32410,28699,4,30,7,0,0,2,0,3,383,84,26705,30302,26496,1,-34,27,378,3,2108,2203,2,0,-1,0,5
EUN1_3574640570',4,129,7,0,0,0,0,6,0,345,94,24472,28462,26345,4,33,15,2,0,0,0,1,319,82,26563,27845,32074,1,26,12,-2091,-8,617,-5729,-2,0,0,0,5
EUN1_3574443407',7,42,7,1,0,0,0,6,0,353,92,23534,26972,26277,4,24,10,1,0,0,0,0,382,54,25900,28681,29750,0,-29,38,-2366,-3,-1709,-3473,0,0,0,0,6
EUN1_3574414513',2,25,9,0,0,1,0,8,1,364,85,26204,28473,30620,5,23,15,2,0,1,0,4,373,98,28196,31991,35864,1,-9,-13,-1992,-6,-3518,-5244,-2,0,0,0,4
EUN1_3574397330',4,26,16,1,0,0,0,11,0,343,74,28514,29497,33767,5,27,21,1,0,1,0,0,367,86,30908,32084,41517,0,-24,-12,-2394,-5,-2587,-7750,0,0,-1,0,11
EUN1_3574375496',4,147,13,0,0,0,0,4,0,335,95,27159,29876,35148,4,26,11,2,0,0,0,2,359,84,26425,28935,27950,1,-24,11,734,2,941,7198,-2,0,0,0,2
EUN1_3574254474',3,19,8,1,0,1,0,7,1,373,90,25847,29683,22697,9,30,6,0,0,0,0,3,360,98,24144,28861,23550,1,13,-8,1703,2,822,-853,1,0,1,0,4
EUN1_3575963047',1,36,9,0,0,1,0,8,1,364,114,27699,31787,28064,5,43,8,1,0,0,0,5,382,76,25946,29571,24858,0,-18,38,1753,1,2216,3206,-1,0,1,0,3
EUN1_3575945641',2,22,14,1,0,1,0,9,0,368,104,29698,30602,34006,6,31,9,1,0,0,0,1,372,80,25511,29436,26943,1,-4,24,4187,5,1166,7063,0,0,1,0,8
EUN1_3575920619',2,40,8,1,0,0,0,11,0,359,70,24681,28042,21789,3,28,19,1,0,1,0,3,353,128,30234,32525,33458,1,6,-58,-5553,-11,-4483,-11669,0,0,-1,0,8
EUN1_3575891972',1,41,19,0,0,0,0,9,1,344,78,30872,30020,48812,3,24,17,2,0,2,0,5,265,101,27955,30058,28383,1,79,-23,2917,2,-38,20429,-2,0,-2,0,4
EUN1_3574988520',5,25,12,0,0,0,0,13,0,338,74,25318,28730,30330,4,24,8,2,0,2,0,3,333,86,26211,26855,34230,0,5,-12,-893,4,1875,-3900,-2,0,-2,0,10
EUN1_3574966621',2,46,18,2,0,2,0,14,1,363,102,31308,32672,42558,2,24,10,0,0,0,0,6,321,78,25852,27491,34154,1,42,24,5456,8,5181,8404,2,0,2,0,8
EUN1_3574743414',4,76,8,0,0,1,0,8,0,356,80,25060,28124,26517,3,26,15,1,0,0,0,1,373,76,26986,29155,31099,1,-17,4,-1926,-7,-1031,-4582,-1,0,1,0,7
EUN1_3574724048',5,70,15,1,0,2,0,7,1,383,103,31744,33364,34302,1,26,9,1,0,1,0,11,367,67,25659,27594,26688,1,16,36,6085,6,5770,7614,0,0,1,0,-4
EUN1_3574687950',5,24,9,0,0,0,0,8,0,366,98,25908,28925,29978,5,36,9,2,1,0,0,1,409,96,26520,29673,36187,0,-43,2,-612,0,-748,-6209,-2,-1,0,0,7
EUN1_3574672869',4,31,30,1,0,1,0,8,0,301,100,32956,30575,43388,1,25,5,1,0,0,0,2,313,72,22046,24678,26539,1,-12,28,10910,25,5897,16849,0,0,1,0,6
EUN1_3574463016',4,26,17,1,0,2,0,7,1,367,88,29591,32874,30038,2,16,4,0,0,0,0,5,327,92,22829,27684,26303,1,40,-4,6762,13,5190,3735,1,0,2,0,2
EUN1_3574368979',1,25,22,1,0,2,0,6,0,334,82,32116,31479,48413,1,18,21,0,0,0,0,7,318,101,30195,31292,40954,1,16,-19,1921,1,187,7459,1,0,2,0,-1
EUN1_3574356432',2,25,14,0,0,0,0,13,0,295,60,27106,26392,33697,4,28,27,2,0,3,0,1,343,103,36562,32810,44494,0,-48,-43,-9456,-13,-6418,-10797,-2,0,-3,0,12
EUN1_3574176900',3,29,18,1,0,1,0,7,1,342,101,29194,33275,31390,1,26,10,1,0,0,0,2,328,62,25402,28098,27646,1,14,39,3792,8,5177,3744,0,0,1,0,5
EUN1_3574169292',4,61,12,2,0,1,0,7,0,341,94,27803,27956,34381,5,27,12,0,0,0,0,4,343,74,25979,27142,31824,0,-2,20,1824,0,814,2557,2,0,1,0,3
EUN1_3574153230',2,31,10,1,0,1,0,15,1,327,100,25771,28278,29580,7,25,14,0,0,2,0,1,335,64,28657,30162,32000,1,-8,36,-2886,-4,-1884,-2420,1,0,-1,0,14
EUN1_3573703187',3,27,6,2,0,1,0,10,0,351,76,23653,27467,28367,2,30,6,0,0,1,0,4,364,64,23847,28001,24979,0,-13,12,-194,0,-534,3388,2,0,0,0,6
EUN1_3573676863',2,33,18,1,0,4,0,7,1,369,91,31163,30511,35751,5,24,9,1,0,0,0,6,321,82,24049,26718,26045,1,48,9,7114,9,3793,9706,0,0,4,0,1
EUN1_3573653866',5,39,12,2,0,0,0,9,1,376,104,28054,30539,32893,1,29,11,0,0,1,0,5,333,95,26351,29255,27982,1,43,9,1703,1,1284,4911,2,0,-1,0,4
EUN1_3573642443',2,164,12,0,0,0,0,7,0,322,68,24634,25704,30360,3,23,17,1,0,1,0,3,306,88,28794,29569,39093,0,16,-20,-4160,-5,-3865,-8733,-1,0,-1,0,4
EUN1_3567274715',2,20,12,0,0,0,0,4,0,386,96,28213,30447,31803,1,24,11,2,1,0,0,7,329,96,26496,29245,26902,1,57,0,1717,1,1202,4901,-2,-1,0,0,-3
EUN1_3567241601',1,25,15,0,0,0,0,12,0,320,116,28862,30469,31915,3,25,14,2,0,1,0,2,357,72,29087,30699,33707,0,-37,44,-225,1,-230,-1792,-2,0,-1,0,10
EUN1_3567228372',3,25,19,2,0,1,0,7,1,379,98,30840,32411,43343,2,24,8,0,0,2,0,4,323,90,25830,28673,26849,1,56,8,5010,11,3738,16494,2,0,-1,0,3
EUN1_3567208522',1,19,9,1,0,0,0,7,0,349,98,26225,29627,26066,5,29,11,1,1,1,0,1,402,82,28542,30796,30579,0,-53,16,-2317,-2,-1169,-4513,0,-1,-1,0,6
EUN1_3567044251',3,24,8,1,0,0,0,7,0,349,82,24684,27868,26495,3,36,13,1,1,1,0,1,332,104,28937,30312,37794,0,17,-22,-4253,-5,-2444,-11299,0,-1,-1,0,6
EUN1_3567019032',3,26,10,1,0,0,0,11,1,326,76,26124,28254,30645,0,36,18,1,0,3,0,4,334,116,31741,30933,39955,0,-8,-40,-5617,-8,-2679,-9310,0,0,-3,0,7
EUN1_3567003663',4,26,12,1,0,0,0,16,0,333,80,26992,28945,34599,5,30,13,1,0,3,0,2,344,108,30512,29285,31750,1,-11,-28,-3520,-1,-340,2849,0,0,-3,0,14
EUN1_3566679858',2,29,11,2,0,0,0,6,0,366,98,26159,29659,32021,2,23,9,0,0,0,0,2,343,61,26209,28420,28703,1,23,37,-50,2,1239,3318,2,0,0,0,4
EUN1_3566659618',0,93,14,0,0,0,0,12,0,322,90,28846,30383,34181,3,23,21,1,0,2,0,5,376,62,31994,29943,37665,0,-54,28,-3148,-7,440,-3484,-1,0,-2,0,7
EUN1_3566635975',2,31,7,0,0,0,0,11,1,345,84,24567,28155,20201,5,29,13,2,0,1,0,1,398,103,28942,30597,26701,0,-53,-19,-4375,-6,-2442,-6500,-2,0,-1,0,10
EUN1_3566624259',4,48,14,0,0,0,0,7,0,304,84,27697,28102,33091,2,430,21,1,0,1,0,4,337,68,30494,31656,40722,1,-33,16,-2797,-7,-3554,-7631,-1,0,-1,0,3
EUN1_3566576292',4,31,6,0,0,0,0,9,0,340,72,23619,26208,21968,6,27,11,1,1,2,0,2,325,114,27926,28644,28679,0,15,-42,-4307,-5,-2436,-6711,-1,-1,-2,0,7
EUN1_3566544633',3,25,9,1,1,0,0,12,0,377,96,28548,29291,28081,4,25,17,1,0,0,0,4,353,76,28558,30969,31634,0,24,20,-10,-8,-1678,-3553,0,1,0,0,8
EUN1_3566537483',5,26,16,1,1,0,0,8,0,323,79,27881,30138,39141,4,23,14,0,0,0,0,1,317,68,27060,30185,29216,1,6,11,821,2,-47,9925,1,1,0,0,7
EUN1_3566522708',5,22,16,0,0,0,0,9,1,264,64,26909,26260,41443,1,132,21,1,0,0,0,3,305,88,29325,30133,47573,0,-41,-24,-2416,-5,-3873,-6130,-1,0,0,0,6
EUN1_3566344930',2,32,10,0,0,0,0,9,0,395,74,26669,29152,30301,2,16,12,2,0,1,0,5,315,130,28193,29716,31033,0,80,-56,-1524,-2,-564,-732,-2,0,-1,0,4
EUN1_3566315869',3,26,14,0,0,1,0,9,1,350,75,28610,30224,36220,4,24,16,1,0,0,0,4,289,88,27255,28879,31672,1,61,-13,1355,-2,1345,4548,-1,0,1,0,5
EUN1_3576015372',3,18,13,1,0,2,0,11,1,330,94,29384,28560,28377,3,175,10,1,0,1,0,5,373,78,26883,28850,27020,1,-43,16,2501,3,-290,1357,0,0,1,0,6
EUN1_3575987500',2,31,17,2,0,1,0,8,1,414,90,30649,32217,31233,4,27,7,0,0,1,0,8,349,86,25583,28089,30762,1,65,4,5066,10,4128,471,2,0,0,0,0
EUN1_3575377216',5,29,4,0,0,0,0,10,0,337,74,22506,28496,22182,2,245,13,2,0,2,0,2,393,109,29105,32652,31594,0,-56,-35,-6599,-9,-4156,-9412,-2,0,-2,0,8
EUN1_3575308445',4,26,9,1,0,0,0,10,0,335,96,25224,28356,24115,3,40,15,1,0,2,0,1,366,100,30148,31579,29534,0,-31,-4,-4924,-6,-3223,-5419,0,0,-2,0,9
EUN1_3575286410',4,28,24,0,0,1,0,6,1,300,67,29498,29696,45147,3,26,15,0,0,0,0,2,310,90,27247,29546,38871,1,-10,-23,2251,9,150,6276,0,0,1,0,4
EUN1_3575253590',3,43,12,2,0,0,0,8,0,315,110,25840,29384,27474,7,30,6,0,0,0,0,6,346,78,24196,29357,20109,1,-31,32,1644,6,27,7365,2,0,0,0,2
EUN1_3575169583',4,32,16,0,0,2,0,9,0,320,91,28146,27962,39250,3,30,17,2,1,1,0,7,282,88,29183,29808,31579,0,38,3,-1037,-1,-1846,7671,-2,-1,1,0,2
EUN1_3575000876',5,24,15,0,0,1,0,3,0,330,72,27908,29254,34514,3,20,18,1,0,1,0,5,328,95,29419,30394,31947,0,2,-23,-1511,-3,-1140,2567,-1,0,0,0,-2
EUN1_3574980005',5,25,21,2,0,1,0,9,0,340,84,33339,30331,38627,3,25,15,0,1,2,0,6,300,112,28237,26404,34063,1,40,-28,5102,6,3927,4564,2,-1,-1,0,3
EUN1_3574639468',2,31,7,1,0,0,0,4,1,366,76,24985,29137,26784,3,29,9,0,0,0,0,4,359,103,25282,29794,23548,1,7,-27,-297,-2,-657,3236,1,0,0,0,0
EUN1_3573982492',7,27,6,2,0,0,0,8,0,328,77,23340,28774,23847,4,22,12,0,0,1,0,1,346,83,26386,28584,32692,1,-18,-6,-3046,-6,190,-8845,2,0,-1,0,7
EUN1_3573948498',3,126,15,2,0,2,0,10,1,261,76,28198,27202,39636,2,25,14,0,0,1,0,10,295,108,27318,29297,29184,1,-34,-32,880,1,-2095,10452,2,0,1,0,0
EUN1_3573368873',1,27,10,0,0,1,0,12,0,363,68,27281,29570,26755,4,23,11,2,0,1,0,4,356,124,26715,31915,25189,0,7,-56,566,-1,-2345,1566,-2,0,0,0,8
EUN1_3573292534',4,46,11,1,0,0,0,2,1,356,88,26157,28027,28740,6,24,10,1,0,0,0,2,317,74,24338,26511,28496,1,39,14,1819,1,1516,244,0,0,0,0,0
EUN1_3573264805',5,29,19,1,0,2,0,9,1,362,102,30659,34268,40973,5,29,10,0,0,0,0,7,339,90,25197,28075,30998,1,23,12,5462,9,6193,9975,1,0,2,0,2
EUN1_3573227370',2,23,4,0,0,0,0,11,0,353,66,22859,27180,15917,4,24,15,2,1,2,0,0,394,110,29604,32695,27032,0,-41,-44,-6745,-11,-5515,-11115,-2,-1,-2,0,11
EUN1_3575909899',1,22,24,1,0,2,0,5,0,306,72,33282,29182,42119,8,37,15,1,0,1,0,11,335,79,28813,27567,30143,1,-29,-7,4469,9,1615,11976,0,0,1,0,-6
EUN1_3575900090',2,21,6,0,0,0,0,16,0,312,72,22887,27642,26778,7,26,18,2,0,2,0,2,380,110,31900,32408,44028,0,-68,-38,-9013,-12,-4766,-17250,-2,0,-2,0,14
EUN1_3575818088',1,12,10,0,0,0,0,13,0,310,80,24928,29234,33222,3,25,18,1,0,2,0,0,388,88,31747,32973,41727,0,-78,-8,-6819,-8,-3739,-8505,-1,0,-2,0,13
EUN1_3575785674',4,81,14,2,0,0,0,7,1,321,84,26273,31768,30989,0,42,8,0,0,1,0,4,381,81,26111,28344,31865,0,-60,3,162,6,3424,-876,2,0,-1,0,3
EUN1_3575245799',2,23,21,1,0,3,0,2,0,313,66,31628,29422,40070,1,25,12,0,0,0,0,12,322,86,26242,27724,32575,1,-9,-20,5386,9,1698,7495,1,0,3,0,-10
EUN1_3575194203',4,27,8,1,0,0,0,7,1,343,68,24353,28515,21009,1,92,8,0,0,0,0,1,342,88,24830,28376,22925,1,1,-20,-477,0,139,-1916,1,0,0,0,6
EUN1_3575179361',3,27,10,0,0,0,0,14,0,317,92,25934,28224,24603,6,36,17,2,0,2,0,1,382,88,31299,32033,34935,1,-65,4,-5365,-7,-3809,-10332,-2,0,-2,0,13
EUN1_3574762831',4,22,10,1,0,0,0,6,0,332,80,24952,29997,31376,3,38,14,1,0,0,0,1,356,100,27550,31336,32764,1,-24,-20,-2598,-4,-1339,-1388,0,0,0,0,5
EUN1_3574614874',2,192,18,1,0,2,0,10,1,337,74,28802,27936,31388,0,28,9,0,0,0,0,3,282,86,24525,26543,26404,1,55,-12,4277,9,1393,4984,1,0,2,0,7
EUN1_3574499869',4,39,13,0,0,0,0,8,1,324,92,26052,28162,39244,1,21,17,1,0,3,0,6,332,77,29912,30913,36729,0,-8,15,-3860,-4,-2751,2515,-1,0,-3,0,2
EUN1_3574180119',2,22,20,0,0,1,0,16,1,313,74,29720,28926,30933,1,38,13,2,0,3,0,3,324,102,28724,28614,32735,1,-11,-28,996,7,312,-1802,-2,0,-2,0,13
EUN1_3574156872',2,28,17,2,0,0,0,3,0,346,103,30670,31078,35753,5,249,12,0,0,2,0,4,358,68,27765,28121,26709,1,-12,35,2905,5,2957,9044,2,0,-2,0,-1
EUN1_3574070323',2,26,17,1,0,2,0,8,0,358,102,29900,31907,33802,2,124,11,0,0,0,0,7,359,66,25806,29689,26532,1,-1,36,4094,6,2218,7270,1,0,2,0,1
EUN1_3576047166',0,32,8,1,0,1,0,8,0,341,94,25778,29267,20791,3,35,9,0,1,0,0,5,364,98,25563,30191,28038,1,-23,-4,215,-1,-924,-7247,1,-1,1,0,3
EUN1_3576011637',0,26,8,0,0,0,0,6,0,364,106,26059,29804,30021,3,28,9,2,0,0,0,5,339,75,24832,28747,22791,1,25,31,1227,-1,1057,7230,-2,0,0,0,1
EUN1_3575944795',1,37,12,0,0,0,0,11,0,330,100,26077,30008,36127,1,21,13,1,1,1,0,2,339,91,28523,29208,29583,1,-9,9,-2446,-1,800,6544,-1,-1,-1,0,9
EUN1_3575913950',6,26,16,1,0,0,0,14,0,320,80,26833,28580,35018,2,21,13,0,0,2,0,0,270,114,29031,29100,39954,1,50,-34,-2198,3,-520,-4936,1,0,-2,0,14
EUN1_3565678669',1,21,19,0,1,2,0,10,1,344,104,30512,29624,35381,5,27,16,2,0,2,0,5,267,70,26337,28218,32540,1,77,34,4175,3,1406,2841,-2,1,0,0,5
EUN1_3565436658',4,31,9,1,0,0,0,9,1,352,106,27604,30529,29614,1,24,15,1,0,0,0,5,313,78,27747,30490,32925,0,39,28,-143,-6,39,-3311,0,0,0,0,4
EUN1_3565411710',2,166,11,1,0,0,0,9,1,384,80,27439,30142,24871,4,23,6,1,0,2,0,4,337,108,25881,29558,26100,0,47,-28,1558,5,584,-1229,0,0,-2,0,5
EUN1_3565381013',2,31,19,1,0,1,0,6,1,308,78,29814,30787,33114,2,22,7,0,1,0,0,6,281,87,23702,27471,29825,1,27,-9,6112,12,3316,3289,1,-1,1,0,0
EUN1_3565323082',6,28,14,1,0,0,0,5,1,290,80,26760,28616,35190,4,26,17,1,0,0,0,4,267,86,27574,28851,39945,0,23,-6,-814,-3,-235,-4755,0,0,0,0,1
EUN1_3565293418',3,26,10,0,0,0,0,3,1,358,72,25966,27782,25977,1,26,13,2,0,0,0,6,333,91,26674,30462,28178,0,25,-19,-708,-3,-2680,-2201,-2,0,0,0,-3
EUN1_3565265868',3,27,11,1,0,0,0,9,1,330,80,26458,29537,27933,5,26,14,1,0,1,0,5,314,88,27369,28903,28595,0,16,-8,-911,-3,634,-662,0,0,-1,0,4
EUN1_3564863154',4,29,10,1,0,0,0,4,1,352,96,26095,30623,32665,6,330,10,1,0,1,0,1,338,92,25215,29378,31057,1,14,4,880,0,1245,1608,0,0,-1,0,3
EUN1_3564835730',5,22,11,0,0,0,0,11,1,281,100,26105,27116,34083,5,21,19,1,0,0,0,2,313,83,28957,29154,41277,0,-32,17,-2852,-8,-2038,-7194,-1,0,0,0,9
EUN1_3564827240',5,30,12,0,0,0,0,11,0,327,89,26469,28876,31391,4,73,16,2,0,1,0,3,348,81,28919,31354,34712,0,-21,8,-2450,-4,-2478,-3321,-2,0,-1,0,8
EUN1_3564808524',3,24,7,1,0,0,0,11,0,310,66,23800,25688,31332,2,24,17,0,1,3,0,1,360,94,30421,32655,35432,0,-50,-28,-6621,-10,-6967,-4100,1,-1,-3,0,10
EUN1_3564481901',3,24,13,1,1,2,0,7,0,342,100,28525,31295,33055,3,18,9,1,0,0,0,9,331,84,25264,28523,24135,1,11,16,3261,4,2772,8920,0,1,2,0,-2
EUN1_3575366579',5,29,15,0,0,1,0,11,0,334,86,28953,27275,34052,4,30,15,1,1,1,0,5,307,109,28621,29222,39010,0,27,-23,332,0,-1947,-4958,-1,-1,0,0,6
EUN1_3575351612',0,20,27,2,1,4,0,8,1,397,108,37594,33807,53706,1,27,9,0,0,1,0,5,276,68,23684,26801,25464,1,121,40,13910,18,7006,28242,2,1,3,0,3
EUN1_3575340580',2,18,8,0,0,0,0,17,1,281,63,22297,24687,21611,2,22,20,2,0,7,2,1,373,127,35377,32995,37171,0,-92,-64,-13080,-12,-8308,-15560,-2,0,-7,-2,16
EUN1_3574848889',0,20,5,0,0,0,0,17,0,303,82,23155,25381,18200,2,27,14,1,1,4,0,3,349,102,30683,30149,33233,0,-46,-20,-7528,-9,-4768,-15033,-1,-1,-4,0,14
EUN1_3574824635',5,25,16,1,0,0,0,7,1,359,101,28584,30992,33451,4,34,7,0,0,0,0,1,355,66,25404,28718,36923,1,4,35,3180,9,2274,-3472,1,0,0,0,6
EUN1_3574802812',1,19,15,1,0,1,0,12,0,311,110,28900,29934,38543,4,33,17,1,0,1,0,5,347,78,29338,29738,41975,1,-36,32,-438,-2,196,-3432,0,0,0,0,7
EUN1_3574790203',1,20,14,1,0,0,0,4,1,333,68,27179,29210,34676,3,96,17,0,0,1,0,3,313,67,27721,29171,30233,0,20,1,-542,-3,39,4443,1,0,-1,0,1
EUN1_3574761691',2,151,18,2,0,1,0,6,1,356,106,30139,32730,40477,0,23,11,0,0,0,0,5,385,90,27101,29999,38142,0,-29,16,3038,7,2731,2335,2,0,1,0,1
EUN1_3574756397',1,108,7,0,0,0,0,18,0,309,55,22671,23962,22094,1,27,17,2,0,5,0,0,338,80,31558,27945,31999,0,-29,-25,-8887,-10,-3983,-9905,-2,0,-5,0,18
EUN1_3574734013',0,22,20,1,0,8,1,4,1,364,108,34568,30475,29398,0,17,9,0,0,1,1,12,188,16,19821,17602,18580,1,176,92,14747,11,12873,10818,1,0,7,0,-8
EUN1_3574727406',7,32,18,1,1,2,0,11,0,366,82,31763,31391,36081,1,18,10,1,0,0,0,6,373,110,26855,29366,33473,0,-7,-28,4908,8,2025,2608,0,1,2,0,5
EUN1_3574712241',0,16,6,0,0,0,0,9,0,328,88,23647,26538,32148,6,25,21,1,0,2,0,2,350,100,32061,30837,39172,0,-22,-12,-8414,-15,-4299,-7024,-1,0,-2,0,7
EUN1_3574687037',0,31,13,0,0,0,0,6,0,343,78,26235,29215,30848,4,26,12,2,0,1,0,4,361,90,27363,29765,32483,1,-18,-12,-1128,1,-550,-1635,-2,0,-1,0,2
EUN1_3574682446',1,27,12,1,0,0,0,14,1,327,74,26857,27840,39832,4,24,20,1,1,3,0,4,388,87,33323,33587,40236,0,-61,-13,-6466,-8,-5747,-404,0,-1,-3,0,10
EUN1_3574665777',1,24,20,0,0,1,0,3,1,339,91,31058,30928,40195,1,24,12,1,0,0,0,10,316,80,25788,27333,30048,1,23,11,5270,8,3595,10147,-1,0,1,0,-7
EUN1_3574456297',4,138,15,2,0,0,0,9,0,378,72,28484,29493,33862,1,24,16,0,0,2,0,2,358,112,30779,32046,33095,0,20,-40,-2295,-1,-2553,767,2,0,-2,0,7
EUN1_3574411728',6,27,8,1,0,0,0,11,1,357,81,25648,29164,21350,6,26,18,1,0,2,0,2,342,87,30072,29745,32900,0,15,-6,-4424,-10,-581,-11550,0,0,-2,0,9
EUN1_3573216323',3,128,6,0,0,0,0,16,1,355,104,25939,29939,29022,1,22,16,2,0,2,0,0,396,120,31381,35105,35328,0,-41,-16,-5442,-10,-5166,-6306,-2,0,-2,0,16
EUN1_3573133770',4,27,19,1,0,3,0,6,0,369,94,32033,30435,39871,2,348,11,1,0,1,0,5,378,85,27672,29839,29304,1,-9,9,4361,8,596,10567,0,0,2,0,1
EUN1_3572725236',7,32,13,1,0,1,0,11,0,372,58,27202,29136,28367,4,25,11,0,0,0,0,6,346,58,26320,27351,26538,0,26,0,882,2,1785,1829,1,0,1,0,5
EUN1_3571314715',6,28,11,0,0,0,0,10,1,341,78,26216,29382,35010,5,29,8,1,0,0,0,2,351,78,24761,28430,33287,1,-10,0,1455,3,952,1723,-1,0,0,0,8
EUN1_3570796207',5,32,18,1,0,0,0,16,1,333,68,29561,28550,36003,4,144,20,0,0,3,0,5,377,100,32415,32733,45338,0,-44,-32,-2854,-2,-4183,-9335,1,0,-3,0,11
EUN1_3570633313',1,47,17,0,0,3,0,5,1,378,90,31868,30006,33668,2,24,12,1,0,0,0,10,285,106,26897,28794,28601,0,93,-16,4971,5,1212,5067,-1,0,3,0,-5
EUN1_3570601109',1,28,15,2,0,1,0,8,1,338,104,28901,31054,33061,2,26,6,0,0,1,0,4,312,80,23498,29232,26702,1,26,24,5403,9,1822,6359,2,0,0,0,4
EUN1_3570249530',1,22,11,1,0,0,0,10,0,366,78,26454,31077,34626,2,19,27,1,0,1,0,3,375,98,32860,33995,45082,0,-9,-20,-6406,-16,-2918,-10456,0,0,-1,0,7
EUN1_3570225082',4,24,13,2,0,0,0,5,0,370,84,27960,29654,36906,3,19,14,0,0,0,0,3,357,79,27538,30399,28306,1,13,5,422,-1,-745,8600,2,0,0,0,2
EUN1_3569981168',4,21,12,1,0,1,0,4,1,374,84,28672,29327,31745,6,27,13,1,0,0,0,5,315,96,26842,27558,29633,0,59,-12,1830,-1,1769,2112,0,0,1,0,-1
EUN1_3569956604',5,126,5,0,0,0,0,9,1,327,81,23383,27100,21182,3,25,11,1,0,1,0,2,409,102,29020,31507,26099,0,-82,-21,-5637,-6,-4407,-4917,-1,0,-1,0,7
EUN1_3569587229',6,26,14,2,0,1,0,7,0,364,82,28214,30271,30028,2,33,15,0,0,1,0,6,325,98,28841,30573,37711,1,39,-16,-627,-1,-302,-7683,2,0,0,0,1
EUN1_3569552825',1,36,8,2,0,0,0,5,0,366,80,25060,30374,27615,1,29,9,0,0,0,0,1,388,91,26019,30053,23838,1,-22,-11,-959,-1,321,3777,2,0,0,0,4
EUN1_3569513946',3,23,13,1,0,0,0,14,1,356,88,27751,31294,31969,1,35,14,0,0,2,0,3,343,88,29673,30289,33229,0,13,0,-1922,-1,1005,-1260,1,0,-2,0,11
EUN1_3569508616',2,38,17,1,0,3,0,5,1,376,99,31988,32121,34356,2,24,8,0,0,0,0,11,306,88,24194,28852,30489,1,70,11,7794,9,3269,3867,1,0,3,0,-6
EUN1_3569480331',1,24,15,1,0,1,0,7,1,364,92,28242,31585,35625,1,22,4,1,0,0,0,2,346,80,21858,26323,22869,1,18,12,6384,11,5262,12756,0,0,1,0,5
EUN1_3569394780',6,37,10,1,0,1,0,9,1,357,84,26425,29095,28921,5,32,11,1,0,2,0,2,370,74,28117,29919,28131,1,-13,10,-1692,-1,-824,790,0,0,-1,0,7
EUN1_3567810844',5,33,11,2,0,0,0,8,0,354,78,26527,29747,32968,5,24,15,0,1,0,0,6,352,82,27189,29491,30764,1,2,-4,-662,-4,256,2204,2,-1,0,0,2
EUN1_3575717433',3,28,20,0,0,1,0,9,0,334,86,30786,31759,34958,3,26,10,2,0,0,0,1,328,104,25441,28539,30564,0,6,-18,5345,10,3220,4394,-2,0,1,0,8
EUN1_3575710307',1,37,10,0,0,0,0,9,1,325,80,27289,27412,34527,2,76,9,2,0,2,0,0,313,84,24843,27428,31436,1,12,-4,2446,1,-16,3091,-2,0,-2,0,9
EUN1_3575234046',5,24,20,0,0,1,0,6,0,313,88,30627,28761,37478,6,31,11,1,0,1,0,7,307,87,26410,26506,31508,0,6,1,4217,9,2255,5970,-1,0,0,0,-1
EUN1_3575210137',2,25,8,0,0,0,0,10,0,296,94,23595,26432,28049,5,25,15,1,0,1,0,0,362,101,29924,31674,32233,0,-66,-7,-6329,-7,-5242,-4184,-1,0,-1,0,10
EUN1_3575196302',6,29,3,0,0,0,0,4,0,347,88,22159,26283,17768,5,38,10,2,1,1,0,4,360,84,26207,27429,21351,0,-13,4,-4048,-7,-1146,-3583,-2,-1,-1,0,0
EUN1_3575186300',8,27,10,1,0,0,0,11,0,308,91,26083,29827,24620,5,25,17,1,0,2,0,3,379,95,30868,32051,40506,0,-71,-4,-4785,-7,-2224,-15886,0,0,-2,0,8
EUN1_3574459703',4,36,6,0,0,0,0,9,0,351,93,24552,29226,26323,2,28,12,1,0,0,0,4,330,74,26508,28230,30174,0,21,19,-1956,-6,996,-3851,-1,0,0,0,5
EUN1_3574419694',2,69,10,0,0,1,0,8,0,362,75,28446,29206,34497,5,25,14,1,0,1,0,6,314,86,28023,28322,32955,1,48,-11,423,-4,884,1542,-1,0,0,0,2
EUN1_3574408184',4,22,22,1,0,1,0,13,1,329,92,31427,31839,36350,3,19,6,0,0,0,0,4,358,83,25253,26951,32881,1,-29,9,6174,16,4888,3469,1,0,1,0,9
EUN1_3567653729',2,31,2,1,0,0,0,6,0,326,98,22119,27138,17134,10,41,8,0,0,1,0,3,344,94,25701,28284,24714,0,-18,4,-3582,-6,-1146,-7580,1,0,-1,0,3
EUN1_3565957102',4,37,12,0,0,0,0,13,0,326,92,26161,29586,28463,7,30,19,2,0,2,0,2,394,92,31153,33563,37720,0,-68,0,-4992,-7,-3977,-9257,-2,0,-2,0,11
EUN1_3565644346',7,41,10,0,0,0,0,16,1,329,99,27183,28533,28513,6,27,22,2,0,3,0,3,413,100,34733,34375,36780,0,-84,-1,-7550,-12,-5842,-8267,-2,0,-3,0,13
EUN1_3565634178',3,74,11,2,0,0,0,4,1,356,96,25902,29941,24359,7,30,2,0,0,1,0,2,371,116,24090,28582,26090,1,-15,-20,1812,9,1359,-1731,2,0,-1,0,2
EUN1_3576155538',4,25,10,1,0,0,0,7,0,309,78,25450,26730,32060,3,28,16,1,0,1,0,3,331,93,29262,30015,42565,0,-22,-15,-3812,-6,-3285,-10505,0,0,-1,0,4
EUN1_3576146153',4,28,9,1,0,0,0,6,1,353,82,26203,30010,24547,0,25,8,1,0,0,0,3,360,102,25527,29353,27871,1,-7,-20,676,1,657,-3324,0,0,0,0,3
EUN1_3575232354',8,34,20,1,1,1,0,11,1,342,73,30203,28867,33771,1,18,12,1,0,0,0,4,346,103,28734,30283,46222,0,-4,-30,1469,8,-1416,-12451,0,1,1,0,7
EUN1_3574985747',4,26,13,0,0,0,0,5,1,347,78,26506,28770,32238,2,23,13,1,1,1,0,3,336,111,28680,30770,33330,0,11,-33,-2174,0,-2000,-1092,-1,-1,-1,0,2
EUN1_3574944335',5,50,9,1,0,0,0,6,0,356,86,25325,30539,23912,3,28,12,1,0,1,0,2,376,102,27051,30561,31490,1,-20,-16,-1726,-3,-22,-7578,0,0,-1,0,4
EUN1_3574915525',2,24,10,1,0,1,0,8,0,374,94,28077,29147,29865,2,23,7,1,0,0,0,8,331,82,23748,27448,21101,1,43,12,4329,3,1699,8764,0,0,1,0,0
EUN1_3574868045',6,26,8,2,0,1,0,11,1,344,92,25762,29066,21818,5,26,12,0,1,2,0,3,403,111,30460,33875,36368,0,-59,-19,-4698,-4,-4809,-14550,2,-1,-1,0,8
EUN1_3574840081',2,147,9,1,0,0,0,10,0,316,86,25382,28362,30337,6,33,17,1,0,2,0,2,376,80,31007,31742,40035,0,-60,6,-5625,-8,-3380,-9698,0,0,-2,0,8
EUN1_3574811482',5,139,9,1,0,0,0,5,0,323,86,24989,27081,32443,4,31,13,1,0,0,0,4,382,93,28034,31096,31213,0,-59,-7,-3045,-4,-4015,1230,0,0,0,0,1
EUN1_3574784775',0,17,12,1,0,0,0,11,1,345,82,27364,30407,33557,1,30,14,1,0,1,0,2,421,92,29622,33671,34413,1,-76,-10,-2258,-2,-3264,-856,0,0,-1,0,9
EUN1_3574718660',4,27,17,1,1,2,0,9,1,372,88,30878,30698,37716,4,29,11,1,0,1,0,5,353,62,25863,28995,32077,1,19,26,5015,6,1703,5639,0,1,1,0,4
EUN1_3574706306',3,39,18,0,0,1,0,9,1,336,72,29249,27798,43819,1,27,15,2,1,0,0,4,277,96,28056,27266,30898,0,59,-24,1193,3,532,12921,-2,-1,1,0,5
EUN1_3573268435',0,146,9,0,0,1,0,10,1,378,92,26139,29964,27036,2,33,15,2,0,1,0,3,360,99,29245,31030,29183,1,18,-7,-3106,-6,-1066,-2147,-2,0,0,0,7
EUN1_3573236814',4,20,9,0,0,0,0,12,1,342,81,27269,27932,25123,2,24,14,2,0,2,0,3,356,85,29348,30706,33669,0,-14,-4,-2079,-5,-2774,-8546,-2,0,-2,0,9
EUN1_3573215848',2,25,8,0,0,0,0,13,0,336,66,23514,27428,30292,4,131,14,1,0,1,0,1,343,105,27880,29873,31053,0,-7,-39,-4366,-6,-2445,-761,-1,0,-1,0,12
EUN1_3573192411',4,26,9,1,0,1,0,6,0,385,90,26673,30162,34853,2,25,10,1,0,0,0,4,324,105,26778,30667,24754,1,61,-15,-105,-1,-505,10099,0,0,1,0,2
EUN1_3573174691',3,24,12,1,0,1,0,10,0,368,75,27046,30768,35538,2,27,14,1,0,1,0,3,342,107,27422,30808,36744,1,26,-32,-376,-2,-40,-1206,0,0,0,0,7
EUN1_3573149683',2,28,21,0,0,1,0,11,0,310,76,31165,30611,37186,3,22,22,2,0,1,0,5,317,85,30797,29235,34033,0,-7,-9,368,-1,1376,3153,-2,0,0,0,6
EUN1_3567422508',4,32,13,0,0,0,0,5,1,370,75,27639,28657,32175,5,31,8,1,0,0,0,4,345,100,24317,28023,29158,1,25,-25,3322,5,634,3017,-1,0,0,0,1
EUN1_3567390529',5,25,13,1,0,0,0,8,0,335,71,27897,27105,36341,2,23,15,0,0,2,0,6,307,76,27472,27962,35730,1,28,-5,425,-2,-857,611,1,0,-2,0,2
EUN1_3567244739',2,19,7,0,0,1,0,7,1,338,68,24783,27156,22358,1,28,17,2,0,2,0,5,325,76,28393,30185,37115,0,13,-8,-3610,-10,-3029,-14757,-2,0,-1,0,2
EUN1_3567202660',0,32,21,1,0,0,0,10,0,323,77,27680,29632,37760,6,28,10,1,0,0,0,2,320,78,24809,25962,26599,1,3,-1,2871,11,3670,11161,0,0,0,0,8
EUN1_3567159531',5,85,10,2,0,0,0,10,1,362,102,27501,30468,26855,2,20,13,0,0,0,0,3,366,102,28106,30198,31118,0,-4,0,-605,-3,270,-4263,2,0,0,0,7
EUN1_3566313463',3,55,14,0,0,1,0,10,0,341,84,29716,31002,26465,9,38,17,2,0,0,0,4,334,88,28537,28895,32541,1,7,-4,1179,-3,2107,-6076,-2,0,1,0,6
EUN1_3566276875',4,33,15,1,0,1,0,7,1,364,86,29711,29159,33383,4,26,17,1,0,0,0,8,310,78,27985,28840,34228,1,54,8,1726,-2,319,-845,0,0,1,0,-1
EUN1_3566265217',4,26,8,2,0,1,0,11,1,360,96,26672,29193,27869,4,20,12,0,0,2,0,5,350,100,27578,28740,30525,1,10,-4,-906,-4,453,-2656,2,0,-1,0,6
EUN1_3566242118',6,24,6,0,0,0,0,8,0,349,68,23369,27619,27751,2,30,15,2,1,0,0,1,329,90,28182,31120,34383,0,20,-22,-4813,-9,-3501,-6632,-2,-1,0,0,7
EUN1_3566223340',6,38,8,0,0,0,0,12,0,367,68,24645,27124,23663,7,49,17,2,1,1,0,1,337,99,30190,29422,33303,0,30,-31,-5545,-9,-2298,-9640,-2,-1,-1,0,11
EUN1_3565799042',3,25,11,1,0,0,0,9,0,290,100,24449,28300,24216,3,28,17,0,0,1,0,3,356,75,29702,30965,36917,0,-66,25,-5253,-6,-2665,-12701,1,0,-1,0,6
EUN1_3565563675',1,203,21,1,0,6,2,3,1,335,113,35436,29498,35077,0,14,3,0,0,2,0,12,229,68,18825,22395,18367,1,106,45,16611,18,7103,16710,1,0,4,2,-9
EUN1_3565296803',4,39,10,1,0,1,0,8,1,336,103,26566,30219,29421,2,20,8,1,0,1,0,3,357,80,25553,28449,28964,1,-21,23,1013,2,1770,457,0,0,0,0,5
EUN1_3565263780',4,29,15,1,0,0,0,6,1,355,74,28968,28796,33995,6,27,11,1,0,1,0,4,296,78,25629,27747,33804,0,59,-4,3339,4,1049,191,0,0,-1,0,2
EUN1_3565253416',3,48,12,0,0,1,0,6,1,378,94,28266,31241,29128,0,31,15,2,0,0,0,3,377,100,28865,30947,29508,1,1,-6,-599,-3,294,-380,-2,0,1,0,3
EUN1_3565236717',6,26,14,2,0,2,0,7,1,361,108,29399,30415,26675,1,22,7,0,0,0,0,5,367,84,24764,28414,27810,1,-6,24,4635,7,2001,-1135,2,0,2,0,2
EUN1_3565069262',1,23,16,1,0,1,0,6,1,350,98,31743,31659,41100,4,36,15,1,0,1,0,1,333,80,27468,29476,30431,1,17,18,4275,1,2183,10669,0,0,0,0,5
EUN1_3565045822',5,40,10,0,1,1,0,8,0,355,88,27174,29093,27936,3,29,11,1,0,0,0,5,362,100,28520,29760,27828,1,-7,-12,-1346,-1,-667,108,-1,1,1,0,3
EUN1_3565023505',3,21,14,0,1,1,0,11,0,311,100,28589,28686,30807,6,46,15,2,0,0,0,8,315,86,28149,27107,29714,0,-4,14,440,-1,1579,1093,-2,1,1,0,3
EUN1_3564997521',1,24,18,1,0,1,0,9,1,340,118,31214,32089,31382,2,30,14,1,0,0,0,4,350,81,29022,28916,35687,1,-10,37,2192,4,3173,-4305,0,0,1,0,5
EUN1_3575408753',3,42,17,0,1,0,0,5,0,378,92,30081,31411,37862,6,80,11,2,0,1,0,6,345,103,27503,29253,30388,1,33,-11,2578,6,2158,7474,-2,1,-1,0,-1
EUN1_3575359044',4,25,13,0,1,2,0,8,1,366,93,29482,30165,29000,6,27,10,1,0,1,0,6,326,101,27095,28027,26669,1,40,-8,2387,3,2138,2331,-1,1,1,0,2
EUN1_3575338892',7,27,11,1,0,1,0,8,1,382,86,28475,29206,25673,4,29,13,1,0,0,0,5,383,94,28535,30977,30017,1,-1,-8,-60,-2,-1771,-4344,0,0,1,0,3
EUN1_3574776791',3,29,7,1,0,1,0,12,0,325,74,24482,26933,30605,4,31,18,1,0,1,0,8,340,95,29576,29354,34901,1,-15,-21,-5094,-11,-2421,-4296,0,0,0,0,4
EUN1_3574767532',1,30,8,0,0,1,0,8,0,374,70,26828,30644,25890,4,31,14,2,0,1,0,7,370,92,27829,30686,32170,1,4,-22,-1001,-6,-42,-6280,-2,0,0,0,1
EUN1_3574237658',4,136,9,1,0,1,0,7,1,334,72,26152,28392,21807,2,19,14,1,0,0,0,6,358,88,27312,31707,38443,1,-24,-16,-1160,-5,-3315,-16636,0,0,1,0,1
EUN1_3574213900',4,31,13,1,1,0,0,9,0,340,86,27539,30083,31973,3,23,11,1,0,1,0,2,349,81,27239,28766,35419,1,-9,5,300,2,1317,-3446,0,1,-1,0,7
EUN1_3574302612',7,57,20,1,0,0,0,8,0,309,94,29351,28695,40099,2,26,12,0,0,1,0,7,317,70,26563,26706,36963,1,-8,24,2788,8,1989,3136,1,0,-1,0,1
EUN1_3574288148',6,27,19,1,0,0,0,13,1,344,61,28969,31700,39876,1,24,16,0,0,1,0,3,346,103,29599,30766,42713,0,-2,-42,-630,3,934,-2837,1,0,-1,0,10
EUN1_3574213559',4,30,10,1,0,0,0,7,0,355,84,26622,28714,31932,12,36,13,1,0,1,0,6,329,92,25676,28817,26084,0,26,-8,946,-3,-103,5848,0,0,-1,0,1
EUN1_3573746590',0,27,18,1,0,1,0,7,1,313,86,28773,28916,40231,1,22,19,1,0,1,0,6,303,82,29778,30676,32978,0,10,4,-1005,-1,-1760,7253,0,0,0,0,1
EUN1_3573665647',3,28,18,0,0,0,0,8,0,329,84,29809,29334,40853,6,26,21,2,0,2,0,4,323,74,30818,29557,41831,0,6,10,-1009,-3,-223,-978,-2,0,-2,0,4
EUN1_3576074767',4,22,16,0,0,0,0,9,0,298,83,26618,31147,30287,2,24,4,2,0,0,0,0,352,95,23877,28293,32031,1,-54,-12,2741,12,2854,-1744,-2,0,0,0,9
EUN1_3576058119',4,23,17,1,0,1,0,3,0,324,78,29445,30893,35154,2,22,16,1,1,0,0,7,324,62,27923,29089,36075,1,0,16,1522,1,1804,-921,0,-1,1,0,-4
EUN1_3576029277',2,36,11,0,0,2,0,3,1,387,89,28605,29330,25741,2,22,11,1,0,1,0,6,345,74,26177,28063,28263,1,42,15,2428,0,1267,-2522,-1,0,1,0,-3
EUN1_3575996228',3,26,13,1,0,1,0,12,1,355,100,28023,29973,35935,5,246,14,0,0,2,0,4,364,92,28707,31313,27931,0,-9,8,-684,-1,-1340,8004,1,0,-1,0,8
EUN1_3575963731',3,27,15,1,0,0,0,9,1,295,60,26621,27682,27529,3,39,18,0,0,1,0,0,320,111,29541,30338,38142,0,-25,-51,-2920,-3,-2656,-10613,1,0,-1,0,9
EUN1_3575889965',3,28,10,1,0,1,0,4,0,377,94,28186,28653,27952,4,94,11,1,0,0,0,9,364,90,26446,28436,23998,1,13,4,1740,-1,217,3954,0,0,1,0,-5
EUN1_3575884275',3,25,6,0,0,0,0,13,0,245,85,21837,24987,20496,1,41,20,2,0,4,0,0,390,109,34588,33590,37433,0,-145,-24,-12751,-14,-8603,-16937,-2,0,-4,0,13
EUN1_3575840979',2,22,17,0,0,0,0,3,1,277,60,27238,27279,37671,3,32,16,1,0,0,0,3,322,87,27251,26921,35793,1,-45,-27,-13,1,358,1878,-1,0,0,0,0
EUN1_3575538876',6,32,6,0,0,0,0,6,0,334,93,23001,27347,25474,4,33,15,1,0,1,0,1,340,84,28056,30546,34056,0,-6,9,-5055,-9,-3199,-8582,-1,0,-1,0,5
EUN1_3575503839',5,282,10,0,1,1,0,7,0,374,88,27298,30384,36658,5,33,11,1,0,0,0,4,325,79,25862,27193,33466,0,49,9,1436,-1,3191,3192,-1,1,1,0,3
EUN1_3575489194',1,113,21,2,1,3,0,9,1,338,90,33460,31926,37471,1,25,13,0,0,1,0,6,324,90,27946,28587,34589,1,14,0,5514,8,3339,2882,2,1,2,0,3
EUN1_3575448401',7,37,15,0,0,0,0,12,1,355,84,27793,28389,30780,0,26,14,1,0,1,0,4,365,100,28737,29636,28370,0,-10,-16,-944,1,-1247,2410,-1,0,-1,0,8
EUN1_3574896865',4,31,8,2,0,1,0,11,0,384,72,26441,29900,31813,7,38,21,0,0,2,0,3,371,114,31642,35942,38530,1,13,-42,-5201,-13,-6042,-6717,2,0,-1,0,8
EUN1_3574881357',1,52,14,1,0,0,0,6,0,360,78,29042,29461,33980,3,26,18,1,0,1,0,3,340,80,28667,28421,34817,1,20,-2,375,-4,1040,-837,0,0,-1,0,3
EUN1_3574864107',2,25,18,2,0,3,0,11,0,370,75,32057,31544,34076,2,21,15,0,0,0,0,6,305,95,27096,29686,32520,1,65,-20,4961,3,1858,1556,2,0,3,0,5
EUN1_3574841753',2,23,11,2,0,2,0,6,1,400,128,29490,32696,24285,2,16,2,0,0,0,0,7,319,68,20471,26382,18647,1,81,60,9019,9,6314,5638,2,0,2,0,-1
EUN1_3574299746',6,27,3,0,0,0,0,8,1,363,96,22817,26492,25680,5,26,12,1,1,0,0,1,357,68,26742,28845,27889,1,6,28,-3925,-9,-2353,-2209,-1,-1,0,0,7
EUN1_3574016656',2,25,5,2,0,1,0,10,1,392,100,24997,29116,22638,5,37,11,0,1,1,0,2,357,110,27199,31245,26563,0,35,-10,-2202,-6,-2129,-3925,2,-1,0,0,8
EUN1_3573999327',2,27,19,1,0,1,0,11,0,349,100,29208,31182,35473,3,13,9,1,0,1,0,4,302,58,25229,24940,25588,0,47,42,3979,10,6242,9885,0,0,0,0,7
EUN1_3567901623',2,25,10,1,0,0,0,11,0,338,85,26062,29432,25007,4,41,8,1,1,0,0,2,391,89,26496,29590,30341,0,-53,-4,-434,2,-158,-5334,0,-1,0,0,9
EUN1_3567469702',4,26,11,1,0,1,0,13,0,346,82,28011,28592,21276,1,19,15,0,0,1,0,2,350,86,28908,31068,32952,1,-4,-4,-897,-4,-2476,-11676,1,0,0,0,11
EUN1_3566388822',2,22,16,2,1,1,0,6,1,341,84,29531,29214,30065,3,25,10,0,0,1,0,2,346,84,26879,29536,27090,1,-5,0,2652,6,-322,2975,2,1,0,0,4
EUN1_3566374195',4,41,15,2,1,0,0,9,0,359,84,28196,30330,35781,3,20,16,0,0,1,0,2,413,80,30682,30811,41472,1,-54,4,-2486,-1,-481,-5691,2,1,-1,0,7
EUN1_3566333895',3,25,12,2,0,1,0,7,1,337,94,27899,28900,36592,1,24,13,0,0,1,0,3,327,78,27040,29341,33328,0,10,16,859,-1,-441,3264,2,0,0,0,4
EUN1_3565086304',5,33,4,1,0,0,0,4,0,395,95,25059,30145,19313,5,36,9,1,0,1,0,2,416,92,28366,29694,19660,0,-21,3,-3307,-5,451,-347,0,0,-1,0,2
EUN1_3565069796',2,17,9,0,0,0,0,9,1,305,82,25123,29454,24480,4,24,13,2,0,2,0,5,388,93,28481,32127,32945,0,-83,-11,-3358,-4,-2673,-8465,-2,0,-2,0,4
EUN1_3564934926',5,26,10,0,0,0,0,9,0,328,92,26333,28691,31674,2,72,18,2,0,1,0,3,334,76,31058,29677,37738,0,-6,16,-4725,-8,-986,-6064,-2,0,-1,0,6
EUN1_3564159423',2,27,8,1,0,0,0,12,1,331,76,24898,26466,25825,3,23,19,0,1,4,0,6,376,84,31655,32819,34142,0,-45,-8,-6757,-11,-6353,-8317,1,-1,-4,0,6
EUN1_3564115351',5,36,11,2,0,2,0,11,1,375,88,28163,29829,30726,3,239,10,0,0,1,0,3,384,84,27853,29751,27066,1,-9,4,310,1,78,3660,2,0,1,0,8
EUN1_3563543124',3,148,11,2,0,0,0,6,1,385,90,26652,29730,30634,4,26,11,0,0,0,0,4,354,78,25726,30130,26615,0,31,12,926,0,-400,4019,2,0,0,0,2
EUN1_3563323219',2,24,11,1,0,1,0,7,1,329,96,26728,28776,35321,3,28,7,0,1,1,0,5,378,79,25723,28766,25071,1,-49,17,1005,4,10,10250,1,-1,0,0,2
EUN1_3563570987',4,27,17,1,0,0,0,3,1,293,92,27811,27686,31954,4,27,17,1,0,1,0,2,319,92,29336,28923,34336,1,-26,0,-1525,0,-1237,-2382,0,0,-1,0,1
EUN1_3563515960',1,30,12,0,0,1,0,12,0,284,70,26733,25875,35306,3,38,26,2,0,2,0,6,318,79,32880,30166,54889,0,-34,-9,-6147,-14,-4291,-19583,-2,0,-1,0,6
EUN1_3563492772',4,28,11,1,0,0,0,3,1,336,98,26254,28934,26234,2,32,9,1,0,0,0,0,292,86,24181,27580,25905,1,44,12,2073,2,1354,329,0,0,0,0,3
EUN1_3563297921',2,20,17,2,0,0,0,5,1,392,95,29796,32376,36887,1,23,4,0,0,0,0,6,373,95,24260,28042,30438,1,19,0,5536,13,4334,6449,2,0,0,0,-1
EUN1_3563282841',4,75,10,0,0,0,0,13,0,267,63,24834,26425,40407,1,26,28,1,0,4,0,2,367,84,36880,32214,55190,0,-100,-21,-12046,-18,-5789,-14783,-1,0,-4,0,11
EUN1_3562922012',3,26,7,1,0,1,0,8,1,342,83,25532,29081,21094,4,33,8,1,0,0,0,5,334,96,24362,28588,24171,0,8,-13,1170,-1,493,-3077,0,0,1,0,3
EUN1_3562900166',3,24,11,0,0,1,0,12,0,312,75,26021,28067,34480,5,51,17,2,0,1,0,3,344,80,29466,30240,37806,0,-32,-5,-3445,-6,-2173,-3326,-2,0,0,0,9
EUN1_3562866092',5,35,6,1,0,0,0,8,1,354,92,24196,28771,26123,6,23,13,1,0,0,0,1,403,84,28139,31597,29550,0,-49,8,-3943,-7,-2826,-3427,0,0,0,0,7
EUN1_3562827912',4,26,13,1,1,0,0,7,1,364,82,28832,28824,36440,0,23,9,1,0,3,0,8,290,102,24432,27416,26169,1,74,-20,4400,4,1408,10271,0,1,-3,0,-1
EUN1_3562574953',3,138,10,0,0,0,0,10,1,327,81,26135,28072,30988,5,26,16,1,0,1,0,1,317,98,28987,30673,27906,0,10,-17,-2852,-6,-2601,3082,-1,0,-1,0,9
EUN1_3562534086',3,31,10,0,0,0,0,8,1,368,67,26695,29520,28266,5,27,10,1,0,1,0,3,348,92,26221,28544,27919,1,20,-25,474,0,976,347,-1,0,-1,0,5
EUN1_3562492345',0,91,10,1,0,0,0,7,1,315,81,24685,26247,30671,3,43,16,0,0,1,0,1,354,102,29530,30540,31997,0,-39,-21,-4845,-6,-4293,-1326,1,0,-1,0,6
EUN1_3569141005',1,27,11,0,0,0,0,4,0,366,91,27182,30598,31472,2,39,12,1,0,0,0,6,356,82,26640,29917,30708,0,10,9,542,-1,681,764,-1,0,0,0,-2
EUN1_3568794618',1,36,13,1,1,1,0,12,1,345,88,29200,30706,34808,7,322,9,1,0,1,0,7,334,124,26222,29517,32717,1,11,-36,2978,4,1189,2091,0,1,0,0,5
EUN1_3568755759',2,34,11,1,1,1,0,7,0,376,93,27745,31636,26885,5,32,10,1,0,0,0,4,364,98,25738,29723,25314,0,12,-5,2007,1,1913,1571,0,1,1,0,3
EUN1_3568463268',5,24,16,1,1,3,0,14,0,388,112,33212,33313,34688,3,24,15,1,0,2,0,11,310,64,29676,29442,30977,1,78,48,3536,1,3871,3711,0,1,1,0,3
EUN1_3565185512',6,28,15,0,0,1,0,7,0,308,62,27988,26593,33923,4,21,16,2,0,0,0,5,372,90,28867,29064,29168,0,-64,-28,-879,-1,-2471,4755,-2,0,1,0,2
EUN1_3564895761',2,22,24,0,0,2,0,8,0,363,85,33607,34589,46109,5,23,11,1,0,0,0,7,344,90,27652,29686,32194,1,19,-5,5955,13,4903,13915,-1,0,2,0,1
EUN1_3564644493',5,34,2,1,0,0,0,6,0,375,84,22945,27423,22533,8,91,14,1,1,0,0,3,339,95,27565,30715,28888,0,36,-11,-4620,-12,-3292,-6355,0,-1,0,0,3
EUN1_3564628954',7,285,23,1,0,2,0,8,1,315,85,32271,28064,42874,3,26,8,0,0,0,0,7,321,74,24304,27194,30733,1,-6,11,7967,15,870,12141,1,0,2,0,1
EUN1_3564101370',4,18,9,1,0,0,0,3,0,349,92,25745,29221,30809,0,20,7,1,0,0,0,1,339,107,24542,29903,33971,0,10,-15,1203,2,-682,-3162,0,0,0,0,2
EUN1_3563527016',6,24,19,0,1,2,0,13,0,325,81,31240,31076,30716,2,22,16,1,0,1,0,2,343,78,29982,29856,40751,0,-18,3,1258,3,1220,-10035,-1,1,1,0,11
EUN1_3563496929',5,26,14,1,0,0,0,7,1,330,92,28283,29927,29084,6,26,10,1,0,0,0,4,352,92,26375,28645,29819,0,-22,0,1908,4,1282,-735,0,0,0,0,3
EUN1_3563359551',5,63,7,1,0,1,0,13,0,332,82,24330,29199,23793,6,64,11,1,1,1,0,2,384,107,28931,30374,28407,0,-52,-25,-4601,-4,-1175,-4614,0,-1,0,0,11
EUN1_3563337532',1,50,15,0,0,1,0,12,0,314,99,28801,27563,31613,2,26,17,2,0,2,0,6,379,84,31378,30792,37765,0,-65,15,-2577,-2,-3229,-6152,-2,0,-1,0,6
EUN1_3563314833',7,34,17,1,0,0,0,6,0,356,92,29248,30616,35186,1,26,13,1,0,1,0,2,362,79,30105,30454,34905,0,-6,13,-857,4,162,281,0,0,-1,0,4
EUN1_3563298368',3,27,11,1,0,1,0,9,0,308,91,26679,28726,29537,7,104,10,1,0,1,0,5,356,88,26673,29090,29871,1,-48,3,6,1,-364,-334,0,0,0,0,4
EUN1_3563277510',7,30,17,0,0,2,0,6,1,371,78,31457,29276,36854,5,25,16,1,0,1,0,9,260,97,27626,26636,33354,1,111,-19,3831,1,2640,3500,-1,0,1,0,-3
EUN1_3563264141',6,26,16,1,0,0,0,8,0,318,72,27715,28082,35249,5,32,17,1,0,0,0,5,318,63,29157,30039,45328,1,0,9,-1442,-1,-1957,-10079,0,0,0,0,3
EUN1_3562438640',3,53,13,1,0,0,0,9,1,294,79,25951,28033,27645,4,62,13,1,0,2,0,1,380,73,29194,30486,34386,1,-86,6,-3243,0,-2453,-6741,0,0,-2,0,8
EUN1_3562430074',4,22,11,0,0,0,0,8,1,321,73,24940,28975,32742,4,96,16,2,0,1,0,0,350,111,29888,33001,34643,0,-29,-38,-4948,-5,-4026,-1901,-2,0,-1,0,8
EUN1_3576206276',3,29,6,0,0,0,0,7,0,356,64,23757,28212,31006,4,26,15,1,0,1,0,2,343,92,27779,31182,34358,0,13,-28,-4022,-9,-2970,-3352,-1,0,-1,0,5
EUN1_3576197057',2,16,9,2,1,0,0,7,0,333,88,26249,30274,31076,5,38,12,0,0,1,0,6,348,82,25505,29427,35162,1,-15,6,744,-3,847,-4086,2,1,-1,0,1
EUN1_3576200748',4,25,19,1,0,1,0,8,0,316,89,29967,28513,37015,3,22,18,1,0,0,0,6,318,99,28405,29601,37247,1,-2,-10,1562,1,-1088,-232,0,0,1,0,2
EUN1_3568349725',6,44,8,1,0,0,0,8,1,303,94,24097,27892,24888,4,26,12,1,0,2,0,1,378,93,27991,30819,29670,1,-75,1,-3894,-4,-2927,-4782,0,0,-2,0,7
EUN1_3568332770',5,28,21,1,0,0,0,10,1,273,87,29230,28663,42246,2,21,13,1,0,0,0,3,333,72,26736,28617,31071,1,-60,15,2494,8,46,11175,0,0,0,0,7
EUN1_3568236894',4,23,12,2,1,0,0,10,0,340,92,27610,30093,34088,2,24,12,0,0,1,0,4,412,108,30072,31672,33375,0,-72,-16,-2462,0,-1579,713,2,1,-1,0,6
EUN1_3568223615',0,130,21,2,0,2,0,2,0,350,124,33372,34899,43093,1,22,12,0,0,0,0,13,372,84,27601,31408,30136,1,-22,40,5771,9,3491,12957,2,0,2,0,-11
EUN1_3568194895',2,31,14,0,0,0,0,7,0,300,71,26515,29474,31322,3,31,14,1,0,1,0,1,367,82,27928,29160,32569,1,-67,-11,-1413,0,314,-1247,-1,0,-1,0,6
EUN1_3568171938',0,17,14,0,0,1,0,10,0,326,80,28981,29148,41789,1,39,21,0,0,0,0,2,352,96,31299,32339,39231,0,-26,-16,-2318,-7,-3191,2558,0,0,1,0,8
EUN1_3567515066',3,27,7,0,0,0,0,12,1,327,112,24457,28221,27310,7,24,13,1,0,1,0,1,387,83,28187,29719,27665,0,-60,29,-3730,-6,-1498,-355,-1,0,-1,0,11
EUN1_3567521281',3,43,18,0,0,0,0,13,0,295,87,29297,28570,36821,4,42,16,1,0,2,0,2,381,68,31059,30206,34809,0,-86,19,-1762,2,-1636,2012,-1,0,-2,0,11
EUN1_3567517405',1,27,15,0,0,0,0,13,0,348,70,28323,29593,28705,3,74,16,2,0,1,0,1,344,98,29432,29688,32439,1,4,-28,-1109,-1,-95,-3734,-2,0,-1,0,12
EUN1_3567516167',1,25,17,0,0,1,0,6,1,362,80,30427,30707,37175,2,24,16,2,0,0,0,6,351,103,28259,30964,31960,0,11,-23,2168,1,-257,5215,-2,0,1,0,0
EUN1_3567506655',5,61,14,2,1,1,0,15,0,319,91,27962,29165,28020,3,64,9,0,0,1,0,2,363,84,27151,28612,32238,1,-44,7,811,5,553,-4218,2,1,0,0,13
EUN1_3567503691',7,27,8,1,0,1,0,11,1,332,69,25614,26401,28811,5,25,20,1,0,1,0,4,364,102,31696,31789,38211,0,-32,-33,-6082,-12,-5388,-9400,0,0,0,0,7
EUN1_3567501830',2,211,13,1,0,1,0,22,1,352,58,27936,28333,26286,3,31,18,1,1,3,0,2,400,124,34215,34477,42632,0,-48,-66,-6279,-5,-6144,-16346,0,-1,-2,0,20
EUN1_3567477733',4,25,12,0,0,1,0,8,0,356,74,27360,28984,31020,2,27,12,1,0,0,0,4,346,88,26515,28914,29883,1,10,-14,845,0,70,1137,-1,0,1,0,4
EUN1_3567295798',3,30,3,0,0,0,0,10,1,343,98,22608,27868,29411,2,25,12,2,1,2,0,0,412,112,29905,34042,29445,0,-69,-14,-7297,-9,-6174,-34,-2,-1,-2,0,10
EUN1_3567279620',1,29,17,0,0,2,0,5,1,363,116,30822,32778,34174,2,27,9,2,0,0,0,7,328,60,24447,27415,28174,1,35,56,6375,8,5363,6000,-2,0,2,0,-2
EUN1_3567256147',2,26,15,2,0,0,0,7,1,364,100,28883,30032,34721,2,71,7,0,0,0,0,3,371,69,25085,28505,41221,1,-7,31,3798,8,1527,-6500,2,0,0,0,4
EUN1_3567233116',4,32,14,0,0,0,0,8,0,342,80,28339,29389,34656,5,30,10,2,0,1,0,3,344,88,26554,28538,35191,0,-2,-8,1785,4,851,-535,-2,0,-1,0,5
EUN1_3567155557',1,48,11,0,0,0,0,8,1,389,68,27548,29363,36574,7,33,14,2,0,0,0,2,376,87,28178,29274,35385,0,13,-19,-630,-3,89,1189,-2,0,0,0,6
EUN1_3567136981',6,27,7,0,0,0,0,6,0,321,100,26159,26734,31117,6,50,24,1,0,3,0,3,350,108,33047,31795,37148,0,-29,-8,-6888,-17,-5061,-6031,-1,0,-3,0,3
EUN1_3566968064',4,26,20,2,1,1,0,8,1,326,119,31333,30459,43190,1,33,13,0,0,1,0,6,295,84,27576,27481,34467,1,31,35,3757,7,2978,8723,2,1,0,0,2
EUN1_3566928023',1,25,12,1,0,0,0,15,0,344,83,27618,29217,29902,5,182,24,1,0,2,0,4,389,124,35417,33552,38112,0,-45,-41,-7799,-12,-4335,-8210,0,0,-2,0,11
EUN1_3566917604',2,27,13,0,0,0,0,14,1,308,64,26342,24466,28854,5,33,23,2,0,3,0,2,345,92,34446,29365,41870,0,-37,-28,-8104,-10,-4899,-13016,-2,0,-3,0,12
EUN1_3566895340',2,33,17,1,0,2,0,8,0,369,99,31348,31710,32143,5,26,11,1,0,0,0,6,353,84,27703,30684,31446,0,16,15,3645,6,1026,697,0,0,2,0,2
EUN1_3566869703',4,26,17,1,1,0,0,6,1,331,74,29354,30498,43377,2,98,12,1,0,1,0,4,351,70,25902,30127,30062,0,-20,4,3452,5,371,13315,0,1,-1,0,2
EUN1_3566853193',5,28,9,1,1,2,0,7,0,342,86,27737,30157,30555,3,26,12,0,0,0,0,6,340,86,26663,29102,24652,0,2,0,1074,-3,1055,5903,1,1,2,0,1
EUN1_3569231400',4,27,9,2,0,0,0,5,1,380,94,26816,29434,28014,5,27,10,0,0,0,0,3,388,75,25623,31284,26984,0,-8,19,1193,-1,-1850,1030,2,0,0,0,2
EUN1_3568455522',3,52,19,1,0,1,0,7,0,295,72,28805,28427,40182,4,26,16,1,0,0,0,3,297,72,27728,25404,43655,1,-2,0,1077,3,3023,-3473,0,0,1,0,4
EUN1_3568438513',9,31,11,0,0,1,0,4,1,343,82,26989,29495,40309,4,24,18,1,1,0,0,4,334,90,28446,30075,35407,0,9,-8,-1457,-7,-580,4902,-1,-1,1,0,0
EUN1_3565706316',9,32,11,0,0,0,0,4,0,395,69,26550,30337,27204,3,44,10,1,0,0,0,1,370,96,26823,29691,27687,1,25,-27,-273,1,646,-483,-1,0,0,0,3
EUN1_3563888884',4,26,19,0,0,2,0,7,0,359,84,32469,31812,39847,9,33,16,2,0,0,0,7,345,92,28954,30250,32784,1,14,-8,3515,3,1562,7063,-2,0,2,0,0
EUN1_3562353361',6,25,18,2,0,1,0,6,1,365,72,30209,32678,33326,2,34,10,0,0,1,0,6,367,82,25843,29760,31819,1,-2,-10,4366,8,2918,1507,2,0,0,0,0
EUN1_3562332091',3,24,10,2,0,1,0,5,1,320,94,27730,27124,31680,3,57,10,0,0,0,0,5,339,96,25281,29899,30389,1,-19,-2,2449,0,-2775,1291,2,0,1,0,0
EUN1_3560264815',5,32,13,1,0,0,0,13,1,331,68,28688,27713,30749,5,30,16,0,0,1,0,3,356,96,30373,30050,41370,0,-25,-28,-1685,-3,-2337,-10621,1,0,-1,0,10
EUN1_3559845629',4,30,13,1,0,0,0,16,0,330,102,27977,29646,29702,2,24,14,1,1,3,0,2,419,90,32074,32714,35057,0,-89,12,-4097,-1,-3068,-5355,0,-1,-3,0,14
EUN1_3559822699',3,26,8,0,0,0,0,13,0,353,86,25397,28779,18386,6,51,13,2,0,1,0,4,373,98,29155,31075,34231,0,-20,-12,-3758,-5,-2296,-15845,-2,0,-1,0,9
EUN1_3559796768',3,24,14,0,0,0,0,9,0,313,89,27137,27942,29494,5,46,16,1,1,1,0,3,296,98,28364,28774,37139,1,17,-9,-1227,-2,-832,-7645,-1,-1,-1,0,6
EUN1_3559606875',1,22,15,1,0,0,0,5,0,368,111,29175,32064,38907,3,21,12,1,0,1,0,6,318,80,26332,29585,38350,1,50,31,2843,3,2479,557,0,0,-1,0,-1
EUN1_3559142617',2,31,10,0,0,0,0,10,1,324,91,25462,29524,30142,3,48,10,2,0,1,0,0,349,82,26222,28040,32102,1,-25,9,-760,0,1484,-1960,-2,0,-1,0,10
EUN1_3558832636',8,30,17,1,0,0,0,12,0,301,69,28920,27837,36509,7,33,16,1,0,1,0,3,289,83,28501,26984,34687,0,12,-14,419,1,853,1822,0,0,-1,0,9
EUN1_3558804683',4,26,6,1,0,1,0,12,0,322,103,24810,28320,25771,2,22,14,1,0,0,0,3,370,108,28950,32085,28472,0,-48,-5,-4140,-8,-3765,-2701,0,0,1,0,9
EUN1_3558780379',4,37,5,0,0,0,0,6,1,396,83,24991,29184,27894,6,39,9,1,0,1,0,3,372,86,25474,29980,26977,0,24,-3,-483,-4,-796,917,-1,0,-1,0,3
EUN1_3558666508',3,22,26,1,0,2,0,7,1,366,92,33579,33940,48261,0,21,9,1,0,0,0,7,303,76,25350,26018,38278,1,63,16,8229,17,7922,9983,0,0,2,0,0
EUN1_3558580054',4,27,6,1,0,0,0,9,0,352,92,24246,28244,28748,4,22,16,1,0,2,0,0,355,82,29650,29486,32443,0,-3,10,-5404,-10,-1242,-3695,0,0,-2,0,9
EUN1_3576219987',5,28,14,2,0,1,0,8,0,340,84,28222,29846,32427,4,40,9,0,0,1,0,6,299,78,25180,25600,34393,1,41,6,3042,5,4246,-1966,2,0,0,0,2
EUN1_3575991081',2,25,14,0,1,0,0,12,0,365,103,28663,31518,33257,5,29,14,1,0,0,0,2,331,111,28711,31846,32938,1,34,-8,-48,0,-328,319,-1,1,0,0,10
EUN1_3575961688',5,14,11,0,0,1,0,15,0,343,78,26120,29796,30433,2,23,16,1,0,2,0,4,321,121,30781,32823,43816,0,22,-43,-4661,-5,-3027,-13383,-1,0,-1,0,11
EUN1_3575934916',3,37,9,0,0,1,0,6,0,370,94,27102,29363,28549,4,36,10,2,0,0,0,5,314,93,25275,27690,30640,1,56,1,1827,-1,1673,-2091,-2,0,1,0,1
EUN1_3575895905',5,33,16,0,0,1,0,8,1,337,88,29036,29021,32625,3,144,16,2,0,0,0,7,320,88,28753,29869,36223,1,17,0,283,0,-848,-3598,-2,0,1,0,1
EUN1_3575851013',5,30,16,1,0,1,0,7,1,369,98,31098,31588,27929,5,24,10,1,0,1,0,9,321,86,25674,26505,29154,1,48,12,5424,6,5083,-1225,0,0,0,0,-2
EUN1_3575842284',3,28,14,1,0,1,0,11,1,335,107,28480,30317,36592,3,22,11,1,0,0,0,5,366,57,25280,28420,33466,1,-31,50,3200,3,1897,3126,0,0,1,0,6
EUN1_3575684736',2,30,13,1,0,1,0,8,1,344,86,26934,29658,31442,8,43,10,0,0,0,0,2,325,71,24668,29275,23198,0,19,15,2266,3,383,8244,1,0,1,0,6
EUN1_3573739582',2,26,11,0,0,0,0,9,0,352,80,25755,29595,32419,2,24,18,2,0,1,0,3,354,120,30844,32270,38563,0,-2,-40,-5089,-7,-2675,-6144,-2,0,-1,0,6
EUN1_3573720632',10,32,14,0,0,0,0,9,1,385,84,27390,30606,27584,1,135,9,2,0,0,0,2,398,100,26840,31818,23041,0,-13,-16,550,5,-1212,4543,-2,0,0,0,7
EUN1_3573674973',4,26,12,0,1,0,0,13,0,339,100,26613,30643,26259,3,21,13,2,0,1,0,1,344,92,28560,29264,27356,0,-5,8,-1947,-1,1379,-1097,-2,1,-1,0,12
EUN1_3573656697',4,23,9,1,0,1,0,6,0,362,72,26434,29468,28769,4,132,6,0,0,1,0,4,279,80,22445,28079,28301,1,83,-8,3989,3,1389,468,1,0,0,0,2
EUN1_3573600113',7,23,8,0,1,0,0,6,0,326,80,24687,28367,28683,3,80,19,2,0,0,0,3,317,82,28688,31464,39404,0,9,-2,-4001,-11,-3097,-10721,-2,1,0,0,3
EUN1_3573384407',2,28,10,1,0,1,0,10,0,339,78,27355,29279,25286,2,20,13,0,0,1,0,4,350,81,27236,30195,35717,0,-11,-3,119,-3,-916,-10431,1,0,0,0,6
EUN1_3573363477',5,29,21,2,0,1,0,9,0,312,94,30585,31772,42928,3,19,13,0,0,0,0,4,289,77,25945,28574,32793,1,23,17,4640,8,3198,10135,2,0,1,0,5
EUN1_3573335621',1,29,15,2,0,0,0,3,1,374,90,28539,31747,37984,7,32,11,0,0,0,0,5,321,90,26696,28308,30840,1,53,0,1843,4,3439,7144,2,0,0,0,-2
EUN1_3573291909',4,22,8,0,0,0,0,7,0,354,86,24806,29016,26698,7,26,6,2,0,0,0,1,383,97,24752,30640,31011,1,-29,-11,54,2,-1624,-4313,-2,0,0,0,6
EUN1_3573250998',6,27,18,1,0,0,0,8,0,334,79,29789,29222,33848,4,37,18,0,0,0,0,2,307,100,29396,30804,37339,1,27,-21,393,0,-1582,-3491,1,0,0,0,6
EUN1_3573125324',0,21,7,1,0,0,0,8,0,334,70,24887,28120,20495,1,25,10,1,0,0,0,1,377,101,26029,29306,27868,1,-43,-31,-1142,-3,-1186,-7373,0,0,0,0,7
EUN1_3573100080',2,32,8,0,0,0,0,6,0,287,64,23591,26531,31760,2,21,14,1,0,1,0,1,333,96,26726,29540,34956,0,-46,-32,-3135,-6,-3009,-3196,-1,0,-1,0,5
EUN1_3575418973',5,32,13,0,0,1,0,6,1,356,98,29158,30989,30794,8,99,10,2,0,1,0,7,350,105,25638,27700,27812,0,6,-7,3520,3,3289,2982,-2,0,0,0,-1
EUN1_3575399185',1,60,12,0,0,0,0,6,1,376,80,27163,29996,38107,9,219,12,2,0,0,0,2,371,108,27930,30839,30481,0,5,-28,-767,0,-843,7626,-2,0,0,0,4
EUN1_3575364338',5,25,11,0,0,0,0,14,1,320,80,25783,30355,26551,4,25,11,1,0,3,0,3,359,112,29685,30624,33161,0,-39,-32,-3902,0,-269,-6610,-1,0,-3,0,11
EUN1_3575347109',4,165,14,1,0,0,0,7,1,355,76,27104,30759,28497,5,23,7,1,0,0,0,1,342,80,23652,28248,29029,1,13,-4,3452,7,2511,-532,0,0,0,0,6
EUN1_3574408216',10,76,12,1,0,0,0,3,1,342,84,25743,30194,36931,4,25,7,0,0,0,0,1,358,72,23779,28805,31136,0,-16,12,1964,5,1389,5795,1,0,0,0,2
EUN1_3574323227',5,28,15,1,0,2,0,9,1,346,84,28988,29998,31373,6,25,7,0,0,0,0,6,331,84,23672,25626,25768,1,15,0,5316,8,4372,5605,1,0,2,0,3
EUN1_3574296036',3,24,13,0,0,1,0,6,0,351,89,29209,28736,36231,5,32,11,1,0,0,0,3,323,58,25003,26068,31699,1,28,31,4206,2,2668,4532,-1,0,1,0,3
EUN1_3574296101',4,33,20,2,0,3,0,9,0,325,100,31450,30473,42084,2,59,10,0,0,1,0,5,334,84,26036,28324,31825,1,-9,16,5414,10,2149,10259,2,0,2,0,4
EUN1_3573729632',4,79,8,0,0,0,0,10,0,355,74,25202,27633,27634,2,26,21,2,0,1,0,5,359,90,32081,33840,39933,0,-4,-16,-6879,-13,-6207,-12299,-2,0,-1,0,5
EUN1_3576118686',5,26,14,2,1,1,0,5,1,356,104,28904,30969,28774,6,25,4,0,0,0,0,4,372,83,22850,28271,16776,1,-16,21,6054,10,2698,11998,2,1,1,0,1
EUN1_3576101213',3,22,17,1,0,0,0,9,0,339,90,28733,30975,34929,8,26,14,1,1,0,0,2,304,94,27400,30369,27058,0,35,-4,1333,3,606,7871,0,-1,0,0,7
EUN1_3576075091',1,30,13,0,1,0,0,6,1,322,79,27170,27683,27479,0,25,19,1,0,0,0,2,288,84,27971,28146,33966,0,34,-5,-801,-6,-463,-6487,-1,1,0,0,4
EUN1_3576038816',5,29,8,0,0,0,0,9,0,315,96,25028,27956,23280,2,25,17,2,0,1,0,3,348,99,30949,30509,33086,0,-33,-3,-5921,-9,-2553,-9806,-2,0,-1,0,6
EUN1_3575864890',4,35,9,0,0,0,0,13,0,294,84,25214,27849,28877,4,20,24,2,0,1,0,0,311,105,31999,29160,40768,1,-17,-21,-6785,-15,-1311,-11891,-2,0,-1,0,13
EUN1_3575847931',5,25,14,1,0,0,0,10,0,358,91,27851,29700,30994,5,35,12,0,0,1,0,2,339,80,27052,28936,31533,1,19,11,799,2,764,-539,1,0,-1,0,8
EUN1_3574892612',5,201,17,0,0,3,0,7,1,399,90,32198,31448,36263,4,25,10,1,0,2,0,9,350,82,26135,29757,33119,1,49,8,6063,7,1691,3144,-1,0,1,0,-2
EUN1_3574870527',6,30,13,1,0,2,0,10,0,379,74,28612,28237,36092,0,49,16,1,0,0,0,7,317,84,28111,29339,34635,1,62,-10,501,-3,-1102,1457,0,0,2,0,3
EUN1_3574841220',5,36,14,1,0,1,0,10,1,329,74,27390,27732,28344,4,30,14,1,0,1,0,4,325,106,28328,28206,25531,0,4,-32,-938,0,-474,2813,0,0,0,0,6
EUN1_3574781101',2,22,20,1,1,1,0,8,1,351,112,33001,33422,50434,4,389,20,1,0,1,0,8,338,56,28888,29002,44095,1,13,56,4113,0,4420,6339,0,1,0,0,0
EUN1_3574472112',3,43,9,0,0,0,0,6,0,398,64,25504,28578,28959,0,23,9,2,0,0,0,1,364,104,26536,30132,28273,1,34,-40,-1032,0,-1554,686,-2,0,0,0,5
EUN1_3574435510',3,26,8,1,0,1,0,8,1,362,98,25533,28564,25062,1,18,9,1,0,1,0,2,348,90,26124,29134,24251,0,14,8,-591,-1,-570,811,0,0,0,0,6
EUN1_3574320611',7,37,11,0,0,0,0,8,1,377,99,29529,30628,31301,7,69,9,1,0,2,0,10,364,72,25696,28762,23930,1,13,27,3833,2,1866,7371,-1,0,-2,0,-2
EUN1_3574300338',4,20,9,1,0,0,0,10,0,320,92,25419,27360,31139,4,26,16,1,0,0,0,0,349,96,28882,30585,35174,0,-29,-4,-3463,-7,-3225,-4035,0,0,0,0,10
EUN1_3573716751',2,19,15,0,1,1,0,15,0,297,83,29030,26431,25256,1,25,18,2,0,3,0,8,311,96,30870,29916,36593,1,-14,-13,-1840,-3,-3485,-11337,-2,1,-2,0,7
EUN1_3573702368',5,27,13,2,0,0,0,11,0,364,84,27953,29261,31524,4,23,10,0,0,2,0,5,355,88,27386,29119,30593,1,9,-4,567,3,142,931,2,0,-2,0,6
EUN1_3573598916',0,17,6,1,0,0,0,13,0,292,95,22784,26049,23721,2,25,22,1,1,1,0,1,352,84,31321,32147,33117,0,-60,11,-8537,-16,-6098,-9396,0,-1,-1,0,12
EUN1_3573588468',4,21,20,0,0,0,0,13,0,263,74,27678,28128,34262,3,20,21,0,0,2,0,2,361,66,31907,29781,45263,1,-98,8,-4229,-1,-1653,-11001,0,0,-2,0,11
EUN1_3573577622',3,23,9,1,0,0,0,11,0,312,82,24223,25763,20562,5,33,17,1,0,2,0,2,396,96,30009,30224,34616,0,-84,-14,-5786,-8,-4461,-14054,0,0,-2,0,9
EUN1_3566737511',3,26,16,1,1,1,0,9,1,364,93,31558,30585,32546,7,29,10,1,0,1,0,6,337,82,25616,26376,28053,1,27,11,5942,6,4209,4493,0,1,0,0,3
EUN1_3566720265',2,149,12,2,0,2,0,9,1,333,88,28578,28653,32418,7,24,17,0,0,1,0,6,373,80,29699,31026,32533,1,-40,8,-1121,-5,-2373,-115,2,0,1,0,3
EUN1_3565313556',8,27,16,0,1,1,0,6,1,358,84,29858,29127,34117,3,25,15,1,0,1,0,6,331,91,28414,29694,37715,0,27,-7,1444,1,-567,-3598,-1,1,0,0,0
EUN1_3565291770',6,30,18,1,0,3,0,5,1,377,102,33944,31592,38828,5,30,8,1,0,1,0,9,313,70,24134,26889,32859,1,64,32,9810,10,4703,5969,0,0,2,0,-4
EUN1_3563904800',3,28,9,0,0,0,0,9,0,333,76,25066,29086,24049,4,29,10,2,0,2,0,2,378,88,28039,29921,27234,0,-45,-12,-2973,-1,-835,-3185,-2,0,-2,0,7
EUN1_3563889133',4,72,19,0,0,2,0,6,1,316,68,29944,29236,41260,2,32,9,1,0,0,0,4,303,103,24429,26464,28520,1,13,-35,5515,10,2772,12740,-1,0,2,0,2
EUN1_3563865160',4,31,16,2,0,0,0,4,0,385,104,30337,31534,29343,6,22,10,0,0,0,0,6,379,60,26482,28787,28644,1,6,44,3855,6,2747,699,2,0,0,0,-2
EUN1_3575966514',3,25,11,1,0,0,0,10,1,332,92,26729,28167,26976,4,81,9,0,0,1,0,6,384,79,26812,29286,24011,0,-52,13,-83,2,-1119,2965,1,0,-1,0,4
EUN1_3575947093',4,24,18,1,0,1,0,14,1,313,78,28490,29887,41103,0,26,11,1,0,2,0,4,335,93,28220,30065,37163,1,-22,-15,270,7,-178,3940,0,0,-1,0,10
EUN1_3567290614',2,22,13,2,0,2,0,5,1,389,120,29644,33093,38519,2,19,4,0,0,0,0,8,338,76,22243,28751,23412,1,51,44,7401,9,4342,15107,2,0,2,0,-3
EUN1_3567268294',4,28,17,1,0,1,0,9,1,355,88,30731,30814,33997,4,26,7,1,0,1,0,5,365,76,24989,27182,22975,1,-10,12,5742,10,3632,11022,0,0,0,0,4
EUN1_3567246511',6,27,27,1,0,3,0,8,1,340,80,34976,30582,49504,1,31,11,0,0,1,0,10,255,88,25228,25414,27454,0,85,-8,9748,16,5168,22050,1,0,2,0,-2
EUN1_3567225415',0,45,18,2,0,0,0,5,1,372,104,29471,32353,33773,2,24,8,0,0,1,0,3,369,96,26558,29680,29781,1,3,8,2913,10,2673,3992,2,0,-1,0,2
EUN1_3567060626',3,28,10,1,0,0,0,8,1,385,83,27285,31287,32914,5,31,12,1,0,0,0,4,313,74,25852,28770,28626,1,72,9,1433,-2,2517,4288,0,0,0,0,4
EUN1_3565775091',4,26,18,0,0,0,0,3,1,349,65,28931,30557,38158,2,28,15,2,0,0,0,4,337,72,27226,29790,37541,0,12,-7,1705,3,767,617,-2,0,0,0,-1
EUN1_3565754549',4,22,10,0,1,0,0,12,1,334,90,26913,29347,23245,2,22,15,2,0,1,0,1,373,78,28975,29861,36506,0,-39,12,-2062,-5,-514,-13261,-2,1,-1,0,11
EUN1_3562722305',3,26,9,1,0,0,0,8,1,337,86,25574,28631,28747,1,22,13,1,0,1,0,4,326,94,27184,30456,29577,0,11,-8,-1610,-4,-1825,-830,0,0,-1,0,4
EUN1_3575799912',7,74,8,1,0,0,0,11,0,327,104,25370,29169,27721,3,25,20,1,0,2,0,0,391,84,31538,32830,36055,0,-64,20,-6168,-12,-3661,-8334,0,0,-2,0,11
EUN1_3573843760',3,36,13,2,0,0,0,8,0,361,86,27842,29538,33036,4,30,15,0,0,0,0,4,341,88,28515,29262,32182,1,20,-2,-673,-2,276,854,2,0,0,0,4
EUN1_3573820573',6,31,14,1,0,2,0,6,0,353,78,29292,28224,37496,1,36,19,0,0,0,0,6,330,71,30012,28063,40104,0,23,7,-720,-5,161,-2608,1,0,2,0,0
EUN1_3573728264',0,28,24,1,0,2,0,9,1,323,82,33527,29415,38028,5,34,8,0,0,0,0,2,298,86,24558,25464,29617,1,25,-4,8969,16,3951,8411,1,0,2,0,7
EUN1_3573703903',1,19,17,0,0,0,0,14,0,316,86,29422,29553,36021,1,22,22,2,0,2,0,1,302,103,30860,30681,38737,0,14,-17,-1438,-5,-1128,-2716,-2,0,-2,0,13
EUN1_3573681934',3,32,13,2,0,1,0,9,1,293,70,25577,26360,27605,2,17,10,0,0,2,0,3,324,73,27750,25979,32848,1,-31,-3,-2173,3,381,-5243,2,0,-1,0,6
EUN1_3573673401',7,32,19,2,1,0,0,8,1,368,88,28971,30797,40222,8,31,12,0,0,0,0,5,341,76,26137,28689,36295,0,27,12,2834,7,2108,3927,2,1,0,0,3
EUN1_3573568471',1,25,11,1,0,0,0,7,0,320,82,25668,27167,31200,2,31,15,0,0,1,0,1,334,84,28352,29222,33188,1,-14,-2,-2684,-4,-2055,-1988,1,0,-1,0,6
EUN1_3573558206',2,31,11,2,0,1,0,13,1,371,96,27528,28950,24265,3,37,11,0,0,1,0,4,332,96,26992,30530,24202,1,39,0,536,0,-1580,63,2,0,0,0,9
EUN1_3573242943',5,55,15,0,0,0,0,7,0,324,85,28018,29169,34305,3,21,16,1,0,0,0,2,304,89,28082,29171,36135,1,20,-4,-64,-1,-2,-1830,-1,0,0,0,5
EUN1_3572997558',0,15,12,0,1,0,0,13,0,317,86,25985,29595,24725,1,25,9,2,0,2,0,5,376,92,27395,29366,30207,0,-59,-6,-1410,3,229,-5482,-2,1,-2,0,8
EUN1_3572520049',0,27,16,2,0,0,0,8,1,355,92,28263,30443,33620,7,28,17,0,1,1,0,3,333,72,30053,30465,30628,0,22,20,-1790,-1,-22,2992,2,-1,-1,0,5
EUN1_3573137449',3,24,15,1,0,2,0,11,1,372,100,31286,31874,34042,7,31,14,1,0,2,0,7,294,84,27148,28254,28521,1,78,16,4138,1,3620,5521,0,0,0,0,4
EUN1_3573111900',3,25,16,0,0,1,0,3,1,383,84,29744,32240,32415,4,24,5,2,0,0,0,7,305,110,22487,28177,30961,0,78,-26,7257,11,4063,1454,-2,0,1,0,-4
EUN1_3574718525',0,20,11,0,0,0,0,12,1,304,92,25386,29329,27523,5,35,5,2,0,2,0,4,363,88,26178,28552,29505,0,-59,4,-792,6,777,-1982,-2,0,-2,0,8
EUN1_3574703376',3,25,15,0,0,0,0,11,0,316,72,28161,28128,34736,1,20,12,2,0,2,0,4,315,70,27310,28961,25250,0,1,2,851,3,-833,9486,-2,0,-2,0,7
EUN1_3574690417',1,68,11,1,0,0,0,11,1,263,76,24704,25998,27653,5,53,10,1,0,3,0,3,325,96,27739,29968,33724,0,-62,-20,-3035,1,-3970,-6071,0,0,-3,0,8
EUN1_3573127006',2,146,8,1,0,1,0,13,0,374,56,26322,29169,25587,4,21,13,1,0,1,0,6,368,87,27743,31363,30352,0,6,-31,-1421,-5,-2194,-4765,0,0,0,0,7
EUN1_3572333294',6,43,13,0,0,0,0,10,0,327,76,26185,28667,27575,0,20,12,2,0,0,0,4,305,81,25181,28253,33391,0,22,-5,1004,1,414,-5816,-2,0,0,0,6
EUN1_3571794270',6,21,12,0,0,0,0,7,1,349,94,26902,28997,34943,3,22,13,1,0,0,0,2,324,74,27242,27942,27689,0,25,20,-340,-1,1055,7254,-1,0,0,0,5
EUN1_3571769671',3,23,8,0,0,0,0,14,0,311,84,23755,27526,23743,6,39,5,1,0,2,0,3,374,84,25229,27704,28372,0,-63,0,-1474,3,-178,-4629,-1,0,-2,0,11
EUN1_3571747747',2,17,5,0,0,0,0,10,0,295,68,21651,26484,26023,1,21,14,1,0,2,0,2,330,96,28746,31426,35513,0,-35,-28,-7095,-9,-4942,-9490,-1,0,-2,0,8
EUN1_3571191536',0,21,8,0,0,0,0,7,0,375,76,23256,30425,19849,3,413,12,1,0,1,0,1,334,106,26891,30350,29923,0,41,-30,-3635,-4,75,-10074,-1,0,-1,0,6
EUN1_3571178132',3,29,16,2,1,1,0,8,1,353,68,27562,29338,38726,4,32,6,0,0,1,0,4,315,88,24396,27521,24114,1,38,-20,3166,10,1817,14612,2,1,0,0,4
EUN1_3563615941',1,203,29,2,0,1,0,3,0,327,76,34512,32907,47983,3,23,10,0,0,1,0,7,302,64,26030,27296,37033,1,25,12,8482,19,5611,10950,2,0,0,0,-4
EUN1_3563614474',4,41,19,2,0,1,0,5,1,324,90,30466,30527,36410,6,29,15,0,0,0,0,4,299,82,28144,27823,29204,1,25,8,2322,4,2704,7206,2,0,1,0,1
EUN1_3563601985',5,28,11,0,0,0,0,10,1,325,52,27065,27983,28270,2,165,15,2,0,2,0,2,348,95,29704,30857,34054,0,-23,-43,-2639,-4,-2874,-5784,-2,0,-2,0,8
EUN1_3563590901',3,42,15,1,0,2,0,12,1,370,78,30940,31484,33289,0,27,14,1,0,0,0,4,344,68,27800,29751,35164,0,26,10,3140,1,1733,-1875,0,0,2,0,8
EUN1_3563578788',5,29,11,0,0,0,0,11,0,316,82,27187,30055,34583,2,27,22,1,0,1,0,1,355,77,30282,30468,36233,1,-39,5,-3095,-11,-413,-1650,-1,0,-1,0,10
EUN1_3562291628',3,34,18,1,0,0,0,15,0,326,92,29521,30344,32511,2,18,15,0,0,1,0,3,338,84,29838,29491,29999,1,-12,8,-317,3,853,2512,1,0,-1,0,12
EUN1_3562276323',4,20,18,0,0,0,0,10,1,296,62,29369,27986,33408,5,28,14,1,0,1,0,7,279,78,27217,28062,30738,1,17,-16,2152,4,-76,2670,-1,0,-1,0,3
EUN1_3562252017',4,29,19,1,0,1,0,11,0,270,93,30177,27773,40484,9,94,20,0,0,2,0,2,289,64,29325,28744,38777,0,-19,29,852,-1,-971,1707,1,0,-1,0,9
EUN1_3562231120',0,33,16,1,0,0,0,11,0,290,72,27245,28798,33497,2,44,17,0,0,1,0,2,327,102,30350,29552,39165,0,-37,-30,-3105,-1,-754,-5668,1,0,-1,0,9
EUN1_3562212529',3,26,19,0,0,1,0,8,0,280,90,30727,27223,37552,2,25,15,1,0,2,0,7,254,70,26522,25624,31001,1,26,20,4205,4,1599,6551,-1,0,-1,0,1
EUN1_3562193932',4,30,18,1,1,3,0,8,1,302,94,31389,29595,36648,3,48,21,1,0,0,0,6,260,82,28518,28768,42614,1,42,12,2871,-3,827,-5966,0,1,3,0,2
EUN1_3571656797',2,23,11,0,0,0,0,9,1,289,72,24458,26769,29457,2,31,16,1,0,1,0,2,346,87,28910,30008,34094,0,-57,-15,-4452,-5,-3239,-4637,-1,0,-1,0,7
EUN1_3571620591',1,176,13,1,0,2,0,6,0,354,87,28898,31150,33770,4,25,10,1,0,0,0,9,327,88,25596,30274,28949,1,27,-1,3302,3,876,4821,0,0,2,0,-3
EUN1_3571588410',0,32,11,1,0,0,0,6,0,283,80,24580,28503,29281,3,26,10,1,0,0,0,2,314,85,24686,28460,30438,0,-31,-5,-106,1,43,-1157,0,0,0,0,4
EUN1_3571563229',3,21,11,0,0,0,0,6,1,307,72,25289,27236,30329,2,25,13,1,0,0,0,3,345,84,26555,29127,30608,0,-38,-12,-1266,-2,-1891,-279,-1,0,0,0,3
EUN1_3571474465',0,37,12,0,0,2,0,5,1,354,88,28036,30468,29323,2,46,4,1,0,0,0,8,283,87,21558,25119,21346,1,71,1,6478,8,5349,7977,-1,0,2,0,-3
EUN1_3571395845',1,20,20,1,0,0,0,5,1,269,80,26705,27106,37076,3,152,12,0,0,0,0,2,323,68,26946,28152,46196,0,-54,12,-241,8,-1046,-9120,1,0,0,0,3
EUN1_3571376015',5,34,16,2,1,1,0,9,0,326,90,28534,29967,34006,7,35,7,0,0,1,0,6,319,90,25303,26562,21856,1,7,0,3231,9,3405,12150,2,1,0,0,3
EUN1_3571368637',1,22,13,2,1,1,0,3,1,392,76,29601,31610,32011,2,22,7,0,0,0,0,6,280,80,23014,27040,19922,1,112,-4,6587,6,4570,12089,2,1,1,0,-3
EUN1_3567242038',1,26,4,0,0,0,0,10,0,268,70,21177,25295,20064,2,161,11,2,0,2,0,1,355,100,27829,30617,34353,0,-87,-30,-6652,-7,-5322,-14289,-2,0,-2,0,9
EUN1_3567055544',3,170,9,0,0,0,0,12,0,334,76,25908,27948,31741,2,24,20,0,0,2,0,0,352,90,31597,31741,44414,0,-18,-14,-5689,-11,-3793,-12673,0,0,-2,0,12
EUN1_3567045159',5,52,10,1,0,0,0,7,0,241,82,24422,27047,30495,6,25,21,0,0,2,0,1,379,86,31139,33117,41057,0,-138,-4,-6717,-11,-6070,-10562,1,0,-2,0,6
EUN1_3566583167',4,30,11,1,0,1,0,5,1,342,88,27057,28035,32499,2,25,12,0,0,0,0,6,282,64,25059,27423,31872,1,60,24,1998,-1,612,627,1,0,1,0,-1
EUN1_3573135814',1,28,11,1,1,1,0,9,0,355,100,27474,29855,31578,3,25,21,0,0,1,0,0,338,95,30964,32256,38675,0,17,5,-3490,-10,-2401,-7097,1,1,0,0,9
EUN1_3573096770',3,60,8,2,0,0,0,7,0,436,112,27583,31629,25081,5,22,11,0,1,0,0,5,374,100,25775,30969,21964,0,62,12,1808,-3,660,3117,2,-1,0,0,2
EUN1_3573082165',7,29,22,2,0,1,0,7,1,336,75,31834,30611,43099,3,30,11,0,0,1,0,4,332,88,26370,29171,32150,0,4,-13,5464,11,1440,10949,2,0,0,0,3
EUN1_3573068074',0,27,10,1,0,0,0,3,0,343,110,26574,29991,30982,3,94,18,1,0,0,0,4,373,86,29469,32854,33758,0,-30,24,-2895,-8,-2863,-2776,0,0,0,0,-1
EUN1_3573043171',2,21,16,1,0,1,0,8,1,385,107,30354,32686,34401,5,149,9,1,0,0,0,6,387,88,26256,30070,35237,1,-2,19,4098,7,2616,-836,0,0,1,0,2
EUN1_3568908911',4,31,13,1,0,0,0,5,1,380,106,28189,31160,26505,2,41,4,1,0,0,0,4,431,96,25249,29803,18043,0,-51,10,2940,9,1357,8462,0,0,0,0,1
EUN1_3568470354',0,23,8,1,0,0,0,7,0,350,86,24636,27974,30987,3,41,12,1,1,0,0,2,366,87,27563,31014,34620,0,-16,-1,-2927,-4,-3040,-3633,0,-1,0,0,5
EUN1_3568449264',5,172,8,0,0,0,0,8,0,367,70,25233,29248,27264,3,22,6,1,0,1,0,3,403,95,26048,29592,23341,0,-36,-25,-815,2,-344,3923,-1,0,-1,0,5
EUN1_3568432737',1,25,9,1,0,0,0,12,0,323,82,25078,28849,30577,2,27,13,1,1,3,0,1,399,94,31253,30049,34114,0,-76,-12,-6175,-4,-1200,-3537,0,-1,-3,0,11
EUN1_3568174434',7,31,8,2,0,0,0,11,0,348,86,24943,29425,26776,1,305,11,0,1,1,0,0,354,110,27942,31649,32557,0,-6,-24,-2999,-3,-2224,-5781,2,-1,-1,0,11
EUN1_3568147908',7,36,9,0,0,2,0,9,1,383,74,27150,28276,28486,7,36,14,2,0,1,0,7,292,102,27567,28899,29631,0,91,-28,-417,-5,-623,-1145,-2,0,1,0,2
EUN1_3574303813',1,26,16,0,0,1,0,2,0,340,84,29430,28844,39859,2,25,16,2,0,0,0,5,276,56,26567,26860,31266,0,64,28,2863,0,1984,8593,-2,0,1,0,-3
EUN1_3574284600',3,20,10,0,0,0,0,5,0,352,70,25950,30127,31762,1,25,15,1,0,1,0,5,329,82,27735,29272,32892,1,23,-12,-1785,-5,855,-1130,-1,0,-1,0,0
EUN1_3574224498',1,22,10,1,0,1,0,5,0,332,92,26047,28969,38236,8,46,11,1,0,1,0,4,321,77,25659,29825,25449,0,11,15,388,-1,-856,12787,0,0,0,0,1
EUN1_3574164657',3,29,15,1,0,1,0,6,0,311,76,27850,29987,34243,5,23,12,1,0,0,0,4,322,76,25544,28745,35752,1,-11,0,2306,3,1242,-1509,0,0,1,0,2
EUN1_3574149721',2,26,10,1,0,1,0,7,1,352,108,25940,31114,29785,5,41,10,0,0,0,0,3,329,92,24850,29482,24734,0,23,16,1090,0,1632,5051,1,0,1,0,4
EUN1_3573780131',1,32,13,1,0,1,0,11,1,319,66,25950,28628,32130,0,21,14,0,0,1,0,4,314,106,28024,29489,33982,1,5,-40,-2074,-1,-861,-1852,1,0,0,0,7
EUN1_3573342306',2,173,5,0,0,2,0,7,0,384,90,26970,29835,32202,5,22,8,0,0,0,0,10,341,72,24494,27495,23635,1,43,18,2476,-3,2340,8567,0,0,2,0,-3
EUN1_3573293278',4,28,15,2,1,0,0,7,1,332,78,27415,30127,31986,4,24,7,0,0,1,0,3,351,86,25097,29639,28800,1,-19,-8,2318,8,488,3186,2,1,-1,0,4
EUN1_3572328062',6,41,26,2,0,2,0,7,1,358,101,34109,32305,40696,4,25,6,0,0,0,0,8,256,49,20548,23322,20080,1,102,52,13561,20,8983,20616,2,0,2,0,-1
EUN1_3566723304',6,30,29,2,0,3,0,8,1,389,103,38067,35717,45857,2,23,6,0,0,2,0,10,317,57,23096,24348,30912,1,72,46,14971,23,11369,14945,2,0,1,0,-2
EUN1_3566710105',4,35,17,0,0,0,0,9,1,352,76,30706,31574,37530,7,22,13,1,0,1,0,5,313,80,27891,30435,30738,1,39,-4,2815,4,1139,6792,-1,0,-1,0,4
EUN1_3566690633',3,28,8,0,0,0,0,13,0,298,57,24552,26693,23165,2,24,24,0,0,2,0,1,406,96,33677,33520,39502,0,-108,-39,-9125,-16,-6827,-16337,0,0,-2,0,12
EUN1_3566676355',3,155,9,0,0,1,0,12,0,346,86,27001,30179,29471,1,24,11,1,0,1,0,6,397,102,28181,31203,28080,0,-51,-16,-1180,-2,-1024,1391,-1,0,0,0,6
EUN1_3566659311',1,22,13,0,0,0,0,9,1,359,72,26859,31852,33873,4,39,6,1,0,0,0,3,346,104,24044,29343,23982,1,13,-32,2815,7,2509,9891,-1,0,0,0,6
EUN1_3566623616',5,28,6,1,0,0,0,5,0,370,80,24381,27071,29007,7,44,12,0,1,1,0,2,370,80,27828,30906,36691,0,0,0,-3447,-6,-3835,-7684,1,-1,-1,0,3
EUN1_3566608753',5,46,9,0,0,0,0,9,1,282,71,24095,24555,35248,2,25,22,1,0,1,0,2,304,64,30773,29345,51191,0,-22,7,-6678,-13,-4790,-15943,-1,0,-1,0,7
EUN1_3566591558',1,142,11,0,0,2,0,7,1,355,80,27914,30395,34006,1,53,10,2,0,0,0,8,335,98,26253,29229,31674,0,20,-18,1661,1,1166,2332,-2,0,2,0,-1
EUN1_3566580732',7,35,23,1,0,1,0,7,1,354,80,31743,31350,39152,2,22,4,1,0,1,0,4,301,84,22820,25610,18619,1,53,-4,8923,19,5740,20533,0,0,0,0,3
EUN1_3566558959',2,18,19,1,0,1,0,8,0,351,80,30414,30596,49982,1,28,15,1,0,0,0,7,315,70,27717,28708,43889,1,36,10,2697,4,1888,6093,0,0,1,0,1
EUN1_3566257960',5,25,19,0,0,1,0,9,1,349,98,30675,32128,38378,3,22,9,1,1,0,0,5,351,98,26380,29219,27693,0,-2,0,4295,10,2909,10685,-1,-1,1,0,4
EUN1_3565942863',2,32,17,0,0,2,0,7,0,361,100,30388,32542,32829,4,34,10,1,0,1,0,5,298,88,24750,26138,36788,0,63,12,5638,7,6404,-3959,-1,0,1,0,2
EUN1_3565926687',4,24,14,1,0,0,0,8,1,271,92,25448,28072,36307,0,11,16,1,0,0,0,2,359,94,28763,31616,38157,0,-88,-2,-3315,-2,-3544,-1850,0,0,0,0,6
EUN1_3565912089',1,20,17,0,1,1,0,12,0,334,86,30432,30598,39543,5,135,17,1,0,1,0,5,345,90,29833,31337,34614,1,-11,-4,599,0,-739,4929,-1,1,0,0,7
EUN1_3565873802',1,26,4,0,0,0,0,10,0,315,79,23453,26328,27572,2,21,14,1,0,2,0,2,419,96,29383,31809,36286,0,-104,-17,-5930,-10,-5481,-8714,-1,0,-2,0,8
EUN1_3565841958',2,23,12,0,0,0,0,9,0,273,108,25487,27050,32946,3,29,21,1,0,2,0,2,329,84,30831,31270,42648,0,-56,24,-5344,-9,-4220,-9702,-1,0,-2,0,7
EUN1_3565831476',2,24,14,2,0,3,0,4,0,359,96,29956,32591,38284,2,20,3,0,0,1,0,9,321,76,21745,26762,18076,1,38,20,8211,11,5829,20208,2,0,2,0,-5
EUN1_3565345673',3,34,4,0,0,0,0,14,0,309,69,22255,25893,21985,4,257,15,1,0,3,0,1,364,102,30731,30660,32734,0,-55,-33,-8476,-11,-4767,-10749,-1,0,-3,0,13
EUN1_3576137811',4,161,11,0,0,1,0,10,1,328,72,26997,27580,37662,1,249,18,1,0,1,0,6,325,88,29275,30838,30256,1,3,-16,-2278,-7,-3258,7406,-1,0,0,0,4
EUN1_3576116531',4,21,23,1,0,1,0,10,1,312,103,33507,29939,40782,3,20,15,0,0,2,0,9,301,69,28304,28083,34885,1,11,34,5203,8,1856,5897,1,0,-1,0,1
EUN1_3575963644',5,25,9,0,0,0,0,10,0,349,68,26651,27475,31449,5,21,28,1,0,1,0,6,286,92,30996,31370,42360,0,63,-24,-4345,-19,-3895,-10911,-1,0,-1,0,4
EUN1_3575945694',2,31,14,0,0,0,0,14,0,305,100,26625,27409,25552,2,27,22,2,0,2,0,1,361,89,32157,30969,41786,0,-56,11,-5532,-8,-3560,-16234,-2,0,-2,0,13
EUN1_3575792101',3,68,4,0,0,0,0,6,0,379,88,23631,27832,24350,3,34,10,1,0,0,0,1,374,94,25979,29984,27696,1,5,-6,-2348,-6,-2152,-3346,-1,0,0,0,5
EUN1_3575769128',3,71,18,1,1,0,0,7,1,340,78,27623,30866,31908,3,33,5,0,0,0,0,2,378,91,25464,29444,24457,1,-38,-13,2159,13,1422,7451,1,1,0,0,5
EUN1_3575647050',0,313,15,1,0,0,0,5,1,353,88,28581,29795,38575,3,18,13,1,0,1,0,4,334,76,26455,30952,31271,1,19,12,2126,2,-1157,7304,0,0,-1,0,1
EUN1_3570223008',3,24,26,1,0,0,0,5,0,335,95,32118,32759,48936,3,22,13,1,0,0,0,4,326,96,28016,29476,33789,1,9,-1,4102,13,3283,15147,0,0,0,0,1
EUN1_3570194899',3,41,17,0,0,1,0,7,1,370,100,30003,30452,31061,3,29,9,2,0,0,0,5,329,83,25926,28812,29070,0,41,17,4077,8,1640,1991,-2,0,1,0,2
EUN1_3570025184',3,23,18,1,0,2,0,7,0,395,78,30553,30976,33918,2,26,8,0,0,1,0,3,351,98,26162,30587,24983,1,44,-20,4391,10,389,8935,1,0,1,0,4
EUN1_3569892324',4,25,15,1,0,0,0,11,0,289,79,26415,29153,31993,4,28,13,0,0,2,0,0,351,92,28043,29587,33353,0,-62,-13,-1628,2,-434,-1360,1,0,-2,0,11
EUN1_3569859846',6,32,23,0,0,1,0,6,1,334,75,30255,30087,38472,4,27,11,1,0,0,0,4,311,84,25656,27485,30916,1,23,-9,4599,12,2602,7556,-1,0,1,0,2
EUN1_3569834729',1,20,12,1,0,0,0,9,0,340,80,27343,28675,30259,3,22,14,1,1,1,0,3,342,86,28885,30288,37882,1,-2,-6,-1542,-2,-1613,-7623,0,-1,-1,0,6
EUN1_3568127844',5,24,13,1,0,0,0,13,0,282,81,25979,25272,30984,2,48,17,1,0,2,0,2,325,86,30377,30036,38749,0,-43,-5,-4398,-4,-4764,-7765,0,0,-2,0,11
EUN1_3567903291',9,51,17,1,0,1,0,4,1,356,95,29641,30469,37447,2,27,12,1,0,0,0,6,362,70,26511,28885,26984,0,-6,25,3130,5,1584,10463,0,0,1,0,-2
EUN1_3563553760',4,53,14,0,0,1,0,8,0,314,72,28449,28664,35216,0,26,12,1,0,0,0,4,327,83,26870,28011,27145,0,-13,-11,1579,2,653,8071,-1,0,1,0,4
EUN1_3575139055',5,235,17,1,1,1,0,6,1,329,93,29069,29859,39092,4,198,7,0,0,0,0,4,343,98,24796,28305,31724,1,-14,-5,4273,10,1554,7368,1,1,1,0,2
EUN1_3574359567',1,25,22,1,0,3,0,15,0,321,100,33645,32809,38149,5,21,14,1,0,1,0,6,358,75,28152,28382,40762,1,-37,25,5493,8,4427,-2613,0,0,2,0,9
EUN1_3574339323',3,140,11,0,0,0,0,8,0,332,80,27135,29258,29254,3,24,17,1,0,0,0,4,401,88,28896,32708,34584,0,-69,-8,-1761,-6,-3450,-5330,-1,0,0,0,4
EUN1_3574319762',3,28,22,1,0,1,0,6,0,349,86,30761,31073,39935,3,29,9,1,0,0,0,4,305,69,23907,25843,26688,1,44,17,6854,13,5230,13247,0,0,1,0,2
EUN1_3574297727',5,29,20,1,0,3,0,5,0,360,94,31758,29830,39790,6,52,7,0,0,0,0,8,291,82,23145,25030,24353,1,69,12,8613,13,4800,15437,1,0,3,0,-3
EUN1_3576016863',3,24,13,0,0,0,0,14,0,277,71,25562,25600,28041,5,30,24,2,1,2,0,2,374,112,33968,31816,44018,0,-97,-41,-8406,-11,-6216,-15977,-2,-1,-2,0,12
EUN1_3575806037',5,25,18,1,0,1,0,12,1,322,79,28740,29825,33593,4,30,14,0,1,1,0,2,349,98,29191,31565,36250,1,-27,-19,-451,4,-1740,-2657,1,-1,0,0,10
EUN1_3575773251',3,32,10,1,0,0,0,8,0,348,80,26556,31117,31902,2,21,13,1,0,2,0,3,363,116,28721,31810,30806,0,-15,-36,-2165,-3,-693,1096,0,0,-2,0,5
EUN1_3575482251',1,53,14,0,0,0,0,15,0,256,76,25971,27345,31970,0,61,19,2,0,3,0,1,304,91,29981,29194,41025,0,-48,-15,-4010,-5,-1849,-9055,-2,0,-3,0,14
EUN1_3575452382',2,22,11,1,0,1,0,10,1,335,112,27960,28747,34567,3,71,15,1,1,1,0,5,343,84,29071,29266,34671,1,-8,28,-1111,-4,-519,-104,0,-1,0,0,5
EUN1_3575425483',3,38,18,0,0,1,0,10,1,344,84,30738,30402,38460,5,85,9,2,0,1,0,3,333,84,25404,27646,34485,0,11,0,5334,9,2756,3975,-2,0,0,0,7
EUN1_3575273808',1,24,10,0,0,0,0,15,0,349,93,27132,28639,26788,4,28,16,2,0,3,0,3,336,74,30474,28272,32259,0,13,19,-3342,-6,367,-5471,-2,0,-3,0,12
EUN1_3572571248',1,19,4,1,0,0,0,8,0,344,92,23200,27620,21732,4,28,14,0,1,2,0,3,381,87,29054,28326,27686,0,-37,5,-5854,-10,-706,-5954,1,-1,-2,0,5
EUN1_3572503510',5,22,10,1,0,0,0,3,0,338,108,25821,29179,30793,2,29,6,1,0,0,0,3,340,71,23393,28010,25231,1,-2,37,2428,4,1169,5562,0,0,0,0,0
EUN1_3572351456',1,20,14,2,0,0,0,10,1,323,79,26993,28076,32984,4,22,14,0,1,1,0,3,338,88,29234,29541,34676,0,-15,-9,-2241,0,-1465,-1692,2,-1,-1,0,7
EUN1_3572298168',0,25,7,0,0,0,0,4,0,379,96,26366,29996,28478,6,38,12,2,0,0,0,5,342,81,26432,30156,31102,0,37,15,-66,-5,-160,-2624,-2,0,0,0,-1
EUN1_3572170696',5,24,13,1,0,0,0,11,1,368,80,29149,29441,34783,4,99,20,1,0,2,0,5,359,104,32543,32680,38978,1,9,-24,-3394,-7,-3239,-4195,0,0,-2,0,6
EUN1_3572119712',3,22,10,0,0,0,0,11,0,338,101,24837,27632,30656,5,27,19,2,0,1,0,3,367,86,30503,32294,37115,0,-29,15,-5666,-9,-4662,-6459,-2,0,-1,0,8
EUN1_3572095607',3,23,13,1,0,0,0,8,1,385,86,27431,29305,32182,5,39,16,1,0,0,0,2,346,100,28188,31418,30461,1,39,-14,-757,-3,-2113,1721,0,0,0,0,6
EUN1_3572078266',5,38,10,0,0,0,0,13,0,388,90,26420,28298,27501,3,190,13,1,1,1,0,2,351,85,28652,30348,30822,1,37,5,-2232,-3,-2050,-3321,-1,-1,-1,0,11
EUN1_3572037876',6,32,14,1,0,0,0,9,1,363,80,28234,30311,36580,7,28,14,1,0,1,0,4,372,74,29035,31236,31947,0,-9,6,-801,0,-925,4633,0,0,-1,0,5
EUN1_3572029699',2,29,8,0,0,0,0,14,0,320,93,25090,27076,23240,2,23,21,2,1,3,0,0,392,99,33788,33221,39793,0,-72,-6,-8698,-13,-6145,-16553,-2,-1,-3,0,14
EUN1_3571771545',5,18,12,2,0,1,0,7,0,339,90,26978,27757,31633,2,37,13,0,1,1,0,5,344,122,28650,30114,27601,1,-5,-32,-1672,-1,-2357,4032,2,-1,0,0,2
EUN1_3573349462',1,20,13,1,0,1,0,12,1,334,105,27570,29716,27992,4,23,11,0,0,1,0,4,307,91,27664,30389,33463,0,27,14,-94,2,-673,-5471,1,0,0,0,8
EUN1_3573322181',4,28,12,0,0,0,0,6,1,334,77,26419,28799,30105,2,41,9,1,0,0,0,3,340,66,24284,27274,32605,0,-6,11,2135,3,1525,-2500,-1,0,0,0,3
EUN1_3573285991',4,24,15,0,0,0,0,8,1,339,70,27931,26709,38082,2,29,24,1,0,1,0,5,349,78,32982,31801,47426,0,-10,-8,-5051,-9,-5092,-9344,-1,0,-1,0,3
EUN1_3572570297',2,21,17,1,0,0,0,8,0,313,102,30144,29618,35867,5,246,13,1,0,0,0,3,350,62,27331,27213,33918,0,-37,40,2813,4,2405,1949,0,0,0,0,5
EUN1_3572560107',5,26,10,1,1,1,0,5,1,401,113,28019,31958,29194,1,339,4,1,0,0,0,3,406,102,24554,31979,27760,1,-5,11,3465,6,-21,1434,0,1,1,0,2
EUN1_3572546121',4,208,8,1,0,1,0,9,1,374,98,27213,30247,24131,3,133,6,1,0,1,0,1,383,86,24562,30151,22678,1,-9,12,2651,2,96,1453,0,0,0,0,8
EUN1_3572531382',4,22,12,1,0,0,0,9,0,325,102,26344,29319,39145,0,23,8,0,0,0,0,2,348,78,24881,29400,38043,1,-23,24,1463,4,-81,1102,1,0,0,0,7
EUN1_3572346157',4,36,16,0,0,0,0,10,1,338,90,28337,29879,29038,7,42,13,2,0,0,0,3,369,90,28605,30208,32083,0,-31,0,-268,3,-329,-3045,-2,0,0,0,7
EUN1_3571979273',4,24,8,1,0,1,0,8,1,362,70,25768,29834,31424,7,27,5,1,1,0,0,5,377,103,24609,29335,23742,1,-15,-33,1159,3,499,7682,0,-1,1,0,3
EUN1_3571912774',4,22,14,1,0,0,0,4,1,386,98,29245,32338,33417,3,41,9,1,0,0,0,8,350,98,25283,30051,32466,1,36,0,3962,5,2287,951,0,0,0,0,-4
EUN1_3571565773',2,22,8,1,0,0,0,6,1,329,103,24576,28153,25810,2,28,18,1,0,0,0,4,316,92,27756,30217,32130,1,13,11,-3180,-10,-2064,-6320,0,0,0,0,2
EUN1_3571538960',0,19,12,0,0,0,0,11,0,340,92,26802,30556,22619,1,25,10,2,0,1,0,2,351,104,28154,30212,26075,0,-11,-12,-1352,2,344,-3456,-2,0,-1,0,9
EUN1_3571507740',2,21,20,2,0,1,0,9,0,333,98,30384,32000,39058,0,218,10,0,0,2,0,5,271,82,26162,30148,29398,1,62,16,4222,10,1852,9660,2,0,-1,0,4
EUN1_3571490435',3,20,9,0,0,0,0,9,1,367,104,25779,30203,22904,7,35,13,2,0,1,0,1,399,92,28480,31996,32796,0,-32,12,-2701,-4,-1793,-9892,-2,0,-1,0,8
EUN1_3571052868',5,32,9,0,0,0,0,7,0,381,79,25995,29733,29726,12,92,14,2,0,0,0,3,351,84,28113,28846,38079,1,30,-5,-2118,-5,887,-8353,-2,0,0,0,4
EUN1_3570303208',6,23,14,1,1,0,0,7,1,340,76,27349,29540,28909,4,25,6,1,0,0,0,1,334,84,22467,28787,27107,1,6,-8,4882,8,753,1802,0,1,0,0,6
EUN1_3570279464',1,26,11,1,0,0,0,8,0,342,78,25420,29859,35609,3,32,17,1,1,1,0,0,328,108,28815,29363,32554,0,14,-30,-3395,-6,496,3055,0,-1,-1,0,8
EUN1_3569991702',2,24,8,0,0,1,0,5,1,324,70,25171,26266,33777,3,24,11,2,0,1,0,3,317,94,26722,29511,35389,0,7,-24,-1551,-3,-3245,-1612,-2,0,0,0,2
EUN1_3569985356',3,34,11,1,0,0,0,9,1,373,72,26840,29766,23697,2,25,12,0,0,1,0,3,401,96,28668,31948,29014,1,-28,-24,-1828,-1,-2182,-5317,1,0,-1,0,6
EUW1_6864548608',4,37,6,0,0,0,0,8,1,355,71,24858,27714,23340,3,31,14,1,0,1,0,9,375,72,27334,29035,32818,0,-20,-1,-2476,-8,-1321,-9478,-1,0,-1,0,-1
EUW1_6864535547',5,188,13,1,0,0,0,13,0,347,123,28289,30570,32133,3,53,12,0,1,1,0,0,372,84,27913,29638,26631,0,-25,39,376,1,932,5502,1,-1,-1,0,13
EUW1_6864513325',1,26,22,2,1,3,0,8,1,369,110,33419,33983,42810,1,171,6,0,0,0,0,8,311,88,24131,26673,25725,1,58,22,9288,16,7310,17085,2,1,3,0,0
EUW1_6864501979',6,21,10,2,0,1,0,11,1,372,98,27049,28833,25515,4,28,11,0,0,2,0,4,332,68,26756,26288,25223,1,40,30,293,-1,2545,292,2,0,-1,0,7
EUW1_6864463152',2,73,16,0,1,1,0,15,1,277,86,27816,28654,28598,4,27,15,1,0,1,0,1,353,76,28512,28996,36735,0,-76,10,-696,1,-342,-8137,-1,1,0,0,14
EUW1_6864439843',3,26,14,1,0,1,0,11,1,372,82,29448,31004,30300,3,27,17,1,0,1,0,6,338,101,29830,32267,34490,0,34,-19,-382,-3,-1263,-4190,0,0,0,0,5
EUW1_6864389054',5,29,10,1,0,1,0,8,1,376,92,27917,29539,25786,1,27,7,1,0,1,0,4,309,76,23044,27279,26725,0,67,16,4873,3,2260,-939,0,0,0,0,4
EUW1_6864341183',4,25,6,0,0,0,0,5,1,396,97,26508,30016,23866,8,28,8,2,1,1,0,1,416,117,26569,32364,24169,1,-20,-20,-61,-2,-2348,-303,-2,-1,-1,0,4
EUW1_6864286843',3,138,9,1,1,3,0,4,1,408,114,29652,32181,27511,5,97,5,0,0,0,0,11,388,85,24750,29954,16175,1,20,29,4902,4,2227,11336,1,1,3,0,-7
EUW1_6864239732',4,27,14,1,0,0,0,6,1,351,102,29256,28929,32947,6,43,6,1,0,0,0,5,341,94,23356,28734,22502,1,10,8,5900,8,195,10445,0,0,0,0,1
EUW1_6864156481',3,248,15,1,1,1,0,6,1,334,81,29951,29298,30458,2,21,11,1,0,0,0,5,324,84,25954,29088,29527,1,10,-3,3997,4,210,931,0,1,1,0,1
EUW1_6864051055',8,57,11,0,0,0,0,4,0,340,67,25409,27843,29496,1,75,16,1,0,0,0,2,368,86,29193,31028,39105,0,-28,-19,-3784,-5,-3185,-9609,-1,0,0,0,2
EUW1_6863982140',2,42,5,0,0,0,0,12,0,365,100,25551,28358,23309,4,32,14,1,0,3,0,4,415,88,29686,32053,33259,0,-50,12,-4135,-9,-3695,-9950,-1,0,-3,0,8
EUW1_6863914305',3,50,19,2,0,1,0,7,0,349,102,30604,30677,42907,4,25,9,0,0,0,0,2,321,81,24595,26111,23162,1,28,21,6009,10,4566,19745,2,0,1,0,5
EUW1_6863174371',5,29,9,0,1,0,0,6,0,406,88,28116,31672,23942,4,31,11,1,0,2,0,5,430,100,28749,31826,27616,0,-24,-12,-633,-2,-154,-3674,-1,1,-2,0,1
EUW1_6863149899',6,23,13,1,0,2,0,6,1,333,95,28854,31470,30907,5,24,5,1,0,0,0,8,368,83,24020,29464,31471,0,-35,12,4834,8,2006,-564,0,0,2,0,-2
EUW1_6863120450',2,83,23,0,0,1,0,9,1,340,94,31908,30350,42302,5,25,4,2,0,1,0,7,320,74,22344,25506,21453,1,20,20,9564,19,4844,20849,-2,0,0,0,2
EUW1_6863092424',4,29,16,1,0,2,0,8,0,363,104,30220,32178,37930,4,32,12,0,0,0,0,4,350,79,26771,28951,39378,1,13,25,3449,4,3227,-1448,1,0,2,0,4
EUN1_3563836753',4,22,10,2,1,2,0,13,1,370,92,28094,31170,27831,2,16,8,0,0,1,0,4,351,96,24889,29716,24438,1,19,-4,3205,2,1454,3393,2,1,1,0,9
EUN1_3563818661',7,28,16,0,0,0,0,14,0,315,74,28154,27645,36657,0,24,17,1,0,0,0,2,321,74,29300,28870,38046,0,-6,0,-1146,-1,-1225,-1389,-1,0,0,0,12
EUN1_3563768042',7,54,12,0,0,0,0,9,1,329,74,27474,27273,29377,0,44,10,1,0,1,0,4,337,94,25560,27965,27755,0,-8,-20,1914,2,-692,1622,-1,0,-1,0,5
EUN1_3563753079',1,30,15,1,0,0,0,13,0,312,88,28333,31069,36679,4,23,11,1,0,0,0,2,370,95,27043,30310,33104,0,-58,-7,1290,4,759,3575,0,0,0,0,11
EUN1_3563724570',0,17,11,0,0,0,0,15,1,312,61,26253,28958,28012,3,68,21,2,1,1,0,1,347,102,31682,31908,36036,0,-35,-41,-5429,-10,-2950,-8024,-2,-1,-1,0,14
EUN1_3563485659',4,26,6,1,0,0,0,10,0,363,86,24914,28274,25041,6,23,13,1,1,0,0,2,311,86,27285,27958,34900,0,52,0,-2371,-7,316,-9859,0,-1,0,0,8
EUN1_3563467572',4,25,10,1,0,0,0,13,1,309,77,26385,28148,29550,4,39,19,1,0,1,0,5,377,90,31755,33728,40978,0,-68,-13,-5370,-9,-5580,-11428,0,0,-1,0,8
EUN1_3563446209',3,21,8,1,1,0,0,12,1,348,98,25436,28401,30248,5,26,13,1,0,0,0,1,361,74,28526,31989,32308,0,-13,24,-3090,-5,-3588,-2060,0,1,0,0,11
EUN1_3563418250',4,27,16,1,1,1,0,7,1,311,86,27788,30381,29650,4,23,10,1,0,1,0,1,334,97,26510,28781,28518,1,-23,-11,1278,6,1600,1132,0,1,0,0,6
EUN1_3563306728',3,25,13,1,0,0,0,12,1,317,82,27211,29522,31091,5,32,13,1,0,1,0,4,353,86,27902,29452,36454,0,-36,-4,-691,0,70,-5363,0,0,-1,0,8
EUN1_3563253601',2,23,19,1,0,2,0,8,1,369,106,32412,33136,37303,7,32,6,1,0,1,0,6,345,83,26091,27725,24762,1,24,23,6321,13,5411,12541,0,0,1,0,2
EUN1_3563236518',3,25,10,1,1,1,0,4,1,368,110,27577,30332,27867,1,22,12,1,0,1,0,1,395,66,28069,29483,26146,0,-27,44,-492,-2,849,1721,0,1,0,0,3
EUN1_3563157873',5,19,21,2,0,2,0,4,1,298,86,33264,28780,43235,3,67,18,0,0,0,0,9,301,78,28562,27615,35883,0,-3,8,4702,3,1165,7352,2,0,2,0,-5
EUN1_3562908222',3,20,12,1,1,0,0,5,1,337,82,27467,29723,34665,3,25,12,1,0,0,0,3,346,78,27367,30956,37163,1,-9,4,100,0,-1233,-2498,0,1,0,0,2
EUN1_3562864877',4,40,9,1,0,0,0,8,1,367,102,26192,28954,24008,5,98,8,1,1,1,0,0,393,102,27183,30980,22301,1,-26,0,-991,1,-2026,1707,0,-1,-1,0,8
EUN1_3562846857',2,22,25,2,0,1,0,9,1,351,92,34188,32535,40150,3,164,12,0,1,0,0,9,355,92,28473,28865,23878,1,-4,0,5715,13,3670,16272,2,-1,1,0,0
EUN1_3562671616',3,29,12,2,0,0,0,10,1,287,73,25846,27013,30175,2,26,15,0,0,2,0,2,340,78,27514,29572,34268,0,-53,-5,-1668,-3,-2559,-4093,2,0,-2,0,8
EUN1_3562660660',3,26,18,1,0,2,0,7,0,376,91,31139,30645,41512,1,21,18,0,0,1,0,9,291,64,30240,29730,37552,1,85,27,899,0,915,3960,1,0,1,0,-2
EUN1_3562648425',5,28,12,0,0,0,0,6,0,353,84,28366,29431,33833,3,24,20,2,0,1,0,2,370,95,31998,32472,37594,0,-17,-11,-3632,-8,-3041,-3761,-2,0,-1,0,4
EUN1_3572313254',3,26,16,1,1,2,0,5,0,351,86,29882,29990,34376,4,27,10,0,0,0,0,10,283,82,23983,25323,25576,1,68,4,5899,6,4667,8800,1,1,2,0,-5
EUN1_3571979545',3,23,11,0,0,0,0,7,1,371,76,27886,29348,29822,6,85,11,2,0,0,0,2,374,99,26900,30806,30421,0,-3,-23,986,0,-1458,-599,-2,0,0,0,5
EUN1_3571974355',1,84,19,2,1,3,0,3,1,383,113,32112,33330,34129,3,63,5,0,0,0,0,13,301,74,22661,26255,25163,1,82,39,9451,14,7075,8966,2,1,3,0,-10
EUN1_3572813116',2,29,15,2,0,0,0,12,0,342,92,28264,31354,45481,2,22,15,0,0,1,0,0,358,92,29082,29924,38285,1,-16,0,-818,0,1430,7196,2,0,-1,0,12
EUN1_3572519287',5,27,21,1,0,0,0,10,1,291,70,30988,29790,38873,4,68,13,1,0,2,0,2,333,81,27027,28069,34309,1,-42,-11,3961,8,1721,4564,0,0,-2,0,8
EUN1_3573751985',1,24,12,0,0,0,0,6,0,342,72,26934,28924,32359,6,26,19,2,0,0,0,2,347,92,28620,30296,38782,0,-5,-20,-1686,-7,-1372,-6423,-2,0,0,0,4
EUN1_3573328817',4,37,14,1,0,2,0,6,1,385,86,29985,29831,33401,2,86,6,0,0,0,0,7,338,70,22848,27011,26922,1,47,16,7137,8,2820,6479,1,0,2,0,-1
EUN1_3571696417',4,28,7,0,0,0,0,12,0,336,87,24038,28229,28245,4,40,7,2,0,1,0,1,373,96,26205,29218,27115,1,-37,-9,-2167,0,-989,1130,-2,0,-1,0,11
EUN1_3569626396',2,27,13,1,0,2,0,10,0,373,123,30709,31646,36021,4,29,19,1,0,2,0,7,336,68,29557,30016,36528,0,37,55,1152,-6,1630,-507,0,0,0,0,3
EUN1_3568239943',5,36,17,2,0,4,0,7,1,395,96,33623,31088,36358,2,29,8,0,0,0,0,11,340,99,25774,29477,25836,1,55,-3,7849,9,1611,10522,2,0,4,0,-4
EUN1_3568216672',2,27,17,1,0,0,0,9,0,333,84,29283,30363,35759,5,29,16,1,0,1,0,5,320,90,29663,30041,34225,1,13,-6,-380,1,322,1534,0,0,-1,0,4
EUN1_3567845631',3,37,21,1,0,1,0,11,0,341,100,32479,31994,56827,3,37,13,1,0,0,0,4,301,80,29055,28760,42265,0,40,20,3424,8,3234,14562,0,0,1,0,7
EUN1_3567813034',1,20,14,0,0,0,0,9,0,296,92,27794,27571,37062,3,50,22,2,0,1,0,3,349,84,31189,30887,40136,0,-53,8,-3395,-8,-3316,-3074,-2,0,-1,0,6
EUN1_3567800099',4,35,17,1,0,1,0,9,1,331,69,29433,29781,35727,5,28,12,1,0,2,0,4,326,64,26348,26790,28254,1,5,5,3085,5,2991,7473,0,0,-1,0,5
EUN1_3567329823',0,16,14,0,0,0,0,14,0,319,78,27363,28980,29485,4,40,18,1,0,1,0,0,341,90,31317,29209,34100,0,-22,-12,-3954,-4,-229,-4615,-1,0,-1,0,14
EUN1_3567306595',3,30,14,1,0,1,0,7,0,382,108,30547,30477,34579,2,25,8,1,0,0,0,7,363,83,25742,29653,27217,1,19,25,4805,6,824,7362,0,0,1,0,0
EUN1_3567278974',5,30,5,0,0,0,0,6,1,339,74,22666,26592,21896,5,32,10,2,0,0,0,1,360,102,26491,30416,27255,0,-21,-28,-3825,-5,-3824,-5359,-2,0,0,0,5
EUN1_3567261640',4,25,17,0,0,0,0,10,1,328,78,28726,28928,39239,4,68,14,2,0,2,0,5,358,96,29029,30888,34024,0,-30,-18,-303,3,-1960,5215,-2,0,-2,0,5
EUN1_3566747203',3,34,8,0,0,0,0,9,0,360,80,26076,27237,35482,4,27,14,1,0,1,0,2,339,72,28195,29548,34453,0,21,8,-2119,-6,-2311,1029,-1,0,-1,0,7
EUN1_3566714879',5,26,17,0,0,0,0,8,1,334,73,30157,28488,34336,8,31,15,2,0,1,0,4,369,87,27882,29665,36865,1,-35,-14,2275,2,-1177,-2529,-2,0,-1,0,4
EUN1_3566706316',5,37,4,1,0,1,0,11,0,344,78,24102,27202,23511,7,23,19,0,1,1,0,2,379,81,30941,31724,33972,0,-35,-3,-6839,-15,-4522,-10461,1,-1,0,0,9
EUN1_3566401973',8,69,16,1,0,1,0,6,1,359,65,29043,31672,39206,4,26,12,1,0,0,0,3,300,86,26207,28831,32397,0,59,-21,2836,4,2841,6809,0,0,1,0,3
EUN1_3566272847',7,34,16,0,0,0,0,13,0,323,79,27862,29214,41591,1,49,25,0,0,1,0,4,336,76,32999,31998,51618,0,-13,3,-5137,-9,-2784,-10027,0,0,-1,0,9
EUN1_3566249479',4,42,10,0,0,1,0,13,0,335,98,26785,29245,23026,6,31,20,1,0,2,0,3,358,78,30863,32316,39736,1,-23,20,-4078,-10,-3071,-16710,-1,0,-1,0,10
EUN1_3566171414',3,26,17,2,1,0,0,9,1,348,100,29879,31627,29959,3,49,6,0,0,1,0,3,353,100,25670,28693,26514,1,-5,0,4209,11,2934,3445,2,1,-1,0,6
EUN1_3576206692',3,37,15,0,0,0,0,17,0,290,68,27043,26465,33693,3,79,25,1,0,3,0,2,342,100,35847,31170,47554,0,-52,-32,-8804,-10,-4705,-13861,-1,0,-3,0,15
EUN1_3576204362',1,24,12,0,0,0,0,13,1,313,76,26492,28067,28501,1,35,18,2,0,2,0,2,384,100,32704,33243,33217,0,-71,-24,-6212,-6,-5176,-4716,-2,0,-2,0,11
EUN1_3576189028',2,31,13,1,0,0,0,7,1,310,79,26731,27898,34488,4,28,10,0,0,1,0,4,338,64,25791,27307,35383,1,-28,15,940,3,591,-895,1,0,-1,0,3
EUN1_3575983537',4,25,12,0,1,0,0,7,0,367,78,27227,29860,30041,5,27,12,1,0,1,0,1,318,98,26796,28573,28194,1,49,-20,431,0,1287,1847,-1,1,-1,0,6
EUN1_3575961635',3,25,12,1,0,0,0,8,0,302,63,25275,27063,32342,7,28,25,1,0,3,0,3,339,98,34424,31606,50848,0,-37,-35,-9149,-13,-4543,-18506,0,0,-3,0,5
EUN1_3575944297',4,46,22,2,1,0,0,5,1,356,98,29673,30511,35677,3,27,10,0,0,1,0,5,324,88,26470,29138,29860,1,32,10,3203,12,1373,5817,2,1,-1,0,0
EUN1_3575919470',6,112,17,0,0,1,0,8,0,348,80,30716,32133,43904,6,88,19,1,0,1,0,5,393,84,30099,30599,41195,1,-45,-4,617,-2,1534,2709,-1,0,0,0,3
EUN1_3575493828',3,64,13,0,0,1,0,9,1,338,96,29694,27540,34295,2,56,16,1,0,0,0,2,339,83,26650,28689,31924,0,-1,13,3044,-3,-1149,2371,-1,0,1,0,7
EUN1_3575471038',3,26,14,0,0,0,0,14,0,360,88,29248,30966,36896,2,25,23,1,0,1,0,2,340,103,33357,32500,38929,0,20,-15,-4109,-9,-1534,-2033,-1,0,-1,0,12
EUN1_3575442008',4,32,4,0,0,0,0,10,0,317,76,22458,27602,23841,3,98,23,2,1,2,0,2,362,115,33434,33887,37967,0,-45,-39,-10976,-19,-6285,-14126,-2,-1,-2,0,8
EUN1_3575426286',3,31,14,1,0,1,0,10,1,410,88,30677,31934,32276,0,290,11,1,0,0,0,4,391,87,26777,31516,27952,1,19,1,3900,3,418,4324,0,0,1,0,6
EUN1_3574824449',2,23,10,0,0,1,0,16,0,328,66,26077,27149,28148,5,33,17,1,0,1,0,0,357,66,28504,28871,33959,0,-29,0,-2427,-7,-1722,-5811,-1,0,0,0,16
EUN1_3574812197',0,96,21,1,0,1,0,7,1,347,77,32203,30924,38004,4,34,14,1,0,1,0,6,351,98,28674,29669,33893,1,-4,-21,3529,7,1255,4111,0,0,0,0,1
EUN1_3574788078',3,29,13,0,0,1,0,4,1,388,77,29038,29772,33843,7,29,12,1,0,0,0,4,295,82,25056,28398,34346,0,93,-5,3982,1,1374,-503,-1,0,1,0,0
EUN1_3574767638',6,30,21,1,0,2,0,10,1,382,82,34320,30639,33562,2,18,18,0,1,2,0,5,296,79,29152,26592,34964,1,86,3,5168,3,4047,-1402,1,-1,0,0,5
EUN1_3574338519',3,187,17,1,0,1,0,4,1,351,120,29736,32210,35959,3,28,12,0,0,0,0,1,347,82,27376,30920,40307,1,4,38,2360,5,1290,-4348,1,0,1,0,3
EUN1_3574321347',5,47,8,0,0,0,0,12,1,334,63,23632,26724,23947,11,41,21,2,0,1,0,3,388,110,31226,33816,34527,0,-54,-47,-7594,-13,-7092,-10580,-2,0,-1,0,9
EUN1_3574207669',4,22,15,0,0,1,0,9,1,358,49,27601,28147,40391,0,22,17,2,0,1,0,2,391,131,31935,33668,32404,0,-33,-82,-4334,-2,-5521,7987,-2,0,0,0,7
EUN1_3573892330',3,25,23,1,0,1,0,9,1,301,90,32217,30748,44740,2,81,16,1,0,1,0,7,278,66,27001,27289,31284,1,23,24,5216,7,3459,13456,0,0,0,0,2
EUN1_3574547882',5,22,17,0,1,0,0,10,1,345,86,29385,31754,35766,1,43,9,1,0,2,0,6,313,88,26599,27171,24708,1,32,-2,2786,8,4583,11058,-1,1,-2,0,4
EUN1_3574534620',3,27,22,1,0,0,0,9,1,276,92,30683,31522,42171,4,26,16,1,0,2,0,6,273,70,27412,26666,39076,0,3,22,3271,6,4856,3095,0,0,-2,0,3
EUN1_3574508645',3,28,10,2,0,0,0,9,0,349,96,26280,29507,35328,7,30,14,0,0,1,0,4,339,82,28148,29983,32481,1,10,14,-1868,-4,-476,2847,2,0,-1,0,5
EUN1_3574495167',6,30,20,2,0,0,0,6,1,318,68,29797,30712,38212,2,19,9,0,0,1,0,6,311,77,24647,27857,36159,1,7,-9,5150,11,2855,2053,2,0,-1,0,0
EUN1_3568756065',4,26,16,1,0,2,0,8,1,409,86,30472,33623,38657,4,23,5,0,0,0,0,5,344,66,23580,27762,28849,1,65,20,6892,11,5861,9808,1,0,2,0,3
EUN1_3566515186',6,50,14,2,0,2,0,4,0,360,106,28813,30630,28067,2,51,5,0,0,0,0,8,303,62,22719,25414,22553,0,57,44,6094,9,5216,5514,2,0,2,0,-4
EUN1_3565967837',2,29,11,0,1,2,0,12,1,343,87,29145,30230,28539,3,21,13,2,0,1,0,10,330,88,27474,30329,31691,0,13,-1,1671,-2,-99,-3152,-2,1,1,0,2
EUN1_3565964349',1,20,13,0,0,0,0,18,1,278,88,27885,26958,35933,9,27,23,1,0,3,0,3,334,92,33652,31817,35434,0,-56,-4,-5767,-10,-4859,499,-1,0,-3,0,15
EUN1_3565296336',2,18,17,0,0,0,0,6,1,340,88,29936,29763,42454,7,42,18,1,0,1,0,2,310,71,29862,29748,42198,0,30,17,74,-1,15,256,-1,0,-1,0,4
EUN1_3565018125',7,34,9,0,0,0,0,6,0,361,96,25817,28742,29970,2,36,9,2,0,0,0,6,389,99,25852,30162,24737,0,-28,-3,-35,0,-1420,5233,-2,0,0,0,0
EUN1_3574497252',4,25,9,0,0,0,0,11,0,310,80,24647,27659,27865,4,27,18,1,0,1,0,0,347,104,31175,31105,35440,0,-37,-24,-6528,-9,-3446,-7575,-1,0,-1,0,11
EUN1_3574466989',1,20,7,1,0,0,0,11,1,307,82,24734,26910,26502,5,45,10,1,0,0,0,2,320,74,25171,28801,32713,0,-13,8,-437,-3,-1891,-6211,0,0,0,0,9
EUN1_3574454370',3,235,18,1,0,0,0,6,1,328,77,27336,28635,35755,2,24,7,1,0,1,0,4,357,73,26447,28635,31997,1,-29,4,889,11,0,3758,0,0,-1,0,2
EUN1_3574425250',1,19,18,0,1,0,0,11,0,377,84,32463,31311,39467,4,242,16,2,0,2,0,2,336,104,29883,30752,32740,1,41,-20,2580,2,559,6727,-2,1,-2,0,9
EUN1_3574388707',4,23,13,2,0,0,0,12,1,335,87,26278,28019,29396,1,19,17,0,0,2,0,2,347,108,32489,32081,44308,0,-12,-21,-6211,-4,-4062,-14912,2,0,-2,0,10
EUN1_3574366525',3,30,10,0,0,0,0,6,1,349,100,26218,29421,32157,1,20,12,1,0,0,0,4,372,88,26094,29951,35263,1,-23,12,124,-2,-530,-3106,-1,0,0,0,2
EUN1_3574342486',5,38,11,0,0,0,0,9,0,336,87,24862,29716,27612,2,19,8,1,0,1,0,1,352,92,26073,30551,29523,0,-16,-5,-1211,3,-835,-1911,-1,0,-1,0,8
EUN1_3573804741',3,26,19,1,0,1,0,11,1,327,74,30809,27284,39880,6,38,18,1,0,1,0,4,370,66,29786,31062,34701,0,-43,8,1023,1,-3778,5179,0,0,0,0,7
EUN1_3573779404',2,31,15,0,1,0,0,9,1,382,83,28888,31800,31685,0,29,12,1,0,1,0,5,346,92,27581,30282,31669,0,36,-9,1307,3,1518,16,-1,1,-1,0,4
EUN1_3573693394',1,20,18,1,0,1,0,10,1,320,78,29061,29362,36066,0,88,16,0,1,2,0,8,294,93,30698,28638,33939,0,26,-15,-1637,2,724,2127,1,-1,-1,0,2
EUN1_3575953693',5,23,16,0,0,1,0,11,1,323,86,30055,28600,40846,4,26,11,1,0,1,0,6,355,76,27684,28103,26590,1,-32,10,2371,5,497,14256,-1,0,0,0,5
EUN1_3575921940',3,32,11,0,0,0,0,8,1,346,68,25780,27176,27747,1,28,14,2,0,2,0,2,364,103,30251,30423,33069,0,-18,-35,-4471,-3,-3247,-5322,-2,0,-2,0,6
EUN1_3575383887',3,30,14,1,0,0,0,12,1,318,92,26525,28603,31944,5,28,13,0,0,0,0,1,301,88,27383,29310,36677,0,17,4,-858,1,-707,-4733,1,0,0,0,11
EUN1_3575370401',2,26,10,1,0,0,0,10,1,316,95,24807,29011,33151,3,28,12,1,0,0,0,3,350,72,26858,29411,35974,1,-34,23,-2051,-2,-400,-2823,0,0,0,0,7
EUN1_3575342949',1,71,10,1,0,0,0,6,1,372,74,25579,30173,26034,2,29,6,0,0,0,0,3,356,86,23682,27777,25620,0,16,-12,1897,4,2396,414,1,0,0,0,3
EUN1_3573457008',4,31,9,1,0,0,0,8,0,410,66,26265,28398,28889,1,32,20,1,0,0,0,3,293,101,28712,29533,35928,0,117,-35,-2447,-11,-1135,-7039,0,0,0,0,5
EUN1_3573431869',2,24,9,2,0,1,0,7,0,287,86,24014,25167,21469,2,18,13,0,1,0,0,2,321,100,25940,27401,28173,0,-34,-14,-1926,-4,-2234,-6704,2,-1,1,0,5
EUN1_3573409950',1,26,20,1,1,1,0,9,1,326,95,29240,30805,41023,8,38,13,1,0,0,0,4,387,97,29294,31373,31190,0,-61,-2,-54,7,-568,9833,0,1,1,0,5
EUN1_3573393198',8,32,9,1,0,0,0,9,1,340,82,23835,28656,23884,4,34,9,1,0,0,0,1,389,114,26544,31142,24828,0,-49,-32,-2709,0,-2486,-944,0,0,0,0,8
EUN1_3573358910',1,22,8,0,0,1,0,13,0,293,76,25102,27110,26437,3,27,17,2,0,1,0,5,341,120,29577,32382,31334,0,-48,-44,-4475,-9,-5272,-4897,-2,0,0,0,8
EUN1_3573224418',3,18,4,0,0,0,0,10,0,350,86,22621,27770,25512,7,299,17,1,0,1,0,0,421,78,30773,32372,36506,0,-71,8,-8152,-13,-4602,-10994,-1,0,-1,0,10
EUN1_3573211174',4,27,12,1,0,0,0,8,1,328,80,26214,28106,31007,2,20,7,0,0,0,0,5,320,72,23632,26604,30349,1,8,8,2582,5,1502,658,1,0,0,0,3
EUN1_3572724518',8,33,12,0,0,0,0,6,0,332,56,26085,27192,35822,5,35,15,2,0,0,0,1,337,74,27820,28254,28105,0,-5,-18,-1735,-3,-1062,7717,-2,0,0,0,5
EUN1_3572692204',5,28,10,1,0,1,0,10,1,358,82,25845,29844,24349,1,23,5,1,0,0,0,2,386,112,24571,29869,24040,1,-28,-30,1274,5,-25,309,0,0,1,0,8
EUN1_3572672279',4,26,6,1,0,1,0,4,1,394,81,25608,28858,26750,3,28,6,0,0,0,0,5,361,84,24177,28624,23036,1,33,-3,1431,0,234,3714,1,0,1,0,-1
EUN1_3572644430',3,31,10,1,0,1,0,5,1,367,75,26231,30468,32316,6,29,6,1,0,0,0,4,341,88,23278,28408,33891,1,26,-13,2953,4,2060,-1575,0,0,1,0,1
EUN1_3572218364',1,47,14,1,0,1,0,9,1,353,84,28908,28364,29671,3,188,11,0,0,0,0,5,313,76,25783,27065,31686,1,40,8,3125,3,1299,-2015,1,0,1,0,4
EUN1_3572168534',4,135,7,0,0,0,0,4,0,366,74,24775,29318,25629,5,28,9,2,0,0,0,4,377,98,25625,30395,28187,1,-11,-24,-850,-2,-1077,-2558,-2,0,0,0,0
EUN1_3575527506',1,20,12,0,0,0,0,17,0,289,84,26635,27685,40200,7,39,26,1,0,3,0,5,331,64,33698,30747,53023,0,-42,20,-7063,-14,-3062,-12823,-1,0,-3,0,12
EUN1_3575493863',6,297,13,0,0,0,0,5,0,324,74,27541,30078,32730,3,30,6,1,0,1,0,7,333,90,23489,27729,28389,1,-9,-16,4052,7,2349,4341,-1,0,-1,0,-2
EUN1_3574322354',5,20,10,0,0,0,0,17,0,312,64,25268,28202,27850,5,72,16,1,0,3,0,2,381,92,31921,31451,41652,0,-69,-28,-6653,-6,-3249,-13802,-1,0,-3,0,15
EUN1_3574297753',4,30,23,0,0,2,0,6,0,347,84,32793,31748,40035,2,24,16,1,0,0,0,7,302,76,28543,29479,34645,1,45,8,4250,7,2269,5390,-1,0,2,0,-1
EUN1_3574171361',3,27,12,0,1,1,0,11,1,326,76,27738,26416,29006,5,30,13,1,0,1,0,6,342,82,28278,29008,34930,0,-16,-6,-540,-1,-2592,-5924,-1,1,0,0,5
EUN1_3574155628',3,37,4,1,0,0,0,6,1,328,72,22755,26404,22002,4,34,8,1,0,0,0,2,338,99,25086,29428,28370,0,-10,-27,-2331,-4,-3024,-6368,0,0,0,0,4
EUN1_3574140836',7,139,11,0,0,2,0,4,1,346,93,28555,29327,31098,4,43,7,2,0,1,0,8,337,80,24570,28149,23456,0,9,13,3985,4,1178,7642,-2,0,1,0,-4
EUN1_3574128883',3,21,15,2,0,1,0,6,1,397,100,30077,31312,33248,6,33,7,0,0,0,0,4,316,79,24337,26364,28825,1,81,21,5740,8,4948,4423,2,0,1,0,2
EUN1_3573790466',7,30,6,2,0,0,0,10,0,332,86,22458,27831,23867,4,28,6,0,0,1,0,0,374,90,25724,27962,23953,0,-42,-4,-3266,0,-131,-86,2,0,-1,0,10
EUN1_3573766442',7,31,17,0,0,0,0,9,0,301,66,28375,29141,38742,4,47,20,2,0,1,0,6,314,90,29738,30200,44642,0,-13,-24,-1363,-3,-1059,-5900,-2,0,-1,0,3
EUN1_3573570063',5,66,7,0,0,0,0,7,0,388,106,25703,30009,23789,7,70,9,1,0,0,0,4,371,86,25673,30336,22539,0,17,20,30,-2,-327,1250,-1,0,0,0,3
EUN1_3574764534',3,24,15,0,0,1,0,6,1,400,78,28796,30788,38705,5,30,7,2,0,0,0,5,322,84,23842,27958,28870,0,78,-6,4954,8,2830,9835,-2,0,1,0,1
EUN1_3574750485',0,22,13,0,0,0,0,11,1,346,104,28099,29574,31737,2,18,16,1,0,1,0,1,332,91,28934,28930,39628,0,14,13,-835,-3,644,-7891,-1,0,-1,0,10
EUN1_3574729862',1,34,14,1,0,0,0,14,1,307,108,27669,29689,31325,2,279,18,0,0,3,0,2,317,80,29682,30666,39443,1,-10,28,-2013,-4,-977,-8118,1,0,-3,0,12
EUN1_3573823056',5,39,12,1,0,0,0,10,0,340,88,26533,29060,34158,3,34,13,0,0,2,0,3,379,92,30040,30981,28515,0,-39,-4,-3507,-1,-1921,5643,1,0,-2,0,7
EUN1_3573816096',3,20,9,0,0,1,0,4,1,403,88,26428,29294,23427,3,19,6,2,0,0,0,4,337,82,23612,27433,19513,1,66,6,2816,3,1861,3914,-2,0,1,0,0
EUN1_3573798146',10,32,3,1,0,0,0,11,0,286,75,20917,27272,19388,3,33,21,1,0,2,0,1,390,101,32315,33723,40663,0,-104,-26,-11398,-18,-6451,-21275,0,0,-2,0,10
EUN1_3575980106',6,34,21,1,0,3,0,7,1,401,69,33772,31839,40551,4,23,9,0,0,0,0,11,370,85,25814,30152,30260,1,31,-16,7958,12,1687,10291,1,0,3,0,-4
EUN1_3575911122',1,229,20,0,0,0,0,11,1,325,104,31282,30376,38954,5,38,18,2,0,2,0,3,339,64,29713,28230,38592,1,-14,40,1569,2,2146,362,-2,0,-2,0,8
EUN1_3575823005',3,20,8,1,0,0,0,17,0,342,81,24566,26959,34469,5,26,26,1,1,3,0,2,371,90,36370,32700,45129,0,-29,-9,-11804,-18,-5741,-10660,0,-1,-3,0,15
EUN1_3575498285',3,23,20,2,0,2,0,7,1,365,101,32489,31375,48027,1,36,9,0,0,0,0,5,292,70,24274,26294,39467,1,73,31,8215,11,5081,8560,2,0,2,0,2
EUN1_3575370002',5,32,14,1,0,0,0,14,0,332,80,27301,28404,34869,0,26,17,1,1,2,0,1,360,100,31629,31557,32311,0,-28,-20,-4328,-3,-3153,2558,0,-1,-2,0,13
EUN1_3575326253',4,29,15,2,0,1,0,9,1,345,86,28455,31187,30768,6,27,15,0,0,1,0,4,388,102,29755,32076,31067,0,-43,-16,-1300,0,-889,-299,2,0,0,0,5
EUN1_3575305238',7,30,14,1,1,2,0,7,1,363,101,29976,29258,39274,5,25,10,1,0,0,0,6,294,64,23931,25725,22677,1,69,37,6045,4,3533,16597,0,1,2,0,1
EUN1_3575280784',0,103,18,1,0,1,0,9,0,332,83,29657,30410,40954,2,21,10,1,0,1,0,4,365,84,27146,29744,32513,1,-33,-1,2511,8,666,8441,0,0,0,0,5
EUN1_3575132520',3,30,19,1,0,2,0,9,0,323,88,31127,28911,39418,3,26,18,1,0,0,0,2,352,73,30254,29002,36164,1,-29,15,873,1,-91,3254,0,0,2,0,7
EUN1_3575125620',5,87,16,1,0,0,0,9,0,339,84,28313,30962,34656,6,34,12,1,0,1,0,2,361,91,27965,28781,32646,1,-22,-7,348,4,2181,2010,0,0,-1,0,7
EUN1_3574850254',1,34,5,2,0,0,0,9,1,403,80,24067,29147,22439,4,24,5,0,0,0,0,2,371,116,24377,30850,25730,0,32,-36,-310,0,-1703,-3291,2,0,0,0,7
EUN1_3574828294',0,92,10,0,1,0,0,11,0,274,93,26177,27720,32504,3,22,23,2,0,2,0,5,363,91,33696,31021,45290,0,-89,2,-7519,-13,-3301,-12786,-2,1,-2,0,6
EUN1_3574765239',2,24,9,1,0,1,0,15,1,324,94,26328,29628,26134,4,28,20,1,0,3,0,3,374,98,31858,31761,37381,0,-50,-4,-5530,-11,-2133,-11247,0,0,-2,0,12
EUN1_3574607926',1,19,15,1,0,0,0,4,0,326,80,28282,28900,38795,3,27,24,1,0,0,0,4,331,72,32637,32161,44263,0,-5,8,-4355,-9,-3261,-5468,0,0,0,0,0
EUN1_3574609547',3,49,32,0,0,2,0,5,1,403,95,37045,33354,61495,3,26,13,1,0,1,0,8,269,80,26245,26914,37466,1,134,15,10800,19,6440,24029,-1,0,1,0,-3
EUN1_3574601979',3,23,17,0,1,0,0,12,1,335,58,28583,28319,36741,1,25,18,2,0,1,0,5,344,98,29407,30176,35934,0,-9,-40,-824,-1,-1857,807,-2,1,-1,0,7
EUN1_3574599632',6,33,16,1,0,1,0,11,1,359,67,30386,31531,36731,2,34,11,1,0,3,0,7,327,100,29507,30867,32774,1,32,-33,879,5,664,3957,0,0,-2,0,4
EUN1_3574594647',2,22,14,2,1,1,0,13,0,316,95,28033,29077,38776,5,31,12,0,0,2,0,5,379,84,29904,28210,32725,0,-63,11,-1871,2,867,6051,2,1,-1,0,8
EUN1_3574585873',6,25,6,0,0,0,0,16,0,322,80,23047,24030,26464,5,28,30,2,0,7,1,1,385,100,39893,35209,47814,0,-63,-20,-16846,-24,-11179,-21350,-2,0,-7,-1,15
EUN1_3565747091',4,25,20,0,0,0,0,12,0,329,92,31446,30079,36130,6,27,24,2,0,0,0,4,327,100,31057,31953,41226,0,2,-8,389,-4,-1874,-5096,-2,0,0,0,8
EUN1_3565720749',6,25,16,0,0,0,0,11,1,351,72,30016,28400,37383,2,53,20,2,0,1,0,6,316,96,30657,29801,40909,1,35,-24,-641,-4,-1401,-3526,-2,0,-1,0,5
EUN1_3565699954',3,39,24,0,1,1,0,9,0,295,66,33588,29376,42365,5,23,24,2,0,1,0,3,295,80,31863,28151,41832,0,0,-14,1725,0,1225,533,-2,1,0,0,6
EUN1_3565687806',3,33,19,1,0,3,0,11,1,389,72,31872,31606,38115,5,29,9,1,0,0,0,6,320,106,25659,27809,31510,1,69,-34,6213,10,3797,6605,0,0,3,0,5
EUN1_3564721645',3,22,14,1,0,1,0,12,0,363,80,28809,30479,36618,4,98,14,1,0,1,0,4,365,84,29275,30222,30404,0,-2,-4,-466,0,257,6214,0,0,0,0,8
EUN1_3564717340',5,266,18,1,0,1,0,14,0,320,78,30502,30999,36171,4,59,15,1,0,2,0,1,354,101,30316,29550,32358,0,-34,-23,186,3,1449,3813,0,0,-1,0,13
EUN1_3564706209',7,61,17,1,0,0,0,16,1,313,60,28788,30538,34906,5,72,16,0,0,2,0,3,320,120,29835,31428,36675,0,-7,-60,-1047,1,-890,-1769,1,0,-2,0,13
EUN1_3564696679',3,26,13,1,0,0,0,14,0,380,85,27485,29889,34546,4,28,18,0,0,2,0,2,350,91,29812,29842,32602,0,30,-6,-2327,-5,47,1944,1,0,-2,0,12
EUN1_3564661753',6,33,6,0,0,0,0,11,1,316,90,23079,25819,29033,5,25,20,2,0,1,0,2,334,93,30297,30909,36665,0,-18,-3,-7218,-14,-5090,-7632,-2,0,-1,0,9
EUN1_3564652058',4,63,14,0,0,0,0,9,1,284,75,25120,28287,30628,2,62,15,2,0,1,0,0,370,108,29572,31572,35515,0,-86,-33,-4452,-1,-3285,-4887,-2,0,-1,0,9
EUN1_3564658472',5,26,19,1,1,0,0,11,1,326,120,30879,30235,30778,5,30,12,0,0,2,0,4,338,80,28370,27728,28795,1,-12,40,2509,7,2507,1983,1,1,-2,0,7
EUN1_3564658264',3,133,19,2,1,2,0,8,1,351,116,32379,32131,35931,1,25,8,0,0,0,0,7,355,84,25169,27470,23582,1,-4,32,7210,11,4661,12349,2,1,2,0,1
EUN1_3564351116',6,35,24,1,0,2,0,10,1,376,115,34486,32650,40713,1,14,10,0,0,2,0,8,238,72,24231,24857,27055,1,138,43,10255,14,7793,13658,1,0,0,0,2
EUN1_3564330213',5,22,24,0,0,1,0,9,1,359,70,32673,33232,46466,4,26,16,2,0,0,0,3,360,94,29098,29300,37128,1,-1,-24,3575,8,3932,9338,-2,0,1,0,6
EUN1_3564313147',2,21,17,0,0,0,0,14,1,314,78,28419,29375,33350,1,29,20,2,0,3,0,1,341,105,32487,31829,42523,1,-27,-27,-4068,-3,-2454,-9173,-2,0,-3,0,13
EUN1_3575980737',3,38,8,1,0,0,0,3,1,343,108,25338,28538,30749,7,32,8,1,0,0,0,2,324,100,23270,28230,26046,1,19,8,2068,0,308,4703,0,0,0,0,1
EUN1_3575966506',9,81,5,0,0,0,0,11,1,337,98,23057,28625,25134,2,26,14,2,0,2,0,3,369,80,28239,32268,33771,0,-32,18,-5182,-9,-3643,-8637,-2,0,-2,0,8
EUN1_3573831772',8,33,16,1,0,1,0,9,1,395,96,30033,31933,38102,4,415,13,1,0,1,0,4,336,63,27740,30076,42701,1,59,33,2293,3,1857,-4599,0,0,0,0,5
EUN1_3573816305',5,33,20,2,0,0,0,5,1,350,105,30370,31706,36779,4,40,10,0,0,0,0,6,359,62,25870,27970,42898,1,-9,43,4500,10,3736,-6119,2,0,0,0,-1
EUN1_3570809623',1,159,14,2,0,2,0,10,1,379,110,31528,32736,26681,7,36,14,0,0,2,0,12,360,73,26481,29824,23490,1,19,37,5047,0,2912,3191,2,0,0,0,-2
EUN1_3570594452',4,29,10,1,0,0,0,6,0,375,94,26129,30758,28313,6,24,13,1,0,0,0,1,374,84,25963,30073,23382,0,1,10,166,-3,685,4931,0,0,0,0,5
EUN1_3570587483',0,20,6,0,0,0,0,10,1,386,92,24681,29209,24798,1,22,13,2,0,1,0,2,352,111,26958,31631,29358,0,34,-19,-2277,-7,-2422,-4560,-2,0,-1,0,8
EUN1_3575899520',4,23,14,0,1,0,0,10,1,314,92,27198,29597,31961,2,20,11,2,0,1,0,2,319,88,25580,29039,31540,0,-5,4,1618,3,558,421,-2,1,-1,0,8
EUN1_3575328139',7,23,12,0,0,0,0,8,1,349,68,26154,29027,26064,0,40,17,2,0,2,0,4,341,84,28768,30458,31446,0,8,-16,-2614,-5,-1431,-5382,-2,0,-2,0,4
EUN1_3575291989',5,31,13,1,0,0,0,12,0,353,110,27671,31078,29842,4,23,13,1,0,2,0,3,361,80,28744,29509,32418,0,-8,30,-1073,0,1569,-2576,0,0,-2,0,9
EUN1_3574813389',1,21,17,1,0,0,0,11,1,317,72,28490,28948,33977,3,25,9,0,0,2,0,4,287,97,25453,27457,25832,0,30,-25,3037,8,1491,8145,1,0,-2,0,7
EUN1_3574789341',1,33,13,2,0,1,0,8,0,325,72,26290,31315,32413,2,36,8,0,0,0,0,8,316,84,24008,28444,30236,1,9,-12,2282,5,2871,2177,2,0,1,0,0
EUN1_3573764345',2,25,6,0,0,0,0,7,0,329,82,23429,29022,28920,5,23,13,2,0,1,0,2,354,78,27098,30408,31994,0,-25,4,-3669,-7,-1386,-3074,-2,0,-1,0,5
EUN1_3573736917',2,23,12,1,0,1,0,12,1,346,84,27739,28503,36403,6,27,18,1,0,1,0,7,325,80,29692,29372,36730,1,21,4,-1953,-6,-869,-327,0,0,0,0,5
EUN1_3573682970',2,28,15,2,0,1,0,9,1,385,70,29162,31744,33921,6,29,9,0,0,0,0,8,328,90,25222,29363,26329,1,57,-20,3940,6,2381,7592,2,0,1,0,1
EUN1_3573335599',5,21,19,1,0,2,0,7,1,355,91,29913,30449,28292,6,31,14,0,0,1,0,4,283,72,27205,26396,32642,1,72,19,2708,5,4053,-4350,1,0,1,0,3
EUN1_3573294196',2,29,20,2,0,2,0,11,1,379,78,30487,32376,35804,6,97,6,0,0,1,0,5,328,74,24225,28365,26810,1,51,4,6262,14,4011,8994,2,0,1,0,6
EUN1_3573253789',4,25,12,0,0,3,0,9,0,378,84,29630,30582,31097,3,29,7,1,1,0,0,7,340,72,23440,28075,17915,1,38,12,6190,5,2507,13182,-1,-1,3,0,2
EUN1_3573231753',4,22,14,2,0,1,0,5,1,373,86,28942,31960,37200,6,25,9,0,0,0,0,6,344,90,25636,29228,29958,0,29,-4,3306,5,2732,7242,2,0,1,0,-1
EUN1_3573216159',3,19,8,1,0,0,0,9,0,287,112,23663,25849,25544,5,26,15,0,0,1,0,0,350,80,28652,30542,27591,0,-63,32,-4989,-7,-4693,-2047,1,0,-1,0,9
EUN1_3573180689',6,68,13,0,0,1,0,8,1,319,90,27350,30761,34137,4,52,15,2,0,0,0,5,349,91,26932,29204,32625,0,-30,-1,418,-2,1557,1512,-2,0,1,0,3
EUN1_3573175245',4,29,18,1,0,0,0,8,0,330,86,28869,30269,34658,6,26,22,0,0,3,0,5,343,90,32757,31475,38072,0,-13,-4,-3888,-4,-1206,-3414,1,0,-3,0,3
EUN1_3573152331',2,67,12,2,0,0,0,15,0,329,96,26483,28831,30699,3,28,18,0,0,2,0,2,376,99,31482,33712,31853,0,-47,-3,-4999,-6,-4881,-1154,2,0,-2,0,13
EUN1_3572515695',2,29,6,0,0,0,0,6,1,376,78,24718,27954,28395,4,262,8,2,0,0,0,2,349,82,24308,30254,20463,1,27,-4,410,-2,-2300,7932,-2,0,0,0,4
EUN1_3572504357',4,27,11,1,1,0,0,9,0,299,94,25974,28297,30227,2,23,18,0,0,1,0,1,303,78,28663,27672,34934,1,-4,16,-2689,-7,625,-4707,1,1,-1,0,8
EUN1_3572478843',7,26,10,0,0,0,0,9,0,304,68,24865,25275,30661,7,23,25,1,0,0,0,0,354,59,30529,32400,45448,0,-50,9,-5664,-15,-7125,-14787,-1,0,0,0,9
EUN1_3572487114',4,23,11,0,1,0,0,11,0,344,84,26406,28462,30167,8,30,13,2,0,0,0,5,343,82,26895,29716,39299,1,1,2,-489,-2,-1254,-9132,-2,1,0,0,6
EUN1_3572543144',5,30,9,0,0,0,0,5,0,362,96,26463,30244,30871,4,31,6,2,0,1,0,5,344,88,23404,28348,29616,1,18,8,3059,3,1896,1255,-2,0,-1,0,0
EUN1_3571944245',3,22,10,1,0,1,0,13,0,343,102,26934,29655,28776,2,22,12,1,1,1,0,4,377,105,29563,33529,28792,0,-34,-3,-2629,-2,-3874,-16,0,-1,0,0,9
EUN1_3569205477',1,25,13,1,1,2,0,8,1,341,69,28706,29023,42347,2,26,18,1,0,1,0,4,359,102,30563,32204,33288,0,-18,-33,-1857,-5,-3181,9059,0,1,1,0,4
EUN1_3569150140',10,49,17,1,0,2,0,9,1,369,76,31154,30963,35325,4,29,17,1,0,0,0,10,333,62,28713,28990,35060,1,36,14,2441,0,1973,265,0,0,2,0,-1
EUN1_3569004927',2,23,5,0,0,0,0,14,0,321,84,23631,26953,17250,5,24,20,2,1,2,0,2,381,112,31659,34633,34674,0,-60,-28,-8028,-15,-7680,-17424,-2,-1,-2,0,12
EUN1_3574598957',2,55,10,0,0,0,0,10,0,338,68,25122,28148,29875,2,27,14,1,0,0,0,1,327,96,27542,29842,35434,0,11,-28,-2420,-4,-1694,-5559,-1,0,0,0,9
EUN1_3574594897',5,29,13,1,0,1,0,10,0,362,98,28185,30390,31522,8,26,12,1,0,0,0,6,334,96,26442,27734,34296,1,28,2,1743,1,2656,-2774,0,0,1,0,4
EUN1_3567727039',1,26,15,1,0,0,0,14,0,309,69,27297,27952,40353,3,27,17,0,0,2,0,2,343,82,29842,28057,36325,1,-34,-13,-2545,-2,-105,4028,1,0,-2,0,12
EUN1_3567708923',1,20,32,2,0,2,0,7,1,346,106,37027,32352,48297,0,19,10,0,0,1,0,11,293,68,25781,24853,29791,1,53,38,11246,22,7499,18506,2,0,1,0,-4
EUN1_3563355082',1,25,13,1,0,0,0,10,0,311,72,27215,27074,33979,1,23,21,0,0,1,0,3,375,80,31072,30671,31993,0,-64,-8,-3857,-8,-3597,1986,1,0,-1,0,7
EUN1_3563319659',8,35,18,2,0,1,0,8,1,334,91,30829,30919,36652,1,27,13,0,0,0,0,5,338,92,28307,29077,33169,1,-4,-1,2522,5,1842,3483,2,0,1,0,3
EUN1_3563296596',4,23,10,1,0,0,0,8,1,358,104,25978,28448,27311,2,31,10,0,0,0,0,2,367,84,25674,28699,28214,0,-9,20,304,0,-251,-903,1,0,0,0,6
EUN1_3563280348',6,35,12,0,0,3,0,9,0,376,92,30993,30424,33612,4,29,14,1,0,0,0,9,336,67,27615,28111,28804,1,40,25,3378,-2,2313,4808,-1,0,3,0,0
EUN1_3563265235',1,20,4,0,0,0,0,8,0,314,60,21751,25905,24172,4,104,18,2,0,2,0,1,375,111,31090,32501,36459,0,-61,-51,-9339,-14,-6596,-12287,-2,0,-2,0,7
EUN1_3562842141',2,20,6,0,0,0,0,8,0,319,90,24063,26479,28548,6,29,26,1,0,1,0,2,331,110,32070,33207,43150,0,-12,-20,-8007,-20,-6728,-14602,-1,0,-1,0,6
EUN1_3562786391',4,26,13,1,0,0,0,9,0,352,82,28297,30013,33080,5,30,16,1,0,0,0,4,303,90,27232,26042,32009,1,49,-8,1065,-3,3971,1071,0,0,0,0,5
EUN1_3562708668',2,62,9,0,0,1,0,12,0,379,84,28210,30546,35450,4,40,17,2,0,0,0,3,349,76,28506,31737,35906,0,30,8,-296,-8,-1191,-456,-2,0,1,0,9
EUN1_3562663796',2,18,9,1,0,2,0,13,1,409,96,28217,30084,30156,2,23,11,0,0,2,0,8,339,84,28334,29400,25821,0,70,12,-117,-2,684,4335,1,0,0,0,5
EUN1_3562662390',1,25,10,0,0,0,0,11,0,336,60,27217,29041,36999,3,26,24,1,0,2,0,1,362,92,32743,33128,48506,0,-26,-32,-5526,-14,-4087,-11507,-1,0,-2,0,10
EUN1_3562564126',3,21,5,0,0,0,0,9,0,359,84,24240,26366,21384,7,54,19,2,1,2,0,1,355,106,30230,31290,33086,0,4,-22,-5990,-14,-4924,-11702,-2,-1,-2,0,8
EUN1_3562546470',2,24,22,2,0,1,0,5,0,344,89,30000,31350,42437,4,35,8,0,0,0,0,4,333,80,25048,27318,34317,1,11,9,4952,14,4032,8120,2,0,1,0,1
EUN1_3562483296',2,47,15,0,0,1,0,8,1,308,74,28157,28601,35775,3,21,11,2,0,0,0,5,299,74,24115,27203,29567,1,9,0,4042,4,1398,6208,-2,0,1,0,3
EUN1_3562455295',4,30,16,0,0,0,0,10,0,327,80,29807,28999,37016,8,33,12,1,0,2,0,5,327,77,26893,27897,27292,1,0,3,2914,4,1102,9724,-1,0,-2,0,5
EUN1_3562345564',5,43,15,1,0,0,0,15,0,335,91,28848,30483,33512,2,175,16,1,0,2,0,5,338,76,30394,31143,28602,1,-3,15,-1546,-1,-660,4910,0,0,-2,0,10
EUN1_3576157430',4,24,8,2,0,0,0,9,0,356,88,24582,30140,23407,4,140,13,0,0,1,0,1,379,96,28356,31495,36672,0,-23,-8,-3774,-5,-1355,-13265,2,0,-1,0,8
EUN1_3576024406',1,22,4,0,0,0,0,15,0,315,100,22873,27958,27637,3,37,23,2,1,2,0,1,341,104,32410,33968,39792,0,-26,-4,-9537,-19,-6010,-12155,-2,-1,-2,0,14
EUN1_3575991935',4,27,11,2,0,1,0,6,1,370,104,28259,31541,23025,4,27,5,0,0,1,0,9,378,96,24989,27729,19322,1,-8,8,3270,6,3812,3703,2,0,0,0,-3
EUN1_3575880747',7,32,7,0,0,0,0,10,0,360,75,24777,28459,29416,7,27,15,1,1,2,0,3,355,83,29332,29258,27363,0,5,-8,-4555,-8,-799,2053,-1,-1,-2,0,7
EUN1_3575871073',6,57,5,0,0,0,0,9,0,350,82,24027,28250,25534,2,23,19,2,0,1,0,2,415,90,32485,31764,31162,0,-65,-8,-8458,-14,-3514,-5628,-2,0,-1,0,7
EUN1_3575841064',0,34,12,1,0,0,0,7,0,402,96,27793,30527,26046,4,30,15,1,0,0,0,5,352,95,28070,30004,31042,1,50,1,-277,-3,523,-4996,0,0,0,0,2
EUN1_3575813759',6,31,14,1,0,0,0,9,1,352,79,28448,29250,34769,4,25,13,1,0,0,0,1,328,77,26943,29586,28958,1,24,2,1505,1,-336,5811,0,0,0,0,8
EUN1_3575775253',4,88,19,1,0,0,0,8,1,295,93,30033,28994,40617,4,28,21,0,0,0,0,4,341,70,30471,29550,37116,0,-46,23,-438,-2,-556,3501,1,0,0,0,4
EUN1_3575662309',4,60,10,0,0,0,0,10,1,283,96,24896,26976,29224,5,67,14,1,0,2,0,2,363,76,29391,31594,37702,0,-80,20,-4495,-4,-4618,-8478,-1,0,-2,0,8
EUN1_3575639787',2,25,18,1,0,0,0,10,1,292,94,28200,29863,33087,2,33,8,0,0,2,0,3,309,102,25368,29218,26717,1,-17,-8,2832,10,645,6370,1,0,-2,0,7
EUN1_3575628706',4,28,16,1,0,0,0,8,1,302,99,28793,29516,34804,0,30,11,1,1,1,0,3,319,84,26207,28497,28132,1,-17,15,2586,5,1019,6672,0,-1,-1,0,5
EUN1_3575613073',1,22,14,0,0,2,0,8,0,329,102,30626,29843,38221,8,32,22,2,0,1,0,8,339,82,31241,30402,44490,0,-10,20,-615,-8,-559,-6269,-2,0,1,0,0
EUN1_3575585783',3,35,18,1,0,0,0,13,0,309,76,27583,26964,32802,3,38,14,0,0,3,0,1,347,80,30535,29405,32556,0,-38,-4,-2952,4,-2441,246,1,0,-3,0,12
EUN1_3575441442',5,26,26,1,0,0,0,13,1,319,88,33209,29692,42965,1,27,23,0,0,1,0,2,274,58,31429,27816,49334,1,45,30,1780,3,1876,-6369,1,0,-1,0,11
EUN1_3575266114',5,31,14,0,0,2,0,7,1,419,104,30867,31625,34914,0,16,7,2,0,0,0,6,355,76,23759,28491,23222,0,64,28,7108,7,3134,11692,-2,0,2,0,1
EUN1_3570656985',4,26,7,0,0,1,0,12,0,315,66,25400,27455,29833,2,23,20,1,0,1,0,3,338,118,30802,31594,33172,0,-23,-52,-5402,-13,-4139,-3339,-1,0,0,0,9
EUN1_3570637791',5,31,15,1,0,0,0,6,1,359,84,27973,29833,37195,4,50,13,1,0,0,0,4,336,85,27886,29588,29336,0,23,-1,87,2,245,7859,0,0,0,0,2
EUN1_3566045475',6,26,5,1,0,0,0,7,0,347,94,23361,28792,28493,3,19,10,1,0,1,0,1,338,90,26276,29365,35407,0,9,4,-2915,-5,-573,-6914,0,0,-1,0,6
EUN1_3561430270',2,30,16,0,1,1,0,11,0,333,78,29969,29049,32683,2,42,14,1,0,2,0,4,352,102,29096,29554,38021,1,-19,-24,873,2,-505,-5338,-1,1,-1,0,7
EUN1_3561397201',1,24,9,0,0,1,0,10,0,350,88,26551,28990,28507,7,32,15,2,0,0,0,5,358,116,29138,31682,39619,0,-8,-28,-2587,-6,-2692,-11112,-2,0,1,0,5
EUN1_3559034728',7,28,12,0,0,0,0,12,1,365,92,27190,27318,33123,4,29,19,1,0,0,0,5,303,72,29688,29176,33725,0,62,20,-2498,-7,-1858,-602,-1,0,0,0,7
EUN1_3559027442',4,39,19,0,0,1,0,6,1,383,66,31373,31667,40286,1,28,14,2,0,0,0,6,296,98,26310,26403,27272,1,87,-32,5063,5,5264,13014,-2,0,1,0,0
EUN1_3575937699',0,227,12,1,0,1,0,8,0,390,82,28087,31471,31865,3,37,11,1,0,0,0,2,352,83,25211,29731,28330,1,38,-1,2876,1,1740,3535,0,0,1,0,6
EUN1_3575919166',1,59,9,2,0,0,0,7,0,381,92,26286,29221,28988,3,65,10,0,0,2,0,2,386,88,27118,31513,34403,1,-5,4,-832,-1,-2292,-5415,2,0,-2,0,5
EUN1_3575893528',5,38,12,0,1,0,0,5,1,336,100,26794,29778,29150,2,24,8,1,0,0,0,4,331,87,23803,28930,26782,0,5,13,2991,4,848,2368,-1,1,0,0,1
EUN1_3575874723',3,33,11,0,1,3,0,7,1,401,76,29664,28865,24906,5,119,4,2,0,0,0,9,345,92,22814,27452,17909,1,56,-16,6850,7,1413,6997,-2,1,3,0,-2
EUN1_3575854002',2,50,9,0,1,2,0,4,0,365,90,27030,30364,25947,2,27,5,1,0,0,0,4,359,104,23396,29513,20431,1,6,-14,3634,4,851,5516,-1,1,2,0,0
EUN1_3574813097',3,26,17,1,0,0,0,5,1,330,76,28328,28490,31657,3,26,10,0,0,0,0,4,370,88,25837,28520,31918,1,-40,-12,2491,7,-30,-261,1,0,0,0,1
EUN1_3574279213',4,25,8,0,0,0,0,16,1,295,68,23414,26044,23676,3,42,26,2,0,4,0,2,376,87,34712,32360,39192,0,-81,-19,-11298,-18,-6316,-15516,-2,0,-4,0,14
EUN1_3574261667',1,144,18,2,0,2,0,1,1,370,96,31156,30403,34262,1,26,6,0,0,1,0,10,316,84,23226,26329,17847,1,54,12,7930,12,4074,16415,2,0,1,0,-9
EUN1_3574249613',1,27,15,0,0,1,0,5,1,411,75,29563,31819,38353,5,30,10,1,0,0,0,7,363,88,26028,30387,28385,1,48,-13,3535,5,1432,9968,-1,0,1,0,-2
EUN1_3574237292',1,29,8,0,0,0,0,7,0,352,82,24470,27622,25226,1,26,14,1,0,1,0,1,393,97,29026,32072,31515,0,-41,-15,-4556,-6,-4450,-6289,-1,0,-1,0,6
EUN1_3574208847',0,19,11,0,0,0,0,7,0,326,88,27051,29976,30050,4,27,15,2,0,0,0,4,319,84,26769,29729,33094,1,7,4,282,-4,247,-3044,-2,0,0,0,3
EUN1_3574194602',5,27,17,1,0,1,0,9,0,398,97,31538,32151,39463,3,27,14,1,0,1,0,3,351,90,28053,29885,34091,1,47,7,3485,3,2266,5372,0,0,0,0,6
EUN1_3574179923',3,27,13,1,0,0,0,10,0,377,84,28709,30830,30615,3,34,10,1,0,2,0,3,389,103,27419,30026,26697,1,-12,-19,1290,3,804,3918,0,0,-2,0,7
EUN1_3574168255',3,31,14,1,0,0,0,7,0,366,88,26161,30353,32396,2,20,14,0,0,0,0,2,385,108,29537,32288,34568,0,-19,-20,-3376,0,-1935,-2172,1,0,0,0,5
EUN1_3574146568',4,31,11,0,0,0,0,6,0,303,70,25235,26529,32942,2,23,21,2,0,0,0,0,334,92,30184,29716,33575,0,-31,-22,-4949,-10,-3187,-633,-2,0,0,0,6
EUN1_3574128028',4,20,13,1,0,0,0,7,1,370,94,27447,30341,38914,2,44,14,1,1,0,0,2,342,78,27205,30057,30724,0,28,16,242,-1,284,8190,0,-1,0,0,5
EUN1_3574118762',2,30,18,1,0,1,0,7,1,361,95,29510,32343,37961,5,39,4,0,0,0,0,7,297,58,21484,24507,21936,1,64,37,8026,14,7836,16025,1,0,1,0,0
EUN1_3574108789',5,30,11,0,0,1,0,9,0,320,60,26117,28571,27024,7,33,18,2,1,1,0,0,393,92,30144,31666,34135,0,-73,-32,-4027,-7,-3095,-7111,-2,-1,0,0,9
EUN1_3574105266',5,28,8,0,0,0,0,5,0,343,86,25400,28855,28201,5,89,14,1,0,0,0,1,345,94,27667,30914,35042,0,-2,-8,-2267,-6,-2059,-6841,-1,0,0,0,4
EUN1_3573655286',3,28,13,1,0,1,0,12,0,367,101,28596,29941,26590,0,27,7,1,0,1,0,4,365,90,25348,28817,25587,0,2,11,3248,6,1124,1003,0,0,0,0,8
EUN1_3576145310',2,25,9,2,0,0,0,8,0,375,104,27525,30364,30664,8,30,16,0,0,1,0,2,331,88,27867,28626,38156,1,44,16,-342,-7,1738,-7492,2,0,-1,0,6
EUN1_3574990540',4,135,17,1,0,1,0,12,0,326,95,29091,31097,31006,3,29,15,0,0,2,0,5,342,100,29809,29815,37802,0,-16,-5,-718,2,1282,-6796,1,0,-1,0,7
EUN1_3574336387',2,24,18,1,0,3,0,6,1,376,92,31391,32149,35546,0,23,5,0,0,1,0,8,326,80,23158,26490,24177,1,50,12,8233,13,5659,11369,1,0,2,0,-2
EUN1_3574261634',3,23,6,0,0,0,0,10,1,321,81,23058,28173,22982,4,69,16,1,0,1,0,0,411,80,29038,32397,32138,0,-90,1,-5980,-10,-4224,-9156,-1,0,-1,0,10
EUN1_3574220652',4,24,16,1,1,0,0,9,0,362,108,29105,31929,34616,4,29,8,0,0,1,0,6,334,80,25370,28257,23608,1,28,28,3735,8,3672,11008,1,1,-1,0,3
EUN1_3573674325',2,22,9,1,0,0,0,7,1,307,73,24180,27502,32261,7,36,15,0,0,0,0,4,304,66,26586,28478,41912,0,3,7,-2406,-6,-976,-9651,1,0,0,0,3
EUN1_3573072987',3,26,14,1,0,1,0,11,1,351,72,28024,29907,33411,5,27,9,0,0,1,0,3,316,92,26463,28295,36187,1,35,-20,1561,5,1612,-2776,1,0,0,0,8
EUN1_3572809396',4,27,22,2,0,2,0,8,1,371,100,31373,31747,38536,4,26,5,0,0,1,0,3,310,88,23751,26215,31911,1,61,12,7622,17,5532,6625,2,0,1,0,5
EUN1_3572349849',6,374,16,0,0,0,0,12,0,317,78,27606,28564,35181,3,30,21,2,0,2,0,3,372,86,31611,30987,40988,0,-55,-8,-4005,-5,-2423,-5807,-2,0,-2,0,9
EUN1_3572176513',6,30,16,2,0,2,0,9,1,355,88,31540,31355,34363,2,27,18,0,0,1,0,9,324,79,29575,29625,39009,1,31,9,1965,-2,1730,-4646,2,0,1,0,0
EUN1_3571993303',2,25,8,0,0,1,0,7,0,370,68,26020,28856,19651,2,24,14,2,0,1,0,7,372,122,30015,31807,28759,0,-2,-54,-3995,-6,-2951,-9108,-2,0,0,0,0
EUN1_3571809848',7,27,16,0,0,2,0,4,0,333,70,29437,29316,41361,8,98,16,1,0,0,0,7,315,90,28828,27862,37966,1,18,-20,609,0,1454,3395,-1,0,2,0,-3
EUN1_3571214194',4,26,18,1,0,1,0,7,0,352,120,29995,30771,31385,6,22,17,0,1,1,0,6,340,64,29820,30659,33792,0,12,56,175,1,112,-2407,1,-1,0,0,1
EUN1_3571182703',5,25,11,0,0,0,0,10,0,379,76,26726,30285,26172,5,27,13,2,1,0,0,7,377,122,29166,31136,37099,0,2,-46,-2440,-2,-851,-10927,-2,-1,0,0,3
EUN1_3571086732',4,24,7,0,0,0,0,10,0,371,84,25835,30897,24686,5,34,16,2,0,1,0,2,374,84,29069,31986,41358,0,-3,0,-3234,-9,-1089,-16672,-2,0,-1,0,8
EUN1_3571011215',4,24,17,0,0,0,0,10,0,298,74,28485,29956,38905,6,108,17,1,0,2,0,5,321,88,28977,30810,40898,0,-23,-14,-492,0,-854,-1993,-1,0,-2,0,5
EUN1_3570944079',3,23,12,0,0,0,0,11,0,324,86,26735,30257,27426,5,27,16,0,0,1,0,2,376,90,28284,30854,30426,0,-52,-4,-1549,-4,-597,-3000,0,0,-1,0,9
EUN1_3570842895',3,24,15,1,0,0,0,14,1,338,86,28042,30263,36047,3,23,19,1,0,1,0,4,391,106,30917,32855,39097,0,-53,-20,-2875,-4,-2592,-3050,0,0,-1,0,10
EUN1_3570207542',2,26,7,1,0,0,0,9,0,335,84,24028,28133,27008,2,22,16,1,0,1,0,2,341,106,28661,32130,36076,0,-6,-22,-4633,-9,-3997,-9068,0,0,-1,0,7
EUN1_3572890308',6,27,12,1,1,2,0,7,1,329,88,28329,30895,35573,3,21,9,1,0,0,0,4,299,100,24549,28562,30351,1,30,-12,3780,3,2333,5222,0,1,2,0,3
EUN1_3572859499',0,89,12,0,0,0,0,14,1,293,84,26313,27727,33971,3,58,19,2,0,3,0,1,369,99,31555,32128,44843,0,-76,-15,-5242,-7,-4401,-10872,-2,0,-3,0,13
EUN1_3572739346',4,27,10,1,0,0,0,13,0,334,70,25814,29217,28317,4,186,16,1,0,2,0,1,372,121,31010,32575,33698,1,-38,-51,-5196,-6,-3358,-5381,0,0,-2,0,12
EUN1_3572066636',5,22,12,1,1,1,0,5,1,384,92,27781,30293,35782,4,28,13,1,0,0,0,4,353,88,27868,31440,35355,0,31,4,-87,-1,-1147,427,0,1,1,0,1
EUN1_3572045618',2,32,10,0,0,0,0,7,0,326,76,25793,29496,31697,3,32,17,2,0,0,0,1,355,88,29410,30893,40012,1,-29,-12,-3617,-7,-1397,-8315,-2,0,0,0,6
EUN1_3571542857',1,29,16,1,0,1,0,9,0,360,94,30435,31612,38909,4,101,8,0,0,1,0,10,354,77,25259,28285,24471,1,6,17,5176,8,3327,14438,1,0,0,0,-1
EUN1_3570875849',0,25,10,0,0,1,0,7,0,336,80,26793,28804,26386,4,40,14,1,0,1,0,6,330,94,27706,30697,31137,0,6,-14,-913,-4,-1893,-4751,-1,0,0,0,1
EUN1_3570860323',2,25,14,2,0,2,0,6,1,359,112,29471,32784,40034,2,18,7,0,0,0,0,5,355,87,25049,28923,22527,1,4,25,4422,7,3861,17507,2,0,2,0,1
EUN1_3570836326',7,33,20,1,1,0,0,4,0,350,85,31352,30207,36694,4,98,11,0,0,1,0,8,267,75,25704,25760,24850,1,83,10,5648,9,4447,11844,1,1,-1,0,-4
EUN1_3570771330',4,19,16,2,0,1,0,5,1,366,106,30114,32144,30240,1,38,12,0,0,0,0,5,348,90,26593,30073,32147,1,18,16,3521,4,2071,-1907,2,0,1,0,0
EUN1_3575986159',3,23,10,1,0,0,0,9,1,373,96,26916,30831,30610,4,17,10,1,0,2,0,3,345,87,28125,30283,27645,0,28,9,-1209,0,548,2965,0,0,-2,0,6
EUN1_3575675705',2,18,13,0,0,1,0,5,0,356,64,27272,31195,30771,0,23,10,2,0,0,0,4,382,100,26327,29935,30357,0,-26,-36,945,3,1260,414,-2,0,1,0,1
EUN1_3575013854',3,30,28,1,0,0,0,8,0,263,64,31442,26262,50916,7,35,23,0,0,1,0,4,277,67,32394,27826,36762,0,-14,-3,-952,5,-1564,14154,1,0,-1,0,4
EUN1_3574683584',3,21,11,1,0,0,0,12,1,361,100,26388,29836,31568,2,44,11,1,0,1,0,3,378,92,28317,30765,36169,0,-17,8,-1929,0,-929,-4601,0,0,-1,0,9
EUN1_3571168108',4,30,22,0,0,1,0,8,0,312,68,30547,29798,39611,2,25,13,2,0,0,0,3,314,80,26798,25987,29127,0,-2,-12,3749,9,3811,10484,-2,0,1,0,5
EUN1_3565883298',1,23,10,1,0,0,0,6,1,314,85,24781,29049,23851,8,36,8,1,0,0,0,3,354,93,25785,29119,28854,0,-40,-8,-1004,2,-70,-5003,0,0,0,0,3
EUN1_3565854591',4,30,14,2,0,0,0,8,1,338,74,28511,28462,33116,3,26,19,0,1,0,0,4,306,102,30372,30610,36105,0,32,-28,-1861,-5,-2148,-2989,2,-1,0,0,4
EUN1_3565823553',2,66,11,1,0,1,0,13,0,332,76,26809,28261,26125,2,24,18,0,0,2,0,6,277,84,29730,27679,35523,1,55,-8,-2921,-7,582,-9398,1,0,-1,0,7
EUN1_3565800524',4,23,14,0,0,0,0,12,0,260,82,25870,26075,30240,0,352,24,2,1,2,0,2,368,78,33322,33948,42406,0,-108,4,-7452,-10,-7873,-12166,-2,-1,-2,0,10
EUN1_3565466592',0,19,9,1,0,0,0,13,1,335,98,26057,27467,33351,6,33,15,1,0,2,0,3,350,82,29074,30715,30571,0,-15,16,-3017,-6,-3248,2780,0,0,-2,0,10
EUN1_3565422521',3,24,4,0,0,0,0,12,1,304,76,21461,24997,22447,5,51,16,2,0,3,0,1,314,95,29863,29527,34049,0,-10,-19,-8402,-12,-4530,-11602,-2,0,-3,0,11
EUN1_3575887682',5,49,10,0,0,0,0,12,0,364,65,25724,28336,25023,0,132,13,2,0,2,0,0,367,106,29421,31502,33448,0,-3,-41,-3697,-3,-3166,-8425,-2,0,-2,0,12
EUN1_3574716482',1,21,7,1,0,1,0,9,0,367,111,25355,30491,29103,2,43,9,1,0,1,0,1,346,80,25602,28655,26180,1,21,31,-247,-2,1836,2923,0,0,0,0,8
EUN1_3574148319',3,22,6,1,0,0,0,10,1,327,97,23390,28235,24079,6,33,15,1,0,0,0,0,366,94,28166,31187,33061,0,-39,3,-4776,-9,-2952,-8982,0,0,0,0,10
EUN1_3572660265',2,33,12,1,0,0,0,12,1,283,72,25112,25510,36646,2,24,16,1,1,3,0,0,364,87,31161,28733,36759,0,-81,-15,-6049,-4,-3223,-113,0,-1,-3,0,12
EUN1_3575411510',5,39,18,0,0,0,0,13,0,342,66,29078,29979,35970,3,30,11,2,0,3,0,2,369,101,29696,29005,36314,1,-27,-35,-618,7,974,-344,-2,0,-3,0,11
EUN1_3567575289',4,65,5,0,0,0,0,4,0,346,82,23320,27838,29622,3,62,13,1,0,1,0,3,319,99,26972,30421,30266,0,27,-17,-3652,-8,-2583,-644,-1,0,-1,0,1
EUN1_3567553891',2,29,12,0,0,0,0,7,0,344,64,26776,28365,38072,7,30,19,1,0,0,0,1,335,76,29767,30351,38795,0,9,-12,-2991,-7,-1986,-723,-1,0,0,0,6
EUN1_3567388572',2,24,15,1,0,1,0,9,0,318,110,28194,30385,32513,2,33,10,1,0,1,0,3,342,64,26362,26594,34126,1,-24,46,1832,5,3791,-1613,0,0,0,0,6
EUN1_3567266643',7,36,12,1,1,0,0,15,0,343,70,25759,29036,29792,5,23,13,0,0,2,0,2,338,92,29124,29926,30605,0,5,-22,-3365,-1,-890,-813,1,1,-2,0,13
EUN1_3567239053',4,29,10,2,1,1,0,6,1,399,72,27023,31059,28211,3,73,3,0,0,0,0,7,316,91,21808,28542,15720,1,83,-19,5215,7,2517,12491,2,1,1,0,-1
EUN1_3567220010',3,29,9,1,0,1,0,8,0,363,80,25759,29151,28209,2,31,17,1,1,1,0,2,314,95,29478,30670,33608,0,49,-15,-3719,-8,-1519,-5399,0,-1,0,0,6
EUN1_3567202356',2,39,15,0,0,0,0,5,1,342,82,28128,30625,32390,4,27,10,1,0,1,0,5,339,84,25864,29334,36174,1,3,-2,2264,5,1291,-3784,-1,0,-1,0,0
EUN1_3566690567',4,26,12,1,0,0,0,15,0,304,84,27912,29016,37345,4,22,21,1,0,3,0,2,329,100,32268,31254,48259,1,-25,-16,-4356,-9,-2238,-10914,0,0,-3,0,13
EUN1_3565297859',2,28,8,1,0,1,0,8,1,334,95,25451,29913,27992,4,27,9,0,0,2,0,4,361,96,26112,30107,34326,1,-27,-1,-661,-1,-194,-6334,1,0,-1,0,4
EUN1_3564426099',2,17,19,1,0,3,0,9,1,370,84,34413,30645,43075,1,48,14,0,0,1,0,11,322,59,26968,28705,32677,1,48,25,7445,5,1940,10398,1,0,2,0,-2
EUN1_3564399402',4,331,11,0,0,0,0,9,0,345,87,26058,29437,26003,3,45,16,2,0,0,0,0,364,108,29157,31737,31260,0,-19,-21,-3099,-5,-2300,-5257,-2,0,0,0,9
EUN1_3563734293',2,24,12,0,0,1,0,10,1,347,70,26699,27215,35804,3,33,12,1,0,1,0,0,308,88,26592,28847,30608,1,39,-18,107,0,-1632,5196,-1,0,0,0,10
EUN1_3563703059',3,101,18,2,0,0,0,9,1,359,118,29525,32530,39104,3,29,7,0,0,0,0,0,306,90,24554,28216,35407,1,53,28,4971,11,4314,3697,2,0,0,0,9
EUN1_3563218084',3,30,11,1,0,0,0,10,1,347,82,26078,28091,27132,4,44,8,1,0,1,0,3,342,78,25650,27515,35597,0,5,4,428,3,576,-8465,0,0,-1,0,7
EUN1_3562686215',3,26,9,0,0,1,0,6,0,340,80,27170,29423,40979,5,31,13,2,0,0,0,5,354,76,27339,30630,34821,0,-14,4,-169,-4,-1207,6158,-2,0,1,0,1
EUN1_3562674261',6,32,5,1,0,0,0,13,0,352,52,24234,27917,24296,3,29,14,1,0,2,0,4,345,94,28842,31560,30633,0,7,-42,-4608,-9,-3643,-6337,0,0,-2,0,9
EUN1_3562654011',2,26,6,0,0,0,0,10,0,385,90,25223,28806,25174,4,33,18,2,0,1,0,5,364,112,31793,33491,35594,0,21,-22,-6570,-12,-4685,-10420,-2,0,-1,0,5
EUN1_3562644683',5,41,19,1,0,1,0,8,1,334,82,29297,28294,42333,2,33,9,0,0,0,0,5,321,82,25127,27558,30386,1,13,0,4170,10,736,11947,1,0,1,0,3
EUN1_3561955769',0,31,15,2,0,2,0,6,1,385,88,29823,31619,31272,5,20,6,0,0,0,0,10,326,83,24244,27203,24986,1,59,5,5579,9,4416,6286,2,0,2,0,-4
EUN1_3575715682',2,24,20,2,1,1,0,4,1,304,89,31700,28409,44275,1,21,15,0,0,0,0,5,297,76,27777,28626,31950,1,7,13,3923,5,-217,12325,2,1,1,0,-1
EUN1_3574840022',6,133,19,0,1,1,0,7,1,351,84,30369,30545,31903,3,27,13,1,0,0,0,5,304,84,26564,26218,31011,1,47,0,3805,6,4327,892,-1,1,1,0,2
EUN1_3574148733',3,27,21,1,0,0,0,7,1,334,78,31032,28887,50361,6,30,13,0,0,1,0,5,344,78,28861,29727,37518,1,-10,0,2171,8,-840,12843,1,0,-1,0,2
EUN1_3574112545',5,31,18,1,0,0,0,9,0,345,74,31758,28939,33218,6,32,28,0,0,1,0,4,361,94,34521,32214,53320,1,-16,-20,-2763,-10,-3275,-20102,1,0,-1,0,5
EUN1_3574104130',2,63,7,1,0,0,0,11,1,336,87,24295,27768,29117,2,31,11,1,0,2,0,2,411,120,31625,32476,31403,0,-75,-33,-7330,-4,-4708,-2286,0,0,-2,0,9
EUN1_3573637578',3,24,2,0,0,0,0,12,0,343,90,22626,26158,26646,2,44,15,2,0,3,0,4,375,86,30273,31752,32821,0,-32,4,-7647,-13,-5594,-6175,-2,0,-3,0,8
EUN1_3573587251',4,27,18,0,0,0,0,13,0,342,112,31330,32388,43421,3,25,18,2,0,1,0,4,308,82,31375,29588,34646,1,34,30,-45,0,2800,8775,-2,0,-1,0,9
EUN1_3573544333',3,47,18,1,0,0,0,11,0,330,91,29587,29840,35074,7,29,14,1,0,1,0,2,299,80,25751,26787,26868,1,31,11,3836,4,3053,8206,0,0,-1,0,9
EUN1_3568325012',6,48,12,1,1,1,0,8,0,335,81,26585,30225,28535,5,41,5,0,0,0,0,5,385,82,23991,27638,21433,1,-50,-1,2594,7,2587,7102,1,1,1,0,3
EUN1_3572024845',4,51,15,1,0,0,0,9,0,325,80,27987,28541,34364,2,54,10,1,1,2,0,5,348,80,26517,27555,33401,1,-23,0,1470,5,986,963,0,-1,-2,0,4
EUN1_3571987288',7,41,14,1,0,0,0,11,1,346,90,28166,28226,32838,7,32,14,1,0,1,0,4,376,80,28893,31263,32759,0,-30,10,-727,0,-3037,79,0,0,-1,0,7
EUN1_3571966888',3,27,13,1,0,2,0,7,1,354,106,29377,31787,36905,6,41,11,0,0,0,0,9,296,98,26362,30212,26518,1,58,8,3015,2,1575,10387,1,0,2,0,-2
EUN1_3570729048',4,31,11,0,0,1,0,6,0,354,72,26523,29150,31033,9,32,7,1,1,0,0,2,366,104,26129,29906,36628,1,-12,-32,394,4,-756,-5595,-1,-1,1,0,4
EUN1_3570630435',3,28,5,0,0,1,0,11,0,279,96,23142,24601,23258,1,36,19,2,0,2,0,7,377,84,30607,30840,39924,0,-98,12,-7465,-14,-6239,-16666,-2,0,-1,0,4
EUN1_3570595840',7,145,12,2,0,0,0,12,0,349,93,26956,28486,28468,2,25,6,0,0,2,0,3,354,94,24618,28022,23833,1,-5,-1,2338,6,464,4635,2,0,-2,0,9
EUN1_3576150853',2,19,16,2,0,0,0,7,1,369,90,29678,32641,33619,2,22,7,0,0,1,0,6,336,109,24682,28276,27423,1,33,-19,4996,9,4365,6196,2,0,-1,0,1
EUN1_3576149111',3,23,21,2,1,2,0,2,1,365,102,34052,32011,40855,3,24,12,0,0,0,0,13,306,76,25143,27301,28697,1,59,26,8909,9,4710,12158,2,1,2,0,-11
EUN1_3576125902',5,24,17,1,0,1,0,4,1,392,116,31230,31892,36322,0,29,3,0,0,1,0,9,308,56,22048,26855,24277,1,84,60,9182,14,5037,12045,1,0,0,0,-5
EUN1_3575655587',2,28,12,0,0,0,0,12,1,275,74,24885,26969,31469,2,27,23,1,0,1,0,2,350,102,30916,31670,47100,0,-75,-28,-6031,-11,-4701,-15631,-1,0,-1,0,10
EUN1_3575653133',5,23,15,2,0,0,0,10,1,332,100,27997,29841,30027,2,19,10,0,0,2,0,1,345,84,27061,28684,33384,1,-13,16,936,5,1157,-3357,2,0,-2,0,9
EUN1_3575634719',2,31,11,2,0,1,0,8,1,406,106,29048,32623,36786,4,22,10,0,0,1,0,4,351,74,25388,29080,25747,1,55,32,3660,1,3543,11039,2,0,0,0,4
EUN1_3575512056',2,24,17,2,0,2,0,11,0,369,105,31380,32040,38189,4,29,11,0,0,2,0,8,339,78,27063,29318,29130,1,30,27,4317,6,2722,9059,2,0,0,0,3
EUN1_3575480274',6,43,11,1,0,2,0,10,1,374,82,29274,30794,27128,5,25,14,0,0,0,0,5,341,66,27541,27155,30363,1,33,16,1733,-3,3639,-3235,1,0,2,0,5
EUN1_3575361533',5,26,12,1,0,2,0,7,1,324,75,27471,29255,32933,6,36,12,0,0,1,0,6,316,88,26883,28486,30958,1,8,-13,588,0,769,1975,1,0,1,0,1
EUN1_3575323251',2,35,10,1,0,2,0,7,1,407,92,29812,29898,29081,5,42,13,1,0,0,0,5,341,75,27088,28743,25075,0,66,17,2724,-3,1155,4006,0,0,2,0,2
EUN1_3575039465',2,41,14,0,0,1,0,8,1,366,22,26817,26142,32031,2,19,5,1,0,1,0,6,342,110,24085,28726,23296,0,24,-88,2732,9,-2584,8735,-1,0,0,0,2
EUN1_3574711238',2,24,6,0,0,0,0,6,0,391,95,25639,30314,24070,7,45,9,2,0,0,0,2,350,100,25486,31013,27672,1,41,-5,153,-3,-699,-3602,-2,0,0,0,4
EUN1_3574685330',6,41,15,0,0,0,0,11,1,347,84,28998,30471,30816,5,36,10,2,0,1,0,1,368,96,27844,31098,32911,0,-21,-12,1154,5,-627,-2095,-2,0,-1,0,10
EUN1_3574662589',3,24,10,0,1,0,0,10,0,316,84,25870,28094,23375,2,22,21,2,0,2,0,0,356,88,31009,31253,35777,0,-40,-4,-5139,-11,-3159,-12402,-2,1,-2,0,10
EUN1_3574653404',4,147,7,1,0,1,0,9,1,348,88,25918,28057,24606,5,30,17,1,0,0,0,4,311,68,28599,27699,31712,0,37,20,-2681,-10,358,-7106,0,0,1,0,5
EUN1_3574624814',2,26,9,0,0,0,0,16,1,319,64,25471,27057,27274,5,32,15,2,0,3,0,3,372,84,30706,29018,30140,0,-53,-20,-5235,-6,-1961,-2866,-2,0,-3,0,13
EUN1_3574518347',4,25,21,1,0,2,0,10,1,328,88,31430,30146,43372,1,18,6,1,0,0,0,5,287,86,23306,25110,26115,1,41,2,8124,15,5036,17257,0,0,2,0,5
EUN1_3574471878',5,242,18,2,0,1,0,9,1,390,68,32223,31459,40332,3,24,12,0,0,1,0,8,348,98,27752,31033,31701,1,42,-30,4471,6,426,8631,2,0,0,0,1
EUN1_3574443435',4,27,19,0,1,1,0,9,1,324,84,31130,31275,44221,3,79,18,1,0,2,0,5,331,78,30202,30476,40270,1,-7,6,928,1,799,3951,-1,1,-1,0,4
EUN1_3574409517',3,28,15,2,0,2,0,4,0,354,84,30772,29679,30953,1,26,13,0,0,0,0,4,340,91,28742,29040,33462,1,14,-7,2030,2,639,-2509,2,0,2,0,0
EUN1_3573638728',0,30,23,1,0,1,0,17,0,353,86,33054,30945,46040,3,27,10,0,0,2,0,4,348,74,28602,27196,27292,0,5,12,4452,13,3749,18748,1,0,-1,0,13
EUN1_3573620709',8,48,7,0,0,0,0,9,1,300,83,23961,26040,25845,4,96,21,2,0,1,0,4,347,76,30691,30352,41230,0,-47,7,-6730,-14,-4312,-15385,-2,0,-1,0,5
EUN1_3572201021',1,28,7,1,1,0,0,9,0,301,94,23330,26777,27275,2,29,12,0,0,0,0,1,343,110,27016,30058,31533,0,-42,-16,-3686,-5,-3281,-4258,1,1,0,0,8
EUN1_3572020299',2,144,14,1,0,0,0,7,1,335,58,26763,27777,32576,9,31,9,0,0,0,0,4,314,122,26152,28511,30983,0,21,-64,611,5,-734,1593,1,0,0,0,3
EUN1_3572001685',4,28,6,0,0,0,0,3,1,354,112,24513,31026,17818,3,23,6,2,0,0,0,4,366,104,24682,30732,17526,0,-12,8,-169,0,294,292,-2,0,0,0,-1
EUN1_3571933666',3,28,10,1,0,0,0,6,1,367,92,26851,30645,27802,2,27,10,1,0,0,0,6,350,80,25943,29357,28074,1,17,12,908,0,1288,-272,0,0,0,0,0
EUN1_3571930094',5,28,18,1,0,2,0,6,0,382,112,34308,33551,40416,4,27,11,1,0,1,0,9,372,76,27151,29786,31431,1,10,36,7157,7,3765,8985,0,0,1,0,-3
EUN1_3571364523',1,20,10,0,1,0,0,9,1,341,88,25310,30218,27222,1,23,7,2,0,2,0,2,342,92,24485,28077,24792,0,-1,-4,825,3,2141,2430,-2,1,-2,0,7
EUN1_3571347545',1,28,10,1,0,0,0,8,0,349,91,26229,28469,28717,2,18,13,1,0,1,0,1,292,81,25713,29431,28630,0,57,10,516,-3,-962,87,0,0,-1,0,7
EUN1_3575957651',9,34,15,0,0,0,0,12,1,318,69,27257,27584,30907,0,26,12,1,0,2,0,3,359,110,29849,30346,34264,0,-41,-41,-2592,3,-2762,-3357,-1,0,-2,0,9
EUN1_3575152493',3,22,9,1,0,0,0,11,0,342,101,26567,29906,33256,2,21,15,1,0,1,0,5,339,79,28175,30220,31701,0,3,22,-1608,-6,-314,1555,0,0,-1,0,6
EUN1_3575148611',2,26,11,2,0,2,0,4,1,378,94,27819,31037,33152,5,34,9,0,0,0,0,2,344,89,24748,29718,25837,1,34,5,3071,2,1319,7315,2,0,2,0,2
EUN1_3574628313',6,28,11,1,0,0,0,10,0,340,92,26455,28712,23938,2,48,12,1,0,1,0,3,326,63,26086,27298,33083,1,14,29,369,-1,1414,-9145,0,0,-1,0,7
EUN1_3574623214',3,27,13,1,0,0,0,12,0,266,64,25440,26759,35121,0,32,20,1,0,3,0,2,370,96,31656,31257,42663,0,-104,-32,-6216,-7,-4498,-7542,0,0,-3,0,10
EUN1_3574088482',1,31,23,2,0,3,0,3,1,391,122,35920,32371,40758,5,20,8,0,0,0,0,12,299,86,24755,27418,25481,1,92,36,11165,15,4953,15277,2,0,3,0,-9
EUN1_3574087138',2,25,20,1,0,0,0,6,0,312,94,30904,30531,42265,3,29,17,1,0,0,0,3,315,85,28581,28634,39543,1,-3,9,2323,3,1897,2722,0,0,0,0,3
EUN1_3573137544',3,38,17,2,0,0,0,4,1,329,83,28883,28532,39818,4,29,13,0,0,0,0,3,328,74,26754,27874,31157,1,1,9,2129,4,658,8661,2,0,0,0,1
EUN1_3575775071',2,18,16,0,0,0,0,11,1,355,67,29764,29358,32324,4,25,11,1,0,1,0,6,340,112,27148,29954,32124,0,15,-45,2616,5,-596,200,-1,0,-1,0,5
EUN1_3575761631',0,31,8,0,0,1,0,11,1,358,77,25461,27456,21925,2,25,9,2,0,2,0,5,394,79,27759,31266,25768,1,-36,-2,-2298,-1,-3810,-3843,-2,0,-1,0,6
EUN1_3575748888',6,69,9,0,0,1,0,4,0,333,90,26436,28070,35491,6,27,10,1,0,0,0,2,314,86,25155,28473,25387,1,19,4,1281,-1,-403,10104,-1,0,1,0,2
EUN1_3575730967',3,25,12,1,1,0,0,9,0,353,68,27326,27951,30509,5,26,11,0,0,1,0,3,297,79,25268,25935,32404,0,56,-11,2058,1,2016,-1895,1,1,-1,0,6
EUN1_3575723722',2,26,6,0,0,0,0,7,0,389,98,25224,30701,25279,7,32,15,2,0,1,0,4,363,86,28733,32004,36008,0,26,12,-3509,-9,-1303,-10729,-2,0,-1,0,3
EUN1_3575719528',3,29,9,1,0,0,0,14,0,343,87,26219,28962,26331,3,23,11,1,0,2,0,4,390,120,29156,30048,27788,0,-47,-33,-2937,-2,-1086,-1457,0,0,-2,0,10
EUN1_3575685117',2,21,14,1,0,1,0,11,1,309,95,28472,27989,29564,1,24,20,1,0,0,0,4,341,62,29198,29545,37971,0,-32,33,-726,-6,-1556,-8407,0,0,1,0,7
EUN1_3575669999',5,30,13,2,1,0,0,10,1,358,89,27658,29664,33470,3,27,18,0,0,0,0,1,368,82,29087,28872,37470,1,-10,7,-1429,-5,792,-4000,2,1,0,0,9
EUN1_3575678194',2,22,14,1,0,0,0,9,1,366,94,27897,30162,36183,3,76,16,1,0,0,0,2,346,102,29457,32250,39706,0,20,-8,-1560,-2,-2088,-3523,0,0,0,0,7
EUN1_3575668456',2,22,16,1,0,0,0,8,0,322,66,28305,28957,28859,6,39,12,1,0,0,0,4,337,98,27429,28846,32594,1,-15,-32,876,4,111,-3735,0,0,0,0,4
EUN1_3575665395',1,25,12,1,0,1,0,7,0,353,72,27781,30110,31943,5,26,17,0,1,1,0,3,311,108,28633,33009,36013,0,42,-36,-852,-5,-2899,-4070,1,-1,0,0,4
EUN1_3575644054',3,39,21,1,0,0,0,10,1,337,84,31564,32452,42483,2,22,15,0,0,2,0,4,280,82,27723,28217,31560,1,57,2,3841,6,4235,10923,1,0,-2,0,6
EUN1_3575642740',1,22,5,0,0,2,0,14,0,338,68,25066,26160,23781,3,29,24,2,0,3,0,5,326,104,32647,34218,40858,0,12,-36,-7581,-19,-8058,-17077,-2,0,-1,0,9
EUN1_3575632464',5,75,10,2,0,0,0,7,1,355,84,27038,28464,34797,1,17,14,0,1,2,0,3,343,96,28085,30437,36452,0,12,-12,-1047,-4,-1973,-1655,2,-1,-2,0,4
EUN1_3575612142',2,72,14,0,0,0,0,13,1,314,70,26489,27979,34448,3,26,26,2,0,1,0,0,348,102,33478,33904,47676,0,-34,-32,-6989,-12,-5925,-13228,-2,0,-1,0,13
EUN1_3575591407',6,25,15,1,0,0,0,4,0,379,104,28341,31992,35327,3,23,12,1,0,0,0,9,381,64,26906,28778,30973,1,-2,40,1435,3,3214,4354,0,0,0,0,-5
EUN1_3575555713',6,74,13,1,1,2,0,8,1,375,102,29554,30690,39890,6,89,14,0,0,1,0,6,302,78,26997,27351,34626,1,73,24,2557,-1,3339,5264,1,1,1,0,2
EUN1_3575530599',5,25,9,0,0,1,0,10,0,325,76,24837,28263,25747,2,29,17,2,0,2,0,2,336,89,29743,30864,29236,0,-11,-13,-4906,-8,-2601,-3489,-2,0,-1,0,8
EUN1_3575985948',4,24,18,1,0,0,0,9,0,379,80,29625,31463,39687,3,35,13,0,0,0,0,5,359,68,27336,30253,29273,1,20,12,2289,5,1210,10414,1,0,0,0,4
EUN1_3575964165',2,28,17,0,0,1,0,11,0,294,77,28688,26867,36046,3,54,19,1,0,1,0,3,328,71,30088,27846,42273,1,-34,6,-1400,-2,-979,-6227,-1,0,0,0,8
EUN1_3575933959',4,28,16,2,0,1,0,5,0,357,94,29525,29814,36552,5,30,12,0,0,0,0,1,328,85,26808,28744,32572,1,29,9,2717,4,1070,3980,2,0,1,0,4
EUN1_3575908648',5,23,6,0,0,1,0,11,1,340,80,24149,25651,26430,2,33,17,2,0,2,0,3,394,80,31234,31632,37447,0,-54,0,-7085,-11,-5981,-11017,-2,0,-1,0,8
EUN1_3575885253',4,21,15,1,0,0,0,9,1,352,82,28701,28987,39285,3,22,10,1,0,1,0,5,332,94,26712,28235,37190,0,20,-12,1989,5,752,2095,0,0,-1,0,4
EUN1_3575855056',3,24,17,1,1,0,0,11,0,364,107,29529,31607,36055,7,30,14,1,0,1,0,4,369,79,29654,30547,32004,0,-5,28,-125,3,1060,4051,0,1,-1,0,7
EUN1_3575846244',2,29,18,0,0,0,0,12,1,320,60,29500,26644,42900,2,19,21,1,0,2,0,4,315,100,32293,27876,42442,1,5,-40,-2793,-3,-1232,458,-1,0,-2,0,8
EUN1_3575831166',3,20,10,0,0,0,0,10,0,323,78,26633,28913,29975,3,27,16,2,0,1,0,2,410,130,30758,33667,36970,0,-87,-52,-4125,-6,-4754,-6995,-2,0,-1,0,8
EUN1_3575783285',3,22,20,0,0,2,0,10,1,356,87,32662,31546,43819,0,26,9,1,0,1,0,7,339,58,26076,26951,40062,0,17,29,6586,11,4595,3757,-1,0,1,0,3
EUN1_3575771307',7,39,11,0,0,0,0,5,1,343,88,26422,28002,30835,5,30,12,2,0,0,0,2,370,79,27260,29806,39712,0,-27,9,-838,-1,-1804,-8877,-2,0,0,0,3
EUN1_3575738606',6,25,15,1,0,0,0,9,0,332,74,27153,29568,32792,3,51,13,0,0,1,0,1,368,81,28985,29774,35152,1,-36,-7,-1832,2,-206,-2360,1,0,-1,0,8
EUN1_3575721874',4,29,11,0,0,0,0,3,0,329,76,26692,27636,33690,3,23,15,1,0,0,0,0,312,104,27069,29862,35892,0,17,-28,-377,-4,-2226,-2202,-1,0,0,0,3
EUN1_3575391998',1,17,11,1,0,1,0,13,1,391,90,28772,30011,34178,4,105,13,1,0,1,0,3,352,78,27964,27698,29779,0,39,12,808,-2,2313,4399,0,0,0,0,10
EUN1_3575361016',2,25,19,1,1,1,0,12,0,360,73,31278,29365,51951,2,25,26,0,0,2,0,7,335,86,33587,30602,45765,0,25,-13,-2309,-7,-1237,6186,1,1,-1,0,5
EUN1_3573547720',2,62,12,0,0,1,0,9,0,343,105,28197,30137,38334,2,57,10,1,0,1,0,1,364,74,27096,30596,31514,0,-21,31,1101,2,-459,6820,-1,0,0,0,8
EUN1_3573199486',4,27,18,1,1,3,0,9,1,382,82,31848,32739,47644,0,26,12,0,0,0,0,9,355,97,26051,30444,37115,1,27,-15,5797,6,2295,10529,1,1,3,0,0
EUN1_3573170960',3,26,19,1,0,1,0,10,0,336,84,30190,30985,51107,5,32,13,1,0,0,0,4,320,80,26412,29349,34504,1,16,4,3778,6,1636,16603,0,0,1,0,6
EUN1_3572610156',4,142,15,2,0,1,0,8,0,335,71,27069,29337,39605,2,24,12,0,0,0,0,3,335,108,27687,30061,40943,0,0,-37,-618,3,-724,-1338,2,0,1,0,5
EUN1_3571541198',2,18,7,0,0,0,0,15,0,298,75,23219,26963,29518,0,27,20,2,0,6,0,1,401,90,35241,31730,44181,0,-103,-15,-12022,-13,-4767,-14663,-2,0,-6,0,14
EUN1_3571491124',6,26,10,0,0,0,0,6,1,342,76,25598,27166,33548,3,29,19,0,0,1,0,4,359,80,29587,29976,41119,0,-17,-4,-3989,-9,-2810,-7571,0,0,-1,0,2
EUN1_3571459114',1,28,6,1,0,0,0,14,1,345,94,24197,29623,25073,4,27,14,1,1,3,0,3,365,98,30340,33124,32560,1,-20,-4,-6143,-8,-3501,-7487,0,-1,-3,0,11
EUN1_3571346623',1,25,22,0,0,0,0,12,0,328,72,30466,32410,41328,4,30,20,2,1,1,0,2,332,123,30723,30509,39498,1,-4,-51,-257,2,1901,1830,-2,-1,-1,0,10
EUN1_3570758682',3,25,15,2,0,1,0,5,1,356,80,29423,30894,38596,5,33,14,0,0,0,0,10,314,79,26718,29343,31123,1,42,1,2705,1,1551,7473,2,0,1,0,-5
EUN1_3569103116',4,26,8,1,0,0,0,3,1,398,88,24873,31183,27841,3,40,5,1,0,0,0,1,370,95,23502,29694,24468,0,28,-7,1371,3,1489,3373,0,0,0,0,2
EUN1_3568736339',3,29,12,0,0,0,0,6,1,278,81,25180,25497,29447,2,27,15,2,0,0,0,0,319,91,27173,30325,36601,0,-41,-10,-1993,-3,-4828,-7154,-2,0,0,0,6
EUN1_3568688103',7,31,11,2,1,1,0,11,1,328,126,27021,29441,29628,7,31,8,0,0,1,0,5,336,82,26047,27926,26563,1,-8,44,974,3,1515,3065,2,1,0,0,6
EUN1_3568355964',2,32,13,1,0,0,0,3,1,329,88,26826,29765,29463,3,23,7,1,0,0,0,4,340,88,24080,27081,29478,0,-11,0,2746,6,2684,-15,0,0,0,0,-1
EUN1_3568352455',4,28,20,1,0,3,0,11,1,377,95,33191,31786,39383,2,25,7,1,0,0,0,6,316,72,24399,27998,25892,1,61,23,8792,13,3788,13491,0,0,3,0,5
EUN1_3568338107',9,28,10,0,1,1,0,5,0,368,100,27959,30810,23154,5,30,4,2,0,0,0,7,354,84,22448,27235,17753,1,14,16,5511,6,3575,5401,-2,1,1,0,-2
EUN1_3568307928',2,29,11,1,0,0,0,13,0,326,86,26404,28598,29440,3,23,16,1,1,2,0,4,320,86,29794,30166,38250,0,6,0,-3390,-5,-1568,-8810,0,-1,-2,0,9
EUN1_3568287774',3,29,24,2,0,3,0,8,1,350,116,34820,33737,39034,1,66,6,0,0,1,0,6,311,76,23478,29100,27978,1,39,40,11342,18,4637,11056,2,0,2,0,2
EUN1_3568200546',1,28,15,2,1,1,0,5,1,336,112,28685,31203,30901,5,26,6,0,0,0,0,3,344,98,23589,27999,26700,1,-8,14,5096,9,3204,4201,2,1,1,0,2
EUN1_3567915695',5,26,10,1,0,0,0,5,0,360,120,26471,30885,34730,2,20,6,0,0,0,0,1,334,80,23017,28167,21523,0,26,40,3454,4,2718,13207,1,0,0,0,4
EUN1_3567736371',4,34,11,1,0,1,0,9,0,350,106,27462,31179,28197,5,29,8,1,0,1,0,6,382,90,26957,30700,22448,1,-32,16,505,3,479,5749,0,0,0,0,3
EUN1_3565540435',1,29,6,0,0,0,0,15,1,238,81,22092,24296,21752,5,143,15,2,1,4,0,3,361,94,30765,30919,34130,0,-123,-13,-8673,-9,-6623,-12378,-2,-1,-4,0,12
EUN1_3565530589',0,58,16,1,0,1,0,6,1,358,85,29594,32762,40629,4,57,11,0,0,0,0,6,325,77,25621,27883,30767,1,33,8,3973,5,4879,9862,1,0,1,0,0
EUN1_3565406736',1,47,11,0,0,0,0,10,1,341,80,25254,28860,25935,3,26,6,2,0,0,0,3,335,108,25045,29166,24925,0,6,-28,209,5,-306,1010,-2,0,0,0,7
EUN1_3573816155',6,31,12,0,0,0,0,13,0,289,78,25583,27022,29753,5,28,14,1,0,0,0,0,329,80,28489,28977,32491,1,-40,-2,-2906,-2,-1955,-2738,-1,0,0,0,13
EUN1_3573798104',2,19,22,0,0,1,0,5,0,362,111,31901,33938,42202,3,31,10,1,0,1,0,11,265,64,25535,26816,28436,1,97,47,6366,12,7122,13766,-1,0,0,0,-6
EUN1_3572587067',3,29,13,1,0,0,0,14,1,296,78,25138,28075,27512,2,53,18,1,0,1,0,0,402,82,30790,32348,43430,0,-106,-4,-5652,-5,-4273,-15918,0,0,-1,0,14
EUN1_3572570001',4,137,15,1,0,1,0,9,0,347,72,29886,28379,29883,3,38,19,0,0,1,0,6,333,75,30182,30711,36536,0,14,-3,-296,-4,-2332,-6653,1,0,0,0,3
EUN1_3572540054',5,25,14,1,0,0,0,8,0,309,92,25900,30512,28312,6,30,11,0,0,1,0,3,341,72,27035,29841,28906,1,-32,20,-1135,3,671,-594,1,0,-1,0,5
EUN1_3572529884',2,24,10,0,0,0,0,5,1,323,80,24902,28531,26827,1,24,11,1,0,0,0,3,364,94,26434,29089,34018,1,-41,-14,-1532,-1,-558,-7191,-1,0,0,0,2
EUN1_3572511062',2,25,10,0,0,0,0,7,0,360,92,26567,29542,29412,3,24,13,1,0,0,0,2,340,96,26519,30871,36286,0,20,-4,48,-3,-1329,-6874,-1,0,0,0,5
EUN1_3572481897',3,28,18,2,0,0,0,4,0,349,68,29612,30825,35859,3,21,17,0,0,0,0,0,319,96,28112,29533,38677,1,30,-28,1500,1,1292,-2818,2,0,0,0,4
EUN1_3572349159',3,26,9,1,0,1,0,7,1,316,84,25859,27826,29051,3,38,14,1,0,0,0,4,360,88,27769,30824,32443,0,-44,-4,-1910,-5,-2998,-3392,0,0,1,0,3
EUN1_3572237368',5,29,19,0,0,1,0,8,1,339,92,29678,32208,38236,2,22,14,1,0,1,0,4,319,87,28195,29895,32780,0,20,5,1483,5,2313,5456,-1,0,0,0,4
EUN1_3572207183',3,26,9,1,0,0,0,6,0,332,102,25543,29261,29363,3,37,9,1,0,0,0,5,309,118,24442,30038,31418,1,23,-16,1101,0,-777,-2055,0,0,0,0,1
EUN1_3572174597',7,22,12,0,0,2,0,12,0,318,80,28324,29181,30270,8,158,14,1,0,1,0,8,339,72,28428,29178,34366,1,-21,8,-104,-2,3,-4096,-1,0,1,0,4
EUN1_3572112005',2,23,9,0,0,0,0,9,0,286,82,23445,26085,32737,5,34,16,2,0,1,0,0,364,88,28849,32080,37922,0,-78,-6,-5404,-7,-5995,-5185,-2,0,-1,0,9
EUN1_3572099257',4,25,13,1,0,0,0,4,0,386,94,27290,30997,36039,3,29,12,1,0,0,0,4,345,78,26674,29386,24593,1,41,16,616,1,1611,11446,0,0,0,0,0
EUN1_3572038081',7,65,11,2,0,1,0,12,0,325,78,26243,29145,29815,8,75,14,0,0,2,0,3,357,104,29875,32918,40381,0,-32,-26,-3632,-3,-3773,-10566,2,0,-1,0,9
EUN1_3571915929',1,18,12,0,1,0,0,5,0,366,89,28152,30669,32519,1,22,9,1,0,0,0,3,324,64,24215,27408,24113,0,42,25,3937,3,3261,8406,-1,1,0,0,2
EUN1_3571796625',3,25,18,2,0,0,0,9,1,342,86,28666,29926,32933,2,139,11,0,0,2,0,4,361,93,29074,31962,25950,1,-19,-7,-408,7,-2036,6983,2,0,-2,0,5
EUN1_3571780507',4,26,14,0,0,1,0,8,0,308,86,26432,29026,38522,2,27,9,2,0,2,0,0,348,93,27390,29742,25504,0,-40,-7,-958,5,-716,13018,-2,0,-1,0,8
EUN1_3571755451',4,27,16,0,0,1,0,8,0,324,114,29509,32081,36872,4,40,13,1,0,1,0,6,347,102,28002,31135,32356,0,-23,12,1507,3,946,4516,-1,0,0,0,2
EUN1_3575901790',4,25,8,0,0,0,0,8,1,365,96,24687,30349,20203,5,38,9,1,1,0,0,2,338,107,25627,29963,27354,0,27,-11,-940,-1,386,-7151,-1,-1,0,0,6
EUN1_3575883504',5,26,11,0,0,0,0,7,0,368,79,27033,27975,32856,3,23,11,2,0,0,0,4,327,96,25284,27862,33415,1,41,-17,1749,0,113,-559,-2,0,0,0,3
EUN1_3574209106',4,30,14,1,0,0,0,9,1,339,78,27466,30371,27487,1,25,10,0,0,2,0,0,358,98,27413,29510,32211,0,-19,-20,53,4,861,-4724,1,0,-2,0,9
EUN1_3574182741',6,33,10,1,0,0,0,4,0,325,104,25692,28045,33241,4,27,16,1,0,0,0,4,341,75,28302,28576,30040,0,-16,29,-2610,-6,-531,3201,0,0,0,0,0
EUN1_3574158064',2,32,13,1,0,1,0,7,1,291,98,28313,26724,31505,2,40,15,1,1,1,0,6,353,68,28270,30430,33488,0,-62,30,43,-2,-3706,-1983,0,-1,0,0,1
EUN1_3573768869',4,29,10,0,0,1,0,13,1,370,73,27300,29235,28321,5,23,11,2,0,0,0,4,332,86,26328,31263,34325,1,38,-13,972,-1,-2028,-6004,-2,0,1,0,9
EUN1_3573363288',2,28,7,0,0,0,0,8,0,374,74,23397,27549,30331,3,28,18,2,0,2,0,1,380,85,30040,32540,36579,0,-6,-11,-6643,-11,-4991,-6248,-2,0,-2,0,7
EUN1_3572208158',2,24,11,0,0,1,0,11,0,351,84,27395,29541,32313,4,31,19,2,0,1,0,2,373,108,30931,31278,36816,0,-22,-24,-3536,-8,-1737,-4503,-2,0,0,0,9
EUN1_3572160626',4,22,12,0,0,1,0,7,1,297,95,27257,28470,37135,5,32,14,1,0,0,0,5,316,76,26394,28174,27434,0,-19,19,863,-2,296,9701,-1,0,1,0,2
EUN1_3572141955',7,31,9,0,0,0,0,6,1,310,92,23570,29127,28508,2,22,13,2,0,0,0,0,338,92,26407,29468,31029,0,-28,0,-2837,-4,-341,-2521,-2,0,0,0,6
EUN1_3572121377',8,43,13,2,0,0,0,14,1,343,90,26950,29136,33734,5,24,12,0,0,2,0,3,329,98,27305,28703,31794,0,14,-8,-355,1,433,1940,2,0,-2,0,11
EUN1_3571718109',3,24,5,1,0,0,0,4,1,391,94,23852,29086,25073,3,27,9,0,0,0,0,1,406,86,25319,30868,24868,1,-15,8,-1467,-4,-1782,205,1,0,0,0,3
EUN1_3571673775',1,19,7,2,0,0,0,3,0,336,126,24535,29497,27005,3,26,9,0,0,0,0,2,361,93,24933,29505,26658,1,-25,33,-398,-2,-8,347,2,0,0,0,1
EUN1_3571659213',4,107,4,0,0,0,0,9,1,316,76,21971,25508,30507,4,26,16,2,0,1,0,2,400,84,29487,32289,35746,0,-84,-8,-7516,-12,-6781,-5239,-2,0,-1,0,7
EUN1_3571516482',2,27,10,0,0,0,0,5,0,354,69,26135,28154,28112,3,33,15,2,0,0,0,5,350,88,27464,28976,35277,1,4,-19,-1329,-5,-822,-7165,-2,0,0,0,0
EUN1_3571382159',2,82,12,0,0,0,0,11,0,285,72,24909,27337,31592,5,28,21,1,0,2,0,1,340,108,32920,33943,43183,0,-55,-36,-8011,-9,-6606,-11591,-1,0,-2,0,10
EUN1_3565007122',2,17,10,1,0,0,0,12,0,291,82,24669,26483,29021,5,27,24,1,1,4,0,0,389,84,35295,31196,40197,0,-98,-2,-10626,-14,-4713,-11176,0,-1,-4,0,12
EUN1_3575778436',7,24,11,2,0,2,0,7,0,368,73,28094,31149,31072,2,43,16,0,0,1,0,4,341,102,29131,32000,29259,0,27,-29,-1037,-5,-851,1813,2,0,1,0,3
EUN1_3575182387',7,27,11,1,0,1,0,6,0,400,101,28703,31326,33761,6,25,19,1,0,0,0,5,322,75,28562,28418,42167,0,78,26,141,-8,2908,-8406,0,0,1,0,1
EUN1_3575161557',3,43,8,0,0,0,0,12,1,336,96,24523,28242,29910,5,31,15,2,0,2,0,3,381,85,29560,32494,30831,0,-45,11,-5037,-7,-4252,-921,-2,0,-2,0,9
EUN1_3574253477',0,41,22,0,0,1,0,8,0,374,98,32936,34078,43295,6,59,9,1,0,2,0,7,338,82,26716,29156,34004,1,36,16,6220,13,4922,9291,-1,0,-1,0,1
EUN1_3574133868',7,32,10,1,0,1,0,6,1,370,80,27454,29794,24847,5,23,12,1,0,0,0,5,381,92,28272,30366,31785,0,-11,-12,-818,-2,-572,-6938,0,0,1,0,1
EUN1_3574098553',6,24,15,1,0,1,0,10,0,334,90,28883,29112,32779,6,27,17,1,0,2,0,3,357,90,30394,30502,37864,1,-23,0,-1511,-2,-1390,-5085,0,0,-1,0,7
EUN1_3573648390',6,25,23,1,0,0,0,9,0,334,80,31040,30723,40394,2,26,9,0,0,1,0,4,366,82,26372,27126,32021,1,-32,-2,4668,14,3597,8373,1,0,-1,0,5
EUN1_3573628415',2,24,10,1,0,0,0,10,0,303,84,24569,28747,25179,6,173,13,1,0,1,0,1,379,86,28505,31345,32047,0,-76,-2,-3936,-3,-2598,-6868,0,0,-1,0,9
EUN1_3573603643',3,26,11,0,0,0,0,12,1,355,78,25937,27486,26096,5,39,18,2,0,1,0,1,357,90,30788,31502,36146,1,-2,-12,-4851,-7,-4016,-10050,-2,0,-1,0,11
EUN1_3573589424',6,26,10,1,0,0,0,10,1,328,80,26326,26840,30107,6,37,10,0,0,2,0,1,298,72,24952,27015,32324,1,30,8,1374,0,-175,-2217,1,0,-2,0,9
EUN1_3573563606',0,24,8,1,0,0,0,13,0,340,86,25378,28210,21490,4,23,13,1,1,2,0,0,402,102,29469,31346,24333,0,-62,-16,-4091,-5,-3136,-2843,0,-1,-2,0,13
EUN1_3573649674',5,24,19,1,0,0,0,11,0,290,90,28864,28402,37766,3,27,20,0,0,0,0,1,307,78,30009,30194,44276,0,-17,12,-1145,-1,-1792,-6510,1,0,0,0,10
EUN1_3573629840',1,29,17,1,0,1,0,10,1,310,86,29108,30653,32685,5,30,4,1,0,0,0,4,360,82,23736,28164,22509,1,-50,4,5372,13,2489,10176,0,0,1,0,6
EUN1_3573489719',5,23,7,0,0,0,0,10,0,323,66,24198,27454,26501,3,30,15,2,1,2,0,1,355,98,29636,30561,29516,0,-32,-32,-5438,-8,-3107,-3015,-2,-1,-2,0,9
EUN1_3573479809',5,26,16,1,0,2,0,12,1,321,88,29977,26758,34543,3,27,24,1,0,1,0,10,289,79,31933,28818,41419,0,32,9,-1956,-8,-2060,-6876,0,0,1,0,2
EUN1_3572941729',5,28,12,0,0,1,0,12,1,317,67,27247,28872,29267,3,140,14,2,0,1,0,3,348,73,26587,28769,29690,1,-31,-6,660,-2,103,-423,-2,0,0,0,9
EUN1_3572941433',5,28,6,0,0,0,0,6,0,336,84,23367,27055,26972,5,31,15,2,0,1,0,4,348,84,28161,30759,23433,0,-12,0,-4794,-9,-3704,3539,-2,0,-1,0,2
EUN1_3572146666',2,23,7,1,0,0,0,7,1,329,88,24104,27234,24498,3,26,15,0,0,1,0,1,359,104,28468,30909,27641,0,-30,-16,-4364,-8,-3675,-3143,1,0,-1,0,6
EUN1_3571812304',3,17,3,0,0,1,0,17,0,310,77,21723,24455,22944,3,279,21,1,0,4,0,2,340,74,33111,29448,41382,0,-30,3,-11388,-18,-4993,-18438,-1,0,-3,0,15
EUN1_3571792686',4,27,15,2,0,0,0,7,0,345,84,27640,29922,29348,3,26,10,0,0,0,0,2,374,78,26399,28997,30073,1,-29,6,1241,5,925,-725,2,0,0,0,5
EUN1_3571764731',4,27,13,1,0,0,0,5,1,345,94,26227,27573,30578,0,20,8,0,0,0,0,4,311,50,23329,24858,24988,1,34,44,2898,5,2715,5590,1,0,0,0,1
EUN1_3571725663',4,89,16,1,0,0,0,5,1,288,108,27672,26556,31348,1,26,11,1,0,0,0,1,327,64,26655,25511,30431,0,-39,44,1017,5,1045,917,0,0,0,0,4
EUN1_3570823350',4,28,20,2,0,1,0,10,1,366,88,30989,32242,38934,4,36,7,0,0,1,0,3,324,84,24164,28312,23832,1,42,4,6825,13,3930,15102,2,0,0,0,7
EUN1_3570790284',6,40,23,1,0,3,0,8,1,374,104,35111,32277,47815,1,30,13,0,0,0,0,8,299,80,27633,29294,31699,1,75,24,7478,10,2983,16116,1,0,3,0,0
EUN1_3570410706',1,84,9,1,0,0,0,5,0,326,84,24538,28081,35843,9,31,6,0,0,0,0,1,348,68,23450,26872,23101,1,-22,16,1088,3,1209,12742,1,0,0,0,4
EUN1_3575189222',5,30,15,1,0,0,0,8,1,325,84,27170,30237,34340,3,31,12,1,0,1,0,1,375,76,27180,30069,28025,0,-50,8,-10,3,168,6315,0,0,-1,0,7
EUN1_3575167773',4,23,11,0,0,0,0,7,0,336,77,25519,29308,34929,5,31,16,1,0,1,0,3,384,90,29212,31988,32802,0,-48,-13,-3693,-5,-2680,2127,-1,0,-1,0,4
EUN1_3575164125',3,27,9,1,0,2,0,7,1,356,88,27413,28756,28109,3,64,13,1,0,0,0,8,309,87,26539,29838,34309,1,47,1,874,-4,-1082,-6200,0,0,2,0,-1
EUN1_3575154388',3,37,10,0,0,0,0,10,0,310,72,25165,26990,28367,5,30,18,1,1,1,0,2,373,104,31270,31425,31243,0,-63,-32,-6105,-8,-4435,-2876,-1,-1,-1,0,8
EUN1_3574212178',11,40,8,1,0,3,0,4,1,373,83,27690,29852,26965,4,18,13,1,0,0,0,6,316,90,25743,26293,28048,0,57,-7,1947,-5,3559,-1083,0,0,3,0,-2
EUN1_3574156778',4,26,13,0,0,1,0,5,0,349,88,27918,31916,35999,3,26,10,2,0,1,0,3,365,100,27546,30443,29468,1,-16,-12,372,3,1473,6531,-2,0,0,0,2
EUN1_3574142806',4,26,9,0,1,0,0,11,0,325,72,24732,27770,30346,2,26,15,1,0,1,0,1,381,92,30450,29234,30237,0,-56,-20,-5718,-6,-1464,109,-1,1,-1,0,10
EUN1_3574139141',2,26,15,0,0,1,0,9,1,408,111,30913,31256,37051,6,28,4,2,0,1,0,8,351,72,22754,27299,27754,1,57,39,8159,11,3957,9297,-2,0,0,0,1
EUN1_3574117359',5,297,13,0,1,1,0,9,0,342,88,29386,30468,32925,3,29,19,2,0,1,0,4,348,96,30518,31794,36005,0,-6,-8,-1132,-6,-1326,-3080,-2,1,0,0,5
EUN1_3574108261',4,24,10,1,1,0,0,6,0,355,78,26170,27999,26008,2,28,12,1,0,0,0,1,349,106,26833,28915,31100,0,6,-28,-663,-2,-916,-5092,0,1,0,0,5
EUN1_3574098536',1,227,17,2,1,0,0,8,0,299,78,29187,29904,46939,4,22,22,0,0,2,0,3,323,73,31427,29027,43132,0,-24,5,-2240,-5,877,3807,2,1,-2,0,5
EUN1_3574093353',1,140,18,1,0,3,0,7,0,381,96,31200,34466,39063,5,23,9,1,0,0,0,5,305,80,25116,26629,35490,1,76,16,6084,9,7837,3573,0,0,3,0,2
EUN1_3573726533',2,23,4,1,0,0,0,3,0,380,92,23870,29124,29845,7,27,8,0,0,0,0,3,349,68,23698,28835,19499,0,31,24,172,-4,289,10346,1,0,0,0,0
EUN1_3573705937',1,20,14,1,0,1,0,7,0,384,86,29048,32273,37094,2,29,11,1,0,1,0,8,375,88,27255,31674,35027,1,9,-2,1793,3,599,2067,0,0,0,0,-1
EUN1_3573028386',3,30,6,2,0,3,0,12,0,365,102,26809,30756,33665,2,27,7,0,0,0,0,5,328,94,24232,30205,23316,1,37,8,2577,-1,551,10349,2,0,3,0,7
EUN1_3573016379',6,28,9,0,0,0,0,9,1,319,84,24883,29376,30627,4,23,12,2,0,1,0,3,331,104,26616,30815,26915,0,-12,-20,-1733,-3,-1439,3712,-2,0,-1,0,6
EUN1_3573008322',5,27,14,1,0,2,0,6,1,364,108,30408,31320,37454,1,15,12,1,0,0,0,5,331,84,25743,29055,32663,1,33,24,4665,2,2265,4791,0,0,2,0,1
EUN1_3572993545',4,28,11,2,0,1,0,15,0,329,73,25943,28675,35678,4,29,11,0,0,3,0,4,354,102,28054,29939,35458,1,-25,-29,-2111,0,-1264,220,2,0,-2,0,11
EUN1_3572989166',1,70,10,0,0,0,0,10,1,331,80,25024,28442,25990,6,29,11,1,0,2,0,2,361,104,27882,30857,30323,0,-30,-24,-2858,-1,-2415,-4333,-1,0,-2,0,8
EUN1_3572134276',2,24,8,2,0,0,0,15,0,344,102,24867,28957,29103,5,25,19,0,0,3,0,3,341,77,31322,30914,35554,0,3,25,-6455,-11,-1957,-6451,2,0,-3,0,12
EUN1_3572673738',3,40,16,1,0,1,0,6,1,350,68,30705,29007,32005,5,39,10,0,0,0,0,7,308,75,24782,27262,26919,1,42,-7,5923,6,1745,5086,1,0,1,0,-1
EUN1_3572356740',6,29,11,0,0,0,0,6,0,313,88,25866,27196,33050,4,98,13,1,0,1,0,3,349,68,27250,28529,33664,0,-36,20,-1384,-2,-1333,-614,-1,0,-1,0,3
EUN1_3572846639',2,25,16,0,1,0,0,7,0,352,85,28518,29671,39047,5,28,16,1,0,1,0,2,360,65,28025,28293,41379,0,-8,20,493,0,1378,-2332,-1,1,-1,0,5
EUN1_3572836356',2,23,19,1,0,3,0,6,0,314,88,30432,29314,36928,4,23,8,0,0,1,0,13,330,86,25316,26852,27939,1,-16,2,5116,11,2462,8989,1,0,2,0,-7
EUN1_3571774411',3,28,7,1,0,0,0,11,0,341,73,24186,26466,21764,2,24,19,1,0,2,0,1,364,107,32247,32873,37289,0,-23,-34,-8061,-12,-6407,-15525,0,0,-2,0,10
EUN1_3571742638',2,17,1,0,0,0,0,9,0,348,88,21860,27271,20752,4,34,19,2,0,2,0,1,382,88,30750,32316,40733,0,-34,0,-8890,-18,-5045,-19981,-2,0,-2,0,8
EUN1_3569889675',2,27,4,1,0,0,0,9,0,327,80,22902,28383,32142,2,17,21,1,0,1,0,1,408,74,32205,32668,41783,0,-81,6,-9303,-17,-4285,-9641,0,0,-1,0,8
EUN1_3568850680',3,23,14,0,0,0,0,9,0,350,77,28030,30879,33062,6,33,16,1,0,0,0,1,356,85,28794,29074,31741,0,-6,-8,-764,-2,1805,1321,-1,0,0,0,8
EUN1_3568789148',5,31,6,0,1,0,0,10,0,380,94,25618,28676,22644,2,24,17,1,0,2,0,5,344,62,28203,28185,29392,0,36,32,-2585,-11,491,-6748,-1,1,-2,0,5
EUN1_3567921313',5,28,12,1,0,2,0,8,1,383,86,28289,29750,33554,2,235,8,1,0,0,0,5,312,98,25394,28122,26708,1,71,-12,2895,4,1628,6846,0,0,2,0,3
EUN1_3567897718',5,24,9,1,1,0,0,11,0,314,81,24252,27073,32227,2,16,17,1,0,1,0,1,332,93,29459,29146,31368,0,-18,-12,-5207,-8,-2073,859,0,1,-1,0,10
EUN1_3567868424',4,26,14,1,0,0,0,7,1,321,97,26962,28752,27725,2,24,12,0,1,0,0,2,356,88,27106,29565,29874,0,-35,9,-144,2,-813,-2149,1,-1,0,0,5
EUN1_3567853502',5,27,1,0,0,0,0,13,0,333,66,20837,26366,21570,0,30,16,1,1,3,0,5,377,79,31267,31674,35029,0,-44,-13,-10430,-15,-5308,-13459,-1,-1,-3,0,8
EUN1_3573830738',4,17,23,2,0,2,0,10,1,345,82,31212,32056,32062,3,148,4,0,0,1,0,6,340,92,23747,26762,25458,1,5,-10,7465,19,5294,6604,2,0,1,0,4
EUN1_3573796070',4,77,9,0,1,0,0,11,1,366,84,27166,29966,25072,5,147,14,1,0,0,0,1,397,81,28005,31073,32694,0,-31,3,-839,-5,-1107,-7622,-1,1,0,0,10
EUN1_3573788576',3,252,25,1,0,2,0,7,1,338,90,34371,31655,39587,2,23,8,1,0,1,0,6,280,79,23899,24723,25514,1,58,11,10472,17,6932,14073,0,0,1,0,1
EUN1_3573770669',2,26,16,0,0,0,0,17,0,273,56,28293,27937,36269,1,24,23,1,0,6,0,3,354,90,36725,31817,44040,0,-81,-34,-8432,-7,-3880,-7771,-1,0,-6,0,14
EUN1_3568096466',3,29,13,2,0,1,0,7,0,345,108,28881,30368,29004,2,23,16,0,0,0,0,6,300,76,27930,27535,37470,1,45,32,951,-3,2833,-8466,2,0,1,0,1
EUN1_3568079997',0,20,8,0,1,0,0,12,0,330,88,25947,27746,30467,3,19,22,1,0,2,0,2,339,72,33263,32419,40043,0,-9,16,-7316,-14,-4673,-9576,-1,1,-2,0,10
EUN1_3568070421',6,32,20,2,0,1,0,9,0,326,79,30034,30962,49206,3,16,18,0,0,1,0,4,275,54,27904,27440,32846,1,51,25,2130,2,3522,16360,2,0,0,0,5
EUN1_3568054604',0,18,11,1,1,0,0,5,0,311,87,27710,26992,32065,1,25,20,1,0,0,0,3,305,86,29853,28927,37740,0,6,1,-2143,-9,-1935,-5675,0,1,0,0,2
EUN1_3568044202',3,145,9,2,0,1,0,9,0,333,94,25794,27229,32858,2,25,13,0,0,1,0,7,328,84,27288,29303,24125,1,5,10,-1494,-4,-2074,8733,2,0,0,0,2
EUN1_3567807371',1,36,14,0,0,0,0,6,1,327,69,26723,29292,30544,6,34,13,2,0,1,0,3,308,82,27458,29696,38707,0,19,-13,-735,1,-404,-8163,-2,0,-1,0,3
EUN1_3567709872',5,27,7,1,0,0,0,7,0,375,100,25366,30834,23186,2,147,10,1,0,0,0,3,358,96,26724,31781,30375,1,17,4,-1358,-3,-947,-7189,0,0,0,0,4
EUN1_3567685045',6,78,18,0,0,2,0,11,0,315,76,30028,29750,35073,3,29,14,2,0,2,0,9,333,92,27998,29013,32923,1,-18,-16,2030,4,737,2150,-2,0,0,0,2
EUN1_3567104313',2,25,17,1,0,1,0,10,0,357,112,30207,30695,41403,2,25,18,1,0,1,0,1,336,87,29863,30203,32842,0,21,25,344,-1,492,8561,0,0,0,0,9
EUN1_3567067957',6,21,11,0,0,0,0,7,0,343,80,25289,29200,36721,3,27,11,1,0,0,0,1,335,92,25671,29698,26647,0,8,-12,-382,0,-498,10074,-1,0,0,0,6
EUN1_3567049157',4,35,12,0,0,0,0,9,0,338,72,26823,29233,40211,1,19,15,1,0,1,0,1,327,88,28171,28894,32979,1,11,-16,-1348,-3,339,7232,-1,0,-1,0,8
EUN1_3566816099',4,30,19,1,0,1,0,13,1,369,96,31062,31255,33892,3,22,8,1,0,2,0,8,338,108,28859,29199,24276,0,31,-12,2203,11,2056,9616,0,0,-1,0,5
EUN1_3565798129',2,26,18,1,1,1,0,10,1,299,92,31140,29576,37184,5,49,17,0,0,2,0,7,346,68,30062,30608,35707,1,-47,24,1078,1,-1032,1477,1,1,-1,0,3
EUN1_3565235785',2,26,13,0,0,0,0,8,0,319,70,27911,27191,34610,4,33,20,1,0,1,0,6,336,69,30907,29066,44562,0,-17,1,-2996,-7,-1875,-9952,-1,0,-1,0,2
EUN1_3565213442',2,20,21,1,0,0,0,8,0,321,67,29614,28238,33447,1,17,17,0,0,1,0,1,322,96,29546,29801,38355,0,-1,-29,68,4,-1563,-4908,1,0,-1,0,7
EUN1_3564864437',3,31,33,1,0,0,0,10,1,351,116,35553,33034,51532,2,19,10,0,0,1,0,6,306,67,25844,28168,35044,1,45,49,9709,23,4866,16488,1,0,-1,0,4
EUN1_3576065367',4,132,12,1,0,1,0,9,0,369,84,28061,30013,30955,2,24,19,1,1,2,0,4,311,104,32335,32578,35453,0,58,-20,-4274,-7,-2565,-4498,0,-1,-1,0,5
EUN1_3576002194',1,132,6,0,0,0,0,7,0,290,78,22577,26019,21430,3,32,14,2,0,1,0,3,326,86,27771,28340,35226,0,-36,-8,-5194,-8,-2321,-13796,-2,0,-1,0,4
EUN1_3575914888',6,34,14,0,0,0,0,10,1,325,64,28136,28037,39967,3,41,16,1,0,0,0,2,358,79,28232,30057,29603,0,-33,-15,-96,-2,-2020,10364,-1,0,0,0,8
EUN1_3575903432',5,26,6,1,1,0,0,10,1,352,96,25234,29768,23429,4,17,8,1,0,3,0,3,360,64,24571,29543,22067,1,-8,32,663,-2,225,1362,0,1,-3,0,7
EUN1_3575819713',6,67,19,1,0,1,0,13,1,328,83,30718,29517,38866,4,78,11,1,1,0,0,4,355,88,26665,29472,30822,1,-27,-5,4053,8,45,8044,0,-1,1,0,9
EUN1_3575732657',3,25,19,0,0,0,0,11,0,328,86,29401,30585,30601,5,34,20,2,0,1,0,4,353,83,31551,29280,42327,0,-25,3,-2150,-1,1305,-11726,-2,0,-1,0,7
EUN1_3575573644',6,33,3,1,0,0,0,8,0,320,68,21592,28223,19234,7,34,12,0,0,1,0,1,420,111,28390,33157,37199,0,-100,-43,-6798,-9,-4934,-17965,1,0,-1,0,7
EUN1_3573404782',1,18,12,2,0,2,0,8,1,368,80,28325,30347,33333,1,273,12,0,0,2,0,8,371,92,28465,31206,29229,1,-3,-12,-140,0,-859,4104,2,0,0,0,0
EUN1_3573376944',2,23,16,0,0,1,0,15,0,374,80,29499,30888,37228,7,32,19,2,1,3,0,3,318,100,32452,32086,40969,0,56,-20,-2953,-3,-1198,-3741,-2,-1,-2,0,12
EUN1_3573347483',3,27,29,1,0,3,0,8,0,336,82,36498,32644,53029,4,33,18,0,0,0,0,9,276,65,29332,27996,39890,1,60,17,7166,11,4648,13139,1,0,3,0,-1
EUN1_3573304709',4,16,7,0,0,0,0,10,0,327,86,24021,27882,29307,5,71,15,2,0,1,0,2,323,102,27472,31058,29613,1,4,-16,-3451,-8,-3176,-306,-2,0,-1,0,8
EUN1_3573153568',3,76,9,0,0,0,0,10,0,298,88,25170,26847,25721,5,247,16,2,0,1,0,4,364,86,29345,31093,33553,0,-66,2,-4175,-7,-4246,-7832,-2,0,-1,0,6
EUN1_3572793608',5,31,11,1,0,0,0,9,0,346,83,26546,29176,31863,0,28,14,0,0,2,0,6,322,100,28817,30684,33494,0,24,-17,-2271,-3,-1508,-1631,1,0,-2,0,3
EUN1_3572753526',1,91,7,1,1,1,0,9,1,342,102,25170,29930,23396,2,21,4,1,0,1,0,3,357,86,24402,26547,29299,1,-15,16,768,3,3383,-5903,0,1,0,0,6
EUN1_3572598836',3,37,18,1,0,1,0,10,0,341,96,29436,32039,39845,7,26,12,1,0,0,0,2,315,79,26138,27961,36141,1,26,17,3298,6,4078,3704,0,0,1,0,8
EUN1_3572586551',6,41,15,1,1,0,0,5,1,334,93,27587,28903,32129,6,38,7,1,0,0,0,2,321,82,23819,27386,30371,1,13,11,3768,8,1517,1758,0,1,0,0,3
EUN1_3572344609',4,28,9,1,0,1,0,5,0,371,98,26469,29097,20279,4,27,8,1,0,0,0,7,294,84,23501,26994,23156,0,77,14,2968,1,2103,-2877,0,0,1,0,-2
EUN1_3562205655',4,27,10,1,1,0,0,5,1,305,83,26670,26308,44849,2,17,15,0,0,1,0,4,366,79,28035,30078,43938,1,-61,4,-1365,-5,-3770,911,1,1,-1,0,1
EUN1_3562197746',6,26,21,2,0,1,0,7,1,334,78,30786,31619,36496,3,81,8,0,0,1,0,7,334,100,25617,27849,31352,1,0,-22,5169,13,3770,5144,2,0,0,0,0
EUN1_3562195166',4,26,11,1,0,0,0,9,0,374,106,27843,31665,28553,4,27,5,1,0,1,0,4,390,90,25500,28585,23428,1,-16,16,2343,6,3080,5125,0,0,-1,0,5
EUN1_3562174478',5,23,17,0,0,0,0,12,0,325,78,28899,29519,33812,1,25,15,2,0,2,0,3,362,106,30943,33828,33352,0,-37,-28,-2044,2,-4309,460,-2,0,-2,0,9
EUN1_3562158875',2,222,14,0,0,1,0,6,0,360,78,27790,29103,33427,0,23,10,2,0,1,0,6,349,86,26321,29120,31206,1,11,-8,1469,4,-17,2221,-2,0,0,0,0
EUN1_3562162159',1,24,11,1,0,1,0,6,0,379,98,26419,29125,23886,3,25,9,1,0,0,0,4,351,89,25067,28687,20631,0,28,9,1352,2,438,3255,0,0,1,0,2
EUN1_3562007812',3,32,10,1,0,0,0,8,0,343,87,26935,29613,31931,6,81,15,1,1,0,0,3,321,92,28111,29604,34885,0,22,-5,-1176,-5,9,-2954,0,-1,0,0,5
EUN1_3561975588',1,26,7,0,0,1,0,16,1,295,80,24328,25615,25210,1,19,21,1,0,2,0,1,366,96,32064,31202,36385,0,-71,-16,-7736,-14,-5587,-11175,-1,0,-1,0,15
EUN1_3561701691',3,23,15,1,0,0,0,12,0,293,80,26868,28413,28165,7,32,13,0,0,1,0,0,346,80,27402,28910,25957,0,-53,0,-534,2,-497,2208,1,0,-1,0,12
EUN1_3561703103',9,34,16,1,1,1,0,8,0,324,98,29999,30411,33060,6,27,14,1,0,0,0,5,352,100,27060,30294,34358,0,-28,-2,2939,2,117,-1298,0,1,1,0,3
EUN1_3561694521',4,28,25,1,0,2,0,4,1,378,110,35288,31785,41150,0,23,10,1,0,0,0,9,302,73,25821,25332,24482,1,76,37,9467,15,6453,16668,0,0,2,0,-5
EUN1_3561691166',5,24,11,2,1,1,0,5,1,369,108,27550,30734,28604,3,21,9,0,0,0,0,5,355,92,26257,29756,23806,1,14,16,1293,2,978,4798,2,1,1,0,0
EUN1_3561571022',2,22,20,2,0,1,0,6,1,351,99,31240,31267,38654,3,24,14,0,0,0,0,2,331,73,26819,27438,32749,1,20,26,4421,6,3829,5905,2,0,1,0,4
EUN1_3561004862',4,22,7,0,0,0,0,7,1,322,56,23133,25247,27218,1,28,14,2,0,0,0,2,293,110,27136,28822,30229,0,29,-54,-4003,-7,-3575,-3011,-2,0,0,0,5
EUN1_3560971566',4,25,16,2,0,1,0,15,1,356,89,28650,31603,41912,2,64,6,0,0,1,0,2,331,80,24826,26922,29283,1,25,9,3824,10,4681,12629,2,0,0,0,13
EUN1_3560930643',4,30,23,1,0,1,0,8,1,352,101,34202,32191,40582,0,26,10,0,0,0,0,4,312,90,25584,28722,27484,1,40,11,8618,13,3469,13098,1,0,1,0,4
EUN1_3560915085',5,28,26,1,0,3,0,5,1,346,88,32218,30967,38995,1,22,13,1,0,0,0,9,255,96,25934,24308,34070,1,91,-8,6284,13,6659,4925,0,0,3,0,-4
EUN1_3560803928',3,28,12,1,0,1,0,10,1,387,96,29465,30901,26741,4,27,16,1,0,2,0,3,361,108,29869,31153,33965,0,26,-12,-404,-4,-252,-7224,0,0,-1,0,7
EUN1_3560792787',5,192,13,0,1,1,0,6,0,354,90,28538,29362,26676,6,24,12,1,0,0,0,7,336,62,25801,27067,26503,1,18,28,2737,1,2295,173,-1,1,1,0,-1
EUN1_3576129126',2,24,4,1,0,0,0,10,0,350,86,22677,28198,21041,2,85,11,1,0,1,0,4,345,94,27068,32177,32924,0,5,-8,-4391,-7,-3979,-11883,0,0,-1,0,6
EUN1_3576100554',4,25,13,0,0,1,0,1,0,368,108,29266,29855,31386,3,81,11,1,0,0,0,9,333,96,25853,28596,27265,0,35,12,3413,2,1259,4121,-1,0,1,0,-8
EUN1_3576062455',0,21,12,0,0,0,0,6,1,386,71,28138,31755,29554,1,22,11,1,0,0,0,3,327,74,24997,28247,28665,0,59,-3,3141,1,3508,889,-1,0,0,0,3
EUN1_3575966721',6,25,17,2,0,1,0,8,1,329,76,28291,28582,29694,3,28,6,0,0,0,0,2,347,115,26058,28066,26716,0,-18,-39,2233,11,516,2978,2,0,1,0,6
EUN1_3575940768',2,26,13,0,0,0,0,10,0,285,63,25579,25643,33182,2,25,15,2,0,1,0,2,319,100,28981,26900,28731,0,-34,-37,-3402,-2,-1257,4451,-2,0,-1,0,8
EUN1_3575914745',5,30,15,1,0,0,0,8,1,324,94,28367,27978,33833,1,24,19,1,1,1,0,5,288,77,29022,29217,35175,0,36,17,-655,-4,-1239,-1342,0,-1,-1,0,3
EUN1_3575859479',4,47,11,0,0,0,0,8,0,317,86,26576,27973,29274,5,23,18,1,0,0,0,2,332,76,28268,28333,39901,1,-15,10,-1692,-7,-360,-10627,-1,0,0,0,6
EUN1_3576030829',3,23,10,0,0,0,0,7,1,309,83,24643,27305,25420,2,24,17,1,0,1,0,0,348,116,30079,31360,32726,0,-39,-33,-5436,-7,-4055,-7306,-1,0,-1,0,7
EUN1_3575459665',5,28,7,2,0,0,0,12,0,354,90,24381,28767,27951,6,86,19,0,0,1,0,4,351,85,31025,31353,41797,0,3,5,-6644,-12,-2586,-13846,2,0,-1,0,8
EUN1_3575087754',2,23,23,0,1,1,0,3,1,362,103,32800,33734,39954,4,57,10,1,0,1,0,10,338,74,24907,27749,30347,1,24,29,7893,13,5985,9607,-1,1,0,0,-7
EUN1_3574506484',7,29,11,2,0,0,0,15,0,377,68,27831,29110,32675,5,29,20,0,0,2,0,3,363,75,31204,30500,38345,0,14,-7,-3373,-9,-1390,-5670,2,0,-2,0,12
EUN1_3573360848',4,31,19,1,1,0,0,11,0,334,75,30057,29716,37193,2,53,11,0,0,2,0,4,344,80,28182,28099,30633,0,-10,-5,1875,8,1617,6560,1,1,-2,0,7
EUN1_3573337472',3,37,8,0,0,0,0,7,0,360,94,25068,29972,28891,1,33,15,1,0,0,0,2,347,94,27613,30335,41142,0,13,0,-2545,-7,-363,-12251,-1,0,0,0,5
EUN1_3573295788',5,32,18,1,0,0,0,3,0,352,90,29854,30007,35430,4,23,15,0,0,0,0,7,324,86,28387,30051,31254,0,28,4,1467,3,-44,4176,1,0,0,0,-4
EUN1_3569526463',7,28,33,1,0,0,0,5,1,338,80,33641,31457,50190,2,25,10,1,0,0,0,6,326,70,25159,28277,31308,1,12,10,8482,23,3180,18882,0,0,0,0,-1
EUN1_3569510093',2,22,15,0,0,0,0,4,1,331,95,28923,27506,34790,3,26,16,1,0,1,0,2,338,77,28103,27924,33644,0,-7,18,820,-1,-418,1146,-1,0,-1,0,2
EUN1_3569498215',6,27,21,1,0,1,0,11,0,341,81,32226,32726,43339,3,26,15,0,0,0,0,2,301,76,27706,26982,28315,1,40,5,4520,6,5744,15024,1,0,1,0,9
EUN1_3569483379',4,38,18,0,1,1,0,12,1,326,74,31243,28257,43723,4,31,23,1,0,1,0,6,343,60,31284,30221,39624,0,-17,14,-41,-5,-1964,4099,-1,1,0,0,6
EUN1_3569255627',5,26,14,0,0,1,0,10,0,344,101,29239,29395,28072,4,30,16,2,0,1,0,3,338,77,28586,26140,33930,0,6,24,653,-2,3255,-5858,-2,0,0,0,7
EUN1_3569219060',4,34,13,1,1,0,0,11,0,330,86,26424,28213,29128,5,24,22,1,0,1,0,0,339,110,33711,32667,34714,0,-9,-24,-7287,-9,-4454,-5586,0,1,-1,0,11
EUN1_3568526916',3,23,16,1,0,1,0,4,1,313,70,28616,28259,34342,3,21,20,1,0,0,0,7,334,81,29887,29826,35005,0,-21,-11,-1271,-4,-1567,-663,0,0,1,0,-3
EUN1_3568506928',2,26,19,0,0,1,0,10,0,359,82,30783,28456,43173,4,31,20,2,0,0,0,3,276,58,28999,27181,36086,1,83,24,1784,-1,1275,7087,-2,0,1,0,7
EUN1_3568498650',1,30,12,0,0,0,0,6,1,327,89,26540,28055,26785,2,25,22,2,1,1,0,2,385,105,32581,33304,40959,0,-58,-16,-6041,-10,-5249,-14174,-2,-1,-1,0,4
EUN1_3568199618',5,30,14,2,1,1,0,14,1,355,85,28956,29752,32700,4,27,7,0,0,1,0,2,384,106,28087,29517,22267,1,-29,-21,869,7,235,10433,2,1,0,0,12
EUN1_3568177459',4,29,15,1,0,0,0,13,0,375,90,29421,31082,31227,4,34,15,1,0,3,0,5,379,110,30981,31016,39068,1,-4,-20,-1560,0,66,-7841,0,0,-3,0,8
EUN1_3568150790',5,30,7,1,0,0,0,9,0,330,78,23653,28439,35962,2,22,11,1,0,1,0,1,338,102,26992,30741,29359,1,-8,-24,-3339,-4,-2302,6603,0,0,-1,0,8
EUN1_3568144116',5,24,5,1,0,0,0,10,0,347,73,22642,27057,18601,5,33,11,0,0,1,0,0,362,106,29175,30922,28843,0,-15,-33,-6533,-6,-3865,-10242,1,0,-1,0,10
EUN1_3568119609',3,25,13,1,0,0,0,7,1,384,102,28461,30247,34854,1,20,9,0,0,0,0,2,326,82,25518,27828,32205,1,58,20,2943,4,2419,2649,1,0,0,0,5
EUN1_3568110091',4,140,12,0,0,0,0,14,0,332,64,26874,28204,30367,1,32,17,1,0,2,0,2,350,90,30999,28777,34854,0,-18,-26,-4125,-5,-573,-4487,-1,0,-2,0,12
EUN1_3576149152',3,42,6,0,0,0,0,15,0,301,68,22296,24492,33888,3,31,23,2,0,4,0,1,358,86,35406,32590,42554,0,-57,-18,-13110,-17,-8098,-8666,-2,0,-4,0,14
EUN1_3576121627',2,31,5,1,0,1,0,9,0,338,76,23835,26416,26242,4,22,17,1,1,2,0,4,341,114,31041,32192,32976,0,-3,-38,-7206,-12,-5776,-6734,0,-1,-1,0,5
EUN1_3575639088',4,28,7,0,0,0,0,9,0,339,102,23858,28952,25985,4,35,6,2,0,1,0,3,357,94,25201,29602,27278,0,-18,8,-1343,1,-650,-1293,-2,0,-1,0,6
EUN1_3575616403',5,27,11,0,0,1,0,11,0,315,81,27300,26721,27846,5,26,22,2,0,3,0,5,373,86,32888,31690,40499,0,-58,-5,-5588,-11,-4969,-12653,-2,0,-2,0,6
EUN1_3575526718',3,27,15,1,0,0,0,10,1,334,87,28877,27509,33441,2,32,16,0,0,2,0,3,303,71,27608,27268,36505,1,31,16,1269,-1,241,-3064,1,0,-2,0,7
EUN1_3574750166',6,29,15,1,0,0,0,5,1,341,72,29066,27815,34288,2,30,15,1,0,2,0,6,337,88,28380,27928,30018,1,4,-16,686,0,-113,4270,0,0,-2,0,-1
EUN1_3574720995',2,37,31,1,0,4,0,13,0,356,91,35965,35638,49694,2,25,13,0,0,1,0,7,283,76,26899,26864,47302,1,73,15,9066,18,8774,2392,1,0,3,0,6
EUN1_3574711885',6,34,18,1,0,2,0,7,1,387,96,32446,32448,33808,7,26,11,1,0,0,0,6,338,76,25731,28046,33830,1,49,20,6715,7,4402,-22,0,0,2,0,1
EUN1_3573996008',2,34,11,0,0,1,0,5,0,377,107,28028,31510,30809,4,23,10,2,0,0,0,6,358,76,24759,28803,31342,1,19,31,3269,1,2707,-533,-2,0,1,0,-1
EUN1_3573977089',4,30,8,0,0,0,0,11,1,350,88,24615,28302,22854,2,19,19,2,0,2,0,0,391,95,31617,34143,38740,0,-41,-7,-7002,-11,-5841,-15886,-2,0,-2,0,11
EUN1_3573461694',0,15,12,1,0,0,0,11,1,308,54,25354,27425,25320,5,34,13,0,0,1,0,0,361,102,28444,30438,34876,0,-53,-48,-3090,-1,-3013,-9556,1,0,-1,0,11
EUN1_3573454514',1,166,14,1,0,3,0,11,0,328,87,29357,28069,34271,2,20,22,1,0,2,0,12,339,84,32977,31480,31069,0,-11,3,-3620,-8,-3411,3202,0,0,1,0,-1
EUN1_3572914040',1,28,16,0,0,0,0,9,1,339,94,29809,29290,37701,2,28,14,2,0,1,0,6,306,81,26258,28146,33725,1,33,13,3551,2,1144,3976,-2,0,-1,0,3
EUN1_3572906667',5,23,19,1,0,1,0,9,1,311,62,30427,27292,38063,4,34,18,0,0,1,0,5,314,94,29687,28528,38460,0,-3,-32,740,1,-1236,-397,1,0,0,0,4
EUN1_3572894649',2,19,17,1,0,1,0,8,1,348,110,29533,31336,41000,2,29,12,0,0,0,0,6,349,98,27157,29940,30156,1,-1,12,2376,5,1396,10844,1,0,1,0,2
EUN1_3572014658',7,36,17,1,0,1,0,4,1,339,66,29316,29148,38407,4,35,14,1,1,0,0,7,320,76,27295,29765,32492,1,19,-10,2021,3,-617,5915,0,-1,1,0,-3
EUN1_3571993834',2,26,11,0,0,1,0,12,0,338,80,26208,27662,31085,7,422,11,2,0,1,0,7,355,103,27746,30333,29845,0,-17,-23,-1538,0,-2671,1240,-2,0,0,0,5
EUN1_3575896496',3,56,16,0,0,0,0,8,0,396,92,30535,29023,31379,5,31,10,2,0,1,0,6,351,90,25348,26646,22148,1,45,2,5187,6,2377,9231,-2,0,-1,0,2
EUN1_3575875892',4,25,12,0,1,1,0,4,1,424,64,29990,30773,26351,2,28,4,0,0,0,0,5,309,96,21724,27250,17689,1,115,-32,8266,8,3523,8662,0,1,1,0,-1
EUN1_3575482298',4,27,24,1,0,0,0,12,1,321,86,30656,29317,40556,4,24,13,0,0,1,0,5,310,83,29418,28610,33935,1,11,3,1238,11,707,6621,1,0,-1,0,7
EUN1_3575446553',7,29,7,0,0,0,0,11,0,323,73,24544,28665,24291,4,97,15,2,0,0,0,2,359,102,29025,32667,31659,0,-36,-29,-4481,-8,-4002,-7368,-2,0,0,0,9
EUN1_3569115559',2,28,17,1,1,0,0,7,1,370,106,30056,32495,36933,5,95,13,1,0,0,0,3,385,80,27944,30703,32280,1,-15,26,2112,4,1792,4653,0,1,0,0,4
EUN1_3569097356',2,29,15,0,0,0,0,11,1,382,82,29702,31676,31622,1,141,15,1,0,2,0,3,364,64,29017,31241,35250,1,18,18,685,0,435,-3628,-1,0,-2,0,8
EUN1_3568074524',1,21,10,0,0,0,0,9,0,312,110,26169,30363,32225,1,27,10,1,0,1,0,3,331,82,25414,28359,30778,0,-19,28,755,0,2004,1447,-1,0,-1,0,6
EUN1_3567566259',3,224,14,1,0,0,0,10,0,334,98,27372,31159,34091,5,62,16,1,1,0,0,2,335,113,29485,31092,34215,0,-1,-15,-2113,-2,67,-124,0,-1,0,0,8
EUN1_3567554541',2,37,14,0,0,0,0,8,1,335,72,27642,27574,35128,4,31,23,2,0,1,0,2,325,116,32828,32242,37911,0,10,-44,-5186,-9,-4668,-2783,-2,0,-1,0,6
EUN1_3567389251',4,38,10,2,0,0,0,3,1,333,96,25877,29639,31309,7,32,9,0,0,0,0,1,384,112,27329,31025,29064,1,-51,-16,-1452,1,-1386,2245,2,0,0,0,2
EUN1_3567302867',5,27,10,0,0,0,0,6,1,332,111,26111,30377,35273,2,21,18,2,0,2,0,2,395,80,30828,34147,40805,0,-63,31,-4717,-8,-3770,-5532,-2,0,-2,0,4
EUN1_3565475599',2,28,16,1,0,0,0,7,0,352,86,29291,30176,36423,3,26,15,1,0,0,0,2,364,98,29416,30521,33590,0,-12,-12,-125,1,-345,2833,0,0,0,0,5
EUN1_3565449456',6,33,10,1,0,0,0,7,0,340,74,26217,28113,36190,1,26,20,0,0,1,0,1,372,116,31483,33277,36617,1,-32,-42,-5266,-10,-5164,-427,1,0,-1,0,6
EUN1_3563550306',4,26,11,1,0,0,0,7,0,306,84,24982,28233,33300,4,27,16,0,1,1,0,1,350,100,29394,31228,37118,0,-44,-16,-4412,-5,-2995,-3818,1,-1,-1,0,6
EUN1_3576047134',3,26,14,2,0,1,0,10,1,378,92,29403,29840,33903,5,27,6,0,0,1,0,5,317,68,22413,26087,23804,1,61,24,6990,8,3753,10099,2,0,0,0,5
EUN1_3576021090',2,22,12,2,1,2,0,11,1,309,122,27931,30235,30054,4,23,7,0,0,1,0,4,330,66,24909,27566,22374,1,-21,56,3022,5,2669,7680,2,1,1,0,7
EUN1_3575965471',5,26,14,1,0,0,0,15,0,337,64,25579,27721,41336,1,171,10,0,0,2,0,2,342,81,28016,30075,31065,0,-5,-17,-2437,4,-2354,10271,1,0,-2,0,13
EUN1_3575936688',2,87,17,1,0,0,0,14,1,255,94,28161,27643,34350,4,371,18,0,0,2,0,2,368,82,31847,30629,41495,0,-113,12,-3686,-1,-2986,-7145,1,0,-2,0,12
EUN1_3575915709',2,30,18,1,1,0,0,11,0,320,80,30046,30584,38224,2,33,21,0,0,2,0,1,337,96,31293,30947,38956,0,-17,-16,-1247,-3,-363,-732,1,1,-2,0,10
EUN1_3575898576',5,29,9,1,0,1,0,10,0,332,106,28126,30044,29565,2,27,13,1,0,2,0,7,317,96,26691,28641,32169,1,15,10,1435,-4,1403,-2604,0,0,-1,0,3
EUN1_3575843255',6,36,6,1,0,0,0,7,1,371,112,24935,31381,26258,7,196,8,1,0,1,0,1,389,80,25560,30236,27033,0,-18,32,-625,-2,1145,-775,0,0,-1,0,6
EUN1_3575825450',2,16,16,1,0,2,0,7,1,355,86,30491,30070,34098,5,27,12,1,1,1,0,5,368,86,28035,30123,27272,1,-13,0,2456,4,-53,6826,0,-1,1,0,2
EUN1_3575806232',4,22,16,1,0,0,0,9,1,281,97,27870,28187,34047,3,48,16,1,0,1,0,3,358,80,28514,29567,33449,0,-77,17,-644,0,-1380,598,0,0,-1,0,6
EUN1_3575653620',3,15,14,1,0,1,0,5,0,311,96,27662,28340,34925,0,22,15,0,0,1,0,7,310,84,25896,29684,33327,1,1,12,1766,-1,-1344,1598,1,0,0,0,-2
EUN1_3575640975',3,24,8,0,0,1,0,5,0,371,93,25804,28504,40651,2,22,17,2,0,0,0,7,318,77,28197,30752,41998,0,53,16,-2393,-9,-2248,-1347,-2,0,1,0,-2
EUN1_3575641098',4,32,14,0,0,2,0,11,1,372,98,30395,29973,35242,4,38,18,2,0,0,0,7,301,86,29429,29561,36623,0,71,12,966,-4,412,-1381,-2,0,2,0,4
EUN1_3575624188',3,27,18,1,0,0,0,11,1,288,66,28378,27397,41326,4,28,20,1,0,0,0,3,284,76,29254,28913,35315,1,4,-10,-876,-2,-1516,6011,0,0,0,0,8
EUN1_3576220441',3,29,10,0,0,0,0,10,1,326,92,25662,27166,31984,2,23,19,1,0,2,0,7,294,84,29589,29442,37775,1,32,8,-3927,-9,-2276,-5791,-1,0,-2,0,3
EUN1_3575995845',4,317,6,1,0,2,0,2,1,343,88,24365,30031,28783,4,29,0,0,0,0,0,1,348,108,21248,27605,20733,1,-5,-20,3117,6,2426,8050,1,0,2,0,1
EUN1_3575931086',1,22,10,0,0,0,0,8,0,299,72,24637,26888,27407,4,33,10,1,0,0,0,2,334,100,25881,28829,29167,0,-35,-28,-1244,0,-1941,-1760,-1,0,0,0,6
EUN1_3575458258',2,27,9,1,0,1,0,11,0,379,94,27691,29676,27313,2,26,10,0,0,1,0,4,342,74,25772,27800,26202,0,37,20,1919,-1,1876,1111,1,0,0,0,7
EUN1_3575248796',5,31,21,0,0,0,0,14,1,300,74,30389,27978,37630,6,368,15,1,0,1,0,4,280,86,27583,27466,33931,1,20,-12,2806,6,512,3699,-1,0,-1,0,10
EUN1_3574843996',0,33,20,1,0,0,0,7,0,357,100,31102,30074,38324,4,28,17,1,0,0,0,7,298,84,27417,28039,29032,1,59,16,3685,3,2035,9292,0,0,0,0,0
EUN1_3574488348',6,25,22,2,0,1,0,8,1,301,85,31421,29639,39173,0,29,19,0,0,0,0,7,342,82,29478,28750,33142,1,-41,3,1943,3,889,6031,2,0,1,0,1
EUN1_3574452328',7,25,13,0,0,1,0,4,0,334,85,28030,30409,35340,1,20,14,2,0,0,0,6,360,74,26534,30642,33564,0,-26,11,1496,-1,-233,1776,-2,0,1,0,-2
EUN1_3573687926',5,27,16,0,0,1,0,4,1,291,72,27989,29029,36242,6,100,11,1,0,0,0,7,294,96,24722,28438,29729,1,-3,-24,3267,5,591,6513,-1,0,1,0,-3
EUN1_3572608635',0,20,6,0,0,0,0,14,0,286,68,23375,25701,27015,1,37,16,2,0,2,0,2,336,88,29077,31038,36614,0,-50,-20,-5702,-10,-5337,-9599,-2,0,-2,0,12
EUN1_3570742988',2,25,10,0,1,0,0,4,1,343,100,26970,29440,28059,5,275,9,2,0,0,0,2,359,96,25691,29149,30556,1,-16,4,1279,1,291,-2497,-2,1,0,0,2
EUN1_3570728693',3,20,14,0,0,0,0,10,0,322,72,27263,27876,30574,3,26,16,2,0,2,0,2,356,112,32151,31065,35822,0,-34,-40,-4888,-2,-3189,-5248,-2,0,-2,0,8
EUN1_3576244473',2,19,12,0,0,0,0,11,0,295,68,24752,27750,34739,5,27,21,1,0,1,0,0,335,75,30869,31627,39620,0,-40,-7,-6117,-9,-3877,-4881,-1,0,-1,0,11
EUN1_3575975592',7,51,15,2,0,0,0,10,0,301,84,27088,29408,29443,1,29,9,0,0,1,0,4,292,80,25105,25310,31784,1,9,4,1983,6,4098,-2341,2,0,-1,0,6
EUN1_3575925916',5,37,2,2,0,0,0,9,0,372,76,21566,26665,28581,7,20,12,0,0,1,0,2,357,79,27333,29033,34196,0,15,-3,-5767,-10,-2368,-5615,2,0,-1,0,7
EUN1_3575902739',0,27,21,1,1,0,0,13,0,281,76,29412,31418,40111,3,95,14,1,0,2,0,0,327,74,29804,28410,38646,1,-46,2,-392,7,3008,1465,0,1,-2,0,13
EUN1_3575844571',3,29,17,2,1,1,0,10,0,331,80,28861,29561,38518,0,22,9,0,0,1,0,3,325,88,25815,26609,28593,1,6,-8,3046,8,2952,9925,2,1,0,0,7
EUN1_3575821880',5,47,20,1,0,2,0,10,0,345,61,30350,31034,46730,1,34,12,1,0,1,0,8,312,81,27300,28141,35683,1,33,-20,3050,8,2893,11047,0,0,1,0,2
EUN1_3575758143',0,22,7,0,0,0,0,16,0,314,74,24082,26383,25153,6,31,17,1,0,3,0,0,370,86,31390,31731,36437,0,-56,-12,-7308,-10,-5348,-11284,-1,0,-3,0,16
EUN1_3575725377',5,28,12,2,0,1,0,7,1,317,84,25508,27658,35448,1,31,11,0,0,1,0,4,313,82,26848,28046,33927,1,4,2,-1340,1,-388,1521,2,0,0,0,3
EUN1_3575704050',3,28,12,0,1,0,0,4,0,364,84,27385,30069,32175,6,32,11,2,0,0,0,6,334,99,26970,29148,25467,1,30,-15,415,1,921,6708,-2,1,0,0,-2
EUN1_3573550939',1,30,18,1,0,1,0,9,1,345,98,30947,28806,35410,6,35,17,1,0,1,0,4,324,90,29029,28652,34959,1,21,8,1918,1,154,451,0,0,0,0,5
EUN1_3573197284',5,30,15,1,0,0,0,7,0,361,74,27334,30979,40230,4,18,10,1,0,0,0,3,274,109,24660,26324,31333,0,87,-35,2674,5,4655,8897,0,0,0,0,4
EUN1_3573172689',5,25,22,1,0,2,0,6,1,356,94,31146,33600,36703,6,42,7,0,0,0,0,8,299,88,23443,26888,30793,1,57,6,7703,15,6712,5910,1,0,2,0,-2
EUN1_3573138234',3,96,7,1,0,0,0,4,0,362,84,24155,27640,23509,2,49,9,1,0,0,0,0,347,80,24759,28118,24453,0,15,4,-604,-2,-478,-944,0,0,0,0,4
EUN1_3573119385',3,27,12,0,0,0,0,9,0,317,102,26623,29237,35222,4,26,20,2,0,1,0,4,350,82,29684,31843,31854,0,-33,20,-3061,-8,-2606,3368,-2,0,-1,0,5
EUN1_3573077377',4,47,5,0,0,0,0,14,0,343,84,23101,28602,26437,5,28,13,2,0,3,0,0,400,100,29750,32563,30911,0,-57,-16,-6649,-8,-3961,-4474,-2,0,-3,0,14
EUN1_3573023982',5,28,21,2,1,3,0,4,1,355,120,33056,32117,41769,0,26,8,0,0,1,0,9,262,59,23250,27763,34914,1,93,61,9806,13,4354,6855,2,1,2,0,-5
EUN1_3573011984',7,28,23,2,0,2,0,6,1,379,120,33185,32915,46645,5,33,7,0,0,0,0,6,249,63,23972,23798,29426,1,130,57,9213,16,9117,17219,2,0,2,0,0
EUN1_3573002060',7,31,21,2,0,1,0,6,1,320,70,28969,29269,38207,6,37,7,0,1,1,0,6,327,94,25298,28434,25136,1,-7,-24,3671,14,835,13071,2,-1,0,0,0
EUN1_3572974002',2,29,23,1,0,1,0,10,0,327,78,30712,29951,41172,3,33,16,0,0,1,0,4,331,70,27854,26822,39977,1,-4,8,2858,7,3129,1195,1,0,0,0,6
EUN1_3572528927',3,52,11,0,0,1,0,6,1,363,122,28397,31561,28002,5,42,12,1,0,0,0,7,339,76,25912,28376,37228,0,24,46,2485,-1,3185,-9226,-1,0,1,0,-1
EUN1_3564350351',2,19,7,1,0,0,0,12,0,343,72,24681,28224,29503,1,26,27,0,0,3,0,0,403,72,34952,32841,42537,0,-60,0,-10271,-20,-4617,-13034,1,0,-3,0,12
EUN1_3564336169',3,27,11,2,0,0,0,5,0,373,94,27481,31013,31270,3,24,9,0,0,0,0,1,397,98,26751,30356,28751,1,-24,-4,730,2,657,2519,2,0,0,0,4
EUN1_3564313564',6,30,15,2,1,1,0,10,1,307,90,28593,30315,32602,1,33,8,0,0,0,0,1,394,90,25937,29085,25578,1,-87,0,2656,7,1230,7024,2,1,1,0,9
EUN1_3564298516',5,27,17,1,0,0,0,8,0,319,72,27604,30980,35925,5,27,12,1,1,1,0,1,341,82,27266,29379,36880,1,-22,-10,338,5,1601,-955,0,-1,-1,0,7
EUN1_3564289140',3,28,18,1,1,2,0,4,0,392,96,32125,31741,36046,1,85,4,0,0,0,0,9,344,80,23041,27307,18494,1,48,16,9084,14,4434,17552,1,1,2,0,-5
EUN1_3564270602',0,18,15,0,0,0,0,12,0,285,86,27672,28220,35785,8,33,22,2,0,3,0,5,338,68,31776,31150,39497,0,-53,18,-4104,-7,-2930,-3712,-2,0,-3,0,7
EUN1_3564268238',6,27,8,0,0,0,0,6,1,304,74,23535,26890,28756,4,27,19,1,0,0,0,0,326,88,28650,29519,35469,0,-22,-14,-5115,-11,-2629,-6713,-1,0,0,0,6
EUN1_3564242228',4,28,11,1,0,0,0,8,0,357,92,26654,30516,24287,5,27,12,1,0,1,0,2,351,91,28515,29643,33112,0,6,1,-1861,-1,873,-8825,0,0,-1,0,6
EUN1_3564220034',7,28,15,0,0,1,0,11,1,365,96,29540,33262,32014,2,28,10,2,0,0,0,7,355,88,27061,30501,31971,1,10,8,2479,5,2761,43,-2,0,1,0,4
EUN1_3564225211',0,14,2,0,0,0,0,11,0,342,100,21599,27783,11417,4,27,16,2,1,3,0,0,398,112,31357,34086,31253,0,-56,-12,-9758,-14,-6303,-19836,-2,-1,-3,0,11
EUN1_3564204054',5,23,11,1,0,0,0,10,1,344,76,25786,28113,33414,2,23,18,1,0,1,0,1,344,88,29776,31560,41641,0,0,-12,-3990,-7,-3447,-8227,0,0,-1,0,9
EUN1_3564199975',3,206,4,1,1,0,0,10,1,351,96,23987,27657,26928,6,27,19,1,0,1,0,5,352,132,30987,34292,35139,0,-1,-36,-7000,-15,-6635,-8211,0,1,-1,0,5
EUN1_3563726846',6,32,8,1,0,2,0,8,0,346,80,26623,28273,35661,3,95,13,0,0,0,0,4,322,68,26535,29169,29412,0,24,12,88,-5,-896,6249,1,0,2,0,4
EUN1_3563709526',4,26,8,0,0,0,0,8,0,256,94,23598,25920,25534,4,30,9,1,0,1,0,0,365,86,26338,28401,27065,0,-109,8,-2740,-1,-2481,-1531,-1,0,-1,0,8
EUN1_3563682697',10,34,13,0,0,0,0,8,0,327,100,28090,29539,35601,2,23,11,2,0,1,0,6,348,90,26680,30580,29679,0,-21,10,1410,2,-1041,5922,-2,0,-1,0,2
EUN1_3563667963',1,82,7,0,0,0,0,8,0,312,93,24275,26790,27334,7,22,20,2,0,1,0,2,363,86,30286,31360,39163,0,-51,7,-6011,-13,-4570,-11829,-2,0,-1,0,6
EUN1_3563658446',3,28,6,0,0,0,0,4,1,354,81,24770,26718,20157,2,29,9,1,0,0,0,5,349,102,26014,28560,24684,0,5,-21,-1244,-3,-1842,-4527,-1,0,0,0,-1
EUN1_3563645003',4,30,13,1,0,0,0,2,1,375,86,27738,32637,25825,3,27,5,1,0,0,0,5,380,86,23616,28906,25153,1,-5,0,4122,8,3731,672,0,0,0,0,-3
EUN1_3565690567',3,353,7,0,0,0,0,13,1,304,68,24093,26284,24680,6,245,21,2,0,2,0,1,373,92,32000,32849,35735,0,-69,-24,-7907,-14,-6565,-11055,-2,0,-2,0,12
EUN1_3565670868',4,20,14,0,0,1,0,6,1,338,82,28625,29961,28608,7,133,13,2,0,0,0,4,330,85,26584,28295,29584,1,8,-3,2041,1,1666,-976,-2,0,1,0,2
EUN1_3565527055',0,106,6,0,0,0,0,14,0,335,84,24599,27610,26932,3,22,22,2,0,1,0,3,391,72,32658,32908,36216,0,-56,12,-8059,-16,-5298,-9284,-2,0,-1,0,11
EUN1_3565518729',3,27,20,0,0,1,0,7,0,335,82,30300,29244,42732,5,47,15,2,0,1,0,2,314,82,27974,28635,36679,0,21,0,2326,5,609,6053,-2,0,0,0,5
EUN1_3565503655',6,23,21,1,0,0,0,6,1,334,86,31498,31782,41065,3,118,20,1,0,0,0,5,318,74,29687,28749,39032,1,16,12,1811,1,3033,2033,0,0,0,0,1
EUN1_3565459091',3,31,13,0,0,1,0,11,0,374,80,27859,28893,40152,5,28,14,2,0,1,0,5,328,104,28633,29191,33968,1,46,-24,-774,-1,-298,6184,-2,0,0,0,6
EUN1_3565430411',3,48,12,1,0,0,0,8,1,367,98,28033,30716,28845,2,24,6,1,0,1,0,3,329,80,22742,27345,25756,1,38,18,5291,6,3371,3089,0,0,-1,0,5
EUN1_3565393751',0,21,13,0,0,1,0,6,0,329,88,26693,29547,32322,4,37,8,1,0,0,0,6,294,86,24598,26669,34291,0,35,2,2095,5,2878,-1969,-1,0,1,0,0
EUN1_3565373277',1,18,14,0,0,0,0,11,0,310,78,27294,27368,36143,3,29,18,1,0,2,0,2,317,88,29270,29746,36834,0,-7,-10,-1976,-4,-2378,-691,-1,0,-2,0,9
EUN1_3565346733',5,25,21,1,0,0,0,9,1,316,100,28795,30262,37201,4,25,7,0,0,1,0,2,316,96,25345,28081,35563,1,0,4,3450,14,2181,1638,1,0,-1,0,7
EUN1_3565334146',6,234,17,1,1,2,0,9,0,312,100,30271,28625,36969,4,24,12,1,0,0,0,6,323,76,26669,26755,28365,1,-11,24,3602,5,1870,8604,0,1,2,0,3
EUN1_3565308394',5,29,19,0,1,1,0,7,0,310,88,29358,29562,38198,2,25,16,2,0,0,0,6,323,100,29946,28293,34510,0,-13,-12,-588,3,1269,3688,-2,1,1,0,1
EUN1_3565294198',6,33,10,0,0,0,0,11,1,299,70,25008,26864,30519,1,27,19,2,0,2,0,2,350,92,32155,30082,34458,0,-51,-22,-7147,-9,-3218,-3939,-2,0,-2,0,9
EUN1_3565270957',7,45,18,2,0,0,0,11,0,325,85,28235,29920,31017,5,27,7,0,0,2,0,5,363,74,25917,27796,31983,1,-38,11,2318,11,2124,-966,2,0,-2,0,6
EUN1_3565263564',2,24,15,1,0,2,0,4,0,354,88,28972,29252,29887,8,26,8,0,0,0,0,8,323,70,24197,28005,27726,1,31,18,4775,7,1247,2161,1,0,2,0,-4
EUN1_3565220002',0,26,8,0,0,0,0,15,1,292,100,26335,27468,31054,3,24,27,2,0,2,0,0,337,92,33739,32868,48766,0,-45,8,-7404,-19,-5400,-17712,-2,0,-2,0,15
EUN1_3565213388',3,25,11,0,0,0,0,9,0,376,97,29216,30260,30630,5,273,11,1,0,2,0,7,324,90,25656,29654,29249,1,52,7,3560,0,606,1381,-1,0,-2,0,2
EUN1_3565198613',1,23,16,1,0,1,0,6,0,310,82,28268,29815,42162,3,22,16,1,0,1,0,8,274,88,28816,28171,38060,1,36,-6,-548,0,1644,4102,0,0,0,0,-2
EUN1_3565183036',4,39,8,1,0,0,0,8,1,344,94,24823,29440,27000,4,26,12,1,0,1,0,1,340,68,27018,29033,29038,1,4,26,-2195,-4,407,-2038,0,0,-1,0,7
EUN1_3576141506',1,23,9,2,1,1,0,11,1,384,94,27152,30751,26819,3,25,11,0,0,0,0,5,303,82,25298,27801,33942,0,81,12,1854,-2,2950,-7123,2,1,1,0,6
EUN1_3575519463',2,25,7,1,0,0,0,6,1,345,80,25163,26965,34422,2,25,12,1,0,0,0,5,338,82,26476,30562,31311,1,7,-2,-1313,-5,-3597,3111,0,0,0,0,1
EUN1_3575491334',2,42,13,0,0,1,0,12,1,363,93,28019,29989,25196,6,25,11,2,0,2,0,5,338,82,27228,28822,27904,0,25,11,791,2,1167,-2708,-2,0,-1,0,7
EUN1_3574861964',6,38,15,2,0,0,0,9,1,335,88,28244,28771,30985,4,22,11,0,1,1,0,5,342,87,27828,29454,28403,0,-7,1,416,4,-683,2582,2,-1,-1,0,4
EUN1_3574780719',4,139,13,0,0,2,0,7,1,312,99,26684,28920,39202,8,69,12,2,0,0,0,3,315,80,25566,28924,26932,1,-3,19,1118,1,-4,12270,-2,0,2,0,4
EUN1_3574309837',1,23,15,0,0,0,0,15,1,344,72,28043,31759,32895,4,22,14,2,0,1,0,2,347,92,28275,30705,37089,0,-3,-20,-232,1,1054,-4194,-2,0,-1,0,13
EUN1_3574174985',6,29,13,1,0,0,0,7,1,371,102,27481,29275,27427,5,26,7,1,0,0,0,4,360,82,25096,27998,22323,1,11,20,2385,6,1277,5104,0,0,0,0,3
EUN1_3574168328',4,93,18,0,1,0,0,9,0,314,84,29280,28840,31976,5,25,15,1,0,1,0,1,366,76,29341,27921,32605,0,-52,8,-61,3,919,-629,-1,1,-1,0,8
EUN1_3574119648',5,29,6,0,0,0,0,11,1,330,82,24329,28289,26738,3,25,8,1,0,1,0,2,367,86,24843,30097,24879,1,-37,-4,-514,-2,-1808,1859,-1,0,-1,0,9
EUN1_3573486534',3,26,10,1,0,0,0,8,0,366,66,25744,29365,27748,2,37,15,1,0,1,0,3,380,90,29198,31938,33096,1,-14,-24,-3454,-5,-2573,-5348,0,0,-1,0,5
EUN1_3573476039',1,10,5,0,0,0,0,15,0,279,103,22787,26274,14608,3,23,21,2,0,6,1,0,401,84,33975,32197,34886,0,-122,19,-11188,-16,-5923,-20278,-2,0,-6,-1,15
EUN1_3573472514',6,30,13,0,0,1,0,5,0,386,110,28867,31730,30563,6,36,6,2,0,0,0,4,334,87,23302,27226,26292,1,52,23,5565,7,4504,4271,-2,0,1,0,1
EUN1_3573457451',3,17,16,0,0,0,0,15,1,346,68,28544,29937,31553,0,26,20,2,0,0,0,1,364,88,30690,32403,41729,0,-18,-20,-2146,-4,-2466,-10176,-2,0,0,0,14
EUN1_3573442646',3,27,9,1,0,1,0,7,0,354,88,26293,29148,32193,6,26,15,0,0,1,0,2,330,96,28527,30162,33016,1,24,-8,-2234,-6,-1014,-823,1,0,0,0,5
EUN1_3573416844',3,24,12,0,0,0,0,9,1,348,65,28069,29386,35509,5,23,13,2,0,1,0,6,327,90,28522,29530,31402,0,21,-25,-453,-1,-144,4107,-2,0,-1,0,3
EUN1_3573396532',4,28,19,1,0,2,0,15,0,394,86,31788,32280,35017,3,31,9,1,0,1,0,6,361,78,27660,29233,28150,1,33,8,4128,10,3047,6867,0,0,1,0,9
EUN1_3573263899',1,24,19,1,0,0,0,4,1,336,96,29589,31158,37763,5,30,7,0,0,0,0,5,324,80,24373,28547,30972,1,12,16,5216,12,2611,6791,1,0,0,0,-1
EUN1_3572709892',2,23,12,2,0,0,0,13,0,280,91,25146,25665,30230,3,26,19,0,0,2,0,4,322,100,31851,30112,43611,0,-42,-9,-6705,-7,-4447,-13381,2,0,-2,0,9
EUN1_3569812265',2,27,15,1,0,0,0,6,0,316,110,27493,29597,35069,2,28,13,1,0,0,0,5,364,78,28099,28951,33130,1,-48,32,-606,2,646,1939,0,0,0,0,1
EUN1_3568086709',2,27,11,0,0,0,0,12,0,327,83,26807,28308,28617,1,13,27,1,0,2,0,2,314,77,33028,28913,41931,0,13,6,-6221,-16,-605,-13314,-1,0,-2,0,10
EUN1_3568080089',3,22,9,0,0,1,0,8,0,338,79,26250,28703,27911,7,29,11,2,1,1,0,5,381,110,27593,31428,30183,0,-43,-31,-1343,-2,-2725,-2272,-2,-1,0,0,3
EUN1_3567752733',2,26,19,1,0,0,0,10,1,323,98,29680,29461,36301,1,29,14,0,0,0,0,1,302,74,26001,26626,30663,1,21,24,3679,5,2835,5638,1,0,0,0,9
EUN1_3567646257',3,25,15,2,0,0,0,10,0,324,88,28588,28233,35119,3,32,23,0,1,4,0,1,371,88,36878,33178,43058,0,-47,0,-8290,-8,-4945,-7939,2,-1,-4,0,9
EUN1_3567629312',3,20,10,0,0,1,0,8,1,372,86,26547,29748,27331,2,43,7,2,0,0,0,4,333,98,25034,28339,25963,0,39,-12,1513,3,1409,1368,-2,0,1,0,4
EUN1_3575848799',3,24,11,0,0,0,0,13,1,317,62,25318,26348,33056,4,27,18,2,0,2,0,3,377,100,32469,31990,35986,0,-60,-38,-7151,-7,-5642,-2930,-2,0,-2,0,10
EUN1_3573166303',5,24,8,0,0,0,0,5,1,327,86,25323,28438,30723,3,23,16,2,1,0,0,3,344,95,27956,31248,30030,1,-17,-9,-2633,-8,-2810,693,-2,-1,0,0,2
EUN1_3573136827',8,73,11,1,0,1,0,10,1,342,84,26556,29664,30132,1,19,10,0,0,0,0,2,370,76,27748,29051,31629,0,-28,8,-1192,1,613,-1497,1,0,1,0,8
EUN1_3573132316',5,31,15,0,0,0,0,10,1,264,59,27433,27770,34752,5,31,19,1,1,3,0,5,341,100,32334,29964,42506,0,-77,-41,-4901,-4,-2194,-7754,-1,-1,-3,0,5
EUN1_3573113428',2,20,7,0,0,1,0,15,0,273,68,23212,25890,25303,5,24,17,1,0,2,0,4,350,88,29428,30466,32261,0,-77,-20,-6216,-10,-4576,-6958,-1,0,-1,0,11
EUN1_3573090892',3,25,10,0,0,0,0,6,1,304,112,25319,29871,30967,6,30,16,2,0,0,0,3,353,96,27972,30648,37542,0,-49,16,-2653,-6,-777,-6575,-2,0,0,0,3
EUN1_3573071841',3,36,18,1,1,1,0,10,1,292,66,30039,27403,37487,7,27,24,1,0,1,0,7,290,91,30833,28535,46619,0,2,-25,-794,-6,-1132,-9132,0,1,0,0,3
EUN1_3572087102',2,22,6,1,0,0,0,8,0,349,105,23899,28658,24566,1,52,12,1,0,1,0,1,411,98,29242,32314,33209,0,-62,7,-5343,-6,-3656,-8643,0,0,-1,0,7
EUN1_3572066275',8,28,18,0,0,2,0,10,1,351,82,30932,29764,35301,3,61,10,1,0,2,0,11,333,94,27869,27837,37610,1,18,-12,3063,8,1927,-2309,-1,0,0,0,-1
EUN1_3572037988',5,30,11,1,0,0,0,6,1,305,78,25265,25723,31912,4,23,28,0,0,0,0,2,335,90,32415,31202,41105,1,-30,-12,-7150,-17,-5479,-9193,1,0,0,0,4
EUN1_3572018883',6,34,6,0,0,0,0,6,0,383,102,25058,30657,23246,4,222,11,2,0,0,0,3,358,78,26356,29743,26751,1,25,24,-1298,-5,914,-3505,-2,0,0,0,3
EUN1_3571997885',2,32,11,1,0,0,0,5,0,355,86,26253,30036,29839,6,24,7,1,0,0,0,4,374,94,24795,29128,20958,0,-19,-8,1458,4,908,8881,0,0,0,0,1
EUN1_3571702729',9,31,9,0,0,0,0,9,0,254,68,24013,23996,27414,6,29,16,0,0,1,0,2,325,75,27768,28389,37150,0,-71,-7,-3755,-7,-4393,-9736,0,0,-1,0,7
EUN1_3575948047',3,26,15,1,0,1,0,13,1,329,79,30116,30695,33984,4,24,9,1,0,2,0,4,289,88,24910,26362,24333,0,40,-9,5206,6,4333,9651,0,0,-1,0,9
EUN1_3574818139',5,29,13,1,0,0,0,4,1,316,90,25780,28464,35098,3,30,12,1,0,0,0,1,325,118,25747,27982,32349,0,-9,-28,33,1,482,2749,0,0,0,0,3
EUN1_3574794862',4,39,9,2,0,0,0,7,0,301,101,23420,25657,27891,5,26,18,0,0,1,0,0,351,82,30170,32324,43432,0,-50,19,-6750,-9,-6667,-15541,2,0,-1,0,7
EUN1_3574786309',1,24,11,1,0,1,0,10,1,346,94,28521,30763,29216,3,26,11,1,0,1,0,3,347,98,27059,29283,27692,0,-1,-4,1462,0,1480,1524,0,0,0,0,7
EUN1_3574772415',4,53,9,0,0,0,0,12,0,293,93,23180,27862,22505,1,21,12,2,0,1,0,1,340,98,26966,29812,31293,0,-47,-5,-3786,-3,-1950,-8788,-2,0,-1,0,11
EUN1_3574757112',2,22,10,1,0,1,0,12,0,318,93,27477,27791,31520,2,29,17,1,0,2,0,6,312,59,28714,29231,46727,1,6,34,-1237,-7,-1440,-15207,0,0,-1,0,6
EUN1_3574726514',4,27,15,1,0,0,0,9,0,369,92,28492,31526,36253,1,25,15,1,1,1,0,1,344,78,28839,28949,31274,1,25,14,-347,0,2577,4979,0,-1,-1,0,8
EUN1_3574625428',4,26,19,1,0,0,0,6,1,338,106,29121,31958,36584,3,25,6,0,0,0,0,7,324,82,23354,26699,24075,0,14,24,5767,13,5259,12509,1,0,0,0,-1
EUN1_3574261359',3,22,19,0,0,1,0,5,0,315,70,29269,28813,36235,2,26,11,1,0,0,0,7,328,94,25838,27282,35996,1,-13,-24,3431,8,1531,239,-1,0,1,0,-2
EUN1_3574131007',3,25,16,1,0,1,0,8,1,379,80,28352,30419,38628,5,40,12,0,0,0,0,6,306,80,26685,29983,35357,0,73,0,1667,4,436,3271,1,0,1,0,2
EUN1_3574118145',1,61,9,1,0,0,0,9,0,297,76,23989,28109,32040,2,64,14,1,0,1,0,2,369,88,28333,30623,33421,1,-72,-12,-4344,-5,-2514,-1381,0,0,-1,0,7
EUN1_3567249868',3,26,15,1,0,0,0,4,0,348,90,28422,30070,37992,4,28,13,0,0,0,0,4,287,86,26066,27916,31897,0,61,4,2356,2,2154,6095,1,0,0,0,0
EUN1_3566151097',2,28,15,1,0,1,0,8,1,334,86,29097,29124,30519,3,29,12,1,0,0,0,4,338,76,26327,27858,30296,1,-4,10,2770,3,1266,223,0,0,1,0,4
EUN1_3564543282',4,25,10,1,0,0,0,9,1,337,86,25985,31016,31149,3,34,11,1,0,2,0,4,385,89,27399,30486,32692,1,-48,-3,-1414,-1,530,-1543,0,0,-2,0,5
EUN1_3564398232',1,21,11,2,0,1,0,5,0,315,82,27426,29061,36134,6,102,11,0,0,0,0,8,314,82,25302,27585,25455,1,1,0,2124,0,1476,10679,2,0,1,0,-3
EUN1_3564079275',1,24,14,0,0,1,0,6,1,357,83,29077,29559,35687,2,21,13,2,0,1,0,8,357,98,28362,30596,29559,1,0,-15,715,1,-1037,6128,-2,0,0,0,-2
EUN1_3563814154',5,34,10,1,0,0,0,9,0,336,92,26549,28864,37025,1,33,14,1,0,1,0,2,371,100,30114,31979,29123,0,-35,-8,-3565,-4,-3115,7902,0,0,-1,0,7
EUN1_3563704006',6,35,15,2,1,0,0,7,1,359,86,28266,31045,34822,4,35,13,0,0,0,0,0,331,74,27369,28237,37153,1,28,12,897,2,2808,-2331,2,1,0,0,7
EUN1_3563319130',6,28,10,2,0,1,0,9,0,361,68,27694,29762,30362,5,29,14,0,1,3,0,5,330,80,28630,30006,31794,0,31,-12,-936,-4,-244,-1432,2,-1,-2,0,4
EUN1_3563294679',6,37,13,0,0,0,0,11,0,302,78,25589,29771,34862,6,36,21,2,0,1,0,3,338,84,33504,32554,34485,0,-36,-6,-7915,-8,-2783,377,-2,0,-1,0,8
EUN1_3563250342',5,78,14,0,1,0,0,12,0,292,100,28198,29467,30766,3,33,11,2,0,3,0,3,376,98,28235,29983,33403,0,-84,2,-37,3,-516,-2637,-2,1,-3,0,9
EUN1_3562437871',0,25,19,2,0,1,0,11,1,331,79,30391,29966,37828,2,143,15,0,0,1,0,6,343,75,30355,30425,32317,1,-12,4,36,4,-459,5511,2,0,0,0,5
EUN1_3560961090',3,29,15,0,0,0,0,9,1,322,84,27401,29823,37474,5,29,10,1,0,0,0,7,334,95,26011,29267,29635,1,-12,-11,1390,5,556,7839,-1,0,0,0,2
EUN1_3560270352',1,30,14,1,0,1,0,9,1,359,100,28736,29130,33421,5,134,10,1,0,1,0,10,308,80,25813,27082,33800,0,51,20,2923,4,2048,-379,0,0,0,0,-1
EUN1_3559356282',4,23,14,0,0,1,0,8,1,355,92,28650,30163,33767,3,27,13,2,0,0,0,6,322,76,26127,28860,27530,0,33,16,2523,1,1303,6237,-2,0,1,0,2
EUN1_3559279014',4,33,28,0,0,2,0,8,0,321,76,34361,31938,52937,2,36,22,1,0,1,0,6,286,71,30911,27839,39151,1,35,5,3450,6,4099,13786,-1,0,1,0,2
EUN1_3559096514',6,33,14,2,0,0,0,11,0,390,100,29185,30893,25975,7,29,9,0,1,0,0,1,359,104,27624,30021,26949,1,31,-4,1561,5,872,-974,2,-1,0,0,10
EUN1_3559076076',2,27,10,0,0,0,0,12,1,342,92,26078,28972,32399,3,23,17,2,0,1,0,2,338,104,30349,30949,31947,1,4,-12,-4271,-7,-1977,452,-2,0,-1,0,10
EUN1_3559054344',1,29,14,1,0,0,0,13,0,295,90,27159,28841,29428,3,31,21,1,1,0,0,1,321,98,30889,30274,43623,1,-26,-8,-3730,-7,-1433,-14195,0,-1,0,0,12
EUN1_3558731117',5,27,20,0,0,0,0,9,1,327,108,29030,33602,32893,2,38,9,1,0,1,0,2,352,83,26355,28936,28904,0,-25,25,2675,11,4666,3989,-1,0,-1,0,7
EUN1_3558016998',3,22,13,0,0,0,0,6,0,325,92,27394,30117,26862,7,32,11,2,0,1,0,2,326,100,26957,29849,31306,0,-1,-8,437,2,268,-4444,-2,0,-1,0,4
EUN1_3575954051',2,30,18,1,0,2,0,13,0,349,90,33290,30845,40985,5,47,28,1,0,1,0,7,293,98,33127,30602,44684,1,56,-8,163,-10,243,-3699,0,0,1,0,6
EUN1_3575947378',2,78,10,0,0,0,0,17,1,318,88,26007,28200,33116,3,39,25,2,0,3,0,2,377,92,35890,34132,48496,0,-59,-4,-9883,-15,-5932,-15380,-2,0,-3,0,15
EUN1_3575473705',4,22,13,2,1,1,0,8,1,358,98,27594,32438,29593,3,23,5,0,0,0,0,3,350,66,23086,28083,26431,1,8,32,4508,8,4355,3162,2,1,1,0,5
EUN1_3574953318',2,22,21,1,0,0,0,13,0,364,88,32065,31296,34270,6,26,12,0,0,2,0,3,345,96,29275,30101,31252,1,19,-8,2790,9,1195,3018,1,0,-2,0,10
EUN1_3574914435',5,32,8,0,0,0,0,8,1,359,77,25307,28486,32407,3,26,13,1,0,1,0,2,398,52,27534,30689,38650,1,-39,25,-2227,-5,-2203,-6243,-1,0,-1,0,6
EUN1_3574900437',5,23,15,1,0,0,0,11,0,311,84,27062,29213,34194,2,22,6,0,0,1,0,5,382,74,25748,28094,29169,1,-71,10,1314,9,1119,5025,1,0,-1,0,6
EUN1_3574859016',4,38,21,0,0,1,0,15,1,333,82,32463,28799,40042,4,26,20,2,0,2,0,5,333,90,32594,29501,40199,0,0,-8,-131,1,-702,-157,-2,0,-1,0,10
EUN1_3574846409',5,30,15,2,0,1,0,7,1,314,86,28076,28217,34306,2,20,10,0,0,1,0,1,355,98,27408,29668,32038,1,-41,-12,668,5,-1451,2268,2,0,0,0,6
EUN1_3574785648',5,28,12,1,0,1,0,10,1,330,112,26359,29146,29597,4,28,14,0,0,1,0,2,344,55,27527,29655,30428,1,-14,57,-1168,-2,-509,-831,1,0,0,0,8
EUN1_3574765832',3,27,22,2,0,1,0,5,0,343,102,31379,30843,37424,4,32,15,0,1,0,0,6,337,78,29129,28633,32059,1,6,24,2250,7,2210,5365,2,-1,1,0,-1
EUN1_3574756350',0,24,14,0,0,0,0,7,0,374,84,29666,30528,36448,6,29,27,2,0,2,0,3,304,112,33357,32638,37819,0,70,-28,-3691,-13,-2110,-1371,-2,0,-2,0,4
EUN1_3574633292',4,206,4,0,0,1,0,8,0,347,96,23511,29196,23068,8,30,11,1,1,1,0,4,389,100,27926,30803,29807,0,-42,-4,-4415,-7,-1607,-6739,-1,-1,0,0,4
EUN1_3574413795',8,29,11,0,0,1,0,8,0,369,70,28172,30026,24948,5,30,9,1,0,0,0,4,367,80,25552,27698,33998,1,2,-10,2620,2,2328,-9050,-1,0,1,0,4
EUN1_3574393021',1,135,7,1,0,0,0,10,0,262,96,22532,25917,25427,4,19,16,1,0,0,0,2,343,88,28179,30186,36341,0,-81,8,-5647,-9,-4269,-10914,0,0,0,0,8
EUN1_3574345324',4,51,14,2,0,0,0,7,0,362,100,28108,31027,40615,5,27,13,0,0,0,0,4,339,79,26432,29824,36532,1,23,21,1676,1,1203,4083,2,0,0,0,3
EUN1_3575125506',4,24,11,1,0,0,0,5,0,378,70,26823,28993,30287,2,66,16,0,1,1,0,1,365,86,29065,32731,36516,0,13,-16,-2242,-5,-3738,-6229,1,-1,-1,0,4
EUN1_3574122476',6,27,10,0,0,0,0,6,1,371,76,26402,28144,25425,5,24,12,2,0,1,0,0,344,109,26999,29785,32958,0,27,-33,-597,-2,-1641,-7533,-2,0,-1,0,6
EUN1_3573701185',1,28,18,1,0,0,0,6,1,369,82,29421,31686,36888,2,42,14,1,0,0,0,5,338,110,28968,29542,29577,0,31,-28,453,4,2144,7311,0,0,0,0,1
EUN1_3573680284',3,34,7,0,1,1,0,6,0,415,116,27845,33131,30900,4,26,6,2,0,1,0,7,379,79,24330,29167,23208,0,36,37,3515,1,3964,7692,-2,1,0,0,-1
EUN1_3573536492',7,32,5,0,0,1,0,6,1,365,79,24714,27080,21869,3,37,14,1,0,0,0,5,341,99,27139,30053,37684,1,24,-20,-2425,-9,-2973,-15815,-1,0,1,0,1
EUN1_3573523962',3,21,17,2,1,0,0,12,1,359,90,29168,31456,35917,3,27,14,0,0,1,0,2,369,82,29302,29224,30089,1,-10,8,-134,3,2232,5828,2,1,-1,0,10
EUN1_3573054282',4,18,9,0,0,0,0,13,1,293,96,23749,29023,33740,2,22,16,2,1,3,0,0,383,106,31582,32324,37496,0,-90,-10,-7833,-7,-3301,-3756,-2,-1,-3,0,13
EUN1_3572988395',2,86,9,0,0,1,0,5,1,322,84,25423,25596,21304,6,31,13,2,1,1,0,1,360,92,27772,30003,29143,1,-38,-8,-2349,-4,-4407,-7839,-2,-1,0,0,4
EUN1_3576153695',3,24,10,0,0,0,0,6,0,339,80,25543,27447,29873,3,27,13,2,0,1,0,5,352,84,27756,29196,32644,0,-13,-4,-2213,-3,-1749,-2771,-2,0,-1,0,1
EUN1_3576133203',2,25,16,0,0,0,0,10,0,367,107,29838,31275,28369,2,20,12,2,0,2,0,4,353,95,27785,28016,31813,1,14,12,2053,4,3259,-3444,-2,0,-2,0,6
EUN1_3574521877',1,26,20,0,0,2,0,9,0,345,80,31771,32018,35293,1,20,14,2,0,2,0,4,337,76,27747,28867,36473,1,8,4,4024,6,3151,-1180,-2,0,0,0,5
EUN1_3574497068',7,29,13,1,0,0,0,11,0,331,87,27422,27839,36083,1,51,25,0,0,2,0,4,348,64,34000,31106,43816,0,-17,23,-6578,-12,-3267,-7733,1,0,-2,0,7
EUN1_3574467044',4,28,17,2,1,0,0,8,1,333,96,28196,30904,32786,6,29,10,0,0,0,0,0,374,74,27092,28271,32842,1,-41,22,1104,7,2633,-56,2,1,0,0,8
EUN1_3574459567',6,32,18,1,0,2,0,8,1,445,86,32119,33356,33924,3,21,3,0,0,0,0,3,318,94,22002,27004,23971,1,127,-8,10117,15,6352,9953,1,0,2,0,5
EUN1_3574442553',1,20,16,1,0,1,0,6,0,359,110,30140,30757,34051,1,46,11,0,0,0,0,3,264,86,25109,27405,26301,1,95,24,5031,5,3352,7750,1,0,1,0,3
EUN1_3574422416',5,27,16,2,0,1,0,6,0,308,84,29068,28641,38485,0,34,12,0,0,1,0,6,315,78,26922,26239,28936,1,-7,6,2146,4,2402,9549,2,0,0,0,0
EUN1_3574395721',3,28,7,0,0,0,0,12,0,328,92,24269,27306,26349,5,26,16,2,0,1,0,3,346,82,28917,30986,35667,0,-18,10,-4648,-9,-3680,-9318,-2,0,-1,0,9
EUN1_3574379554',2,27,15,2,1,3,0,5,0,377,111,30776,30833,31342,0,13,6,0,0,0,0,9,328,63,23551,26898,21307,1,49,48,7225,9,3935,10035,2,1,3,0,-4
EUN1_3572930247',2,31,13,0,0,0,0,10,1,320,90,27823,28030,32760,4,31,19,1,1,1,0,4,345,74,29654,29889,41383,1,-25,16,-1831,-6,-1859,-8623,-1,-1,-1,0,6
EUN1_3572924298',3,30,22,1,0,3,0,7,1,350,81,32314,31121,42374,0,23,9,0,0,0,0,12,296,94,25020,28214,25833,1,54,-13,7294,13,2907,16541,1,0,3,0,-5
EUN1_3572904589',2,53,23,2,1,1,0,10,0,326,89,31661,31243,37804,6,27,9,0,0,2,0,5,333,81,26683,27219,24759,1,-7,8,4978,14,4024,13045,2,1,-1,0,5
EUN1_3572890633',3,23,12,1,0,2,0,10,0,348,96,29360,31790,30769,3,28,12,1,0,0,0,10,388,80,29011,29329,33433,1,-40,16,349,0,2461,-2664,0,0,2,0,0
EUN1_3572877273',5,26,14,0,0,0,0,9,1,299,56,25883,26189,30528,3,90,17,2,0,1,0,1,319,88,28222,29776,32888,0,-20,-32,-2339,-3,-3587,-2360,-2,0,-1,0,8
EUN1_3572528411',2,30,12,0,0,0,0,7,1,365,74,28022,29836,33243,1,32,11,1,0,1,0,2,335,98,25522,29595,32826,1,30,-24,2500,1,241,417,-1,0,-1,0,5
EUN1_3572517405',4,33,6,0,0,0,0,10,0,325,80,23379,27576,24233,6,33,22,1,0,1,0,3,357,96,30832,31891,36878,0,-32,-16,-7453,-16,-4315,-12645,-1,0,-1,0,7
EUN1_3572501344',2,25,10,1,0,0,0,6,1,328,84,25648,28200,34502,2,22,14,1,0,0,0,5,341,87,27717,31595,45180,1,-13,-3,-2069,-4,-3395,-10678,0,0,0,0,1
EUN1_3572353072',1,60,8,0,0,1,0,7,1,364,77,25572,28294,25641,4,66,13,2,1,2,0,5,337,85,27956,28635,31417,0,27,-8,-2384,-5,-341,-5776,-2,-1,-1,0,2
EUN1_3576035797',4,58,8,0,0,1,0,5,0,342,78,24646,27754,28370,4,60,10,2,0,0,0,3,319,82,24879,26953,28739,1,23,-4,-233,-2,801,-369,-2,0,1,0,2
EUN1_3575978571',6,45,12,2,1,0,0,5,0,335,78,26198,28166,32987,3,50,14,0,0,1,0,2,369,89,29164,29720,32548,1,-34,-11,-2966,-2,-1554,439,2,1,-1,0,3
EUN1_3575946301',5,24,11,0,0,0,0,8,0,366,89,24956,28863,24558,3,26,13,2,0,1,0,2,366,114,27915,30127,27454,0,0,-25,-2959,-2,-1264,-2896,-2,0,-1,0,6
EUN1_3575852833',5,33,7,1,0,0,0,11,0,340,90,24601,27912,26887,6,30,14,1,0,0,0,1,339,81,27232,28509,27802,0,1,9,-2631,-7,-597,-915,0,0,0,0,10
EUN1_3575841591',1,26,25,1,0,1,0,7,0,340,72,33613,30721,50559,3,87,23,1,0,1,0,9,278,96,30331,26859,42134,1,62,-24,3282,2,3862,8425,0,0,0,0,-2
EUN1_3575327394',4,28,9,1,0,0,0,9,1,358,80,25522,29452,33284,6,33,8,0,0,0,0,2,350,71,25071,28559,25504,0,8,9,451,1,893,7780,1,0,0,0,7
EUN1_3574923569',3,25,7,1,0,2,0,9,0,362,76,25768,27383,23595,8,26,12,0,0,0,0,5,380,100,27594,31906,30893,0,-18,-24,-1826,-5,-4523,-7298,1,0,2,0,4
EUN1_3574829350',2,38,11,1,0,1,0,6,1,323,59,25864,25603,29685,1,23,13,0,0,0,0,4,361,104,27358,29806,36252,0,-38,-45,-1494,-2,-4203,-6567,1,0,1,0,2
EUN1_3574804644',6,26,7,0,0,0,0,8,0,365,95,24357,29428,29796,3,25,15,1,0,0,0,1,395,92,28597,31583,31244,0,-30,3,-4240,-8,-2155,-1448,-1,0,0,0,7
EUN1_3574769439',4,26,8,2,0,1,0,7,1,346,88,25450,30269,26119,6,33,11,0,0,1,0,1,414,88,28130,31019,30929,1,-68,0,-2680,-3,-750,-4810,2,0,0,0,6
EUN1_3574726820',1,22,8,1,0,1,0,8,1,367,98,27959,28859,22414,3,22,14,1,0,1,0,8,334,104,29986,30502,30408,0,33,-6,-2027,-6,-1643,-7994,0,0,0,0,0
EUN1_3574715496',3,23,10,0,0,1,0,9,0,353,84,25956,28505,27191,3,46,13,2,0,0,0,1,329,104,27002,30261,37028,0,24,-20,-1046,-3,-1756,-9837,-2,0,1,0,8
EUN1_3574690945',5,31,17,1,0,0,0,8,1,379,92,29825,31788,38291,3,24,13,0,0,2,0,4,379,92,30780,31082,39253,0,0,0,-955,4,706,-962,1,0,-2,0,4
EUN1_3575414457',4,30,14,1,0,2,0,6,1,365,86,29939,32063,33703,5,36,11,1,0,0,0,7,299,102,26300,29642,33668,1,66,-16,3639,3,2421,35,0,0,2,0,-1
EUN1_3575386611',9,35,9,1,0,0,0,4,0,342,77,24597,28300,32175,6,29,13,1,0,0,0,2,337,92,27209,30226,38048,0,5,-15,-2612,-4,-1926,-5873,0,0,0,0,2
EUN1_3575363981',5,27,13,0,0,2,0,16,0,289,74,28015,27144,35181,4,28,23,2,0,4,1,3,355,82,35869,29256,41477,0,-66,-8,-7854,-10,-2112,-6296,-2,0,-2,-1,13
EUN1_3575260584',4,49,10,0,0,1,0,12,1,315,92,25407,27766,25915,2,23,16,2,1,2,0,7,354,84,29720,31621,34969,0,-39,8,-4313,-6,-3855,-9054,-2,-1,-1,0,5
EUN1_3574902712',3,32,11,1,0,0,0,3,0,333,82,26665,28341,33801,8,28,17,0,0,1,0,6,370,74,30067,31008,39023,1,-37,8,-3402,-6,-2667,-5222,1,0,-1,0,-3
EUN1_3574858382',5,30,11,1,0,1,0,8,0,312,80,26216,27213,28725,9,74,18,0,0,1,0,1,323,96,28672,28378,33050,1,-11,-16,-2456,-7,-1165,-4325,1,0,0,0,7
EUN1_3574256318',6,40,16,1,0,0,0,10,1,337,90,27949,30466,33440,0,19,9,1,0,1,0,4,396,98,27430,29822,31634,1,-59,-8,519,7,644,1806,0,0,-1,0,6
EUN1_3573249243',5,29,19,2,0,2,0,9,1,312,78,33201,29081,33816,2,21,13,0,0,1,0,9,331,86,27472,28793,30647,0,-19,-8,5729,6,288,3169,2,0,1,0,0
EUN1_3573222396',5,33,18,0,0,0,0,12,1,350,82,29347,31669,35843,3,63,12,1,0,1,0,3,358,81,27965,28855,34281,0,-8,1,1382,6,2814,1562,-1,0,-1,0,9
EUN1_3572691046',2,25,6,0,0,0,0,8,1,371,100,25089,30851,24355,3,25,11,2,0,1,0,1,395,100,27761,32161,24551,0,-24,0,-2672,-5,-1310,-196,-2,0,-1,0,7
EUN1_3572652432',2,34,12,1,1,1,0,3,0,358,115,28508,29962,28663,3,27,9,0,0,0,0,5,343,72,24255,29028,28475,0,15,43,4253,3,934,188,1,1,1,0,-2
EUN1_3572641245',6,31,5,0,0,0,0,13,0,310,78,22980,25865,26795,5,31,21,2,0,3,0,3,374,110,33277,32332,40863,0,-64,-32,-10297,-16,-6467,-14068,-2,0,-3,0,10
EUN1_3575414190',3,31,10,0,0,0,0,11,0,358,70,26071,29892,31553,3,21,20,1,0,1,0,1,368,104,29314,31530,34700,0,-10,-34,-3243,-10,-1638,-3147,-1,0,-1,0,10
EUN1_3575395088',3,27,13,1,0,0,0,9,0,359,78,26987,29226,35919,7,30,12,1,0,0,0,3,314,81,25900,27962,32401,1,45,-3,1087,1,1264,3518,0,0,0,0,6
EUN1_3575257565',0,66,25,1,0,0,0,10,0,357,88,32807,33756,49960,4,22,19,0,0,2,0,2,316,72,29220,29333,40240,1,41,16,3587,6,4423,9720,1,0,-2,0,8
EUN1_3575248132',4,25,10,1,0,1,0,5,0,382,108,27898,31192,31601,4,28,9,1,0,0,0,3,377,87,25358,29401,25712,1,5,21,2540,1,1791,5889,0,0,1,0,2
EUN1_3568972186',2,117,7,0,0,0,0,6,0,373,88,24157,29043,29434,3,34,12,2,0,0,0,2,413,88,27934,30485,34589,1,-40,0,-3777,-5,-1442,-5155,-2,0,0,0,4
EUN1_3568956349',4,17,17,1,0,0,0,10,0,376,98,31757,30751,37268,3,27,7,0,0,2,0,1,312,76,23108,26259,29483,1,64,22,8649,10,4492,7785,1,0,-2,0,9
EUN1_3568945547',5,26,12,1,0,1,0,4,0,332,78,25931,28677,36262,1,32,9,1,0,0,0,4,319,90,23940,27628,28021,0,13,-12,1991,3,1049,8241,0,0,1,0,0
EUN1_3568615441',5,35,15,0,0,0,0,8,1,408,91,30789,31692,34697,5,31,14,1,0,2,0,6,345,112,28285,29424,28085,0,63,-21,2504,1,2268,6612,-1,0,-2,0,2
EUN1_3568596971',1,28,7,0,0,0,0,14,0,278,102,24373,26966,24187,7,29,20,2,1,3,0,0,377,98,31930,31958,39196,0,-99,4,-7557,-13,-4992,-15009,-2,-1,-3,0,14
EUN1_3568576361',3,28,9,0,0,1,0,5,0,388,99,26710,31356,28578,2,203,10,2,0,0,0,3,393,91,25497,29737,24734,0,-5,8,1213,-1,1619,3844,-2,0,1,0,2
EUN1_3568406392',2,34,20,0,0,1,0,5,1,416,69,32080,31046,37573,2,24,4,0,0,0,0,6,283,89,21891,25026,24984,1,133,-20,10189,16,6020,12589,0,0,1,0,-1
EUN1_3568298522',3,35,19,0,0,1,0,10,1,351,82,31930,28861,43491,5,29,17,1,0,0,0,5,364,81,29999,29272,36416,1,-13,1,1931,2,-411,7075,-1,0,1,0,5
EUN1_3568269530',5,51,8,1,0,0,0,5,0,419,93,26941,29992,30316,11,143,10,1,0,0,0,4,341,74,25118,28279,19630,1,78,19,1823,-2,1713,10686,0,0,0,0,1
EUN1_3568239728',2,94,12,0,1,0,0,9,1,338,79,27403,28978,46308,4,29,15,2,0,0,0,3,336,84,27616,31215,36044,0,2,-5,-213,-3,-2237,10264,-2,1,0,0,6
EUN1_3568212762',6,24,11,0,0,1,0,12,0,347,68,27062,27111,26771,8,288,9,1,0,1,0,3,358,79,27662,27399,33007,0,-11,-11,-600,2,-288,-6236,-1,0,0,0,9
EUN1_3568185770',3,28,12,2,0,0,0,6,1,350,104,27199,31926,34880,3,186,6,0,0,0,0,4,371,60,23085,26381,22238,1,-21,44,4114,6,5545,12642,2,0,0,0,2
EUN1_3568160693',5,28,15,0,0,0,0,15,0,327,89,28726,28349,30348,8,28,17,2,0,3,0,3,395,74,33132,31173,36103,0,-68,15,-4406,-2,-2824,-5755,-2,0,-3,0,12
EUN1_3568145326',5,72,8,2,1,1,0,8,1,360,97,26213,28502,26587,2,22,10,0,0,1,0,4,393,96,26515,29470,25034,1,-33,1,-302,-2,-968,1553,2,1,0,0,4
EUN1_3573868197',2,40,16,1,0,0,0,16,0,270,78,26960,28107,33930,0,22,23,1,1,3,0,3,375,101,34060,31976,45453,0,-105,-23,-7100,-7,-3869,-11523,0,-1,-3,0,13
EUN1_3573851226',5,130,17,2,0,1,0,6,1,394,106,31633,32231,37842,1,18,10,0,0,0,0,4,265,86,24047,27625,28927,1,129,20,7586,7,4606,8915,2,0,1,0,2
EUN1_3573821940',2,27,4,1,0,1,0,11,0,304,76,21472,26288,20765,3,24,15,1,0,2,0,1,311,92,27864,29496,31116,0,-7,-16,-6392,-11,-3208,-10351,0,0,-1,0,10
EUN1_3573764184',1,20,18,1,0,1,0,11,0,251,102,28752,26737,34641,2,25,19,1,0,2,0,5,331,82,31780,28273,36629,1,-80,20,-3028,-1,-1536,-1988,0,0,-1,0,6
EUN1_3573698200',3,26,15,0,0,0,0,10,0,298,83,27648,28063,33003,2,26,17,2,0,1,0,2,285,97,29570,27665,45399,0,13,-14,-1922,-2,398,-12396,-2,0,-1,0,8
EUN1_3573669018',5,23,11,2,0,0,0,5,1,398,94,28106,31575,32806,6,93,9,0,0,0,0,3,372,72,26089,28884,29366,0,26,22,2017,2,2691,3440,2,0,0,0,2
EUN1_3573352894',8,31,18,2,0,6,0,6,1,366,96,33914,30241,32033,4,23,3,0,0,0,0,14,296,72,21709,25013,16833,1,70,24,12205,15,5228,15200,2,0,6,0,-8
EUN1_3573324177',3,23,9,0,0,0,0,7,0,327,102,25148,28627,29890,3,31,18,2,0,0,0,4,282,85,27381,30585,35732,0,45,17,-2233,-9,-1958,-5842,-2,0,0,0,3
EUN1_3573246327',7,28,10,1,0,0,0,5,1,298,88,25338,27354,27881,5,20,18,1,0,1,0,5,357,87,30445,31057,40433,1,-59,1,-5107,-8,-3703,-12552,0,0,-1,0,0
EUN1_3573223232',5,25,12,1,0,1,0,9,0,315,79,26661,29331,34318,7,23,18,1,0,1,0,4,339,80,29736,29596,37131,1,-24,-1,-3075,-6,-265,-2813,0,0,0,0,5
EUN1_3573199926',2,24,24,2,1,3,0,12,1,355,134,35089,34348,42410,2,42,9,0,0,0,0,9,311,65,25009,28467,30410,1,44,69,10080,15,5881,12000,2,1,3,0,3
EUN1_3572158858',7,30,11,0,0,1,0,10,0,339,86,27100,28211,31383,4,285,15,2,0,0,0,6,330,80,27051,30559,29654,1,9,6,49,-4,-2348,1729,-2,0,1,0,4
EUN1_3572128571',6,22,5,0,0,0,0,5,1,375,66,23845,27022,32298,4,26,13,2,0,0,0,1,340,112,26788,30471,30576,0,35,-46,-2943,-8,-3449,1722,-2,0,0,0,4
EUN1_3568267575',7,133,5,1,0,0,0,11,1,310,102,23083,27812,25893,5,32,12,0,0,3,0,1,368,70,28021,30615,30443,0,-58,32,-4938,-7,-2803,-4550,1,0,-3,0,10
EUN1_3568247957',3,21,21,2,0,4,0,5,0,383,120,34261,33814,41229,5,26,5,0,0,2,0,9,272,72,21460,23357,23244,1,111,48,12801,16,10457,17985,2,0,2,0,-4
EUN1_3567230453',6,133,7,0,0,0,0,3,0,365,91,24638,29094,29035,3,20,11,2,0,0,0,2,378,79,26415,31129,32615,0,-13,12,-1777,-4,-2035,-3580,-2,0,0,0,1
EUN1_3567212153',3,32,16,1,0,2,0,8,1,364,92,30440,31482,29739,3,139,9,0,0,1,0,5,386,84,26457,29149,32413,1,-22,8,3983,7,2333,-2674,1,0,1,0,3
EUN1_3567190165',4,45,9,1,0,0,0,13,0,310,84,24768,28418,25382,2,166,12,1,0,1,0,3,328,88,26669,28337,33680,0,-18,-4,-1901,-3,81,-8298,0,0,-1,0,10
EUN1_3567095726',4,25,16,0,0,1,0,12,1,343,92,29814,29489,35161,2,17,18,2,1,1,0,2,330,79,29163,29820,37125,0,13,13,651,-2,-331,-1964,-2,-1,0,0,10
EUN1_3575795338',1,22,22,2,0,1,0,10,1,290,114,31524,30479,36989,2,27,8,0,0,1,0,4,312,77,24940,26406,26505,1,-22,37,6584,14,4073,10484,2,0,0,0,6
EUN1_3575782164',4,33,17,0,0,0,0,6,0,371,90,28877,32787,32029,3,24,9,2,0,0,0,7,351,94,25474,28294,27406,1,20,-4,3403,8,4493,4623,-2,0,0,0,-1
EUN1_3575731332',4,60,1,0,0,0,0,5,0,356,85,21214,28394,18498,0,24,13,2,0,1,0,3,366,98,27299,31208,26362,0,-10,-13,-6085,-12,-2814,-7864,-2,0,-1,0,2
EUN1_3575711831',2,26,19,1,0,1,0,3,1,347,102,29590,31334,35624,4,27,8,1,0,0,0,5,302,82,23941,26567,30997,1,45,20,5649,11,4767,4627,0,0,1,0,-2
EUN1_3573152022',3,28,18,1,0,1,0,13,0,309,86,30874,29816,37509,5,33,22,0,0,1,0,5,360,104,32228,32182,40042,1,-51,-18,-1354,-4,-2366,-2533,1,0,0,0,8
EUN1_3573143949',5,36,20,2,0,2,0,10,1,386,110,32676,32650,36283,6,25,5,0,1,1,0,6,328,94,24291,27222,25046,1,58,16,8385,15,5428,11237,2,-1,1,0,4
EUN1_3573119611',3,24,14,1,0,1,0,9,0,342,78,28492,28956,34825,9,27,13,0,0,0,0,6,353,85,27258,28809,35792,0,-11,-7,1234,1,147,-967,1,0,1,0,3
EUN1_3573092219',4,141,15,1,0,2,0,5,1,425,85,31791,32066,32154,3,31,13,1,0,0,0,4,359,90,28116,31833,28938,1,66,-5,3675,2,233,3216,0,0,2,0,1
EUN1_3573058548',5,21,21,1,1,0,0,3,1,347,80,31446,32138,40406,3,29,10,0,0,1,0,3,316,96,25503,28053,29786,1,31,-16,5943,11,4085,10620,1,1,-1,0,0
EUN1_3570941638',5,182,14,0,0,0,0,11,0,298,63,26601,27495,33133,4,24,20,2,0,2,0,0,398,84,32209,31884,38974,0,-100,-21,-5608,-6,-4389,-5841,-2,0,-2,0,11
EUN1_3567101739',6,30,4,1,0,0,0,13,0,315,86,22106,26098,20660,3,23,16,1,0,3,0,1,358,82,29196,29805,32961,0,-43,4,-7090,-12,-3707,-12301,0,0,-3,0,12
EUN1_3566714464',2,22,8,1,0,0,0,9,0,355,95,25286,28738,25462,4,155,17,1,0,2,0,5,337,108,30496,31317,37467,0,18,-13,-5210,-9,-2579,-12005,0,0,-2,0,4
EUN1_3566655197',2,25,13,0,0,0,0,11,1,275,70,25262,27068,32762,4,29,14,1,0,0,0,1,294,91,27862,27518,38849,0,-19,-21,-2600,-1,-450,-6087,-1,0,0,0,10
EUN1_3566634519',2,24,8,1,0,0,0,5,1,379,102,25973,30426,41640,3,131,7,1,0,0,0,3,369,101,24655,30496,28721,1,10,1,1318,1,-70,12919,0,0,0,0,2
EUN1_3564467224',12,50,23,0,1,1,0,10,1,340,91,32617,32856,40006,2,39,12,2,0,0,0,6,354,76,26522,27679,44346,1,-14,15,6095,11,5177,-4340,-2,1,1,0,4
EUN1_3564427651',4,34,17,1,0,1,0,10,0,348,90,29749,31776,34805,7,27,10,1,0,2,0,6,341,81,26342,28175,35737,0,7,9,3407,7,3601,-932,0,0,-1,0,4
EUN1_3563962540',2,27,18,0,0,0,0,7,1,351,68,28032,30597,35293,3,28,2,2,0,2,0,1,331,108,22613,28088,20964,0,20,-40,5419,16,2509,14329,-2,0,-2,0,6
EUN1_3563127259',2,32,6,1,0,0,0,3,0,367,102,25011,31156,26264,6,27,6,1,0,0,0,5,319,70,22356,26404,24151,1,48,32,2655,0,4752,2113,0,0,0,0,-2
EUN1_3562362050',4,27,8,1,0,0,0,12,0,281,77,23563,26788,27327,2,30,18,1,0,3,0,2,398,94,32121,31519,42498,0,-117,-17,-8558,-10,-4731,-15171,0,0,-3,0,10
EUN1_3562351411',4,55,18,1,0,1,0,5,1,353,94,30722,31740,43183,5,28,8,1,0,0,0,6,303,85,24912,27588,27570,1,50,9,5810,10,4152,15613,0,0,1,0,-1
EUN1_3562321468',5,85,14,1,0,1,0,9,1,282,78,26957,27149,26824,2,27,11,1,0,0,0,1,325,102,26266,28127,34762,1,-43,-24,691,3,-978,-7938,0,0,1,0,8
EUN1_3560228378',2,27,3,0,0,0,0,13,0,315,76,22076,26680,23739,2,21,16,2,0,3,0,1,388,103,31187,32814,34808,0,-73,-27,-9111,-13,-6134,-11069,-2,0,-3,0,12
EUN1_3563750937',2,47,13,1,0,1,0,13,0,293,103,29357,28693,32731,3,33,23,0,0,1,0,4,361,63,31884,28419,38747,1,-68,40,-2527,-10,274,-6016,1,0,0,0,9
EUN1_3563738460',2,24,24,0,0,2,0,10,1,388,80,33085,32219,40344,4,25,8,0,0,0,0,7,352,68,24671,27413,29026,1,36,12,8414,16,4806,11318,0,0,2,0,3
EUN1_3563728324',4,40,31,0,0,4,0,10,1,375,72,40968,32842,55504,4,29,18,2,0,2,0,7,278,98,30311,28533,34446,1,97,-26,10657,13,4309,21058,-2,0,2,0,3
EUN1_3563708808',4,25,20,1,0,2,0,10,0,369,99,31865,33079,35805,1,29,7,0,0,1,0,2,346,93,26891,28219,26860,1,23,6,4974,13,4860,8945,1,0,1,0,8
EUN1_3563695490',7,28,8,2,0,0,0,4,0,334,112,25269,29142,33014,2,39,12,0,0,0,0,1,371,92,27593,30827,33476,0,-37,20,-2324,-4,-1685,-462,2,0,0,0,3
EUN1_3563686136',5,34,15,1,0,1,0,7,1,358,94,30208,30645,28248,6,31,9,0,0,0,0,2,356,76,25211,27932,28062,0,2,18,4997,6,2713,186,1,0,1,0,5
EUN1_3563670073',4,41,11,0,0,1,0,9,0,376,80,27618,29627,27612,4,28,9,2,0,1,0,3,349,120,27106,30296,27666,0,27,-40,512,2,-669,-54,-2,0,0,0,6
EUN1_3563655595',4,30,12,0,0,0,0,8,1,376,90,27245,29814,31129,2,26,13,2,0,0,0,3,364,90,27268,31581,36183,0,12,0,-23,-1,-1767,-5054,-2,0,0,0,5
EUN1_3563652367',5,30,15,2,0,1,0,6,1,371,96,29025,29812,35942,8,39,12,0,0,0,0,5,325,72,25936,28075,29843,1,46,24,3089,3,1737,6099,2,0,1,0,1
EUN1_3563646210',2,26,14,2,0,0,0,8,1,333,84,27936,28834,35742,1,21,11,0,1,0,0,3,324,96,26056,27413,32186,1,9,-12,1880,3,1421,3556,2,-1,0,0,5
EUN1_3562121285',4,29,10,1,0,0,0,9,1,339,76,24729,27910,27338,4,131,12,1,0,1,0,0,375,100,28112,31808,28637,0,-36,-24,-3383,-2,-3898,-1299,0,0,-1,0,9
EUN1_3562112020',6,29,11,1,0,1,0,10,0,338,79,26873,27145,25486,4,31,18,0,0,1,0,4,352,76,30831,32234,32188,0,-14,3,-3958,-7,-5089,-6702,1,0,0,0,6
EUN1_3570089850',4,47,21,1,0,0,0,5,1,349,110,30666,31850,41267,5,52,6,0,0,0,0,4,342,85,23692,27065,23362,1,7,25,6974,15,4785,17905,1,0,0,0,1
EUN1_3561367577',3,153,15,1,0,0,0,13,1,374,90,29805,30526,32561,4,36,12,0,0,3,0,6,300,74,26857,28245,33072,1,74,16,2948,3,2281,-511,1,0,-3,0,7
EUN1_3560198526',5,24,9,1,0,0,0,3,1,359,84,24648,28367,25020,3,24,9,1,0,0,0,3,328,90,25922,28396,27204,0,31,-6,-1274,0,-29,-2184,0,0,0,0,0
EUN1_3559607866',3,29,14,1,0,0,0,11,0,362,97,28306,31699,32511,1,32,10,0,0,1,0,0,336,70,25025,29158,38401,1,26,27,3281,4,2541,-5890,1,0,-1,0,11
EUN1_3559130014',2,25,11,1,0,1,0,10,0,339,102,28130,29060,40314,3,42,22,0,0,1,0,5,271,82,30140,28793,33567,0,68,20,-2010,-11,267,6747,1,0,0,0,5
EUN1_3559102566',3,57,9,0,0,0,0,10,0,308,75,24441,28418,28218,1,20,22,2,1,1,0,1,353,132,33525,34429,41698,0,-45,-57,-9084,-13,-6011,-13480,-2,-1,-1,0,9
EUN1_3558618698',3,29,7,0,0,0,0,8,0,367,82,24490,29834,24170,3,125,9,1,1,1,0,3,393,98,27401,31377,29486,0,-26,-16,-2911,-2,-1543,-5316,-1,-1,-1,0,5
EUN1_3558600621',4,25,12,0,0,0,0,7,1,336,76,25741,28844,29772,2,32,10,0,0,0,0,3,356,56,24833,27153,32417,0,-20,20,908,2,1691,-2645,0,0,0,0,4
EUN1_3558536998',3,34,9,0,0,0,0,10,1,365,65,26575,28589,27196,6,24,10,2,0,1,0,3,299,94,24790,27169,25486,0,66,-29,1785,-1,1420,1710,-2,0,-1,0,7
EUN1_3558527966',2,23,10,1,0,0,0,9,0,338,92,24990,30755,27676,4,32,9,0,0,0,0,2,331,100,24755,29956,21771,1,7,-8,235,1,799,5905,1,0,0,0,7
EUN1_3558028490',4,28,4,1,0,0,0,15,0,333,92,22753,27944,19985,6,30,12,1,0,2,0,0,398,88,29799,31005,29486,0,-65,4,-7046,-8,-3061,-9501,0,0,-2,0,15
EUN1_3555823992',7,50,8,1,0,1,0,6,1,353,64,25806,26557,30035,3,33,7,0,0,1,0,4,327,82,24452,27118,23939,0,26,-18,1354,1,-561,6096,1,0,0,0,2
EUN1_3552254135',5,23,13,1,0,0,0,9,1,330,90,27102,29367,30575,2,73,9,1,0,2,0,2,357,102,27005,29497,34222,0,-27,-12,97,4,-130,-3647,0,0,-2,0,7
EUN1_3551525625',4,78,18,1,0,0,0,7,1,360,100,28870,31603,38506,2,128,7,0,0,0,0,2,405,72,26539,29948,35785,1,-45,28,2331,11,1655,2721,1,0,0,0,5
EUN1_3575402214',2,22,12,0,0,0,0,7,0,372,74,26649,29306,32026,4,44,11,1,0,2,0,1,337,90,26441,28232,30368,0,35,-16,208,1,1074,1658,-1,0,-2,0,6
EUN1_3574937222',6,22,12,0,0,0,0,5,1,327,86,26331,28915,34268,3,28,8,2,0,0,0,2,271,97,23552,25617,37500,1,56,-11,2779,4,3298,-3232,-2,0,0,0,3
EUN1_3574906821',6,27,18,2,0,2,0,12,1,353,82,30753,30224,40429,2,22,11,0,0,0,0,6,355,80,26972,29099,34719,1,-2,2,3781,7,1125,5710,2,0,2,0,6
EUN1_3574893162',7,31,20,1,0,0,0,8,1,329,84,29933,31715,36697,2,124,8,1,0,1,0,7,367,92,27175,29541,24788,1,-38,-8,2758,12,2174,11909,0,0,-1,0,1
EUN1_3574867274',5,29,15,0,0,0,0,9,0,315,83,28549,27878,31588,4,27,18,1,0,0,0,3,343,72,30143,28896,41570,1,-28,11,-1594,-3,-1018,-9982,-1,0,0,0,6
EUN1_3574775857',0,134,12,0,0,0,0,9,0,334,87,27309,29367,34370,5,35,19,2,0,1,0,4,339,89,30858,30971,35586,0,-5,-2,-3549,-7,-1604,-1216,-2,0,-1,0,5
EUN1_3574703922',3,27,17,1,0,2,0,8,0,353,80,31151,28404,29635,4,30,16,1,0,1,0,7,349,59,29775,30660,35805,1,4,21,1376,1,-2256,-6170,0,0,1,0,1
EUN1_3574699083',5,29,13,2,0,0,0,4,0,327,58,25088,27864,35561,2,25,17,0,0,0,0,4,329,78,28029,29486,43320,0,-2,-20,-2941,-4,-1622,-7759,2,0,0,0,0
EUN1_3574438996',3,22,20,0,1,1,0,9,1,386,99,31659,30909,40199,3,24,18,2,0,0,0,2,278,96,28611,28571,36472,0,108,3,3048,2,2338,3727,-2,1,1,0,7
EUN1_3574172149',4,25,10,2,0,0,0,6,1,338,66,25285,28905,27162,1,29,4,0,0,0,0,0,324,86,22644,25627,25144,1,14,-20,2641,6,3278,2018,2,0,0,0,6
EUN1_3574150550',5,35,12,1,0,0,0,8,1,345,87,26287,28731,26093,4,26,11,1,0,0,0,1,375,92,27785,30143,26529,0,-30,-5,-1498,1,-1412,-436,0,0,0,0,7
EUN1_3574132575',2,29,11,0,0,0,0,7,0,361,92,27550,28930,28037,4,28,11,2,0,2,0,3,348,72,27393,28627,29306,0,13,20,157,0,303,-1269,-2,0,-2,0,4
EUN1_3574115807',2,27,11,1,0,0,0,6,1,372,94,28108,30747,26522,1,29,5,0,0,0,0,5,402,93,24629,29170,20814,1,-30,1,3479,6,1577,5708,1,0,0,0,1
EUN1_3573856617',5,21,14,2,0,1,0,10,1,317,92,27577,27818,33136,2,26,8,0,1,0,0,7,357,86,25613,28666,33626,0,-40,6,1964,6,-848,-490,2,-1,1,0,3
EUN1_3573835361',1,22,3,0,0,0,0,11,0,358,79,22923,26271,23011,4,92,18,2,1,2,0,2,377,88,31597,32350,34024,0,-19,-9,-8674,-15,-6079,-11013,-2,-1,-2,0,9
EUN1_3573782134',1,28,18,2,1,1,0,13,0,379,106,31412,32929,36533,6,47,22,0,0,1,0,5,310,56,30907,29697,45112,1,69,50,505,-4,3232,-8579,2,1,0,0,8
EUN1_3573761442',4,27,14,2,0,0,0,12,0,340,76,28331,31269,34317,7,29,14,0,0,1,0,2,356,152,30253,31783,30380,0,-16,-76,-1922,0,-514,3937,2,0,-1,0,10
EUN1_3573738430',2,27,6,0,0,0,0,6,1,398,76,24004,28283,20831,7,33,10,2,0,0,0,2,387,104,26316,31285,23244,0,11,-28,-2312,-4,-3002,-2413,-2,0,0,0,4
EUN1_3571543569',4,25,10,2,0,0,0,9,1,296,82,25448,27645,31305,2,27,9,0,0,0,0,5,355,106,26564,29093,29754,0,-59,-24,-1116,1,-1448,1551,2,0,0,0,4
EUN1_3576158344',5,28,10,1,0,0,0,10,1,383,97,26670,31625,30183,2,21,11,1,0,1,0,0,367,83,26492,31364,29055,0,16,14,178,-1,261,1128,0,0,-1,0,10
EUN1_3576133922',5,44,20,1,0,0,0,12,1,312,60,29596,30633,38646,9,35,19,1,0,3,0,5,341,96,31466,30508,42337,0,-29,-36,-1870,1,125,-3691,0,0,-3,0,7
EUN1_3576113600',5,36,14,2,0,1,0,6,1,350,78,27183,29547,30701,1,22,3,0,0,2,0,7,325,75,24286,25764,24701,1,25,3,2897,11,3783,6000,2,0,-1,0,-1
EUN1_3576088034',3,24,8,1,0,0,0,11,0,367,84,25925,29604,29862,3,28,12,1,0,1,0,3,343,100,28322,30412,31962,0,24,-16,-2397,-4,-808,-2100,0,0,-1,0,8
EUN1_3575913122',5,30,14,1,0,1,0,14,0,331,94,26984,28971,34450,3,24,12,0,0,1,0,0,356,70,27881,29320,31129,0,-25,24,-897,2,-349,3321,1,0,0,0,14
EUN1_3575874118',4,28,12,1,0,0,0,8,1,321,72,26838,28472,30684,3,23,13,0,0,2,0,0,356,88,27861,28818,30434,1,-35,-16,-1023,-1,-346,250,1,0,-2,0,8
EUN1_3575631724',4,33,14,1,0,0,0,10,0,342,98,28292,31382,38992,5,24,11,1,0,0,0,1,339,98,26196,29357,27308,1,3,0,2096,3,2025,11684,0,0,0,0,9
EUN1_3575618876',0,18,16,0,0,1,0,12,1,314,4,26220,25718,36149,3,19,27,1,1,3,0,6,378,95,33583,33453,41690,0,-64,-91,-7363,-11,-7735,-5541,-1,-1,-2,0,6
EUN1_3575608900',2,19,9,1,0,0,0,13,1,270,76,22930,25807,29708,5,30,19,1,0,3,0,2,384,92,32066,33576,33628,0,-114,-16,-9136,-10,-7769,-3920,0,0,-3,0,11
EUN1_3575216995',2,24,18,0,0,1,0,6,1,348,84,30378,31138,39262,3,23,18,1,0,0,0,6,347,76,29701,30675,34836,0,1,8,677,0,463,4426,-1,0,1,0,0
EUN1_3575205838',0,23,14,2,0,0,0,4,0,347,68,26171,29516,34261,5,448,7,0,0,0,0,4,292,80,22898,26583,31436,1,55,-12,3273,7,2933,2825,2,0,0,0,0
EUN1_3575048512',4,21,23,1,0,1,0,9,0,341,96,32913,31598,47853,3,23,19,0,0,0,0,7,298,59,28887,30145,35171,1,43,37,4026,4,1453,12682,1,0,1,0,2
EUN1_3575008595',1,52,27,2,0,2,0,11,1,345,80,34141,30770,45339,0,153,13,0,1,1,0,7,326,84,28993,29477,31839,1,19,-4,5148,14,1293,13500,2,-1,1,0,4
EUN1_3574972926',4,34,8,0,0,0,0,5,0,342,83,24653,28717,29548,3,22,15,1,0,0,0,3,353,92,27856,32078,33332,0,-11,-9,-3203,-7,-3361,-3784,-1,0,0,0,2
EUN1_3573752272',4,41,13,0,0,0,0,10,0,317,54,26973,27348,37963,4,23,22,2,0,1,0,1,337,94,32558,30939,36564,0,-20,-40,-5585,-9,-3591,1399,-2,0,-1,0,9
EUN1_3573733864',7,266,9,0,0,0,0,5,1,264,80,23473,23478,31643,2,182,23,2,0,0,0,2,311,95,30666,32240,43989,0,-47,-15,-7193,-14,-8762,-12346,-2,0,0,0,3
EUN1_3573235966',3,24,6,1,0,0,0,5,0,372,88,23990,30467,22272,5,30,12,0,0,0,0,1,356,100,26665,31237,32652,1,16,-12,-2675,-6,-770,-10380,1,0,0,0,4
EUN1_3573139332',8,28,21,1,0,0,0,12,1,313,88,29793,28928,46848,4,99,19,1,0,1,0,0,317,80,30468,32146,46712,0,-4,8,-675,2,-3218,136,0,0,-1,0,12
EUN1_3573122453',4,28,10,0,0,0,0,14,0,284,78,24038,25254,27356,4,24,18,2,1,3,0,1,363,72,32610,29055,33016,0,-79,6,-8572,-8,-3801,-5660,-2,-1,-3,0,13
EUN1_3575970904',6,25,13,2,0,1,0,6,1,325,82,27483,26589,27370,3,39,7,0,0,1,0,1,321,70,23634,26852,21381,1,4,12,3849,6,-263,5989,2,0,0,0,5
EUN1_3575947840',5,136,20,0,0,0,0,11,1,304,52,27864,28052,43421,1,21,23,1,0,1,0,6,312,95,32061,30933,43806,0,-8,-43,-4197,-3,-2881,-385,-1,0,-1,0,5
EUN1_3575420635',3,111,15,1,0,1,0,9,1,365,90,29799,30327,34181,2,22,10,1,0,1,0,8,329,93,26634,27504,31958,1,36,-3,3165,5,2823,2223,0,0,0,0,1
EUN1_3575373736',1,17,17,1,0,1,0,11,0,361,80,30383,31635,35523,1,22,11,1,0,0,0,4,269,66,24976,25597,28930,1,92,14,5407,6,6038,6593,0,0,1,0,7
EUN1_3575353723',5,28,11,2,0,0,0,7,1,401,68,27352,30511,32933,1,24,7,0,0,0,0,3,348,84,24351,28280,23520,1,53,-16,3001,4,2231,9413,2,0,0,0,4
EUN1_3575338098',5,28,10,1,0,1,0,9,1,342,82,26283,28972,32087,1,25,9,0,0,1,0,2,358,102,26468,29068,29781,1,-16,-20,-185,1,-96,2306,1,0,0,0,7
EUN1_3575307913',5,27,18,2,0,2,0,9,0,349,86,31589,31101,37717,4,24,12,0,0,0,0,5,354,74,27315,27871,30840,1,-5,12,4274,6,3230,6877,2,0,2,0,4
EUN1_3575293685',4,18,14,0,0,0,0,5,1,281,62,25395,26793,38747,1,23,20,2,0,1,0,0,340,97,30388,30651,36596,0,-59,-35,-4993,-6,-3858,2151,-2,0,-1,0,5
EUN1_3572887085',2,22,7,0,0,0,0,12,1,277,74,23561,25584,21974,3,70,20,1,0,3,0,5,377,90,32518,32161,39591,0,-100,-16,-8957,-13,-6577,-17617,-1,0,-3,0,7
EUN1_3572860388',1,16,18,0,0,0,0,7,0,338,76,29382,32397,37379,2,17,13,1,0,1,0,5,313,80,26603,28638,37402,0,25,-4,2779,5,3759,-23,-1,0,-1,0,2
EUN1_3572839390',2,26,10,0,0,0,0,7,0,310,80,25114,30255,28546,1,53,12,2,0,0,0,2,358,94,27143,31489,31852,0,-48,-14,-2029,-2,-1234,-3306,-2,0,0,0,5
EUN1_3572808802',4,29,10,0,0,0,0,10,0,315,76,24430,28132,35584,1,28,24,2,0,1,0,2,316,100,31540,33368,41529,0,-1,-24,-7110,-14,-5236,-5945,-2,0,-1,0,8
EUN1_3572779984',1,30,10,0,0,1,0,9,1,306,68,25640,27074,28576,4,25,16,2,0,1,0,5,348,90,29389,30339,30604,0,-42,-22,-3749,-6,-3265,-2028,-2,0,0,0,4
EUN1_3572754686',2,23,11,0,1,1,0,5,0,359,82,27547,30101,25565,0,22,13,2,0,0,0,3,399,98,28051,31097,26939,1,-40,-16,-504,-2,-996,-1374,-2,1,1,0,2
EUN1_3572727266',4,29,17,0,0,2,0,11,0,333,56,30060,27712,39481,0,23,17,2,0,1,0,5,318,83,27890,27510,32700,1,15,-27,2170,0,202,6781,-2,0,1,0,6
EUN1_3572688697',2,17,9,0,0,0,0,15,0,270,82,24221,26824,29896,4,20,20,1,1,1,0,0,370,97,32503,33736,40104,0,-100,-15,-8282,-11,-6912,-10208,-1,-1,-1,0,15
EUN1_3572676178',3,26,4,0,0,0,0,10,0,308,88,22927,26835,27493,6,26,13,2,0,1,0,3,303,88,26326,29805,27072,0,5,0,-3399,-9,-2970,421,-2,0,-1,0,7
EUN1_3572646700',3,57,9,0,0,0,0,13,0,317,76,25192,26618,25280,4,26,21,2,0,1,0,0,351,93,32860,30185,37449,0,-34,-17,-7668,-12,-3567,-12169,-2,0,-1,0,13
EUN1_3572185863',4,51,4,1,0,0,0,9,1,349,84,22744,28269,20994,5,27,6,1,0,1,0,0,388,96,25372,29472,23464,0,-39,-12,-2628,-2,-1203,-2470,0,0,-1,0,9
EUN1_3575965164',3,21,11,0,0,0,0,13,0,300,76,25675,25542,29027,3,36,17,2,0,4,0,3,372,116,32856,31953,27963,0,-72,-40,-7181,-6,-6411,1064,-2,0,-4,0,10
EUN1_3575944588',2,20,5,0,0,0,0,13,1,298,84,22712,24031,27591,3,24,20,2,0,3,0,4,396,104,32249,33760,41740,0,-98,-20,-9537,-15,-9729,-14149,-2,0,-3,0,9
EUN1_3575830167',1,23,5,0,0,0,0,11,1,274,68,21811,25453,22623,5,29,22,2,0,2,0,1,357,98,31539,31253,36461,0,-83,-30,-9728,-17,-5800,-13838,-2,0,-2,0,10
EUN1_3575803744',1,25,15,0,0,2,0,9,1,326,68,28714,28162,36252,5,29,17,2,1,1,0,7,315,99,28749,28082,33530,1,11,-31,-35,-2,80,2722,-2,-1,1,0,2
EUN1_3575787859',2,27,22,1,0,1,0,7,1,334,102,31620,31420,38154,1,26,9,0,0,0,0,4,330,62,24802,26612,28253,1,4,40,6818,13,4808,9901,1,0,1,0,3
EUN1_3575781164',0,345,11,1,0,0,0,5,1,349,96,26909,28837,36413,4,24,8,0,0,0,0,3,318,75,24953,28198,36233,1,31,21,1956,3,639,180,1,0,0,0,2
EUN1_3575750932',4,27,19,0,0,1,0,8,1,327,110,32230,29314,36703,6,27,16,2,0,1,0,8,294,77,29010,27716,36526,1,33,33,3220,3,1598,177,-2,0,0,0,0
EUN1_3574806394',6,46,12,1,1,0,0,9,0,314,94,26621,26809,23296,4,32,7,1,0,0,0,2,313,77,22625,25118,26638,1,1,17,3996,5,1691,-3342,0,1,0,0,7
EUN1_3574761942',3,238,17,1,0,1,0,13,0,319,87,28524,29989,32477,3,28,10,1,0,0,0,7,321,58,25594,27087,29152,0,-2,29,2930,7,2902,3325,0,0,1,0,6
EUN1_3574757361',5,48,9,0,0,0,0,9,1,327,70,24679,26842,25581,5,24,16,2,0,0,0,2,362,92,27401,31581,35676,0,-35,-22,-2722,-7,-4739,-10095,-2,0,0,0,7
EUN1_3574737256',3,24,14,0,0,0,0,9,0,351,94,27377,29467,30121,4,30,18,2,1,2,0,3,360,88,31952,32808,36785,0,-9,6,-4575,-4,-3341,-6664,-2,-1,-2,0,6
EUN1_3574718290',3,26,21,1,1,2,0,6,0,371,90,32622,32352,39238,2,72,12,0,0,0,0,8,305,85,26396,27919,30897,1,66,5,6226,9,4433,8341,1,1,2,0,-2
EUN1_3574493852',6,44,5,0,0,1,0,5,0,367,95,24989,29622,18148,4,41,9,2,0,0,0,4,344,123,25465,31057,25173,1,23,-28,-476,-4,-1435,-7025,-2,0,1,0,1
EUN1_3574469946',4,26,15,2,0,1,0,6,1,346,112,28897,30639,36089,4,19,5,0,0,0,0,7,316,80,23153,27086,24695,1,30,32,5744,10,3553,11394,2,0,1,0,-1
EUN1_3574279062',6,29,4,0,0,0,0,15,0,229,42,19216,19502,20336,1,33,18,1,0,6,0,0,391,110,34718,31359,28904,0,-162,-68,-15502,-14,-11857,-8568,-1,0,-6,0,15
EUN1_3574259413',3,21,18,1,0,3,0,3,0,405,93,32188,32415,35909,6,32,11,1,1,0,0,6,285,74,26202,28203,28978,1,120,19,5986,7,4212,6931,0,-1,3,0,-3
EUN1_3574239272',2,27,8,1,0,1,0,10,1,359,86,24804,29886,25313,6,29,3,1,0,2,0,6,355,78,23191,26962,15079,1,4,8,1613,5,2924,10234,0,0,-1,0,4
EUN1_3574210070',1,265,14,1,1,6,0,7,1,346,116,31702,30804,28217,1,24,11,1,0,0,0,10,293,87,25171,28637,30097,1,53,29,6531,3,2167,-1880,0,1,6,0,-3
EUN1_3574197100',6,176,17,1,0,1,0,6,1,375,106,30253,32146,36125,3,35,8,0,0,1,0,5,344,89,25331,29306,25883,1,31,17,4922,9,2840,10242,1,0,0,0,1
EUN1_3574162774',5,19,12,2,0,1,0,9,1,367,92,27032,29727,27756,1,31,12,0,1,1,0,1,349,96,27489,30200,27382,1,18,-4,-457,0,-473,374,2,-1,0,0,8
EUN1_3571021475',0,15,14,0,0,0,0,13,0,284,70,25455,28847,34889,4,30,15,2,0,2,0,1,358,90,29958,31790,36136,0,-74,-20,-4503,-1,-2943,-1247,-2,0,-2,0,12
EUN1_3570983589',3,23,16,1,0,1,0,9,1,349,87,29663,29005,34477,1,89,17,1,0,1,0,5,313,67,29029,29111,35967,0,36,20,634,-1,-106,-1490,0,0,0,0,4
EUN1_3568276955',4,26,18,2,0,3,0,6,0,353,97,32526,31910,35957,2,37,11,0,0,1,0,8,316,83,26594,27079,29318,1,37,14,5932,7,4831,6639,2,0,2,0,-2
EUN1_3568243957',3,28,21,1,0,1,0,11,1,338,94,32339,31252,36389,8,31,11,0,0,1,0,8,335,90,27623,27859,31381,0,3,4,4716,10,3393,5008,1,0,0,0,3
EUN1_3567643942',4,32,20,0,0,2,0,13,0,334,94,31254,32224,43441,1,27,17,1,0,2,0,8,355,85,30891,29848,34228,1,-21,9,363,3,2376,9213,-1,0,0,0,5
EUN1_3567624956',1,14,17,0,0,0,0,11,1,316,70,29454,29080,36898,2,32,16,2,0,0,0,3,349,94,28609,30229,38318,1,-33,-24,845,1,-1149,-1420,-2,0,0,0,8
EUN1_3567371555',0,22,16,0,0,0,0,8,0,360,92,29384,31912,37533,5,33,18,1,0,1,0,5,327,88,30511,29535,41598,0,33,4,-1127,-2,2377,-4065,-1,0,-1,0,3
EUN1_3567237210',6,82,14,1,0,0,0,13,0,290,101,27252,28836,29923,1,73,12,0,1,1,0,3,315,81,27929,28624,29375,1,-25,20,-677,2,212,548,1,-1,-1,0,10
EUN1_3560903621',6,28,13,0,0,1,0,8,1,354,126,29230,31609,31124,4,148,14,2,0,0,0,4,332,86,25933,29107,29984,1,22,40,3297,-1,2502,1140,-2,0,1,0,4
EUN1_3560885789',0,62,5,0,1,1,0,13,0,381,94,27917,28435,28164,3,94,25,1,0,2,0,7,340,93,31756,32795,37349,0,41,1,-3839,-20,-4360,-9185,-1,1,-1,0,6
EUN1_3560859886',3,24,13,1,0,1,0,14,0,354,88,28801,29797,31412,3,27,15,1,0,2,0,7,384,92,31396,30053,33787,1,-30,-4,-2595,-2,-256,-2375,0,0,-1,0,7
EUN1_3560844663',7,31,8,2,0,0,0,11,1,310,78,24251,28493,22123,6,29,7,0,1,1,0,0,409,118,27627,31864,27805,0,-99,-40,-3376,1,-3371,-5682,2,-1,-1,0,11
EUN1_3560833197',8,37,11,1,0,0,0,7,0,330,122,26543,30417,31856,3,19,11,0,0,0,0,3,307,70,25641,27161,31097,1,23,52,902,0,3256,759,1,0,0,0,4
EUN1_3560817261',2,18,13,0,0,0,0,11,1,304,90,27545,29780,29419,2,19,18,1,0,2,0,1,361,81,30192,33733,38811,0,-57,9,-2647,-5,-3953,-9392,-1,0,-2,0,10
EUN1_3560797696',4,27,16,2,0,0,0,6,1,314,96,28141,30233,35294,2,398,8,0,0,0,0,5,349,96,26612,29273,31627,1,-35,0,1529,8,960,3667,2,0,0,0,1
EUN1_3560639945',2,27,19,0,0,1,0,5,0,368,87,31230,29942,36600,5,30,12,1,0,0,0,5,343,72,28184,29135,34457,0,25,15,3046,7,807,2143,-1,0,1,0,0
EUN1_3560636113',1,24,20,1,0,3,0,11,0,368,91,35526,33145,36162,6,47,20,1,0,2,0,12,343,72,30132,29648,39072,0,25,19,5394,0,3497,-2910,0,0,1,0,-1
EUN1_3560518172',4,28,18,1,0,1,0,10,1,336,80,31316,28494,37111,0,16,9,1,0,1,0,7,326,100,25393,28320,33094,0,10,-20,5923,9,174,4017,0,0,0,0,3
EUN1_3575913366',6,36,15,1,0,2,0,1,1,351,94,29555,28851,35122,3,106,9,0,0,0,0,9,284,98,23811,27342,29178,1,67,-4,5744,6,1509,5944,1,0,2,0,-8
EUN1_3575882004',7,39,15,2,0,1,0,12,0,325,102,29345,29313,36242,4,32,20,0,0,1,0,4,370,82,32415,31542,36064,1,-45,20,-3070,-5,-2229,178,2,0,0,0,8
EUN1_3575846754',5,169,14,1,0,1,0,7,1,332,119,27723,31860,29901,0,40,16,0,0,0,0,4,350,101,28959,32556,37562,0,-18,18,-1236,-2,-696,-7661,1,0,1,0,3
EUN1_3575792369',3,26,13,0,0,2,0,7,1,350,68,28411,28272,34832,0,34,18,2,0,0,0,8,332,122,29551,29652,36681,1,18,-54,-1140,-5,-1380,-1849,-2,0,2,0,-1
EUN1_3575771772',3,40,15,1,0,2,0,8,1,403,107,29983,32232,36341,2,24,12,1,0,1,0,7,367,112,28427,31764,23297,0,36,-5,1556,3,468,13044,0,0,1,0,1
EUN1_3575755719',4,23,13,1,0,0,0,17,1,338,122,28179,29933,36641,0,21,18,1,0,0,0,3,351,84,29510,33291,32092,0,-13,38,-1331,-5,-3358,4549,0,0,0,0,14
EUN1_3575657639',3,26,16,1,0,1,0,15,1,303,94,28961,29674,37147,2,22,16,1,1,2,0,3,318,106,29628,30620,32117,1,-15,-12,-667,0,-946,5030,0,-1,-1,0,12
EUN1_3575649786',6,25,16,0,0,0,0,10,1,357,99,28806,31166,36800,1,19,8,2,0,0,0,3,328,112,25727,29194,30459,1,29,-13,3079,8,1972,6341,-2,0,0,0,7
EUN1_3575631718',4,29,14,1,0,1,0,11,1,410,80,29924,31987,32353,4,28,7,1,1,1,0,5,330,108,24919,29119,26648,0,80,-28,5005,7,2868,5705,0,-1,0,0,6
EUN1_3575613992',4,23,11,1,0,1,0,12,1,367,104,28155,28979,25932,2,19,15,1,0,1,0,4,351,100,29477,32164,35245,0,16,4,-1322,-4,-3185,-9313,0,0,0,0,8
EUN1_3575598828',1,19,17,0,0,1,0,6,1,374,126,32627,32508,30191,3,28,10,1,0,1,0,9,329,86,25394,27982,30759,1,45,40,7233,7,4526,-568,-1,0,0,0,-3
EUN1_3575475112',1,41,9,2,0,0,0,3,0,371,97,26206,29952,35477,6,41,9,0,0,0,0,5,360,102,25437,30891,29339,1,11,-5,769,0,-939,6138,2,0,0,0,-2
EUN1_3575322150',6,51,10,0,0,0,0,6,0,364,92,25658,29671,31521,4,30,14,2,1,1,0,3,349,120,28823,32610,29882,0,15,-28,-3165,-4,-2939,1639,-2,-1,-1,0,3
EUN1_3575297649',3,30,3,0,0,0,0,11,0,387,114,23905,28272,27319,4,29,13,2,0,2,0,4,392,90,29096,30266,33341,1,-5,24,-5191,-10,-1994,-6022,-2,0,-2,0,7
EUN1_3575273066',4,27,6,1,0,0,0,11,0,365,80,25321,28920,23464,0,25,15,1,0,2,0,3,386,132,30310,32191,26117,0,-21,-52,-4989,-9,-3271,-2653,0,0,-2,0,8
EUN1_3575267122',2,29,19,1,0,0,0,10,1,372,70,30751,30659,34608,2,19,12,1,1,1,0,3,319,106,26513,29122,31260,0,53,-36,4238,7,1537,3348,0,-1,-1,0,7
EUN1_3575244486',6,25,16,0,1,1,0,9,0,379,80,28716,31071,28197,4,26,8,2,0,1,0,3,359,126,25616,29866,26474,1,20,-46,3100,8,1205,1723,-2,1,0,0,6
EUN1_3575235081',1,22,20,1,0,0,0,10,1,381,92,32126,33557,40446,4,25,10,1,0,2,0,6,331,104,27013,28590,38977,0,50,-12,5113,10,4967,1469,0,0,-2,0,4
EUN1_3574978905',9,30,15,1,0,0,0,9,1,334,100,28019,29801,37417,4,27,16,1,0,2,0,7,334,88,30025,31214,36086,0,0,12,-2006,-1,-1413,1331,0,0,-2,0,2
EUN1_3574846860',3,53,16,1,0,0,0,8,0,326,108,28555,30017,35964,1,18,10,1,0,1,0,4,349,79,25979,28253,30866,1,-23,29,2576,6,1764,5098,0,0,-1,0,4
EUN1_3574841128',4,32,3,0,0,0,0,8,0,302,80,20935,27090,19785,6,33,18,2,0,1,0,0,425,88,31637,32580,29896,0,-123,-8,-10702,-15,-5490,-10111,-2,0,-1,0,8
EUN1_3574815820',2,26,6,1,0,0,0,15,0,358,88,23655,28276,23807,8,31,12,0,1,3,0,2,368,92,30095,30716,33543,0,-10,-4,-6440,-6,-2440,-9736,1,-1,-3,0,13
EUN1_3574801666',4,26,21,1,0,2,0,6,1,355,100,32680,32801,39265,6,26,8,1,0,0,0,9,296,67,23477,26168,28655,1,59,33,9203,13,6633,10610,0,0,2,0,-3
EUN1_3574776898',4,24,10,0,0,0,0,9,0,360,88,26614,32267,29300,4,22,16,2,0,1,0,6,382,72,29322,29530,39010,0,-22,16,-2708,-6,2737,-9710,-2,0,-1,0,3
EUN1_3574681693',6,29,12,1,0,0,0,6,0,257,94,26345,25446,28447,2,35,11,1,0,1,0,2,343,98,27733,28029,21380,1,-86,-4,-1388,1,-2583,7067,0,0,-1,0,4
EUN1_3574667468',5,24,13,1,0,3,0,3,1,370,96,30127,31368,32738,2,78,6,0,0,0,0,10,302,84,22740,26828,17716,1,68,12,7387,7,4540,15022,1,0,3,0,-7
EUN1_3574660134',2,22,11,1,0,0,0,9,0,346,80,25133,29423,25980,3,29,18,1,0,1,0,2,361,76,30644,30326,42250,0,-15,4,-5511,-7,-903,-16270,0,0,-1,0,7
EUN1_3574636033',5,31,16,2,0,2,0,8,0,379,97,31041,30829,32147,1,20,9,0,0,0,0,6,346,78,25271,28244,28682,1,33,19,5770,7,2585,3465,2,0,2,0,2
EUN1_3574630850',2,46,13,1,0,0,0,11,0,316,74,26490,29065,30987,1,26,13,0,0,2,0,4,364,90,27968,30860,30321,1,-48,-16,-1478,0,-1795,666,1,0,-2,0,7
EUN1_3574622938',4,27,2,0,0,1,0,15,0,343,98,23855,28782,14059,3,28,13,2,0,4,0,5,357,90,29931,31418,29672,0,-14,8,-6076,-11,-2636,-15613,-2,0,-3,0,10
EUN1_3574621462',2,23,16,2,0,2,0,13,1,357,66,28780,31824,33291,5,137,10,0,0,1,0,4,343,88,27064,28876,36658,1,14,-22,1716,6,2948,-3367,2,0,1,0,9
EUN1_3574462575',2,41,3,1,0,0,0,6,0,403,108,24290,29922,18151,6,39,5,1,0,0,0,4,395,102,24593,29558,23968,1,8,6,-303,-2,364,-5817,0,0,0,0,2
EUN1_3574444118',2,33,21,1,0,1,0,6,1,411,74,32662,32085,35580,4,47,9,0,0,0,0,3,335,82,24194,27521,29855,1,76,-8,8468,12,4564,5725,1,0,1,0,3
EUN1_3574410060',2,23,14,0,0,0,0,9,0,354,76,28033,28803,26775,2,29,15,2,0,2,0,7,370,83,30478,29981,28830,0,-16,-7,-2445,-1,-1178,-2055,-2,0,-2,0,2
EUN1_3574292819',6,26,4,0,0,0,0,7,0,349,82,22739,27773,24514,3,40,10,2,0,1,0,2,377,104,26629,31528,25533,0,-28,-22,-3890,-6,-3755,-1019,-2,0,-1,0,5
EUN1_3574263699',3,23,7,0,0,0,0,8,0,340,88,23837,27171,20598,6,32,15,2,0,0,0,1,343,88,28160,28521,32442,0,-3,0,-4323,-8,-1350,-11844,-2,0,0,0,7
EUN1_3574238842',7,31,17,2,0,0,0,5,0,305,80,27077,28695,35458,1,44,13,0,0,0,0,2,335,83,26863,28758,34275,0,-30,-3,214,4,-63,1183,2,0,0,0,3
EUN1_3572453538',6,36,19,1,0,1,0,9,1,317,90,29967,29788,37190,3,26,11,0,0,0,0,5,298,85,24173,26381,27855,1,19,5,5794,8,3407,9335,1,0,1,0,4
EUN1_3576005379',3,20,8,0,0,0,0,10,0,371,87,26214,29300,28356,6,46,15,1,0,2,0,3,341,84,28538,30990,48196,1,30,3,-2324,-7,-1690,-19840,-1,0,-2,0,7
EUN1_3575979320',2,23,10,0,0,1,0,11,0,359,94,27487,30878,34358,2,35,21,2,0,1,0,2,344,86,29958,31928,36683,0,15,8,-2471,-11,-1050,-2325,-2,0,0,0,9
EUN1_3575930383',2,157,17,2,1,3,0,2,0,380,102,31723,33337,36259,0,23,9,0,0,0,0,8,373,82,25972,28076,24005,1,7,20,5751,8,5261,12254,2,1,3,0,-6
EUN1_3575767316',6,30,5,0,0,0,0,8,0,352,82,23095,28582,20414,4,22,8,2,0,1,0,1,381,88,25726,29075,26466,0,-29,-6,-2631,-3,-493,-6052,-2,0,-1,0,7
EUN1_3575723423',0,101,13,0,0,0,0,12,0,317,94,27463,28002,27850,7,28,16,1,0,2,0,3,333,90,29927,28299,37387,0,-16,4,-2464,-3,-297,-9537,-1,0,-2,0,9
EUN1_3575628069',0,19,24,1,0,0,0,6,1,285,84,29218,28200,39795,4,39,10,0,0,1,0,4,276,83,26093,25667,32383,1,9,1,3125,14,2533,7412,1,0,-1,0,2
EUN1_3575627087',3,24,14,1,0,1,0,8,0,374,82,29277,31395,36541,5,50,14,1,0,0,0,3,311,106,26780,29714,32092,1,63,-24,2497,0,1681,4449,0,0,1,0,5
EUN1_3575605738',4,38,16,0,0,1,0,8,0,360,88,29415,30484,37534,2,21,9,2,0,1,0,7,332,100,24338,27241,25109,1,28,-12,5077,7,3243,12425,-2,0,0,0,1
EUN1_3573597766',7,33,11,1,0,0,0,11,0,347,88,27032,28101,32042,3,27,12,1,0,0,0,7,349,91,27902,28997,32834,1,-2,-3,-870,-1,-896,-792,0,0,0,0,4
EUN1_3573585483',6,45,12,1,0,0,0,11,0,326,94,27035,28996,32229,3,30,10,1,0,2,0,2,341,102,27171,29686,26986,1,-15,-8,-136,2,-690,5243,0,0,-2,0,9
EUN1_3573576360',7,27,9,0,0,0,0,5,0,360,76,25297,28849,27433,4,35,10,2,0,0,0,0,338,100,25631,28619,29904,1,22,-24,-334,-1,230,-2471,-2,0,0,0,5
EUN1_3573447868',3,28,13,2,0,3,0,10,1,386,119,30822,32771,31470,3,29,4,0,0,0,0,7,371,72,23458,28401,15566,1,15,47,7364,9,4370,15904,2,0,3,0,3
EUN1_3573433227',5,54,14,1,0,0,0,11,1,337,82,27120,29737,29719,3,24,5,1,0,0,0,2,370,97,24991,27900,18394,1,-33,-15,2129,9,1837,11325,0,0,0,0,9
EUN1_3573408313',0,27,7,0,0,1,0,12,0,308,96,25121,27404,33711,4,22,17,2,0,2,0,8,353,108,29455,32108,36476,0,-45,-12,-4334,-10,-4704,-2765,-2,0,-1,0,4
EUN1_3573376548',2,24,14,1,0,0,0,12,1,299,94,25914,26187,33039,3,26,18,1,0,1,0,3,378,90,31509,31893,39717,0,-79,4,-5595,-4,-5706,-6678,0,0,-1,0,9
EUN1_3573348000',2,16,12,2,0,0,0,13,0,318,98,26505,30202,45712,1,17,17,0,0,3,0,3,345,80,31520,32729,43481,0,-27,18,-5015,-5,-2527,2231,2,0,-3,0,10
EUN1_3575917996',6,33,20,2,0,0,0,10,1,262,60,26600,25536,39399,2,33,17,0,1,2,0,1,358,83,31065,28961,41267,0,-96,-23,-4465,3,-3425,-1868,2,-1,-2,0,9
EUN1_3575338119',3,28,12,1,0,0,0,4,1,376,70,27026,30861,29136,3,30,4,1,0,1,0,4,363,97,23337,29142,21128,1,13,-27,3689,8,1719,8008,0,0,-1,0,0
EUN1_3575300372',6,138,12,2,0,2,0,11,1,418,96,30585,31560,38995,4,62,10,0,0,1,0,7,295,84,24736,27979,35612,1,123,12,5849,2,3581,3383,2,0,1,0,4
EUN1_3575239804',3,26,11,2,0,2,0,4,1,348,94,26935,31045,24877,0,23,1,0,0,0,0,6,298,74,19845,24860,27458,1,50,20,7090,10,6185,-2581,2,0,2,0,-2
EUN1_3575220913',4,332,14,0,0,0,0,7,0,357,74,28371,30703,37037,2,28,19,1,1,0,0,4,322,69,28792,28842,42341,0,35,5,-421,-5,1861,-5304,-1,-1,0,0,3
EUN1_3574721841',5,31,12,2,0,0,0,11,1,295,68,26438,25951,32556,4,41,21,0,0,1,0,1,325,64,31238,28576,39596,1,-30,4,-4800,-9,-2625,-7040,2,0,-1,0,10
EUN1_3574691598',0,49,16,0,1,1,0,5,0,371,109,29813,32992,30348,4,30,7,1,0,0,0,5,346,94,24875,28836,22793,1,25,15,4938,9,4156,7555,-1,1,1,0,0
EUN1_3574623946',2,21,13,1,0,0,0,8,1,352,99,27417,31041,39221,4,24,10,1,0,0,0,2,328,88,25083,29185,30830,1,24,11,2334,3,1856,8391,0,0,0,0,6
EUN1_3574377578',9,36,10,0,1,0,0,9,1,340,64,25007,30864,27175,3,25,9,2,0,0,0,3,365,86,26027,29465,27279,1,-25,-22,-1020,1,1399,-104,-2,1,0,0,6
EUN1_3574235974',4,29,10,2,0,0,0,4,0,325,96,26325,29237,37939,1,23,12,0,0,0,0,2,338,88,25925,28638,29865,1,-13,8,400,-2,599,8074,2,0,0,0,2
EUN1_3573792317',4,144,12,2,0,2,0,5,1,357,84,28688,29568,30891,0,19,6,0,0,0,0,8,276,80,22775,26151,29875,1,81,4,5913,6,3417,1016,2,0,2,0,-3
EUN1_3571548430',5,216,14,1,0,0,0,5,1,363,96,27767,32091,35813,5,25,11,0,0,0,0,4,375,72,26961,30858,29542,1,-12,24,806,3,1233,6271,1,0,0,0,1
EUN1_3571379571',5,23,9,0,0,0,0,10,0,298,90,25178,28892,29662,2,93,17,1,0,2,0,0,340,86,29816,29482,40597,0,-42,4,-4638,-8,-590,-10935,-1,0,-2,0,10
EUN1_3571330363',0,22,12,0,1,0,0,9,0,338,90,27018,28461,20607,3,17,13,2,0,1,0,3,345,86,28343,30386,30438,0,-7,4,-1325,-1,-1925,-9831,-2,1,-1,0,6
EUN1_3571139336',4,32,12,1,0,0,0,11,0,348,88,27033,30238,32202,2,26,10,1,0,1,0,3,366,108,27703,30046,31178,0,-18,-20,-670,2,192,1024,0,0,-1,0,8
EUN1_3570810144',7,73,17,0,0,0,0,4,0,352,81,29213,30680,37514,2,49,12,2,0,0,0,4,334,77,26524,29208,27445,0,18,4,2689,5,1472,10069,-2,0,0,0,0
EUN1_3570782122',6,29,14,0,0,0,0,7,1,329,92,27599,29004,37808,1,29,16,2,0,0,0,1,325,116,28668,30815,29970,0,4,-24,-1069,-2,-1811,7838,-2,0,0,0,6
EUN1_3570100689',4,29,15,1,1,0,0,8,0,287,94,27860,29165,39764,5,23,19,1,0,1,0,2,286,102,28150,29072,39480,0,1,-8,-290,-4,93,284,0,1,-1,0,6
EUN1_3576126210',2,25,13,1,0,0,0,7,1,385,76,28127,31542,28406,3,25,11,0,0,1,0,4,389,72,26967,29414,28009,0,-4,4,1160,2,2128,397,1,0,-1,0,3
EUN1_3576111290',3,23,21,0,1,1,0,9,1,340,81,31398,32866,39516,5,31,12,2,0,0,0,7,295,114,26433,27290,32506,1,45,-33,4965,9,5576,7010,-2,1,1,0,2
EUN1_3576082393',4,18,24,1,0,1,0,7,1,343,96,31389,32127,41197,8,25,10,1,0,0,0,7,311,96,26029,28146,25617,1,32,0,5360,14,3981,15580,0,0,1,0,0
EUN1_3575997194',3,34,5,0,0,0,0,10,0,316,89,22833,27477,24854,7,31,10,2,0,1,0,2,362,86,26373,30264,29795,0,-46,3,-3540,-5,-2787,-4941,-2,0,-1,0,8
EUN1_3567334974',1,23,19,1,0,1,0,9,0,344,78,30492,30735,40660,5,31,19,0,0,1,0,3,267,76,28775,30044,35597,0,77,2,1717,0,691,5063,1,0,0,0,6
EUN1_3567309328',3,25,13,2,0,0,0,11,0,340,86,26541,31184,31595,2,22,10,0,0,1,0,5,348,90,26872,29509,32491,1,-8,-4,-331,3,1675,-896,2,0,-1,0,6
EUN1_3567282346',3,27,10,1,0,1,0,7,0,375,104,27632,29921,26575,5,23,14,1,1,1,0,4,330,75,28728,28940,24542,1,45,29,-1096,-4,981,2033,0,-1,0,0,3
EUN1_3567138171',3,30,10,0,0,0,0,12,0,299,76,25674,25696,33532,3,31,21,1,0,2,0,0,328,66,31184,27539,38733,0,-29,10,-5510,-11,-1843,-5201,-1,0,-2,0,12
EUN1_3567105850',3,26,23,2,1,2,0,10,0,367,81,33183,33453,39803,3,28,7,0,0,0,0,4,310,88,23256,26058,32558,1,57,-7,9927,16,7395,7245,2,1,2,0,6
EUN1_3567095397',1,31,16,0,0,0,0,12,0,347,96,29433,30242,41476,1,25,11,2,0,1,0,2,391,64,27940,30424,28472,0,-44,32,1493,5,-182,13004,-2,0,-1,0,10
EUN1_3567076404',5,26,18,2,0,2,0,10,0,378,88,30116,31701,37304,1,23,10,0,0,0,0,3,299,72,26590,28873,34599,1,79,16,3526,8,2828,2705,2,0,2,0,7
EUN1_3567057794',4,29,15,1,0,0,0,10,0,285,66,26606,27921,38382,2,25,15,1,0,1,0,1,310,74,28274,27008,47655,0,-25,-8,-1668,0,913,-9273,0,0,-1,0,9
EUN1_3567043673',0,138,10,0,0,0,0,12,0,316,84,25689,28090,35296,4,30,18,1,0,2,0,1,319,91,30753,30432,41400,0,-3,-7,-5064,-8,-2342,-6104,-1,0,-2,0,11
EUN1_3566214203',2,134,11,1,1,0,0,6,0,384,96,28192,30144,31063,5,96,10,1,0,1,0,3,315,68,24342,26022,24698,0,69,28,3850,1,4122,6365,0,1,-1,0,3
EUN1_3564393469',5,26,18,0,0,1,0,6,1,338,94,30383,31319,45588,3,26,10,1,0,0,0,5,321,82,25127,27404,31159,1,17,12,5256,8,3915,14429,-1,0,1,0,1
EUN1_3564365880',4,27,11,1,0,0,0,7,0,346,110,26991,30542,25495,4,30,9,0,0,1,0,4,329,70,26259,28687,24198,1,17,40,732,2,1855,1297,1,0,-1,0,3
EUN1_3564352756',5,24,6,1,0,0,0,14,0,321,84,23537,27137,26294,3,36,17,1,0,4,0,0,330,96,31684,30409,35905,0,-9,-12,-8147,-11,-3272,-9611,0,0,-4,0,14
EUN1_3564264275',1,24,8,0,0,0,0,7,1,314,70,23890,26833,32882,4,26,16,1,0,2,0,1,330,85,28653,29197,37749,0,-16,-15,-4763,-8,-2364,-4867,-1,0,-2,0,6
EUN1_3560374426',1,16,12,0,0,0,0,3,0,365,82,27055,31539,34577,5,26,10,1,0,0,0,1,342,94,25382,28597,32754,1,23,-12,1673,2,2942,1823,-1,0,0,0,2
EUN1_3560221010',5,43,23,0,0,0,0,6,0,328,99,32494,30538,45878,5,25,28,1,0,1,0,5,301,79,34071,30031,60096,0,27,20,-1577,-5,507,-14218,-1,0,-1,0,1
EUN1_3576071528',9,26,7,1,0,1,0,7,0,327,78,25815,26502,25873,2,44,13,0,0,1,0,7,330,82,27951,28755,32239,0,-3,-4,-2136,-6,-2253,-6366,1,0,0,0,0
EUN1_3575552517',2,65,14,0,0,0,0,6,1,371,80,28100,29478,31095,3,24,12,2,0,0,0,8,349,87,26237,30992,34980,0,22,-7,1863,2,-1514,-3885,-2,0,0,0,-2
EUN1_3575524265',3,22,11,0,0,0,0,13,1,311,88,26377,26803,33445,3,26,21,2,0,2,0,3,319,100,31741,30053,39222,0,-8,-12,-5364,-10,-3250,-5777,-2,0,-2,0,10
EUN1_3575409602',3,24,10,0,0,2,0,11,0,346,90,28310,28043,31083,8,48,15,2,0,2,0,6,325,69,27795,28253,29401,0,21,21,515,-5,-210,1682,-2,0,0,0,5
EUN1_3574715102',2,23,15,1,0,0,0,10,0,314,92,26953,28916,35021,6,30,17,0,0,2,0,4,350,96,30720,30094,39000,1,-36,-4,-3767,-2,-1178,-3979,1,0,-2,0,6
EUN1_3575351613',7,88,15,1,0,0,0,6,1,357,86,27105,30677,36863,5,102,3,1,0,0,0,4,304,108,21826,27603,22184,1,53,-22,5279,12,3074,14679,0,0,0,0,2
EUN1_3575317498',2,77,18,0,0,0,0,8,1,344,77,29927,28998,34744,2,61,13,1,0,1,0,8,252,64,25408,24682,28285,1,92,13,4519,5,4316,6459,-1,0,-1,0,0
EUN1_3575292017',1,28,9,2,0,0,0,8,1,354,99,25849,29728,23181,3,30,5,0,0,0,0,2,368,76,23213,29421,20160,1,-14,23,2636,4,307,3021,2,0,0,0,6
EUN1_3574933305',7,30,13,1,0,0,0,12,0,310,74,26063,28935,29469,3,91,10,1,0,2,0,1,368,78,28483,29457,33449,0,-58,-4,-2420,3,-522,-3980,0,0,-2,0,11
EUN1_3574903660',4,28,13,0,0,0,0,7,0,351,76,27707,29048,38365,5,30,18,2,0,0,0,3,360,88,30761,31386,35179,0,-9,-12,-3054,-5,-2338,3186,-2,0,0,0,4
EUN1_3574772539',6,29,20,1,0,0,0,7,1,306,106,30054,31155,41023,1,22,14,1,0,0,0,1,333,82,26553,26648,32728,0,-27,24,3501,6,4507,8295,0,0,0,0,6
EUN1_3574739641',2,28,12,1,0,1,0,4,1,339,83,27205,29858,35703,0,16,9,0,0,0,0,7,313,80,24286,27133,24085,0,26,3,2919,3,2725,11618,1,0,1,0,-3
EUN1_3574727532',2,23,12,1,1,0,0,8,0,404,104,28887,31932,31983,4,23,8,1,0,0,0,4,348,88,25136,28479,25580,1,56,16,3751,4,3453,6403,0,1,0,0,4
EUN1_3574469438',2,24,5,0,0,0,0,8,1,379,84,24986,29010,27261,3,26,8,1,0,0,0,3,371,76,25113,29627,28553,0,8,8,-127,-3,-617,-1292,-1,0,0,0,5
EUN1_3574092456',4,22,11,1,0,1,0,16,1,332,83,26619,28322,26112,3,38,6,1,0,2,0,3,398,92,27382,29355,30194,0,-66,-9,-763,5,-1033,-4082,0,0,-1,0,13
EUN1_3572562688',2,37,12,2,0,1,0,7,1,333,92,28076,30152,34008,5,26,15,0,0,0,0,7,317,84,26381,30083,35518,0,16,8,1695,-3,69,-1510,2,0,1,0,0
EUN1_3572536076',4,26,11,2,0,0,0,8,0,372,95,26975,30834,29284,4,31,12,0,0,0,0,3,371,81,26276,29432,32938,1,1,14,699,-1,1402,-3654,2,0,0,0,5
EUN1_3572524214',1,19,9,0,0,0,0,12,0,312,67,23083,27097,40151,1,27,21,2,0,3,0,0,355,104,32411,33152,51489,0,-43,-37,-9328,-12,-6055,-11338,-2,0,-3,0,12
EUN1_3572506263',6,37,14,1,1,3,0,9,0,392,96,30076,33398,31656,4,26,4,0,0,1,0,3,319,84,23258,26696,23784,1,73,12,6818,10,6702,7872,1,1,2,0,6
EUN1_3572472026',7,37,14,0,0,2,0,4,1,401,92,29668,32056,37189,7,38,6,1,0,1,0,7,359,91,25545,29260,25147,1,42,1,4123,8,2796,12042,-1,0,1,0,-3
EUN1_3572089438',5,42,18,0,0,2,0,10,1,334,90,29927,28892,34835,0,21,12,1,0,1,0,5,346,79,25974,29384,26148,0,-12,11,3953,6,-492,8687,-1,0,1,0,5
EUN1_3571425994',7,101,18,0,0,2,0,5,1,332,104,32517,32860,38740,1,27,18,1,0,1,0,11,303,80,29480,31412,36675,1,29,24,3037,0,1448,2065,-1,0,1,0,-6
EUN1_3571406986',6,31,10,0,0,1,0,6,1,350,64,26025,27865,29232,7,137,13,2,1,0,0,4,355,94,26834,31331,33376,1,-5,-30,-809,-3,-3466,-4144,-2,-1,1,0,2
EUN1_3575846539',7,58,11,0,0,1,0,6,0,364,64,26258,28758,31531,2,140,15,1,0,0,0,3,295,79,26396,28599,30935,0,69,-15,-138,-4,159,596,-1,0,1,0,3
EUN1_3575833278',3,147,17,0,0,1,0,3,0,344,88,29234,30388,30346,2,25,4,2,0,1,0,8,342,88,22056,27158,23031,1,2,0,7178,13,3230,7315,-2,0,0,0,-5
EUN1_3574251367',6,65,24,1,0,2,0,7,1,351,108,33632,33929,44521,3,74,7,0,0,0,0,9,349,80,25239,27616,29127,1,2,28,8393,17,6313,15394,1,0,2,0,-2
EUN1_3573730917',3,27,15,0,0,0,0,11,0,340,86,27544,28577,31179,4,27,13,1,0,2,0,5,330,70,29567,28223,29274,0,10,16,-2023,2,354,1905,-1,0,-2,0,6
EUN1_3573196556',4,38,12,1,0,0,0,10,0,387,82,27540,30193,34943,2,29,13,1,0,2,0,2,385,86,28381,31529,35402,0,2,-4,-841,-1,-1336,-459,0,0,-2,0,8
EUN1_3573187116',5,55,18,0,0,1,0,9,1,365,86,31645,30531,31800,3,31,13,2,1,1,0,7,379,88,28990,30512,32270,0,-14,-2,2655,5,19,-470,-2,-1,0,0,2
EUN1_3573155929',1,24,12,0,0,2,0,7,0,353,91,30021,29060,36647,10,32,16,2,1,1,0,6,289,104,27788,28722,28806,0,64,-13,2233,-4,338,7841,-2,-1,1,0,1
EUN1_3573137630',6,30,17,0,0,2,0,8,0,348,100,30471,29241,35030,1,23,8,2,0,1,0,9,304,87,25077,25347,26508,1,44,13,5394,9,3894,8522,-2,0,1,0,-1
EUN1_3573114756',3,17,15,0,0,1,0,9,0,319,102,28517,31108,39388,1,347,18,2,0,1,0,6,352,70,28643,29697,39096,0,-33,32,-126,-3,1411,292,-2,0,0,0,3
EUN1_3573102144',5,28,13,0,0,0,0,10,1,337,84,27060,31326,33179,2,17,10,2,0,1,0,2,300,63,25148,28980,29821,0,37,21,1912,3,2346,3358,-2,0,-1,0,8
EUN1_3572804887',5,61,13,2,0,0,0,11,0,322,79,27129,28630,27820,5,63,16,0,0,1,0,2,370,104,30005,32265,35879,1,-48,-25,-2876,-3,-3635,-8059,2,0,-1,0,9
EUN1_3572775853',2,51,9,0,0,1,0,3,1,382,96,26984,28443,22901,1,19,7,1,0,0,0,6,396,88,24962,30095,18404,1,-14,8,2022,2,-1652,4497,-1,0,1,0,-3
EUN1_3572743937',6,40,14,2,0,3,0,11,0,389,102,31676,30962,39655,1,38,20,0,0,0,0,10,316,78,29808,30485,43463,1,73,24,1868,-6,477,-3808,2,0,3,0,1
EUN1_3572716920',4,29,17,0,0,2,0,3,0,356,88,30001,30396,32976,3,25,12,1,0,1,0,11,334,88,27496,28189,35056,0,22,0,2505,5,2207,-2080,-1,0,1,0,-8
EUN1_3572532047',5,41,19,2,0,0,0,8,1,343,95,31240,32751,41278,2,20,4,0,0,2,0,6,339,87,22956,28836,28693,1,4,8,8284,15,3915,12585,2,0,-2,0,2
EUN1_3572492813',2,31,11,0,0,0,0,13,1,351,76,26024,28407,29613,4,28,16,1,0,0,0,2,363,92,29559,31272,35636,0,-12,-16,-3535,-5,-2865,-6023,-1,0,0,0,11
EUN1_3572115959',1,27,12,1,0,0,0,9,1,373,67,27188,28440,29024,2,34,16,0,0,1,0,2,380,87,29503,30796,35526,0,-7,-20,-2315,-4,-2356,-6502,1,0,-1,0,7
EUN1_3572088785',2,22,16,1,0,0,0,5,1,346,84,27920,30547,35547,5,35,17,1,0,0,0,2,331,78,28589,29321,40346,0,15,6,-669,-1,1226,-4799,0,0,0,0,3
EUN1_3572067489',3,24,12,0,0,0,0,4,1,360,82,26802,29922,35709,3,27,9,1,0,0,0,0,375,76,24722,27893,35228,0,-15,6,2080,3,2029,481,-1,0,0,0,4
EUN1_3576084324',6,45,14,1,1,0,0,12,1,332,80,27506,30491,32773,3,28,15,0,0,1,0,4,344,90,29713,30069,34705,0,-12,-10,-2207,-1,422,-1932,1,1,-1,0,8
EUN1_3576058654',5,101,22,2,0,0,0,10,1,381,107,31483,33479,46474,4,28,6,0,0,2,0,3,351,88,24761,26717,30257,1,30,19,6722,16,6762,16217,2,0,-2,0,7
EUN1_3576034578',1,13,9,0,0,0,0,15,1,320,84,24636,28083,21850,3,28,14,2,1,3,0,1,371,98,30383,31574,35853,0,-51,-14,-5747,-5,-3491,-14003,-2,-1,-3,0,14
EUN1_3575810193',1,25,19,0,0,0,0,6,1,309,78,29855,28039,42793,5,28,19,1,0,0,0,4,268,90,29602,28845,42618,1,41,-12,253,0,-806,175,-1,0,0,0,2
EUN1_3575781556',1,49,27,1,1,3,0,12,1,310,92,34841,31281,43483,2,27,15,0,0,1,0,11,279,63,27225,27219,34921,0,31,29,7616,12,4062,8562,1,1,2,0,1
EUN1_3575606174',4,32,16,1,0,0,0,9,1,349,80,27516,29664,32461,4,31,13,1,0,0,0,4,309,92,26859,29750,33466,1,40,-12,657,3,-86,-1005,0,0,0,0,5
EUN1_3575580308',4,40,18,1,0,0,0,11,0,314,92,27583,31031,41357,5,144,17,1,0,1,0,3,362,78,28927,32448,44734,0,-48,14,-1344,1,-1417,-3377,0,0,-1,0,8
EUN1_3575535563',2,24,4,1,0,0,0,16,0,329,90,23283,26701,26094,8,31,24,1,0,3,0,5,382,78,32944,32664,36518,0,-53,12,-9661,-20,-5963,-10424,0,0,-3,0,11
EUN1_3575514665',1,23,11,0,0,1,0,14,0,267,83,26337,28518,33293,6,28,30,1,1,3,0,4,391,75,37558,32857,50426,0,-124,8,-11221,-19,-4339,-17133,-1,-1,-2,0,10
EUN1_3575492804',0,21,23,2,1,2,0,7,0,345,70,32140,31025,44334,2,26,12,0,0,2,0,9,274,85,25757,26925,28420,1,71,-15,6383,11,4100,15914,2,1,0,0,-2
EUN1_3575080414',0,17,8,0,0,0,0,15,0,282,56,23198,24968,26299,0,25,20,2,0,2,0,3,348,98,31073,31568,38338,0,-66,-42,-7875,-12,-6600,-12039,-2,0,-2,0,12
EUN1_3574438530',2,20,11,1,0,0,0,12,0,340,86,27182,29300,36054,3,26,16,0,0,2,0,3,333,86,29470,31453,41004,1,7,0,-2288,-5,-2153,-4950,1,0,-2,0,9
EUN1_3574409011',3,25,8,0,0,0,0,13,0,321,82,25263,25912,28704,2,198,20,2,0,1,0,1,373,98,32341,33787,38176,0,-52,-16,-7078,-12,-7875,-9472,-2,0,-1,0,12
EUN1_3574386666',3,32,12,1,0,1,0,5,0,365,68,28260,28990,34109,4,261,12,0,0,0,0,0,337,68,25877,28541,29992,0,28,0,2383,0,449,4117,1,0,1,0,5
EUN1_3574364952',2,21,12,0,0,1,0,7,1,354,83,28705,30060,35052,1,26,19,2,0,1,0,5,344,80,29082,30361,37343,0,10,3,-377,-7,-301,-2291,-2,0,0,0,2
EUN1_3573928083',5,25,12,2,1,1,0,8,0,359,89,27214,31498,30676,3,23,9,0,0,1,0,2,346,102,27159,30373,32315,1,13,-13,55,3,1125,-1639,2,1,0,0,6
EUN1_3573902263',1,62,10,0,0,1,0,8,1,350,84,26014,28705,23864,3,23,8,2,1,1,0,3,358,96,26763,30437,26331,0,-8,-12,-749,2,-1732,-2467,-2,-1,0,0,5
EUN1_3574860443',0,366,19,0,0,2,0,9,1,345,96,30905,31972,44433,0,22,17,1,0,1,0,7,337,84,29709,30689,36575,0,8,12,1196,2,1283,7858,-1,0,1,0,2
EUN1_3574836980',4,19,18,0,0,0,0,14,0,305,94,27120,29811,37675,4,25,19,1,0,3,0,5,366,66,32847,31702,45808,0,-61,28,-5727,-1,-1891,-8133,-1,0,-3,0,9
EUN1_3574796172',2,25,18,2,0,1,0,13,1,332,88,29914,29275,33951,1,48,18,0,0,1,0,5,333,70,29903,28337,31650,1,-1,18,11,0,938,2301,2,0,0,0,8
EUN1_3574764037',2,34,14,1,0,0,0,4,0,329,78,26423,30008,35285,3,21,8,0,0,0,0,3,364,70,25114,27802,33693,1,-35,8,1309,6,2206,1592,1,0,0,0,1
EUN1_3574759277',1,22,14,1,0,3,0,7,0,379,90,31391,33070,30444,0,18,7,1,0,0,0,10,306,90,24270,28053,22216,1,73,0,7121,7,5017,8228,0,0,3,0,-3
EUN1_3573922874',4,20,11,0,0,0,0,7,0,312,50,23722,26506,29188,2,49,18,2,0,0,0,4,331,93,28986,29131,36220,0,-19,-43,-5264,-7,-2625,-7032,-2,0,0,0,3
EUN1_3575006942',4,24,13,1,0,0,0,6,0,321,80,25877,28187,38031,0,76,15,1,0,1,0,3,336,68,26392,28405,29174,0,-15,12,-515,-2,-218,8857,0,0,-1,0,3
EUN1_3574983578',4,31,10,0,0,0,0,8,0,361,82,26040,27970,31083,8,27,17,1,0,0,0,5,353,86,28423,30685,31670,0,8,-4,-2383,-7,-2715,-587,-1,0,0,0,3
EUN1_3574964244',3,36,3,0,0,0,0,9,0,318,87,21261,27396,25662,2,25,7,1,1,2,0,0,352,124,27266,31912,30995,0,-34,-37,-6005,-4,-4516,-5333,-1,-1,-2,0,9
EUN1_3574935458',5,43,11,1,0,0,0,4,0,324,92,25861,28052,34699,5,100,18,1,0,0,0,4,340,64,28790,28813,42234,0,-16,28,-2929,-7,-761,-7535,0,0,0,0,0
EUN1_3574910182',4,43,14,0,0,0,0,6,0,313,104,28161,31033,34401,2,17,12,1,0,0,0,5,360,84,26763,30337,29568,1,-47,20,1398,2,696,4833,-1,0,0,0,1
EUN1_3574818140',3,26,3,0,0,0,0,12,0,306,96,21938,27099,21797,2,35,12,1,0,2,0,1,382,99,28782,31949,31748,0,-76,-3,-6844,-9,-4850,-9951,-1,0,-2,0,11
EUN1_3574774772',5,40,13,1,1,1,0,5,1,327,98,27771,28603,34031,2,25,9,1,0,0,0,4,331,70,24196,26562,25506,1,-4,28,3575,4,2041,8525,0,1,1,0,1
EUN1_3574765682',3,24,3,1,0,0,0,11,0,333,90,21180,26522,21109,1,20,16,1,1,5,0,0,348,110,33053,33233,40150,0,-15,-20,-11873,-13,-6711,-19041,0,-1,-5,0,11
EUN1_3574744982',1,22,9,0,0,0,0,14,0,286,66,23825,26232,24145,5,23,15,2,0,3,0,0,386,110,31994,31526,42039,0,-100,-44,-8169,-6,-5294,-17894,-2,0,-3,0,14
EUN1_3575890693',6,28,13,2,1,1,0,11,1,364,86,29233,30806,31952,2,24,9,0,0,1,0,5,361,78,26864,29161,32554,1,3,8,2369,4,1645,-602,2,1,0,0,6
EUN1_3575883428',7,39,5,0,0,0,0,12,1,275,84,21839,23266,24625,2,22,20,1,0,1,0,0,314,80,28760,29309,35214,0,-39,4,-6921,-15,-6043,-10589,-1,0,-1,0,12
EUN1_3575864361',3,142,10,0,0,0,0,9,0,329,86,26219,29928,30348,1,24,15,2,0,1,0,0,393,98,29535,31713,32420,1,-64,-12,-3316,-5,-1785,-2072,-2,0,-1,0,9
EUN1_3575839524',8,39,7,1,0,0,0,13,0,334,87,24440,28333,19959,2,25,9,1,0,1,0,0,378,99,27201,29093,23619,0,-44,-12,-2761,-2,-760,-3660,0,0,-1,0,13
EUN1_3574893927',1,20,7,1,0,0,0,8,0,325,100,23801,28152,19842,1,23,10,1,0,1,0,1,386,79,26590,29635,21336,0,-61,21,-2789,-3,-1483,-1494,0,0,-1,0,7
EUN1_3574883295',3,42,21,1,0,1,0,6,1,329,78,31970,31775,39923,2,24,13,0,0,1,0,7,287,80,26602,28575,30640,1,42,-2,5368,8,3200,9283,1,0,0,0,-1
EUN1_3574856342',4,24,12,0,0,1,0,8,0,361,90,28407,30597,29218,3,20,13,2,0,1,0,6,324,103,28176,30746,30543,0,37,-13,231,-1,-149,-1325,-2,0,0,0,2
EUN1_3574801523',5,31,21,1,0,0,0,10,1,305,61,30183,27624,37677,3,24,16,1,0,1,0,5,302,82,27885,28501,38179,1,3,-21,2298,5,-877,-502,0,0,-1,0,5
EUN1_3574779179',4,28,17,0,0,0,0,11,1,265,68,28806,26616,37368,1,29,29,2,1,2,0,2,313,96,31782,30797,46194,0,-48,-28,-2976,-12,-4181,-8826,-2,-1,-2,0,9
EUN1_3574739487',2,26,13,0,0,0,0,5,1,362,68,27190,29475,28688,6,51,7,2,0,0,0,4,347,106,24949,28507,23720,0,15,-38,2241,6,968,4968,-2,0,0,0,1
EUN1_3574725154',0,25,8,1,0,0,0,9,0,304,102,24536,28364,27575,3,24,16,1,0,1,0,3,328,89,27952,30808,36965,1,-24,13,-3416,-8,-2444,-9390,0,0,-1,0,6
EUN1_3574698816',0,21,9,0,0,0,0,11,0,353,108,26626,29220,28779,2,25,15,2,0,1,0,4,354,96,29473,32101,33736,0,-1,12,-2847,-6,-2881,-4957,-2,0,-1,0,7
EUN1_3574288527',2,21,26,1,0,3,0,11,1,345,77,36304,31737,41931,3,95,18,0,0,0,0,7,275,78,29417,27698,35388,1,70,-1,6887,8,4039,6543,1,0,3,0,4
EUN1_3574268417',1,26,16,1,0,0,0,11,0,329,78,27802,28561,27210,1,22,10,0,0,1,0,2,320,72,26558,25933,30869,1,9,6,1244,6,2628,-3659,1,0,-1,0,9
EUN1_3574251218',4,27,10,2,0,1,0,7,1,352,88,26641,30141,29009,2,18,12,0,0,0,0,4,360,116,27647,31979,29852,1,-8,-28,-1006,-2,-1838,-843,2,0,1,0,3
EUN1_3574181537',5,23,15,1,0,2,0,12,0,378,114,29984,33240,26588,4,26,5,1,0,0,0,4,365,98,24796,28087,20029,1,13,16,5188,10,5153,6559,0,0,2,0,8
EUN1_3574167370',4,24,16,1,0,2,0,15,1,333,88,30414,30716,30702,3,27,12,0,1,2,0,8,372,107,28748,30326,28774,1,-39,-19,1666,4,390,1928,1,-1,0,0,7
EUN1_3574148622',1,37,17,1,1,0,0,6,0,330,116,28455,31493,30927,4,33,9,0,0,0,0,3,330,76,24711,29208,27269,1,0,40,3744,8,2285,3658,1,1,0,0,3
EUN1_3575245993',7,45,21,1,1,1,0,14,1,311,106,31018,31183,38211,2,23,10,1,0,1,0,3,319,86,26822,28236,24394,1,-8,20,4196,11,2947,13817,0,1,0,0,11
EUN1_3575232578',7,41,13,1,0,1,0,8,1,342,90,28108,28519,33171,7,36,8,0,0,0,0,7,341,86,25365,27911,30975,0,1,4,2743,5,608,2196,1,0,1,0,1
EUN1_3575061539',3,23,14,0,0,1,0,10,0,359,84,27965,30520,31085,3,41,15,1,0,1,0,1,340,88,28323,29743,36554,0,19,-4,-358,-1,777,-5469,-1,0,0,0,9
EUN1_3575038926',4,27,14,1,0,0,0,4,1,382,80,27102,29693,35746,5,62,11,1,0,0,0,3,296,92,25352,28496,30235,1,86,-12,1750,3,1197,5511,0,0,0,0,1
EUN1_3570318879',2,19,9,1,0,0,0,9,0,392,65,26964,28171,31766,3,37,14,1,0,1,0,4,342,94,28017,27895,33853,1,50,-29,-1053,-5,276,-2087,0,0,-1,0,5
EUN1_3570288869',3,22,16,1,0,0,0,11,0,320,74,28232,29675,38077,3,35,12,0,0,1,0,2,364,90,28714,29360,31251,1,-44,-16,-482,4,315,6826,1,0,-1,0,9
EUN1_3570261766',5,32,15,1,0,0,0,5,0,336,102,28898,28690,43535,2,55,18,1,0,0,0,7,308,66,28205,27285,34601,0,28,36,693,-3,1405,8934,0,0,0,0,-2
EUN1_3568659652',6,50,12,0,0,0,0,14,1,353,95,28052,30141,26550,3,22,23,1,0,3,0,3,372,67,32489,31518,41974,0,-19,28,-4437,-11,-1377,-15424,-1,0,-3,0,11
EUN1_3568638304',6,53,12,1,0,0,0,7,1,407,88,27702,31930,32454,3,30,8,0,0,1,0,2,351,96,26166,30859,24928,0,56,-8,1536,4,1071,7526,1,0,-1,0,5
EUN1_3568593599',6,32,10,2,0,0,0,8,1,358,92,25802,30313,26550,4,28,6,0,0,0,0,2,372,86,24237,29342,30053,1,-14,6,1565,4,971,-3503,2,0,0,0,6
EUN1_3568566973',3,23,5,0,0,0,0,6,0,362,104,23917,28796,25344,3,22,14,1,0,0,0,0,333,76,26419,29337,36638,0,29,28,-2502,-9,-541,-11294,-1,0,0,0,6
EUN1_3568494490',4,29,19,0,0,1,0,6,1,366,70,31114,28824,41711,7,108,12,2,0,0,0,4,297,74,25002,26075,37531,1,69,-4,6112,7,2749,4180,-2,0,1,0,2
EUN1_3568485248',4,288,24,0,0,1,0,6,0,353,97,31990,32580,41303,5,139,14,0,0,0,0,7,297,70,26234,27127,36718,1,56,27,5756,10,5453,4585,0,0,1,0,-1
EUN1_3576165174',2,32,21,1,0,0,0,14,1,311,55,29046,28608,36724,4,26,12,0,0,1,0,0,329,80,27869,27481,36352,1,-18,-25,1177,9,1127,372,1,0,-1,0,14
EUN1_3576145647',3,25,16,0,0,1,0,8,0,337,83,29438,30530,33269,2,51,12,2,0,0,0,3,352,80,26820,29109,37321,0,-15,3,2618,4,1421,-4052,-2,0,1,0,5
EUN1_3576124763',4,26,11,1,0,0,0,7,1,286,67,24963,25691,30577,3,23,12,1,0,1,0,5,326,105,26415,28658,26522,0,-40,-38,-1452,-1,-2967,4055,0,0,-1,0,2
EUN1_3576096601',5,31,10,1,0,0,0,9,0,327,86,25723,28513,25928,2,25,13,1,0,0,0,3,391,81,27877,30263,29410,0,-64,5,-2154,-3,-1750,-3482,0,0,0,0,6
EUN1_3576068124',1,21,9,1,0,0,0,5,1,330,90,25155,29717,28296,6,74,11,1,0,0,0,1,384,78,25804,28205,25401,1,-54,12,-649,-2,1512,2895,0,0,0,0,4
EUN1_3576032049',4,31,14,2,0,0,0,6,1,355,89,27824,30983,29014,4,33,6,0,0,0,0,7,368,89,25010,28586,34291,1,-13,0,2814,8,2397,-5277,2,0,0,0,-1
EUN1_3576012607',1,22,9,0,0,1,0,7,1,332,116,27020,30574,35554,3,26,9,1,0,0,0,6,355,80,24445,28873,24552,0,-23,36,2575,0,1701,11002,-1,0,1,0,1
EUN1_3575539928',1,23,15,1,0,0,0,6,1,324,81,27150,29333,42981,5,24,15,1,0,0,0,2,315,90,26866,29093,32700,0,9,-9,284,0,240,10281,0,0,0,0,4
EUN1_3575500063',5,28,5,1,0,0,0,9,0,334,76,22017,27533,27473,2,32,15,1,0,2,0,0,402,76,29695,32387,34126,0,-68,0,-7678,-10,-4854,-6653,0,0,-2,0,9
EUN1_3575478220',6,33,9,2,0,1,0,12,0,324,88,25698,28760,21787,7,31,11,0,0,2,0,4,362,84,27921,27967,27916,1,-38,4,-2223,-2,793,-6129,2,0,-1,0,8
EUN1_3574994561',3,22,11,0,0,0,0,13,0,364,78,27267,29947,24740,3,31,12,2,0,1,0,0,389,86,27419,31033,29582,1,-25,-8,-152,-1,-1086,-4842,-2,0,-1,0,13
EUN1_3574525978',2,23,21,2,0,1,0,5,0,363,92,31246,30470,39102,4,40,14,0,0,0,0,4,318,80,27237,28512,35443,0,45,12,4009,7,1958,3659,2,0,1,0,1
EUN1_3574513434',3,25,11,1,0,0,0,10,0,339,88,26874,30804,26035,2,25,15,1,0,2,0,4,406,92,31181,32105,32085,0,-67,-4,-4307,-4,-1301,-6050,0,0,-2,0,6
EUN1_3574417636',4,25,8,1,0,1,0,10,0,349,84,25204,27876,21995,3,23,8,1,0,2,0,2,370,104,26471,29478,24072,0,-21,-20,-1267,0,-1602,-2077,0,0,-1,0,8
EUN1_3574397111',4,30,11,1,0,0,0,5,1,330,97,26433,29677,30441,0,22,10,1,0,0,0,0,384,86,26495,31344,30966,1,-54,11,-62,1,-1667,-525,0,0,0,0,5
EUN1_3574032122',3,48,12,0,1,0,0,4,1,338,88,27830,27778,31695,5,28,14,1,0,0,0,2,358,84,27332,30353,31641,1,-20,4,498,-2,-2575,54,-1,1,0,0,2
EUN1_3576112802',2,19,10,1,0,0,0,10,0,364,90,25788,30529,34935,6,27,11,0,0,0,0,0,324,86,25467,28579,35890,1,40,4,321,-1,1950,-955,1,0,0,0,10
EUN1_3576038456',5,24,16,2,0,1,0,6,1,316,97,31478,28705,40637,3,23,5,0,0,1,0,7,305,79,23306,25965,23159,1,11,18,8172,11,2740,17478,2,0,0,0,-1
EUN1_3576021154',2,26,14,0,0,0,0,8,0,293,70,27455,28639,39759,2,24,14,1,0,0,0,3,338,92,26892,28970,34070,1,-45,-22,563,0,-331,5689,-1,0,0,0,5
EUN1_3566151060',5,36,14,1,0,1,0,4,0,368,98,28725,31327,37635,1,21,9,0,0,1,0,6,328,90,25959,30820,26756,1,40,8,2766,5,507,10879,1,0,0,0,-2
EUN1_3566118421',2,130,15,1,0,0,0,7,1,362,104,29782,31461,37066,3,101,13,1,0,1,0,4,353,75,28758,30046,26623,0,9,29,1024,2,1415,10443,0,0,-1,0,3
EUN1_3565970158',5,31,14,2,0,1,0,8,1,361,82,28950,29570,32549,9,28,12,0,0,0,0,5,364,68,27980,28817,31329,1,-3,14,970,2,753,1220,2,0,1,0,3
EUN1_3565933053',1,46,22,1,1,1,0,8,1,305,76,31258,29078,35645,0,18,12,1,0,0,0,9,346,103,28873,27295,34022,0,-41,-27,2385,10,1783,1623,0,1,1,0,-1
EUN1_3565768119',3,313,14,1,0,0,0,11,0,315,62,25856,29254,34682,3,27,14,1,0,1,0,1,348,86,29110,29638,45895,1,-33,-24,-3254,0,-384,-11213,0,0,-1,0,10
EUN1_3565652309',1,19,15,1,0,1,0,11,0,315,96,29082,28897,30951,2,32,12,1,0,1,0,3,372,63,27450,28449,34041,1,-57,33,1632,3,448,-3090,0,0,0,0,8
EUN1_3565363789',1,21,8,2,0,0,0,5,1,375,104,25606,31513,23447,6,37,4,0,0,0,0,1,358,100,23662,29041,18588,1,17,4,1944,4,2472,4859,2,0,0,0,4
EUN1_3565331631',2,55,9,0,0,0,0,13,0,262,70,23795,25639,24874,4,61,16,2,0,2,0,1,365,90,29768,29971,31705,0,-103,-20,-5973,-7,-4332,-6831,-2,0,-2,0,12
EUN1_3565172886',3,18,12,2,0,0,0,5,0,375,92,26942,30752,29270,5,25,9,0,0,0,0,1,328,80,24470,28956,30266,1,47,12,2472,3,1796,-996,2,0,0,0,4
EUN1_3564952216',2,20,15,0,0,1,0,11,1,330,66,27025,27842,28266,2,32,15,2,0,2,0,2,362,86,32619,29115,39873,0,-32,-20,-5594,0,-1273,-11607,-2,0,-1,0,9
EUN1_3564921136',3,25,18,2,0,2,0,6,1,359,102,32606,31550,36018,1,28,8,0,0,1,0,10,339,81,25839,28140,22052,1,20,21,6767,10,3410,13966,2,0,1,0,-4
EUN1_3574686123',2,17,10,2,0,0,0,11,1,327,104,25460,28144,30580,3,32,15,0,0,1,0,2,350,100,29916,32477,33218,0,-23,4,-4456,-5,-4333,-2638,2,0,-1,0,9
EUN1_3574674168',4,23,17,1,0,0,0,5,1,352,82,29327,31589,36411,4,30,12,1,0,3,0,5,350,102,28873,31019,38717,1,2,-20,454,5,570,-2306,0,0,-3,0,0
EUN1_3567641927',1,20,20,1,0,1,0,10,1,383,108,32777,32318,33333,1,26,11,1,0,0,0,2,379,72,26812,27179,26517,1,4,36,5965,9,5139,6816,0,0,1,0,8
EUN1_3567623022',7,39,12,2,0,0,0,11,0,314,70,26348,25952,32729,7,29,16,0,0,1,0,2,330,82,28687,28186,37917,0,-16,-12,-2339,-4,-2234,-5188,2,0,-1,0,9
EUN1_3567614419',3,22,8,1,0,1,0,13,1,330,90,24477,28908,24186,5,25,19,1,0,3,0,3,419,78,32997,31822,34188,1,-89,12,-8520,-11,-2914,-10002,0,0,-2,0,10
EUN1_3567605073',8,169,13,0,0,2,0,6,1,391,76,30541,31393,33920,9,24,8,2,0,1,0,5,365,88,24893,27878,31032,1,26,-12,5648,5,3515,2888,-2,0,1,0,1
EUN1_3567586820',2,32,13,2,0,0,0,7,1,377,70,27387,30828,37734,2,23,8,0,0,0,0,5,329,80,24806,29224,31413,1,48,-10,2581,5,1604,6321,2,0,0,0,2
EUN1_3567558536',1,30,10,0,0,1,0,3,1,339,46,25702,27516,32704,6,29,17,1,0,0,0,5,323,66,26978,28046,36755,0,16,-20,-1276,-7,-530,-4051,-1,0,1,0,-2
EUN1_3567156911',5,27,8,0,1,0,0,5,0,353,107,25735,30831,26846,2,30,6,1,0,0,0,3,376,97,23793,28354,16875,1,-23,10,1942,2,2477,9971,-1,1,0,0,2
EUN1_3567148162',5,23,13,1,0,0,0,9,0,374,88,28029,29670,29245,2,23,14,1,0,1,0,3,386,88,29062,30840,29299,0,-12,0,-1033,-1,-1170,-54,0,0,-1,0,6
EUN1_3567115429',4,29,15,1,0,0,0,13,1,314,84,26980,28365,29379,3,23,17,0,0,1,0,3,333,84,30090,31447,41592,0,-19,0,-3110,-2,-3082,-12213,1,0,-1,0,10
EUN1_3567092317',4,150,18,1,0,0,0,6,1,326,86,29963,30030,33922,4,20,12,1,0,1,0,4,350,78,26399,26898,33116,0,-24,8,3564,6,3132,806,0,0,-1,0,2
EUN1_3567064337',4,146,12,0,0,1,0,14,0,295,88,26745,27910,38070,5,24,14,1,0,3,0,2,379,84,29702,30118,31639,0,-84,4,-2957,-2,-2208,6431,-1,0,-2,0,12
EUN1_3566530467',5,33,8,2,1,0,0,6,0,340,100,25104,29215,30010,5,25,6,0,0,0,0,2,350,84,24379,28596,25384,1,-10,16,725,2,619,4626,2,1,0,0,4
EUN1_3565475484',5,25,12,1,1,0,0,6,1,356,96,27112,30893,31654,8,38,9,1,0,1,0,3,357,92,25900,30082,31268,1,-1,4,1212,3,811,386,0,1,-1,0,3
EUN1_3565251883',5,29,12,0,0,0,0,9,1,395,74,27578,30946,36325,2,27,12,1,0,1,0,3,343,81,28236,31186,32873,1,52,-7,-658,0,-240,3452,-1,0,-1,0,6
EUN1_3565180160',0,24,13,0,1,0,0,9,1,338,111,29871,32408,32092,2,26,17,1,0,0,0,3,371,80,28684,30567,34829,0,-33,31,1187,-4,1841,-2737,-1,1,0,0,6
EUN1_3574171414',0,21,5,0,0,1,0,14,1,284,78,21631,25890,23793,2,81,15,2,0,2,0,4,300,90,28577,29555,34035,0,-16,-12,-6946,-10,-3665,-10242,-2,0,-1,0,10
EUN1_3574150453',2,60,10,0,0,0,0,14,0,271,107,25182,28289,22971,5,28,14,2,1,2,0,4,338,108,28362,31065,30546,0,-67,-1,-3180,-4,-2776,-7575,-2,-1,-2,0,10
EUN1_3574046767',4,22,14,1,0,1,0,8,0,262,60,24969,27299,36924,6,35,16,1,0,1,0,3,343,90,28034,30047,35561,1,-81,-30,-3065,-2,-2748,1363,0,0,0,0,5
EUN1_3573843899',3,184,6,1,0,0,0,13,0,303,90,23752,26356,26840,4,24,24,1,0,3,0,2,361,80,32814,30221,33611,0,-58,10,-9062,-18,-3865,-6771,0,0,-3,0,11
EUN1_3573389593',6,33,21,2,0,0,0,7,1,324,88,30230,31697,42083,3,21,8,0,0,1,0,3,304,80,24343,27119,27661,1,20,8,5887,13,4578,14422,2,0,-1,0,4
EUN1_3573343670',3,137,15,2,0,3,0,7,0,355,120,30139,30887,35615,4,38,6,0,0,0,0,8,270,82,22864,25096,25720,1,85,38,7275,9,5791,9895,2,0,3,0,-1
EUN1_3573312988',5,27,14,0,0,0,0,7,1,320,84,27258,28133,30293,5,27,16,1,1,1,0,3,350,78,29926,29177,34117,1,-30,6,-2668,-2,-1044,-3824,-1,-1,-1,0,4
EUN1_3573281861',5,70,8,0,0,0,0,7,0,341,90,25778,28113,32136,3,143,15,1,0,2,0,4,336,82,28396,30075,36927,0,5,8,-2618,-7,-1962,-4791,-1,0,-2,0,3
EUN1_3572845406',6,29,21,1,0,1,0,4,1,334,83,31537,30543,34430,3,19,7,0,0,1,0,6,337,79,25928,26835,29664,1,-3,4,5609,14,3708,4766,1,0,0,0,-2
EUN1_3572803816',2,129,13,0,0,0,0,6,1,372,84,28167,30160,35677,7,32,15,1,0,0,0,1,334,92,27857,30186,28456,0,38,-8,310,-2,-26,7221,-1,0,0,0,5
EUN1_3572775217',3,32,16,1,0,2,0,3,1,298,92,27435,30025,37084,1,32,4,1,0,0,0,7,282,76,20434,24979,25316,0,16,16,7001,12,5046,11768,0,0,2,0,-4
EUN1_3572750366',2,151,18,2,0,1,0,9,1,357,118,32300,32459,37281,3,22,9,0,0,0,0,6,322,72,24760,27479,25064,1,35,46,7540,9,4980,12217,2,0,1,0,3
EUN1_3572710978',1,19,10,1,0,0,0,7,0,372,76,26268,28861,27461,4,34,12,0,0,2,0,3,317,82,26894,27167,30837,0,55,-6,-626,-2,1694,-3376,1,0,-2,0,4
EUN1_3572696268',2,54,17,0,0,2,0,7,0,347,84,30450,31490,36230,3,63,15,1,0,0,0,5,328,70,27318,30685,31936,0,19,14,3132,2,805,4294,-1,0,2,0,2
EUN1_3572331228',5,27,18,1,0,1,0,9,0,345,92,28766,30787,33460,5,26,10,1,0,0,0,5,343,87,25991,29089,26890,1,2,5,2775,8,1698,6570,0,0,1,0,4
EUN1_3572295062',1,22,12,1,0,1,0,11,1,342,88,27320,29802,33123,3,131,14,1,0,1,0,4,324,98,27940,29205,37261,0,18,-10,-620,-2,597,-4138,0,0,0,0,7
EUN1_3572282330',1,33,20,1,0,0,0,4,0,355,94,30258,30939,38210,3,25,14,0,0,0,0,5,322,73,27528,29046,32994,1,33,21,2730,6,1893,5216,1,0,0,0,-1
EUN1_3571764791',5,43,18,0,0,1,0,11,1,344,83,29941,32316,35063,3,24,10,1,0,0,0,3,356,100,26594,28966,32269,1,-12,-17,3347,8,3350,2794,-1,0,1,0,8
EUN1_3575188040',6,32,20,2,0,0,0,8,0,343,75,29881,31005,37412,6,36,13,0,0,0,0,7,362,79,27462,27775,24029,1,-19,-4,2419,7,3230,13383,2,0,0,0,1
EUN1_3573148622',3,24,7,2,0,0,0,8,1,341,79,23651,27442,24843,4,27,14,0,0,0,0,1,344,96,27469,30483,35838,0,-3,-17,-3818,-7,-3041,-10995,2,0,0,0,7
EUN1_3570960930',1,38,4,1,0,0,0,6,0,295,96,22262,27786,26776,6,24,10,1,0,0,0,1,361,100,25290,30514,27453,1,-66,-4,-3028,-6,-2728,-677,0,0,0,0,5
EUN1_3570636397',3,285,16,2,0,1,0,14,0,313,88,27870,30486,33951,4,22,10,0,0,1,0,3,298,76,26500,27697,27453,1,15,12,1370,6,2789,6498,2,0,0,0,11
EUN1_3568705489',3,22,11,0,0,0,0,10,0,337,100,26990,29025,28283,7,35,15,2,0,2,0,3,295,88,28744,27174,34229,1,42,12,-1754,-4,1851,-5946,-2,0,-2,0,7
EUN1_3568681960',4,67,21,1,0,2,0,4,1,395,82,32307,35069,43748,2,17,7,0,0,0,0,11,320,93,23288,28977,25999,1,75,-11,9019,14,6092,17749,1,0,2,0,-7
EUN1_3568211379',4,30,9,2,0,1,0,10,1,372,78,27092,30300,29777,2,40,11,0,0,0,0,6,386,94,27965,32272,33885,1,-14,-16,-873,-2,-1972,-4108,2,0,1,0,4
EUN1_3568185778',4,25,17,2,0,3,0,7,1,392,128,34075,34380,41500,4,19,12,0,0,0,0,10,340,87,27008,29790,26155,1,52,41,7067,5,4590,15345,2,0,3,0,-3
EUN1_3567430875',5,27,22,1,0,2,0,12,0,326,92,33110,30212,41382,1,17,16,0,0,2,0,9,347,56,29189,28984,40374,0,-21,36,3921,6,1228,1008,1,0,0,0,3
EUN1_3567114843',4,44,10,0,1,1,0,8,1,357,98,27282,30524,31591,3,25,13,1,0,1,0,5,338,97,28382,30009,31121,1,19,1,-1100,-3,515,470,-1,1,0,0,3
EUN1_3565823927',4,30,10,2,1,2,0,8,0,390,112,29401,33234,31687,4,27,6,0,0,0,0,8,342,71,23293,26809,21980,1,48,41,6108,4,6425,9707,2,1,2,0,0
EUN1_3565231846',2,21,8,0,0,0,0,7,1,365,61,25757,26902,28611,5,26,20,2,0,1,0,2,362,68,30036,31380,38858,0,3,-7,-4279,-12,-4478,-10247,-2,0,-1,0,5
EUN1_3564900791',9,30,17,1,0,0,0,9,1,342,98,30196,32456,40650,2,24,11,1,1,0,0,0,388,98,28419,30051,37492,0,-46,0,1777,6,2405,3158,0,-1,0,0,9
EUN1_3564881747',5,28,11,0,0,0,0,6,1,324,67,25455,26301,25385,4,24,10,2,1,0,0,2,395,92,27550,30410,27566,0,-71,-25,-2095,1,-4109,-2181,-2,-1,0,0,4
EUN1_3564565115',4,37,8,0,1,0,0,9,0,332,92,25016,29220,28994,6,25,4,1,0,0,0,3,329,104,23396,28884,21685,1,3,-12,1620,4,336,7309,-1,1,0,0,6
EUN1_3566660357',3,22,11,1,0,1,0,12,1,327,104,27499,28580,29146,2,27,12,1,0,1,0,2,349,59,27238,29980,32632,1,-22,45,261,-1,-1400,-3486,0,0,0,0,10
EUN1_3566634994',1,42,14,2,0,2,0,10,1,320,88,28501,29516,29430,3,32,10,0,0,0,0,7,324,57,24499,26907,27224,1,-4,31,4002,4,2609,2206,2,0,2,0,3
EUN1_3575266364',7,26,10,0,0,0,0,11,0,326,73,24862,27739,32927,4,28,18,2,0,0,0,1,330,78,28749,30859,37630,0,-4,-5,-3887,-8,-3120,-4703,-2,0,0,0,10
EUN1_3575251409',4,26,6,0,0,0,0,10,1,293,76,22389,26959,23269,3,30,14,2,0,0,0,1,368,88,27771,30593,37162,0,-75,-12,-5382,-8,-3634,-13893,-2,0,0,0,9
EUN1_3575227917',6,20,17,1,0,0,0,10,0,302,86,28310,29935,32527,2,90,14,0,0,0,0,3,287,82,26136,27898,26852,1,15,4,2174,3,2037,5675,1,0,0,0,7
EUN1_3566299104',2,28,10,1,0,0,0,7,1,299,84,24459,28553,20091,3,30,12,1,0,1,0,1,355,80,27076,29735,36582,0,-56,4,-2617,-2,-1182,-16491,0,0,-1,0,6
EUN1_3566178363',3,27,9,0,1,1,0,9,1,370,84,26578,28945,19209,2,25,9,2,0,1,0,3,367,87,27132,29462,26088,0,3,-3,-554,0,-517,-6879,-2,1,0,0,6
EUN1_3566153807',5,25,20,0,0,1,0,10,0,326,77,29878,27339,39398,5,108,24,1,0,1,0,3,347,81,33727,31878,47531,0,-21,-4,-3849,-4,-4539,-8133,-1,0,0,0,7
EUN1_3566118317',7,30,25,2,0,1,0,7,0,344,96,33549,30471,45876,7,31,19,0,0,1,0,10,308,76,29910,27651,41626,0,36,20,3639,6,2820,4250,2,0,0,0,-3
EUN1_3566100563',0,35,10,0,0,0,0,9,0,339,62,25215,28230,27620,8,34,13,1,0,0,0,4,338,93,26949,29526,31675,1,1,-31,-1734,-3,-1296,-4055,-1,0,0,0,5
EUN1_3566090481',6,30,12,0,0,0,0,3,0,352,94,26192,30335,29487,3,25,8,2,0,0,0,2,337,106,25334,29304,26730,1,15,-12,858,4,1031,2757,-2,0,0,0,1
EUN1_3566080389',4,27,12,1,0,3,0,10,1,345,95,29450,30875,29558,2,27,6,0,0,0,0,10,326,84,23487,28689,30317,1,19,11,5963,6,2186,-759,1,0,3,0,0
EUN1_3566060865',8,27,11,0,1,1,0,6,1,373,85,27434,31293,31166,4,23,10,1,0,1,0,5,358,75,26259,28543,28411,1,15,10,1175,1,2750,2755,-1,1,0,0,1
EUN1_3564744196',4,27,16,1,0,0,0,7,1,324,95,28089,30824,32645,4,25,15,1,0,0,0,0,306,78,27808,29209,39710,1,18,17,281,1,1615,-7065,0,0,0,0,7
EUN1_3564720860',5,26,9,1,0,1,0,7,0,403,100,28001,31154,32868,2,28,11,1,0,0,0,2,378,96,26555,30496,29647,1,25,4,1446,-2,658,3221,0,0,1,0,5
EUN1_3563816405',5,45,19,2,0,1,0,10,1,334,78,30595,30000,43992,3,23,13,0,0,0,0,2,336,54,27117,28856,34576,1,-2,24,3478,6,1144,9416,2,0,1,0,8
EUN1_3563036074',8,38,34,2,0,2,0,11,0,341,102,38197,34240,48739,1,21,8,0,0,2,0,10,261,78,25314,24430,32328,1,80,24,12883,26,9810,16411,2,0,0,0,1
EUN1_3563004187',6,32,10,1,0,1,0,7,0,357,82,27493,27981,33855,3,37,11,1,0,1,0,5,364,84,27754,31201,21672,1,-7,-2,-261,-1,-3220,12183,0,0,0,0,2
EUN1_3562689392',5,31,19,1,0,1,0,5,1,337,78,29424,28869,40377,7,20,8,0,1,0,0,8,292,93,24761,27750,28148,1,45,-15,4663,11,1119,12229,1,-1,1,0,-3
EUN1_3562681376',5,32,20,1,1,1,0,6,1,339,107,31677,32017,41252,1,73,5,1,0,1,0,6,337,80,23692,28236,29922,1,2,27,7985,15,3781,11330,0,1,0,0,0
EUN1_3562649394',3,399,15,0,0,0,0,9,0,315,63,28074,29495,31561,5,35,14,2,0,2,0,2,319,110,29391,29394,33330,0,-4,-47,-1317,1,101,-1769,-2,0,-2,0,7
EUN1_3574838392',2,28,15,1,0,2,0,5,1,382,130,32068,32064,25080,3,40,2,0,1,1,0,9,299,101,21396,24954,17858,1,83,29,10672,13,7110,7222,1,-1,1,0,-4
EUN1_3574002273',2,27,18,2,0,0,0,10,1,321,70,29143,29476,35837,2,29,13,0,0,3,0,5,328,82,29210,28587,34253,1,-7,-12,-67,5,889,1584,2,0,-3,0,5
EUN1_3573213304',4,30,15,0,0,0,0,9,1,359,74,27279,30778,30610,7,34,7,1,0,1,0,3,345,94,25681,27415,36713,1,14,-20,1598,8,3363,-6103,-1,0,-1,0,6
EUN1_3573190634',1,137,14,1,0,1,0,8,0,298,99,28345,28812,27497,1,23,8,0,0,0,0,5,390,101,26185,29667,27457,1,-92,-2,2160,6,-855,40,1,0,1,0,3
EUN1_3573082066',6,28,5,1,0,0,0,7,0,397,77,23401,29744,21143,3,27,6,1,1,0,0,0,397,117,26017,31518,28867,1,0,-40,-2616,-1,-1774,-7724,0,-1,0,0,7
EUN1_3576224654',5,49,15,1,0,0,0,12,0,351,59,28200,30463,31615,3,27,15,0,0,1,0,2,364,108,31032,31396,40927,1,-13,-49,-2832,0,-933,-9312,1,0,-1,0,10
EUN1_3576148991',3,25,15,1,0,1,0,6,1,341,74,29323,32280,30380,2,60,7,1,0,2,0,4,308,82,22632,26531,26001,1,33,-8,6691,8,5749,4379,0,0,-1,0,2
EUN1_3576143630',5,29,10,0,0,0,0,6,0,332,84,26549,28573,26034,5,23,12,2,0,0,0,3,331,96,26367,28480,24192,1,1,-12,182,-2,93,1842,-2,0,0,0,3
EUN1_3576122619',2,24,10,1,0,1,0,11,1,330,104,27601,28711,35309,3,19,13,1,0,1,0,8,313,96,27334,29912,31038,1,17,8,267,-3,-1201,4271,0,0,0,0,3
EUN1_3576080535',2,23,16,1,0,0,0,9,1,358,80,27494,30715,36388,5,25,11,0,1,1,0,4,363,76,27741,29501,39033,0,-5,4,-247,5,1214,-2645,1,-1,-1,0,5
EUN1_3576053464',7,29,12,1,0,1,0,8,1,316,80,26986,28519,28777,5,24,16,1,0,1,0,2,339,92,28637,30120,33496,0,-23,-12,-1651,-4,-1601,-4719,0,0,0,0,6
EUN1_3576012482',4,32,3,0,0,1,0,7,0,358,76,23290,27458,23925,5,27,18,2,0,1,0,3,352,92,29914,31286,34422,0,6,-16,-6624,-15,-3828,-10497,-2,0,0,0,4
EUN1_3575984721',7,36,7,0,0,0,0,8,0,329,68,23126,28464,27308,6,31,15,1,0,2,0,1,369,92,29191,31083,36047,0,-40,-24,-6065,-8,-2619,-8739,-1,0,-2,0,7
EUN1_3575957976',3,25,18,1,0,2,0,5,0,369,116,30920,31762,35527,7,26,6,0,0,0,0,7,322,84,23430,25968,24643,1,47,32,7490,12,5794,10884,1,0,2,0,-2
EUN1_3575939188',1,414,13,0,0,0,0,6,0,352,60,27726,30709,36084,3,26,19,2,1,0,0,5,352,95,30173,32216,43624,0,0,-35,-2447,-6,-1507,-7540,-2,-1,0,0,1
EUN1_3575911092',4,18,6,0,0,0,0,9,0,370,80,24730,29686,20052,5,40,11,2,0,1,0,5,358,99,26370,31583,28129,0,12,-19,-1640,-5,-1897,-8077,-2,0,-1,0,4
EUN1_3575886225',2,42,15,0,0,1,0,9,1,299,86,26899,29942,32499,1,24,6,1,0,0,0,1,302,102,23326,27468,25142,0,-3,-16,3573,9,2474,7357,-1,0,1,0,8
EUN1_3575847949',5,20,21,2,0,0,0,10,1,358,100,31578,32611,41446,2,19,16,0,0,1,0,3,308,70,28208,27931,40502,1,50,30,3370,5,4680,944,2,0,-1,0,7
EUN1_3575833206',5,23,11,1,0,0,0,11,0,373,80,26951,28830,26478,2,57,11,1,1,2,0,0,336,108,27393,29278,26182,0,37,-28,-442,0,-448,296,0,-1,-2,0,11
EUN1_3575767877',5,27,19,1,0,2,0,12,1,331,110,31915,31617,38133,4,24,17,1,0,1,0,9,308,99,30712,30735,30524,1,23,11,1203,2,882,7609,0,0,1,0,3
EUN1_3575755609',5,25,12,0,0,0,0,7,1,344,82,26661,29697,31899,10,28,12,1,0,0,0,2,323,70,25593,27516,29444,1,21,12,1068,0,2181,2455,-1,0,0,0,5
EUN1_3575746349',3,20,12,2,0,2,0,7,0,310,72,27193,28513,35598,3,20,10,0,0,0,0,6,260,70,23545,27633,27056,1,50,2,3648,2,880,8542,2,0,2,0,1
EUN1_3575733473',7,37,16,1,0,0,0,8,1,327,76,27504,28507,34150,4,24,16,1,0,0,0,2,317,92,27401,30331,31400,0,10,-16,103,0,-1824,2750,0,0,0,0,6
EUN1_3575716192',6,26,15,0,0,0,0,16,1,359,97,29146,31453,37583,2,41,19,2,0,1,0,5,371,78,32293,33621,37428,0,-12,19,-3147,-4,-2168,155,-2,0,-1,0,11
EUN1_3576136767',1,127,10,1,0,1,0,12,0,289,78,26257,26431,29010,3,26,18,1,0,1,0,6,377,105,32361,32947,41981,1,-88,-27,-6104,-8,-6516,-12971,0,0,0,0,6
EUN1_3568444360',0,31,18,2,0,0,0,8,1,353,90,28956,30299,33726,4,35,7,0,0,0,0,1,351,100,25431,29650,26360,1,2,-10,3525,11,649,7366,2,0,0,0,7
EUN1_3567960890',2,28,7,1,0,0,0,12,1,315,72,23929,25996,22957,3,28,22,0,0,4,0,4,365,100,34204,33351,38613,0,-50,-28,-10275,-15,-7355,-15656,1,0,-4,0,8
EUN1_3567955013',4,28,12,0,0,1,0,8,0,362,92,28207,29740,30832,6,33,13,2,0,0,0,4,300,115,27001,29818,25219,1,62,-23,1206,-1,-78,5613,-2,0,1,0,4
EUN1_3567884809',4,27,8,0,0,0,0,8,1,357,93,26151,28573,27757,3,21,9,1,0,0,0,9,337,95,26389,29561,29311,0,20,-2,-238,-1,-988,-1554,-1,0,0,0,-1
EUN1_3567619394',2,17,18,2,0,0,0,6,1,310,103,30169,31368,43363,4,22,19,0,0,0,0,8,310,76,29635,28690,38274,1,0,27,534,-1,2678,5089,2,0,0,0,-2
EUN1_3567160076',3,28,20,1,0,2,0,10,0,318,104,31383,31811,49231,3,23,6,1,0,0,0,5,295,96,23667,26771,36360,1,23,8,7716,14,5040,12871,0,0,2,0,5
EUN1_3567138665',3,24,10,0,0,0,0,12,0,281,83,24786,26995,27289,3,27,19,2,1,2,0,0,391,98,32628,31494,35375,0,-110,-15,-7842,-9,-4499,-8086,-2,-1,-2,0,12
EUN1_3567125275',4,20,16,2,1,0,0,6,0,305,119,28456,29265,34930,0,16,13,0,0,2,0,6,347,84,29766,29312,30159,0,-42,35,-1310,3,-47,4771,2,1,-2,0,0
EUN1_3566780113',2,50,7,0,0,1,0,11,1,305,75,24963,27187,27855,3,31,23,1,1,0,0,0,367,100,32751,31699,36328,0,-62,-25,-7788,-16,-4512,-8473,-1,-1,1,0,11
EUN1_3566564029',2,26,11,0,0,0,0,4,0,365,68,26846,28110,29590,4,95,18,2,0,0,0,3,327,100,28379,30292,35035,0,38,-32,-1533,-7,-2182,-5445,-2,0,0,0,1
EUN1_3566449213',2,83,12,1,0,0,0,6,0,360,105,27177,32253,31089,4,40,8,1,0,1,0,4,366,106,26772,30134,24574,1,-6,-1,405,4,2119,6515,0,0,-1,0,2
EUN1_3566428483',4,68,6,2,0,1,0,10,1,365,96,26534,28722,25572,1,22,9,0,0,1,0,6,321,95,24389,29673,22975,0,44,1,2145,-3,-951,2597,2,0,0,0,4
EUN1_3566121196',4,26,12,1,0,0,0,12,1,362,94,27552,30523,35390,2,21,8,0,0,2,0,3,376,86,27719,28833,26942,1,-14,8,-167,4,1690,8448,1,0,-2,0,9
EUN1_3566107176',5,151,12,1,0,0,0,10,1,350,78,28112,29979,36363,4,31,18,0,0,1,0,5,339,74,29686,30682,30000,0,11,4,-1574,-6,-703,6363,1,0,-1,0,5
EUN1_3565973967',7,29,10,1,0,0,0,7,0,364,90,26211,31752,37164,4,32,10,0,0,0,0,2,389,73,26625,29419,32048,1,-25,17,-414,0,2333,5116,1,0,0,0,5
EUN1_3576010570',10,27,13,2,0,0,0,9,1,371,90,26546,29903,30074,3,23,5,0,0,0,0,3,338,94,24281,28671,27171,1,33,-4,2265,8,1232,2903,2,0,0,0,6
EUN1_3575978186',0,27,22,0,0,0,0,12,0,336,70,30704,31108,36273,1,24,18,1,0,2,0,2,299,63,28556,27643,39857,0,37,7,2148,4,3465,-3584,-1,0,-2,0,10
EUN1_3575956119',4,31,12,1,0,0,0,11,1,356,84,26552,29572,34400,4,33,13,1,0,1,0,3,360,104,29380,30784,33531,0,-4,-20,-2828,-1,-1212,869,0,0,-1,0,8
EUN1_3575926170',2,126,4,0,0,0,0,6,0,375,69,23590,27918,27903,5,63,11,2,0,1,0,2,365,82,28218,28445,28431,1,10,-13,-4628,-7,-527,-528,-2,0,-1,0,4
EUN1_3575903489',2,20,8,0,0,0,0,10,0,340,80,24619,27234,34925,8,36,17,1,0,0,0,1,316,77,28100,30382,38251,0,24,3,-3481,-9,-3148,-3326,-1,0,0,0,9
EUN1_3575879602',6,67,13,1,0,1,0,13,1,380,82,27660,30545,30076,11,32,9,1,0,1,0,3,382,82,27982,29986,27696,1,-2,0,-322,4,559,2380,0,0,0,0,10
EUN1_3575451512',3,27,4,1,0,0,0,4,1,396,98,24901,29731,18670,2,30,6,0,0,0,0,8,379,73,23060,29007,22002,1,17,25,1841,-2,724,-3332,1,0,0,0,-4
EUN1_3575423852',6,24,9,0,0,0,0,8,0,337,74,24708,28334,31968,4,25,18,2,0,1,0,0,322,93,28956,31335,34901,0,15,-19,-4248,-9,-3001,-2933,-2,0,-1,0,8
EUN1_3575165464',5,93,15,1,0,0,0,10,1,325,80,27788,28338,39465,5,33,21,0,0,2,0,3,307,75,32189,30367,42995,1,18,5,-4401,-6,-2029,-3530,1,0,-2,0,7
EUN1_3575157405',1,22,10,1,0,1,0,18,1,375,102,26935,30468,34557,3,28,16,0,0,2,0,3,292,86,29413,29225,32259,0,83,16,-2478,-6,1243,2298,1,0,-1,0,15
EUN1_3575082311',4,159,15,1,0,0,0,8,0,340,85,27784,30538,34294,4,28,13,0,0,0,0,0,342,98,26638,28111,30499,0,-2,-13,1146,2,2427,3795,1,0,0,0,8
EUN1_3575061494',2,28,13,0,0,0,0,7,0,330,44,24698,26528,29162,5,33,10,1,0,0,0,0,308,89,24649,28345,30824,0,22,-45,49,3,-1817,-1662,-1,0,0,0,7
EUN1_3575038461',5,21,11,2,0,0,0,13,0,357,83,27242,29986,27757,6,24,11,0,0,2,0,3,356,96,27029,32396,35023,0,1,-13,213,0,-2410,-7266,2,0,-2,0,10
EUN1_3575017187',5,33,20,1,0,3,0,7,1,326,75,30940,31150,41063,3,25,12,1,0,0,0,8,236,75,23752,24432,26155,1,90,0,7188,8,6718,14908,0,0,3,0,-1
EUN1_3574992539',1,17,8,0,0,0,0,11,0,271,86,23997,27449,43657,6,22,28,2,0,3,0,1,356,102,33438,35187,49306,0,-85,-16,-9441,-20,-7738,-5649,-2,0,-3,0,10
EUN1_3574950716',6,27,2,1,0,0,0,6,0,378,78,21908,27667,22717,3,60,10,1,0,2,0,5,403,112,28252,32447,30000,0,-25,-34,-6344,-8,-4780,-7283,0,0,-2,0,1
EUN1_3574927308',4,28,9,0,0,0,0,5,0,316,76,24956,25929,25420,3,27,15,2,1,1,0,0,371,92,29026,31014,33167,0,-55,-16,-4070,-6,-5085,-7747,-2,-1,-1,0,5
EUN1_3574908277',2,22,21,1,0,2,0,3,1,431,102,32545,34231,42155,5,32,6,0,0,1,0,11,258,69,22672,27295,23657,1,173,33,9873,15,6936,18498,1,0,1,0,-8
EUN1_3574882287',0,25,18,1,1,0,0,9,0,328,98,29100,32057,32187,5,27,15,1,0,1,0,2,355,98,29186,31538,30436,1,-27,0,-86,3,519,1751,0,1,-1,0,7
EUN1_3575169845',2,26,10,0,0,2,0,5,1,406,121,30203,31837,31606,5,23,3,1,0,1,0,9,309,97,21761,26360,21971,1,97,24,8442,7,5477,9635,-1,0,1,0,-4
EUN1_3575150489',6,32,12,0,0,0,0,13,0,334,82,25786,26897,33355,4,221,17,2,0,2,0,0,377,88,30393,30826,36105,0,-43,-6,-4607,-5,-3929,-2750,-2,0,-2,0,13
EUN1_3575142810',4,25,6,0,0,1,0,16,0,345,83,24680,27150,25886,8,30,19,2,1,3,0,1,386,100,32618,32000,34416,0,-41,-17,-7938,-13,-4850,-8530,-2,-1,-2,0,15
EUN1_3574647647',4,37,5,0,0,0,0,8,0,377,72,23456,28571,24541,6,23,7,1,0,1,0,1,348,116,25913,29678,22418,0,29,-44,-2457,-2,-1107,2123,-1,0,-1,0,7
EUN1_3574637470',3,171,7,1,0,0,0,7,1,339,72,23583,27362,30521,5,24,11,0,0,0,0,0,372,103,27284,30102,38237,0,-33,-31,-3701,-4,-2740,-7716,1,0,0,0,7
EUN1_3574608054',4,20,9,0,1,1,0,13,0,360,97,26281,30348,28675,3,33,5,2,0,1,0,1,342,78,23929,27245,25366,0,18,19,2352,4,3103,3309,-2,1,0,0,12
EUN1_3574131972',1,28,17,1,0,2,0,10,0,350,92,30668,30500,33763,6,23,19,1,0,0,0,4,345,87,30526,31917,40149,0,5,5,142,-2,-1417,-6386,0,0,2,0,6
EUN1_3574122929',2,26,16,2,0,1,0,6,1,355,92,29810,31648,38563,6,72,3,0,0,0,0,7,353,71,22164,26586,34269,1,2,21,7646,13,5062,4294,2,0,1,0,-1
EUN1_3574114762',3,27,17,1,0,0,0,5,1,332,102,30139,31681,34460,2,28,16,1,1,0,0,4,337,79,28559,28844,28049,0,-5,23,1580,1,2837,6411,0,-1,0,0,1
EUN1_3574107267',3,23,16,1,0,0,0,8,1,359,72,28545,29385,31492,4,25,6,1,0,1,0,2,365,98,24959,29086,24654,1,-6,-26,3586,10,299,6838,0,0,-1,0,6
EUN1_3574091473',7,25,12,0,0,1,0,6,1,349,103,27800,28514,34887,3,35,14,2,0,1,0,6,318,60,27686,27706,23246,1,31,43,114,-2,808,11641,-2,0,0,0,0
EUN1_3574088218',3,28,16,2,0,1,0,10,0,347,78,29541,31458,39864,1,24,7,0,0,1,0,6,337,86,24809,28451,31517,1,10,-8,4732,9,3007,8347,2,0,0,0,4
EUN1_3573809136',4,25,16,0,0,0,0,6,1,360,80,28991,30162,36727,3,96,8,2,0,2,0,6,302,92,25285,28993,34333,1,58,-12,3706,8,1169,2394,-2,0,-2,0,0
EUN1_3573789446',7,28,15,1,0,1,0,5,1,391,92,29697,31337,30807,3,28,12,0,1,0,0,2,359,96,27022,30066,31960,1,32,-4,2675,3,1271,-1153,1,-1,1,0,3
EUN1_3575932344',2,22,14,2,1,1,0,6,1,400,81,31385,31353,34332,2,16,8,0,0,1,0,9,323,88,24205,27697,23587,1,77,-7,7180,6,3656,10745,2,1,0,0,-3
EUN1_3575903782',3,55,4,0,0,0,0,4,0,368,97,23934,29154,25691,6,145,16,2,0,0,0,3,358,90,27715,32550,29846,0,10,7,-3781,-12,-3396,-4155,-2,0,0,0,1
EUN1_3575873926',5,31,18,2,0,1,0,4,1,394,84,31705,31218,40121,6,41,13,0,0,0,0,7,336,64,27197,27398,28789,1,58,20,4508,5,3820,11332,2,0,1,0,-3
EUN1_3575168312',5,27,9,1,0,1,0,5,1,349,82,26596,26526,31960,12,33,12,0,0,0,0,7,303,66,25627,27177,28348,0,46,16,969,-3,-651,3612,1,0,1,0,-2
EUN1_3575165297',4,112,19,2,0,1,0,3,1,404,116,32081,32697,38600,2,38,6,0,0,1,0,8,310,56,22479,23998,27139,1,94,60,9602,13,8699,11461,2,0,0,0,-5
EUN1_3575156363',4,66,9,1,0,0,0,6,1,358,70,25578,28874,23224,4,187,7,1,0,0,0,0,346,126,24794,30050,31908,0,12,-56,784,2,-1176,-8684,0,0,0,0,6
EUN1_3575143863',3,22,22,2,0,3,0,8,1,349,86,33302,31154,47258,3,23,13,0,0,0,0,10,313,67,27151,28254,30595,1,36,19,6151,9,2900,16663,2,0,3,0,-2
EUN1_3574696424',3,26,9,2,0,1,0,9,0,340,92,26148,29409,26995,2,29,13,0,0,0,0,5,308,97,26323,29748,26616,0,32,-5,-175,-4,-339,379,2,0,1,0,4
EUN1_3574682452',2,24,21,1,0,2,0,9,1,376,84,32913,30731,41874,4,29,8,1,0,1,0,4,305,72,24396,26023,32022,1,71,12,8517,13,4708,9852,0,0,1,0,5
EUN1_3574671270',1,22,24,1,1,3,0,6,1,331,94,34689,29388,43124,5,25,12,1,0,2,0,9,328,82,28101,28469,30285,1,3,12,6588,12,919,12839,0,1,1,0,-3
EUN1_3573569817',7,31,18,0,0,0,0,9,0,349,72,28800,31253,39918,5,27,17,2,0,1,0,4,311,108,29682,28684,40064,1,38,-36,-882,1,2569,-146,-2,0,-1,0,5
EUN1_3572983144',5,154,12,1,0,2,0,9,1,405,98,29146,31932,33312,1,133,6,1,0,0,0,4,346,74,24290,31091,17801,0,59,24,4856,6,841,15511,0,0,2,0,5
EUN1_3572979413',0,15,17,0,0,0,0,11,0,296,72,27793,26092,42033,3,25,21,1,0,2,0,2,346,84,31481,29804,38088,0,-50,-12,-3688,-4,-3712,3945,-1,0,-2,0,9
EUN1_3572004119',3,25,24,0,0,4,0,8,1,343,86,34576,31338,41936,2,25,12,1,0,0,0,8,328,74,27377,27540,38689,1,15,12,7199,12,3798,3247,-1,0,4,0,0
EUN1_3571971941',2,22,11,0,0,1,0,15,1,344,75,26068,28521,31082,4,22,20,1,1,3,0,4,340,130,33585,33970,40679,1,4,-55,-7517,-9,-5449,-9597,-1,-1,-2,0,11
EUN1_3571449497',3,25,11,1,0,0,0,9,1,357,98,27305,29271,26515,6,30,9,1,0,1,0,2,373,86,26881,28219,32391,0,-16,12,424,2,1052,-5876,0,0,-1,0,7
EUN1_3575545445',4,30,14,0,0,0,0,9,0,344,86,28149,28576,38681,4,26,20,2,1,2,0,2,337,78,30096,30812,41728,0,7,8,-1947,-6,-2236,-3047,-2,-1,-2,0,7
EUN1_3569047871',1,273,14,2,0,2,0,5,1,380,108,29666,32249,36443,1,35,5,0,0,0,0,9,310,77,22623,27222,21613,1,70,31,7043,9,5027,14830,2,0,2,0,-4
EUN1_3568980161',5,47,13,2,0,0,0,4,1,351,84,27498,28217,32479,2,23,12,0,0,0,0,4,321,92,27050,28441,30292,1,30,-8,448,1,-224,2187,2,0,0,0,0
EUN1_3568957680',1,22,14,1,0,1,0,7,0,365,78,28427,31178,37570,5,26,11,1,0,0,0,3,300,77,25035,27303,32491,1,65,1,3392,3,3875,5079,0,0,1,0,4
EUN1_3568563413',0,23,14,0,0,2,0,7,0,364,83,29179,30688,29122,2,26,9,1,0,0,0,5,326,62,24050,27171,30792,1,38,21,5129,5,3517,-1670,-1,0,2,0,2
EUN1_3568539208',4,31,12,0,0,0,0,14,0,325,68,27151,28729,29153,2,25,13,1,0,2,0,4,344,80,27829,28021,32833,1,-19,-12,-678,-1,708,-3680,-1,0,-2,0,10
EUN1_3568502853',3,25,9,1,0,1,0,9,0,363,81,26049,29292,26654,4,34,10,1,0,1,0,2,339,106,25569,28093,23765,1,24,-25,480,-1,1199,2889,0,0,0,0,7
EUN1_3568242664',2,64,12,2,0,0,0,5,1,350,90,27376,30334,28017,4,67,8,0,0,0,0,3,348,72,25230,28063,26845,0,2,18,2146,4,2271,1172,2,0,0,0,2
EUN1_3568055653',3,26,14,1,1,1,0,9,1,347,86,28146,29446,30461,4,29,8,0,0,0,0,6,367,70,24410,29353,24032,1,-20,16,3736,6,93,6429,1,1,1,0,3
EUN1_3568043621',2,20,9,1,0,0,0,14,0,304,65,23855,26536,22604,2,21,19,1,1,4,0,1,359,106,33699,32860,33816,0,-55,-41,-9844,-10,-6324,-11212,0,-1,-4,0,13
EUN1_3567985707',4,125,6,1,1,1,0,4,0,310,88,24657,27341,25251,3,37,15,0,0,0,0,6,328,68,27502,29252,33776,0,-18,20,-2845,-9,-1911,-8525,1,1,1,0,-2
EUN1_3576069590',3,85,13,0,0,0,0,7,1,377,78,28036,30954,32617,9,41,15,2,0,0,0,2,355,90,28578,30097,31172,0,22,-12,-542,-2,857,1445,-2,0,0,0,5
EUN1_3576038900',4,36,14,0,0,0,0,5,0,332,78,26579,27822,31521,4,23,12,2,0,1,0,5,319,75,27143,28013,25803,0,13,3,-564,2,-191,5718,-2,0,-1,0,0
EUN1_3574545385',4,27,14,1,0,0,0,11,1,339,84,26942,28202,28774,1,25,7,0,0,2,0,2,300,94,24217,27622,25102,0,39,-10,2725,7,580,3672,1,0,-2,0,9
EUN1_3574406972',2,35,4,0,0,0,0,10,0,323,69,21942,26602,20429,2,21,14,2,0,2,0,3,367,106,28725,31296,34315,0,-44,-37,-6783,-10,-4694,-13886,-2,0,-2,0,7
EUN1_3574400128',6,31,16,1,0,1,0,7,0,335,80,28091,28212,36351,3,29,9,1,0,0,0,6,308,70,23923,27269,29266,1,27,10,4168,7,943,7085,0,0,1,0,1
EUN1_3574278652',4,47,11,0,1,1,0,4,0,340,89,27323,28963,27659,3,28,8,0,0,0,0,7,328,93,24760,28747,22196,1,12,-4,2563,3,216,5463,0,1,1,0,-3
EUN1_3574160714',2,26,21,2,1,2,0,5,1,396,102,33396,33005,45794,7,36,10,0,0,0,0,8,320,90,26222,26732,28308,1,76,12,7174,11,6273,17486,2,1,2,0,-3
EUN1_3574151318',1,26,16,0,0,0,0,9,1,384,68,28878,30202,38441,2,23,8,1,0,2,0,4,338,104,26680,29097,31133,1,46,-36,2198,8,1105,7308,-1,0,-2,0,5
EUN1_3574120914',3,25,13,0,1,0,0,4,0,348,126,29005,31467,27018,3,40,11,1,0,1,0,4,356,82,27249,29768,23169,0,-8,44,1756,2,1699,3849,-1,1,-1,0,0
EUN1_3573894612',4,28,8,0,0,0,0,7,0,326,92,24049,28671,29036,2,27,12,1,0,1,0,0,340,92,27938,29335,32167,0,-14,0,-3889,-4,-664,-3131,-1,0,-1,0,7
EUN1_3573571642',4,25,12,1,0,0,0,10,0,315,77,26119,27030,36133,2,27,17,1,0,1,0,0,319,84,28818,28914,32793,1,-4,-7,-2699,-5,-1884,3340,0,0,-1,0,10
EUN1_3573562622',0,21,7,0,0,0,0,13,1,323,65,23266,28842,27566,4,22,16,1,1,2,0,1,368,132,31404,34622,35603,0,-45,-67,-8138,-9,-5780,-8037,-1,-1,-2,0,12
EUN1_3573554573',6,43,14,2,1,1,0,8,0,386,78,28758,31442,30168,5,65,4,0,0,1,0,3,395,89,24342,29575,22245,1,-9,-11,4416,10,1867,7923,2,1,0,0,5
EUN1_3573404762',3,26,10,1,0,0,0,10,1,352,75,25297,28587,27720,4,23,16,0,0,1,0,3,348,95,29337,30342,33109,1,4,-20,-4040,-6,-1755,-5389,1,0,-1,0,7
EUN1_3573249130',3,149,6,0,0,0,0,8,0,334,78,24756,27323,20967,4,22,12,1,0,1,0,3,367,66,27077,30396,29957,0,-33,12,-2321,-6,-3073,-8990,-1,0,-1,0,5
EUN1_3573224410',3,32,14,2,0,2,0,9,0,334,96,28204,30872,27775,3,49,12,0,0,1,0,4,388,88,28622,31062,30768,0,-54,8,-418,2,-190,-2993,2,0,1,0,5
EUN1_3573103443',1,18,25,1,0,1,0,5,1,303,83,31681,29582,46693,3,25,17,1,0,0,0,9,306,72,29525,29977,38903,1,-3,11,2156,8,-395,7790,0,0,1,0,-4
EUN1_3573086341',1,23,8,0,0,1,0,12,0,383,70,26788,30463,26706,1,22,13,1,0,1,0,2,361,114,29024,31296,30608,0,22,-44,-2236,-5,-833,-3902,-1,0,0,0,10
EUN1_3572595026',3,30,17,0,0,1,0,6,0,341,71,30334,29514,38416,3,27,11,1,0,0,0,5,300,68,24653,26552,26000,0,41,3,5681,6,2962,12416,-1,0,1,0,1
EUN1_3572579409',2,20,12,0,0,1,0,8,1,313,66,25970,28418,28958,2,19,14,1,0,1,0,4,329,76,28558,28657,37079,0,-16,-10,-2588,-2,-239,-8121,-1,0,0,0,4
EUN1_3571909687',3,30,18,0,1,1,0,5,1,343,96,29873,28841,32116,1,146,8,2,0,0,0,6,330,78,24257,27512,23282,0,13,18,5616,10,1329,8834,-2,1,1,0,-1
EUN1_3571898596',5,29,6,0,0,0,0,8,1,386,82,24443,28409,22796,4,29,10,1,0,0,0,2,386,106,26401,30111,22485,0,0,-24,-1958,-4,-1702,311,-1,0,0,0,6
EUN1_3575969140',3,23,8,1,0,1,0,13,0,372,79,25726,28751,26594,4,43,19,1,0,0,0,1,369,104,29153,32667,37717,0,3,-25,-3427,-11,-3916,-11123,0,0,1,0,12
EUN1_3575847088',5,25,12,1,0,0,0,6,0,350,90,26760,31077,32635,3,27,10,1,0,0,0,1,367,78,26048,29689,30917,1,-17,12,712,2,1388,1718,0,0,0,0,5
EUN1_3575816856',2,47,17,1,0,0,0,9,1,319,82,27939,27780,36479,5,23,21,1,1,1,0,3,313,88,31944,30418,42310,0,6,-6,-4005,-4,-2638,-5831,0,-1,-1,0,6
EUN1_3575805498',4,374,11,0,0,1,0,8,1,355,92,28349,29868,39370,1,34,14,2,0,0,0,7,356,96,28136,29975,37338,1,-1,-4,213,-3,-107,2032,-2,0,1,0,1
EUN1_3575792425',2,24,13,1,0,0,0,5,0,359,68,26383,29985,35840,5,28,14,1,0,0,0,3,323,104,28086,29215,39457,0,36,-36,-1703,-1,770,-3617,0,0,0,0,2
EUN1_3575780085',5,26,19,2,0,2,0,8,0,320,90,31028,28545,40603,4,32,16,0,0,0,0,7,288,101,27470,27582,37730,0,32,-11,3558,3,963,2873,2,0,2,0,1
EUN1_3575755883',3,73,16,2,0,2,0,7,1,396,104,29910,32707,33966,1,20,6,0,0,2,0,4,350,71,24399,27592,23810,1,46,33,5511,10,5115,10156,2,0,0,0,3
EUN1_3575732622',5,28,9,1,0,0,0,11,0,325,90,24730,28708,24931,3,18,14,1,1,0,0,4,267,78,26666,26784,24618,0,58,12,-1936,-5,1924,313,0,-1,0,0,7
EUN1_3575719831',0,22,17,0,0,0,0,7,0,331,102,27958,30937,30823,2,31,11,1,0,1,0,2,363,82,27147,29883,35393,1,-32,20,811,6,1054,-4570,-1,0,-1,0,5
EUN1_3575709047',4,27,15,2,0,3,0,3,1,347,104,30217,32078,30359,3,27,3,0,0,0,0,9,348,76,22468,26400,26173,1,-1,28,7749,12,5678,4186,2,0,3,0,-6
EUN1_3575711415',4,18,22,1,0,0,0,5,1,348,72,29249,31380,37317,5,30,7,0,0,0,0,6,281,76,24175,26087,23601,1,67,-4,5074,15,5293,13716,1,0,0,0,-1
EUN1_3575701552',3,24,9,2,0,1,0,6,1,354,84,26709,28577,27731,3,21,8,0,0,2,0,4,279,80,23751,26429,22203,1,75,4,2958,1,2148,5528,2,0,-1,0,2
EUN1_3575689966',2,30,19,2,0,1,0,8,1,315,104,31256,31615,37202,6,25,17,0,0,1,0,5,329,80,28960,29441,37096,1,-14,24,2296,2,2174,106,2,0,0,0,3
EUN1_3575688760',2,68,18,1,0,0,0,10,1,281,88,29217,28851,43094,3,24,19,1,0,1,0,0,379,72,29166,29391,46885,1,-98,16,51,-1,-540,-3791,0,0,-1,0,10
EUN1_3575681020',0,17,19,1,0,1,0,6,1,328,99,30465,30937,33327,3,25,11,1,0,0,0,5,321,76,24744,26729,29879,1,7,23,5721,8,4208,3448,0,0,1,0,1
EUN1_3575682681',3,28,15,2,0,0,0,7,0,344,112,28592,29889,34296,2,29,7,0,0,0,0,2,368,88,23713,27923,30107,1,-24,24,4879,8,1966,4189,2,0,0,0,5
EUN1_3575671334',0,32,8,0,0,0,0,11,0,296,85,24011,25499,28759,3,50,22,1,0,3,0,3,369,95,33655,32462,36359,0,-73,-10,-9644,-14,-6963,-7600,-1,0,-3,0,8
EUN1_3575662788',4,30,7,0,0,0,0,8,1,312,59,23296,27043,18965,6,30,15,2,0,0,0,1,403,110,29735,31735,38081,0,-91,-51,-6439,-8,-4692,-19116,-2,0,0,0,7
EUN1_3575657557',5,22,18,1,1,0,0,7,1,317,81,29394,29948,38197,2,19,19,1,0,1,0,3,352,94,30532,30681,34393,1,-35,-13,-1138,-1,-733,3804,0,1,-1,0,4
EUN1_3575653484',4,22,13,0,0,1,0,4,0,368,96,28334,31810,34566,1,23,10,1,0,0,0,8,347,68,24829,28026,28408,1,21,28,3505,3,3784,6158,-1,0,1,0,-4
EUN1_3576133881',3,27,11,0,0,1,0,10,0,321,96,27814,28545,36068,2,24,19,2,0,1,0,3,339,86,31376,31388,38182,0,-18,10,-3562,-8,-2843,-2114,-2,0,0,0,7
EUN1_3576118587',3,28,18,1,0,1,0,12,1,278,76,27576,28635,33885,2,21,16,0,0,2,0,3,292,69,28487,26743,40862,0,-14,7,-911,2,1892,-6977,1,0,-1,0,9
EUN1_3575554246',5,27,8,0,0,1,0,9,0,344,62,25224,26370,28229,7,32,9,2,0,0,0,3,302,80,24212,27000,23156,0,42,-18,1012,-1,-630,5073,-2,0,1,0,6
EUN1_3575100803',4,29,8,1,0,0,0,7,0,376,68,24704,28342,25777,3,24,11,1,0,1,0,0,380,93,27386,29587,28562,0,-4,-25,-2682,-3,-1245,-2785,0,0,-1,0,7
EUN1_3575091790',0,28,14,0,0,0,0,15,1,322,94,28606,30002,40663,5,32,18,2,0,2,0,3,315,94,29683,30056,38125,1,7,0,-1077,-4,-54,2538,-2,0,-2,0,12
EUN1_3575081827',3,28,18,2,0,3,0,5,1,318,108,30295,30563,33555,4,25,5,0,0,0,0,8,300,88,22710,27399,21421,1,18,20,7585,13,3164,12134,2,0,3,0,-3
EUN1_3574283207',0,21,23,0,0,3,0,4,1,361,84,34792,30681,43797,2,38,17,1,0,0,0,13,248,68,26649,26818,32946,1,113,16,8143,6,3863,10851,-1,0,3,0,-9
EUN1_3574259687',2,57,11,0,0,0,0,3,0,339,98,25371,29805,33876,2,24,20,1,0,0,0,0,357,102,29876,31816,44742,0,-18,-4,-4505,-9,-2011,-10866,-1,0,0,0,3
EUN1_3574212913',3,24,10,1,0,0,0,8,1,368,103,27702,29116,27638,3,30,6,0,0,1,0,6,293,68,22495,26039,20480,1,75,35,5207,4,3077,7158,1,0,-1,0,2
EUN1_3574200171',2,25,13,2,0,1,0,6,1,315,84,28187,29320,33272,5,26,14,0,0,0,0,7,357,84,27655,30302,34310,0,-42,0,532,-1,-982,-1038,2,0,1,0,-1
EUN1_3574179322',4,27,4,1,0,1,0,7,0,335,90,23957,28569,20039,5,20,13,1,0,1,0,3,360,85,26952,31377,31970,0,-25,5,-2995,-9,-2808,-11931,0,0,0,0,4
EUN1_3574158575',5,27,18,1,0,0,0,10,0,352,102,28529,30806,37439,5,50,7,1,0,0,0,2,349,62,25034,27550,29240,1,3,40,3495,11,3256,8199,0,0,0,0,8
EUN1_3574053033',4,22,21,0,1,0,0,9,1,346,100,30731,31423,38926,1,94,15,2,0,1,0,4,307,60,27771,29769,34416,0,39,40,2960,6,1654,4510,-2,1,-1,0,5
EUN1_3573736794',5,26,12,0,0,0,0,6,1,320,73,25642,26270,33746,6,38,11,2,0,0,0,2,335,80,25005,28981,32517,0,-15,-7,637,1,-2711,1229,-2,0,0,0,4
EUN1_3573702078',3,228,20,1,0,0,0,5,0,298,66,29573,29714,40952,8,24,16,1,0,3,0,8,310,90,28687,28546,42817,1,-12,-24,886,4,1168,-1865,0,0,-3,0,-3
EUN1_3573671562',3,25,14,1,0,1,0,2,0,372,68,28022,29753,38521,4,22,10,0,0,0,0,8,302,84,25126,28080,28798,1,70,-16,2896,4,1673,9723,1,0,1,0,-6
EUN1_3573592577',4,22,12,0,0,0,0,9,0,331,86,25785,28296,25607,2,27,14,2,0,0,0,2,365,55,26538,29618,24001,1,-34,31,-753,-2,-1322,1606,-2,0,0,0,7
EUN1_3573443114',1,20,18,1,0,1,0,7,0,339,70,31535,30485,39562,3,23,11,1,0,0,0,7,321,78,25447,28537,29386,1,18,-8,6088,7,1948,10176,0,0,1,0,0
EUN1_3572926007',2,25,18,1,1,0,0,4,1,330,92,28230,30705,41173,4,20,7,0,0,0,0,4,301,63,22499,26843,27340,1,29,29,5731,11,3862,13833,1,1,0,0,0
EUN1_3573120100',1,26,10,0,0,2,0,5,0,381,98,28572,30317,28101,4,26,10,2,0,0,0,9,285,105,24562,28770,24394,1,96,-7,4010,0,1547,3707,-2,0,2,0,-4
EUN1_3572672722',3,30,15,0,0,0,0,12,0,316,102,26930,30117,38075,4,29,14,1,0,2,0,2,343,78,29404,29967,38264,0,-27,24,-2474,1,150,-189,-1,0,-2,0,10
EUN1_3570603793',2,21,14,2,0,0,0,8,1,327,73,26239,29031,38913,3,23,11,0,0,0,0,1,348,79,26980,30390,37752,0,-21,-6,-741,3,-1359,1161,2,0,0,0,7
EUN1_3570596599',3,20,16,2,0,2,0,8,1,380,98,30809,30770,35702,4,19,6,0,0,0,0,3,330,70,22883,25806,27176,1,50,28,7926,10,4964,8526,2,0,2,0,5
EUN1_3570591573',3,16,13,1,0,1,0,4,1,364,100,28376,32330,25811,7,33,3,1,0,1,0,6,319,104,22121,27358,23148,1,45,-4,6255,10,4972,2663,0,0,0,0,-2
EUN1_3566935151',8,37,14,2,1,0,0,7,1,343,106,28633,31222,32259,6,28,6,0,0,0,0,5,328,102,24624,27579,27231,1,15,4,4009,8,3643,5028,2,1,0,0,2
EUN1_3566903063',4,175,18,1,0,1,0,7,1,367,92,30667,32191,38829,3,76,13,1,0,0,0,2,312,84,25619,28989,26610,0,55,8,5048,5,3202,12219,0,0,1,0,5
EUN1_3566889692',5,26,20,1,1,2,0,12,0,317,80,31797,31062,38274,1,58,15,1,0,1,0,5,363,88,29566,30221,32998,0,-46,-8,2231,5,841,5276,0,1,1,0,7
EUN1_3564739724',3,31,12,0,1,1,0,9,0,368,112,28221,33269,30371,4,25,7,2,0,1,0,2,359,88,25268,28388,23888,1,9,24,2953,5,4881,6483,-2,1,0,0,7
EUN1_3564479155',3,132,22,2,0,0,0,5,1,352,94,31160,32801,50616,2,30,8,0,1,0,0,4,293,97,24668,27537,36621,1,59,-3,6492,14,5264,13995,2,-1,0,0,1
EUN1_3561014866',3,23,17,2,0,1,0,5,1,322,88,28426,30844,37546,3,21,7,0,0,0,0,3,370,94,25599,30338,26752,1,-48,-6,2827,10,506,10794,2,0,1,0,2
EUN1_3560996266',3,28,2,1,0,0,0,7,0,334,103,21811,28491,21837,5,211,8,0,0,0,0,0,356,88,25158,30443,32580,0,-22,15,-3347,-6,-1952,-10743,1,0,0,0,7
EUN1_3560035869',0,21,20,1,0,1,0,11,0,321,74,30518,30908,43721,5,26,15,1,0,1,0,4,342,78,29084,28974,35256,1,-21,-4,1434,5,1934,8465,0,0,0,0,7
EUN1_3560024206',3,28,15,0,1,0,0,11,1,326,95,28229,28795,29354,2,25,12,2,0,1,0,3,354,100,29177,29421,29573,0,-28,-5,-948,3,-626,-219,-2,1,-1,0,8
EUN1_3559854159',1,25,11,0,0,0,0,9,0,329,102,28287,29959,31240,3,28,14,2,0,1,0,3,376,98,28885,31836,31798,0,-47,4,-598,-3,-1877,-558,-2,0,-1,0,6
EUN1_3559823750',5,43,16,2,0,0,0,10,1,332,92,28888,32637,35335,4,25,9,0,0,1,0,1,300,88,25059,29036,33366,1,32,4,3829,7,3601,1969,2,0,-1,0,9
EUN1_3559708245',4,25,16,0,0,2,0,10,1,338,100,30779,31151,34745,1,23,19,2,0,0,0,7,280,70,28530,28899,36465,1,58,30,2249,-3,2252,-1720,-2,0,2,0,3
EUN1_3559691123',2,21,10,0,0,1,0,12,0,304,92,27468,26907,34733,1,22,19,2,1,1,0,8,325,112,30108,31248,37954,0,-21,-20,-2640,-9,-4341,-3221,-2,-1,0,0,4
EUN1_3559667622',4,26,19,1,0,0,0,5,0,348,78,30097,33073,37558,1,24,8,0,0,0,0,5,341,102,24854,28758,25501,1,7,-24,5243,11,4315,12057,1,0,0,0,0
EUN1_3559065200',2,15,18,1,0,0,0,9,0,303,87,28990,30702,36846,5,25,13,1,0,0,0,4,313,88,27979,27834,37515,0,-10,-1,1011,5,2868,-669,0,0,0,0,5
EUN1_3559042718',1,23,8,0,1,1,0,7,0,334,98,26341,29243,29997,3,44,13,1,0,1,0,3,331,96,26224,30126,31268,1,3,2,117,-5,-883,-1271,-1,1,0,0,4
EUN1_3559039384',3,23,19,0,0,1,0,9,0,329,77,30677,27230,33220,0,98,21,2,0,1,0,5,324,102,33192,31575,42407,0,5,-25,-2515,-2,-4345,-9187,-2,0,0,0,4
EUN1_3559015891',8,34,17,1,0,0,0,14,0,296,80,28312,29609,34700,1,30,13,1,0,3,0,2,375,95,29998,29246,37569,0,-79,-15,-1686,4,363,-2869,0,0,-3,0,12
EUN1_3558916015',3,33,21,0,0,1,0,13,1,330,70,32339,30291,39031,1,19,15,2,0,2,0,7,291,102,29295,29276,36539,0,39,-32,3044,6,1015,2492,-2,0,-1,0,6
EUN1_3558909745',1,78,16,1,0,0,0,13,1,307,87,28080,30075,39765,4,191,17,1,0,2,0,1,357,96,32146,32802,42133,1,-50,-9,-4066,-1,-2727,-2368,0,0,-2,0,12
EUN1_3573896629',5,26,9,1,0,0,0,10,0,362,79,25145,28224,25030,7,133,13,0,0,1,0,1,345,92,27663,29832,33998,0,17,-13,-2518,-4,-1608,-8968,1,0,-1,0,9
EUN1_3573873644',2,159,12,1,0,0,0,8,0,321,72,26066,28883,34921,4,32,19,1,0,2,0,2,351,116,32941,30886,35532,0,-30,-44,-6875,-7,-2003,-611,0,0,-2,0,6
EUN1_3573833722',3,20,17,0,0,1,0,6,1,361,75,29850,31923,36777,2,24,8,1,0,0,0,4,316,80,23785,26339,27533,1,45,-5,6065,9,5584,9244,-1,0,1,0,2
EUN1_3573806711',3,64,11,0,0,2,0,17,1,400,116,29698,31598,32392,8,25,16,1,0,2,0,6,360,90,30158,32805,36302,1,40,26,-460,-5,-1207,-3910,-1,0,0,0,11
EUN1_3573791308',0,21,10,1,0,0,0,11,0,340,74,26051,26828,30250,3,23,21,0,0,2,0,3,366,102,32482,33449,42839,0,-26,-28,-6431,-11,-6621,-12589,1,0,-2,0,8
EUN1_3576156678',2,21,17,0,0,1,0,6,1,325,84,29310,30433,36572,3,263,12,2,0,0,0,8,282,84,25393,28223,38125,1,43,0,3917,5,2210,-1553,-2,0,1,0,-2
EUN1_3575582119',2,25,18,0,0,0,0,9,0,306,84,28636,28243,37910,3,36,16,1,0,1,0,1,329,71,28967,26098,33657,1,-23,13,-331,2,2145,4253,-1,0,-1,0,8
EUN1_3574748442',4,24,11,0,0,1,0,11,1,338,104,27866,29716,30479,4,26,21,2,1,0,0,4,300,92,29395,30754,34440,1,38,12,-1529,-10,-1038,-3961,-2,-1,1,0,7
EUN1_3574730767',2,267,12,0,0,1,0,4,1,370,92,28301,31041,26876,1,22,17,1,0,0,0,8,337,52,26818,30290,33349,0,33,40,1483,-5,751,-6473,-1,0,1,0,-4
EUN1_3574585010',3,40,22,1,0,2,0,14,0,308,64,32592,31914,38157,5,22,16,0,0,2,0,6,325,88,29804,29652,33244,1,-17,-24,2788,6,2262,4913,1,0,0,0,8
EUN1_3574588243',1,20,12,0,0,0,0,7,1,317,76,25598,28236,29532,3,27,10,2,0,1,0,4,309,100,26144,29388,28457,1,8,-24,-546,2,-1152,1075,-2,0,-1,0,3
EUN1_3574573613',2,23,7,1,0,0,0,17,0,321,74,23028,26110,25460,4,41,17,0,1,3,0,1,375,97,31363,31700,32729,1,-54,-23,-8335,-10,-5590,-7269,1,-1,-3,0,16
EUN1_3574556018',2,32,9,1,0,0,0,9,0,339,81,26036,29581,35454,2,31,15,1,1,1,0,1,357,96,28603,30415,35143,0,-18,-15,-2567,-6,-834,311,0,-1,-1,0,8
EUN1_3574539875',2,20,10,0,0,0,0,7,0,305,88,23579,27808,28538,4,24,11,0,0,0,0,0,370,100,26596,31136,36322,1,-65,-12,-3017,-1,-3328,-7784,0,0,0,0,7
EUN1_3574524776',3,22,21,0,1,0,0,11,1,343,80,31949,29601,41747,2,99,18,1,0,1,0,3,316,82,28214,29947,31366,0,27,-2,3735,3,-346,10381,-1,1,-1,0,8
EUN1_3574511226',2,28,18,1,0,1,0,8,1,315,66,29181,27867,33532,4,21,20,1,0,0,0,2,286,87,28438,28416,40076,0,29,-21,743,-2,-549,-6544,0,0,1,0,6
EUN1_3574488538',3,31,3,0,0,0,0,14,0,320,69,21924,26098,20045,4,30,16,2,0,3,0,1,369,118,31022,33220,38288,0,-49,-49,-9098,-13,-7122,-18243,-2,0,-3,0,13
EUN1_3574464842',3,27,22,0,1,2,0,11,0,299,106,32402,31771,43648,6,171,11,2,0,1,0,9,329,71,27187,28170,37105,1,-30,35,5215,11,3601,6543,-2,1,1,0,2
EUN1_3574447085',1,25,20,0,0,0,0,6,1,314,74,27870,29161,38215,3,24,8,0,0,0,0,4,280,73,23986,25050,30601,0,34,1,3884,12,4111,7614,0,0,0,0,2
EUN1_3575792838',4,28,14,0,0,0,0,12,0,306,80,25889,28611,30392,4,86,17,2,0,2,0,1,357,96,31075,31071,36935,0,-51,-16,-5186,-3,-2460,-6543,-2,0,-2,0,11
EUN1_3575779041',1,38,7,0,0,0,0,12,1,286,72,23786,26876,26486,1,18,18,2,0,2,0,1,347,100,30478,30868,39956,0,-61,-28,-6692,-11,-3992,-13470,-2,0,-2,0,11
EUN1_3575769367',4,24,6,1,0,0,0,8,0,324,68,23521,28567,22463,5,28,9,1,0,0,0,3,348,100,24653,27682,30413,0,-24,-32,-1132,-3,885,-7950,0,0,0,0,5
EUN1_3575723167',2,40,10,1,1,0,0,6,0,328,96,27375,26624,30180,4,27,8,1,0,1,0,7,272,84,24294,27393,29178,0,56,12,3081,2,-769,1002,0,1,-1,0,-1
EUN1_3574839910',5,41,13,1,0,3,0,2,1,375,74,30165,29797,35759,3,25,6,0,0,0,0,13,313,68,23651,25690,26363,1,62,6,6514,7,4107,9396,1,0,3,0,-11
EUN1_3574679103',5,34,14,1,0,1,0,11,0,302,86,27375,26680,32104,2,23,16,0,0,1,0,6,301,74,29213,26773,40028,1,1,12,-1838,-2,-93,-7924,1,0,0,0,5
EUN1_3574384806',3,32,15,1,0,2,0,11,0,346,76,28489,30239,38417,2,81,16,1,0,1,0,3,328,92,29032,29998,37235,1,18,-16,-543,-1,241,1182,0,0,1,0,8
EUN1_3573565880',2,21,15,1,0,1,0,7,0,362,104,29232,31444,31506,3,20,8,1,0,1,0,7,334,87,25273,29651,24486,0,28,17,3959,7,1793,7020,0,0,0,0,0
EUN1_3573294470',1,24,9,0,0,0,0,13,0,289,83,24989,28646,25142,2,173,21,1,0,2,0,0,355,102,32149,30710,41116,0,-66,-19,-7160,-12,-2064,-15974,-1,0,-2,0,13
EUN1_3573163797',6,32,9,2,0,0,0,12,1,314,76,24882,27797,22803,0,42,13,0,0,3,0,4,398,88,29687,32267,36873,1,-84,-12,-4805,-4,-4470,-14070,2,0,-3,0,8
EUN1_3573155433',5,27,11,2,0,1,0,8,1,408,102,29266,31864,29367,7,27,6,0,0,0,0,5,356,86,24038,28989,18528,1,52,16,5228,5,2875,10839,2,0,1,0,3
EUN1_3573143185',1,23,13,0,0,0,0,8,0,363,96,28603,32536,31106,9,33,10,2,0,3,0,4,363,111,27085,30448,30151,1,0,-15,1518,3,2088,955,-2,0,-3,0,4
EUN1_3573110822',4,42,8,0,0,0,0,7,0,300,85,25106,27088,31037,3,63,19,1,0,1,0,3,362,86,30585,32757,39569,0,-62,-1,-5479,-11,-5669,-8532,-1,0,-1,0,4
EUN1_3571700884',8,28,13,0,0,0,0,13,1,351,63,27769,29260,30261,3,44,11,2,0,1,0,6,304,88,26122,28636,28399,1,47,-25,1647,2,624,1862,-2,0,-1,0,7
EUN1_3571664788',2,24,16,1,0,0,0,17,0,292,63,26453,28732,39946,2,26,14,1,0,3,0,1,344,112,30164,30302,40809,0,-52,-49,-3711,2,-1570,-863,0,0,-3,0,16
EUN1_3573125256',3,30,11,0,0,0,0,9,1,322,94,25956,28589,30937,7,29,17,0,0,1,0,3,388,74,30755,32359,37591,0,-66,20,-4799,-6,-3770,-6654,0,0,-1,0,6
EUN1_3576160107',3,35,8,0,0,0,0,3,0,327,79,23560,27263,27103,4,99,13,1,0,0,0,2,331,80,26116,29250,33326,0,-4,-1,-2556,-5,-1987,-6223,-1,0,0,0,1
EUN1_3576149095',7,29,8,0,1,0,0,7,0,292,76,23872,27995,28282,0,92,12,2,0,1,0,1,343,102,28704,31528,31535,0,-51,-26,-4832,-4,-3533,-3253,-2,1,-1,0,6
EUN1_3576125010',3,25,7,0,1,1,0,10,1,310,89,25206,28603,23247,2,344,13,2,0,2,0,2,390,90,29074,32022,29406,0,-80,-1,-3868,-6,-3419,-6159,-2,1,-1,0,8
EUN1_3576109394',3,26,11,0,0,0,0,12,0,279,68,23861,27058,27561,6,27,8,1,0,1,0,1,330,108,25741,28176,25695,0,-51,-40,-1880,3,-1118,1866,-1,0,-1,0,11
EUN1_3576074736',6,134,11,0,0,0,0,6,0,379,70,26863,30363,30873,2,27,11,1,0,0,0,3,353,88,26544,29478,36548,1,26,-18,319,0,885,-5675,-1,0,0,0,3
EUN1_3576051257',6,24,13,1,0,0,0,6,1,333,72,25932,28747,33777,2,140,9,1,0,0,0,0,296,83,22920,27097,26596,0,37,-11,3012,4,1650,7181,0,0,0,0,6
EUN1_3576018924',0,21,3,0,0,1,0,8,0,311,84,22685,27079,23370,4,96,11,2,0,0,0,1,366,96,25935,30282,27552,0,-55,-12,-3250,-8,-3203,-4182,-2,0,1,0,7
EUN1_3575857941',2,27,14,1,0,1,0,7,0,328,106,28896,29595,30830,3,29,15,0,0,0,0,4,316,62,26016,28498,30164,1,12,44,2880,-1,1097,666,1,0,1,0,3
EUN1_3575846351',1,23,13,1,0,0,0,10,0,356,96,26363,30471,27776,4,184,2,0,0,1,0,1,321,87,22449,27063,27043,1,35,9,3914,11,3408,733,1,0,-1,0,9
EUN1_3575831337',4,30,20,2,0,1,0,9,1,312,85,30711,28462,40339,3,25,19,0,1,1,0,4,289,78,29198,27003,32957,1,23,7,1513,1,1459,7382,2,-1,0,0,5
EUN1_3575794154',6,27,16,1,0,2,0,5,1,375,80,30563,29565,34681,4,95,11,1,0,1,0,9,281,76,24192,27191,31994,1,94,4,6371,5,2374,2687,0,0,1,0,-4
EUN1_3575771847',0,27,17,1,0,0,0,8,0,313,72,27229,28741,37277,5,26,11,1,0,0,0,2,293,85,24099,25891,35115,1,20,-13,3130,6,2850,2162,0,0,0,0,6
EUN1_3575669340',5,30,13,1,1,0,0,5,1,298,86,26567,26364,31533,4,29,16,1,0,0,0,3,328,80,27481,28150,34807,0,-30,6,-914,-3,-1786,-3274,0,1,0,0,2
EUN1_3575657753',4,16,18,1,0,0,0,4,0,343,76,27638,30686,33369,3,17,11,0,0,0,0,4,307,66,25053,27869,31768,1,36,10,2585,7,2817,1601,1,0,0,0,0
EUN1_3575649048',3,48,18,2,0,1,0,7,1,323,96,29748,32631,35012,3,23,7,0,0,0,0,2,319,86,24158,27432,25382,1,4,10,5590,11,5199,9630,2,0,1,0,5
EUN1_3575642798',0,155,9,1,0,0,0,9,0,342,80,24276,30335,24389,4,22,7,0,0,2,0,0,390,108,26484,30361,22766,0,-48,-28,-2208,2,-26,1623,1,0,-2,0,9
EUN1_3575639182',6,26,12,0,0,1,0,12,0,319,100,27672,28096,29864,5,30,11,1,0,2,0,3,357,73,28416,26893,30481,0,-38,27,-744,1,1203,-617,-1,0,-1,0,9
EUN1_3575616649',4,20,15,0,0,0,0,8,0,308,82,27525,27717,34432,1,22,16,1,0,1,0,6,293,72,27537,27703,29409,1,15,10,-12,-1,14,5023,-1,0,-1,0,2
EUN1_3575500571',4,29,9,1,0,0,0,8,0,306,74,23606,26110,19792,5,30,12,1,0,1,0,0,368,97,28134,29392,27403,0,-62,-23,-4528,-3,-3282,-7611,0,0,-1,0,8
EUN1_3574558632',4,31,16,1,0,1,0,11,1,411,88,30850,33406,41963,2,23,12,0,0,0,0,3,363,90,27339,30203,34077,1,48,-2,3511,4,3203,7886,1,0,1,0,8
EUN1_3573923430',5,29,15,0,0,1,0,4,0,383,74,30067,31732,36699,3,72,15,1,0,0,0,5,351,89,26794,31204,36996,0,32,-15,3273,0,528,-297,-1,0,1,0,-1
EUN1_3576091715',5,26,8,0,0,0,0,4,1,314,93,24814,27415,28557,4,30,11,2,0,0,0,0,354,72,26388,30130,36364,0,-40,21,-1574,-3,-2715,-7807,-2,0,0,0,4
EUN1_3575874413',1,22,15,1,0,1,0,8,0,336,72,28345,28893,32938,1,26,13,0,1,2,0,4,367,124,30205,31637,28470,1,-31,-52,-1860,2,-2744,4468,1,-1,-1,0,4
EUN1_3575860122',3,22,7,1,0,0,0,11,0,345,84,24779,29002,23137,4,31,13,1,0,1,0,2,369,88,28333,33427,22405,0,-24,-4,-3554,-6,-4425,732,0,0,-1,0,9
EUN1_3575802711',2,24,20,1,0,1,0,9,0,369,56,29001,30100,34584,1,23,6,0,0,0,0,4,375,70,24046,28145,23156,1,-6,-14,4955,14,1955,11428,1,0,1,0,5
EUN1_3575784747',4,33,20,1,1,1,0,10,0,300,100,31578,29252,41625,0,20,14,0,0,1,0,6,322,76,27097,29792,31574,0,-22,24,4481,6,-540,10051,1,1,0,0,4
EUN1_3575762619',4,25,18,2,0,0,0,9,0,307,69,29464,31211,33912,6,32,17,0,0,1,0,6,357,78,29945,28793,39284,0,-50,-9,-481,1,2418,-5372,2,0,-1,0,3
EUN1_3575448841',5,37,11,1,0,0,0,9,0,283,104,25694,28385,28305,2,23,13,1,0,1,0,2,332,88,26804,28792,35073,0,-49,16,-1110,-2,-407,-6768,0,0,-1,0,7
EUN1_3575274121',4,132,16,0,0,0,0,5,0,299,70,27042,29001,38987,2,38,15,2,0,0,0,6,304,98,27224,30372,35909,0,-5,-28,-182,1,-1371,3078,-2,0,0,0,-1
EUN1_3574786113',4,26,15,1,0,1,0,7,0,340,96,28435,31314,36151,6,28,9,0,0,0,0,5,321,80,24645,28139,26500,1,19,16,3790,6,3175,9651,1,0,1,0,2
EUN1_3574124283',3,38,8,1,0,1,0,6,1,350,84,26456,28933,22626,4,27,6,1,0,0,0,6,342,79,24723,27291,23957,1,8,5,1733,2,1642,-1331,0,0,1,0,0
EUN1_3574007918',6,28,6,0,0,0,0,9,0,299,76,23329,25999,26439,5,29,21,2,0,2,0,5,341,92,30855,31691,34529,1,-42,-16,-7526,-15,-5692,-8090,-2,0,-2,0,4
EUN1_3573679342',1,27,13,1,0,0,0,12,0,312,96,28666,28704,26418,3,27,13,1,0,2,0,6,376,104,28363,31652,27536,0,-64,-8,303,0,-2948,-1118,0,0,-2,0,6
EUN1_3573666273',4,29,9,0,0,0,0,7,0,304,84,23533,28080,26305,4,34,17,2,0,1,0,1,312,84,29141,30321,43721,0,-8,0,-5608,-8,-2241,-17416,-2,0,-1,0,6
EUN1_3573627805',5,24,13,1,1,1,0,10,1,315,64,27358,27235,32161,3,22,19,1,0,3,0,6,344,95,32055,31484,38767,0,-29,-31,-4697,-6,-4249,-6606,0,1,-2,0,4
EUN1_3573412191',1,23,10,2,0,0,0,10,1,303,107,26367,29123,23693,1,31,8,0,1,2,0,3,327,86,26106,27720,23689,1,-24,21,261,2,1403,4,2,-1,-2,0,7
EUN1_3576110737',3,73,9,2,0,0,0,4,0,372,98,26843,30016,38886,3,27,12,0,0,1,0,4,310,70,24977,27637,35201,1,62,28,1866,-3,2379,3685,2,0,-1,0,0
EUN1_3575875719',3,31,16,1,0,1,0,6,1,344,96,30297,32993,34416,8,69,11,1,0,0,0,7,367,76,26136,28342,35371,1,-23,20,4161,5,4651,-955,0,0,1,0,-1
EUN1_3575861477',1,29,17,1,0,3,0,9,0,319,94,30683,30909,35575,4,19,7,0,0,0,0,8,306,82,22572,25781,25606,1,13,12,8111,10,5128,9969,1,0,3,0,1
EUN1_3575847135',2,32,15,1,0,1,0,8,0,306,100,27978,29941,33290,6,31,14,1,0,0,0,6,328,88,27277,30131,28756,0,-22,12,701,1,-190,4534,0,0,1,0,2
EUN1_3575828248',0,23,13,0,0,0,0,7,1,385,68,27660,30092,31485,1,19,19,1,0,1,0,1,361,98,31168,34265,36394,0,24,-30,-3508,-6,-4173,-4909,-1,0,-1,0,6
EUN1_3575814083',5,35,14,2,0,0,0,6,0,363,96,27780,28970,32868,3,23,8,0,0,0,0,2,349,64,24300,27278,26023,1,14,32,3480,6,1692,6845,2,0,0,0,4
EUN1_3575494089',1,29,7,0,0,1,0,6,1,341,105,25804,29934,22053,0,25,10,2,1,0,0,1,347,93,25342,29833,27014,0,-6,12,462,-3,101,-4961,-2,-1,1,0,5
EUN1_3575462504',0,24,7,0,0,0,0,16,0,298,54,24001,27410,24829,3,32,22,1,0,5,0,2,387,97,34407,30898,38754,0,-89,-43,-10406,-15,-3488,-13925,-1,0,-5,0,14
EUN1_3575399612',2,28,9,1,0,0,0,4,0,337,102,25255,30428,26096,5,32,5,1,0,0,0,4,339,101,23440,28623,28676,1,-2,1,1815,4,1805,-2580,0,0,0,0,0
EUN1_3575300890',2,27,10,1,0,0,0,6,1,367,100,27696,30944,30999,6,30,5,1,0,1,0,4,323,91,22608,28299,23191,1,44,9,5088,5,2645,7808,0,0,-1,0,2
EUN1_3575282979',4,80,16,1,0,2,0,8,1,328,92,29485,32336,37092,2,30,10,0,0,1,0,9,314,72,26121,28700,33206,1,14,20,3364,6,3636,3886,1,0,1,0,-1
EUN1_3574671692',3,35,16,0,1,1,0,6,0,346,94,28802,30932,36327,5,28,10,1,0,0,0,5,346,92,26670,28725,26593,1,0,2,2132,6,2207,9734,-1,1,1,0,1
EUN1_3574660465',2,22,12,1,1,0,0,18,0,316,108,25677,28190,24508,2,23,15,1,0,3,0,2,371,103,30506,30674,28816,1,-55,5,-4829,-3,-2484,-4308,0,1,-3,0,16
EUN1_3574636928',5,30,21,2,1,0,0,7,1,334,86,31611,29527,35539,5,27,9,0,0,1,0,3,299,61,25287,26607,30557,1,35,25,6324,12,2920,4982,2,1,-1,0,4
EUN1_3574638191',4,32,9,0,0,1,0,4,0,344,82,26482,28907,29430,3,43,8,1,0,0,0,5,346,102,24318,28455,23411,0,-2,-20,2164,1,452,6019,-1,0,1,0,-1
EUN1_3574623610',0,27,10,0,0,0,0,8,0,344,69,25248,27181,27016,7,26,15,2,0,1,0,2,406,98,30285,32025,29999,1,-62,-29,-5037,-5,-4844,-2983,-2,0,-1,0,6
EUN1_3574149819',4,35,15,1,0,0,0,7,1,324,83,28076,29734,33341,2,29,8,0,0,0,0,1,346,96,25282,29272,29727,1,-22,-13,2794,7,462,3614,1,0,0,0,6
EUN1_3574130053',1,45,15,0,1,0,0,10,1,331,88,28084,30039,33954,2,26,16,2,0,2,0,2,363,91,29953,31738,37787,0,-32,-3,-1869,-1,-1699,-3833,-2,1,-2,0,8
EUN1_3574111406',2,26,17,2,0,0,0,10,1,320,67,27159,29655,37319,3,128,7,0,1,0,0,2,320,92,23851,28661,24758,1,0,-25,3308,10,994,12561,2,-1,0,0,8
EUN1_3574101120',3,32,14,2,1,0,0,11,1,297,92,26487,27715,36513,0,85,10,0,0,1,0,4,339,100,27315,28669,33718,0,-42,-8,-828,4,-954,2795,2,1,-1,0,7
EUN1_3571421083',1,26,14,1,0,1,0,10,1,363,80,27279,28680,36746,3,33,19,1,0,1,0,3,343,103,30936,31685,34333,1,20,-23,-3657,-5,-3005,2413,0,0,0,0,7
EUN1_3566045954',2,28,16,1,1,1,0,7,1,295,79,30108,30370,36233,3,30,15,1,0,1,0,7,324,92,28460,27800,35861,1,-29,-13,1648,1,2570,372,0,1,0,0,0
EUN1_3563324218',2,28,9,0,0,1,0,11,0,349,81,26759,29710,30358,2,227,12,1,0,1,0,7,345,98,28184,30034,35592,0,4,-17,-1425,-3,-324,-5234,-1,0,0,0,4
EUN1_3563137182',3,22,8,0,1,1,0,4,0,351,85,26659,30098,28187,5,32,5,2,0,0,0,5,308,82,23093,26035,29327,0,43,3,3566,3,4063,-1140,-2,1,1,0,-1
EUN1_3563119826',7,26,9,0,0,1,0,7,0,295,92,25621,27586,27941,2,29,13,1,0,1,0,3,358,96,27129,29266,28066,1,-63,-4,-1508,-4,-1680,-125,-1,0,0,0,4
EUN1_3562964818',4,33,7,0,0,0,0,10,1,311,70,23232,26088,28771,3,15,21,1,0,2,0,1,378,96,33679,34136,37909,0,-67,-26,-10447,-14,-8048,-9138,-1,0,-2,0,9
EUN1_3562857724',5,32,16,2,0,0,0,11,0,321,113,28846,31573,32763,0,22,13,0,1,0,0,5,341,78,26636,29774,42308,1,-20,35,2210,3,1799,-9545,2,-1,0,0,6
EUN1_3562740851',1,37,11,1,0,1,0,7,0,349,90,27885,31801,27900,7,31,9,1,0,0,0,3,339,98,25765,29329,31457,1,10,-8,2120,2,2472,-3557,0,0,1,0,4
EUN1_3561585385',4,21,14,0,0,0,0,12,0,324,94,27477,30526,29049,3,231,17,2,0,1,0,1,411,104,31986,32288,35194,0,-87,-10,-4509,-3,-1762,-6145,-2,0,-1,0,11
EUN1_3561550417',0,23,11,0,0,0,0,5,0,399,107,28498,31974,30890,11,35,13,1,0,0,0,5,332,80,27989,29900,32987,1,67,27,509,-2,2074,-2097,-1,0,0,0,0
EUN1_3559887090',4,21,21,1,1,2,0,8,1,340,92,31075,31679,41768,2,23,9,1,0,0,0,4,285,72,25611,26279,26211,1,55,20,5464,12,5400,15557,0,1,2,0,4
EUN1_3559311441',2,25,9,1,0,0,0,11,0,360,56,25933,28881,31095,1,86,14,0,0,1,0,4,344,92,29571,32242,33371,1,16,-36,-3638,-5,-3361,-2276,1,0,-1,0,7
EUN1_3559260578',3,20,6,0,0,0,0,1,1,398,96,25275,30732,21790,4,25,5,0,0,0,0,2,340,75,23438,28335,22760,1,58,21,1837,1,2397,-970,0,0,0,0,-1
EUN1_3559243619',6,34,10,0,1,0,0,14,1,327,72,24750,27545,22306,4,24,17,1,0,4,0,1,341,100,32339,30794,28980,0,-14,-28,-7589,-7,-3249,-6674,-1,1,-4,0,13
EUN1_3559220507',5,29,15,1,0,0,0,8,1,299,82,27536,27673,33656,4,30,16,0,0,1,0,3,292,83,28840,30844,33091,0,7,-1,-1304,-1,-3171,565,1,0,-1,0,5
EUN1_3559000645',2,24,11,0,0,0,0,6,0,339,73,26601,29305,28918,5,32,11,2,0,1,0,3,351,86,26596,29637,29865,1,-12,-13,5,0,-332,-947,-2,0,-1,0,3
EUN1_3558344334',7,30,10,2,0,0,0,13,0,274,86,24528,25037,28861,3,24,20,0,0,1,0,1,323,74,30055,28555,37884,1,-49,12,-5527,-10,-3518,-9023,2,0,-1,0,12
EUN1_3557895192',1,18,5,0,0,1,0,13,0,348,102,25253,29037,22370,7,30,16,1,0,2,0,8,371,98,30375,32094,32564,1,-23,4,-5122,-11,-3057,-10194,-1,0,-1,0,5
EUN1_3575962518',1,29,19,1,1,2,0,2,1,359,102,31928,31721,38199,1,21,4,0,0,0,0,4,327,98,23242,27222,26225,1,32,4,8686,15,4499,11974,1,1,2,0,-2
EUN1_3575931693',2,28,12,2,1,2,0,9,0,388,85,29605,29869,31290,2,121,11,0,0,0,0,7,344,74,26505,27518,22107,1,44,11,3100,1,2351,9183,2,1,2,0,2
EUN1_3575902841',2,83,12,1,0,1,0,8,0,326,95,27305,30271,30920,4,27,15,1,0,0,0,8,324,101,28469,31512,29058,1,2,-6,-1164,-3,-1241,1862,0,0,1,0,0
EUN1_3575883969',1,21,11,1,0,0,0,13,0,268,95,25178,28377,28004,5,52,15,1,0,4,1,0,398,76,31379,30483,39595,0,-130,19,-6201,-4,-2106,-11591,0,0,-4,-1,13
EUN1_3575757405',3,23,12,2,0,0,0,5,1,356,92,26373,29624,26863,3,24,11,0,0,0,0,2,306,80,25412,27804,33099,0,50,12,961,1,1820,-6236,2,0,0,0,3
EUN1_3575740166',3,27,10,0,1,1,0,7,1,412,104,29208,31012,27623,3,30,8,1,0,0,0,7,338,84,24993,28209,24736,0,74,20,4215,2,2803,2887,-1,1,1,0,0
EUN1_3575443493',4,22,19,1,0,2,0,10,1,334,84,31441,29569,29614,1,30,15,1,0,1,0,6,322,88,28118,30137,37635,1,12,-4,3323,4,-568,-8021,0,0,1,0,4
EUN1_3575391637',4,26,8,0,0,1,0,10,1,400,89,26531,29653,27281,10,32,13,2,1,1,0,2,351,106,28421,31895,28472,0,49,-17,-1890,-5,-2242,-1191,-2,-1,0,0,8
EUN1_3575377448',6,22,13,0,0,0,0,13,1,285,74,28513,25751,40531,1,34,29,2,1,4,0,4,372,102,37601,33527,44473,0,-87,-28,-9088,-16,-7776,-3942,-2,-1,-4,0,9
EUN1_3575327408',4,26,11,2,0,0,0,14,1,317,98,25258,27884,34356,5,55,13,0,0,1,0,2,327,94,27984,29103,35238,1,-10,4,-2726,-2,-1219,-882,2,0,-1,0,12
EUN1_3575304373',0,93,26,0,0,0,0,8,1,278,104,32451,30057,45974,9,25,21,1,0,0,0,4,324,60,30386,26585,38162,0,-46,44,2065,5,3472,7812,-1,0,0,0,4
EUN1_3575272755',9,34,10,1,0,0,0,7,1,385,105,27383,31400,29915,6,37,7,1,0,1,0,2,349,82,24630,27666,29454,1,36,23,2753,3,3734,461,0,0,-1,0,5
EUN1_3575245916',3,27,11,2,0,0,0,6,1,343,106,26762,29521,30160,4,21,7,0,0,1,0,6,256,94,22549,25932,20951,1,87,12,4213,4,3589,9209,2,0,-1,0,0
EUN1_3574923313',0,21,21,1,0,3,0,8,0,350,76,32994,31474,43630,3,23,15,1,0,0,0,9,280,84,27324,27921,34214,1,70,-8,5670,6,3553,9416,0,0,3,0,-1
EUN1_3574888893',4,31,3,0,0,1,0,7,0,377,92,24606,29182,24879,5,83,12,1,1,0,0,5,357,104,26521,31625,26527,0,20,-12,-1915,-9,-2443,-1648,-1,-1,1,0,2
EUN1_3574824458',3,24,4,0,0,0,0,9,0,347,96,23565,27558,17873,1,24,12,1,0,0,0,4,385,92,26833,30657,20906,0,-38,4,-3268,-8,-3099,-3033,-1,0,0,0,5
EUN1_3574807276',6,30,10,0,0,0,0,12,0,343,110,27424,29695,34190,10,52,20,2,0,2,0,3,375,94,30893,31580,35375,1,-32,16,-3469,-10,-1885,-1185,-2,0,-2,0,9
EUN1_3574780801',7,24,13,0,0,1,0,17,1,301,124,27164,29667,29511,3,31,16,2,0,2,0,1,363,68,29672,30293,38975,0,-62,56,-2508,-3,-626,-9464,-2,0,-1,0,16
EUN1_3574753071',5,44,12,0,0,0,0,8,0,337,96,26883,29509,30880,0,89,9,1,0,1,0,1,315,98,26000,27686,27962,0,22,-2,883,3,1823,2918,-1,0,-1,0,7
EUN1_3561419022',1,42,9,1,0,0,0,7,1,359,78,25891,28076,34447,7,29,10,1,0,0,0,2,330,78,24884,27980,25593,0,29,0,1007,-1,96,8854,0,0,0,0,5
EUN1_3559988370',3,46,11,2,0,0,0,7,0,356,116,27532,31248,33706,3,68,13,0,0,1,0,2,328,92,27567,30668,32029,1,28,24,-35,-2,580,1677,2,0,-1,0,5
EUN1_3559885840',3,37,15,1,0,0,0,6,1,402,117,29855,32481,38595,2,26,10,1,0,1,0,4,339,101,26471,30642,28577,1,63,16,3384,5,1839,10018,0,0,-1,0,2
EUN1_3559776179',0,18,15,1,0,0,0,11,0,264,64,26127,25471,37047,0,26,18,0,0,2,0,5,269,87,29617,26654,40536,0,-5,-23,-3490,-3,-1183,-3489,1,0,-2,0,6
EUN1_3559725722',2,18,17,1,1,0,0,6,1,316,80,28677,28660,40592,4,22,17,0,0,0,0,4,297,99,28828,29421,34931,1,19,-19,-151,0,-761,5661,1,1,0,0,2
EUN1_3559666491',2,20,14,0,0,1,0,9,1,345,88,30566,29246,30853,3,52,19,2,0,2,0,7,356,84,32257,31058,34463,0,-11,4,-1691,-5,-1812,-3610,-2,0,-1,0,2
EUN1_3559636695',6,59,8,1,0,1,0,7,1,365,82,26741,29817,24853,2,29,7,0,0,0,0,2,364,106,25332,30968,23534,0,1,-24,1409,1,-1151,1319,1,0,1,0,5
EUN1_3559409326',0,21,13,0,0,1,0,10,1,341,89,28218,29773,35527,0,22,11,2,0,2,0,5,347,82,28272,29860,33079,0,-6,7,-54,2,-87,2448,-2,0,-1,0,5
EUN1_3559241310',6,39,23,1,0,0,0,3,1,311,81,30626,27974,43868,3,27,18,1,0,0,0,5,292,90,28562,28371,42628,1,19,-9,2064,5,-397,1240,0,0,0,0,-2
EUN1_3559181295',1,36,12,0,0,0,0,15,1,334,80,27758,28174,25392,4,24,11,2,0,2,0,2,362,108,28879,29534,35572,0,-28,-28,-1121,1,-1360,-10180,-2,0,-2,0,13
EUN1_3559103980',4,27,5,0,0,0,0,8,0,347,84,24049,28026,23456,2,25,11,1,0,1,0,3,375,80,27324,30359,28285,0,-28,4,-3275,-6,-2333,-4829,-1,0,-1,0,5
EUN1_3558828857',4,45,12,2,1,0,0,11,0,302,92,25544,28364,29939,1,44,16,0,0,1,0,3,355,92,30104,31487,31128,0,-53,0,-4560,-4,-3123,-1189,2,1,-1,0,8
EUN1_3558724485',7,163,13,0,0,1,0,5,0,350,84,27771,30135,26114,1,24,6,2,0,0,0,5,343,93,23519,27292,19930,1,7,-9,4252,7,2843,6184,-2,0,1,0,0
EUN1_3553635726',0,30,10,0,1,0,0,10,0,333,78,24964,29472,32310,1,23,14,1,0,1,0,3,350,102,27724,29552,28585,0,-17,-24,-2760,-4,-80,3725,-1,1,-1,0,7
EUN1_3553515477',5,28,16,2,0,0,0,5,1,328,102,29035,30442,36895,0,20,5,0,0,1,0,2,317,94,23261,28326,34233,1,11,8,5774,11,2116,2662,2,0,-1,0,3
EUN1_3488193098',8,28,14,0,1,1,0,4,0,382,72,27971,30049,25973,4,30,7,1,0,0,0,8,340,88,24527,26307,27009,1,42,-16,3444,7,3742,-1036,-1,1,1,0,-4
EUN1_3486589707',3,21,14,1,1,1,0,7,1,301,72,28063,28798,30560,5,192,10,0,0,0,0,5,335,76,24997,29132,33664,1,-34,-4,3066,4,-334,-3104,1,1,1,0,2
EUN1_3485954312',4,36,13,1,1,2,0,6,0,364,76,28043,30421,27747,2,25,9,0,0,1,0,3,329,76,24849,28367,25278,1,35,0,3194,4,2054,2469,1,1,1,0,3
EUN1_3485904588',6,36,4,0,0,1,0,9,0,389,78,24747,27729,23316,8,35,16,2,0,1,0,2,375,84,28350,30054,32678,0,14,-6,-3603,-12,-2325,-9362,-2,0,0,0,7
EUN1_3574622071',6,257,21,1,0,2,0,7,1,348,59,31644,29783,37373,4,35,13,1,0,0,0,5,277,60,26939,24804,30661,1,71,-1,4705,8,4979,6712,0,0,2,0,2
EUN1_3572676346',4,22,18,2,0,1,0,6,0,329,90,31736,30178,35729,4,26,17,0,0,0,0,6,339,76,28851,28102,40050,1,-10,14,2885,1,2076,-4321,2,0,1,0,0
EUN1_3571489904',3,38,7,1,0,0,0,9,0,307,74,22534,25845,20431,7,147,12,1,0,1,0,0,348,102,27139,29912,31114,1,-41,-28,-4605,-5,-4067,-10683,0,0,-1,0,9
EUN1_3571438428',0,23,7,1,0,2,0,5,0,314,82,24829,25992,26652,5,31,15,1,0,0,0,5,355,90,28465,30568,34296,1,-41,-8,-3636,-8,-4576,-7644,0,0,2,0,0
EUN1_3568449688',6,45,13,2,0,0,0,10,0,351,94,27325,30923,33263,3,23,14,0,1,1,0,3,355,74,27482,30605,32653,0,-4,20,-157,-1,318,610,2,-1,-1,0,7
EUN1_3567689924',3,79,11,1,0,0,0,11,0,300,76,25495,27488,29139,4,29,16,1,0,2,0,4,347,112,30460,31074,33259,0,-47,-36,-4965,-5,-3586,-4120,0,0,-2,0,7
EUN1_3566662283',3,32,13,2,1,0,0,9,1,337,86,27608,29309,36845,8,35,12,0,0,0,0,0,353,118,26818,31775,27426,1,-16,-32,790,1,-2466,9419,2,1,0,0,9
EUN1_3574732267',1,64,8,0,0,0,0,12,0,314,88,25246,26912,42556,6,26,23,1,1,1,0,3,296,60,30282,31802,47940,1,18,28,-5036,-15,-4890,-5384,-1,-1,-1,0,9
EUN1_3573820338',3,149,18,0,0,1,0,18,0,342,61,30115,30510,38802,5,74,20,2,0,3,0,5,340,107,33424,32063,36865,0,2,-46,-3309,-2,-1553,1937,-2,0,-2,0,13
EUN1_3573796537',5,27,7,2,0,0,0,12,1,350,73,24577,29294,29156,6,27,18,0,0,2,0,1,350,124,29323,32609,33295,0,0,-51,-4746,-11,-3315,-4139,2,0,-2,0,11
EUN1_3572698474',3,27,6,0,0,0,0,8,0,333,60,23164,27662,25289,3,26,21,1,0,1,0,1,319,98,30470,29380,41584,0,14,-38,-7306,-15,-1718,-16295,-1,0,-1,0,7
EUN1_3572671665',5,24,7,1,0,0,0,7,0,334,66,23795,26496,24695,6,24,11,1,0,2,0,3,371,106,27527,30414,30040,0,-37,-40,-3732,-4,-3918,-5345,0,0,-2,0,4
EUN1_3575412652',6,25,19,1,0,3,0,4,1,364,80,31323,31101,42551,3,27,12,0,0,0,0,10,314,84,25706,28939,34221,0,50,-4,5617,7,2162,8330,1,0,3,0,-6
EUN1_3573793556',3,26,9,1,0,0,0,14,0,242,91,22943,26084,25718,6,42,13,0,0,2,0,2,358,84,29475,30764,42814,1,-116,7,-6532,-4,-4680,-17096,1,0,-2,0,12
EUN1_3573777156',4,42,13,2,0,1,0,9,1,334,86,27571,31111,28623,4,138,10,0,0,0,0,3,318,90,24795,29573,26551,0,16,-4,2776,3,1538,2072,2,0,1,0,6
EUN1_3576243699',6,29,18,1,0,1,0,8,1,404,124,32474,34295,31589,15,31,13,0,0,1,0,9,387,16,27184,29288,28383,1,17,108,5290,5,5007,3206,1,0,0,0,-1
EUN1_3576229357',8,55,12,0,0,0,0,7,1,360,116,29451,32326,32862,4,22,12,0,0,2,0,9,340,80,26545,28721,25595,1,20,36,2906,0,3605,7267,0,0,-2,0,-2
EUN1_3576215877',3,19,11,1,1,0,0,6,0,375,86,27982,30896,30476,0,25,10,0,0,1,0,2,323,94,23922,29470,30660,0,52,-8,4060,1,1426,-184,1,1,-1,0,4
EUN1_3575712386',6,22,10,0,0,0,0,8,0,332,68,25605,28665,26656,3,26,10,2,0,2,0,5,361,67,27624,29624,31338,0,-29,1,-2019,0,-959,-4682,-2,0,-2,0,3
EUN1_3575707376',5,215,13,1,0,1,0,13,0,378,100,28267,30641,29684,4,29,17,1,0,2,0,2,375,84,31502,31886,36754,0,3,16,-3235,-4,-1245,-7070,0,0,-1,0,11
EUN1_3575703156',1,18,12,0,0,0,0,15,0,283,74,25296,29051,31701,3,71,13,2,0,3,0,1,350,94,29475,29327,39556,0,-67,-20,-4179,-1,-276,-7855,-2,0,-3,0,14
EUN1_3575162442',2,37,16,0,1,1,0,15,1,344,100,30089,31161,36976,3,28,20,2,0,2,0,6,339,88,31604,30843,32879,0,5,12,-1515,-4,318,4097,-2,1,-1,0,9
EUN1_3575155414',7,31,11,1,0,1,0,3,1,377,100,28024,29766,28645,2,27,10,0,0,0,0,7,362,84,25613,29761,23382,1,15,16,2411,1,5,5263,1,0,1,0,-4
EUN1_3574636961',3,27,15,1,0,1,0,9,1,332,100,27857,29253,33185,2,36,5,0,0,0,0,1,321,84,22126,26358,24626,1,11,16,5731,10,2895,8559,1,0,1,0,8
EUN1_3574638274',5,24,11,1,0,1,0,12,1,312,71,27347,27552,34223,3,29,20,1,0,1,0,1,313,136,31057,32210,44914,0,-1,-65,-3710,-9,-4658,-10691,0,0,0,0,11
EUN1_3574629454',2,227,10,0,0,1,0,13,0,317,103,25843,27594,26767,3,65,25,1,0,2,0,2,337,100,33815,32749,45180,0,-20,3,-7972,-15,-5155,-18413,-1,0,-1,0,11
EUN1_3576136022',0,25,15,0,0,0,0,16,0,348,80,28756,30870,33431,4,326,9,2,0,2,0,2,370,79,26851,27951,29130,1,-22,1,1905,6,2919,4301,-2,0,-2,0,14
EUN1_3576130389',9,73,22,2,0,1,0,7,0,320,82,31093,29233,43318,7,34,16,0,0,0,0,6,312,74,27402,26816,32949,1,8,8,3691,6,2417,10369,2,0,1,0,1
EUN1_3576107152',7,34,14,1,0,1,0,10,1,364,86,28664,29020,34082,5,25,17,0,0,0,0,4,356,80,29744,32084,38085,1,8,6,-1080,-3,-3064,-4003,1,0,1,0,6
EUN1_3576080315',4,24,11,2,0,0,0,7,0,367,81,26950,28917,38548,3,22,11,0,0,1,0,4,359,82,26821,27805,28473,0,8,-1,129,0,1112,10075,2,0,-1,0,3
EUN1_3576045828',2,23,15,1,0,1,0,11,1,365,105,28995,31083,35879,5,24,12,1,0,2,0,4,329,85,27719,28768,32965,1,36,20,1276,3,2315,2914,0,0,-1,0,7
EUN1_3575633685',4,24,18,1,1,1,0,9,1,353,90,31031,31921,35757,3,39,10,0,0,0,0,2,314,63,24623,26068,35733,1,39,27,6408,8,5853,24,1,1,1,0,7
EUN1_3575625431',5,26,20,2,0,1,0,10,1,334,92,29366,32281,39095,2,37,12,0,0,1,0,5,383,103,29157,31887,35691,1,-49,-11,209,8,394,3404,2,0,0,0,5
EUN1_3575612290',2,15,15,2,0,0,0,12,1,307,79,28748,28055,30603,3,26,10,0,0,1,0,6,352,87,27339,28603,36260,1,-45,-8,1409,5,-548,-5657,2,0,-1,0,6
EUN1_3575594158',2,29,9,0,0,0,0,4,0,326,83,24200,28629,31076,2,33,12,2,0,0,0,1,366,115,26869,31415,31742,0,-40,-32,-2669,-3,-2786,-666,-2,0,0,0,3
EUN1_3575564413',3,22,8,0,0,2,0,6,0,371,88,27521,30386,26113,4,28,8,1,0,0,0,8,387,98,25761,29795,32916,1,-16,-10,1760,0,591,-6803,-1,0,2,0,-2
EUN1_3575354745',1,21,8,0,0,1,0,5,1,400,90,26682,29226,24096,4,27,10,2,0,0,0,5,331,86,24915,27672,25714,1,69,4,1767,-2,1554,-1618,-2,0,1,0,0
EUN1_3575331004',7,40,7,0,0,0,0,8,1,356,89,24076,28940,21735,4,28,13,2,0,2,0,1,355,115,29263,31592,28447,0,1,-26,-5187,-6,-2652,-6712,-2,0,-2,0,7
EUN1_3575322139',5,228,11,0,0,0,0,11,1,324,81,25811,27672,33967,4,93,13,2,1,2,0,1,361,98,28803,29275,31496,1,-37,-17,-2992,-2,-1603,2471,-2,-1,-2,0,10
EUN1_3575300600',4,26,17,0,1,1,0,8,1,338,110,30582,31427,32363,6,27,9,2,0,1,0,7,333,94,25343,27660,24941,1,5,16,5239,8,3767,7422,-2,1,0,0,1
EUN1_3575226288',5,26,11,1,0,0,0,6,0,377,90,27473,30074,24368,4,29,12,1,0,0,0,0,375,96,27518,29487,27314,1,2,-6,-45,-1,587,-2946,0,0,0,0,6
EUN1_3575214187',5,33,10,2,0,0,0,11,1,331,102,24933,28439,25696,7,30,11,0,0,0,0,1,349,70,25386,27924,22891,1,-18,32,-453,-1,515,2805,2,0,0,0,10
EUN1_3575205131',4,26,9,0,0,0,0,12,1,369,82,26547,28360,27498,2,23,20,2,0,3,0,4,372,90,33120,32251,34106,0,-3,-8,-6573,-11,-3891,-6608,-2,0,-3,0,8
EUN1_3566553486',3,28,5,0,0,0,0,9,0,273,72,21944,24502,29996,4,25,21,1,0,1,0,1,287,92,28665,28393,36869,1,-14,-20,-6721,-16,-3891,-6873,-1,0,-1,0,8
EUN1_3566540358',4,26,7,0,0,1,0,8,0,334,78,25271,26915,31806,1,29,20,2,0,0,0,7,331,93,28929,30730,41366,0,3,-15,-3658,-13,-3815,-9560,-2,0,1,0,1
EUN1_3566288928',6,82,20,1,0,2,0,8,1,338,84,32877,30594,38448,5,32,10,1,0,0,0,7,299,94,25229,27779,29075,1,39,-10,7648,10,2815,9373,0,0,2,0,1
EUN1_3566269700',4,25,8,1,0,0,0,9,0,294,85,24117,27172,27806,2,26,16,0,0,1,0,3,318,114,29065,29692,26578,0,-24,-29,-4948,-8,-2520,1228,1,0,-1,0,6
EUN1_3566027483',4,246,7,1,0,1,0,5,0,362,88,25306,28251,24233,2,26,9,1,0,0,0,4,400,91,26257,29496,25649,0,-38,-3,-951,-2,-1245,-1416,0,0,1,0,1
EUN1_3565763041',6,103,8,1,0,0,0,13,1,320,76,24004,26628,26148,2,137,11,0,0,3,0,3,371,64,28852,29361,34606,0,-51,12,-4848,-3,-2733,-8458,1,0,-3,0,10
EUN1_3565750558',6,43,16,1,1,0,0,10,0,320,107,29025,30271,36286,2,26,12,1,0,2,0,1,350,83,28479,27669,35629,1,-30,24,546,4,2602,657,0,1,-2,0,9
EUN1_3565740135',1,22,22,1,0,0,0,7,0,280,68,30557,29700,45076,2,22,13,1,0,1,0,5,311,103,28963,27978,35924,1,-31,-35,1594,9,1722,9152,0,0,-1,0,2
EUN1_3565316412',5,27,13,0,0,2,0,4,1,337,74,28038,29135,35919,3,100,14,2,0,1,0,6,319,82,26556,28745,33439,1,18,-8,1482,-1,390,2480,-2,0,1,0,-2
EUN1_3565289891',5,31,10,2,0,1,0,8,1,359,90,27360,29443,30703,5,36,13,0,0,1,0,3,326,80,26703,29002,29468,1,33,10,657,-3,441,1235,2,0,0,0,5
EUN1_3575247667',4,32,8,0,0,1,0,7,0,366,82,26350,29286,23932,1,275,13,2,0,0,0,3,381,83,27748,32309,34071,1,-15,-1,-1398,-5,-3023,-10139,-2,0,1,0,4
EUN1_3573159209',7,28,11,1,1,0,0,8,0,359,89,27467,30149,30887,3,29,14,1,0,1,0,0,345,82,27559,28348,31661,0,14,7,-92,-3,1801,-774,0,1,-1,0,8
EUN1_3573131967',3,27,13,0,0,0,0,6,0,333,74,26430,28829,29451,4,150,17,1,0,0,0,2,358,104,29224,30624,41711,0,-25,-30,-2794,-4,-1795,-12260,-1,0,0,0,4
EUN1_3571625436',2,32,9,1,0,0,0,9,1,279,80,23359,24568,34492,4,29,11,0,0,0,0,2,324,92,26696,27071,31670,0,-45,-12,-3337,-2,-2503,2822,1,0,0,0,7
EUN1_3571595458',2,25,8,1,0,0,0,7,0,292,83,23483,27055,30200,2,68,13,1,0,0,0,5,345,88,25808,28467,32466,0,-53,-5,-2325,-5,-1412,-2266,0,0,0,0,2
EUN1_3571568594',1,22,18,2,1,1,0,5,1,403,118,31974,33453,37039,3,24,7,0,0,1,0,6,303,98,23500,26671,18726,1,100,20,8474,11,6782,18313,2,1,0,0,-1
EUN1_3575759371',1,29,13,1,0,1,0,2,1,345,102,27986,29387,25578,4,23,15,1,0,0,0,7,327,102,27906,31131,25528,1,18,0,80,-2,-1744,50,0,0,1,0,-5
EUN1_3574894218',5,28,19,1,1,1,0,9,1,356,110,31316,31993,33273,2,21,9,1,0,0,0,2,331,62,25000,27769,27223,0,25,48,6316,10,4224,6050,0,1,1,0,7
EUN1_3574836627',5,25,16,2,0,2,0,6,1,329,102,28897,31337,36722,3,35,6,0,0,0,0,9,334,75,23777,26437,27243,1,-5,27,5120,10,4900,9479,2,0,2,0,-3
EUN1_3573103427',1,30,17,1,0,0,0,9,0,316,93,27748,29459,41603,5,23,13,1,0,0,0,5,278,100,26323,27480,37516,1,38,-7,1425,4,1979,4087,0,0,0,0,4
EUN1_3573088114',1,26,14,1,1,0,0,9,0,343,112,27654,32597,28900,2,21,5,1,0,0,0,1,364,86,24398,28134,18036,1,-21,26,3256,9,4463,10864,0,1,0,0,8
EUN1_3573065238',2,23,9,1,1,0,0,4,0,362,84,25635,30625,29873,2,23,5,1,0,0,0,4,344,104,23153,29034,21137,1,18,-20,2482,4,1591,8736,0,1,0,0,0
EUN1_3573042834',5,26,10,1,0,0,0,11,1,332,78,24972,28927,30749,3,30,20,1,0,4,0,1,379,90,33308,33309,39433,0,-47,-12,-8336,-10,-4382,-8684,0,0,-4,0,10
EUN1_3573029828',5,25,11,2,0,0,0,7,0,349,110,26366,29445,25831,1,93,8,0,0,0,0,3,353,67,24772,28657,20624,1,-4,43,1594,3,788,5207,2,0,0,0,4
EUN1_3572001456',2,24,9,0,0,1,0,9,1,377,88,26975,30166,26411,7,26,15,2,0,0,0,4,388,116,30057,32226,27945,1,-11,-28,-3082,-6,-2060,-1534,-2,0,1,0,5
EUN1_3571981685',3,58,10,1,0,0,0,8,0,348,94,27032,30812,29176,9,30,16,0,0,0,0,2,319,66,26904,28038,30743,1,29,28,128,-6,2774,-1567,1,0,0,0,6
EUN1_3571927422',8,34,11,1,0,0,0,9,1,354,102,25998,30135,25199,3,25,8,1,0,0,0,3,370,78,25344,29681,27205,1,-16,24,654,3,454,-2006,0,0,0,0,6
EUN1_3571920237',6,27,8,1,0,1,0,11,0,364,92,26178,27693,26157,3,20,19,1,0,1,0,8,342,104,30211,33417,33819,0,22,-12,-4033,-11,-5724,-7662,0,0,0,0,3
EUN1_3571899997',3,24,15,1,0,1,0,10,0,276,100,27856,29626,35016,1,26,21,0,0,2,0,4,337,68,30054,30265,40279,1,-61,32,-2198,-6,-639,-5263,1,0,-1,0,6
EUN1_3571890550',2,22,12,0,0,0,0,11,1,307,78,25982,30738,30501,5,28,15,2,0,0,0,2,382,122,29863,31641,38176,1,-75,-44,-3881,-3,-903,-7675,-2,0,0,0,9
EUN1_3571436142',1,23,10,1,0,0,0,7,0,331,92,25654,28893,33994,2,20,10,0,0,0,0,2,380,88,26624,30272,29980,0,-49,4,-970,0,-1379,4014,1,0,0,0,5
EUN1_3571407689',5,33,13,0,0,1,0,9,0,335,92,28299,30452,30246,3,25,9,2,0,0,0,5,332,96,25120,29009,30968,1,3,-4,3179,4,1443,-722,-2,0,1,0,4
EUN1_3571402266',6,26,9,1,0,0,0,9,0,352,84,25030,29944,27227,4,22,15,1,0,1,0,0,369,106,29157,32280,42946,0,-17,-22,-4127,-6,-2336,-15719,0,0,-1,0,9
EUN1_3571340169',2,39,7,0,0,0,0,5,0,376,88,24956,28578,23246,2,130,5,2,0,0,0,1,381,88,23303,29617,23954,0,-5,0,1653,2,-1039,-708,-2,0,0,0,4
EUN1_3571329152',4,25,14,1,0,1,0,6,1,308,55,25461,28123,31191,5,29,10,1,0,0,0,2,355,104,25973,27981,28001,0,-47,-49,-512,4,142,3190,0,0,1,0,4
EUN1_3575823244',4,26,11,1,0,0,0,7,1,336,60,26346,30011,32391,3,31,9,1,0,0,0,0,336,80,24361,28452,37424,1,0,-20,1985,2,1559,-5033,0,0,0,0,7
EUN1_3575807276',2,22,15,1,0,1,0,9,1,322,104,28789,31133,26299,4,27,11,1,0,0,0,6,378,72,27677,29253,31678,1,-56,32,1112,4,1880,-5379,0,0,1,0,3
EUN1_3575215372',1,25,17,0,0,1,0,9,0,362,80,29892,30874,33124,5,29,13,2,0,1,0,9,357,72,27042,27729,30470,0,5,8,2850,4,3145,2654,-2,0,0,0,0
EUN1_3575194658',3,17,16,1,0,0,0,13,1,340,81,28668,28753,44773,1,29,18,0,0,2,0,3,328,78,30126,30681,40904,1,12,3,-1458,-2,-1928,3869,1,0,-2,0,10
EUN1_3575179007',7,44,14,1,0,1,0,9,0,358,72,28894,30720,29435,2,25,11,0,0,0,0,4,324,90,26019,28088,31033,0,34,-18,2875,3,2632,-1598,1,0,1,0,5
EUN1_3574746838',5,35,18,2,0,1,0,13,1,291,96,28630,29085,37726,4,31,24,0,1,2,0,1,339,76,32711,31100,44646,0,-48,20,-4081,-6,-2015,-6920,2,-1,-1,0,12
EUN1_3574729884',1,27,8,2,0,1,0,5,1,363,102,26850,29184,31265,3,23,14,0,0,0,0,3,327,74,26450,29013,29700,0,36,28,400,-6,171,1565,2,0,1,0,2
EUN1_3574241411',1,24,10,0,0,0,0,7,1,298,86,24184,29467,19714,8,28,10,2,0,1,0,0,346,110,26265,29840,35085,0,-48,-24,-2081,0,-373,-15371,-2,0,-1,0,7
EUN1_3573563264',0,21,5,1,0,0,0,6,0,335,76,23421,28843,20231,8,30,9,1,0,0,0,0,409,96,26749,30636,30311,0,-74,-20,-3328,-4,-1793,-10080,0,0,0,0,6
EUN1_3573548496',5,209,15,1,0,3,0,9,0,357,80,30636,30468,34604,5,25,11,0,0,1,0,7,385,96,28036,30954,28971,0,-28,-16,2600,4,-486,5633,1,0,2,0,2
EUN1_3573541222',4,27,15,1,0,1,0,8,0,320,96,29400,29349,33626,2,25,14,1,0,1,0,8,299,80,27978,28198,31572,1,21,16,1422,1,1151,2054,0,0,0,0,0
EUN1_3573527730',2,36,9,1,0,0,0,6,0,361,80,25472,27466,30513,2,22,12,0,0,0,0,4,315,75,26266,28595,25282,1,46,5,-794,-3,-1129,5231,1,0,0,0,2
EUN1_3572595255',3,24,13,0,1,0,0,4,1,343,72,26895,28646,31331,6,32,6,2,0,0,0,4,339,100,23815,28259,29642,1,4,-28,3080,7,387,1689,-2,1,0,0,0
EUN1_3572156252',4,28,8,0,0,0,0,11,1,324,68,23023,25390,26041,2,29,19,1,0,1,0,1,333,77,30732,29924,39699,0,-9,-9,-7709,-11,-4534,-13658,-1,0,-1,0,10
EUN1_3572125906',4,20,18,1,1,2,0,11,1,321,70,30380,28991,40674,2,23,20,0,0,0,0,4,291,64,28173,28087,31275,1,30,6,2207,-2,904,9399,1,1,2,0,7
EUN1_3572099946',1,27,7,0,0,1,0,8,0,329,80,25519,28729,26435,3,31,14,2,0,1,0,7,338,76,28265,30117,28707,0,-9,4,-2746,-7,-1388,-2272,-2,0,0,0,1
EUN1_3571943138',0,20,8,0,0,1,0,17,1,283,82,25328,26312,25032,3,28,21,1,0,2,0,1,344,110,31009,31774,39114,0,-61,-28,-5681,-13,-5462,-14082,-1,0,-1,0,16
EUN1_3571921841',4,30,13,0,0,0,0,11,0,290,88,25499,27104,29112,1,25,13,1,0,1,0,2,329,68,26829,28438,29605,0,-39,20,-1330,0,-1334,-493,-1,0,-1,0,9
EUN1_3571909916',3,157,14,1,0,2,0,9,0,315,68,28594,27975,37552,2,23,11,0,0,1,0,8,314,72,25625,26685,29656,1,1,-4,2969,3,1290,7896,1,0,1,0,1
EUN1_3571897872',1,26,11,0,0,1,0,6,1,303,67,27352,26925,36398,4,138,19,1,0,1,0,4,323,88,28320,28254,34967,0,-20,-21,-968,-8,-1329,1431,-1,0,0,0,2
EUN1_3571432643',2,23,19,1,0,3,0,7,0,359,118,33357,30231,42236,4,24,12,1,0,0,0,8,236,54,24819,24830,31587,1,123,64,8538,7,5401,10649,0,0,3,0,-1
EUN1_3571297586',6,97,15,1,0,0,0,10,1,329,80,27379,30246,31788,4,30,5,0,0,0,0,3,372,99,24610,30071,29148,1,-43,-19,2769,10,175,2640,1,0,0,0,7
EUN1_3571296352',1,23,7,0,0,0,0,9,0,362,94,25111,28812,28157,4,25,13,2,0,1,0,3,349,76,27376,29652,31980,1,13,18,-2265,-6,-840,-3823,-2,0,-1,0,6
EUN1_3570874792',3,48,13,0,0,1,0,10,0,361,96,28747,30068,31021,4,243,13,2,0,0,0,4,307,87,26536,28771,40474,0,54,9,2211,0,1297,-9453,-2,0,1,0,6
EUN1_3570849513',4,26,18,0,0,0,0,10,0,412,82,30368,33920,30392,1,29,11,2,0,1,0,4,349,82,25807,27974,32613,1,63,0,4561,7,5946,-2221,-2,0,-1,0,6
EUN1_3570817011',5,30,13,1,0,0,0,5,1,294,78,26649,26342,33661,4,36,15,0,0,0,0,4,321,88,27086,28983,39007,1,-27,-10,-437,-2,-2641,-5346,1,0,0,0,1
EUN1_3569564158',2,28,13,0,0,0,0,7,1,344,75,27412,29400,39893,6,27,12,2,0,0,0,3,328,96,25217,29964,35023,0,16,-21,2195,1,-564,4870,-2,0,0,0,4
EUN1_3558911704',6,27,18,1,1,0,0,6,1,340,104,30281,31206,35384,2,87,15,0,0,0,0,2,332,78,27949,28091,35568,1,8,26,2332,3,3115,-184,1,1,0,0,4
EUN1_3558898291',3,22,12,1,0,0,0,9,0,360,88,26918,29297,32665,0,64,10,1,0,1,0,3,337,88,26724,29613,32048,1,23,0,194,2,-316,617,0,0,-1,0,6
EUN1_3558874521',1,27,10,1,0,2,0,5,1,336,94,28413,27892,35901,3,94,11,0,0,0,0,6,333,94,26189,28565,37860,0,3,0,2224,-1,-673,-1959,1,0,2,0,-1
EUN1_3558858351',3,64,16,0,0,1,0,12,0,305,86,28915,28267,34164,6,36,21,1,0,1,0,1,334,81,32748,29357,41132,0,-29,5,-3833,-5,-1090,-6968,-1,0,0,0,11
EUN1_3558839081',2,29,14,1,0,0,0,9,0,331,104,28486,29659,34079,3,21,12,0,0,0,0,2,360,88,27837,29643,36306,0,-29,16,649,2,16,-2227,1,0,0,0,7
EUN1_3558807267',7,35,19,1,0,2,0,6,0,330,97,31362,31795,36993,4,36,8,1,0,0,0,7,340,90,25359,27701,28461,1,-10,7,6003,11,4094,8532,0,0,2,0,-1
EUN1_3558738697',3,40,24,1,0,1,0,14,1,319,90,32453,31648,42815,2,21,14,1,0,2,0,7,308,84,28586,27933,35353,1,11,6,3867,10,3715,7462,0,0,-1,0,7
EUN1_3558717162',3,44,10,0,0,0,0,11,0,290,58,23947,25602,28941,3,39,18,2,1,2,0,4,336,87,28842,28825,37921,0,-46,-29,-4895,-8,-3223,-8980,-2,-1,-2,0,7
EUN1_3558678886',2,27,12,0,0,0,0,7,0,317,68,26119,29397,37907,3,26,17,1,0,0,0,1,291,80,27203,28550,49250,0,26,-12,-1084,-5,847,-11343,-1,0,0,0,6
EUN1_3558664302',7,29,11,0,0,1,0,7,0,305,75,27592,29316,40217,2,69,21,1,0,1,0,2,331,76,30483,29668,34117,0,-26,-1,-2891,-10,-352,6100,-1,0,0,0,5
EUN1_3558647110',3,24,12,0,0,0,0,12,0,315,74,26561,26564,30217,6,58,22,2,1,2,0,0,362,101,34130,32106,40005,0,-47,-27,-7569,-10,-5542,-9788,-2,-1,-2,0,12
EUN1_3558520952',4,30,15,1,0,2,0,4,1,385,88,30016,33348,33258,5,31,8,1,0,0,0,6,335,80,25169,28896,31966,1,50,8,4847,7,4452,1292,0,0,2,0,-2
EUN1_3558513733',4,32,16,2,0,0,0,5,1,368,108,28934,33230,35055,4,41,9,0,0,0,0,1,349,88,25181,28969,25107,1,19,20,3753,7,4261,9948,2,0,0,0,4
EUN1_3558506225',4,25,16,0,0,1,0,5,0,328,92,29972,30490,38170,3,26,15,1,0,0,0,5,276,88,27056,28362,30246,0,52,4,2916,1,2128,7924,-1,0,1,0,0
EUN1_3558491848',2,24,13,1,0,2,0,6,0,356,112,29955,33222,35898,4,24,11,1,0,0,0,5,311,90,25905,29115,29328,1,45,22,4050,2,4107,6570,0,0,2,0,1
EUN1_3558485871',5,18,9,1,0,0,0,9,1,370,66,25664,28829,22512,2,31,7,0,1,0,0,4,340,94,25768,29435,30203,0,30,-28,-104,2,-606,-7691,1,-1,0,0,5
EUN1_3558485337',4,30,13,1,0,1,0,4,1,341,70,27943,29021,25992,5,30,8,1,0,0,0,6,349,106,24694,28340,24561,1,-8,-36,3249,5,681,1431,0,0,1,0,-2
EUN1_3556938404',2,27,15,2,0,1,0,2,0,349,102,29435,32408,35001,3,29,3,0,0,0,0,7,347,82,22666,28015,26378,0,2,20,6769,12,4393,8623,2,0,1,0,-5
EUN1_3574845706',2,27,20,2,0,0,0,7,1,323,95,30542,31567,39703,0,21,12,0,0,2,0,6,317,72,27088,28011,36960,1,6,23,3454,8,3556,2743,2,0,-2,0,1
EUN1_3574830252',9,55,13,1,0,0,0,9,1,307,94,26943,27260,37504,4,29,18,0,0,2,0,5,274,86,29449,28728,38065,0,33,8,-2506,-5,-1468,-561,1,0,-2,0,4
EUN1_3574807751',2,23,12,1,0,0,0,6,1,323,92,26918,28073,29372,0,313,8,0,0,1,0,5,324,68,24506,26918,32048,1,-1,24,2412,4,1155,-2676,1,0,-1,0,1
EUN1_3574790356',3,26,11,0,0,0,0,7,0,347,71,25735,28624,27184,3,34,11,2,0,0,0,6,340,111,26659,30333,27605,0,7,-40,-924,0,-1709,-421,-2,0,0,0,1
EUN1_3574761099',3,36,9,0,0,0,0,6,0,346,102,25851,28286,31679,6,26,9,1,0,1,0,3,337,76,24744,27981,26445,1,9,26,1107,0,305,5234,-1,0,-1,0,3
EUN1_3573542918',4,24,6,0,0,0,0,10,0,340,86,23201,27298,18425,4,34,17,1,1,2,0,1,390,85,30870,33826,29248,0,-50,1,-7669,-11,-6528,-10823,-1,-1,-2,0,9
EUN1_3571355809',3,31,13,0,1,2,0,9,1,360,100,31128,30940,31391,9,29,10,2,0,0,0,5,330,88,26151,28974,30886,1,30,12,4977,3,1966,505,-2,1,2,0,4
EUN1_3571339978',5,171,13,0,0,0,0,16,1,345,70,28399,30232,31564,3,136,16,2,0,5,0,1,371,86,30536,30217,35120,0,-26,-16,-2137,-3,15,-3556,-2,0,-5,0,15
EUN1_3576020303',4,95,14,0,0,0,0,10,0,311,80,27221,29447,31613,2,23,16,1,1,1,0,3,337,76,28715,29602,41108,0,-26,4,-1494,-2,-155,-9495,-1,-1,-1,0,7
EUN1_3575659267',6,26,6,2,0,0,0,9,0,369,74,24689,29238,21578,4,34,11,0,0,2,0,3,393,86,28427,30392,29927,0,-24,-12,-3738,-5,-1154,-8349,2,0,-2,0,6
EUN1_3575646589',1,102,10,0,0,1,0,9,0,288,68,25167,25729,28693,2,23,25,2,0,2,0,4,284,76,32242,29641,41971,0,4,-8,-7075,-15,-3912,-13278,-2,0,-1,0,5
EUN1_3575632817',5,27,15,2,0,1,0,7,1,324,90,27985,29689,35725,3,340,14,0,0,0,0,3,308,78,26862,29672,28511,0,16,12,1123,1,17,7214,2,0,1,0,4
EUN1_3575618772',3,27,9,0,0,1,0,9,1,334,83,26118,28799,29359,1,23,13,1,0,0,0,2,306,80,26466,28964,26551,0,28,3,-348,-4,-165,2808,-1,0,1,0,7
EUN1_3575603363',2,32,7,0,0,0,0,7,1,318,79,23877,29456,25805,1,20,16,1,1,1,0,2,324,72,26207,31270,31184,1,-6,7,-2330,-9,-1814,-5379,-1,-1,-1,0,5
EUN1_3575169267',5,26,12,1,0,1,0,8,1,324,108,26445,30065,38507,3,24,12,0,0,2,0,3,327,76,26780,29228,33198,1,-3,32,-335,0,837,5309,1,0,-1,0,5
EUN1_3575160503',1,28,11,0,0,2,0,7,1,377,96,28581,31006,34671,3,23,5,2,0,1,0,6,316,80,23395,26614,24430,1,61,16,5186,6,4392,10241,-2,0,1,0,1
EUN1_3575021872',4,45,10,0,0,0,0,6,0,346,77,24720,28294,26766,2,26,13,1,0,0,0,5,342,80,26541,29397,32692,1,4,-3,-1821,-3,-1103,-5926,-1,0,0,0,1
EUN1_3574695118',3,23,19,1,0,1,0,4,1,328,112,29937,30582,36187,2,23,13,0,0,0,0,5,301,68,26749,27195,31804,1,27,44,3188,6,3387,4383,1,0,1,0,-1
EUN1_3574677112',0,199,13,1,0,0,0,10,1,299,87,26245,28210,32282,4,26,12,1,0,1,0,1,378,84,27447,30372,33517,0,-79,3,-1202,1,-2162,-1235,0,0,-1,0,9
EUN1_3574656525',1,41,8,0,0,1,0,11,0,368,91,26448,30133,20724,2,73,16,2,0,1,0,4,380,60,28714,31228,27883,0,-12,31,-2266,-8,-1095,-7159,-2,0,0,0,7
EUN1_3574562970',5,30,16,2,0,0,0,9,1,340,81,28251,29425,34852,5,28,11,0,1,1,0,3,352,92,28495,29697,29812,1,-12,-11,-244,5,-272,5040,2,-1,-1,0,6
EUN1_3574550668',3,31,14,0,0,1,0,7,0,329,82,27655,28507,31479,1,47,16,2,0,0,0,3,289,86,27913,27845,37827,1,40,-4,-258,-2,662,-6348,-2,0,1,0,4
EUN1_3573684957',5,29,15,1,0,1,0,4,1,365,94,30130,30956,29670,3,105,17,1,0,0,0,5,345,86,27989,29962,39515,1,20,8,2141,-2,994,-9845,0,0,1,0,-1
EUN1_3567686161',2,24,10,1,0,0,0,7,1,341,82,25712,28730,37362,4,33,8,1,0,0,0,1,322,78,24490,26307,33545,1,19,4,1222,2,2423,3817,0,0,0,0,6
EUN1_3567517159',2,24,17,0,0,1,0,8,1,335,92,31291,28031,32911,2,28,13,2,0,1,0,7,338,92,26675,29452,28156,0,-3,0,4616,4,-1421,4755,-2,0,0,0,1
EUN1_3567513136',4,85,15,0,0,1,0,8,0,321,63,28189,28591,36590,2,27,11,1,0,1,0,4,334,88,27323,28653,37847,0,-13,-25,866,4,-62,-1257,-1,0,0,0,4
EUN1_3567502597',5,34,22,0,0,1,0,9,1,361,100,32511,33049,38163,1,38,8,0,0,0,0,2,323,62,24179,27221,33926,1,38,38,8332,14,5828,4237,0,0,1,0,7
EUN1_3567496824',8,61,21,1,1,0,0,5,1,310,119,30221,31250,37181,4,25,7,1,0,0,0,4,350,60,24016,26388,32054,1,-40,59,6205,14,4862,5127,0,1,0,0,1
EUN1_3567235050',5,36,15,0,0,0,0,10,0,286,80,27476,28699,29933,5,25,16,2,0,3,0,4,345,88,31019,30383,36386,0,-59,-8,-3543,-1,-1684,-6453,-2,0,-3,0,6
EUN1_3567218856',6,50,23,1,0,1,0,10,1,353,86,33269,30509,38975,3,26,12,1,0,1,0,9,340,77,29191,28202,31474,1,13,9,4078,11,2307,7501,0,0,0,0,1
EUN1_3575646396',2,25,13,1,1,1,0,10,0,346,104,29192,30884,30242,4,40,8,1,0,2,0,7,367,88,27496,29309,25338,1,-21,16,1696,5,1575,4904,0,1,-1,0,3
EUN1_3575624186',5,30,18,1,1,1,0,5,1,377,98,31005,31698,29978,3,43,9,0,0,0,0,0,335,89,25329,28555,31614,1,42,9,5676,9,3143,-1636,1,1,1,0,5
EUN1_3575593602',6,29,17,2,0,2,0,6,1,355,81,29276,27345,37201,4,24,7,0,0,1,0,9,332,72,25436,26763,29114,1,23,9,3840,10,582,8087,2,0,1,0,-3
EUN1_3574029845',3,26,13,1,1,0,0,9,0,376,86,28264,30034,29560,3,28,6,1,0,0,0,1,347,85,24857,26880,24158,1,29,1,3407,7,3154,5402,0,1,0,0,8
EUN1_3573496691',5,28,15,1,0,1,0,11,0,351,86,30371,29292,33835,2,133,16,0,1,0,0,3,387,70,29507,31900,33007,1,-36,16,864,-1,-2608,828,1,-1,1,0,8
EUN1_3572935274',5,19,18,2,0,0,0,15,0,290,78,29058,29064,38190,0,22,19,0,0,5,0,2,368,82,33758,29602,38482,0,-78,-4,-4700,-1,-538,-292,2,0,-5,0,13
EUN1_3572920475',4,25,12,2,0,0,0,8,1,368,100,26698,30519,26043,2,25,6,0,0,1,0,2,386,94,25530,30122,20306,1,-18,6,1168,6,397,5737,2,0,-1,0,6
EUN1_3574573551',3,23,8,2,0,1,0,5,0,346,88,25152,28715,30339,2,34,8,0,0,0,0,4,331,67,23755,27919,26644,0,15,21,1397,0,796,3695,2,0,1,0,1
EUN1_3574564371',5,24,8,0,0,0,0,9,0,333,86,25187,26978,28860,2,28,12,2,0,1,0,3,342,58,27096,28181,27944,0,-9,28,-1909,-4,-1203,916,-2,0,-1,0,6
EUN1_3574538997',2,105,10,1,0,0,0,12,1,307,94,24854,29622,31072,3,23,9,1,0,2,0,0,345,86,26930,29126,30505,0,-38,8,-2076,1,496,567,0,0,-2,0,12
EUN1_3574530210',3,30,9,1,1,0,0,8,0,340,100,26395,28322,26235,4,127,14,1,0,1,0,2,385,83,28788,30464,31021,0,-45,17,-2393,-5,-2142,-4786,0,1,-1,0,6
EUN1_3574497799',1,35,7,1,0,0,0,8,1,371,88,24799,29645,25622,3,28,9,0,1,0,0,1,400,67,25770,29100,25996,1,-29,21,-971,-2,545,-374,1,-1,0,0,7
EUN1_3573686651',3,130,13,0,0,1,0,9,0,330,84,27581,31882,33399,3,25,9,2,0,1,0,5,395,108,27828,30495,30895,0,-65,-24,-247,4,1387,2504,-2,0,0,0,4
EUN1_3573673282',3,28,10,0,0,0,0,14,1,382,84,25819,29543,28503,2,27,13,1,0,0,0,2,346,80,27029,31303,29988,0,36,4,-1210,-3,-1760,-1485,-1,0,0,0,12
EUN1_3573649680',1,18,17,0,0,0,0,8,1,361,86,29159,31757,38434,2,22,16,2,0,0,0,1,330,102,28285,33673,36003,0,31,-16,874,1,-1916,2431,-2,0,0,0,7
EUN1_3573619943',6,30,15,2,0,1,0,12,1,304,110,29418,29950,33879,3,22,13,0,1,2,0,9,323,76,28312,28482,30954,0,-19,34,1106,2,1468,2925,2,-1,-1,0,3
EUN1_3573595317',9,221,9,0,0,0,0,12,0,360,80,25781,28803,30577,6,27,11,2,0,2,0,2,374,80,28624,29454,26531,0,-14,0,-2843,-2,-651,4046,-2,0,-2,0,10
EUN1_3573576642',6,28,16,1,0,1,0,8,0,397,108,30144,30987,33667,2,26,11,0,0,0,0,3,362,76,27831,29261,26230,1,35,32,2313,5,1726,7437,1,0,1,0,5
EUN1_3573560962',6,24,10,1,0,1,0,9,0,356,102,27686,30838,36662,3,61,7,1,0,0,0,2,320,66,24124,26122,26482,1,36,36,3562,3,4716,10180,0,0,1,0,7
EUN1_3573563082',5,24,10,1,0,2,0,2,0,384,84,27004,31186,30198,2,24,6,1,0,0,0,5,357,108,23971,29074,24676,1,27,-24,3033,4,2112,5522,0,0,2,0,-3
EUN1_3573548464',5,24,9,0,0,2,0,5,1,357,70,26220,26617,32881,5,30,7,2,0,0,0,5,316,102,23001,27766,20569,1,41,-32,3219,2,-1149,12312,-2,0,2,0,0
EUN1_3573215762',1,24,16,1,0,1,0,8,1,342,82,29322,32009,34179,3,27,7,0,0,1,0,6,346,80,24436,28710,28072,1,-4,2,4886,9,3299,6107,1,0,0,0,2
EUN1_3573203596',3,26,11,1,0,0,0,9,0,356,91,26545,29896,25540,4,23,10,1,0,1,0,3,340,136,27603,31786,29429,0,16,-45,-1058,1,-1890,-3889,0,0,-1,0,6
EUN1_3573180456',1,28,13,1,0,1,0,11,1,330,88,26679,30598,34009,0,24,10,0,0,1,0,2,331,76,24430,28365,24850,1,-1,12,2249,3,2233,9159,1,0,0,0,9
EUN1_3573161687',0,30,12,0,0,0,0,11,1,324,68,26504,26622,27937,6,95,22,2,1,2,0,2,339,62,30989,31957,39153,0,-15,6,-4485,-10,-5335,-11216,-2,-1,-2,0,9
EUN1_3573116058',2,24,22,2,0,1,0,6,1,389,96,32296,32884,36315,1,24,6,0,0,1,0,7,302,76,23712,27121,22836,1,87,20,8584,16,5763,13479,2,0,0,0,-1
EUN1_3575924533',4,32,5,0,0,0,0,10,0,301,78,22555,26578,22113,7,34,16,1,0,1,0,3,357,88,28434,31315,32225,0,-56,-10,-5879,-11,-4737,-10112,-1,0,-1,0,7
EUN1_3573651709',8,36,9,0,0,0,0,12,1,270,56,22517,25983,39004,3,25,15,1,0,2,0,2,358,91,30616,30313,43999,0,-88,-35,-8099,-6,-4330,-4995,-1,0,-2,0,10
EUN1_3572939797',2,24,19,1,1,3,0,12,1,386,124,33013,34952,36073,6,19,5,1,0,2,0,9,322,68,24010,26157,21618,1,64,56,9003,14,8795,14455,0,1,1,0,3
EUN1_3572942345',3,25,16,0,0,0,0,4,0,332,85,27760,28929,38949,1,21,15,2,0,0,0,4,305,81,27912,28112,33322,1,27,4,-152,1,817,5627,-2,0,0,0,0
EUN1_3572928758',5,26,7,0,0,0,0,7,1,337,78,24592,28089,27098,2,26,11,2,0,0,0,4,325,82,24870,30321,32548,0,12,-4,-278,-4,-2232,-5450,-2,0,0,0,3
EUN1_3572929183',1,19,8,0,0,0,0,5,1,358,80,25274,29518,24608,3,21,7,2,0,0,0,2,356,84,24783,29227,27488,1,2,-4,491,1,291,-2880,-2,0,0,0,3
EUN1_3572911552',0,25,13,1,0,0,0,7,1,318,84,27829,30740,27199,2,29,14,0,0,0,0,3,366,96,27141,29479,32737,1,-48,-12,688,-1,1261,-5538,1,0,0,0,4
EUN1_3572899437',2,48,11,1,1,0,0,15,0,262,72,25993,27414,24978,1,101,22,1,0,3,0,0,348,101,33991,30738,41283,0,-86,-29,-7998,-11,-3324,-16305,0,1,-3,0,15
EUN1_3573377150',2,26,7,1,0,0,0,4,0,314,88,23457,27414,27657,7,403,12,1,0,0,0,2,350,80,26607,29221,32044,0,-36,8,-3150,-5,-1807,-4387,0,0,0,0,2
EUN1_3573315878',1,21,22,0,0,1,0,10,0,329,88,31564,30105,41384,4,24,14,2,0,1,0,3,313,100,28177,27840,33976,1,16,-12,3387,8,2265,7408,-2,0,0,0,7
EUN1_3573226621',4,30,8,0,0,0,0,5,0,384,84,25340,29462,26210,4,31,11,1,0,0,0,2,396,87,26969,29144,28365,1,-12,-3,-1629,-3,318,-2155,-1,0,0,0,3
EUN1_3575291706',6,40,10,0,0,1,0,7,1,356,86,27718,29219,30148,1,17,8,1,0,0,0,4,371,82,25769,29106,23897,0,-15,4,1949,2,113,6251,-1,0,1,0,3
EUN1_3574223563',1,240,8,0,0,1,0,11,1,381,76,26737,29356,27625,5,25,7,2,0,0,0,4,328,104,25104,28840,24179,0,53,-28,1633,1,516,3446,-2,0,1,0,7
EUN1_3574060207',2,46,24,0,1,0,0,14,1,328,63,32692,30964,42034,4,224,17,1,0,2,0,6,281,100,30286,27828,39023,1,47,-37,2406,7,3136,3011,-1,1,-2,0,8
EUN1_3574051547',1,22,6,0,0,0,0,10,0,291,81,23509,25188,22296,3,25,13,2,0,1,0,2,356,110,29662,30679,26775,0,-65,-29,-6153,-7,-5491,-4479,-2,0,-1,0,8
EUN1_3574038918',3,41,11,2,0,0,0,10,0,334,84,25467,29890,32692,5,28,16,0,0,2,0,3,383,97,28826,31028,34740,0,-49,-13,-3359,-5,-1138,-2048,2,0,-2,0,7
EUN1_3575646565',3,30,8,2,0,0,0,6,1,385,92,25837,29462,27621,1,16,6,0,0,0,0,4,347,76,23555,28800,25300,1,38,16,2282,2,662,2321,2,0,0,0,2
EUN1_3575636194',5,22,13,1,0,0,0,5,1,349,90,27420,28073,26642,4,36,10,1,0,2,0,2,332,98,25116,27716,26149,0,17,-8,2304,3,357,493,0,0,-2,0,3
EUN1_3575589856',4,35,9,1,0,0,0,8,0,311,96,24376,27462,23592,2,33,9,1,0,1,0,2,400,92,27643,29950,25070,0,-89,4,-3267,0,-2488,-1478,0,0,-1,0,6
EUN1_3575511070',3,31,15,0,0,2,0,8,1,352,108,30353,31185,28947,2,31,15,2,1,0,0,4,333,78,27525,29320,31563,1,19,30,2828,0,1865,-2616,-2,-1,2,0,4
EUN1_3575466844',5,64,12,1,0,0,0,3,1,339,88,26400,28744,32256,5,67,11,1,0,0,0,3,341,75,25373,28994,34679,0,-2,13,1027,1,-250,-2423,0,0,0,0,0
EUN1_3575444081',5,33,13,2,0,0,0,4,0,352,86,26438,29632,34696,4,32,16,0,1,0,0,4,336,78,27495,29105,34474,0,16,8,-1057,-3,527,222,2,-1,0,0,0
EUN1_3575304019',6,33,14,2,0,2,0,9,0,375,95,28496,30559,34404,3,28,6,0,0,0,0,3,342,92,24137,27645,26791,0,33,3,4359,8,2914,7613,2,0,2,0,6
EUN1_3575289540',4,34,16,0,0,0,0,4,0,328,72,27659,29185,33514,3,40,19,2,0,0,0,2,348,100,30092,30295,41534,0,-20,-28,-2433,-3,-1110,-8020,-2,0,0,0,2
EUN1_3575271828',5,26,24,0,0,0,0,9,1,343,92,31735,32288,42843,3,38,8,1,0,0,0,3,330,88,24802,27329,34267,1,13,4,6933,16,4959,8576,-1,0,0,0,6
EUN1_3575250304',3,32,17,0,0,0,0,11,1,320,68,26981,28106,35376,2,24,18,1,0,0,0,0,352,62,29897,30513,43019,1,-32,6,-2916,-1,-2407,-7643,-1,0,0,0,11
EUN1_3575235114',2,24,18,1,0,0,0,12,0,312,78,29731,30655,44582,3,29,12,1,1,2,0,0,343,65,27441,30493,41911,0,-31,13,2290,6,162,2671,0,-1,-2,0,12
EUN1_3575205568',4,26,13,2,0,1,0,8,0,356,101,28298,30719,37719,4,29,11,0,0,1,0,5,306,74,24929,28112,24818,1,50,27,3369,2,2607,12901,2,0,0,0,3
EUN1_3575110767',4,24,19,1,0,1,0,6,1,332,76,30638,29726,37703,2,43,12,0,0,0,0,9,287,78,25991,26453,30812,1,45,-2,4647,7,3273,6891,1,0,1,0,-3
EUN1_3575074123',3,31,8,0,0,0,0,7,0,339,92,24098,28282,29656,7,46,14,1,0,2,0,1,343,76,28361,29146,34637,0,-4,16,-4263,-6,-864,-4981,-1,0,-2,0,6
EUN1_3575048285',5,29,17,1,0,1,0,10,1,322,70,29484,28467,37290,5,44,18,0,0,0,0,7,316,79,29538,30442,41214,0,6,-9,-54,-1,-1975,-3924,1,0,1,0,3
EUN1_3575019809',6,31,11,1,0,0,0,8,0,374,87,27642,30347,30849,2,24,12,1,0,0,0,4,313,82,26448,29023,31313,0,61,5,1194,-1,1324,-464,0,0,0,0,4
EUN1_3574991867',3,25,21,1,0,0,0,13,0,334,76,29099,30804,36563,3,37,13,1,1,2,0,1,345,100,30354,29465,39386,0,-11,-24,-1255,8,1339,-2823,0,-1,-2,0,12
EUN1_3574106028',7,30,14,1,1,1,0,7,1,365,102,28323,30115,33951,4,20,19,1,0,0,0,5,300,66,27530,29860,28889,0,65,36,793,-5,255,5062,0,1,1,0,2
EUN1_3573575874',3,19,13,0,0,1,0,11,1,331,90,28408,29353,30444,5,22,11,1,0,0,0,4,309,73,25721,27288,28558,0,22,17,2687,2,2065,1886,-1,0,1,0,7
EUN1_3573561996',1,25,10,1,0,0,0,12,1,328,72,25883,26949,25451,2,18,16,1,1,2,0,2,386,96,30207,30933,33247,0,-58,-24,-4324,-6,-3984,-7796,0,-1,-2,0,10
EUN1_3575593783',3,25,15,1,0,0,0,7,1,314,102,27957,29289,34273,2,24,9,1,0,0,0,2,356,80,25341,27828,33097,1,-42,22,2616,6,1461,1176,0,0,0,0,5
EUN1_3575120104',1,25,13,1,0,1,0,14,1,334,65,27948,29193,31548,4,389,11,0,0,2,0,5,349,60,27256,27541,31474,0,-15,5,692,2,1652,74,1,0,-1,0,9
EUN1_3575101024',3,24,7,0,0,0,0,8,0,298,66,22459,26133,24057,8,28,14,2,0,2,0,1,411,98,30102,32711,37492,0,-113,-32,-7643,-7,-6578,-13435,-2,0,-2,0,7
EUN1_3575097504',2,19,20,1,0,0,0,4,0,347,80,29690,31943,47146,3,30,12,0,0,0,0,4,328,60,26921,27954,42693,0,19,20,2769,8,3989,4453,1,0,0,0,0
EUN1_3575072069',5,27,12,1,0,0,0,13,1,371,79,27216,30444,34449,4,26,22,1,0,2,0,1,345,91,32756,33748,45784,0,26,-12,-5540,-10,-3304,-11335,0,0,-2,0,12
EUN1_3575071113',2,21,7,0,0,0,0,3,0,377,81,24139,29464,30036,4,26,12,2,0,0,0,1,362,98,26838,31342,31303,0,15,-17,-2699,-5,-1878,-1267,-2,0,0,0,2
EUN1_3574276722',6,33,17,2,0,1,0,7,1,396,78,30578,33019,39928,6,19,6,0,0,1,0,4,346,82,23574,27200,29772,1,50,-4,7004,11,5819,10156,2,0,0,0,3
EUN1_3573317858',6,23,16,2,0,1,0,15,1,321,90,28671,29573,42444,2,33,18,0,0,1,0,6,320,98,30285,31320,42096,0,1,-8,-1614,-2,-1747,348,2,0,0,0,9
EUN1_3573289279',3,27,9,1,0,0,0,7,0,315,92,24689,29002,36818,4,37,15,1,0,1,0,5,353,80,28540,30144,34599,0,-38,12,-3851,-6,-1142,2219,0,0,-1,0,2
EUN1_3573254639',0,22,9,1,0,0,0,11,1,346,86,25736,28863,35591,3,25,12,1,0,1,0,3,335,97,27413,28479,35502,1,11,-11,-1677,-3,384,89,0,0,-1,0,8
EUN1_3576201744',0,19,9,0,0,0,0,14,0,298,97,24980,28587,25272,4,24,22,1,0,3,0,0,358,103,33077,32227,40574,0,-60,-6,-8097,-13,-3640,-15302,-1,0,-3,0,14
EUN1_3576160543',3,15,20,0,0,1,0,13,0,344,76,31574,29618,27807,2,42,22,1,1,3,0,5,385,104,34021,32814,43489,1,-41,-28,-2447,-2,-3196,-15682,-1,-1,-2,0,8
EUN1_3576128966',2,17,12,0,1,0,0,8,1,322,98,26471,30385,25592,6,28,14,1,0,1,0,2,347,77,27795,31097,32816,0,-25,21,-1324,-2,-712,-7224,-1,1,-1,0,6
EUN1_3575698495',3,24,14,2,0,1,0,11,0,336,80,27836,29714,30819,3,23,11,0,0,1,0,5,354,85,27901,29296,32365,0,-18,-5,-65,3,418,-1546,2,0,0,0,6
EUN1_3575698247',6,20,7,1,0,1,0,16,0,304,93,23851,27641,18348,2,27,15,1,0,2,0,2,405,102,31832,31110,27746,0,-101,-9,-7981,-8,-3469,-9398,0,0,-1,0,14
EUN1_3575692532',4,29,11,1,0,1,0,8,1,385,94,29055,32173,30585,8,45,7,1,1,1,0,8,360,72,24522,29499,26342,1,25,22,4533,4,2674,4243,0,-1,0,0,0
EUN1_3575685442',5,23,18,2,0,0,0,17,1,281,82,27798,28270,33738,0,17,9,0,0,2,0,1,297,77,25286,26417,29297,1,-16,5,2512,9,1853,4441,2,0,-2,0,16
EUN1_3575678872',4,24,16,1,0,1,0,6,0,303,80,29609,27845,35967,2,21,15,0,1,1,0,2,317,77,28520,28647,40979,1,-14,3,1089,1,-802,-5012,1,-1,0,0,4
EUN1_3575674410',2,21,6,0,0,0,0,12,0,314,67,22472,27816,28486,2,46,11,1,1,1,0,1,342,114,27907,29497,27591,0,-28,-47,-5435,-5,-1681,895,-1,-1,-1,0,11
EUN1_3575663956',2,21,12,0,0,0,0,9,1,323,74,26254,29115,35875,4,133,17,2,0,1,0,0,328,86,28236,29864,34933,0,-5,-12,-1982,-5,-749,942,-2,0,-1,0,9
EUN1_3575657067',1,86,14,1,0,0,0,6,1,351,100,28794,30023,34295,2,132,10,1,0,0,0,2,293,103,24422,28701,21812,1,58,-3,4372,4,1322,12483,0,0,0,0,4
EUN1_3575654660',4,27,14,0,0,0,0,9,0,308,47,27348,27244,31010,5,37,25,1,1,1,0,5,316,93,32167,26983,42773,0,-8,-46,-4819,-11,261,-11763,-1,-1,-1,0,4
EUN1_3575648368',4,24,12,0,0,1,0,14,0,307,76,25499,28724,28620,4,27,18,2,0,2,0,5,357,80,31243,30030,35663,1,-50,-4,-5744,-6,-1306,-7043,-2,0,-1,0,9
EUN1_3575621191',5,26,9,0,0,0,0,9,0,318,88,25296,28669,30702,4,28,16,1,0,0,0,1,326,104,27367,30275,32347,0,-8,-16,-2071,-7,-1606,-1645,-1,0,0,0,8
EUN1_3575220033',2,38,9,1,0,0,0,14,1,363,70,25849,29037,25894,4,27,13,1,0,2,0,3,369,114,28700,30607,33179,0,-6,-44,-2851,-4,-1570,-7285,0,0,-2,0,11
EUN1_3575213343',7,24,16,1,0,2,0,7,0,317,71,29462,28531,26366,3,49,21,1,0,1,0,7,253,90,29092,28197,32847,1,64,-19,370,-5,334,-6481,0,0,1,0,0
EUN1_3575663614',1,24,19,0,0,1,0,6,0,292,74,29984,28610,39151,1,19,18,2,0,1,0,10,329,70,29643,28865,38536,0,-37,4,341,1,-255,615,-2,0,0,0,-4
EUN1_3575662307',1,22,20,1,0,1,0,13,0,341,88,29203,31948,40968,2,21,14,1,0,2,0,5,328,96,30039,30366,31516,1,13,-8,-836,6,1582,9452,0,0,-1,0,8
EUN1_3575654267',1,24,17,1,0,0,0,11,1,341,70,30138,32962,33579,2,38,15,0,0,1,0,2,359,85,27682,29857,33276,1,-18,-15,2456,2,3105,303,1,0,-1,0,9
EUN1_3575110656',1,38,15,0,0,0,0,11,0,331,88,28837,31118,40659,2,18,13,1,0,1,0,2,333,88,27190,28909,34555,1,-2,0,1647,2,2209,6104,-1,0,-1,0,9
EUN1_3575105759',3,27,15,0,1,1,0,11,1,329,100,30040,30683,31452,2,24,10,2,0,1,0,6,303,72,26383,27819,29779,1,26,28,3657,5,2864,1673,-2,1,0,0,5
EUN1_3575096531',4,18,15,2,0,1,0,6,1,360,82,29910,30697,26080,5,23,8,0,0,1,0,6,310,88,23486,27634,25783,1,50,-6,6424,7,3063,297,2,0,0,0,0
EUN1_3575088238',2,21,12,1,0,0,0,11,0,285,74,26344,27820,35888,2,46,25,1,0,0,0,4,322,102,31642,31064,45232,0,-37,-28,-5298,-13,-3244,-9344,0,0,0,0,7
EUN1_3575066791',1,22,7,0,0,0,0,5,0,324,85,23958,28748,28085,2,34,7,2,0,1,0,3,319,90,23502,29017,23093,1,5,-5,456,0,-269,4992,-2,0,-1,0,2
EUN1_3573508511',2,19,9,0,0,0,0,17,1,272,91,25024,25871,33070,6,29,22,2,0,4,0,3,298,84,32723,30693,43449,0,-26,7,-7699,-13,-4822,-10379,-2,0,-4,0,14
EUN1_3572957105',5,23,12,1,0,1,0,5,0,328,81,28546,27620,33405,3,25,25,1,0,0,0,5,284,114,30046,31879,44704,0,44,-33,-1500,-13,-4259,-11299,0,0,1,0,0
EUN1_3572946832',3,23,15,0,0,0,0,7,0,361,95,28040,30989,37054,1,20,9,1,0,1,0,5,384,86,25943,30676,29105,1,-23,9,2097,6,313,7949,-1,0,-1,0,2
EUN1_3572939715',3,31,6,1,1,0,0,11,0,337,78,24650,27502,23201,2,22,13,1,0,1,0,1,379,104,28885,31906,30773,0,-42,-26,-4235,-7,-4404,-7572,0,1,-1,0,10
EUN1_3572353249',1,21,12,0,0,0,0,9,1,310,82,25541,25715,30687,2,21,14,2,0,1,0,1,360,85,29066,28971,30931,0,-50,-3,-3525,-2,-3256,-244,-2,0,-1,0,8
EUN1_3571791527',3,28,11,0,0,1,0,7,0,390,96,28096,31248,29030,1,23,10,2,0,0,0,4,343,86,25455,29088,26164,0,47,10,2641,1,2160,2866,-2,0,1,0,3
EUN1_3571642222',1,40,9,0,0,0,0,5,0,362,86,26236,30590,31185,3,137,11,1,0,0,0,4,355,90,26056,29849,28323,0,7,-4,180,-2,741,2862,-1,0,0,0,1
EUN1_3571602643',2,29,8,0,0,1,0,8,0,386,89,27205,28862,29425,4,60,10,1,0,1,0,8,347,78,25581,28204,33824,0,39,11,1624,-2,658,-4399,-1,0,0,0,0
EUN1_3570540483',8,28,23,0,0,0,0,11,1,296,64,29275,28279,39710,3,33,14,1,0,0,0,4,347,84,28881,29590,35558,0,-51,-20,394,9,-1311,4152,-1,0,0,0,7
EUN1_3570530636',5,25,7,1,0,0,0,10,1,297,66,23477,25173,24592,3,28,16,0,0,1,0,0,366,102,30153,30977,30310,1,-69,-36,-6676,-9,-5804,-5718,1,0,-1,0,10
EUN1_3570518637',5,27,13,2,0,0,0,16,0,363,72,26813,29193,31850,1,20,8,0,0,2,0,2,366,96,27754,30090,28133,0,-3,-24,-941,5,-897,3717,2,0,-2,0,14
EUN1_3570498844',1,18,11,0,0,0,0,14,1,310,36,24071,27172,32030,2,21,16,1,1,2,0,2,358,118,31120,31977,34557,0,-48,-82,-7049,-5,-4805,-2527,-1,-1,-2,0,12
EUN1_3576068233',3,24,13,0,0,0,0,10,0,297,74,25392,27198,27722,0,22,21,1,0,1,0,4,327,84,32844,30933,48784,0,-30,-10,-7452,-8,-3735,-21062,-1,0,-1,0,6
EUN1_3576038426',6,34,14,0,0,0,0,11,0,346,72,27431,28353,37573,3,21,19,2,0,1,0,4,300,82,28772,28610,39357,0,46,-10,-1341,-5,-257,-1784,-2,0,-1,0,7
EUN1_3576012936',5,30,17,2,0,3,0,6,1,401,96,32416,31685,35534,6,24,6,0,0,0,0,7,320,83,22809,26288,20215,1,81,13,9607,11,5397,15319,2,0,3,0,-1
EUN1_3575925092',0,21,21,1,0,2,0,12,0,381,88,31921,31437,41467,7,29,19,1,0,1,0,4,313,79,30621,29612,36399,1,68,9,1300,2,1825,5068,0,0,1,0,8
EUN1_3575847602',0,25,14,0,0,0,0,2,1,327,98,28141,29067,33134,4,26,14,2,0,0,0,1,343,98,26358,28480,33559,0,-16,0,1783,0,587,-425,-2,0,0,0,1
EUN1_3575828801',5,27,12,1,0,0,0,8,1,306,88,25382,27571,30608,0,21,14,1,0,1,0,0,333,94,29894,29566,36496,0,-27,-6,-4512,-2,-1995,-5888,0,0,-1,0,8
EUN1_3575818377',3,27,18,0,0,0,0,10,0,329,74,30289,28490,36728,8,30,13,1,0,2,0,3,344,78,28210,28223,34082,0,-15,-4,2079,5,267,2646,-1,0,-2,0,7
EUN1_3575272944',3,25,19,1,0,2,0,5,1,379,88,32326,30460,38131,4,43,10,0,0,0,0,8,318,82,25409,28128,32347,1,61,6,6917,9,2332,5784,1,0,2,0,-3
EUN1_3575249569',3,23,13,0,0,2,0,10,0,321,88,28368,28254,32409,2,22,13,1,0,1,0,4,317,83,27005,28469,30000,1,4,5,1363,0,-215,2409,-1,0,1,0,6
EUN1_3568146003',4,28,9,0,0,0,0,16,0,270,83,25024,26235,27875,3,33,33,1,0,5,0,1,362,87,36583,34273,49243,0,-92,-4,-11559,-24,-8038,-21368,-1,0,-5,0,15
EUN1_3567335402',10,39,13,0,1,0,0,16,1,323,72,26145,27649,31067,7,33,11,2,0,4,0,2,386,100,30674,30734,34357,0,-63,-28,-4529,2,-3085,-3290,-2,1,-4,0,14
EUN1_3567306816',4,38,17,1,0,0,0,15,0,337,88,28822,29671,33249,1,28,13,0,0,2,0,6,295,104,28849,29984,32401,1,42,-16,-27,4,-313,848,1,0,-2,0,9
EUN1_3567289279',2,91,16,0,0,0,0,9,0,310,76,28015,28282,36946,6,52,17,1,0,2,0,4,309,92,30539,28868,34707,0,1,-16,-2524,-1,-586,2239,-1,0,-2,0,5
EUN1_3567270434',6,27,21,2,1,2,0,10,0,362,92,33591,32806,39686,5,21,13,0,0,1,0,7,311,60,27569,27862,30816,1,51,32,6022,8,4944,8870,2,1,1,0,3
EUN1_3566967616',6,32,11,0,0,1,0,6,0,325,66,26013,26255,26646,3,26,13,2,0,0,0,2,290,87,26185,26660,27687,0,35,-21,-172,-2,-405,-1041,-2,0,1,0,4
EUN1_3566952013',1,27,16,2,0,0,0,12,0,327,91,30231,29794,36400,1,15,19,0,0,2,0,3,328,83,30906,30473,39309,1,-1,8,-675,-3,-679,-2909,2,0,-2,0,9
EUN1_3566949192',2,26,26,2,0,1,0,9,0,315,82,32438,32676,50441,2,21,22,0,0,0,0,4,316,86,30483,30103,37746,1,-1,-4,1955,4,2573,12695,2,0,1,0,5
EUN1_3573453121',2,23,16,1,0,2,0,7,1,352,84,29548,29871,37357,7,29,8,1,1,0,0,2,322,88,24283,28139,24333,1,30,-4,5265,8,1732,13024,0,-1,2,0,5
EUN1_3573423684',5,30,14,1,0,0,0,10,1,298,64,26903,27122,27846,4,31,15,0,0,1,0,1,353,96,28992,30250,32237,0,-55,-32,-2089,-1,-3128,-4391,1,0,-1,0,9
EUN1_3573386057',2,26,17,1,0,1,0,9,0,332,66,29291,30612,37751,2,25,16,1,0,0,0,4,352,82,28775,29320,36137,0,-20,-16,516,1,1292,1614,0,0,1,0,5
EUN1_3573370093',4,25,15,0,0,0,0,8,1,318,66,26595,29163,26073,6,30,16,1,0,1,0,5,356,70,29593,30411,36006,0,-38,-4,-2998,-1,-1248,-9933,-1,0,-1,0,3
EUN1_3573230036',2,47,11,0,1,1,0,8,0,346,71,27284,29862,35650,6,28,18,2,0,1,0,1,332,116,28524,31158,36949,1,14,-45,-1240,-7,-1296,-1299,-2,1,0,0,7
EUN1_3572802757',3,22,12,0,0,0,0,10,1,317,100,27550,29531,29613,2,20,16,1,0,1,0,2,346,99,30094,30632,32894,0,-29,1,-2544,-4,-1101,-3281,-1,0,-1,0,8
EUN1_3572775525',3,23,8,1,0,0,0,9,0,386,78,24352,30043,27789,1,21,8,0,1,1,0,2,363,110,27128,31907,28342,0,23,-32,-2776,0,-1864,-553,1,-1,-1,0,7
EUN1_3572734700',4,29,11,1,0,0,0,7,0,316,92,25626,28783,24884,3,26,17,0,0,0,0,2,355,64,27661,30503,39368,1,-39,28,-2035,-6,-1720,-14484,1,0,0,0,5
EUN1_3572707853',8,27,11,1,0,1,0,8,0,369,96,27857,30575,33851,2,150,9,1,0,0,0,4,356,96,26832,30135,34498,1,13,0,1025,2,440,-647,0,0,1,0,4
EUN1_3572603869',2,25,7,2,0,0,0,5,1,334,98,24353,28920,23909,4,26,10,0,1,0,0,5,346,106,25893,30425,30988,1,-12,-8,-1540,-3,-1505,-7079,2,-1,0,0,0
EUN1_3572365311',6,29,12,0,0,1,0,9,1,355,80,27196,29462,35427,6,366,11,2,0,1,0,3,351,91,27026,29556,31736,0,4,-11,170,1,-94,3691,-2,0,0,0,6
EUN1_3572345696',3,26,13,0,1,0,0,2,0,335,81,26899,30335,29195,2,32,16,2,0,1,0,3,329,90,28840,29638,34379,0,6,-9,-1941,-3,697,-5184,-2,1,-1,0,-1
EUN1_3569311020',3,26,17,1,0,1,0,10,1,344,68,28540,30317,33960,2,89,17,0,0,0,0,3,330,84,28875,32313,32579,0,14,-16,-335,0,-1996,1381,1,0,1,0,7
EUN1_3569286264',4,29,14,0,1,0,0,8,0,314,68,27077,28175,32666,7,30,18,1,0,1,0,2,339,80,30288,29490,39519,1,-25,-12,-3211,-4,-1315,-6853,-1,1,-1,0,6
EUN1_3569251700',4,27,15,1,0,0,0,6,0,278,88,27105,29396,30532,7,33,20,1,0,0,0,0,369,91,29771,31252,40458,1,-91,-3,-2666,-5,-1856,-9926,0,0,0,0,6
EUN1_3569216899',2,25,24,1,0,1,0,7,1,370,96,33315,33365,36343,1,126,13,1,0,0,0,4,333,86,26925,29230,35089,1,37,10,6390,11,4135,1254,0,0,1,0,3
EUN1_3569191756',3,42,10,2,0,1,0,11,0,311,96,27694,29993,31022,6,24,14,0,1,2,0,7,346,84,27865,31633,33577,1,-35,12,-171,-4,-1640,-2555,2,-1,-1,0,4
EUN1_3569174035',1,28,8,0,0,0,0,8,1,307,84,24210,27922,29767,7,24,16,2,0,1,0,1,381,100,29946,32128,33337,0,-74,-16,-5736,-8,-4206,-3570,-2,0,-1,0,7
EUN1_3569090425',5,24,18,0,0,2,0,11,0,338,96,30086,32532,36329,2,29,8,2,0,0,0,4,296,80,23469,27377,28319,0,42,16,6617,10,5155,8010,-2,0,2,0,7
EUN1_3569069470',6,29,6,1,0,0,0,10,0,343,84,23721,28505,25311,3,30,13,0,0,0,0,1,381,104,28141,31226,33807,0,-38,-20,-4420,-7,-2721,-8496,1,0,0,0,9
EUN1_3575496925',2,25,19,1,0,3,0,10,1,414,72,32520,32034,37911,3,22,14,0,0,0,0,5,312,96,27215,29668,37361,1,102,-24,5305,5,2366,550,1,0,3,0,5
EUN1_3575468110',3,80,9,1,0,1,0,10,0,351,80,25582,27201,31089,1,20,18,1,0,0,0,4,332,88,28802,29490,32518,1,19,-8,-3220,-9,-2289,-1429,0,0,1,0,6
EUN1_3575431919',7,25,9,1,0,0,0,7,1,290,65,23787,26064,32549,2,24,5,1,0,0,0,3,354,78,23695,27123,28525,1,-64,-13,92,4,-1059,4024,0,0,0,0,4
EUN1_3575370053',1,26,7,0,0,0,0,9,0,372,104,25077,29496,21839,3,60,14,2,0,3,0,6,339,76,27447,29877,29503,0,33,28,-2370,-7,-381,-7664,-2,0,-3,0,3
EUN1_3575355602',6,31,12,0,0,1,0,12,1,362,62,27049,28219,27778,2,27,11,2,0,1,0,4,333,100,27040,29639,32575,0,29,-38,9,1,-1420,-4797,-2,0,0,0,8
EUN1_3576035262',8,34,14,0,1,2,0,5,0,345,84,29519,29889,31350,8,28,11,2,0,0,0,8,334,84,26333,28245,28451,1,11,0,3186,3,1644,2899,-2,1,2,0,-3
EUN1_3575994999',5,23,12,1,0,1,0,5,1,398,102,28996,32755,25384,2,19,5,1,0,0,0,7,357,82,23628,28744,24850,1,41,20,5368,7,4011,534,0,0,1,0,-2
EUN1_3572057126',3,25,17,1,0,0,0,12,1,306,76,29296,29029,43399,7,29,19,0,0,2,0,5,321,68,29339,29236,45395,0,-15,8,-43,-2,-207,-1996,1,0,-2,0,7
EUN1_3571700215',3,24,15,2,0,0,0,9,1,332,122,28458,30195,36566,3,26,17,0,0,1,0,1,330,68,30074,30955,39890,1,2,54,-1616,-2,-760,-3324,2,0,-1,0,8
EUN1_3571440218',3,25,12,2,0,0,0,9,0,324,90,25876,27896,35548,3,27,16,0,0,1,0,0,383,66,30184,28521,32945,1,-59,24,-4308,-4,-625,2603,2,0,-1,0,9
EUN1_3571062629',3,26,12,1,0,1,0,7,1,351,74,27290,30518,36211,3,26,14,1,0,0,0,3,362,92,28414,32482,47034,1,-11,-18,-1124,-2,-1964,-10823,0,0,1,0,4
EUN1_3571023187',7,34,5,0,0,0,0,8,0,353,106,23171,30029,31111,2,24,10,1,0,0,0,2,312,102,24743,31311,27197,1,41,4,-1572,-5,-1282,3914,-1,0,0,0,6
EUN1_3570971742',5,25,9,1,0,0,0,9,1,298,83,25077,27846,21704,6,44,12,1,0,2,0,4,371,91,27747,29310,26470,1,-73,-8,-2670,-3,-1464,-4766,0,0,-2,0,5
EUN1_3570936363',8,32,25,0,0,1,0,8,0,315,76,31282,30592,48612,2,38,18,1,0,0,0,7,286,71,27999,25856,33922,0,29,5,3283,7,4736,14690,-1,0,1,0,1
EUN1_3570909371',3,23,10,0,0,0,0,16,1,405,85,26952,28523,34591,3,25,13,2,0,2,0,0,377,90,29417,30832,26742,0,28,-5,-2465,-3,-2309,7849,-2,0,-2,0,16
EUN1_3575318522',2,20,16,2,0,1,0,7,0,356,96,29791,30066,38472,2,38,15,0,0,0,0,4,319,96,28249,28337,38040,1,37,0,1542,1,1729,432,2,0,1,0,3
EUN1_3575310177',4,31,12,0,0,0,0,12,0,285,68,25256,25809,32540,2,42,24,2,1,2,0,0,381,86,34512,32119,46384,0,-96,-18,-9256,-12,-6310,-13844,-2,-1,-2,0,12
EUN1_3568267971',1,26,17,2,0,2,0,6,0,383,115,31440,32988,41385,2,20,6,0,0,0,0,9,370,80,24585,29208,24873,1,13,35,6855,11,3780,16512,2,0,2,0,-3
EUN1_3568235971',6,30,13,2,0,0,0,9,1,345,90,27515,30350,32983,3,22,8,0,0,1,0,3,362,82,26101,29262,29170,0,-17,8,1414,5,1088,3813,2,0,-1,0,6
EUN1_3568138028',0,25,13,0,0,0,0,10,0,308,80,27267,26876,33269,6,26,17,2,0,2,0,5,294,86,28579,28726,32009,0,14,-6,-1312,-4,-1850,1260,-2,0,-2,0,5
EUN1_3570241578',1,36,22,2,0,1,0,8,0,370,109,33068,31809,44141,1,21,10,0,0,0,0,2,305,102,25787,27946,30281,1,65,7,7281,12,3863,13860,2,0,1,0,6
EUN1_3570214699',6,58,15,0,0,1,0,10,1,299,82,28688,28383,38833,0,91,19,2,0,1,0,4,302,93,29576,31247,38199,0,-3,-11,-888,-4,-2864,634,-2,0,0,0,6
EUN1_3570190700',6,33,12,0,0,0,0,10,0,352,74,26831,29091,34248,2,25,19,2,1,1,0,3,333,102,30217,31429,36670,0,19,-28,-3386,-7,-2338,-2422,-2,-1,-1,0,7
EUN1_3570177188',4,20,14,1,0,0,0,9,1,296,70,26675,27965,30917,2,47,9,0,0,0,0,1,389,89,27746,30668,32735,0,-93,-19,-1071,5,-2703,-1818,1,0,0,0,8
EUN1_3575371558',4,32,16,0,0,0,0,12,0,283,76,28268,26894,33068,2,22,22,2,0,1,0,2,320,100,31117,29674,37231,1,-37,-24,-2849,-6,-2780,-4163,-2,0,-1,0,10
EUN1_3575344039',5,27,12,1,0,1,0,6,0,339,92,26569,28655,26843,3,28,9,1,0,0,0,7,348,72,24594,29725,26757,1,-9,20,1975,3,-1070,86,0,0,1,0,-1
EUN1_3575240991',5,26,10,0,0,2,0,8,0,352,98,28503,28627,30949,3,29,22,2,0,0,0,10,298,77,29246,29894,44861,0,54,21,-743,-12,-1267,-13912,-2,0,2,0,-2
EUN1_3575237285',0,21,18,1,0,3,0,8,0,355,106,31533,31473,47058,5,114,15,1,0,0,0,7,297,78,26050,28234,33435,1,58,28,5483,3,3239,13623,0,0,3,0,1
EUN1_3575220520',1,41,10,0,0,0,0,11,1,309,79,24762,28123,27506,3,25,13,2,0,2,0,1,368,124,28490,32177,38757,0,-59,-45,-3728,-3,-4054,-11251,-2,0,-2,0,10
EUN1_3575197841',4,27,14,0,0,1,0,12,0,338,77,29244,29846,32358,2,33,13,1,0,1,0,8,360,70,26954,29187,29426,0,-22,7,2290,1,659,2932,-1,0,0,0,4
EUN1_3573661149',4,27,9,1,0,0,0,5,0,374,74,25823,29631,26725,3,21,11,1,0,0,0,4,333,98,26515,30004,34237,0,41,-24,-692,-2,-373,-7512,0,0,0,0,1
EUN1_3573632929',3,31,16,1,0,0,0,4,1,342,76,28584,27670,35481,1,23,16,0,0,1,0,5,343,80,29784,28905,35477,1,-1,-4,-1200,0,-1235,4,1,0,-1,0,-1
EUN1_3573618486',4,26,5,2,0,0,0,14,0,371,84,24640,29051,26656,5,26,14,0,0,1,0,1,378,111,28523,33018,27256,0,-7,-27,-3883,-9,-3967,-600,2,0,-1,0,13
EUN1_3573606110',8,33,14,1,0,0,0,8,0,314,108,26576,29664,35452,8,33,11,1,0,1,0,1,317,96,27495,28433,27153,1,-3,12,-919,3,1231,8299,0,0,-1,0,7
EUN1_3573421536',4,59,12,2,0,0,0,9,1,353,90,26245,30246,31493,5,58,8,0,1,0,0,4,343,82,25801,28682,29681,0,10,8,444,4,1564,1812,2,-1,0,0,5
EUN1_3573342146',3,46,13,1,0,0,0,10,1,317,68,26850,26835,32408,6,27,18,1,0,1,0,5,290,91,28668,27894,41707,0,27,-23,-1818,-5,-1059,-9299,0,0,-1,0,5
EUN1_3575985375',5,29,8,0,0,0,0,7,0,346,82,24695,29240,27160,5,31,10,1,0,0,0,0,394,91,26619,30747,29550,0,-48,-9,-1924,-2,-1507,-2390,-1,0,0,0,7
EUN1_3575952622',8,34,15,1,0,3,0,13,0,318,96,30666,29463,33133,2,35,14,1,0,1,0,4,357,96,28513,29087,37984,1,-39,0,2153,1,376,-4851,0,0,2,0,9
EUN1_3575121914',4,22,35,1,0,3,0,4,1,288,78,40138,28717,58993,1,27,12,0,0,1,0,10,228,64,24264,22670,36181,1,60,14,15874,23,6047,22812,1,0,2,0,-6
EUN1_3575099519',6,33,15,1,1,0,0,6,1,344,112,29236,30448,29985,3,143,13,1,0,1,0,3,368,88,27491,29183,31268,1,-24,24,1745,2,1265,-1283,0,1,-1,0,3
EUN1_3574576060',6,30,5,0,0,0,0,12,0,337,88,22578,26466,26966,3,29,19,2,0,3,0,2,373,88,31354,33353,33107,0,-36,0,-8776,-14,-6887,-6141,-2,0,-3,0,10
EUN1_3574524457',2,31,16,1,0,1,0,8,1,379,92,28975,30614,33432,10,35,11,1,0,0,0,3,340,107,26872,31145,35191,0,39,-15,2103,5,-531,-1759,0,0,1,0,5
EUN1_3574055787',5,33,20,2,0,4,0,4,0,296,100,30769,31455,38319,4,23,9,0,1,0,0,10,291,80,25036,27585,27809,1,5,20,5733,11,3870,10510,2,-1,4,0,-6
EUN1_3574047727',2,74,7,0,0,0,0,11,1,317,96,25405,28490,28121,3,24,21,2,0,2,0,3,354,108,30618,34158,41265,0,-37,-12,-5213,-14,-5668,-13144,-2,0,-2,0,8
EUN1_3574947649',2,24,13,1,1,1,0,6,1,364,95,28785,31701,29596,5,30,4,1,0,0,0,1,339,84,22501,25499,20132,1,25,11,6284,9,6202,9464,0,1,1,0,5
EUN1_3574930236',1,50,7,0,0,1,0,10,1,311,81,24716,26840,29142,6,31,16,2,0,3,0,4,389,110,30570,32070,36320,0,-78,-29,-5854,-9,-5230,-7178,-2,0,-2,0,6
EUN1_3574893982',3,215,10,1,0,0,0,7,1,368,86,25146,30101,25219,3,23,6,1,0,1,0,3,384,90,25628,30254,27254,1,-16,-4,-482,4,-153,-2035,0,0,-1,0,4
EUN1_3572023833',6,66,24,1,0,2,0,10,0,336,108,33792,30160,43523,4,38,12,0,0,0,0,5,295,72,26354,26316,32608,1,41,36,7438,12,3844,10915,1,0,2,0,5
EUN1_3572013484',3,22,18,1,1,1,0,8,0,372,95,30928,31567,36325,0,21,14,0,0,1,0,4,322,92,27909,28429,36773,1,50,3,3019,4,3138,-448,1,1,0,0,4
EUN1_3571976580',4,26,17,1,0,1,0,12,0,330,90,29044,29894,32503,2,20,11,1,0,1,0,4,338,90,26826,28757,35974,0,-8,0,2218,6,1137,-3471,0,0,0,0,8
EUN1_3571968193',2,24,6,1,1,0,0,11,0,352,78,25153,29138,26772,3,24,8,0,0,0,0,6,384,94,26072,30227,31236,1,-32,-16,-919,-2,-1089,-4464,1,1,0,0,5
EUN1_3571955301',7,31,22,1,0,2,0,5,1,352,80,32674,29539,42059,5,23,12,0,0,0,0,6,293,94,27362,27968,32483,1,59,-14,5312,10,1571,9576,1,0,2,0,-1
EUN1_3571942492',5,45,14,2,0,1,0,6,0,365,90,28692,31476,36940,3,23,10,0,0,0,0,3,326,97,24606,27075,30150,1,39,-7,4086,4,4401,6790,2,0,1,0,3
EUN1_3570553976',3,27,5,1,0,0,0,11,1,338,78,23218,25552,27387,5,31,25,1,0,2,0,4,350,107,33890,32564,41762,0,-12,-29,-10672,-20,-7012,-14375,0,0,-2,0,7
EUN1_3570551566',5,28,18,1,1,0,0,12,1,336,94,29084,29997,41082,0,35,14,0,0,1,0,5,285,78,27359,27169,32054,1,51,16,1725,4,2828,9028,1,1,-1,0,7
EUN1_3575738283',7,27,13,1,0,0,0,11,0,346,104,28017,30591,27527,8,36,11,1,0,2,0,4,355,75,27564,28399,26503,1,-9,29,453,2,2192,1024,0,0,-2,0,7
EUN1_3575141588',4,25,19,0,0,1,0,9,0,323,74,29340,29876,40878,4,89,13,1,0,0,0,1,316,81,26940,28395,31679,1,7,-7,2400,6,1481,9199,-1,0,1,0,8
EUN1_3574649044',1,14,10,0,0,0,0,9,0,349,94,25528,30042,21277,5,30,13,2,0,1,0,1,382,84,28457,32093,33355,1,-33,10,-2929,-3,-2051,-12078,-2,0,-1,0,8
EUN1_3573844169',1,23,12,1,0,0,0,6,1,315,88,25917,27612,29303,2,24,19,0,0,1,0,2,358,84,29833,29939,40048,0,-43,4,-3916,-7,-2327,-10745,1,0,-1,0,4
EUN1_3573042601',1,135,23,1,0,3,0,9,0,349,76,32397,33260,46045,2,22,16,0,0,0,0,10,304,76,27703,29030,35085,0,45,0,4694,7,4230,10960,1,0,3,0,-1
EUN1_3572968722',2,300,8,1,0,0,0,10,0,332,87,24386,29744,30342,8,29,13,1,0,1,0,1,399,86,28169,30501,35094,0,-67,1,-3783,-5,-757,-4752,0,0,-1,0,9
EUN1_3572969425',3,26,3,1,0,0,0,7,1,359,100,22913,27496,20148,3,26,11,1,0,1,0,6,376,80,27216,30166,31763,0,-17,20,-4303,-8,-2670,-11615,0,0,-1,0,1
EUN1_3572699411',6,25,21,0,0,0,0,6,1,347,70,30881,32150,41795,1,40,12,1,0,0,0,2,285,90,25942,26588,28723,1,62,-20,4939,9,5562,13072,-1,0,0,0,4
EUN1_3569203733',3,23,9,0,0,0,0,11,0,344,89,27069,30693,31384,6,139,17,2,0,2,0,6,326,70,27841,29103,35352,0,18,19,-772,-8,1590,-3968,-2,0,-2,0,5
EUN1_3568898908',6,208,11,0,0,1,0,4,1,369,82,27289,29997,28560,4,29,4,2,0,0,0,6,342,90,22903,26656,27460,1,27,-8,4386,7,3341,1100,-2,0,1,0,-2
EUN1_3568899525',2,22,18,2,1,1,0,8,1,314,78,29402,28840,35682,4,27,5,0,0,0,0,5,328,78,23328,25947,25475,1,-14,0,6074,13,2893,10207,2,1,1,0,3
EUN1_3563808485',1,22,10,1,0,1,0,7,0,326,95,27623,28310,30159,3,77,14,1,0,0,0,8,331,112,27881,29357,31720,1,-5,-17,-258,-4,-1047,-1561,0,0,1,0,-1
EUN1_3560712022',3,168,15,2,1,1,0,3,1,400,106,31077,33741,36973,2,57,2,0,0,0,0,5,353,86,22120,26967,20636,1,47,20,8957,13,6774,16337,2,1,1,0,-2
EUN1_3560710299',3,27,9,1,0,0,0,7,1,295,102,25132,27464,27521,3,34,11,1,0,0,0,1,319,110,26741,29640,33124,1,-24,-8,-1609,-2,-2176,-5603,0,0,0,0,6
EUN1_3560380212',4,39,19,1,0,2,0,6,1,347,98,32575,30526,43305,6,36,14,1,0,1,0,9,313,79,28337,28965,34907,1,34,19,4238,5,1561,8398,0,0,1,0,-3
EUN1_3559207288',5,20,2,1,0,0,0,5,1,390,92,22642,29224,20860,5,39,4,0,0,0,0,2,333,80,21284,27465,19546,1,57,12,1358,-2,1759,1314,1,0,0,0,3
EUN1_3559146151',3,24,15,1,0,1,0,9,0,307,52,27361,27201,31133,1,135,25,0,0,2,0,5,336,96,33688,32070,42423,0,-29,-44,-6327,-10,-4869,-11290,1,0,-1,0,4
EUN1_3559123543',4,29,16,1,1,0,0,10,1,348,114,29679,31678,31472,6,269,10,0,0,0,0,6,359,70,25905,28757,31579,1,-11,44,3774,6,2921,-107,1,1,0,0,4
EUN1_3559062512',8,31,11,0,0,0,0,11,0,321,78,25974,27389,31069,3,24,20,2,0,2,0,2,340,98,32960,30217,36079,0,-19,-20,-6986,-9,-2828,-5010,-2,0,-2,0,9
EUN1_3559047900',9,27,21,1,0,0,0,8,0,361,86,30840,32017,37617,2,22,7,0,0,0,0,3,340,85,25230,27743,24219,1,21,1,5610,14,4274,13398,1,0,0,0,5
EUN1_3575899468',2,28,24,2,0,1,0,12,1,302,81,30754,31602,42537,4,27,14,0,0,1,0,1,337,70,28771,28557,36398,0,-35,11,1983,10,3045,6139,2,0,0,0,11
EUN1_3575885120',2,36,7,1,0,0,0,5,1,372,76,24503,27281,25191,5,31,14,1,0,0,0,3,328,96,27741,30890,31235,1,44,-20,-3238,-7,-3609,-6044,0,0,0,0,2
EUN1_3575865168',2,24,6,0,0,0,0,10,0,326,98,23125,29920,25467,9,25,7,2,0,1,0,1,387,96,26106,30206,23636,0,-61,2,-2981,-1,-286,1831,-2,0,-1,0,9
EUN1_3575843325',1,21,30,1,0,1,0,6,1,310,100,35231,31943,49716,10,33,19,0,0,0,0,5,306,72,30989,28522,41689,1,4,28,4242,11,3421,8027,1,0,1,0,1
EUN1_3575815818',5,45,14,1,0,1,0,6,1,400,94,29432,31988,37831,6,24,9,1,0,0,0,5,359,86,25402,29905,24521,1,41,8,4030,5,2083,13310,0,0,1,0,1
EUN1_3575794563',3,22,15,2,0,2,0,9,0,346,94,29266,31863,28743,5,26,8,0,0,1,0,4,368,94,26259,29707,26835,1,-22,0,3007,7,2156,1908,2,0,1,0,5
EUN1_3575782264',5,28,12,1,0,2,0,5,1,370,90,29920,29760,30464,2,19,11,1,0,0,0,7,317,90,24843,28053,26810,1,53,0,5077,1,1707,3654,0,0,2,0,-2
EUN1_3575764494',0,23,11,0,0,0,0,7,0,313,84,25422,27234,33190,3,29,28,1,0,0,0,1,372,123,32569,33603,49978,0,-59,-39,-7147,-17,-6369,-16788,-1,0,0,0,6
EUN1_3575742233',2,25,11,0,0,0,0,5,1,347,92,26848,28605,30986,4,26,13,2,0,1,0,2,308,83,26720,29338,27288,0,39,9,128,-2,-733,3698,-2,0,-1,0,3
EUN1_3575376255',3,28,11,2,0,0,0,16,1,368,98,28378,29565,31520,3,16,22,0,0,2,0,3,348,79,32137,31740,39591,0,20,19,-3759,-11,-2175,-8071,2,0,-2,0,13
EUN1_3575353419',1,62,22,1,0,0,0,4,0,330,90,30370,29714,45193,5,43,16,1,0,1,0,6,324,73,29407,28748,47634,1,6,17,963,6,966,-2441,0,0,-1,0,-2
EUN1_3575305749',5,153,15,1,0,0,0,11,0,328,91,27453,28433,36532,4,25,11,1,0,1,0,5,348,66,26954,28426,33259,1,-20,25,499,4,7,3273,0,0,-1,0,6
EUN1_3575287599',4,21,12,1,0,1,0,7,0,360,95,28014,30618,35110,6,28,13,1,0,0,0,5,337,88,27365,29837,31685,0,23,7,649,-1,781,3425,0,0,1,0,2
EUN1_3575268552',1,111,21,1,0,2,0,8,1,320,88,32614,31920,35016,6,29,13,1,0,0,0,8,330,68,26731,29263,33030,1,-10,20,5883,8,2657,1986,0,0,2,0,0
EUN1_3575253349',2,18,13,0,0,0,0,12,0,291,72,26285,28603,31687,1,22,24,1,0,0,0,1,336,82,31004,32678,42793,0,-45,-10,-4719,-11,-4075,-11106,-1,0,0,0,11
EUN1_3575230035',4,24,7,2,0,0,0,11,1,327,98,24390,28196,21457,2,25,8,0,1,0,0,2,347,85,24811,29037,20948,1,-20,13,-421,-1,-841,509,2,-1,0,0,9
EUN1_3575215497',4,23,7,1,0,0,0,9,0,376,80,24387,29675,22296,4,29,8,0,0,1,0,0,364,88,26570,28456,20517,1,12,-8,-2183,-1,1219,1779,1,0,-1,0,9
EUN1_3572726520',2,29,9,1,0,1,0,8,1,303,87,25918,28974,28213,0,26,6,0,0,1,0,6,371,72,24582,28209,24748,1,-68,15,1336,3,765,3465,1,0,0,0,2
EUN1_3572693291',3,31,21,1,0,0,0,4,0,337,75,30416,30120,41430,1,22,14,1,0,0,0,4,308,78,28367,26997,38204,1,29,-3,2049,7,3123,3226,0,0,0,0,0
EUN1_3572565857',4,29,9,0,0,2,0,9,1,343,72,26470,29356,27926,2,22,9,2,0,1,0,6,334,72,25300,29203,31289,0,9,0,1170,0,153,-3363,-2,0,1,0,3
EUN1_3568499253',5,22,11,0,0,0,0,11,1,365,79,26568,29255,30713,2,41,12,2,0,1,0,4,352,96,28181,29943,33247,0,13,-17,-1613,-1,-688,-2534,-2,0,-1,0,7
EUN1_3568482239',5,29,9,0,0,0,0,10,0,303,82,24951,29818,31214,4,38,22,1,0,2,0,2,346,99,32062,35123,37228,0,-43,-17,-7111,-13,-5305,-6014,-1,0,-2,0,8
EUN1_3564535578',3,25,15,1,0,0,0,3,0,350,90,28038,30452,36685,4,25,6,0,0,0,0,5,275,68,22294,24654,33380,1,75,22,5744,9,5798,3305,1,0,0,0,-2
EUN1_3564389051',3,27,12,1,0,0,0,4,1,361,90,27175,31145,32572,5,26,6,1,0,0,0,2,350,90,24445,28241,25135,1,11,0,2730,6,2904,7437,0,0,0,0,2
EUN1_3564287653',3,26,17,2,0,1,0,7,1,363,108,30582,31404,33487,2,20,7,0,0,0,0,9,301,68,22584,27139,22505,1,62,40,7998,10,4265,10982,2,0,1,0,-2
EUN1_3564271000',3,29,17,1,0,1,0,8,0,311,76,28263,29485,35709,2,28,14,0,0,1,0,7,343,80,28546,29967,35166,1,-32,-4,-283,3,-482,543,1,0,0,0,1
EUN1_3564263506',4,32,11,1,1,0,0,9,0,278,79,25847,26988,30159,5,23,20,1,0,1,0,2,352,98,31036,30281,34428,1,-74,-19,-5189,-9,-3293,-4269,0,1,-1,0,7
EUN1_3564252767',7,26,9,0,0,0,0,6,0,301,85,24674,26926,29669,4,28,14,2,0,1,0,2,323,90,28811,30250,36593,0,-22,-5,-4137,-5,-3324,-6924,-2,0,-1,0,4
EUN1_3564242350',4,23,4,1,0,0,0,5,0,402,102,23606,30729,25028,4,29,10,0,0,0,0,0,388,102,27674,31158,25084,1,14,0,-4068,-6,-429,-56,1,0,0,0,5
EUN1_3564072435',8,27,10,1,0,0,0,4,0,372,81,26505,27805,28337,3,47,12,0,0,1,0,4,310,78,26303,26631,26121,1,62,3,202,-2,1174,2216,1,0,-1,0,0
EUN1_3564044467',2,33,13,2,0,0,0,7,1,321,80,28139,28436,29953,2,24,8,0,0,0,0,3,324,100,24368,27996,20267,1,-3,-20,3771,5,440,9686,2,0,0,0,4
EUN1_3561929930',3,30,11,0,0,0,0,7,1,306,84,25975,25825,33721,4,30,11,1,0,1,0,7,292,68,25844,26821,33149,0,14,16,131,0,-996,572,-1,0,-1,0,0
EUN1_3561822316',1,28,6,0,0,0,0,7,0,340,76,24178,27280,32941,4,24,17,2,0,1,0,2,382,88,29913,31474,36083,0,-42,-12,-5735,-11,-4194,-3142,-2,0,-1,0,5
EUN1_3561797830',2,25,15,1,0,0,0,10,1,304,74,26952,28559,34955,2,28,14,1,0,1,0,1,297,104,27710,29440,40781,1,7,-30,-758,1,-881,-5826,0,0,-1,0,9
EUN1_3573794428',7,27,7,0,0,0,0,8,0,375,88,24364,28072,22739,6,25,13,1,1,1,0,1,414,100,29621,33192,31076,0,-39,-12,-5257,-6,-5120,-8337,-1,-1,-1,0,7
EUN1_3573774785',4,26,21,2,0,0,0,6,1,339,80,28860,32174,35751,1,22,12,0,0,0,0,2,365,86,27534,30020,34703,1,-26,-6,1326,9,2154,1048,2,0,0,0,4
EUN1_3573242695',8,31,16,1,0,1,0,3,1,366,82,31430,30677,39775,5,141,11,0,0,0,0,9,328,74,24331,26333,35300,1,38,8,7099,5,4344,4475,1,0,1,0,-6
EUN1_3573226227',3,31,19,2,0,1,0,13,1,332,84,28550,31273,36145,3,21,11,0,0,1,0,4,321,87,27433,29522,30870,1,11,-3,1117,8,1751,5275,2,0,0,0,9
EUN1_3573191266',5,50,7,1,0,0,0,7,1,335,92,24047,27777,30004,3,27,9,1,0,1,0,1,353,68,25915,28223,34286,1,-18,24,-1868,-2,-446,-4282,0,0,-1,0,6
EUN1_3571454391',7,29,11,0,0,0,0,4,0,369,76,26537,30018,26002,5,34,9,2,0,0,0,0,339,90,25134,28240,28610,0,30,-14,1403,2,1778,-2608,-2,0,0,0,4
EUN1_3571429674',3,27,10,1,0,0,0,10,0,333,56,25826,26015,26012,7,40,19,1,0,2,0,0,373,92,31386,29074,38354,0,-40,-36,-5560,-9,-3059,-12342,0,0,-2,0,10
EUN1_3571344747',5,28,12,1,0,2,0,7,1,365,84,27605,28367,28603,4,47,10,1,0,1,0,6,316,87,25981,29208,22465,1,49,-3,1624,2,-841,6138,0,0,1,0,1
EUN1_3571338389',3,24,7,0,0,0,0,14,0,323,60,22832,26481,20423,0,22,14,2,0,3,0,1,376,128,31484,32269,26789,0,-53,-68,-8652,-7,-5788,-6366,-2,0,-3,0,13
EUN1_3571319552',5,29,8,1,0,0,0,5,1,367,96,26404,30471,26636,2,32,7,0,0,1,0,4,327,52,23677,26677,28163,0,40,44,2727,1,3794,-1527,1,0,-1,0,1
EUN1_3575979900',2,29,18,0,0,1,0,6,1,362,78,29968,30875,36814,1,15,7,2,1,1,0,5,364,86,26023,29210,30847,0,-2,-8,3945,11,1665,5967,-2,-1,0,0,1
EUN1_3575958107',6,253,12,0,0,0,0,9,0,335,78,25852,27557,29809,2,20,11,2,0,0,0,2,328,94,26850,29331,35808,1,7,-16,-998,1,-1774,-5999,-2,0,0,0,7
EUN1_3575857997',5,33,13,0,0,1,0,12,0,310,68,27870,26739,38607,5,91,21,2,0,2,0,2,359,82,31948,31152,44778,0,-49,-14,-4078,-8,-4413,-6171,-2,0,-1,0,10
EUN1_3574959869',4,22,25,2,1,0,0,5,1,359,96,33646,33499,44458,4,31,11,0,0,2,0,9,275,68,25294,27041,29670,1,84,28,8352,14,6458,14788,2,1,-2,0,-4
EUN1_3574388652',6,21,11,1,0,1,0,12,0,342,76,26735,28809,36616,3,22,16,0,0,1,0,4,338,85,29168,29698,38030,1,4,-9,-2433,-5,-889,-1414,1,0,0,0,8
EUN1_3574364768',2,26,17,0,0,0,0,9,1,351,84,30371,30349,44358,4,27,16,2,0,1,0,2,349,79,27977,31227,36105,0,2,5,2394,1,-878,8253,-2,0,-1,0,7
EUN1_3574341812',4,23,9,0,1,0,0,8,1,342,84,24676,28369,28091,5,39,12,1,0,1,0,4,327,84,27288,29760,26073,1,15,0,-2612,-3,-1391,2018,-1,1,-1,0,4
EUN1_3573124253',2,32,8,0,1,0,0,6,1,400,94,26194,30997,26082,3,39,14,2,0,1,0,4,335,98,27770,31098,29423,0,65,-4,-1576,-6,-101,-3341,-2,1,-1,0,2
EUN1_3573095835',6,139,9,0,0,0,0,8,1,393,82,26278,29999,25886,6,28,5,1,0,0,0,4,380,73,24498,29249,21282,0,13,9,1780,4,750,4604,-1,0,0,0,4
EUN1_3572831294',0,25,10,1,0,1,0,17,1,298,62,25957,25975,27084,4,25,24,1,0,3,0,2,327,93,34083,30948,45949,0,-29,-31,-8126,-14,-4973,-18865,0,0,-2,0,15
EUN1_3572802166',4,87,16,1,0,0,0,12,1,274,66,27015,28090,38452,1,24,12,1,0,1,0,6,326,77,27872,28560,35201,1,-52,-11,-857,4,-470,3251,0,0,-1,0,6
EUN1_3572759045',5,25,13,1,0,1,0,11,0,360,102,28041,31208,29785,1,20,14,1,0,1,0,2,352,93,29416,30588,33009,0,8,9,-1375,-1,620,-3224,0,0,0,0,9
EUN1_3576195371',3,264,5,0,1,0,0,8,0,319,76,24067,28527,20737,8,27,18,2,0,1,0,3,386,104,31636,31639,36646,0,-67,-28,-7569,-13,-3112,-15909,-2,1,-1,0,5
EUN1_3576185207',1,56,9,0,0,0,0,11,1,326,94,25316,28134,28506,10,31,15,1,0,2,0,3,341,85,28512,31023,32171,0,-15,9,-3196,-6,-2889,-3665,-1,0,-2,0,8
EUN1_3576156927',3,23,25,2,0,2,0,10,1,367,90,33265,29287,48752,2,33,14,0,0,1,0,5,290,64,27771,27235,33047,1,77,26,5494,11,2052,15705,2,0,1,0,5
EUN1_3576144476',2,26,12,2,0,1,0,11,0,317,100,28206,31328,33350,2,23,16,0,0,0,0,6,337,66,27501,29929,34866,1,-20,34,705,-4,1399,-1516,2,0,1,0,5
EUN1_3576123291',3,26,13,1,0,1,0,12,0,300,91,26938,28825,31566,4,21,17,1,0,1,0,4,356,108,29457,31346,39234,0,-56,-17,-2519,-4,-2521,-7668,0,0,0,0,8
EUN1_3576004867',6,31,14,0,0,1,0,8,1,320,69,27345,30031,36179,6,29,9,2,0,0,0,3,319,90,24567,27808,26793,1,1,-21,2778,5,2223,9386,-2,0,1,0,5
EUN1_3575901549',3,25,19,1,1,3,0,4,1,332,108,32197,30874,40970,2,149,14,1,0,0,0,9,278,89,25534,28696,30124,1,54,19,6663,5,2178,10846,0,1,3,0,-5
EUN1_3575846879',3,33,14,1,0,1,0,11,0,349,62,28410,26834,35151,4,30,10,0,0,1,0,9,321,90,26887,26705,31793,0,28,-28,1523,4,129,3358,1,0,0,0,2
EUN1_3575826495',6,31,22,2,0,3,0,12,1,405,104,33034,34395,38943,3,19,7,0,0,2,0,7,289,92,24152,25954,26208,1,116,12,8882,15,8441,12735,2,0,1,0,5
EUN1_3575667968',6,34,4,1,0,0,0,9,1,329,87,22376,29206,22620,7,32,9,1,0,1,0,3,372,81,26607,30236,27023,0,-43,6,-4231,-5,-1030,-4403,0,0,-1,0,6
EUN1_3575666314',2,29,15,2,0,2,0,11,1,342,100,30766,30175,43485,2,20,17,0,0,1,0,10,295,80,28300,29205,31191,0,47,20,2466,-2,970,12294,2,0,1,0,1
EUN1_3575652752',3,40,12,0,0,0,0,14,1,305,58,24489,26931,32364,2,24,20,2,0,2,0,3,310,92,32563,29442,43084,0,-5,-34,-8074,-8,-2511,-10720,-2,0,-2,0,11
EUN1_3575646776',7,24,18,2,0,0,0,10,0,355,76,28875,31662,39302,5,26,7,0,0,2,0,5,337,84,25090,26679,28988,1,18,-8,3785,11,4983,10314,2,0,-2,0,5
EUN1_3575634892',4,25,18,1,1,2,0,7,1,383,87,30039,31107,35832,2,26,11,1,0,0,0,9,305,90,25127,27809,30002,1,78,-3,4912,7,3298,5830,0,1,2,0,-2
EUN1_3575628326',6,40,16,2,0,1,0,12,1,324,90,28112,27753,33862,2,28,7,0,0,1,0,4,293,76,23816,23597,29753,1,31,14,4296,9,4156,4109,2,0,0,0,8
EUN1_3575605589',3,46,10,1,0,0,0,1,0,374,76,26774,29228,30754,3,23,15,1,1,0,0,4,334,104,27862,30982,31913,1,40,-28,-1088,-5,-1754,-1159,0,-1,0,0,-3
EUN1_3575576991',2,23,16,0,0,1,0,7,1,314,81,26430,28829,30809,3,22,8,2,0,1,0,8,321,105,25127,28246,29147,1,-7,-24,1303,8,583,1662,-2,0,0,0,-1
EUN1_3576114172',3,22,23,1,0,0,0,7,0,364,74,31303,30758,38033,4,27,18,0,0,0,0,4,316,76,28945,27938,41576,1,48,-2,2358,5,2820,-3543,1,0,0,0,3
EUN1_3576087510',1,23,11,1,0,0,0,11,1,340,106,28020,30052,25908,6,24,15,0,0,1,0,1,417,94,29038,32338,27090,0,-77,12,-1018,-4,-2286,-1182,1,0,-1,0,10
EUN1_3575881670',3,28,18,0,0,0,0,10,1,292,70,27077,27222,43869,4,31,21,2,0,1,0,1,334,86,30904,32192,42885,1,-42,-16,-3827,-3,-4970,984,-2,0,-1,0,9
EUN1_3575869461',6,29,23,1,0,0,0,9,1,326,76,31805,31886,43987,1,24,13,1,0,2,0,4,299,92,27309,27670,34973,1,27,-16,4496,10,4216,9014,0,0,-2,0,5
EUN1_3575854395',1,18,23,2,1,3,0,8,0,326,67,32509,31313,46611,0,18,14,0,0,1,0,9,321,82,27398,28358,34586,0,5,-15,5111,9,2955,12025,2,1,2,0,-1
EUN1_3575841250',1,28,16,0,1,0,0,14,1,317,98,28835,28419,34481,10,29,14,1,0,2,0,3,368,91,30033,29138,32725,0,-51,7,-1198,2,-719,1756,-1,1,-2,0,11
EUN1_3575567708',6,27,7,0,0,0,0,6,0,340,85,24463,28615,27343,5,32,15,2,0,0,0,3,361,90,27759,31845,32792,0,-21,-5,-3296,-8,-3230,-5449,-2,0,0,0,3
EUN1_3575538544',4,40,13,1,0,0,0,9,0,334,79,26736,30484,36806,3,18,20,1,0,1,0,3,309,100,30397,31241,38272,0,25,-21,-3661,-7,-757,-1466,0,0,-1,0,6
EUN1_3574754341',3,37,11,1,0,1,0,8,1,334,66,26423,28572,38758,5,43,11,1,0,0,0,5,301,80,25101,29229,29390,0,33,-14,1322,0,-657,9368,0,0,1,0,3
EUN1_3571525698',1,24,15,1,0,0,0,2,0,371,110,29876,31167,32666,2,24,11,0,0,0,0,4,321,106,26208,28505,24214,1,50,4,3668,4,2662,8452,1,0,0,0,-2
EUN1_3571498058',1,23,6,0,0,0,0,10,0,285,73,22610,25370,20759,3,28,14,1,0,1,0,0,366,82,27468,28636,31167,0,-81,-9,-4858,-8,-3266,-10408,-1,0,-1,0,10
EUN1_3570540482',8,31,24,1,0,0,0,7,0,298,66,30666,28287,41569,1,21,15,0,0,1,0,0,334,58,28047,25909,36782,1,-36,8,2619,9,2378,4787,1,0,-1,0,7
EUN1_3575950815',1,15,14,1,0,0,0,15,0,345,91,29506,30319,34249,0,21,14,1,0,3,0,2,345,108,29662,28970,37688,1,0,-17,-156,0,1349,-3439,0,0,-3,0,13
EUN1_3575937354',6,161,15,1,0,2,0,9,1,335,80,30012,28329,32752,6,29,7,0,0,1,0,11,331,77,24530,27863,26306,1,4,3,5482,8,466,6446,1,0,1,0,-2
EUN1_3573845290',2,32,8,1,0,1,0,11,1,356,73,25846,27210,27804,4,28,16,0,0,0,0,1,337,94,27812,29088,30384,0,19,-21,-1966,-8,-1878,-2580,1,0,1,0,10
EUN1_3573745924',2,30,24,0,0,0,0,11,1,339,91,29937,32437,38777,1,16,7,1,0,0,0,2,370,92,26313,29452,35920,0,-31,-1,3624,17,2985,2857,-1,0,0,0,9
EUN1_3573723885',1,15,7,0,0,0,0,13,0,347,104,24764,30708,26982,3,29,17,1,0,3,0,1,357,75,30963,31385,40013,0,-10,29,-6199,-10,-677,-13031,-1,0,-3,0,12
EUN1_3573463105',3,35,10,2,0,0,0,9,1,301,90,24661,26369,32833,5,30,10,0,0,0,0,2,373,75,26744,30801,34521,1,-72,15,-2083,0,-4432,-1688,2,0,0,0,7
EUN1_3573428983',5,31,14,0,0,0,0,11,0,348,84,27635,29014,29746,5,34,21,1,0,1,0,1,343,56,31124,28084,38258,0,5,28,-3489,-7,930,-8512,-1,0,-1,0,10
EUN1_3569179058',2,23,19,1,0,1,0,11,0,319,78,31111,31155,36431,3,26,13,1,0,3,0,8,336,98,28508,29229,38221,1,-17,-20,2603,6,1926,-1790,0,0,-2,0,3
EUN1_3569156817',3,30,11,1,0,1,0,9,1,386,84,28229,29658,26509,5,34,7,1,0,0,0,5,392,92,25205,29309,23747,0,-6,-8,3024,4,349,2762,0,0,1,0,4
EUN1_3569140282',9,351,19,1,0,3,0,7,0,320,70,31442,27858,43357,1,50,16,0,0,0,0,9,258,55,25824,24731,36899,1,62,15,5618,3,3127,6458,1,0,3,0,-2
EUN1_3569083546',7,25,17,1,0,0,0,7,1,312,74,27543,28934,32717,3,25,13,0,0,1,0,2,317,62,27391,28207,33397,0,-5,12,152,4,727,-680,1,0,-1,0,5
EUN1_3569066286',4,31,14,0,0,2,0,9,0,349,60,29075,30283,39922,3,20,16,2,0,1,0,10,349,92,29156,31165,35189,1,0,-32,-81,-2,-882,4733,-2,0,1,0,-1
EUN1_3576239540',4,27,5,2,0,1,0,4,1,416,82,25268,29911,16941,3,35,4,0,1,0,0,1,370,134,24151,30639,18394,0,46,-52,1117,1,-728,-1453,2,-1,1,0,3
EUN1_3576120488',7,32,19,0,0,0,0,10,0,288,104,28548,30625,34950,2,36,16,0,0,1,0,2,345,92,28946,29556,40404,1,-57,12,-398,3,1069,-5454,0,0,-1,0,8
EUN1_3576093906',2,34,20,2,0,2,0,6,1,395,108,32861,31919,42814,6,29,8,0,0,1,0,7,365,75,24966,29030,28607,1,30,33,7895,12,2889,14207,2,0,1,0,-1
EUN1_3576084311',1,27,12,0,0,1,0,10,0,335,88,27332,27349,35270,3,35,14,2,0,0,0,4,318,116,28727,29943,32374,0,17,-28,-1395,-2,-2594,2896,-2,0,1,0,6
EUN1_3576041256',6,28,10,1,0,0,0,7,1,313,102,25600,28209,28826,3,35,16,0,0,0,0,3,318,74,27052,27525,32671,0,-5,28,-1452,-6,684,-3845,1,0,0,0,4
EUN1_3576008467',4,23,17,0,0,0,0,6,1,321,91,28087,27901,31051,3,30,13,1,0,1,0,4,367,78,27672,28880,27681,0,-46,13,415,4,-979,3370,-1,0,-1,0,2
EUN1_3575913733',5,41,9,2,0,0,0,6,1,364,96,25556,29274,29847,7,36,10,0,1,0,0,2,341,76,26075,29801,31023,1,23,20,-519,-1,-527,-1176,2,-1,0,0,4
EUN1_3575905180',1,25,9,0,0,0,0,11,0,315,60,24008,26295,25706,2,21,17,1,0,2,0,0,382,115,30560,32074,29697,0,-67,-55,-6552,-8,-5779,-3991,-1,0,-2,0,11
EUN1_3575480596',5,66,11,0,0,0,0,14,0,385,88,27547,30375,36558,5,60,19,2,0,1,0,2,322,105,30654,32490,35725,0,63,-17,-3107,-8,-2115,833,-2,0,-1,0,12
EUN1_3575453434',7,288,12,1,0,0,0,3,1,363,96,26415,29922,30602,1,39,13,1,0,0,0,2,312,76,25533,29358,30169,0,51,20,882,-1,564,433,0,0,0,0,1
EUN1_3575415516',3,82,13,1,0,2,0,7,1,354,68,30960,28949,29406,2,24,15,1,0,0,0,5,333,100,28157,30792,34015,1,21,-32,2803,-2,-1843,-4609,0,0,2,0,2
EUN1_3575392760',4,35,18,1,1,1,0,11,0,334,85,30990,30145,39195,7,37,12,0,0,2,0,7,342,78,28480,28811,32683,1,-8,7,2510,6,1334,6512,1,1,-1,0,4
EUN1_3575376670',3,24,14,0,0,0,0,13,1,326,70,26953,28090,30983,3,35,12,2,0,3,0,0,402,98,30202,30009,35512,0,-76,-28,-3249,2,-1919,-4529,-2,0,-3,0,13
EUN1_3575355904',6,94,14,0,0,0,0,14,1,306,89,27898,28601,33601,2,33,16,1,0,1,0,1,358,74,28578,29486,36933,0,-52,15,-680,-2,-885,-3332,-1,0,-1,0,13
EUN1_3575344643',2,19,11,0,0,0,0,13,1,268,72,26677,26065,29336,4,25,31,2,0,5,0,3,393,100,38784,35392,42670,0,-125,-28,-12107,-20,-9327,-13334,-2,0,-5,0,10
EUN1_3575325548',4,37,12,1,0,0,0,9,0,372,80,26048,29995,32105,2,18,11,1,0,0,0,1,302,89,25344,28307,34103,1,70,-9,704,1,1688,-1998,0,0,0,0,8
EUN1_3575306221',6,30,12,1,0,2,0,7,1,394,80,29995,30093,28450,6,45,9,1,0,0,0,12,359,80,25695,28290,33902,1,35,0,4300,3,1803,-5452,0,0,2,0,-5
EUN1_3575290163',4,41,15,1,0,0,0,10,1,303,74,28458,28970,37392,4,24,18,0,0,1,0,4,352,104,29070,30078,46652,1,-49,-30,-612,-3,-1108,-9260,1,0,-1,0,6
EUN1_3576229981',3,18,9,0,1,1,0,8,1,359,116,27793,31801,30559,4,27,11,1,0,0,0,6,330,88,24811,28584,27459,1,29,28,2982,-2,3217,3100,-1,1,1,0,2
EUN1_3576222562',4,89,13,0,0,0,0,11,1,296,94,25994,29472,27848,0,65,12,1,0,3,0,1,362,97,30091,30397,32115,1,-66,-3,-4097,1,-925,-4267,-1,0,-3,0,10
EUN1_3576216016',2,25,13,1,0,0,0,5,1,355,84,26825,29269,30365,2,24,9,1,0,1,0,5,337,56,24205,27083,29152,0,18,28,2620,4,2186,1213,0,0,-1,0,0
EUN1_3576210783',2,59,15,1,0,1,0,8,1,338,82,29510,28206,34285,1,21,16,1,0,1,0,3,321,73,26782,29561,32132,1,17,9,2728,-1,-1355,2153,0,0,0,0,5
EUN1_3575910901',3,25,11,0,0,0,0,10,0,286,95,25114,29246,27210,5,30,15,1,0,2,0,1,388,76,29364,30718,35832,0,-102,19,-4250,-4,-1472,-8622,-1,0,-2,0,9
EUN1_3575902504',5,26,18,1,0,1,0,14,1,285,86,30367,27064,35761,3,19,30,0,0,2,0,1,323,97,36129,31786,41845,0,-38,-11,-5762,-12,-4722,-6084,1,0,-1,0,13
EUN1_3575878798',3,20,15,2,1,1,0,8,0,345,78,29002,29462,30969,3,23,15,0,0,0,0,4,322,114,29268,31029,33487,1,23,-36,-266,0,-1567,-2518,2,1,1,0,4
EUN1_3575859670',7,20,10,0,1,0,0,14,1,348,92,26499,30229,26403,3,206,16,2,0,3,0,3,347,104,30404,31041,35906,0,1,-12,-3905,-6,-812,-9503,-2,1,-3,0,11
EUN1_3575755639',3,28,11,1,0,0,0,7,1,393,82,27200,31053,27755,4,29,7,1,0,0,0,4,349,75,23626,26689,21392,1,44,7,3574,4,4364,6363,0,0,0,0,3
EUN1_3575736990',4,286,17,1,0,1,0,6,1,350,62,29410,30512,39660,2,21,20,0,0,0,0,6,300,77,28626,31266,39125,0,50,-15,784,-3,-754,535,1,0,1,0,0
EUN1_3575739197',4,23,23,1,0,1,0,9,0,387,84,32687,31823,42011,5,32,8,0,0,1,0,4,292,68,23564,26157,27799,1,95,16,9123,15,5666,14212,1,0,0,0,5
EUN1_3575712543',4,27,18,2,0,0,0,8,1,363,104,31323,33076,32896,0,21,7,0,1,3,0,4,342,88,25858,28783,27108,1,21,16,5465,11,4293,5788,2,-1,-3,0,4
EUN1_3575697938',3,31,8,2,0,0,0,7,0,408,104,26767,30678,23997,5,224,7,0,0,0,0,3,388,74,25160,28280,24563,1,20,30,1607,1,2398,-566,2,0,0,0,4
EUN1_3575696740',4,23,16,1,0,1,0,10,1,365,100,29687,30810,35585,2,41,13,1,0,0,0,5,363,88,28036,29850,38556,1,2,12,1651,3,960,-2971,0,0,1,0,5
EUN1_3567067814',1,26,10,1,0,0,0,12,0,344,79,25912,29420,24032,5,28,19,1,0,1,0,2,396,81,32005,32760,32711,0,-52,-2,-6093,-9,-3340,-8679,0,0,-1,0,10
EUN1_3567051053',1,28,14,2,0,1,0,6,1,381,96,28409,30211,33019,4,239,4,0,0,0,0,5,294,83,22279,25328,22545,1,87,13,6130,10,4883,10474,2,0,1,0,1
EUN1_3566930581',3,20,10,1,0,0,0,10,0,351,88,25662,29146,22648,4,136,12,1,0,2,0,5,329,87,28073,29341,27377,1,22,1,-2411,-2,-195,-4729,0,0,-2,0,5
EUN1_3566910194',5,22,14,0,0,0,0,11,0,333,76,27488,30014,29724,5,20,13,1,0,1,0,3,348,92,29487,30279,36582,1,-15,-16,-1999,1,-265,-6858,-1,0,-1,0,8
EUN1_3566618714',6,25,15,0,0,0,0,5,0,350,64,27583,29241,33271,4,45,16,1,0,1,0,5,352,108,28848,31403,40528,1,-2,-44,-1265,-1,-2162,-7257,-1,0,-1,0,0
EUN1_3566601521',1,29,13,1,0,0,0,11,0,303,102,26692,27924,36630,4,28,17,1,0,1,0,2,333,75,29618,29879,35935,0,-30,27,-2926,-4,-1955,695,0,0,-1,0,9
EUN1_3566579485',3,31,17,1,0,0,0,4,1,331,70,28394,29336,33509,4,29,6,0,0,0,0,3,290,90,23553,25654,26399,1,41,-20,4841,11,3682,7110,1,0,0,0,1
EUN1_3566548463',4,32,14,2,0,2,0,6,1,338,84,29151,29156,35991,3,22,12,0,0,0,0,7,325,84,25912,27896,26801,0,13,0,3239,2,1260,9190,2,0,2,0,-1
EUN1_3566540145',2,29,12,0,0,0,0,6,1,320,92,27188,30464,32777,6,27,14,2,0,0,0,3,310,64,26621,28043,29813,1,10,28,567,-2,2421,2964,-2,0,0,0,3
EUN1_3566528308',2,40,6,1,0,0,0,8,0,321,79,22594,28953,23278,3,25,8,0,0,0,0,0,365,104,26103,31244,25839,0,-44,-25,-3509,-2,-2291,-2561,1,0,0,0,8
EUN1_3566522288',3,25,5,1,0,0,0,9,0,321,84,23024,28520,26111,3,25,13,0,0,0,0,0,405,92,28656,31463,33230,0,-84,-8,-5632,-8,-2943,-7119,1,0,0,0,9
EUN1_3566445327',4,30,17,1,0,0,0,3,1,327,76,29240,29472,34202,3,30,6,1,1,0,0,6,331,79,23544,27854,25595,1,-4,-3,5696,11,1618,8607,0,-1,0,0,-3
EUN1_3566426923',7,33,13,1,0,0,0,10,0,360,74,28317,28654,33103,2,26,18,1,0,1,0,3,336,66,28058,28395,32673,1,24,8,259,-5,259,430,0,0,-1,0,7
EUN1_3573328989',4,38,13,2,0,1,0,9,0,367,90,29244,32163,31718,1,244,12,0,0,0,0,6,371,80,27984,29029,28308,1,-4,10,1260,1,3134,3410,2,0,1,0,3
EUN1_3573310899',2,35,10,0,0,1,0,8,0,351,79,26168,28977,29901,5,23,16,2,0,1,0,5,300,105,27828,30173,31775,0,51,-26,-1660,-6,-1196,-1874,-2,0,0,0,3
EUN1_3573236765',3,29,8,0,1,0,0,5,0,296,84,24560,27005,21540,4,36,13,2,0,1,0,4,334,88,26841,27225,29348,0,-38,-4,-2281,-5,-220,-7808,-2,1,-1,0,1
EUN1_3573217624',1,357,14,0,0,0,0,17,1,296,72,28123,27727,37127,0,34,28,1,1,2,0,2,319,80,35374,33016,53328,0,-23,-8,-7251,-14,-5289,-16201,-1,-1,-2,0,15
EUN1_3573140285',3,44,16,2,0,0,0,6,1,323,86,27891,28319,35480,5,26,14,0,0,0,0,4,289,68,26374,26225,29379,0,34,18,1517,2,2094,6101,2,0,0,0,2
EUN1_3572724476',4,78,13,2,0,0,0,7,1,385,88,27355,31370,31312,0,63,4,0,0,1,0,1,393,84,24566,28024,25419,1,-8,4,2789,9,3346,5893,2,0,-1,0,6
EUN1_3572678710',3,16,10,2,0,0,0,8,1,304,90,24635,27685,27595,2,59,17,0,0,2,0,1,383,84,31246,31408,38144,0,-79,6,-6611,-7,-3723,-10549,2,0,-2,0,7
EUN1_3572245346',4,27,17,1,0,0,0,10,1,281,96,27855,26752,33760,5,28,22,1,0,1,0,0,317,76,31869,29512,39730,0,-36,20,-4014,-5,-2760,-5970,0,0,-1,0,10
EUN1_3572195902',2,24,11,2,0,0,0,7,0,342,67,27160,28413,35681,8,189,16,0,1,1,0,7,329,96,27835,30339,31504,1,13,-29,-675,-5,-1926,4177,2,-1,-1,0,0
EUN1_3572130342',4,34,20,1,0,1,0,6,0,372,103,33140,33547,43230,6,29,13,1,0,2,0,10,302,60,25749,25668,32225,1,70,43,7391,7,7879,11005,0,0,-1,0,-4
EUN1_3571680960',1,19,15,0,0,0,0,7,1,352,72,29172,30891,34931,3,20,10,1,0,1,0,7,300,76,25276,26996,28837,0,52,-4,3896,5,3895,6094,-1,0,-1,0,0
EUN1_3571603591',3,23,8,0,0,0,0,8,0,322,70,24560,28193,28944,1,34,19,2,0,0,0,2,367,82,28844,30672,34851,0,-45,-12,-4284,-11,-2479,-5907,-2,0,0,0,6
EUN1_3571542691',3,20,17,0,0,1,0,8,0,333,82,30793,30074,32236,3,26,18,1,0,1,0,5,296,94,28419,30504,35423,0,37,-12,2374,-1,-430,-3187,-1,0,0,0,3
EUN1_3571459896',5,38,11,1,0,0,0,9,0,322,95,26685,28835,23470,2,37,11,1,1,1,0,3,357,88,25922,29342,27891,0,-35,7,763,0,-507,-4421,0,-1,-1,0,6
EUN1_3571076028',7,41,12,1,0,0,0,8,1,351,86,26133,28012,33518,4,29,12,0,0,1,0,1,351,86,28291,28536,32123,1,0,0,-2158,0,-524,1395,1,0,-1,0,7
EUN1_3571047579',2,22,22,0,0,0,0,4,0,345,78,30241,29167,37526,3,52,11,1,0,0,0,5,300,53,24988,25122,31825,1,45,25,5253,11,4045,5701,-1,0,0,0,-1
EUN1_3570953064',3,37,13,0,0,0,0,10,0,356,88,28264,29869,34690,1,28,14,1,0,0,0,2,328,70,27139,29260,25282,0,28,18,1125,-1,609,9408,-1,0,0,0,8
EUN1_3570897937',6,31,14,0,0,1,0,4,1,375,90,27840,29751,27471,8,50,14,1,0,0,0,1,365,81,27791,30530,35405,0,10,9,49,0,-779,-7934,-1,0,1,0,3
EUN1_3570865998',4,28,16,2,0,1,0,7,0,356,78,29041,29236,37288,4,27,13,0,0,1,0,3,304,82,26279,26802,38982,0,52,-4,2762,3,2434,-1694,2,0,0,0,4
EUN1_3570830820',3,38,7,0,0,0,0,10,0,336,68,24766,28069,22334,8,76,16,1,0,2,0,7,354,86,29504,30483,39492,0,-18,-18,-4738,-9,-2414,-17158,-1,0,-2,0,3
EUN1_3575062935',4,38,18,1,0,0,0,9,0,341,73,29755,29191,33958,2,27,16,1,0,2,0,4,354,78,29814,28959,36398,1,-13,-5,-59,2,232,-2440,0,0,-2,0,5
EUN1_3575047744',4,44,12,0,0,0,0,11,0,321,108,27471,28565,31538,4,22,24,2,0,0,0,4,364,96,32163,33460,35951,0,-43,12,-4692,-12,-4895,-4413,-2,0,0,0,7
EUN1_3574852518',9,38,13,0,0,0,0,9,0,383,86,27313,31514,38416,4,35,9,2,0,2,0,3,348,82,26706,30007,29109,0,35,4,607,4,1507,9307,-2,0,-2,0,6
EUN1_3574808673',6,32,15,2,0,0,0,6,1,322,90,27994,31003,29528,2,30,7,0,0,0,0,4,329,66,24008,27954,27789,0,-7,24,3986,8,3049,1739,2,0,0,0,2
EUN1_3574735361',8,30,17,0,0,1,0,6,1,312,88,29942,29989,30276,4,84,10,2,0,0,0,5,311,80,23873,27309,25575,1,1,8,6069,7,2680,4701,-2,0,1,0,1
EUN1_3574710062',5,28,23,1,0,1,0,4,1,339,88,30939,28963,41881,3,31,11,0,0,0,0,5,311,83,25709,26260,37549,1,28,5,5230,12,2703,4332,1,0,1,0,-1
EUN1_3572201881',5,29,9,1,0,1,0,12,1,336,68,25724,28737,28650,5,26,12,1,0,2,0,3,361,84,27912,29540,28911,1,-25,-16,-2188,-3,-803,-261,0,0,-1,0,9
EUN1_3572175175',3,26,9,1,0,0,0,7,1,344,96,25846,30114,27523,3,23,17,1,0,0,0,3,342,78,27603,29457,33130,0,2,18,-1757,-8,657,-5607,0,0,0,0,4
EUN1_3572135661',4,49,14,0,0,0,0,7,1,279,68,25086,26682,29403,2,278,8,2,0,1,0,2,366,79,26576,27845,34208,0,-87,-11,-1490,6,-1163,-4805,-2,0,-1,0,5
EUN1_3571787339',6,32,11,1,0,1,0,8,1,351,88,27859,29931,31462,7,219,8,1,0,0,0,6,342,84,24811,29114,28529,1,9,4,3048,3,817,2933,0,0,1,0,2
EUN1_3571757622',3,172,13,1,0,0,0,14,0,288,93,27437,28481,33536,5,32,18,1,0,1,0,0,318,86,29440,27947,36328,1,-30,7,-2003,-5,534,-2792,0,0,-1,0,14
EUN1_3571568281',0,24,11,0,0,1,0,7,0,298,93,26240,28729,29228,1,83,15,2,1,0,0,4,335,90,28246,30814,35155,0,-37,3,-2006,-4,-2085,-5927,-2,-1,1,0,3
EUN1_3568463833',2,24,21,2,1,2,0,6,0,337,85,32085,31730,40719,2,53,18,0,0,1,0,10,338,82,29791,31321,39116,0,-1,3,2294,3,409,1603,2,1,1,0,-4
EUN1_3567750184',3,19,15,0,1,2,0,13,0,315,95,29755,30430,40283,2,32,10,1,0,1,0,10,335,85,27139,29142,41191,1,-20,10,2616,5,1288,-908,-1,1,1,0,3
EUN1_3567697378',2,22,22,0,0,2,0,5,1,304,86,33619,28652,55075,1,25,17,2,0,0,0,7,304,64,27851,28678,38543,0,0,22,5768,5,-26,16532,-2,0,2,0,-2
EUN1_3575363260',2,22,19,1,0,2,0,5,1,318,81,31752,32082,39143,6,23,14,1,0,0,0,7,279,64,24998,25752,31718,1,39,17,6754,5,6330,7425,0,0,2,0,-2
EUN1_3575307006',1,137,6,1,0,0,0,12,0,343,98,24130,29525,20179,3,28,7,1,0,2,0,3,388,90,27548,29681,24037,0,-45,8,-3418,-1,-156,-3858,0,0,-2,0,9
EUN1_3575285810',5,33,14,0,0,0,0,8,0,359,96,28921,31738,38952,4,19,14,2,0,0,0,4,353,104,27046,30894,28747,1,6,-8,1875,0,844,10205,-2,0,0,0,4
EUN1_3575254990',3,29,12,1,0,0,0,9,0,353,94,26369,30050,39959,3,139,10,1,0,0,0,2,306,81,25563,27797,35625,1,47,13,806,2,2253,4334,0,0,0,0,7
EUN1_3574251083',2,25,16,0,0,1,0,5,1,383,69,28947,31870,39165,4,27,11,2,0,0,0,2,310,98,24724,29519,29228,1,73,-29,4223,5,2351,9937,-2,0,1,0,3
EUN1_3574231401',3,24,11,2,1,2,0,8,1,355,120,28685,32435,35475,3,23,9,0,0,1,0,3,371,76,25227,29297,27401,1,-16,44,3458,2,3138,8074,2,1,1,0,5
EUN1_3574011230',2,23,9,0,0,0,0,8,0,315,97,24644,29258,22184,2,24,6,2,0,1,0,1,396,87,26065,28653,21845,0,-81,10,-1421,3,605,339,-2,0,-1,0,7
EUN1_3573982636',5,27,7,0,0,0,0,8,1,331,86,24365,29227,27407,4,25,11,1,0,1,0,1,372,102,28602,31758,26721,0,-41,-16,-4237,-4,-2531,686,-1,0,-1,0,7
EUN1_3573948816',4,45,11,1,0,1,0,5,0,383,102,27693,32253,27744,9,36,9,1,0,0,0,7,352,94,25571,29657,27501,1,31,8,2122,2,2596,243,0,0,1,0,-2
EUN1_3573849918',1,45,7,1,0,0,0,9,0,322,90,23836,26713,29940,3,24,15,1,0,0,0,1,308,86,26153,30213,33593,0,14,4,-2317,-8,-3500,-3653,0,0,0,0,8
EUN1_3573030009',2,17,5,0,0,0,0,11,0,372,92,23135,29212,24872,7,34,11,1,0,1,0,1,382,100,28426,30701,32555,0,-10,-8,-5291,-6,-1489,-7683,-1,0,-1,0,10
EUN1_3571878449',3,152,19,1,0,0,0,7,1,340,64,29959,28323,38120,6,29,12,0,0,1,0,5,322,74,27494,26506,37440,1,18,-10,2465,7,1817,680,1,0,-1,0,2
EUN1_3571823519',4,141,18,2,1,2,0,8,0,332,94,31319,32480,38855,2,21,17,0,0,0,0,5,370,97,30530,31377,34671,1,-38,-3,789,1,1103,4184,2,1,2,0,3
EUN1_3571201038',1,22,11,0,0,1,0,5,1,364,78,26604,29473,25191,3,29,8,1,0,0,0,4,327,86,24098,27435,29070,1,37,-8,2506,3,2038,-3879,-1,0,1,0,1
EUN1_3571180715',1,41,10,0,0,1,0,6,1,357,92,27589,29987,29735,6,26,12,2,0,1,0,4,364,68,26205,29570,33226,0,-7,24,1384,-2,417,-3491,-2,0,0,0,2
EUN1_3571353075',2,58,12,2,0,2,0,11,1,346,88,28076,31477,32263,1,61,7,0,0,0,0,9,365,87,24666,30188,34559,1,-19,1,3410,5,1289,-2296,2,0,2,0,2
EUN1_3569964648',3,32,14,0,1,2,0,7,1,368,108,30389,31172,38436,5,23,8,2,0,0,0,7,365,88,25243,28352,27430,1,3,20,5146,6,2820,11006,-2,1,2,0,0
EUN1_3569955817',7,205,18,1,1,3,0,4,1,372,106,31759,32173,31953,2,25,7,1,0,0,0,9,341,86,24713,27903,20245,1,31,20,7046,11,4270,11708,0,1,3,0,-5
EUN1_3569941958',2,19,16,1,0,0,0,10,1,321,80,28965,29433,34834,3,315,10,1,0,1,0,5,349,87,27143,30738,28730,1,-28,-7,1822,6,-1305,6104,0,0,-1,0,5
EUN1_3568841805',2,27,13,1,0,0,0,10,0,327,82,26401,30832,32324,2,36,11,1,0,1,0,2,328,66,26552,28154,32283,1,-1,16,-151,2,2678,41,0,0,-1,0,8
EUN1_3568825159',4,26,9,1,1,0,0,10,1,356,74,24515,27902,25953,3,31,12,0,0,1,0,1,355,94,28164,29903,29569,1,1,-20,-3649,-3,-2001,-3616,1,1,-1,0,9
EUN1_3568507899',3,24,11,1,0,0,0,7,0,309,78,25694,27215,30860,0,19,17,1,0,1,0,3,319,94,29623,29774,34280,0,-10,-16,-3929,-6,-2559,-3420,0,0,-1,0,4
EUN1_3568489810',4,25,9,1,0,1,0,7,1,359,92,27565,28531,26984,4,28,6,1,0,0,0,3,355,88,24352,29634,26344,0,4,4,3213,3,-1103,640,0,0,1,0,4
EUN1_3568346158',4,23,8,1,0,0,0,7,0,343,96,25009,28161,27076,4,25,10,1,0,0,0,2,325,82,25447,28652,29363,0,18,14,-438,-2,-491,-2287,0,0,0,0,5
EUN1_3568075243',3,23,9,2,0,0,0,4,1,359,78,25497,28703,32527,3,91,7,0,0,0,0,4,340,106,24722,29158,21006,1,19,-28,775,2,-455,11521,2,0,0,0,0
EUN1_3567421381',3,74,16,0,0,2,0,5,1,365,72,30486,28957,34831,3,31,10,1,0,1,0,7,275,76,26071,27059,35369,1,90,-4,4415,6,1898,-538,-1,0,1,0,-2
EUN1_3576021868',3,19,10,0,0,1,0,3,1,386,95,27298,29084,29557,1,470,8,2,0,0,0,5,370,96,25436,29416,25783,1,16,-1,1862,2,-332,3774,-2,0,1,0,-2
EUN1_3575991944',1,22,3,0,0,0,0,8,0,384,71,23043,29913,17190,4,148,11,2,1,0,0,0,391,131,27262,31958,28103,0,-7,-60,-4219,-8,-2045,-10913,-2,-1,0,0,8
EUN1_3575214206',5,30,13,0,0,1,0,8,0,348,66,26866,26983,33540,7,30,11,2,0,0,0,3,286,70,24781,25980,28502,1,62,-4,2085,2,1003,5038,-2,0,1,0,5
EUN1_3574865479',2,25,18,2,0,0,0,6,1,376,84,30468,31355,41177,3,29,14,0,0,1,0,4,354,99,28876,31531,27367,1,22,-15,1592,4,-176,13810,2,0,-1,0,2
EUN1_3574851298',5,42,17,2,0,2,0,7,1,348,100,30677,31082,29584,1,24,7,0,0,0,0,6,345,84,24885,28596,29809,1,3,16,5792,10,2486,-225,2,0,2,0,1
EUN1_3574836181',2,26,17,1,0,0,0,7,1,371,50,28529,28767,30680,4,32,7,1,0,1,0,4,281,74,22836,25983,26974,1,90,-24,5693,10,2784,3706,0,0,-1,0,3
EUN1_3574364455',3,37,15,1,0,2,0,6,1,323,119,29003,29442,33633,1,23,11,0,0,1,0,4,323,72,26427,27071,27496,1,0,47,2576,4,2371,6137,1,0,1,0,2
EUN1_3574209972',1,23,7,0,0,0,0,13,0,346,67,24393,26560,25602,4,23,21,2,0,3,0,1,409,114,35266,34363,44071,0,-63,-47,-10873,-14,-7803,-18469,-2,0,-3,0,12
EUN1_3574189733',2,45,15,1,0,0,0,6,1,318,80,27876,27008,30608,5,29,16,1,1,1,0,6,319,80,28928,30022,37262,0,-1,0,-1052,-1,-3014,-6654,0,-1,-1,0,0
EUN1_3574170792',2,78,10,2,0,0,0,6,1,330,105,26153,29346,25499,4,25,8,0,0,0,0,5,361,70,25585,28898,30436,1,-31,35,568,2,448,-4937,2,0,0,0,1
EUN1_3573586865',1,42,3,0,0,0,0,8,0,334,85,22000,27352,20720,4,34,14,2,0,0,0,1,395,109,29168,32792,32292,0,-61,-24,-7168,-11,-5440,-11572,-2,0,0,0,7
EUN1_3573574504',2,26,6,2,0,0,0,11,0,326,79,23564,27724,26257,1,24,15,0,1,2,0,1,359,100,28850,31528,29288,0,-33,-21,-5286,-9,-3804,-3031,2,-1,-2,0,10
EUN1_3573050963',5,20,9,1,0,0,0,14,1,316,81,24811,24927,27243,2,443,20,1,1,3,0,2,343,107,32682,30715,35626,0,-27,-26,-7871,-11,-5788,-8383,0,-1,-3,0,12
EUN1_3572498961',3,20,16,1,0,1,0,12,0,324,85,28547,29511,37060,3,19,15,1,0,1,0,5,308,79,29155,27506,36446,0,16,6,-608,1,2005,614,0,0,0,0,7
EUN1_3572192417',3,26,10,1,0,0,0,3,1,305,93,24624,26825,33903,2,87,8,1,0,1,0,0,375,102,25591,29022,29289,0,-70,-9,-967,2,-2197,4614,0,0,-1,0,3
EUN1_3572104110',3,57,10,1,1,0,0,10,0,315,82,25655,27022,31876,3,28,20,1,0,1,0,2,303,84,30239,27270,36330,0,12,-2,-4584,-10,-248,-4454,0,1,-1,0,8
EUN1_3572075071',0,21,7,0,0,1,0,14,0,366,86,25705,29372,25416,8,28,20,2,0,2,0,4,381,94,31131,32593,35723,0,-15,-8,-5426,-13,-3221,-10307,-2,0,-1,0,10
EUN1_3572001839',1,20,8,1,0,1,0,7,1,363,119,26924,29962,30392,5,26,11,0,0,1,0,9,336,68,26440,29370,31411,1,27,51,484,-3,592,-1019,1,0,0,0,-2
EUN1_3572762600',2,27,10,0,0,0,0,9,1,319,94,25824,27872,32341,5,29,15,2,0,1,0,3,349,78,27437,28764,28092,0,-30,16,-1613,-5,-892,4249,-2,0,-1,0,6
EUN1_3572730419',5,28,15,2,1,2,0,6,0,368,100,28543,33022,33542,1,28,6,0,0,0,0,1,301,86,23967,27527,25055,1,67,14,4576,9,5495,8487,2,1,2,0,5
EUN1_3572702341',2,26,10,0,0,0,0,11,0,283,97,24487,28332,33881,5,33,16,1,0,2,0,0,306,86,29009,29413,39029,0,-23,11,-4522,-6,-1081,-5148,-1,0,-2,0,11
EUN1_3572674788',4,32,6,1,0,0,0,10,0,329,95,23855,27833,31989,3,40,17,1,0,0,0,0,336,84,27661,31205,33726,0,-7,11,-3806,-11,-3372,-1737,0,0,0,0,10
EUN1_3572441134',7,39,14,2,0,0,0,9,0,359,82,27957,31125,37816,7,26,16,0,0,0,0,0,357,73,28722,31150,35063,0,2,9,-765,-2,-25,2753,2,0,0,0,9
EUN1_3572427751',4,35,8,1,0,0,0,5,0,357,98,25754,29096,28593,7,32,18,1,0,1,0,1,327,90,29066,30101,32802,0,30,8,-3312,-10,-1005,-4209,0,0,-1,0,4
EUN1_3572089020',4,26,14,1,0,0,0,9,0,407,88,29366,31342,33119,6,39,12,1,0,1,0,2,330,82,26286,29245,28543,1,77,6,3080,2,2097,4576,0,0,-1,0,7
EUN1_3572079579',4,24,12,1,1,0,0,6,0,355,78,27486,29503,30205,7,30,16,1,0,0,0,3,325,110,28980,30721,30667,0,30,-32,-1494,-4,-1218,-462,0,1,0,0,3
EUN1_3572000253',3,34,22,2,0,2,0,7,1,353,81,33053,30800,50587,3,29,14,0,0,1,0,7,292,77,25715,27526,34890,1,61,4,7338,8,3274,15697,2,0,1,0,0
EUN1_3571981175',4,29,14,2,1,0,0,13,0,311,90,27688,28133,29988,4,25,18,0,0,1,0,0,372,98,30031,30392,33228,1,-61,-8,-2343,-4,-2259,-3240,2,1,-1,0,13
EUN1_3571650558',3,25,21,1,0,3,0,8,1,357,79,32875,29136,39652,1,28,9,1,0,0,0,5,290,76,25921,27469,29804,1,67,3,6954,12,1667,9848,0,0,3,0,3
EUN1_3571637129',3,27,16,0,0,0,0,8,1,329,100,29222,29899,34247,3,31,7,2,0,1,0,8,333,100,23684,28401,20198,1,-4,0,5538,9,1498,14049,-2,0,-1,0,0
EUN1_3571599134',2,20,3,1,0,0,0,12,1,315,76,21431,26474,24816,4,28,11,1,0,1,0,0,372,112,26785,31043,27529,0,-57,-36,-5354,-8,-4569,-2713,0,0,-1,0,12
EUN1_3569162693',2,31,16,2,0,1,0,7,0,390,100,30181,31198,29722,7,31,9,0,0,0,0,4,307,104,25392,27881,24545,1,83,-4,4789,7,3317,5177,2,0,1,0,3
EUN1_3569147340',2,44,15,1,0,0,0,6,0,341,88,29242,31413,38550,5,27,17,1,0,1,0,1,341,72,27157,27788,34118,1,0,16,2085,-2,3625,4432,0,0,-1,0,5
EUN1_3569098858',5,25,10,0,0,0,0,10,0,338,69,26056,28234,35038,2,34,18,2,0,3,0,4,367,90,30146,31442,46738,0,-29,-21,-4090,-8,-3208,-11700,-2,0,-3,0,6
EUN1_3568939237',2,26,21,2,0,0,0,5,1,374,96,30069,32349,37339,7,33,4,0,0,0,0,2,301,92,22506,24404,31859,1,73,4,7563,17,7945,5480,2,0,0,0,3
EUN1_3568918497',5,25,9,1,0,0,0,12,0,292,102,25275,29101,29985,2,22,15,1,1,3,0,2,383,106,31184,31498,44547,0,-91,-4,-5909,-6,-2397,-14562,0,-1,-3,0,10
EUN1_3568902016',6,33,5,0,0,0,0,11,0,362,90,24327,29997,25194,4,41,11,2,0,1,0,1,382,104,27327,29837,25430,0,-20,-14,-3000,-6,160,-236,-2,0,-1,0,10
EUN1_3576005731',5,35,10,0,0,1,0,8,1,382,105,28023,30053,27001,2,22,12,2,0,0,0,5,376,74,28008,28456,28091,0,6,31,15,-2,1597,-1090,-2,0,1,0,3
EUN1_3575859053',7,45,9,1,0,0,0,5,0,407,94,27635,30323,24641,6,32,8,1,0,1,0,2,399,109,26784,31828,23644,1,8,-15,851,1,-1505,997,0,0,-1,0,3
EUN1_3575469456',2,44,13,1,1,4,0,10,0,394,126,32066,32355,34319,8,101,11,0,0,0,0,9,335,77,25842,27590,23508,1,59,49,6224,2,4765,10811,1,1,4,0,1
EUN1_3575454146',3,29,17,1,0,0,0,10,1,307,91,28826,28573,34618,6,31,12,1,0,0,0,2,363,84,27615,28485,29181,1,-56,7,1211,5,88,5437,0,0,0,0,8
EUN1_3574017958',4,25,16,1,0,1,0,9,1,367,86,30207,31387,28962,3,19,5,0,0,1,0,7,360,94,24327,28340,18977,1,7,-8,5880,11,3047,9985,1,0,0,0,2
EUN1_3573926814',0,48,11,1,0,0,0,7,0,338,81,25716,28695,30681,3,93,11,1,0,0,0,1,343,122,26971,29522,27239,0,-5,-41,-1255,0,-827,3442,0,0,0,0,6
EUN1_3573858944',4,32,7,1,0,0,0,11,0,371,89,24695,28542,25544,2,27,13,1,0,3,0,1,416,102,30400,31358,24298,1,-45,-13,-5705,-6,-2816,1246,0,0,-3,0,10
EUN1_3573832839',6,24,9,1,0,0,0,9,1,351,81,24782,28800,29573,5,44,6,0,0,0,0,0,342,84,23816,28948,26639,0,9,-3,966,3,-148,2934,1,0,0,0,9
EUN1_3573816199',5,30,17,1,0,0,0,10,0,378,68,29404,31511,38132,4,26,11,1,0,0,0,5,367,98,28044,29821,32603,0,11,-30,1360,6,1690,5529,0,0,0,0,5
EUN1_3573787851',3,151,17,0,0,1,0,11,1,312,70,29492,27062,46485,5,58,19,2,0,2,0,5,346,82,30726,29505,38676,0,-34,-12,-1234,-2,-2443,7809,-2,0,-1,0,6
EUN1_3573769714',4,28,7,0,0,0,0,15,0,346,92,24367,27017,21372,4,30,16,1,0,4,0,0,372,88,32116,31117,32555,0,-26,4,-7749,-9,-4100,-11183,-1,0,-4,0,15
EUN1_3575844670',3,29,13,0,1,2,0,9,0,372,106,29715,28957,25549,3,39,11,2,0,1,0,8,298,80,25639,25981,24353,1,74,26,4076,2,2976,1196,-2,1,1,0,1
EUN1_3575836341',4,22,12,2,0,1,0,9,0,404,100,30308,31557,30917,2,23,9,0,0,3,0,9,361,102,25714,29368,28800,1,43,-2,4594,3,2189,2117,2,0,-2,0,0
EUN1_3575822180',4,42,15,0,0,1,0,8,1,353,100,29007,30255,27116,1,23,13,2,0,1,0,10,365,87,28528,30251,33790,1,-12,13,479,2,4,-6674,-2,0,0,0,-2
EUN1_3575783297',3,20,10,0,0,0,0,14,0,364,82,26448,30129,33956,4,24,15,2,0,2,0,3,379,98,29858,31344,39017,1,-15,-16,-3410,-5,-1215,-5061,-2,0,-2,0,11
EUN1_3575762821',2,23,14,1,0,0,0,9,0,395,74,27673,30623,28860,0,22,10,1,0,1,0,4,339,77,25969,27962,32002,1,56,-3,1704,4,2661,-3142,0,0,-1,0,5
EUN1_3575751326',4,29,15,0,0,0,0,10,1,339,98,28661,29369,40600,2,38,11,2,0,1,0,3,392,68,26856,29950,31805,0,-53,30,1805,4,-581,8795,-2,0,-1,0,7
EUN1_3575565449',1,23,19,1,0,1,0,8,0,323,76,30705,29979,36567,3,146,13,0,0,1,0,2,325,74,26720,28546,33153,1,-2,2,3985,6,1433,3414,1,0,0,0,6
EUN1_3575519791',4,27,15,1,0,1,0,5,0,373,95,29912,30828,39453,6,31,10,1,0,1,0,9,359,76,26592,28133,34121,1,14,19,3320,5,2695,5332,0,0,0,0,-4
EUN1_3575469090',2,14,17,2,1,1,0,10,0,374,68,29953,31537,34477,3,23,15,0,0,0,0,4,370,96,29347,30325,34708,0,4,-28,606,2,1212,-231,2,1,1,0,6
EUN1_3575440475',2,52,5,0,0,0,0,15,1,313,73,22123,25146,26154,3,27,21,2,0,1,0,0,294,80,30591,30652,34205,0,19,-7,-8468,-16,-5506,-8051,-2,0,-1,0,15
EUN1_3575413779',2,25,6,0,0,0,0,12,0,339,80,24039,27423,32570,3,30,21,2,0,1,0,1,398,72,30894,31832,35127,0,-59,8,-6855,-15,-4409,-2557,-2,0,-1,0,11
EUN1_3575205405',5,35,15,0,0,0,0,9,0,292,92,27800,28063,37354,4,127,20,1,0,0,0,3,335,66,29259,30352,33845,0,-43,26,-1459,-5,-2289,3509,-1,0,0,0,6
EUN1_3574473260',1,103,18,1,1,0,0,7,1,305,80,28852,30054,43129,1,24,9,0,0,1,0,5,328,82,25928,27763,33219,1,-23,-2,2924,9,2291,9910,1,1,-1,0,2
EUN1_3574438517',4,25,9,0,0,0,0,6,1,317,83,24675,27857,29474,4,29,10,2,0,0,0,2,314,75,25343,27675,35591,0,3,8,-668,-1,182,-6117,-2,0,0,0,4
EUN1_3574287338',2,36,13,1,0,0,0,13,0,315,58,24834,27879,40059,3,21,19,1,0,2,0,2,322,82,29512,30651,38072,1,-7,-24,-4678,-6,-2772,1987,0,0,-2,0,11
EUN1_3574250066',3,27,13,0,0,0,0,13,0,289,69,26982,26910,32475,1,285,18,2,0,2,0,1,373,106,31455,32510,41021,0,-84,-37,-4473,-5,-5600,-8546,-2,0,-2,0,12
EUN1_3574150954',4,33,5,1,0,0,0,9,0,414,84,24794,30010,23143,5,25,9,0,0,2,0,4,349,72,26870,28344,24672,1,65,12,-2076,-4,1666,-1529,1,0,-2,0,5
EUN1_3568810891',2,21,3,1,0,0,0,7,0,336,97,22355,28625,22965,3,37,8,1,0,2,0,2,344,90,25131,28870,25273,1,-8,7,-2776,-5,-245,-2308,0,0,-2,0,5
EUN1_3568305698',6,47,4,1,0,0,0,10,1,334,74,22994,26388,26574,7,51,22,1,0,0,0,0,359,84,29164,31489,39560,0,-25,-10,-6170,-18,-5101,-12986,0,0,0,0,10
EUN1_3566266140',2,22,13,0,0,0,0,12,0,317,84,26534,27766,35289,3,424,16,1,0,3,0,1,360,88,31595,31082,40726,1,-43,-4,-5061,-3,-3316,-5437,-1,0,-3,0,11
EUN1_3565484411',1,32,15,1,0,0,0,9,1,341,67,28244,29063,32970,3,44,17,0,0,1,0,2,360,82,28995,30872,38223,1,-19,-15,-751,-2,-1809,-5253,1,0,-1,0,7
EUN1_3565464567',4,44,15,1,0,1,0,9,0,373,78,30768,31695,34803,3,24,9,0,0,1,0,9,381,94,27040,29462,33038,1,-8,-16,3728,6,2233,1765,1,0,0,0,0
EUN1_3564437109',4,30,8,2,0,0,0,10,1,365,84,26515,29336,31063,6,32,12,0,0,0,0,3,371,96,27603,32626,31562,0,-6,-12,-1088,-4,-3290,-499,2,0,0,0,7
EUN1_3564275393',2,126,12,1,0,0,0,8,0,308,80,26367,27690,32868,7,28,19,1,0,0,0,4,350,108,30757,31671,35032,0,-42,-28,-4390,-7,-3981,-2164,0,0,0,0,4
EUN1_3564250011',7,24,26,2,1,2,0,6,1,366,80,34621,32617,42727,3,19,6,0,0,0,0,8,264,67,22066,24435,29482,1,102,13,12555,20,8182,13245,2,1,2,0,-2
EUN1_3563546884',4,25,18,1,0,0,0,10,0,332,104,30085,32299,38057,5,32,7,0,0,1,0,3,323,82,25612,26614,25939,1,9,22,4473,11,5685,12118,1,0,-1,0,7
EUN1_3563505115',4,42,12,1,0,1,0,11,0,281,78,26654,25624,28533,2,26,17,1,0,1,0,4,323,114,29817,30602,32989,0,-42,-36,-3163,-5,-4978,-4456,0,0,0,0,7
EUN1_3563465965',0,21,10,0,0,1,0,12,0,305,90,26768,27110,26975,2,29,21,2,0,1,0,6,313,102,31090,30762,46645,0,-8,-12,-4322,-11,-3652,-19670,-2,0,0,0,6
EUN1_3563435620',4,27,12,1,0,1,0,7,1,340,64,27725,28625,35478,3,26,9,0,0,0,0,4,315,76,24800,27293,28355,1,25,-12,2925,3,1332,7123,1,0,1,0,3
EUN1_3561733459',4,64,12,0,0,0,0,7,0,332,82,26614,30684,35216,8,59,10,1,0,0,0,1,382,94,27648,29182,29846,1,-50,-12,-1034,2,1502,5370,-1,0,0,0,6
EUN1_3559936444',6,26,13,1,0,1,0,13,0,349,78,28608,29903,37155,1,29,12,1,0,0,0,3,374,88,27728,30659,31231,0,-25,-10,880,1,-756,5924,0,0,1,0,10
EUN1_3568718816',3,24,18,1,0,2,0,11,1,358,96,33169,30340,37667,2,31,14,1,0,2,0,10,326,72,26603,26425,32082,1,32,24,6566,4,3915,5585,0,0,0,0,1
EUN1_3568632260',2,38,22,1,0,1,0,9,0,334,96,31499,30543,45395,4,30,14,0,0,0,0,6,317,67,27594,26699,40194,1,17,29,3905,8,3844,5201,1,0,1,0,3
EUN1_3565984362',5,228,10,0,0,0,0,13,1,325,80,26825,29310,32675,3,27,19,1,0,1,0,4,348,104,29125,32136,34546,0,-23,-24,-2300,-9,-2826,-1871,-1,0,-1,0,9
EUN1_3560108065',2,337,11,2,0,3,0,5,0,381,70,29255,28903,34746,2,22,11,0,0,1,0,7,316,77,26058,28696,25943,1,65,-7,3197,0,207,8803,2,0,2,0,-2
EUN1_3560113245',1,30,19,1,0,1,0,9,0,289,92,30502,30095,35109,1,29,13,0,0,1,0,6,332,90,28086,28088,38801,1,-43,2,2416,6,2007,-3692,1,0,0,0,3
EUN1_3560002935',3,28,11,2,0,3,0,7,1,361,104,28353,30668,30375,2,38,6,0,0,0,0,6,335,82,24117,28800,26608,1,26,22,4236,5,1868,3767,2,0,3,0,1
EUN1_3559985096',2,79,16,0,0,0,0,6,1,334,72,28419,29893,37223,1,27,6,2,0,1,0,2,295,80,22250,27712,26158,1,39,-8,6169,10,2181,11065,-2,0,-1,0,4
EUN1_3559962274',3,21,9,1,0,1,0,5,1,338,98,26598,29278,28415,4,25,8,1,1,0,0,4,329,86,24021,28512,23666,0,9,12,2577,1,766,4749,0,-1,1,0,1
EUN1_3559927711',5,29,19,0,0,0,0,6,1,319,96,29359,31407,34288,2,23,16,1,0,0,0,3,316,79,27171,29353,37276,0,3,17,2188,3,2054,-2988,-1,0,0,0,3
EUN1_3559895796',1,39,10,0,0,2,0,7,1,364,100,28121,31138,33447,7,28,3,2,0,0,0,7,352,88,22288,27677,17476,1,12,12,5833,7,3461,15971,-2,0,2,0,0
EUN1_3559873451',3,28,27,0,0,1,0,9,0,325,62,34172,28851,41392,4,28,13,1,0,2,0,8,281,63,27309,26321,32614,1,44,-1,6863,14,2530,8778,-1,0,-1,0,1
EUN1_3559826669',10,30,14,0,0,1,0,5,1,324,104,27984,29717,31059,3,27,8,2,0,0,0,5,342,96,25088,28347,21422,0,-18,8,2896,6,1370,9637,-2,0,1,0,0
EUN1_3559808345',4,23,15,1,1,1,0,6,1,378,84,29336,33156,32259,2,30,5,1,0,0,0,6,337,86,23834,28375,26309,1,41,-2,5502,10,4781,5950,0,1,1,0,0
EUN1_3559779579',2,25,17,1,0,1,0,9,1,299,99,29933,30478,41163,3,23,17,1,1,1,0,1,296,84,29659,28782,42490,1,3,15,274,0,1696,-1327,0,-1,0,0,8
EUN1_3559766242',5,28,11,0,0,1,0,6,0,387,68,27768,29897,34339,6,54,9,1,0,0,0,5,337,80,25282,28207,33348,1,50,-12,2486,2,1690,991,-1,0,1,0,1
EUN1_3559727573',3,65,8,0,0,0,0,6,0,318,100,24440,30290,28757,3,26,12,2,0,0,0,1,355,96,26492,30936,35386,0,-37,4,-2052,-4,-646,-6629,-2,0,0,0,5
EUN1_3559699807',3,290,19,1,0,1,0,6,1,363,72,30369,32117,35174,4,24,13,0,0,0,0,7,311,84,27378,31518,30661,1,52,-12,2991,6,599,4513,1,0,1,0,-1
EUN1_3559606193',4,187,11,1,0,0,0,7,0,335,90,26778,29805,31007,3,69,15,1,0,1,0,2,367,86,28827,30904,30904,0,-32,4,-2049,-4,-1099,103,0,0,-1,0,5
EUN1_3559473765',5,78,17,1,0,2,0,8,1,374,73,30497,30706,36178,5,29,8,0,0,0,0,5,368,74,25721,28752,31077,1,6,-1,4776,9,1954,5101,1,0,2,0,3
EUN1_3559464566',3,27,12,2,0,1,0,5,1,378,108,28453,32645,31811,2,17,5,0,0,0,0,6,375,92,23828,29073,28491,1,3,16,4625,7,3572,3320,2,0,1,0,-1
EUN1_3575951048',2,32,18,1,0,0,0,9,1,281,84,28441,26365,38021,2,29,14,1,1,1,0,5,298,86,27964,27866,41445,1,-17,-2,477,4,-1501,-3424,0,-1,-1,0,4
EUN1_3575936414',2,21,13,1,0,1,0,8,1,320,98,27501,31022,30849,2,29,12,1,1,1,0,6,356,94,27731,31276,27069,1,-36,4,-230,1,-254,3780,0,-1,0,0,2
EUN1_3575895489',4,29,11,1,0,3,0,12,1,345,94,28658,31238,33303,3,50,9,1,0,0,0,11,349,106,26281,28403,27850,1,-4,-12,2377,2,2835,5453,0,0,3,0,1
EUN1_3575840455',5,22,6,0,0,0,0,11,0,327,73,22335,25472,20016,2,19,17,1,1,2,0,1,368,70,30650,30665,30194,0,-41,3,-8315,-11,-5193,-10178,-1,-1,-2,0,10
EUN1_3575811862',4,134,12,0,0,3,0,4,1,362,100,30367,29730,33593,4,30,12,1,0,0,0,4,325,56,25480,26630,38073,0,37,44,4887,0,3100,-4480,-1,0,3,0,0
EUN1_3575807364',6,31,18,2,0,0,0,7,1,352,108,29791,32381,38388,3,28,13,0,0,1,0,3,343,100,28497,31230,27295,1,9,8,1294,5,1151,11093,2,0,-1,0,4
EUN1_3575790068',2,57,18,1,1,1,0,9,1,338,99,30330,32084,41578,0,24,9,0,0,0,0,1,331,81,24282,28273,26663,1,7,18,6048,9,3811,14915,1,1,1,0,8
EUN1_3575776039',1,23,14,1,0,1,0,8,0,353,88,28212,28773,28537,5,36,10,1,0,1,0,6,273,83,24679,24939,26231,1,80,5,3533,4,3834,2306,0,0,0,0,2
EUN1_3575473362',3,26,14,0,0,1,0,6,1,378,86,28975,32045,36824,8,31,9,1,0,0,0,4,330,66,24397,26595,30299,1,48,20,4578,5,5450,6525,-1,0,1,0,2
EUN1_3575440972',4,27,14,2,0,1,0,6,1,321,116,29400,30126,29962,7,32,10,0,0,1,0,6,294,78,23919,27656,27631,1,27,38,5481,4,2470,2331,2,0,0,0,0
EUN1_3575408980',1,33,10,0,0,0,0,3,1,340,92,24783,28444,26972,4,281,16,2,0,0,0,2,359,96,27900,31604,32379,0,-19,-4,-3117,-6,-3160,-5407,-2,0,0,0,1
EUN1_3575252500',2,25,12,0,0,1,0,12,1,325,76,26576,28367,29297,4,93,14,1,0,2,0,5,331,88,28186,31122,29007,0,-6,-12,-1610,-2,-2755,290,-1,0,-1,0,7
EUN1_3575235161',7,33,11,0,0,0,0,13,1,340,90,26124,29280,27258,2,28,10,1,0,1,0,1,374,82,28051,30091,23674,0,-34,8,-1927,1,-811,3584,-1,0,-1,0,12
EUN1_3575210037',4,27,12,1,0,1,0,9,1,324,73,26428,27375,31954,4,31,13,0,0,2,0,2,366,66,28006,28327,25147,0,-42,7,-1578,-1,-952,6807,1,0,-1,0,7
EUN1_3575196456',4,23,12,2,0,3,0,4,1,364,103,29312,32018,36764,1,23,8,0,0,0,0,12,335,75,23357,28711,26219,1,29,28,5955,4,3307,10545,2,0,3,0,-8
EUN1_3575181571',4,26,8,1,0,1,0,7,0,369,95,26347,30776,29275,2,25,10,1,0,0,0,5,354,88,25435,30612,29848,1,15,7,912,-2,164,-573,0,0,1,0,2
EUN1_3575165590',0,20,13,0,0,0,0,8,1,350,88,27670,29319,32049,3,31,14,1,0,0,0,1,340,100,28426,29535,30994,1,10,-12,-756,-1,-216,1055,-1,0,0,0,7
EUN1_3575155792',4,76,11,2,0,0,0,8,0,364,94,26875,31162,31063,5,30,3,0,0,0,0,5,333,90,21906,26171,19895,1,31,4,4969,8,4991,11168,2,0,0,0,3
EUN1_3572464941',1,21,19,1,0,0,0,10,0,312,107,29481,30300,39211,2,28,11,0,0,1,0,3,347,72,27553,28373,30487,0,-35,35,1928,8,1927,8724,1,0,-1,0,7
EUN1_3572464328',3,25,19,2,0,1,0,12,1,348,84,30322,31640,31215,3,26,9,0,1,2,0,6,364,96,26221,29461,22117,1,-16,-12,4101,10,2179,9098,2,-1,-1,0,6
EUN1_3572452645',7,38,10,1,0,1,0,12,1,348,76,26745,29133,28226,3,24,6,0,0,1,0,3,382,80,25772,27547,30265,1,-34,-4,973,4,1586,-2039,1,0,0,0,9
EUN1_3575906709',3,20,19,2,0,0,0,10,1,353,102,29450,31805,36772,4,25,12,0,1,0,0,2,319,78,27990,29047,35599,1,34,24,1460,7,2758,1173,2,-1,0,0,8
EUN1_3575888967',1,19,17,2,0,1,0,9,1,282,120,28884,30576,36850,3,33,8,0,0,0,0,4,332,72,23798,25629,30720,1,-50,48,5086,9,4947,6130,2,0,1,0,5
EUN1_3575463028',2,25,17,2,0,1,0,8,0,386,86,29738,33770,38851,6,28,11,0,0,0,0,3,361,93,27026,29567,31158,1,25,-7,2712,6,4203,7693,2,0,1,0,5
EUN1_3575438817',3,23,7,1,0,0,0,7,0,385,100,25769,29558,19355,5,28,10,1,0,1,0,2,410,84,26547,31375,23503,1,-25,16,-778,-3,-1817,-4148,0,0,-1,0,5
EUN1_3575422147',9,38,6,1,0,0,0,7,1,368,100,24516,30364,21447,7,24,7,1,0,0,0,2,378,96,24883,30322,21421,1,-10,4,-367,-1,42,26,0,0,0,0,5
EUN1_3575379821',3,29,14,1,0,1,0,8,0,301,83,27178,27377,33942,2,24,17,0,0,1,0,3,319,92,28907,29414,34558,1,-18,-9,-1729,-3,-2037,-616,1,0,0,0,5
EUN1_3575361536',3,27,10,2,0,1,0,7,1,356,104,27297,30908,28930,7,82,9,0,0,0,0,3,310,60,24332,28108,27558,1,46,44,2965,1,2800,1372,2,0,1,0,4
EUN1_3576042278',5,88,9,1,0,0,0,9,1,268,79,23243,24651,24029,2,25,11,0,0,0,0,2,398,94,27370,30328,33615,1,-130,-15,-4127,-2,-5677,-9586,1,0,0,0,7
EUN1_3575885682',3,20,14,0,1,0,0,8,0,316,104,27617,29369,33988,2,21,19,2,0,2,0,1,367,99,31331,32729,36146,0,-51,5,-3714,-5,-3360,-2158,-2,1,-2,0,7
EUN1_3571776030',3,39,12,1,0,1,0,5,1,384,98,29009,30352,39402,6,27,7,1,0,0,0,6,296,82,22505,26623,28962,1,88,16,6504,5,3729,10440,0,0,1,0,-1
EUN1_3571192748',3,65,9,2,0,0,0,8,0,337,92,25368,28706,26092,7,27,15,0,0,2,0,3,378,80,29417,30126,30847,0,-41,12,-4049,-6,-1420,-4755,2,0,-2,0,5
EUN1_3570377654',4,28,5,0,0,0,0,10,0,292,76,22070,24498,17233,4,25,20,2,0,1,0,0,362,69,30429,29170,38462,0,-70,7,-8359,-15,-4672,-21229,-2,0,-1,0,10
EUN1_3565969382',4,26,11,1,0,0,0,7,0,347,82,26103,29960,31452,6,26,15,1,0,0,0,5,326,90,27638,30505,31103,1,21,-8,-1535,-4,-545,349,0,0,0,0,2
EUN1_3565958299',5,26,14,0,0,2,0,5,1,368,98,29731,29418,34087,7,34,10,0,0,0,0,5,315,62,24106,27500,25977,1,53,36,5625,4,1918,8110,0,0,2,0,0
EUN1_3561602189',1,29,12,1,0,1,0,11,1,359,92,28258,29200,30408,3,38,11,1,0,0,0,5,355,92,26881,29143,25989,0,4,0,1377,1,57,4419,0,0,1,0,6
EUN1_3561332100',4,24,17,2,0,1,0,3,1,348,100,30399,32057,35892,2,26,7,0,0,1,0,8,331,84,25837,27551,25878,1,17,16,4562,10,4506,10014,2,0,0,0,-5
EUN1_3561307115',8,26,23,1,1,1,0,13,1,373,90,32890,33678,37932,2,43,13,1,0,1,0,9,373,90,29451,30853,36542,1,0,0,3439,10,2825,1390,0,1,0,0,4
EUN1_3561406523',3,21,17,0,0,1,0,7,1,379,80,29716,32242,27962,4,29,13,2,1,0,0,2,338,76,27272,30405,31577,0,41,4,2444,4,1837,-3615,-2,-1,1,0,5
EUN1_3568837661',2,18,11,1,1,1,0,9,0,365,112,27315,31136,30926,3,45,15,1,0,1,0,4,325,80,27974,29880,32542,0,40,32,-659,-4,1256,-1616,0,1,0,0,5
EUN1_3568817944',1,26,14,1,0,2,0,7,1,375,70,30953,31596,29759,2,23,11,1,0,0,0,9,346,90,26057,29312,25801,1,29,-20,4896,3,2284,3958,0,0,2,0,-2
EUN1_3568804787',2,18,4,0,0,0,0,5,0,338,72,22572,28454,21257,6,29,12,1,1,1,0,0,346,128,29552,30906,30249,0,-8,-56,-6980,-8,-2452,-8992,-1,-1,-1,0,5
EUN1_3567122693',2,94,18,1,0,0,0,11,0,287,70,28956,27289,36100,6,30,23,1,0,1,0,2,313,78,33096,30161,47652,0,-26,-8,-4140,-5,-2872,-11552,0,0,-1,0,9
EUN1_3567111379',5,29,8,0,0,0,0,8,1,351,76,25383,28118,25419,9,134,19,2,0,0,0,2,365,79,29581,31531,35986,0,-14,-3,-4198,-11,-3413,-10567,-2,0,0,0,6
EUN1_3567086052',3,28,20,1,1,2,0,10,1,350,84,31499,30527,42272,4,98,13,0,0,1,0,5,303,82,26985,27759,44008,1,47,2,4514,7,2768,-1736,1,1,1,0,5
EUN1_3566689684',7,27,8,0,0,0,0,4,0,331,86,24292,28590,25340,2,26,7,2,0,0,0,2,373,104,25159,30421,31911,0,-42,-18,-867,1,-1831,-6571,-2,0,0,0,2
EUN1_3566668875',2,30,12,2,0,0,0,10,0,349,79,28158,29375,31729,2,34,18,0,0,2,0,6,386,108,31079,33677,39018,0,-37,-29,-2921,-6,-4302,-7289,2,0,-2,0,4
EUN1_3566063576',2,22,17,1,0,2,0,9,1,370,95,31191,31159,34816,3,25,14,1,0,1,0,6,341,64,28801,28913,30563,1,29,31,2390,3,2246,4253,0,0,1,0,3
EUN1_3564945656',8,26,21,2,0,2,0,10,1,378,96,32975,32495,54324,2,24,11,0,0,1,0,6,321,63,26049,26954,31975,1,57,33,6926,10,5541,22349,2,0,1,0,4
EUN1_3564917935',8,27,16,2,0,1,0,11,1,326,64,28646,29403,36855,4,29,12,0,0,1,0,4,364,104,29477,31341,35850,1,-38,-40,-831,4,-1938,1005,2,0,0,0,7
EUN1_3564903420',2,33,9,0,0,0,0,8,0,345,76,25669,26721,24687,5,30,15,2,1,1,0,1,379,103,29475,30138,35945,0,-34,-27,-3806,-6,-3417,-11258,-2,-1,-1,0,7
EUN1_3564369984',4,28,15,1,1,1,0,7,1,299,95,28107,31551,31599,2,31,9,1,0,0,0,2,323,99,25745,28939,36294,1,-24,-4,2362,6,2612,-4695,0,1,1,0,5
EUN1_3564352644',1,23,12,0,0,0,0,3,0,348,80,26206,28087,38780,4,24,7,1,0,0,0,1,342,83,24692,27696,28368,0,6,-3,1514,5,391,10412,-1,0,0,0,2
EUN1_3564327843',2,19,15,2,0,0,0,10,0,338,92,27178,33028,42775,1,19,14,0,0,1,0,0,341,91,28627,30976,34264,0,-3,1,-1449,1,2052,8511,2,0,-1,0,10
EUN1_3564309070',7,43,13,1,0,1,0,12,1,348,82,26733,29253,35618,5,32,5,1,0,0,0,4,355,74,24449,28240,26910,1,-7,8,2284,8,1013,8708,0,0,1,0,8
EUN1_3562206490',5,32,14,1,0,0,0,7,1,366,104,27940,32153,37400,7,27,8,1,0,0,0,4,363,116,25393,29738,22995,1,3,-12,2547,6,2415,14405,0,0,0,0,3
EUN1_3562196426',2,27,14,0,0,0,0,11,0,324,96,29224,29247,35057,2,20,19,1,0,2,0,5,369,76,31182,30377,33869,0,-45,20,-1958,-5,-1130,1188,-1,0,-2,0,6
EUN1_3562181631',4,30,16,1,0,0,0,7,0,317,84,27709,29204,35191,2,25,14,0,0,0,0,3,365,91,28459,29749,30777,1,-48,-7,-750,2,-545,4414,1,0,0,0,4
EUN1_3562105296',4,27,15,0,0,0,0,10,0,331,82,28413,28769,39183,4,27,21,1,0,1,0,1,321,78,31458,30974,36727,0,10,4,-3045,-6,-2205,2456,-1,0,-1,0,9
EUN1_3576228525',4,32,11,0,0,0,0,9,1,314,62,25663,27798,29575,5,28,15,2,1,0,0,3,360,105,27631,31760,30424,0,-46,-43,-1968,-4,-3962,-849,-2,-1,0,0,6
EUN1_3576225164',3,27,10,2,0,0,0,3,1,381,84,27372,28821,28203,5,33,12,0,0,1,0,5,354,108,27010,29506,33228,1,27,-24,362,-2,-685,-5025,2,0,-1,0,-2
EUN1_3576209706',5,27,10,1,0,1,0,7,0,333,88,25587,28615,26046,6,25,10,1,0,1,0,3,332,92,26565,28681,31228,0,1,-4,-978,0,-66,-5182,0,0,0,0,4
EUN1_3576209096',0,15,6,0,0,0,0,5,1,380,72,24372,29365,22118,4,28,8,1,0,1,0,3,343,108,26311,31818,29834,0,37,-36,-1939,-2,-2453,-7716,-1,0,-1,0,2
EUN1_3576187862',4,26,13,2,0,2,0,12,1,361,80,28375,28679,32639,2,19,17,0,0,1,0,5,342,75,30198,29617,38906,0,19,5,-1823,-4,-938,-6267,2,0,1,0,7
EUN1_3576186744',1,26,19,1,0,3,0,8,1,360,113,33085,31662,36024,2,22,9,1,0,0,0,7,326,86,24924,27532,28756,1,34,27,8161,10,4130,7268,0,0,3,0,1
EUN1_3576197575',2,22,16,0,0,0,0,12,1,319,76,27916,30590,37939,4,27,14,2,0,0,0,5,372,76,26901,30146,33001,0,-53,0,1015,2,444,4938,-2,0,0,0,7
EUN1_3576152679',1,24,20,1,0,2,0,14,0,371,87,32768,30224,40350,2,31,19,1,1,3,0,6,338,84,32761,29886,35321,1,33,3,7,1,338,5029,0,-1,-1,0,8
EUN1_3576133834',3,25,7,1,0,0,0,8,1,377,62,23784,28853,26825,5,159,14,0,0,1,0,1,394,98,30365,32822,32561,0,-17,-36,-6581,-7,-3969,-5736,1,0,-1,0,7
EUN1_3576119689',3,28,12,1,0,1,0,7,1,388,91,28708,30211,23758,10,36,8,0,0,1,0,5,329,78,24276,27725,22752,1,59,13,4432,4,2486,1006,1,0,0,0,2
EUN1_3575702169',4,28,10,1,0,1,0,15,0,330,84,26732,26990,28292,3,27,20,1,1,4,0,1,372,88,33839,32045,39159,0,-42,-4,-7107,-10,-5055,-10867,0,-1,-3,0,14
EUN1_3575697214',7,34,14,0,0,0,0,10,0,315,93,27245,28046,35192,2,32,16,1,0,4,0,1,392,74,33453,30031,34037,0,-77,19,-6208,-2,-1985,1155,-1,0,-4,0,9
EUN1_3575694116',4,24,10,1,0,0,0,10,0,341,86,26131,27669,26888,1,25,12,1,0,1,0,6,341,70,27537,28242,34716,0,0,16,-1406,-2,-573,-7828,0,0,-1,0,4
EUN1_3575687476',3,31,12,0,0,0,0,10,0,286,69,25711,25073,30201,7,31,22,2,0,1,0,3,297,67,30944,27430,39233,0,-11,2,-5233,-10,-2357,-9032,-2,0,-1,0,7
EUN1_3575675805',2,23,24,0,0,2,0,9,1,310,98,33278,29629,34329,1,25,14,2,0,2,0,9,319,73,28645,29907,30514,1,-9,25,4633,10,-278,3815,-2,0,0,0,0
EUN1_3575672514',4,195,11,0,0,1,0,15,0,340,82,27961,31284,32318,5,24,19,2,0,2,0,3,337,98,30433,31792,35619,0,3,-16,-2472,-8,-508,-3301,-2,0,-1,0,12
EUN1_3575678089',4,34,11,0,0,0,0,10,1,323,80,26484,28335,40167,3,38,22,2,0,0,0,4,363,91,30754,32967,50876,0,-40,-11,-4270,-11,-4632,-10709,-2,0,0,0,6
EUN1_3575666469',3,21,6,0,0,0,0,15,0,371,96,25404,30010,26988,6,30,15,2,1,3,0,2,357,96,30610,32833,28321,0,14,0,-5206,-9,-2823,-1333,-2,-1,-3,0,13
EUN1_3576187157',2,71,15,1,0,1,0,9,1,304,80,28884,27536,40277,1,52,18,0,0,1,0,5,326,72,27888,30910,35092,0,-22,8,996,-3,-3374,5185,1,0,0,0,4
EUN1_3576162150',3,20,15,1,0,0,0,15,0,279,96,27759,29607,34381,3,19,22,1,0,4,0,4,324,84,33249,32472,44929,1,-45,12,-5490,-7,-2865,-10548,0,0,-4,0,11
EUN1_3576148656',5,19,6,0,0,0,0,13,1,246,78,21205,23038,23630,3,23,16,1,0,3,0,1,357,94,30743,31288,31041,0,-111,-16,-9538,-10,-8250,-7411,-1,0,-3,0,12
EUN1_3575668376',3,48,6,1,0,0,0,7,1,328,96,23429,27807,36527,4,29,11,1,0,0,0,2,340,91,25434,29950,24761,0,-12,5,-2005,-5,-2143,11766,0,0,0,0,5
EUN1_3574033369',3,188,27,2,0,2,0,7,1,391,84,33974,31713,44484,5,22,10,0,0,0,0,11,294,67,25197,27229,26817,1,97,17,8777,17,4484,17667,2,0,2,0,-4
EUN1_3573776774',2,32,15,1,0,0,0,17,1,294,58,26845,25847,39539,5,30,20,1,0,5,0,3,356,98,34346,29734,42206,0,-62,-40,-7501,-5,-3887,-2667,0,0,-5,0,14
EUN1_3573760352',3,21,12,1,0,0,0,6,1,371,77,26582,28475,24633,5,24,9,0,0,0,0,1,420,80,26560,30743,27149,1,-49,-3,22,3,-2268,-2516,1,0,0,0,5
EUN1_3573525245',3,25,14,1,0,0,0,11,0,335,82,28465,29046,31956,5,25,17,1,1,1,0,5,324,76,30001,29796,29630,0,11,6,-1536,-3,-750,2326,0,-1,-1,0,6
EUN1_3573520298',3,19,19,1,1,1,0,4,1,361,60,30390,31045,31464,4,32,8,0,0,0,0,9,313,84,24854,28081,24699,1,48,-24,5536,11,2964,6765,1,1,1,0,-5
EUN1_3573518175',3,31,7,1,0,0,0,4,1,363,91,24979,30295,20919,4,20,6,1,0,0,0,3,358,104,24510,29510,16444,0,5,-13,469,1,785,4475,0,0,0,0,1
EUN1_3573501060',4,25,12,1,0,1,0,12,0,278,68,26118,27201,29194,5,24,12,1,0,0,0,3,351,80,27633,29803,36643,1,-73,-12,-1515,0,-2602,-7449,0,0,1,0,9
EUN1_3573504618',6,26,22,2,0,0,0,11,0,325,77,30902,29276,44505,3,26,13,0,0,2,0,5,330,61,28567,28181,32430,1,-5,16,2335,9,1095,12075,2,0,-2,0,6
EUN1_3573507164',2,60,8,1,0,2,0,8,0,369,94,26789,29354,27341,2,82,8,1,0,0,0,5,291,102,24220,29103,24016,1,78,-8,2569,0,251,3325,0,0,2,0,3
EUN1_3573496593',4,30,21,0,0,2,0,11,1,335,50,31667,29101,42138,4,25,8,1,0,0,0,5,293,55,24036,25993,32144,0,42,-5,7631,13,3108,9994,-1,0,2,0,6
EUN1_3572900730',4,21,13,0,0,0,0,9,1,317,72,26958,27883,31502,0,25,8,1,0,1,0,7,369,96,26147,29230,28493,1,-52,-24,811,5,-1347,3009,-1,0,-1,0,2
EUN1_3576235773',6,23,14,0,0,0,0,10,1,307,82,25600,27972,32332,1,25,18,2,1,1,0,1,352,94,28576,31052,38265,0,-45,-12,-2976,-4,-3080,-5933,-2,-1,-1,0,9
EUN1_3576235135',2,31,10,2,0,0,0,11,1,315,92,26912,28722,27766,2,23,20,0,0,3,0,3,369,100,32001,33433,36612,0,-54,-8,-5089,-10,-4711,-8846,2,0,-3,0,8
EUN1_3576223523',7,65,13,1,0,0,0,6,1,337,69,27009,28048,32967,2,59,11,1,0,1,0,8,297,98,26676,28035,30796,1,40,-29,333,2,13,2171,0,0,-1,0,-2
EUN1_3576145239',1,22,9,0,0,0,0,9,0,339,76,24643,29407,28336,2,21,16,2,0,0,0,1,386,96,30116,32694,32794,0,-47,-20,-5473,-7,-3287,-4458,-2,0,0,0,8
EUN1_3576126294',8,31,8,0,0,0,0,8,0,369,74,25103,28755,25615,3,26,12,2,0,0,0,1,367,94,27336,30764,29697,0,2,-20,-2233,-4,-2009,-4082,-2,0,0,0,7
EUN1_3575896578',2,18,10,0,0,0,0,10,1,302,82,25596,29549,36234,6,78,12,2,0,1,0,3,299,82,25235,29257,34218,0,3,0,361,-2,292,2016,-2,0,-1,0,7
EUN1_3575881431',5,26,17,1,0,1,0,10,1,333,99,30090,28582,32252,2,23,12,1,0,1,0,7,343,90,28587,29088,23662,1,-10,9,1503,5,-506,8590,0,0,0,0,3
EUN1_3575621186',3,25,9,1,0,2,0,9,1,357,82,26843,28582,29316,4,25,14,0,0,1,0,6,318,90,27871,30473,32019,1,39,-8,-1028,-5,-1891,-2703,1,0,1,0,3
EUN1_3575599397',2,23,9,0,0,0,0,13,0,303,92,24770,29055,29421,1,21,23,1,1,4,0,1,372,104,33680,33879,41411,0,-69,-12,-8910,-14,-4824,-11990,-1,-1,-4,0,12
EUN1_3575572746',1,23,12,0,0,0,0,7,1,330,56,25634,27918,32374,3,23,18,1,0,1,0,2,344,88,29279,31709,38225,0,-14,-32,-3645,-6,-3791,-5851,-1,0,-1,0,5
EUN1_3575379796',1,22,19,1,0,0,0,6,0,356,104,30665,30489,40487,3,27,12,0,0,0,0,7,264,52,24992,26527,29231,1,92,52,5673,7,3962,11256,1,0,0,0,-1
EUN1_3575365133',3,30,15,0,0,0,0,4,0,326,62,26049,29519,32080,6,52,17,2,0,1,0,0,345,88,29698,30803,40719,0,-19,-26,-3649,-2,-1284,-8639,-2,0,-1,0,4
EUN1_3575312603',3,50,7,0,0,0,0,11,0,323,68,23669,29262,24694,2,163,13,1,0,2,0,2,398,94,29865,31172,30066,0,-75,-26,-6196,-6,-1910,-5372,-1,0,-2,0,9
EUN1_3575280773',3,22,13,0,0,0,0,6,0,370,106,28932,31183,34496,1,353,17,2,0,1,0,3,369,98,28627,33043,38854,1,1,8,305,-4,-1860,-4358,-2,0,-1,0,3
EUN1_3575262936',6,37,14,1,0,2,0,8,1,383,83,30921,30457,32832,3,71,8,0,0,1,0,11,347,88,25205,28802,23862,1,36,-5,5716,6,1655,8970,1,0,1,0,-3
EUN1_3575245626',1,87,19,1,1,2,0,6,1,300,76,30716,25641,32784,5,55,13,1,0,1,0,8,284,62,26415,25284,31252,1,16,14,4301,6,357,1532,0,1,1,0,-2
EUN1_3575233381',3,29,13,0,0,0,0,8,1,303,90,26049,29257,28462,4,25,17,2,0,0,0,2,303,70,27296,27778,30469,1,0,20,-1247,-4,1479,-2007,-2,0,0,0,6
EUN1_3575213191',3,33,11,0,0,0,0,11,1,300,84,24446,28002,27568,2,25,16,0,0,1,0,0,334,116,30313,32311,41945,0,-34,-32,-5867,-5,-4309,-14377,0,0,-1,0,11
EUN1_3575195364',3,24,8,0,0,1,0,9,1,377,95,25885,30527,29954,1,126,11,1,0,1,0,4,366,96,27169,31129,30564,0,11,-1,-1284,-3,-602,-610,-1,0,0,0,5
EUN1_3575167637',5,23,9,0,0,1,0,2,0,377,78,26514,29743,33661,3,22,10,1,0,0,0,8,344,93,26540,30800,27549,0,33,-15,-26,-1,-1057,6112,-1,0,1,0,-6
EUN1_3571717628',1,26,17,1,0,0,0,8,1,290,58,27067,27620,30151,3,22,7,0,0,1,0,3,337,84,24914,26918,26154,0,-47,-26,2153,10,702,3997,1,0,-1,0,5
EUN1_3571621443',3,28,11,0,0,0,0,12,0,346,74,26395,27943,31353,3,27,19,1,0,2,0,2,321,76,29421,30104,38025,1,25,-2,-3026,-8,-2161,-6672,-1,0,-2,0,10
EUN1_3570111474',3,25,10,0,0,2,0,5,0,355,90,27308,30924,29495,1,32,7,1,0,0,0,6,369,94,24318,29207,35798,0,-14,-4,2990,3,1717,-6303,-1,0,2,0,-1
EUN1_3570071739',2,29,10,0,0,0,0,6,0,380,90,26753,30509,35523,4,33,14,1,0,1,0,4,294,94,26852,27633,30277,0,86,-4,-99,-4,2876,5246,-1,0,-1,0,2
EUN1_3570029671',2,24,12,0,0,1,0,12,1,344,78,27558,30184,33198,5,28,9,2,0,1,0,3,345,67,25368,29342,24226,1,-1,11,2190,3,842,8972,-2,0,0,0,9
EUN1_3570009687',2,27,12,0,0,2,0,8,0,340,91,28050,31076,32529,4,23,15,2,1,1,0,3,360,88,27813,29981,36219,1,-20,3,237,-3,1095,-3690,-2,-1,1,0,5
EUN1_3569821972',10,46,10,1,1,0,0,8,0,332,113,26241,29045,27055,4,25,8,0,0,0,0,2,386,64,25811,30831,30436,0,-54,49,430,2,-1786,-3381,1,1,0,0,6
EUN1_3566075610',3,28,13,1,0,1,0,13,1,330,94,29178,28817,35300,2,31,20,1,0,2,0,5,349,68,29731,31179,40604,1,-19,26,-553,-7,-2362,-5304,0,0,-1,0,8
EUN1_3565787129',3,23,17,2,0,1,0,5,1,376,86,30100,31508,44121,5,34,10,0,0,0,0,5,314,102,25206,29016,27163,1,62,-16,4894,7,2492,16958,2,0,1,0,0
EUN1_3565692590',7,44,7,1,0,1,0,4,1,390,104,26697,30138,25274,5,80,6,1,0,0,0,5,342,84,22632,26961,17560,0,48,20,4065,1,3177,7714,0,0,1,0,-1
EUN1_3565658890',3,28,5,0,0,0,0,9,0,357,80,23612,29355,21131,7,31,19,1,1,3,0,1,409,100,33274,32974,37744,0,-52,-20,-9662,-14,-3619,-16613,-1,-1,-3,0,8
EUN1_3576065316',2,23,9,0,0,0,0,11,1,303,72,24279,27416,29877,4,29,20,2,0,2,0,0,357,88,31266,31117,38167,0,-54,-16,-6987,-11,-3701,-8290,-2,0,-2,0,11
EUN1_3576035145',2,62,9,0,0,2,0,6,0,352,104,27806,31075,29379,3,92,8,1,0,0,0,10,338,87,24283,27786,27099,1,14,17,3523,1,3289,2280,-1,0,2,0,-4
EUN1_3575996907',4,59,11,1,0,0,0,4,0,378,99,27400,31361,27999,2,58,8,0,0,2,0,2,359,83,25175,28464,24146,1,19,16,2225,3,2897,3853,1,0,-2,0,2
EUN1_3575966313',1,26,11,1,0,0,0,10,1,329,81,25627,28605,32121,2,23,16,1,0,1,0,2,373,86,28540,30016,31066,0,-44,-5,-2913,-5,-1411,1055,0,0,-1,0,8
EUN1_3575940328',2,28,9,1,0,0,0,14,0,335,65,24551,29055,32307,1,27,15,1,0,3,0,2,384,98,30524,31222,40087,0,-49,-33,-5973,-6,-2167,-7780,0,0,-3,0,12
EUN1_3575796494',5,28,7,0,0,0,0,11,0,327,72,24263,26559,23764,3,25,20,2,0,2,0,3,347,92,31826,32140,41811,0,-20,-20,-7563,-13,-5581,-18047,-2,0,-2,0,8
EUN1_3575750967',4,273,10,1,0,0,0,7,1,363,70,25171,27375,25963,4,22,12,1,0,0,0,1,395,86,26394,30710,31215,0,-32,-16,-1223,-2,-3335,-5252,0,0,0,0,6
EUN1_3575726006',2,141,5,2,0,0,0,5,0,420,104,26170,30483,24544,1,24,6,0,0,2,0,5,379,99,24782,29843,22481,0,41,5,1388,-1,640,2063,2,0,-2,0,0
EUN1_3575720882',0,23,15,1,0,0,0,5,1,374,94,28102,30647,35840,1,24,12,1,0,0,0,1,339,78,26089,28680,31334,1,35,16,2013,3,1967,4506,0,0,0,0,4
EUN1_3575536062',6,28,19,1,0,2,0,10,1,381,62,31830,30545,41648,1,23,15,1,0,0,0,8,388,74,29009,32375,35137,0,-7,-12,2821,4,-1830,6511,0,0,2,0,2
EUN1_3575517203',5,33,15,0,0,1,0,8,1,323,62,28953,28545,29141,1,23,13,1,0,3,0,5,371,108,29794,30639,34716,1,-48,-46,-841,2,-2094,-5575,-1,0,-2,0,3
EUN1_3575492278',5,31,12,0,0,0,0,11,0,326,82,25384,28960,25024,4,26,14,2,0,2,0,2,367,88,29183,30155,32663,0,-41,-6,-3799,-2,-1195,-7639,-2,0,-2,0,9
EUN1_3575434380',3,26,6,0,0,1,0,13,0,326,82,23906,25239,26907,4,31,21,2,0,3,0,2,389,86,32241,33366,35392,0,-63,-4,-8335,-15,-8127,-8485,-2,0,-2,0,11
EUN1_3575389185',4,27,19,0,0,3,0,2,1,335,110,32612,30461,40721,8,48,8,1,0,1,0,12,268,82,23200,23833,27850,1,67,28,9412,11,6628,12871,-1,0,2,0,-10
EUN1_3575812954',5,27,7,0,0,0,0,6,0,390,61,24435,28512,22314,9,35,13,2,0,0,0,2,367,78,27226,29624,29924,0,23,-17,-2791,-6,-1112,-7610,-2,0,0,0,4
EUN1_3575303168',4,25,13,1,0,0,0,5,0,358,86,27992,31009,31287,3,25,13,1,0,0,0,7,363,80,28091,29802,33940,1,-5,6,-99,0,1207,-2653,0,0,0,0,-2
EUN1_3575279427',2,24,12,1,0,0,0,6,1,331,85,26402,30738,34681,5,24,11,1,0,2,0,2,364,78,27692,30635,30542,1,-33,7,-1290,1,103,4139,0,0,-2,0,4
EUN1_3574692008',6,46,11,1,0,2,0,9,0,358,80,28808,27266,28984,3,74,10,0,0,0,0,11,351,62,26245,26881,35213,1,7,18,2563,1,385,-6229,1,0,2,0,-2
EUN1_3573629561',5,31,12,0,0,0,0,10,0,319,83,27821,28679,36274,6,26,14,2,0,2,0,1,346,100,30316,29958,34659,1,-27,-17,-2495,-2,-1279,1615,-2,0,-2,0,9
EUN1_3573613142',5,31,5,1,0,0,0,10,0,387,85,24117,29574,25678,4,22,9,1,0,1,0,2,382,110,27006,31643,31262,0,5,-25,-2889,-4,-2069,-5584,0,0,-1,0,8
EUN1_3573594520',5,30,16,2,0,2,0,8,0,342,124,29542,31673,36550,3,23,14,0,0,0,0,5,319,73,27428,28288,28916,1,23,51,2114,2,3385,7634,2,0,2,0,3
EUN1_3573580008',2,24,11,0,0,0,0,12,0,282,88,25921,28300,35192,5,30,21,2,0,3,0,2,356,116,32581,34087,36024,0,-74,-28,-6660,-10,-5787,-832,-2,0,-3,0,10
EUN1_3573576186',2,21,10,1,0,0,0,9,0,313,96,24995,30504,29889,6,27,11,1,0,1,0,3,332,95,27642,32789,32996,0,-19,1,-2647,-1,-2285,-3107,0,0,-1,0,6
EUN1_3573549038',3,23,8,1,0,0,0,10,0,318,68,24181,26877,25378,4,28,19,1,1,3,0,2,369,100,32638,31028,40824,0,-51,-32,-8457,-11,-4151,-15446,0,-1,-3,0,8
EUN1_3573038290',3,33,15,1,0,1,0,8,1,386,82,30729,29373,31739,4,31,14,1,0,0,0,8,321,91,26845,29346,33697,0,65,-9,3884,1,27,-1958,0,0,1,0,0
EUN1_3573023331',3,28,11,0,0,0,0,12,0,332,82,26601,29757,25653,4,28,19,1,0,3,0,4,377,84,31594,30283,36027,0,-45,-2,-4993,-8,-526,-10374,-1,0,-3,0,8
EUN1_3573020157',4,29,14,1,0,0,0,9,0,315,102,28051,28817,32454,4,23,11,0,0,1,0,3,350,82,25316,28008,27278,1,-35,20,2735,3,809,5176,1,0,-1,0,6
EUN1_3573006332',3,39,19,1,1,2,0,8,1,330,105,31502,31334,40713,6,28,15,1,0,0,0,7,348,73,27252,29667,38298,1,-18,32,4250,4,1667,2415,0,1,2,0,1
EUN1_3572984767',1,25,11,0,0,0,0,13,0,278,82,25301,26719,31995,1,20,22,2,0,1,0,1,319,104,30604,31236,45369,0,-41,-22,-5303,-11,-4517,-13374,-2,0,-1,0,12
EUN1_3572470469',1,407,11,0,0,0,0,8,0,369,86,26476,30047,30673,3,16,13,1,0,0,0,4,317,109,26658,30207,25269,0,52,-23,-182,-2,-160,5404,-1,0,0,0,4
EUN1_3574724982',1,25,8,0,0,1,0,8,1,359,68,25704,28797,31723,5,28,14,1,0,1,0,4,337,84,27751,29584,31807,1,22,-16,-2047,-6,-787,-84,-1,0,0,0,4
EUN1_3574706566',2,22,9,0,0,0,0,8,0,329,87,25617,28397,37253,3,29,20,2,1,1,0,4,315,105,29404,30548,38849,0,14,-18,-3787,-11,-2151,-1596,-2,-1,-1,0,4
EUN1_3574689887',0,29,10,0,0,1,0,13,1,336,62,26128,27550,34135,7,31,18,1,1,2,0,5,368,102,31913,32110,38110,0,-32,-40,-5785,-8,-4560,-3975,-1,-1,-1,0,8
EUN1_3574675734',3,24,6,1,1,0,0,8,0,366,102,24908,30588,29809,3,24,13,1,0,1,0,2,367,88,28350,30526,27923,1,-1,14,-3442,-7,62,1886,0,1,-1,0,6
EUN1_3574657970',6,27,10,1,0,0,0,6,1,359,78,25546,28687,28617,3,28,12,1,0,1,0,2,337,102,27180,31692,27865,0,22,-24,-1634,-2,-3005,752,0,0,-1,0,4
EUN1_3574166636',8,43,16,1,0,1,0,8,0,350,89,28171,27947,35508,4,33,14,1,0,0,0,1,372,71,29494,30072,31227,0,-22,18,-1323,2,-2125,4281,0,0,1,0,7
EUN1_3574148629',5,23,11,1,0,0,0,7,1,305,82,25637,27331,27618,1,21,10,0,0,1,0,6,383,90,27377,29858,31432,0,-78,-8,-1740,1,-2527,-3814,1,0,-1,0,1
EUN1_3574123071',6,30,11,1,0,0,0,4,0,332,102,26032,30276,33932,1,21,7,1,0,1,0,3,349,90,26065,28986,24937,1,-17,12,-33,4,1290,8995,0,0,-1,0,1
EUN1_3574116637',7,31,5,0,0,1,0,9,1,363,118,25355,28522,21865,2,25,13,2,0,2,0,2,380,70,28739,29607,37228,0,-17,48,-3384,-8,-1085,-15363,-2,0,-1,0,7
EUN1_3574101992',3,34,15,2,0,1,0,8,0,368,86,30280,29228,37775,6,28,20,0,0,0,0,6,302,77,29801,28633,38106,1,66,9,479,-5,595,-331,2,0,1,0,2
EUN1_3573646317',4,34,19,1,0,0,0,6,1,358,110,29544,31834,38823,7,174,4,1,0,0,0,1,340,76,22242,26120,28276,1,18,34,7302,15,5714,10547,0,0,0,0,5
EUN1_3573624896',3,26,19,1,0,1,0,9,1,286,80,28591,28310,33980,4,29,10,1,0,1,0,7,311,99,26938,28139,33180,0,-25,-19,1653,9,171,800,0,0,0,0,2
EUN1_3573612676',4,40,6,1,0,1,0,14,1,343,82,26503,28407,22037,2,26,17,1,0,2,0,5,370,121,30457,33646,34181,0,-27,-39,-3954,-11,-5239,-12144,0,0,-1,0,9
EUN1_3573601721',1,22,8,1,0,0,0,7,0,366,99,24892,28451,27884,7,31,18,1,0,0,0,2,337,90,28362,30284,31509,0,29,9,-3470,-10,-1833,-3625,0,0,0,0,5
EUN1_3573576657',9,33,11,1,0,0,0,8,0,356,80,28042,26751,34194,4,36,16,1,0,0,0,2,329,84,28593,29898,32932,0,27,-4,-551,-5,-3147,1262,0,0,0,0,6
EUN1_3573561793',4,44,13,1,0,0,0,13,0,290,94,27669,28829,37041,3,61,19,1,0,2,0,2,356,61,31246,29308,44571,0,-66,33,-3577,-6,-479,-7530,0,0,-2,0,11
EUN1_3573554461',10,230,13,1,0,0,0,5,0,313,96,26543,30061,32776,3,25,10,1,0,1,0,4,356,70,25837,30119,27887,0,-43,26,706,3,-58,4889,0,0,-1,0,1
EUN1_3573234662',3,19,6,0,0,1,0,6,0,302,69,23435,26929,26894,1,19,12,1,0,0,0,4,358,82,26840,30000,28426,0,-56,-13,-3405,-6,-3071,-1532,-1,0,1,0,2
EUN1_3573868702',1,25,6,1,0,0,0,13,0,297,60,22932,25449,28058,5,102,27,1,0,3,0,2,373,88,35122,32362,46298,0,-76,-28,-12190,-21,-6913,-18240,0,0,-3,0,11
EUN1_3573831032',2,48,17,1,0,0,0,4,1,342,82,30211,28265,37085,1,45,24,0,0,0,0,7,319,90,32348,28679,41644,0,23,-8,-2137,-7,-414,-4559,1,0,0,0,-3
EUN1_3575687900',2,23,8,0,0,0,0,4,0,296,53,23311,25795,23837,3,372,13,1,0,1,0,2,359,79,27097,31781,35737,0,-63,-26,-3786,-5,-5986,-11900,-1,0,-1,0,2
EUN1_3575691575',2,28,27,2,0,2,0,11,1,359,94,32472,34198,42689,0,15,4,0,0,1,0,9,344,94,23861,26880,22751,1,15,0,8611,23,7318,19938,2,0,1,0,2
EUN1_3574672897',1,28,11,1,0,1,0,12,0,365,66,27087,26912,29880,3,28,13,0,0,1,0,4,343,93,28172,29318,31706,0,22,-27,-1085,-2,-2406,-1826,1,0,0,0,8
EUN1_3574616332',1,20,13,2,1,0,0,7,1,331,128,26403,32075,29141,4,22,12,0,0,0,0,2,308,60,25931,28118,28768,1,23,68,472,1,3957,373,2,1,0,0,5
EUN1_3574614208',5,22,22,1,0,1,0,11,0,305,96,31454,30765,40965,1,33,17,1,0,2,0,4,321,67,29418,29396,38537,1,-16,29,2036,5,1369,2428,0,0,-1,0,7
EUN1_3574602702',0,24,23,0,0,0,0,11,0,314,66,31308,31042,33928,6,34,19,2,0,2,0,3,315,96,30057,28964,40052,0,-1,-30,1251,4,2078,-6124,-2,0,-2,0,8
EUN1_3574603325',0,16,13,1,0,1,0,11,1,354,92,27490,29489,27280,3,18,8,1,1,0,0,3,319,74,25135,28378,21148,1,35,18,2355,5,1111,6132,0,-1,1,0,8
EUN1_3574076226',3,29,16,1,0,2,0,10,0,347,76,28634,29608,33617,3,29,12,1,0,1,0,8,322,92,26513,27644,27195,1,25,-16,2121,4,1964,6422,0,0,1,0,2
EUN1_3573506987',2,29,15,2,0,0,0,12,1,320,74,27870,28380,30544,2,33,17,0,0,1,0,3,380,90,30101,31118,39829,0,-60,-16,-2231,-2,-2738,-9285,2,0,-1,0,9
EUN1_3573507718',3,21,11,2,0,0,0,10,1,319,94,26379,28819,26625,3,31,13,0,0,0,0,6,294,88,26289,27739,37006,0,25,6,90,-2,1080,-10381,2,0,0,0,4
EUN1_3573478422',8,36,18,1,0,0,0,10,0,339,84,29407,29795,40271,3,27,21,1,0,0,0,4,365,68,29768,31930,46128,0,-26,16,-361,-3,-2135,-5857,0,0,0,0,6
EUN1_3573459595',2,19,23,2,0,3,0,11,1,330,92,33664,33022,40360,3,15,14,0,0,0,0,6,292,84,26562,27599,36045,1,38,8,7102,9,5423,4315,2,0,3,0,5
EUN1_3573439679',2,206,23,1,1,3,0,7,1,359,94,36261,31331,42758,5,30,13,1,0,0,0,10,302,85,27593,28593,31897,1,57,9,8668,10,2738,10861,0,1,3,0,-3
EUN1_3575858925',2,35,18,1,0,0,0,6,0,363,78,31030,31343,34483,0,17,14,0,0,1,0,8,375,82,28026,31013,29366,1,-12,-4,3004,4,330,5117,1,0,-1,0,-2
EUN1_3575820247',2,24,11,1,1,2,0,6,1,396,63,29223,29433,28011,1,156,11,0,0,0,0,7,336,112,26974,29775,25696,1,60,-49,2249,0,-342,2315,1,1,2,0,-1
EUN1_3575799240',6,49,6,0,0,0,0,11,0,330,80,23594,26452,27865,2,22,13,2,0,3,0,3,361,102,28099,30432,31147,0,-31,-22,-4505,-7,-3980,-3282,-2,0,-3,0,8
EUN1_3575777676',0,24,13,0,0,0,0,10,0,375,98,27988,30997,28435,3,25,13,1,1,0,0,2,357,89,27979,29761,34267,0,18,9,9,0,1236,-5832,-1,-1,0,0,8
EUN1_3573635411',2,34,14,1,0,0,0,15,0,294,88,27015,29790,26498,3,29,16,1,1,3,0,2,391,84,31337,33325,35816,0,-97,4,-4322,-2,-3535,-9318,0,-1,-3,0,13
EUN1_3573619416',4,27,17,2,1,0,0,10,1,366,66,28522,30069,37639,5,28,13,0,0,1,0,3,329,85,28708,30353,39308,1,37,-19,-186,4,-284,-1669,2,1,-1,0,7
EUN1_3573608344',5,28,13,2,1,3,0,7,1,380,94,30946,32110,33933,2,14,10,0,0,0,0,10,377,98,26604,30554,28803,1,3,-4,4342,3,1556,5130,2,1,3,0,-3
EUN1_3573595212',7,27,17,1,0,2,0,6,1,385,96,30736,32389,32608,1,20,5,1,0,0,0,6,342,107,25141,28281,25766,1,43,-11,5595,12,4108,6842,0,0,2,0,0
EUN1_3573367445',5,22,6,0,0,0,0,8,1,371,108,25343,29867,22075,8,32,16,2,0,0,0,0,393,103,28819,33628,35299,1,-22,5,-3476,-10,-3761,-13224,-2,0,0,0,8
EUN1_3573097160',6,26,16,2,0,1,0,12,1,342,74,29385,29180,36142,2,56,15,0,0,2,0,5,303,86,27384,27904,37693,1,39,-12,2001,1,1276,-1551,2,0,-1,0,7
EUN1_3573071643',0,28,7,1,0,0,0,9,1,398,100,25671,31488,36265,3,30,10,0,0,0,0,2,400,75,26432,29264,30629,1,-2,25,-761,-3,2224,5636,1,0,0,0,7
EUN1_3573052249',3,27,8,0,0,0,0,7,0,340,94,24584,28854,26412,2,18,10,1,0,1,0,3,371,99,26911,31333,31873,0,-31,-5,-2327,-2,-2479,-5461,-1,0,-1,0,4
EUN1_3573039172',2,23,11,1,0,0,0,8,1,269,101,25625,27630,30932,5,29,14,1,0,0,0,4,333,94,27233,29246,30797,1,-64,7,-1608,-3,-1616,135,0,0,0,0,4
EUN1_3573013032',4,45,11,2,0,1,0,7,0,336,98,26868,31758,27890,5,99,9,0,0,0,0,5,361,97,26285,30668,29369,1,-25,1,583,2,1090,-1479,2,0,1,0,2
EUN1_3572288082',4,42,15,1,0,0,0,9,0,266,68,27523,26555,37794,1,18,14,1,0,2,0,7,293,104,28191,28099,25327,0,-27,-36,-668,1,-1544,12467,0,0,-2,0,2
EUN1_3572025904',3,27,25,1,0,2,0,10,1,316,100,33460,30219,46193,4,23,12,0,0,0,0,5,258,68,25668,24036,35960,1,58,32,7792,13,6183,10233,1,0,2,0,5
EUN1_3572011767',0,19,19,2,0,0,0,4,1,320,112,29586,31535,34011,0,25,13,0,0,0,0,2,302,86,26533,29872,32960,1,18,26,3053,6,1663,1051,2,0,0,0,2
EUN1_3576204919',3,28,11,0,0,0,0,4,1,318,72,24781,27278,29163,6,29,18,1,1,0,0,2,338,80,27368,29110,36396,0,-20,-8,-2587,-7,-1832,-7233,-1,-1,0,0,2
EUN1_3575456305',2,42,13,1,1,1,0,5,0,353,104,28435,30204,32533,1,266,12,1,0,0,0,3,353,72,26309,29330,28440,0,0,32,2126,1,874,4093,0,1,1,0,2
EUN1_3575428678',3,26,15,0,0,0,0,7,0,320,72,26925,27818,36957,2,24,13,1,0,0,0,3,308,76,25758,27635,29621,1,12,-4,1167,2,183,7336,-1,0,0,0,4
EUN1_3575413262',3,29,8,0,0,0,0,6,1,368,74,25430,27475,26134,4,27,10,2,0,0,0,2,320,86,25140,26695,26712,0,48,-12,290,-2,780,-578,-2,0,0,0,4
EUN1_3575392200',3,28,12,0,0,0,0,6,0,357,70,26771,27132,34854,11,36,18,2,0,0,0,4,316,86,29901,30424,38270,0,41,-16,-3130,-6,-3292,-3416,-2,0,0,0,2
EUN1_3575247091',3,26,4,0,0,0,0,9,0,324,64,22118,25068,24805,4,34,22,2,0,1,0,4,339,84,30357,30808,35819,0,-15,-20,-8239,-18,-5740,-11014,-2,0,-1,0,5
EUN1_3575222634',2,23,11,2,0,0,0,9,1,345,89,26533,29540,37386,3,26,16,0,0,1,0,3,276,77,28223,31655,30921,0,69,12,-1690,-5,-2115,6465,2,0,-1,0,6
EUN1_3575217359',1,17,22,1,0,2,0,12,0,344,78,31949,32914,38235,3,24,16,0,0,1,0,7,329,86,29632,27634,37044,1,15,-8,2317,6,5280,1191,1,0,1,0,5
EUN1_3573794758',3,31,8,2,0,0,0,4,1,329,103,24501,30845,27786,6,143,5,0,0,0,0,3,338,81,23032,30027,26610,1,-9,22,1469,3,818,1176,2,0,0,0,1
EUN1_3573785195',3,28,27,2,0,2,0,11,0,346,73,34024,31349,42002,4,23,18,0,0,0,0,8,260,90,28813,28049,39029,1,86,-17,5211,9,3300,2973,2,0,2,0,3
EUN1_3573761470',6,28,15,1,0,0,0,7,1,368,69,27937,30242,33385,3,25,11,0,0,0,0,1,346,88,26078,27755,28102,1,22,-19,1859,4,2487,5283,1,0,0,0,6
EUN1_3573742840',3,27,16,1,0,5,0,5,1,370,112,32215,33715,32948,1,246,4,1,0,0,0,12,306,84,22034,28005,18972,1,64,28,10181,12,5710,13976,0,0,5,0,-7
EUN1_3573681739',4,22,13,1,0,1,0,6,1,365,98,27631,29856,24939,1,28,9,0,0,0,0,4,322,101,25442,27996,24995,1,43,-3,2189,4,1860,-56,1,0,1,0,2
EUN1_3567329369',4,25,14,1,1,0,0,9,0,353,84,28248,29857,38252,4,27,9,1,0,1,0,1,359,112,27321,29561,37333,1,-6,-28,927,5,296,919,0,1,-1,0,8
EUN1_3566280062',5,26,15,0,0,0,0,8,1,323,88,28339,28559,34129,5,26,21,2,1,0,0,1,358,83,29590,31638,37433,0,-35,5,-1251,-6,-3079,-3304,-2,-1,0,0,7
EUN1_3565849251',4,22,9,0,0,2,0,13,0,368,84,27680,28556,26319,6,32,12,2,0,2,0,2,363,84,28097,28868,32053,1,5,0,-417,-3,-312,-5734,-2,0,0,0,11
EUN1_3565391148',4,24,5,0,0,0,0,12,0,322,104,23070,27799,21213,4,225,11,2,1,1,0,1,361,107,27680,32384,33786,0,-39,-3,-4610,-6,-4585,-12573,-2,-1,-1,0,11
EUN1_3564512042',4,20,3,0,0,0,0,11,0,294,89,21467,24637,26994,7,31,16,2,0,3,0,1,386,82,29576,31044,30110,0,-92,7,-8109,-13,-6407,-3116,-2,0,-3,0,10
EUN1_3564497261',3,29,12,1,0,0,0,9,0,342,86,26906,27833,33668,2,70,13,1,0,0,0,4,307,90,27325,29543,31727,1,35,-4,-419,-1,-1710,1941,0,0,0,0,5
EUN1_3564031839',4,32,15,1,0,0,0,5,1,362,66,28831,28984,34574,3,29,12,0,0,1,0,6,319,94,26210,28542,30377,1,43,-28,2621,3,442,4197,1,0,-1,0,-1
EUN1_3564009152',1,30,15,0,0,1,0,12,1,350,84,27704,28217,33902,1,26,17,2,1,1,0,4,341,108,30574,29894,30741,0,9,-24,-2870,-2,-1677,3161,-2,-1,0,0,8
EUN1_3563424672',4,28,10,1,0,1,0,9,0,319,80,25107,26578,27609,8,41,14,1,0,1,0,1,350,84,28918,29183,41093,0,-31,-4,-3811,-4,-2605,-13484,0,0,0,0,8
EUN1_3563394862',5,28,15,0,1,1,0,8,1,322,110,29658,29941,29686,1,23,13,2,0,0,0,3,368,74,26669,29676,32567,1,-46,36,2989,2,265,-2881,-2,1,1,0,5
EUN1_3562478185',8,28,16,1,0,1,0,13,1,333,74,30212,28072,43786,4,25,19,0,0,1,0,4,336,81,31039,31114,41297,0,-3,-7,-827,-3,-3042,2489,1,0,0,0,9
EUN1_3560998557',5,28,19,2,0,0,0,9,1,326,60,29060,28184,31884,4,28,14,0,0,0,0,3,376,112,30153,30330,37798,1,-50,-52,-1093,5,-2146,-5914,2,0,0,0,6
EUN1_3560754103',4,42,11,1,0,0,0,9,1,376,108,27170,31497,26238,4,38,6,1,0,1,0,3,379,92,24137,28978,26419,0,-3,16,3033,5,2519,-181,0,0,-1,0,6
EUN1_3560742252',1,25,15,1,0,0,0,6,1,375,98,30526,31572,37091,4,33,10,1,0,1,0,2,358,82,26593,28709,23209,1,17,16,3933,5,2863,13882,0,0,-1,0,4
EUN1_3560480622',4,28,9,0,0,0,0,10,1,317,84,24610,27348,25497,4,29,13,2,0,1,0,1,329,70,26916,29935,26966,0,-12,14,-2306,-4,-2587,-1469,-2,0,-1,0,9
EUN1_3560140084',3,24,10,0,0,0,0,7,0,328,74,25586,28888,28253,2,42,15,1,0,1,0,4,359,118,30763,31593,38370,0,-31,-44,-5177,-5,-2705,-10117,-1,0,-1,0,3
EUN1_3560120902',2,348,12,1,0,1,0,10,1,321,80,26934,27382,35746,6,31,17,1,0,1,0,3,320,84,29616,29682,37193,0,1,-4,-2682,-5,-2300,-1447,0,0,0,0,7
EUN1_3559731151',3,28,11,1,1,0,0,10,0,356,92,27092,29035,31126,9,35,14,1,0,1,0,3,354,112,28667,30611,29852,1,2,-20,-1575,-3,-1576,1274,0,1,-1,0,7
EUN1_3559652608',5,30,14,1,0,1,0,3,1,392,76,29161,29625,29687,5,26,8,1,0,0,0,8,343,83,25128,28053,23212,1,49,-7,4033,6,1572,6475,0,0,1,0,-5
EUN1_3576096467',6,23,12,0,0,1,0,6,1,342,68,26718,27668,29657,5,22,11,2,0,0,0,4,303,92,25275,28018,27882,1,39,-24,1443,1,-350,1775,-2,0,1,0,2
EUN1_3575880431',5,24,10,1,0,1,0,6,0,412,86,27673,30302,30295,5,127,10,0,0,0,0,3,353,106,27240,30800,32762,1,59,-20,433,0,-498,-2467,1,0,1,0,3
EUN1_3575866166',0,28,6,0,0,0,0,7,0,351,90,24655,29267,27504,3,25,15,1,1,0,0,2,318,118,27308,30429,33178,0,33,-28,-2653,-9,-1162,-5674,-1,-1,0,0,5
EUN1_3575816898',2,31,21,0,0,0,0,4,0,277,60,28971,27876,43623,3,25,25,1,0,1,0,3,282,80,30135,29875,44557,0,-5,-20,-1164,-4,-1999,-934,-1,0,-1,0,1
EUN1_3575804090',6,30,15,1,0,0,0,5,1,287,84,25860,26660,34329,4,41,14,0,0,1,0,2,324,80,27671,29950,27971,1,-37,4,-1811,1,-3290,6358,1,0,-1,0,3
EUN1_3575780093',2,25,14,0,0,0,0,7,0,359,104,29387,30873,30854,9,29,13,2,0,1,0,3,312,100,26548,28307,29170,0,47,4,2839,1,2566,1684,-2,0,-1,0,4
EUN1_3575752799',5,44,15,2,0,1,0,4,1,355,86,28576,31203,39154,6,34,11,0,0,0,0,5,316,74,23699,25963,29765,1,39,12,4877,4,5240,9389,2,0,1,0,-1
EUN1_3575731822',5,31,17,1,0,1,0,8,0,298,84,28212,29557,30336,4,35,20,0,0,1,0,1,344,84,30461,29476,40419,1,-46,0,-2249,-3,81,-10083,1,0,0,0,7
EUN1_3575458279',2,23,19,0,0,1,0,3,1,345,95,29777,31153,38675,3,28,16,1,0,2,0,5,321,82,29034,29547,37059,0,24,13,743,3,1606,1616,-1,0,-1,0,-2
EUN1_3575365289',3,29,15,1,0,0,0,6,1,376,88,27542,30885,31360,4,44,13,1,0,1,0,4,296,84,25705,28125,34074,0,80,4,1837,2,2760,-2714,0,0,-1,0,2
EUN1_3575341103',1,58,10,1,0,0,0,16,1,316,80,25075,28840,29832,5,67,14,1,0,2,0,1,336,100,28502,30682,36999,0,-20,-20,-3427,-4,-1842,-7167,0,0,-2,0,15
EUN1_3575320322',5,31,9,1,0,2,0,8,0,377,95,27562,30327,22379,2,38,6,1,0,0,0,6,342,92,22805,28200,24629,1,35,3,4757,3,2127,-2250,0,0,2,0,2
EUN1_3573595348',1,23,8,2,0,1,0,8,0,392,69,25733,29586,27930,5,89,9,0,0,1,0,3,339,87,25176,29078,28523,0,53,-18,557,-1,508,-593,2,0,0,0,5
EUN1_3573570913',0,22,20,2,0,0,0,9,0,335,99,30711,32728,39907,5,318,10,0,0,1,0,8,347,72,25909,26293,29452,1,-12,27,4802,10,6435,10455,2,0,-1,0,1
EUN1_3572485043',4,33,14,0,0,0,0,6,0,300,88,27362,28960,32351,3,49,17,1,0,0,0,2,331,80,28308,28102,35208,1,-31,8,-946,-3,858,-2857,-1,0,0,0,4
EUN1_3572474062',3,26,14,1,0,1,0,7,1,394,74,29431,29802,28505,6,26,9,1,0,0,0,7,362,78,25241,27960,29132,0,32,-4,4190,5,1842,-627,0,0,1,0,0
EUN1_3572057826',4,25,15,0,0,0,0,6,1,303,92,27339,27807,35190,3,14,15,1,0,2,0,4,341,72,28170,28369,29883,0,-38,20,-831,0,-562,5307,-1,0,-2,0,2
EUN1_3571973759',3,26,4,0,0,0,0,9,0,377,77,22988,28101,21389,4,30,13,2,1,1,0,1,381,112,29416,32667,28144,0,-4,-35,-6428,-9,-4566,-6755,-2,-1,-1,0,8
EUN1_3571960624',3,138,10,2,0,1,0,6,0,345,79,25962,27887,24737,3,39,13,0,1,1,0,5,304,70,26277,26445,23057,0,41,9,-315,-3,1442,1680,2,-1,0,0,1
EUN1_3571946772',3,30,12,1,0,1,0,10,0,285,85,26398,29611,28407,3,36,4,1,0,1,0,4,346,82,23740,26841,24893,1,-61,3,2658,8,2770,3514,0,0,0,0,6
EUN1_3575357864',2,32,12,1,0,0,0,11,1,347,96,28008,30121,29970,4,27,14,1,0,2,0,4,336,96,27081,30569,28803,1,11,0,927,-2,-448,1167,0,0,-2,0,7
EUN1_3571430212',7,35,4,1,0,1,0,5,0,349,95,24378,29554,25085,2,22,2,0,0,0,0,5,388,69,22775,27777,25318,1,-39,26,1603,2,1777,-233,1,0,1,0,0
EUN1_3568297788',2,22,2,0,0,0,0,11,0,301,92,21388,26494,21332,2,29,13,2,0,2,0,1,385,112,29296,32699,36877,0,-84,-20,-7908,-11,-6205,-15545,-2,0,-2,0,10
EUN1_3567826900',5,149,21,2,0,1,0,6,1,339,81,30941,30828,42085,3,28,6,0,0,0,0,5,305,86,23712,26831,28681,1,34,-5,7229,15,3997,13404,2,0,1,0,1
EUN1_3567459222',3,25,14,1,1,1,0,10,0,369,107,29821,32340,30568,2,26,14,1,0,1,0,6,338,96,28424,28424,27390,0,31,11,1397,0,3916,3178,0,1,0,0,4
EUN1_3567439247',6,74,8,0,0,0,0,9,0,291,75,23789,25091,33669,8,68,17,2,0,1,0,3,339,122,28869,31702,37480,0,-48,-47,-5080,-9,-6611,-3811,-2,0,-1,0,6
EUN1_3567411023',0,25,10,2,0,0,0,5,1,380,70,27493,29187,30549,5,78,13,0,0,1,0,3,327,89,26668,27114,35401,1,53,-19,825,-3,2073,-4852,2,0,-1,0,2
EUN1_3567392021',4,26,18,2,0,0,0,5,1,323,96,28353,30455,43590,4,24,8,0,0,1,0,4,292,72,25093,26247,34022,1,31,24,3260,10,4208,9568,2,0,-1,0,1
EUN1_3565466407',2,26,17,2,1,0,0,7,1,310,106,29703,30479,37541,5,48,16,0,0,0,0,3,323,73,28144,27941,31526,1,-13,33,1559,1,2538,6015,2,1,0,0,4
EUN1_3565246814',5,32,14,0,0,0,0,15,0,250,59,25469,27423,31613,2,24,22,1,0,2,0,2,328,88,31927,29696,42769,0,-78,-29,-6458,-8,-2273,-11156,-1,0,-2,0,13
EUN1_3565185360',3,28,11,0,0,1,0,6,1,375,52,25984,29159,29994,2,25,7,2,0,0,0,6,349,96,25841,30229,25162,1,26,-44,143,4,-1070,4832,-2,0,1,0,0
EUN1_3565167069',4,27,15,1,0,0,0,8,1,352,102,29385,31482,30398,5,26,9,0,0,1,0,1,343,86,25627,29943,30926,1,9,16,3758,6,1539,-528,1,0,-1,0,7
EUN1_3565021976',2,24,11,0,0,0,0,11,0,378,73,26775,29768,36283,5,28,21,2,0,2,0,5,373,87,31713,30584,40656,0,5,-14,-4938,-10,-816,-4373,-2,0,-2,0,6
EUN1_3565003723',3,52,12,1,0,1,0,11,0,272,77,26379,25665,35555,2,24,20,0,0,0,0,0,299,76,27510,28588,33395,0,-27,1,-1131,-8,-2923,2160,1,0,1,0,11
EUN1_3564826429',6,22,10,0,0,0,0,6,1,336,122,25905,30777,33045,3,143,12,1,0,0,0,3,311,50,24978,26777,32338,1,25,72,927,-2,4000,707,-1,0,0,0,3
EUN1_3564576876',0,24,15,0,0,2,0,12,0,365,85,29518,32210,34274,0,24,7,1,0,1,0,2,323,82,24190,26266,28922,1,42,3,5328,8,5944,5352,-1,0,1,0,10
EUN1_3564561610',0,22,10,0,0,0,0,12,0,338,86,26047,28488,30990,7,30,15,0,1,1,0,3,349,72,29116,30873,33438,0,-11,14,-3069,-5,-2385,-2448,0,-1,-1,0,9
EUN1_3575543250',7,26,13,2,0,1,0,9,0,368,88,28197,30466,30301,2,28,4,0,0,0,0,6,337,76,23275,26578,21375,1,31,12,4922,9,3888,8926,2,0,1,0,3
EUN1_3575510109',3,35,8,0,0,0,0,14,0,349,80,24598,28414,21553,6,32,13,2,0,1,0,1,377,87,28656,31240,25622,0,-28,-7,-4058,-5,-2826,-4069,-2,0,-1,0,13
EUN1_3575461859',2,25,21,1,1,2,0,9,1,324,91,32513,31905,35110,2,36,9,1,0,0,0,7,352,92,26580,29077,24072,1,-28,-1,5933,12,2828,11038,0,1,2,0,2
EUN1_3575422024',5,24,21,0,0,2,0,5,1,391,92,31879,32588,40607,2,28,2,2,1,1,0,6,324,84,21818,25415,22962,1,67,8,10061,19,7173,17645,-2,-1,1,0,-1
EUN1_3575400136',6,27,8,2,0,1,0,7,0,338,88,25521,28474,37795,1,25,8,0,1,0,0,4,305,79,24382,27847,33275,0,33,9,1139,0,627,4520,2,-1,1,0,3
EUN1_3575377249',5,133,12,0,0,1,0,13,1,336,74,26667,30222,29243,5,63,9,1,0,1,0,6,355,90,26436,29668,26900,0,-19,-16,231,3,554,2343,-1,0,0,0,7
EUN1_3575198559',3,193,16,2,0,2,0,7,1,360,91,29959,31428,35978,2,21,12,0,0,1,0,4,302,71,24911,26202,31515,1,58,20,5048,4,5226,4463,2,0,1,0,3
EUN1_3575191121',6,171,18,2,1,1,0,9,1,351,104,30987,31079,35041,1,20,12,0,0,0,0,4,335,92,27735,31250,30464,1,16,12,3252,6,-171,4577,2,1,1,0,5
EUN1_3575176478',0,23,9,1,0,0,0,12,0,332,66,24558,29634,23823,5,288,8,1,0,1,0,2,363,87,25112,28317,26562,1,-31,-21,-554,1,1317,-2739,0,0,-1,0,10
EUN1_3575035710',4,23,13,0,0,0,0,7,1,321,78,26344,29516,27186,5,34,10,0,0,0,0,1,353,78,24949,28742,27710,1,-32,0,1395,3,774,-524,0,0,0,0,6
EUN1_3575010933',6,33,16,1,0,1,0,10,1,353,103,28601,32243,34816,2,173,11,1,0,1,0,2,345,76,26224,27723,30215,1,8,27,2377,5,4520,4601,0,0,0,0,8
EUN1_3573861872',1,31,27,1,1,2,0,10,1,301,91,35156,30118,39122,3,25,12,0,0,1,0,9,293,72,26932,24547,29764,1,8,19,8224,15,5571,9358,1,1,1,0,1
EUN1_3573825297',4,60,9,1,0,1,0,9,1,375,64,26397,28479,35001,4,138,11,0,0,0,0,3,317,88,26191,29081,28953,1,58,-24,206,-2,-602,6048,1,0,1,0,6
EUN1_3576098552',2,24,10,0,0,0,0,12,0,295,88,25034,26323,31870,4,323,16,2,0,1,0,2,350,84,30420,29019,29405,0,-55,4,-5386,-6,-2696,2465,-2,0,-1,0,10
EUN1_3575847141',2,22,22,1,0,1,0,11,1,340,72,33027,31263,41186,3,17,14,0,0,2,0,2,312,84,28327,28212,38712,1,28,-12,4700,8,3051,2474,1,0,-1,0,9
EUN1_3575818053',1,33,10,0,0,1,0,10,0,386,78,26085,29827,26999,6,26,15,2,0,2,0,5,383,93,30075,31120,30456,1,3,-15,-3990,-5,-1293,-3457,-2,0,-1,0,5
EUN1_3575805488',2,21,19,1,0,2,0,7,1,343,84,29363,30527,38271,1,62,2,0,0,0,0,5,312,67,20378,24618,24695,1,31,17,8985,17,5909,13576,1,0,2,0,2
EUN1_3575791395',2,21,12,2,0,0,0,8,0,336,81,25741,29192,36707,4,24,18,0,0,1,0,3,307,74,29703,33392,33665,1,29,7,-3962,-6,-4200,3042,2,0,-1,0,5
EUN1_3575635206',4,26,14,1,0,2,0,8,1,343,58,28729,29409,32519,2,27,18,1,0,2,0,7,325,118,31400,33188,45600,0,18,-60,-2671,-4,-3779,-13081,0,0,0,0,1
EUN1_3575618239',2,29,13,0,0,0,0,14,0,323,84,25910,29044,25855,7,37,18,1,0,2,0,4,356,88,31031,29032,37303,0,-33,-4,-5121,-5,12,-11448,-1,0,-2,0,10
EUN1_3575595759',2,15,19,1,0,0,0,6,1,340,46,29489,29307,40568,5,26,17,0,0,1,0,5,296,78,27270,27511,35469,1,44,-32,2219,2,1796,5099,1,0,-1,0,1
EUN1_3573311137',3,26,11,1,0,1,0,9,0,327,94,27061,30243,33871,5,28,14,1,0,1,0,4,343,82,28403,29390,42761,0,-16,12,-1342,-3,853,-8890,0,0,0,0,5
EUN1_3573275221',1,30,10,1,0,0,0,10,1,285,68,25010,26568,38749,5,27,20,1,0,1,0,0,332,84,30985,30564,42586,0,-47,-16,-5975,-10,-3996,-3837,0,0,-1,0,10
EUN1_3573059410',4,58,19,1,0,3,0,7,0,357,101,32142,31567,42858,2,20,16,0,0,0,0,6,290,60,27699,27502,32226,1,67,41,4443,3,4065,10632,1,0,3,0,1
EUN1_3573038455',1,30,12,1,0,0,0,9,0,326,83,25699,27939,36439,3,31,16,1,0,1,0,4,359,87,29757,29954,40832,0,-33,-4,-4058,-4,-2015,-4393,0,0,-1,0,5
EUN1_3573017705',6,22,15,0,0,0,0,9,1,323,99,28968,29743,36381,3,25,14,1,1,0,0,4,284,68,26060,28580,36272,1,39,31,2908,1,1163,109,-1,-1,0,0,5
EUN1_3573001959',2,21,19,0,0,1,0,10,1,301,86,30381,28086,40217,6,28,10,2,0,0,0,6,317,69,25740,26933,30704,1,-16,17,4641,9,1153,9513,-2,0,1,0,4
EUN1_3573000181',3,25,10,0,0,0,0,11,1,342,77,26145,28474,28908,3,27,15,2,0,1,0,6,409,102,29885,33944,36065,0,-67,-25,-3740,-5,-5470,-7157,-2,0,-1,0,5
EUN1_3572905207',4,37,9,0,1,0,0,9,0,307,84,25280,26548,31426,2,19,18,2,0,1,0,0,345,80,29494,30499,34965,0,-38,4,-4214,-9,-3951,-3539,-2,1,-1,0,9
EUN1_3572882321',7,30,18,2,0,0,0,6,1,374,76,29021,30519,43714,3,27,11,0,0,0,0,3,344,73,25985,30158,28283,1,30,3,3036,7,361,15431,2,0,0,0,3
EUN1_3575056980',3,28,10,0,0,1,0,12,1,369,86,28089,29895,36082,1,176,8,2,0,1,0,5,320,74,24274,29688,22464,1,49,12,3815,2,207,13618,-2,0,0,0,7
EUN1_3575036350',2,25,10,0,1,1,0,5,0,318,111,26819,28780,24723,1,21,9,2,0,1,0,8,348,95,26044,28610,26539,0,-30,16,775,1,170,-1816,-2,1,0,0,-3
EUN1_3574940004',1,25,16,1,0,0,0,12,1,291,92,27658,31289,37574,4,28,16,1,0,1,0,1,354,108,30124,30668,37895,1,-63,-16,-2466,0,621,-321,0,0,-1,0,11
EUN1_3574925103',5,25,14,0,0,0,0,8,0,353,66,28006,27698,36627,5,28,21,1,0,0,0,6,321,90,30306,28968,41627,1,32,-24,-2300,-7,-1270,-5000,-1,0,0,0,2
EUN1_3574889974',8,29,19,1,0,1,0,8,1,351,72,30223,30892,46072,3,25,15,0,0,0,0,6,303,94,27970,28297,33836,1,48,-22,2253,4,2595,12236,1,0,1,0,2
EUN1_3574761646',4,29,11,1,0,1,0,9,1,393,110,29393,31428,34428,4,38,12,1,1,2,0,5,363,86,27695,31251,29747,1,30,24,1698,-1,177,4681,0,-1,-1,0,4
EUN1_3574737518',7,47,8,0,0,0,0,12,0,316,60,24755,27553,22086,4,26,21,2,1,2,0,1,405,118,32928,34342,43689,0,-89,-58,-8173,-13,-6789,-21603,-2,-1,-2,0,11
EUN1_3574689781',6,31,9,1,1,0,0,11,1,345,72,25695,28085,27578,4,27,11,0,0,1,0,5,338,84,26992,28270,30378,0,7,-12,-1297,-2,-185,-2800,1,1,-1,0,6
EUN1_3574670010',2,23,14,1,0,0,0,16,0,270,92,26350,28273,32374,3,19,21,1,0,3,0,1,358,64,31549,30881,40237,0,-88,28,-5199,-7,-2608,-7863,0,0,-3,0,15
EUN1_3574652789',3,25,19,0,0,1,0,8,0,304,96,29312,30742,38555,5,142,13,2,0,0,0,6,314,88,25686,28462,37040,0,-10,8,3626,6,2280,1515,-2,0,1,0,2
EUN1_3558828374',8,31,11,1,0,0,0,10,0,314,84,25932,26372,26850,4,27,18,1,0,1,0,1,293,72,29039,27883,30543,0,21,12,-3107,-7,-1511,-3693,0,0,-1,0,9
EUN1_3558793693',5,28,12,0,0,1,0,7,1,356,104,29683,30456,34841,3,29,11,1,0,2,0,8,342,75,25609,27587,33680,0,14,29,4074,1,2869,1161,-1,0,-1,0,-1
EUN1_3558654766',2,24,31,1,0,4,0,8,1,356,112,36229,35431,46422,2,25,10,1,0,0,0,9,289,68,25301,27852,37818,1,67,44,10928,21,7579,8604,0,0,4,0,-1
EUN1_3558613994',7,32,11,1,0,0,0,4,1,397,111,28707,32882,35700,3,94,8,1,0,0,0,6,355,64,24543,28902,27490,1,42,47,4164,3,3980,8210,0,0,0,0,-2
EUN1_3558545221',7,42,13,0,0,0,0,12,0,283,94,26008,28035,32835,4,25,18,1,0,3,0,1,370,86,31954,30781,40938,0,-87,8,-5946,-5,-2746,-8103,-1,0,-3,0,11
EUN1_3575997103',3,31,8,1,0,0,0,9,0,314,100,25563,28539,29068,3,48,14,1,0,1,0,2,368,76,27882,30753,34669,0,-54,24,-2319,-6,-2214,-5601,0,0,-1,0,7
EUN1_3573929053',4,22,21,2,0,1,0,6,1,335,106,31442,32393,38182,1,33,9,0,0,0,0,4,299,81,24181,27595,26249,1,36,25,7261,12,4798,11933,2,0,1,0,2
EUN1_3573910917',0,121,1,0,0,0,0,8,0,375,72,21095,26946,26300,3,55,20,1,0,1,0,0,385,109,30655,33248,34441,0,-10,-37,-9560,-19,-6302,-8141,-1,0,-1,0,8
EUN1_3572747983',2,33,16,1,1,0,0,7,1,386,76,28182,30763,29706,2,18,8,0,0,0,0,4,352,94,24712,28955,22580,1,34,-18,3470,8,1808,7126,1,1,0,0,3
EUN1_3571626874',3,29,10,1,0,0,0,11,0,292,92,24684,27503,34087,1,76,21,1,0,0,0,1,317,96,31207,30328,36950,0,-25,-4,-6523,-11,-2825,-2863,0,0,0,0,10
EUN1_3571598576',2,20,9,1,0,1,0,12,0,339,86,26045,28706,34409,1,239,14,1,0,2,0,2,383,74,29155,30730,36384,1,-44,12,-3110,-5,-2024,-1975,0,0,-1,0,10
EUN1_3570372979',3,31,8,1,0,1,0,7,0,398,84,26283,31375,30853,4,115,10,1,0,1,0,5,372,76,26541,30120,27317,1,26,8,-258,-2,1255,3536,0,0,0,0,2
EUN1_3569843668',3,49,4,0,0,0,0,7,1,313,81,21944,26165,28195,3,22,13,1,0,1,0,4,365,70,26497,29873,36981,0,-52,11,-4553,-9,-3708,-8786,-1,0,-1,0,3
EUN1_3569262810',2,25,5,0,0,0,0,8,0,311,81,23425,27747,28457,4,27,18,2,0,1,0,1,369,78,28562,31475,38699,0,-58,3,-5137,-13,-3728,-10242,-2,0,-1,0,7
EUN1_3568741635',1,17,17,1,0,0,0,6,1,254,88,26181,29191,32790,2,26,15,1,0,0,0,1,348,76,27448,28844,38431,0,-94,12,-1267,2,347,-5641,0,0,0,0,5
EUN1_3568298424',1,24,17,2,0,0,0,9,1,361,106,30612,32477,41655,0,19,10,0,0,1,0,6,323,67,25639,28977,31773,1,38,39,4973,7,3500,9882,2,0,-1,0,3
EUN1_3568270258',2,25,12,1,0,1,0,7,0,334,58,26254,27598,26040,3,16,12,1,0,0,0,5,317,90,26045,27400,30828,1,17,-32,209,0,198,-4788,0,0,1,0,2
EUN1_3568245333',2,36,18,1,1,2,0,12,0,372,102,29819,33071,37611,2,20,6,0,0,0,0,6,372,0,23534,25187,27182,1,0,102,6285,12,7884,10429,1,1,2,0,6
EUN1_3575612620',0,35,12,0,0,1,0,12,0,322,93,27690,29145,33952,2,22,13,2,0,2,0,3,334,94,27865,27501,28727,0,-12,-1,-175,-1,1644,5225,-2,0,-1,0,9
EUN1_3575579571',4,27,3,1,0,0,0,8,0,344,72,21934,27126,26086,3,80,12,1,0,1,0,2,337,120,27460,31202,24132,1,7,-48,-5526,-9,-4076,1954,0,0,-1,0,6
EUN1_3575545695',3,22,14,0,0,0,0,13,0,338,89,28394,29423,34506,1,25,20,2,0,2,0,2,387,86,34514,32800,41367,0,-49,3,-6120,-6,-3377,-6861,-2,0,-2,0,11
EUN1_3575520858',1,32,10,1,0,1,0,6,0,379,70,27215,28687,30150,2,24,12,1,0,0,0,5,345,111,26791,29398,27812,0,34,-41,424,-2,-711,2338,0,0,1,0,1
EUN1_3575436509',0,44,2,0,0,0,0,9,0,349,100,21356,26293,23294,7,25,15,2,1,1,0,0,362,98,29463,29563,27527,0,-13,2,-8107,-13,-3270,-4233,-2,-1,-1,0,9
EUN1_3575074973',3,207,11,1,0,0,0,8,0,334,92,25549,29332,26184,3,25,8,1,0,0,0,2,377,96,25798,30632,29101,0,-43,-4,-249,3,-1300,-2917,0,0,0,0,6
EUN1_3574955255',3,37,15,1,0,3,0,10,1,345,111,30293,33621,33439,4,21,11,1,0,1,0,8,304,92,26056,29111,30420,1,41,19,4237,4,4510,3019,0,0,2,0,2
EUN1_3574915025',1,54,22,2,0,0,0,8,1,296,95,30769,31392,39801,6,32,12,0,0,1,0,7,341,72,26343,27272,32561,1,-45,23,4426,10,4120,7240,2,0,-1,0,1
EUN1_3574862673',2,24,10,0,0,0,0,13,1,338,68,25763,27278,27486,2,25,15,2,0,2,0,3,377,116,30668,31936,33936,0,-39,-48,-4905,-5,-4658,-6450,-2,0,-2,0,10
EUN1_3574833008',6,27,13,1,0,0,0,14,1,342,103,28218,29654,31057,2,23,17,1,0,1,0,2,354,88,31149,30972,33751,0,-12,15,-2931,-4,-1318,-2694,0,0,-1,0,12
EUN1_3574790008',0,21,4,1,0,0,0,6,0,327,92,22814,27531,18424,4,30,18,1,1,1,0,5,370,76,28938,31995,37133,0,-43,16,-6124,-14,-4464,-18709,0,-1,-1,0,1
EUN1_3574712081',3,28,13,1,0,0,0,9,0,358,76,27452,29500,32975,0,24,15,1,0,1,0,2,333,100,28605,30406,36746,0,25,-24,-1153,-2,-906,-3771,0,0,-1,0,7
EUN1_3574685929',7,43,12,1,0,0,0,10,0,349,65,26548,28694,32295,4,29,12,0,0,0,0,5,354,102,28074,30432,27455,0,-5,-37,-1526,0,-1738,4840,1,0,0,0,5
EUN1_3574673616',2,28,18,2,0,0,0,12,1,288,105,28226,30637,32109,2,27,4,0,0,0,0,0,344,86,23613,27065,25987,1,-56,19,4613,14,3572,6122,2,0,0,0,12
EUN1_3574233599',5,23,9,1,0,1,0,13,0,311,82,24826,28348,28783,3,27,16,1,0,2,0,5,340,96,30467,30353,37867,0,-29,-14,-5641,-7,-2005,-9084,0,0,-1,0,8
EUN1_3574221093',3,24,6,1,0,0,0,10,0,324,90,23057,27210,27930,3,105,16,1,1,1,0,1,303,114,28859,31518,37365,0,21,-24,-5802,-10,-4308,-9435,0,-1,-1,0,9
EUN1_3576119911',4,127,11,1,0,2,0,12,1,325,95,27939,28518,34397,7,28,15,1,1,0,0,7,269,116,27794,28116,31464,1,56,-21,145,-4,402,2933,0,-1,2,0,5
EUN1_3576106585',1,24,19,2,0,2,0,7,1,320,114,30546,30308,34661,2,20,13,0,0,1,0,10,276,78,26298,26973,32229,1,44,36,4248,6,3335,2432,2,0,1,0,-3
EUN1_3576081347',4,30,14,2,0,0,0,9,0,295,88,27000,27149,28556,4,43,16,0,0,0,0,1,313,73,27327,28192,30213,0,-18,15,-327,-2,-1043,-1657,2,0,0,0,8
EUN1_3576050886',4,24,18,1,0,1,0,8,0,283,86,28684,30390,33810,4,34,18,1,0,1,0,1,339,56,29467,29614,44570,0,-56,30,-783,0,776,-10760,0,0,0,0,7
EUN1_3575681552',2,18,12,0,0,0,0,5,0,326,93,27414,29743,30218,4,34,13,2,0,0,0,1,354,78,27671,29862,34434,1,-28,15,-257,-1,-119,-4216,-2,0,0,0,4
EUN1_3575678703',2,22,7,0,1,0,0,5,1,347,94,23771,27912,22210,4,22,16,1,0,1,0,1,330,106,29143,30446,28861,1,17,-12,-5372,-9,-2534,-6651,-1,1,-1,0,4
EUN1_3575673556',3,26,12,2,0,2,0,7,0,344,72,28408,29583,29378,4,21,15,0,0,1,0,3,349,88,28880,28700,26552,0,-5,-16,-472,-3,883,2826,2,0,1,0,4
EUN1_3575670555',6,31,14,2,0,2,0,9,1,353,104,27594,30918,34855,3,31,7,0,0,1,0,4,330,96,25664,27999,27255,1,23,8,1930,7,2919,7600,2,0,1,0,5
EUN1_3575661871',3,50,9,0,0,0,0,8,1,331,78,24785,28090,23279,7,36,15,2,0,0,0,3,367,110,27518,32713,32833,0,-36,-32,-2733,-6,-4623,-9554,-2,0,0,0,5
EUN1_3575656069',7,32,6,1,0,0,0,12,0,305,70,23397,26965,28428,4,39,16,1,0,1,0,1,379,94,29919,33562,38378,0,-74,-24,-6522,-10,-6597,-9950,0,0,-1,0,11
EUN1_3575663122',0,57,10,0,0,0,0,9,1,309,70,26067,27199,28139,2,59,25,2,0,2,0,2,343,97,33861,33111,49398,0,-34,-27,-7794,-15,-5912,-21259,-2,0,-2,0,7
EUN1_3575642531',2,19,7,1,0,0,0,9,0,350,106,24098,30875,25752,1,154,16,1,0,1,0,0,365,106,29100,30865,31349,1,-15,0,-5002,-9,10,-5597,0,0,-1,0,9
EUN1_3575620948',0,32,15,1,0,0,0,8,0,345,104,28319,30804,37715,3,30,13,1,0,2,0,5,339,78,26693,29842,30009,0,6,26,1626,2,962,7706,0,0,-2,0,3
EUN1_3575608248',6,37,8,0,0,0,0,9,1,310,86,24653,25607,22690,5,151,14,2,0,0,0,3,324,68,26575,28182,28249,1,-14,18,-1922,-6,-2575,-5559,-2,0,0,0,6
EUN1_3575583310',9,28,11,1,0,1,0,10,1,325,100,26647,29503,30268,1,20,15,0,0,1,0,2,342,95,29101,31097,35196,0,-17,5,-2454,-4,-1594,-4928,1,0,0,0,8
EUN1_3575560274',4,31,14,0,0,0,0,8,0,358,95,27405,29629,32424,3,27,10,1,1,0,0,3,335,76,25865,27537,28602,0,23,19,1540,4,2092,3822,-1,-1,0,0,5
EUN1_3575344755',9,53,18,2,0,0,0,8,0,375,72,29314,31997,40762,3,437,14,0,0,0,0,2,344,83,27879,30153,31059,1,31,-11,1435,4,1844,9703,2,0,0,0,6
EUN1_3575323790',5,314,14,2,0,1,0,16,1,350,80,26782,30241,35244,3,20,9,0,0,2,0,2,368,78,28170,28705,32248,1,-18,2,-1388,5,1536,2996,2,0,-1,0,14
EUN1_3575304756',3,20,5,0,0,0,0,9,0,374,88,23544,29586,23460,2,49,12,2,0,1,0,1,354,87,26858,30631,28207,0,20,1,-3314,-7,-1045,-4747,-2,0,-1,0,8
EUN1_3575923142',2,27,10,0,0,1,0,10,0,359,92,26532,30595,28982,4,34,11,1,0,0,0,3,364,72,26935,27995,27754,1,-5,20,-403,-1,2600,1228,-1,0,1,0,7
EUN1_3575009046',4,29,6,0,0,1,0,7,0,427,74,26104,30977,23014,4,57,7,2,1,0,0,2,350,126,26078,30877,24497,0,77,-52,26,-1,100,-1483,-2,-1,1,0,5
EUN1_3574981881',3,20,7,0,0,0,0,12,1,325,92,24710,29376,23400,3,29,12,1,0,3,0,3,404,92,29364,32568,34333,0,-79,0,-4654,-5,-3192,-10933,-1,0,-3,0,9
EUN1_3574961448',2,23,8,0,0,0,0,13,1,270,64,24276,23714,36231,1,27,26,1,0,2,0,2,320,68,32565,30230,45612,0,-50,-4,-8289,-18,-6516,-9381,-1,0,-2,0,11
EUN1_3574184304',6,26,13,2,0,1,0,5,1,376,104,28736,30335,25289,6,25,6,0,1,1,0,1,387,96,25197,29656,22590,1,-11,8,3539,7,679,2699,2,-1,0,0,4
EUN1_3576017256',5,27,8,1,1,1,0,8,0,406,108,27952,32025,25004,2,37,8,0,0,0,0,3,373,84,25123,29876,30580,0,33,24,2829,0,2149,-5576,1,1,1,0,5
EUN1_3575999130',4,50,15,1,0,2,0,10,1,341,98,29692,31737,31491,3,22,8,1,0,0,0,5,347,77,23734,27521,28473,1,-6,21,5958,7,4216,3018,0,0,2,0,5
EUN1_3575965754',5,176,15,1,0,2,0,7,1,369,104,29540,32723,29698,4,28,3,1,0,0,0,5,350,99,23174,28782,22399,0,19,5,6366,12,3941,7299,0,0,2,0,2
EUN1_3575592528',5,33,19,1,0,2,0,9,1,390,85,31395,32284,33498,3,23,9,1,0,0,0,5,334,78,25514,28562,29560,1,56,7,5881,10,3722,3938,0,0,2,0,4
EUN1_3575569401',3,27,16,1,0,0,0,9,1,276,74,28661,25206,37649,1,28,17,0,0,1,0,4,304,64,27451,27159,43530,1,-28,10,1210,-1,-1953,-5881,1,0,-1,0,5
EUN1_3575530917',2,22,13,1,0,1,0,6,1,367,106,28887,30634,32727,4,29,15,1,0,0,0,2,316,82,28183,29472,35452,1,51,24,704,-2,1162,-2725,0,0,1,0,4
EUN1_3575033299',5,30,9,0,0,0,0,8,0,373,60,25645,29406,27984,3,100,8,2,0,0,0,0,331,94,23962,27783,18725,1,42,-34,1683,1,1623,9259,-2,0,0,0,8
EUN1_3575000581',5,30,12,0,0,1,0,12,0,342,58,27408,28989,28187,1,20,14,2,0,1,0,5,363,108,29591,30711,38291,0,-21,-50,-2183,-2,-1722,-10104,-2,0,0,0,7
EUN1_3574977429',4,22,10,0,0,2,0,7,0,352,76,26825,28448,32587,2,20,11,1,0,1,0,5,374,56,27352,29313,29134,0,-22,20,-527,-1,-865,3453,-1,0,1,0,2
EUN1_3574728403',2,35,13,0,0,1,0,6,1,356,76,28751,27773,36578,7,34,9,1,0,1,0,8,334,83,25952,28844,27992,0,22,-7,2799,4,-1071,8586,-1,0,0,0,-2
EUN1_3574565221',3,28,12,0,0,0,0,6,1,354,90,26632,29596,25843,2,27,11,1,0,2,0,3,321,104,25828,26962,23348,0,33,-14,804,1,2634,2495,-1,0,-2,0,3
EUN1_3574545885',1,21,9,2,0,0,0,10,0,328,100,25683,28410,24644,4,27,9,0,0,0,0,3,366,87,25952,29067,32002,1,-38,13,-269,0,-657,-7358,2,0,0,0,7
EUN1_3574462780',3,24,11,1,0,2,0,4,1,357,82,27336,28834,33969,0,24,6,1,0,0,0,9,330,85,23840,27735,21722,1,27,-3,3496,5,1099,12247,0,0,2,0,-5
EUN1_3574433908',0,26,7,1,0,1,0,14,0,367,76,25613,28761,27310,1,23,10,1,0,1,0,3,383,93,27506,31025,29701,1,-16,-17,-1893,-3,-2264,-2391,0,0,0,0,11
EUN1_3574412027',4,49,14,1,0,1,0,4,1,393,107,28827,32268,34294,2,29,2,0,0,0,0,2,338,76,21962,27160,20592,1,55,31,6865,12,5108,13702,1,0,1,0,2
EUN1_3574243865',4,28,12,0,0,1,0,10,0,367,88,28032,30404,35558,3,25,15,2,0,0,0,8,311,64,27890,27826,35223,1,56,24,142,-3,2578,335,-2,0,1,0,2
EUN1_3574240270',3,26,16,1,1,0,0,8,1,344,97,28427,29798,27426,1,133,3,0,0,2,0,6,290,73,22009,25969,23635,1,54,24,6418,13,3829,3791,1,1,-2,0,2
EUN1_3574216682',7,33,2,0,0,1,0,4,1,405,104,24014,30806,14213,1,21,4,1,0,0,0,4,369,124,23438,31056,16246,0,36,-20,576,-2,-250,-2033,-1,0,1,0,0
EUN1_3574043019',0,16,13,0,0,0,0,10,0,295,90,27744,28995,26617,3,42,19,2,0,0,0,5,338,81,28865,29481,35457,1,-43,9,-1121,-6,-486,-8840,-2,0,0,0,5
EUN1_3574032990',2,30,7,1,0,0,0,6,0,340,80,23790,28262,21876,3,25,13,0,0,1,0,2,344,84,27654,31116,29731,0,-4,-4,-3864,-6,-2854,-7855,1,0,-1,0,4
EUN1_3576196137',3,24,13,0,0,0,0,15,0,290,52,25586,25891,37223,3,20,28,1,1,3,0,1,341,86,34934,32119,48423,0,-51,-34,-9348,-15,-6228,-11200,-1,-1,-3,0,14
EUN1_3576164102',2,26,23,0,0,0,0,12,1,304,63,29652,29716,45627,4,25,19,2,0,2,0,6,349,84,31372,29253,47077,0,-45,-21,-1720,4,463,-1450,-2,0,-2,0,6
EUN1_3576146632',5,23,17,0,0,0,0,5,0,326,78,29243,29595,43813,0,83,19,2,0,0,0,5,361,90,31213,31867,37806,0,-35,-12,-1970,-2,-2272,6007,-2,0,0,0,0
EUN1_3575740113',3,29,8,1,0,1,0,9,0,381,107,27266,30159,30209,5,30,13,1,1,0,0,2,341,88,26336,30575,31796,0,40,19,930,-5,-416,-1587,0,-1,1,0,7
EUN1_3575454650',5,23,11,0,0,0,0,7,1,364,71,26224,30764,30948,2,91,7,2,0,0,0,1,375,117,25537,30682,21055,0,-11,-46,687,4,82,9893,-2,0,0,0,6
EUN1_3575423917',4,61,10,2,0,0,0,11,0,318,88,26191,28220,29180,6,82,15,0,0,1,0,4,302,68,27656,27974,36681,0,16,20,-1465,-5,246,-7501,2,0,-1,0,7
EUN1_3575342625',4,25,6,1,0,0,0,8,1,337,78,24233,28984,23995,7,32,8,1,0,1,0,1,355,102,26280,30193,23418,0,-18,-24,-2047,-2,-1209,577,0,0,-1,0,7
EUN1_3574569282',4,28,16,2,0,0,0,5,0,385,114,30228,31602,34551,6,32,4,0,0,1,0,4,283,70,21131,25988,21262,1,102,44,9097,12,5614,13289,2,0,-1,0,1
EUN1_3574223838',2,130,20,1,0,2,0,11,0,365,98,32111,32753,44153,4,29,15,1,0,1,0,7,302,85,26411,28985,29794,1,63,13,5700,5,3768,14359,0,0,1,0,4
EUN1_3576236730',3,24,21,0,0,1,0,9,1,357,85,32600,30915,36284,3,28,10,2,0,1,0,7,322,86,24333,26373,29592,1,35,-1,8267,11,4542,6692,-2,0,0,0,2
EUN1_3576237155',4,33,19,0,0,1,0,6,1,409,82,31138,31260,39742,3,145,13,0,0,0,0,3,331,78,26465,28189,36024,1,78,4,4673,6,3071,3718,0,0,1,0,3
EUN1_3576067482',5,31,23,1,0,1,0,7,1,340,90,32278,31667,35815,1,26,17,0,0,1,0,5,278,98,28237,28283,31995,0,62,-8,4041,6,3384,3820,1,0,0,0,2
EUN1_3576046249',1,20,4,1,0,0,0,16,0,318,88,22719,27825,21972,4,25,12,1,1,3,0,1,362,96,29267,30431,35274,0,-44,-8,-6548,-8,-2606,-13302,0,-1,-3,0,15
EUN1_3575940410',4,29,9,0,0,0,0,11,0,299,81,24042,27488,28955,2,29,13,1,0,1,0,0,339,102,27276,28573,31210,0,-40,-21,-3234,-4,-1085,-2255,-1,0,-1,0,11
EUN1_3575863199',4,33,19,0,0,1,0,8,1,349,82,30675,30953,34257,4,19,8,2,0,0,0,5,363,98,25453,29388,30309,1,-14,-16,5222,11,1565,3948,-2,0,1,0,3
EUN1_3575830783',7,34,4,0,0,0,0,9,1,336,88,21913,27682,24937,3,24,12,2,0,2,0,0,401,100,29467,33296,31511,0,-65,-12,-7554,-8,-5614,-6574,-2,0,-2,0,9
EUN1_3575819359',3,22,10,1,0,0,0,7,0,368,96,27351,29766,33003,6,25,17,1,0,2,0,7,358,64,30242,31370,36014,0,10,32,-2891,-7,-1604,-3011,0,0,-2,0,0
EUN1_3575597033',2,23,10,2,0,1,0,10,0,328,94,25331,27202,27399,4,28,13,0,0,1,0,3,376,85,28514,30041,30032,1,-48,9,-3183,-3,-2839,-2633,2,0,0,0,7
EUN1_3575541545',6,33,16,1,0,0,0,6,0,349,92,28420,31667,42123,2,23,19,1,0,0,0,5,346,90,29796,32145,43746,1,3,2,-1376,-3,-478,-1623,0,0,0,0,1
EUN1_3575464376',2,21,8,1,0,0,0,9,0,338,92,25075,28427,26676,9,35,18,1,0,1,0,3,337,88,29704,31981,37083,0,1,4,-4629,-10,-3554,-10407,0,0,-1,0,6
EUN1_3575405190',3,28,11,1,0,0,0,11,1,405,83,27117,31404,27408,4,29,6,0,0,0,0,3,378,112,24953,29476,26471,1,27,-29,2164,5,1928,937,1,0,0,0,8
EUN1_3575006505',4,27,6,0,0,0,0,3,0,409,94,26459,29360,27554,4,24,13,1,0,0,0,3,357,96,27411,33006,31146,0,52,-2,-952,-7,-3646,-3592,-1,0,0,0,0
EUN1_3574969745',3,22,8,1,0,0,0,10,0,350,97,26112,27843,33801,7,35,21,0,0,1,0,3,368,84,32333,31866,40746,0,-18,13,-6221,-13,-4023,-6945,1,0,-1,0,7
EUN1_3574946940',4,26,17,1,0,0,0,7,1,391,74,28210,33233,36838,2,22,6,0,0,1,0,4,366,92,26196,28301,27235,1,25,-18,2014,11,4932,9603,1,0,-1,0,3
EUN1_3574926519',3,27,12,2,0,2,0,6,0,416,106,30028,30849,32348,5,30,10,0,0,0,0,4,342,86,26000,30197,21966,1,74,20,4028,2,652,10382,2,0,2,0,2
EUN1_3575987131',2,23,19,2,0,1,0,6,0,348,76,30250,30688,38599,0,18,9,0,0,0,0,6,406,92,26724,30746,29831,1,-58,-16,3526,10,-58,8768,2,0,1,0,0
EUN1_3575961382',2,20,12,1,0,0,0,10,0,337,83,27189,28118,30449,7,27,21,1,0,3,0,6,348,103,31926,32341,40135,0,-11,-20,-4737,-9,-4223,-9686,0,0,-3,0,4
EUN1_3575740125',4,24,10,0,0,1,0,13,0,341,84,26861,29893,33848,4,25,13,2,0,1,0,1,405,104,29132,32062,30070,0,-64,-20,-2271,-3,-2169,3778,-2,0,0,0,12
EUN1_3575723441',4,31,15,1,1,2,0,8,1,354,99,30726,30743,39736,3,32,14,1,0,1,0,7,310,68,26644,27413,30297,0,44,31,4082,1,3330,9439,0,1,1,0,1
EUN1_3575709895',6,28,22,2,0,0,0,11,1,353,88,33772,30910,33966,5,27,12,0,0,2,0,6,301,85,26375,26445,30656,1,52,3,7397,10,4465,3310,2,0,-2,0,5
EUN1_3575373033',1,17,18,1,0,1,0,4,1,302,80,28634,28060,36102,4,27,5,1,1,0,0,5,374,80,24069,28844,32564,1,-72,0,4565,13,-784,3538,0,-1,1,0,-1
EUN1_3575363183',2,21,22,0,0,0,0,7,1,393,102,32482,33053,38455,6,34,9,1,0,1,0,5,361,78,26823,29001,24170,1,32,24,5659,13,4052,14285,-1,0,-1,0,2
EUN1_3575240537',5,28,10,2,0,0,0,8,0,330,98,25187,28164,29521,5,34,8,0,0,0,0,3,360,78,25080,27666,29312,0,-30,20,107,2,498,209,2,0,0,0,5
EUN1_3575228379',5,22,20,0,1,0,0,10,1,364,91,30250,31174,36834,2,91,12,2,0,2,0,7,324,100,27974,28907,36591,0,40,-9,2276,8,2267,243,-2,1,-2,0,3
EUN1_3575220078',3,27,10,0,0,0,0,16,0,303,56,23561,25903,22348,6,38,22,2,0,3,0,1,381,119,34155,33331,45083,0,-78,-63,-10594,-12,-7428,-22735,-2,0,-3,0,15
EUN1_3574883764',7,252,5,0,0,1,0,9,0,350,72,23771,27930,25575,4,27,17,2,0,1,0,3,358,111,28217,31327,32824,0,-8,-39,-4446,-12,-3397,-7249,-2,0,0,0,6
EUN1_3574865389',1,25,14,2,0,0,0,9,0,327,94,27828,30380,32097,5,23,14,0,0,0,0,2,344,102,28224,28781,35941,0,-17,-8,-396,0,1599,-3844,2,0,0,0,7
EUN1_3574833606',5,33,7,0,0,0,0,16,0,338,88,24824,27477,24827,6,34,11,2,0,2,0,1,346,100,28832,28144,26124,1,-8,-12,-4008,-4,-667,-1297,-2,0,-2,0,15
EUN1_3574811819',3,27,7,0,0,0,0,15,0,320,66,24246,26083,25212,3,22,24,2,1,3,0,3,347,101,33230,30666,45521,0,-27,-35,-8984,-17,-4583,-20309,-2,-1,-3,0,12
EUN1_3565832226',4,32,10,0,0,0,0,9,1,348,83,27451,29039,36231,7,23,16,2,0,2,0,3,323,72,28079,28915,34362,0,25,11,-628,-6,124,1869,-2,0,-2,0,6
EUN1_3565799404',4,24,14,2,0,0,0,8,0,340,74,28864,28424,35092,4,26,14,0,0,2,0,7,327,91,28972,28922,32676,1,13,-17,-108,0,-498,2416,2,0,-2,0,1
EUN1_3565782074',3,30,15,2,0,0,0,11,1,286,82,28215,28312,34959,6,27,7,0,0,1,0,4,384,72,26522,27112,28699,1,-98,10,1693,8,1200,6260,2,0,-1,0,7
EUN1_3565759084',5,29,12,1,0,2,0,8,0,404,76,30241,30013,34300,2,24,13,1,0,0,0,6,366,88,27286,30296,28772,1,38,-12,2955,-1,-283,5528,0,0,2,0,2
EUN1_3565732593',1,217,9,0,0,1,0,10,0,354,84,26437,28345,26559,2,73,9,2,0,1,0,2,352,92,26830,29188,26223,1,2,-8,-393,0,-843,336,-2,0,0,0,8
EUN1_3565724076',4,63,13,1,0,1,0,8,0,421,92,29184,31981,33118,6,67,7,1,0,0,0,3,376,84,24999,28845,27581,0,45,8,4185,6,3136,5537,0,0,1,0,5
EUN1_3565549988',2,28,16,2,0,0,0,11,1,301,71,27321,26565,30951,4,28,15,0,0,2,0,1,318,92,28769,28703,30186,1,-17,-21,-1448,1,-2138,765,2,0,-2,0,10
EUN1_3565310561',6,25,30,0,0,2,0,10,1,339,50,36507,31286,62857,4,34,19,1,0,0,0,7,311,96,32074,27744,48784,0,28,-46,4433,11,3542,14073,-1,0,2,0,3
EUN1_3565236194',3,23,12,0,0,1,0,6,1,345,111,27928,30685,30230,5,30,11,2,0,1,0,8,308,92,25589,27689,26077,1,37,19,2339,1,2996,4153,-2,0,0,0,-2
EUN1_3565097881',3,91,14,1,0,1,0,9,1,356,90,28908,30902,29607,2,147,9,0,1,1,0,3,353,98,27775,30035,25918,1,3,-8,1133,5,867,3689,1,-1,0,0,6
EUN1_3564804348',4,27,14,0,0,1,0,9,0,376,63,28278,31144,38226,4,25,17,2,0,0,0,1,322,100,28896,29575,38145,1,54,-37,-618,-3,1569,81,-2,0,1,0,8
EUN1_3564777907',6,26,9,1,0,0,0,6,1,352,76,25361,29393,22810,3,27,6,1,0,1,0,3,405,103,26263,30234,22023,0,-53,-27,-902,3,-841,787,0,0,-1,0,3
EUN1_3564598191',1,21,7,0,0,0,0,8,1,395,102,25439,31233,27050,3,25,10,2,0,1,0,3,355,110,26842,30516,26819,0,40,-8,-1403,-3,717,231,-2,0,-1,0,5
EUN1_3574034853',3,21,4,0,1,0,0,9,0,300,96,22539,27007,28154,3,25,10,1,0,1,0,0,376,80,26304,30827,24629,0,-76,16,-3765,-6,-3820,3525,-1,1,-1,0,9
EUN1_3573936479',4,23,6,0,0,0,0,9,0,327,82,23375,27036,18673,3,28,18,1,0,1,0,4,313,89,28203,28808,34302,0,14,-7,-4828,-12,-1772,-15629,-1,0,-1,0,5
EUN1_3573861755',1,138,14,2,0,0,0,11,1,260,98,26452,28438,32045,2,19,15,0,1,0,0,2,309,88,28018,30493,35583,1,-49,10,-1566,-1,-2055,-3538,2,-1,0,0,9
EUN1_3567656323',2,21,9,0,0,0,0,13,1,287,74,24145,24011,21441,4,26,13,2,0,3,0,2,359,96,29173,31661,31108,0,-72,-22,-5028,-4,-7650,-9667,-2,0,-3,0,11
EUN1_3567427106',6,32,14,1,1,0,0,6,1,320,98,27724,29923,33377,3,24,11,1,0,0,0,1,311,78,26894,28350,29802,1,9,20,830,3,1573,3575,0,1,0,0,5
EUN1_3567399160',3,30,14,2,0,0,0,7,1,298,84,25985,27863,31625,6,27,11,0,0,1,0,0,311,84,26288,27934,27238,0,-13,0,-303,3,-71,4387,2,0,-1,0,7
EUN1_3567191210',2,27,18,1,0,2,0,5,1,302,66,28163,28525,39505,3,25,15,0,0,1,0,8,283,68,27275,27776,36365,0,19,-2,888,3,749,3140,1,0,1,0,-3
EUN1_3566937310',1,21,5,1,0,0,0,7,0,290,80,22693,25858,21099,2,21,17,1,0,2,0,2,339,116,29111,32591,31961,0,-49,-36,-6418,-12,-6733,-10862,0,0,-2,0,5
EUN1_3566922279',2,21,21,0,0,0,0,9,1,321,71,30523,30085,42476,6,39,12,1,0,0,0,5,295,96,26825,27049,35577,1,26,-25,3698,9,3036,6899,-1,0,0,0,4
EUN1_3566879455',3,26,12,0,1,2,0,12,0,365,108,30271,29833,32167,2,27,21,1,0,1,0,10,325,84,31834,32089,35220,1,40,24,-1563,-9,-2256,-3053,-1,1,1,0,2
EUN1_3566719132',2,27,14,2,0,2,0,7,0,307,100,29273,28392,38862,1,36,13,0,0,0,0,6,315,80,26652,27973,33113,1,-8,20,2621,1,419,5749,2,0,2,0,1
EUN1_3566663672',2,23,16,0,0,2,0,6,0,356,80,28961,30270,39729,0,31,14,1,0,0,0,9,274,108,26755,30502,34157,1,82,-28,2206,2,-232,5572,-1,0,2,0,-3
EUN1_3566647237',2,26,21,0,0,1,0,9,0,291,72,30576,28041,39690,4,37,15,1,0,1,0,1,334,76,27497,28577,35304,1,-43,-4,3079,6,-536,4386,-1,0,0,0,8
EUN1_3566622693',0,28,15,1,0,1,0,6,0,282,83,27677,28353,32301,2,45,17,1,1,0,0,7,289,76,28142,28732,33434,0,-7,7,-465,-2,-379,-1133,0,-1,1,0,-1
EUN1_3566413836',5,29,16,1,0,1,0,9,1,272,91,28461,27094,37170,2,34,17,0,0,0,0,4,281,68,26576,27952,36916,0,-9,23,1885,-1,-858,254,1,0,1,0,5
EUN1_3566310135',4,23,16,0,0,0,0,5,0,309,104,27618,31241,37648,2,69,12,1,0,0,0,2,335,80,25957,29995,34295,1,-26,24,1661,4,1246,3353,-1,0,0,0,3
EUN1_3566281440',1,17,8,0,0,0,0,10,0,299,84,24120,27587,23154,5,28,17,0,0,1,0,0,349,86,29254,30756,38041,0,-50,-2,-5134,-9,-3169,-14887,0,0,-1,0,10
EUN1_3566140200',4,26,13,1,0,0,0,13,0,324,72,27475,28141,34225,3,22,22,1,0,2,0,4,329,95,31887,32326,36427,0,-5,-23,-4412,-9,-4185,-2202,0,0,-2,0,9
EUN1_3565474084',2,22,8,0,0,0,0,11,1,277,88,24292,24559,22653,5,24,11,1,0,3,0,3,368,104,28763,29982,24805,0,-91,-16,-4471,-3,-5423,-2152,-1,0,-3,0,8
EUN1_3565446452',2,40,12,1,0,1,0,8,0,324,95,27546,30465,33003,3,45,14,0,0,1,0,3,345,88,28059,30554,35628,0,-21,7,-513,-2,-89,-2625,1,0,0,0,5
EUN1_3574557655',2,36,14,0,1,0,0,8,1,327,78,26771,31552,31249,1,42,14,2,0,0,0,0,349,87,27063,32020,32335,0,-22,-9,-292,0,-468,-1086,-2,1,0,0,8
EUN1_3574537704',6,25,14,0,0,2,0,9,1,317,64,27827,27439,29389,6,25,17,1,1,1,0,5,309,68,29060,28389,37565,0,8,-4,-1233,-3,-950,-8176,-1,-1,1,0,4
EUN1_3574517724',2,23,13,1,0,0,0,10,1,310,72,27394,27058,26625,3,22,15,1,0,0,0,2,329,96,27340,29542,35946,1,-19,-24,54,-2,-2484,-9321,0,0,0,0,8
EUN1_3573442909',3,21,8,0,0,0,0,9,0,312,76,23790,30320,24756,1,20,11,1,0,1,0,2,362,96,27708,32632,33860,0,-50,-20,-3918,-3,-2312,-9104,-1,0,-1,0,7
EUN1_3573420722',5,46,13,0,0,1,0,10,0,264,78,25486,26609,33158,3,23,22,2,0,2,0,4,317,78,30780,32052,41207,0,-53,0,-5294,-9,-5443,-8049,-2,0,-1,0,6
EUN1_3572912305',0,23,7,0,0,0,0,8,1,334,50,22598,26818,30462,2,19,15,2,0,0,0,1,349,98,26302,31534,33980,0,-15,-48,-3704,-8,-4716,-3518,-2,0,0,0,7
EUN1_3572895057',2,20,10,0,0,0,0,5,0,359,94,25106,29960,33971,2,23,9,2,0,0,0,2,328,94,24858,29497,31814,0,31,0,248,1,463,2157,-2,0,0,0,3
EUN1_3572870106',5,29,9,1,0,1,0,9,1,295,70,23506,28100,34570,3,22,18,1,0,1,0,1,337,86,28565,29372,37041,1,-42,-16,-5059,-9,-1272,-2471,0,0,0,0,8
EUN1_3572379752',0,142,11,0,0,0,0,6,1,361,90,27109,29961,31236,3,24,10,2,0,0,0,8,303,64,25548,28311,30407,1,58,26,1561,1,1650,829,-2,0,0,0,-2
EUN1_3572368685',3,30,17,1,0,0,0,4,1,390,96,30287,32014,36174,0,21,13,0,0,1,0,6,345,100,26789,30562,33621,1,45,-4,3498,4,1452,2553,1,0,-1,0,-2
EUN1_3572340878',5,29,6,2,1,0,0,9,0,331,108,24587,28714,24393,2,78,12,0,0,3,0,2,339,84,26836,28025,28656,1,-8,24,-2249,-6,689,-4263,2,1,-3,0,7
EUN1_3572324322',3,89,11,0,0,0,0,2,1,343,84,26553,30548,30925,4,25,8,2,0,1,0,2,350,74,23859,28347,29781,1,-7,10,2694,3,2201,1144,-2,0,-1,0,0
EUN1_3571810574',3,21,12,0,0,1,0,10,1,323,66,26994,28890,29429,4,29,17,1,0,1,0,5,317,82,29187,30422,37214,0,6,-16,-2193,-5,-1532,-7785,-1,0,0,0,5
EUN1_3571771540',0,140,14,0,0,0,0,11,0,288,82,26462,27562,31596,2,37,16,1,0,1,0,1,361,105,30776,30548,36063,0,-73,-23,-4314,-2,-2986,-4467,-1,0,-1,0,10
EUN1_3571752336',6,25,7,1,0,0,0,5,0,325,82,23562,27195,20231,5,25,16,1,0,0,0,0,333,110,28460,31591,33482,0,-8,-28,-4898,-9,-4396,-13251,0,0,0,0,5
EUN1_3570488508',10,97,15,2,0,1,0,12,1,303,84,27378,28296,31047,4,33,6,0,1,0,0,5,343,92,25397,29025,23701,0,-40,-8,1981,9,-729,7346,2,-1,1,0,7
EUN1_3570467387',5,26,12,1,0,0,0,7,1,309,96,25369,28657,21915,7,30,9,0,1,1,0,3,336,77,24946,28925,28376,1,-27,19,423,3,-268,-6461,1,-1,-1,0,4
EUN1_3570436991',9,28,14,1,0,0,0,4,0,346,91,27469,29773,41793,4,46,10,1,0,0,0,4,308,80,25642,27930,36253,1,38,11,1827,4,1843,5540,0,0,0,0,0
EUN1_3570410713',0,24,14,0,0,0,0,6,1,327,76,26557,27407,32373,2,23,11,2,0,1,0,5,307,76,25071,27718,30404,1,20,0,1486,3,-311,1969,-2,0,-1,0,1
EUN1_3568211648',8,31,15,1,1,1,0,4,0,332,92,28796,30084,35100,6,35,11,0,0,0,0,6,324,89,27108,28672,31233,1,8,3,1688,4,1412,3867,1,1,1,0,-2
EUN1_3568179446',5,29,17,0,0,0,0,15,0,287,72,27878,27981,33308,6,26,8,1,1,3,0,3,351,108,28493,27726,26726,0,-64,-36,-615,9,255,6582,-1,-1,-3,0,12
EUN1_3568146491',2,28,18,2,0,1,0,5,1,344,86,29412,29556,40057,4,24,8,0,0,0,0,2,306,82,23637,28336,26754,1,38,4,5775,10,1220,13303,2,0,1,0,3
EUN1_3565633492',3,33,4,1,0,0,0,6,0,343,85,22697,28505,18609,3,30,7,1,0,1,0,0,396,78,25558,30235,22213,1,-53,7,-2861,-3,-1730,-3604,0,0,-1,0,6
EUN1_3565627247',6,34,7,0,0,0,0,11,1,316,84,24084,27602,17704,2,47,14,2,0,3,0,0,352,98,29727,30708,25069,0,-36,-14,-5643,-7,-3106,-7365,-2,0,-3,0,11
EUN1_3565397097',1,33,9,0,0,0,0,12,1,306,94,25155,27650,35096,5,24,17,1,0,3,0,6,335,74,29353,30214,36106,0,-29,20,-4198,-8,-2564,-1010,-1,0,-3,0,6
EUN1_3565355037',1,28,7,0,0,0,0,7,1,267,58,22012,25146,25470,4,21,18,2,0,1,0,1,372,90,29937,31884,33124,0,-105,-32,-7925,-11,-6738,-7654,-2,0,-1,0,6
EUN1_3565344450',2,28,4,1,0,0,0,7,0,336,74,22201,26908,23526,4,21,13,0,0,0,0,2,390,94,26899,31772,33925,0,-54,-20,-4698,-9,-4864,-10399,1,0,0,0,5
EUN1_3565051329',9,34,11,0,0,0,0,8,1,345,58,25627,28074,28080,5,132,7,1,0,1,0,2,367,78,25443,28226,22444,1,-22,-20,184,4,-152,5636,-1,0,-1,0,6
EUN1_3565032206',3,22,7,1,0,0,0,7,1,375,107,24820,30937,26504,0,28,7,1,0,0,0,2,326,82,24499,30375,21135,0,49,25,321,0,562,5369,0,0,0,0,5
EUN1_3573627480',4,56,13,0,1,0,0,12,1,349,83,28759,30055,34522,3,35,13,1,0,1,0,3,322,88,26046,30151,29320,0,27,-5,2713,0,-96,5202,-1,1,-1,0,9
EUN1_3573609666',5,28,14,0,0,1,0,8,0,295,78,27628,28188,37792,1,68,19,2,0,1,0,4,282,78,28235,26936,41203,1,13,0,-607,-5,1252,-3411,-2,0,0,0,4
EUN1_3573233757',2,27,13,1,0,0,0,6,0,352,98,26973,29534,38262,3,41,12,0,0,0,0,2,336,98,27081,31804,32656,1,16,0,-108,1,-2270,5606,1,0,0,0,4
EUN1_3573207489',5,52,15,1,0,0,0,11,0,347,82,28172,30032,35281,7,50,11,0,0,0,0,5,332,84,26541,27835,30500,0,15,-2,1631,4,2197,4781,1,0,0,0,6
EUN1_3573201117',5,22,16,0,0,0,0,10,1,347,68,29123,28262,40078,5,46,22,1,0,3,0,6,325,76,33354,30813,43890,0,22,-8,-4231,-6,-2551,-3812,-1,0,-3,0,4
EUN1_3573124756',5,55,23,1,1,2,0,7,1,340,100,32783,30497,43076,1,31,18,0,0,1,0,5,337,54,28543,28524,33336,1,3,46,4240,5,1973,9740,1,1,1,0,2
EUN1_3573098194',3,52,10,1,1,0,0,5,1,321,86,25101,26710,32310,3,25,11,1,0,0,0,3,314,70,25094,26823,33259,0,7,16,7,-1,-113,-949,0,1,0,0,2
EUN1_3573079308',7,50,8,1,0,0,0,8,0,341,116,26054,29436,27259,2,24,13,1,0,1,0,3,355,92,29057,32025,34836,0,-14,24,-3003,-5,-2589,-7577,0,0,-1,0,5
EUN1_3573061792',3,29,16,1,1,1,0,7,1,337,112,29545,30399,31126,7,57,12,1,0,0,0,3,330,76,25659,28426,35437,1,7,36,3886,4,1973,-4311,0,1,1,0,4
EUN1_3572649388',2,21,8,0,0,0,0,8,1,318,76,24668,27581,23864,2,48,9,2,0,2,0,2,342,80,26017,28583,26538,0,-24,-4,-1349,-1,-1002,-2674,-2,0,-2,0,6
EUN1_3572619650',3,223,14,0,0,1,0,9,1,349,74,28661,29098,35110,6,55,13,2,0,0,0,4,367,98,28207,29823,32039,0,-18,-24,454,1,-725,3071,-2,0,1,0,5
EUN1_3572604126',2,21,8,1,0,0,0,4,1,345,69,25240,27087,24303,6,52,15,1,0,0,0,2,296,98,26727,27828,32246,0,49,-29,-1487,-7,-741,-7943,0,0,0,0,2
EUN1_3572580419',5,52,17,1,0,1,0,7,1,310,67,29046,29581,39245,7,29,15,1,1,0,0,4,298,92,27204,29597,36814,1,12,-25,1842,2,-16,2431,0,-1,1,0,3
EUN1_3572561298',5,38,17,1,0,1,0,11,0,344,108,29205,31621,34218,1,47,11,0,0,2,0,5,315,83,28237,29158,32367,1,29,25,968,6,2463,1851,1,0,-1,0,6
EUN1_3572538018',4,61,17,1,0,1,0,13,1,336,84,31050,29125,34875,4,86,18,1,0,2,0,6,320,92,30474,29881,34113,0,16,-8,576,-1,-756,762,0,0,-1,0,7
EUN1_3576240956',4,24,5,1,0,0,0,13,1,341,96,23412,27238,26464,0,36,20,1,1,5,0,0,382,84,33973,32366,37398,0,-41,12,-10561,-15,-5128,-10934,0,-1,-5,0,13
EUN1_3576234398',4,32,16,0,0,0,0,8,1,347,70,28125,28918,32754,7,22,9,1,0,0,0,2,339,77,25106,26839,27258,1,8,-7,3019,7,2079,5496,-1,0,0,0,6
EUN1_3571369721',3,240,9,1,0,0,0,7,1,336,72,24474,28189,24923,5,33,13,1,0,0,0,4,344,95,25903,29591,27137,1,-8,-23,-1429,-4,-1402,-2214,0,0,0,0,3
EUN1_3571348902',3,67,9,1,0,0,0,10,0,373,86,25904,29307,20005,3,59,17,1,0,1,0,3,399,90,29770,31566,35674,0,-26,-4,-3866,-8,-2259,-15669,0,0,-1,0,7
EUN1_3569459488',4,30,7,1,1,0,0,9,1,333,104,24006,29785,21255,2,20,12,1,0,1,0,3,341,95,26943,29937,23726,1,-8,9,-2937,-5,-152,-2471,0,1,-1,0,6
EUN1_3569447589',6,29,15,1,0,1,0,9,0,329,88,28113,29557,31328,5,35,7,1,1,0,0,5,335,84,24713,26935,25815,1,-6,4,3400,8,2622,5513,0,-1,1,0,4
EUN1_3569439704',5,30,12,2,1,1,0,6,1,404,105,28896,30962,28033,2,20,6,0,0,1,0,4,338,62,22318,27742,16300,1,66,43,6578,6,3220,11733,2,1,0,0,2
EUN1_3569412961',5,79,10,1,0,0,0,9,1,282,82,24273,26334,30717,3,27,8,1,0,1,0,1,379,97,27546,29824,28056,0,-97,-15,-3273,2,-3490,2661,0,0,-1,0,8
EUN1_3568980891',3,35,20,1,0,1,0,5,1,356,86,31474,29938,36439,7,30,10,0,0,0,0,7,302,62,24137,26278,28627,0,54,24,7337,10,3660,7812,1,0,1,0,-2
EUN1_3568968847',3,32,8,0,0,0,0,5,0,342,96,25004,29814,24087,3,26,14,2,0,0,0,2,332,96,27022,31026,31503,0,10,0,-2018,-6,-1212,-7416,-2,0,0,0,3
EUN1_3568955938',2,30,9,1,0,0,0,8,1,333,80,26701,28181,33707,2,26,19,1,0,1,0,5,348,99,30437,31499,36205,0,-15,-19,-3736,-10,-3318,-2498,0,0,-1,0,3
EUN1_3568951341',3,36,15,1,0,2,0,11,0,334,96,28161,30133,26428,4,41,8,0,1,1,0,4,355,78,26100,27987,26991,1,-21,18,2061,7,2146,-563,1,-1,1,0,7
EUN1_3568938293',2,26,12,0,0,1,0,7,0,384,76,27413,30614,31137,2,25,7,2,0,1,0,5,358,104,25940,28733,26206,0,26,-28,1473,5,1881,4931,-2,0,0,0,2
EUN1_3568926258',3,23,7,1,0,0,0,8,0,353,88,24419,28427,28787,1,26,12,0,0,0,0,3,363,78,26861,29257,21950,0,-10,10,-2442,-5,-830,6837,1,0,0,0,5
EUN1_3568915593',4,31,16,2,0,1,0,5,1,320,106,28728,29841,30704,2,27,8,0,1,0,0,4,361,84,25491,29385,30339,1,-41,22,3237,8,456,365,2,-1,1,0,1
EUN1_3568904877',1,18,4,1,0,0,0,6,0,374,94,23110,28381,23240,0,314,9,1,0,0,0,0,367,82,25595,28461,30257,0,7,12,-2485,-5,-80,-7017,0,0,0,0,6
EUN1_3568736876',2,27,15,1,0,0,0,6,1,333,74,27658,29798,36773,4,25,16,0,0,0,0,3,403,74,28910,29986,39200,0,-70,0,-1252,-1,-188,-2427,1,0,0,0,3
EUN1_3568028754',4,26,14,0,0,0,0,5,0,298,66,26544,26967,36263,5,34,16,1,0,0,0,2,371,70,30787,29328,35070,0,-73,-4,-4243,-2,-2361,1193,-1,0,0,0,3
EUN1_3567603530',4,26,7,1,0,0,0,2,1,332,90,23686,27525,23677,2,25,13,1,1,0,0,0,395,92,28555,30494,30438,0,-63,-2,-4869,-6,-2969,-6761,0,-1,0,0,2
EUN1_3566082926',3,44,19,1,0,0,0,11,1,296,85,29498,28631,37216,3,25,17,0,0,2,0,5,316,78,29334,28975,32986,0,-20,7,164,2,-344,4230,1,0,-2,0,6
EUN1_3575956107',1,21,9,0,0,0,0,5,1,370,82,25255,29876,27597,3,29,10,1,1,0,0,3,386,92,26603,30977,23386,0,-16,-10,-1348,-1,-1101,4211,-1,-1,0,0,2
EUN1_3575031440',4,24,15,0,0,1,0,9,1,346,77,28983,29173,35471,4,25,16,1,0,0,0,6,371,86,30442,31419,39031,0,-25,-9,-1459,-1,-2246,-3560,-1,0,1,0,3
EUN1_3575004305',5,25,12,1,0,1,0,12,0,321,68,27634,30191,33354,3,24,12,1,0,0,0,2,363,83,27553,29148,27866,1,-42,-15,81,0,1043,5488,0,0,1,0,10
EUN1_3574755567',2,21,16,0,0,0,0,8,1,359,80,27997,29582,33356,2,24,15,1,0,0,0,4,346,80,28091,31321,37399,0,13,0,-94,1,-1739,-4043,-1,0,0,0,4
EUN1_3573870234',7,29,17,1,0,1,0,13,1,308,86,29329,30617,35186,3,29,16,0,0,1,0,5,345,64,28089,29048,32804,0,-37,22,1240,1,1569,2382,1,0,0,0,8
EUN1_3573816763',5,29,13,1,0,1,0,3,1,375,107,28680,31748,30640,4,34,9,1,0,0,0,6,331,64,23605,27769,23636,1,44,43,5075,4,3979,7004,0,0,1,0,-3
EUN1_3573291855',6,28,11,2,0,1,0,10,1,378,97,28771,30966,27693,1,16,4,0,0,1,0,4,333,82,23368,27233,22798,1,45,15,5403,7,3733,4895,2,0,0,0,6
EUN1_3573270862',6,28,10,0,0,0,0,7,0,335,86,26280,29565,28056,8,41,12,2,0,1,0,4,367,90,28597,29453,31075,1,-32,-4,-2317,-2,112,-3019,-2,0,-1,0,3
EUN1_3573116409',7,26,6,0,0,0,0,8,1,324,80,23183,27665,21992,5,28,13,2,0,0,0,3,369,94,27031,30935,38052,0,-45,-14,-3848,-7,-3270,-16060,-2,0,0,0,5
EUN1_3573083918',7,34,15,0,0,0,0,13,1,326,78,28689,30570,34877,2,71,19,1,0,1,0,0,374,97,32394,31704,38080,0,-48,-19,-3705,-4,-1134,-3203,-1,0,-1,0,13
EUN1_3572895241',5,42,13,1,0,1,0,7,0,342,80,28536,28629,30152,1,38,12,0,0,2,0,5,309,87,27209,28155,33938,0,33,-7,1327,1,474,-3786,1,0,-1,0,2
EUN1_3572870332',3,31,4,0,0,0,0,11,0,321,85,22148,27669,21760,5,96,5,1,0,1,0,1,367,82,25019,29401,21984,0,-46,3,-2871,-1,-1732,-224,-1,0,-1,0,10
EUN1_3572784267',1,24,6,0,0,1,0,9,1,354,97,25242,28409,20056,2,26,12,1,0,1,0,6,341,82,27058,27954,27533,0,13,15,-1816,-6,455,-7477,-1,0,0,0,3
EUN1_3572723495',4,35,3,2,0,0,0,7,0,322,75,21258,27211,25580,0,21,8,0,1,2,0,3,392,112,27994,32083,29985,1,-70,-37,-6736,-5,-4872,-4405,2,-1,-2,0,4
EUN1_3572686915',4,32,15,0,0,1,0,8,1,349,82,28481,30430,34442,4,26,13,1,0,0,0,6,342,73,26782,29586,29760,0,7,9,1699,2,844,4682,-1,0,1,0,2
EUN1_3572637030',3,36,11,0,0,0,0,9,1,351,80,26830,27582,33204,2,21,13,1,0,0,0,3,300,64,25966,26909,33830,0,51,16,864,-2,673,-626,-1,0,0,0,6
EUN1_3572619595',1,21,6,0,0,0,0,13,0,332,75,23266,26814,23387,3,26,15,2,1,4,0,2,391,112,31122,31895,36814,0,-59,-37,-7856,-9,-5081,-13427,-2,-1,-4,0,11
EUN1_3572599733',4,23,22,1,0,2,0,13,0,302,81,31888,30916,43896,3,67,18,0,0,0,0,3,312,70,30195,30543,36808,1,-10,11,1693,4,373,7088,1,0,2,0,10
EUN1_3576163317',1,22,17,2,0,3,0,5,0,362,99,31788,30745,39167,7,28,4,0,0,0,0,8,309,104,22468,26515,24092,1,53,-5,9320,13,4230,15075,2,0,3,0,-3
EUN1_3575266459',5,33,9,1,0,0,0,5,0,360,98,26129,29183,29733,4,29,18,1,1,0,0,3,359,88,28959,30475,36727,1,1,10,-2830,-9,-1292,-6994,0,-1,0,0,2
EUN1_3575240167',5,31,14,0,0,0,0,7,0,371,100,29736,31965,30979,6,25,12,2,0,2,0,3,402,88,27183,29617,32729,1,-31,12,2553,2,2348,-1750,-2,0,-2,0,4
EUN1_3574686037',3,26,8,1,0,0,0,7,0,361,80,24282,28728,26947,4,66,12,1,1,0,0,1,314,79,25787,27879,28295,1,47,1,-1505,-4,849,-1348,0,-1,0,0,6
EUN1_3574192497',2,71,4,0,0,0,0,11,0,323,88,23274,26401,25539,7,265,19,2,0,1,0,5,389,87,30240,31328,39664,0,-66,1,-6966,-15,-4927,-14125,-2,0,-1,0,6
EUN1_3574175564',1,24,19,1,0,0,0,8,0,356,94,29808,30750,38391,5,30,16,0,0,0,0,3,347,84,28943,29859,34714,1,9,10,865,3,891,3677,1,0,0,0,5
EUN1_3574170112',2,133,28,2,0,1,0,11,0,345,74,33982,31490,55110,0,21,13,0,0,2,0,6,286,92,25968,28467,38468,1,59,-18,8014,15,3023,16642,2,0,-1,0,5
EUN1_3574102309',4,21,15,0,0,0,0,10,0,302,81,26733,27615,28949,3,23,18,2,0,1,0,1,313,82,29240,27500,38021,0,-11,-1,-2507,-3,115,-9072,-2,0,-1,0,9
EUN1_3576138774',9,27,14,0,0,0,0,10,1,289,75,26924,26580,33345,6,91,17,1,0,2,0,2,327,71,29656,27403,38495,0,-38,4,-2732,-3,-823,-5150,-1,0,-2,0,8
EUN1_3576126760',3,57,7,1,0,0,0,10,0,334,69,23604,28279,30246,1,258,20,0,0,3,0,0,384,101,32320,31789,38906,0,-50,-32,-8716,-13,-3510,-8660,1,0,-3,0,10
EUN1_3575696165',2,24,16,0,0,2,0,10,0,358,92,30214,31582,32905,8,27,8,1,0,0,0,7,355,94,25236,28780,24888,1,3,-2,4978,8,2802,8017,-1,0,2,0,3
EUN1_3575683600',1,24,16,0,0,1,0,7,1,342,90,29503,29625,31802,3,26,14,2,1,0,0,5,301,96,27743,30201,33478,0,41,-6,1760,2,-576,-1676,-2,-1,1,0,2
EUN1_3575388154',3,185,5,0,0,0,0,6,1,370,86,23768,27739,25585,4,24,6,2,0,0,0,2,398,98,24733,30120,22984,0,-28,-12,-965,-1,-2381,2601,-2,0,0,0,4
EUN1_3574677648',4,27,11,0,1,0,0,11,0,341,92,24569,29763,30590,5,27,18,1,0,1,0,0,364,104,31302,31686,37039,0,-23,-12,-6733,-7,-1923,-6449,-1,1,-1,0,11
EUN1_3574673193',4,156,16,0,0,0,0,14,1,300,68,27494,27445,32168,3,18,23,1,0,3,0,1,374,100,35063,32210,40522,0,-74,-32,-7569,-7,-4765,-8354,-1,0,-3,0,13
EUN1_3574235364',2,24,16,1,1,0,0,5,0,366,100,30000,30301,36057,5,33,7,0,0,1,0,6,334,88,24004,28294,23169,1,32,12,5996,9,2007,12888,1,1,-1,0,-1
EUN1_3574219198',3,23,15,1,0,2,0,16,0,325,120,29993,31346,37892,4,59,22,1,0,3,0,5,351,83,32730,32160,36741,1,-26,37,-2737,-7,-814,1151,0,0,-1,0,11
EUN1_3574003299',3,28,12,0,1,0,0,10,0,337,98,26865,29414,32167,5,28,14,2,0,1,0,0,330,100,29964,28982,31626,0,7,-2,-3099,-2,432,541,-2,1,-1,0,10
EUN1_3573937034',2,99,8,1,0,0,0,9,1,373,84,24575,30391,25477,3,24,12,1,1,1,0,0,386,92,27701,30588,27377,0,-13,-8,-3126,-4,-197,-1900,0,-1,-1,0,9
EUN1_3573908069',0,31,13,1,0,0,0,10,0,332,98,27565,29300,35867,4,27,17,1,0,2,0,4,357,74,30043,30576,40755,1,-25,24,-2478,-4,-1276,-4888,0,0,-2,0,6
EUN1_3573874219',3,29,6,0,0,0,0,11,0,290,62,21968,25590,24606,5,29,16,1,0,0,0,4,351,86,28887,30316,35919,0,-61,-24,-6919,-10,-4726,-11313,-1,0,0,0,7
EUN1_3575825286',4,26,10,0,0,2,0,11,1,331,118,27853,29198,33114,4,23,18,2,0,1,0,6,329,81,29514,30167,31448,0,2,37,-1661,-8,-969,1666,-2,0,1,0,5
EUN1_3575765378',2,33,21,0,0,2,0,11,1,355,93,32613,32045,38987,1,26,10,2,0,0,0,3,327,88,24984,28539,35148,0,28,5,7629,11,3506,3839,-2,0,2,0,8
EUN1_3575739658',4,23,15,0,0,2,0,11,1,340,90,30816,28598,37060,2,46,29,2,0,0,0,7,308,81,33751,32683,42794,1,32,9,-2935,-14,-4085,-5734,-2,0,2,0,4
EUN1_3575339144',1,18,5,0,0,0,0,10,0,299,72,23197,25299,28083,9,37,20,2,0,1,0,3,320,84,29352,29537,42162,0,-21,-12,-6155,-15,-4238,-14079,-2,0,-1,0,7
EUN1_3575215640',9,38,9,0,0,0,0,8,1,337,74,25453,29160,37390,3,35,8,1,0,1,0,4,395,83,26686,29184,26429,1,-58,-9,-1233,1,-24,10961,-1,0,-1,0,4
EUN1_3575197336',3,25,15,1,0,1,0,6,1,378,90,29093,31074,31595,3,31,10,0,0,0,0,4,369,105,28030,30134,29807,0,9,-15,1063,5,940,1788,1,0,1,0,2
EUN1_3575180421',10,33,12,0,1,0,0,15,0,349,87,26989,30403,31341,3,24,11,2,0,2,0,3,355,80,26949,30185,34356,0,-6,7,40,1,218,-3015,-2,1,-2,0,12
EUN1_3573652985',6,26,17,2,0,3,0,13,1,308,101,30354,31663,34713,1,259,15,0,0,0,0,4,313,74,28503,30909,35644,1,-5,27,1851,2,754,-931,2,0,3,0,9
EUN1_3573634023',4,25,20,1,0,1,0,12,0,281,84,29588,27962,39213,1,22,25,0,0,2,0,3,347,92,33390,31519,53250,1,-66,-8,-3802,-5,-3557,-14037,1,0,-1,0,9
EUN1_3573399311',4,46,13,0,0,1,0,7,0,342,80,26679,28270,32991,3,26,11,1,0,0,0,2,347,68,26011,28011,32233,0,-5,12,668,2,259,758,-1,0,1,0,5
EUN1_3573369434',4,22,15,0,0,3,0,4,0,344,81,30004,31625,35437,3,22,16,2,0,0,0,6,320,90,28181,29721,30979,1,24,-9,1823,-1,1904,4458,-2,0,3,0,-2
EUN1_3573335492',6,31,13,1,0,0,0,11,0,291,66,24909,27512,35079,6,27,16,1,0,2,0,0,318,84,29601,29069,39820,0,-27,-18,-4692,-3,-1557,-4741,0,0,-2,0,11
EUN1_3573177804',3,27,10,0,0,2,0,6,0,359,77,28450,28103,31598,3,28,14,2,0,0,0,6,312,82,26806,27442,28258,0,47,-5,1644,-4,661,3340,-2,0,2,0,0
EUN1_3572899423',4,31,11,0,0,2,0,10,0,343,78,27914,29227,31569,7,30,11,2,1,1,0,7,323,90,27677,28742,28206,1,20,-12,237,0,485,3363,-2,-1,1,0,3
EUN1_3572373752',3,39,15,0,0,2,0,5,1,357,92,29134,30256,26936,4,39,7,2,0,0,0,3,329,88,24062,27809,24381,1,28,4,5072,8,2447,2555,-2,0,2,0,2
EUN1_3576064235',3,132,11,0,1,1,0,3,1,378,102,27486,30533,28836,4,103,12,1,0,0,0,6,391,98,27643,29456,31312,0,-13,4,-157,-1,1077,-2476,-1,1,1,0,-3
EUN1_3575742863',2,26,15,0,0,1,0,10,0,328,90,28205,30593,36147,6,34,11,2,0,0,0,4,356,106,27715,30210,31542,0,-28,-16,490,4,383,4605,-2,0,1,0,6
EUN1_3575739214',5,30,8,0,0,0,0,16,1,349,99,25391,29238,29307,6,28,12,2,0,2,0,4,340,96,29388,29793,33797,0,9,3,-3997,-4,-555,-4490,-2,0,-2,0,12
EUN1_3575625534',4,25,9,1,0,0,0,9,1,371,88,25148,29613,29356,5,29,6,1,0,1,0,2,342,84,23815,29027,23370,1,29,4,1333,3,586,5986,0,0,-1,0,7
EUN1_3575614295',1,29,6,0,0,0,0,9,1,337,88,24245,27367,31453,4,27,22,2,0,2,0,1,383,100,31885,34368,43656,0,-46,-12,-7640,-16,-7001,-12203,-2,0,-2,0,8
EUN1_3575026053',2,27,11,2,0,1,0,7,0,386,100,27631,30735,34449,4,47,13,0,0,0,0,6,338,72,26451,31014,30806,1,48,28,1180,-2,-279,3643,2,0,1,0,1
EUN1_3574963134',0,23,17,1,0,0,0,13,0,333,78,29294,28496,37824,5,28,17,1,0,2,0,7,363,104,31504,31124,39033,0,-30,-26,-2210,0,-2628,-1209,0,0,-2,0,6
EUN1_3574934630',3,23,8,0,0,1,0,14,1,337,83,24877,28080,22657,2,29,16,2,1,1,0,2,332,104,29889,30262,36179,0,5,-21,-5012,-8,-2182,-13522,-2,-1,0,0,12
EUN1_3574894406',4,23,16,1,1,0,0,5,1,390,111,30988,32447,37106,2,25,12,0,0,1,0,5,328,86,27182,29538,31076,1,62,25,3806,4,2909,6030,1,1,-1,0,0
EUN1_3574859522',4,26,15,0,0,0,0,6,1,376,81,28858,29847,37190,2,26,11,1,0,1,0,3,295,81,25552,28833,30294,1,81,0,3306,4,1014,6896,-1,0,-1,0,3
EUN1_3559668526',3,22,12,0,0,2,0,10,1,300,68,28139,27109,34782,4,28,18,2,0,0,0,8,303,70,28783,29000,44217,0,-3,-2,-644,-6,-1891,-9435,-2,0,2,0,2
EUN1_3559012982',5,28,18,2,0,1,0,14,0,323,74,29460,29829,35970,5,29,17,0,0,0,0,0,339,94,29848,29919,33471,0,-16,-20,-388,1,-90,2499,2,0,1,0,14
EUN1_3558338738',1,21,4,1,0,0,0,12,0,299,78,22169,26354,26916,7,24,18,1,0,0,0,2,341,102,29365,31985,35451,0,-42,-24,-7196,-14,-5631,-8535,0,0,0,0,10
EUN1_3558326186',3,22,16,0,0,0,0,8,1,317,68,28562,26242,41027,2,20,25,1,0,1,0,1,250,84,31631,28939,47279,0,67,-16,-3069,-9,-2697,-6252,-1,0,-1,0,7
EUN1_3558298403',6,55,10,0,0,0,0,11,1,342,72,26058,26299,25370,4,45,23,2,0,3,0,5,354,103,32771,32213,42272,0,-12,-31,-6713,-13,-5914,-16902,-2,0,-3,0,6
EUN1_3558259618',5,95,22,1,0,0,0,11,1,301,64,31385,28499,40535,2,45,17,1,0,1,0,4,295,93,28581,27560,33475,1,6,-29,2804,5,939,7060,0,0,-1,0,7
EUN1_3557998774',5,28,7,0,1,0,0,5,1,376,96,25925,29411,20115,5,26,9,2,0,0,0,2,408,88,27318,31456,24703,0,-32,8,-1393,-2,-2045,-4588,-2,1,0,0,3
EUN1_3557961242',4,25,16,2,1,1,0,8,1,318,84,28508,29418,32295,2,21,16,0,0,1,0,1,327,84,28779,29016,31202,0,-9,0,-271,0,402,1093,2,1,0,0,7
EUN1_3557291521',2,43,9,1,0,1,0,10,0,319,59,25871,26239,27271,4,50,17,0,0,1,0,4,322,84,29025,29263,28949,0,-3,-25,-3154,-8,-3024,-1678,1,0,0,0,6
EUN1_3557274151',6,158,9,1,0,0,0,3,0,337,84,24963,30235,33741,4,23,9,1,1,0,0,3,303,96,24387,29390,25063,0,34,-12,576,0,845,8678,0,-1,0,0,0
EUN1_3557225775',3,28,10,0,0,0,0,7,1,275,90,23874,25872,25445,5,25,10,1,0,2,0,2,325,94,27076,27783,28767,0,-50,-4,-3202,0,-1911,-3322,-1,0,-2,0,5
EUN1_3557201059',6,28,22,1,0,2,0,1,1,323,78,32624,29816,39823,5,27,7,0,0,0,0,5,367,89,24530,26673,21430,1,-44,-11,8094,15,3143,18393,1,0,2,0,-4
EUN1_3557114212',7,35,17,1,0,1,0,9,1,346,107,31283,29069,39673,8,32,15,1,0,1,0,6,311,57,29269,26900,34561,0,35,50,2014,2,2169,5112,0,0,0,0,3
EUN1_3557077924',8,34,12,2,0,0,0,11,0,363,96,29177,30962,27577,0,24,16,0,0,0,0,4,366,95,29763,31000,38616,1,-3,1,-586,-4,-38,-11039,2,0,0,0,7
EUN1_3557061341',3,25,7,0,0,0,0,8,1,321,68,23942,26321,28710,3,26,16,2,0,0,0,1,360,72,26940,29179,31103,0,-39,-4,-2998,-9,-2858,-2393,-2,0,0,0,7
EUN1_3557023803',4,33,15,0,0,0,0,10,0,329,60,28753,28267,37929,3,44,26,1,0,3,0,4,274,88,31854,30266,39200,1,55,-28,-3101,-11,-1999,-1271,-1,0,-3,0,6
EUN1_3556812997',6,41,16,1,0,0,0,9,0,332,86,29959,28821,35734,0,21,15,1,0,1,0,3,320,94,30135,29049,36793,1,12,-8,-176,1,-228,-1059,0,0,-1,0,6
EUN1_3556804545',1,27,8,1,0,0,0,11,0,374,101,27100,30626,29159,6,26,13,1,1,1,0,1,345,73,27090,30391,28426,1,29,28,10,-5,235,733,0,-1,-1,0,10
EUN1_3575954602',4,20,7,0,0,0,0,10,0,290,91,22858,27156,26131,3,24,18,1,0,1,0,1,373,109,29658,32494,34089,0,-83,-18,-6800,-11,-5338,-7958,-1,0,-1,0,9
EUN1_3573989016',3,30,12,0,0,0,0,3,0,356,78,26540,28789,38534,5,100,10,1,0,0,0,3,328,92,26004,28847,27797,1,28,-14,536,2,-58,10737,-1,0,0,0,0
EUN1_3573742359',0,23,10,0,0,0,0,11,0,296,55,24059,26161,30736,4,219,20,1,0,3,0,0,380,103,32814,32153,43456,0,-84,-48,-8755,-10,-5992,-12720,-1,0,-3,0,11
EUN1_3573710044',3,84,8,0,0,1,0,9,1,330,87,24782,28718,26052,1,26,12,2,0,1,0,5,307,92,26528,30124,24069,0,23,-5,-1746,-4,-1406,1983,-2,0,0,0,4
EUN1_3573298870',4,30,17,1,0,0,0,13,1,261,84,26872,25728,31866,0,46,22,0,0,2,0,2,334,88,32576,29430,36016,1,-73,-4,-5704,-5,-3702,-4150,1,0,-2,0,11
EUN1_3573270855',0,21,16,1,0,0,0,11,0,296,86,27148,29410,34723,7,19,14,0,0,0,0,0,346,77,27554,30504,34077,1,-50,9,-406,2,-1094,646,1,0,0,0,11
EUN1_3573140104',6,26,11,1,0,0,0,13,1,369,76,27274,28709,26730,2,33,16,1,0,1,0,0,337,92,29663,30261,32079,0,32,-16,-2389,-5,-1552,-5349,0,0,-1,0,13
EUN1_3573119709',6,186,16,0,0,2,0,13,1,301,95,30589,29638,38061,3,25,13,2,0,1,0,10,335,82,27406,29925,32455,1,-34,13,3183,3,-287,5606,-2,0,1,0,3
EUN1_3572634426',4,21,8,2,0,0,0,14,0,347,94,25966,27954,23124,2,24,11,0,0,2,0,2,368,83,26867,30268,25819,0,-21,11,-901,-3,-2314,-2695,2,0,-2,0,12
EUN1_3572296072',4,26,23,1,0,1,0,7,0,364,76,30557,32484,41238,3,27,8,0,0,0,0,4,318,82,24008,27292,31889,0,46,-6,6549,15,5192,9349,1,0,1,0,3
EUN1_3572247890',3,43,10,0,0,0,0,11,0,338,96,24740,29739,30405,2,21,7,2,0,0,0,3,361,120,26122,30521,30175,0,-23,-24,-1382,3,-782,230,-2,0,0,0,8
EUN1_3572086896',6,31,13,0,0,1,0,11,0,350,76,28056,28689,29373,3,27,16,2,0,1,0,4,338,99,29527,29708,35029,0,12,-23,-1471,-3,-1019,-5656,-2,0,0,0,7
EUN1_3572067783',5,31,23,2,0,1,0,6,1,360,102,32621,35189,46830,3,27,13,0,0,0,0,8,314,74,26689,29380,31133,1,46,28,5932,10,5809,15697,2,0,1,0,-2
EUN1_3571928925',5,29,15,0,0,1,0,13,0,321,87,29585,29170,37707,4,24,25,2,0,2,0,6,353,84,32949,30957,40210,0,-32,3,-3364,-10,-1787,-2503,-2,0,-1,0,7
EUN1_3568332318',3,58,22,0,0,0,0,8,1,303,86,30706,29557,41773,2,158,19,0,0,0,0,3,347,80,29771,29991,35689,0,-44,6,935,3,-434,6084,0,0,0,0,5
EUN1_3568300907',4,24,14,1,0,0,0,8,1,336,88,28157,30220,30149,0,26,14,1,0,0,0,0,348,84,28577,29441,39627,0,-12,4,-420,0,779,-9478,0,0,0,0,8
EUN1_3568285407',4,24,13,0,0,1,0,5,0,345,64,28012,29466,30608,5,26,8,2,0,0,0,5,365,94,26686,29333,29505,0,-20,-30,1326,5,133,1103,-2,0,1,0,0
EUN1_3565299174',0,23,19,1,0,3,0,4,1,376,87,31553,31848,39828,3,22,6,1,0,0,0,6,315,82,22840,26138,25946,1,61,5,8713,13,5710,13882,0,0,3,0,-2
EUN1_3565267538',5,68,15,2,0,0,0,3,0,312,92,26527,30950,29912,3,61,7,0,0,0,0,2,380,80,24563,30020,27413,1,-68,12,1964,8,930,2499,2,0,0,0,1
EUN1_3565252404',1,26,12,1,0,0,0,6,1,334,100,28112,31324,29851,2,27,5,1,0,1,0,3,353,82,23419,27603,24115,0,-19,18,4693,7,3721,5736,0,0,-1,0,3
EUN1_3564300009',6,25,7,1,0,0,0,13,0,345,74,24358,26994,26436,3,30,16,1,1,2,0,0,346,108,32582,29677,34580,0,-1,-34,-8224,-9,-2683,-8144,0,-1,-2,0,13
EUN1_3564287608',5,34,5,1,0,0,0,8,0,299,78,22183,25534,21307,5,96,14,1,0,1,0,1,338,114,29688,29726,36934,0,-39,-36,-7505,-9,-4192,-15627,0,0,-1,0,7
EUN1_3562499558',4,34,14,1,0,0,0,9,0,312,94,26639,28933,32107,2,140,9,0,0,0,0,0,381,85,26659,29511,27200,0,-69,9,-20,5,-578,4907,1,0,0,0,9
EUN1_3562273471',7,22,7,2,0,0,0,11,0,363,91,24693,27831,25013,4,28,12,0,0,2,0,1,375,82,29062,29429,30030,0,-12,9,-4369,-5,-1598,-5017,2,0,-2,0,10
EUN1_3562256254',5,52,8,2,0,0,0,8,1,384,106,26244,28380,21680,2,27,12,0,0,2,0,2,396,90,29509,30771,26726,0,-12,16,-3265,-4,-2391,-5046,2,0,-2,0,6
EUN1_3562237725',4,20,12,1,0,0,0,11,0,390,71,27359,30104,31077,8,321,7,1,0,0,0,4,321,88,24546,27034,19560,1,69,-17,2813,5,3070,11517,0,0,0,0,7
EUN1_3562217773',3,28,8,0,0,0,0,10,0,346,86,25615,28168,29616,4,23,13,2,0,0,0,3,382,94,27338,31111,26290,0,-36,-8,-1723,-5,-2943,3326,-2,0,0,0,7
EUN1_3561810689',3,24,17,2,0,0,0,12,1,379,76,29620,29653,35083,3,204,18,0,0,1,0,2,354,94,32006,31875,37782,0,25,-18,-2386,-1,-2222,-2699,2,0,-1,0,10
EUN1_3559663813',4,49,17,1,0,1,0,7,1,293,92,29335,27764,32858,7,50,10,1,0,0,0,6,313,92,25671,27017,31239,1,-20,0,3664,7,747,1619,0,0,1,0,1
EUN1_3559626970',2,23,7,0,0,1,0,6,1,338,98,25396,28140,30952,2,23,11,2,0,0,0,4,311,98,26403,30465,34780,0,27,0,-1007,-4,-2325,-3828,-2,0,1,0,2
EUN1_3575829153',5,24,7,0,0,0,0,12,0,357,70,24059,27758,27884,3,21,19,1,0,1,0,2,347,115,30870,33988,37118,0,10,-45,-6811,-12,-6230,-9234,-1,0,-1,0,10
EUN1_3575334497',2,24,3,0,0,0,0,15,0,354,103,23289,26273,25583,1,23,18,2,1,3,0,4,371,108,31759,32633,28789,0,-17,-5,-8470,-15,-6360,-3206,-2,-1,-3,0,11
EUN1_3575313685',7,26,20,1,0,1,0,12,1,360,106,32632,32291,31995,5,31,15,1,0,2,0,9,320,86,29673,31527,36168,0,40,20,2959,5,764,-4173,0,0,-1,0,3
EUN1_3574972862',1,23,5,1,0,1,0,12,0,345,104,24625,27667,24233,2,30,6,1,0,0,0,2,360,88,24613,29361,22228,1,-15,16,12,-1,-1694,2005,0,0,1,0,10
EUN1_3574397556',5,22,12,0,0,0,0,7,0,334,116,27446,31528,30326,5,87,14,2,0,0,0,3,315,83,25677,28564,32554,0,19,33,1769,-2,2964,-2228,-2,0,0,0,4
EUN1_3574367836',2,25,15,1,0,1,0,6,0,381,77,28946,31948,34496,4,28,13,0,0,1,0,6,345,98,27924,30539,29057,1,36,-21,1022,2,1409,5439,1,0,0,0,0
EUN1_3574302122',6,28,17,1,0,2,0,6,1,454,88,32675,36122,38565,5,21,14,1,0,1,0,4,337,88,28092,31159,29985,1,117,0,4583,3,4963,8580,0,0,1,0,2
EUN1_3574261268',4,26,7,1,0,1,0,11,1,355,90,26135,29051,22541,3,31,9,1,0,0,0,5,340,110,26409,29848,26221,1,15,-20,-274,-2,-797,-3680,0,0,1,0,6
EUN1_3573382553',0,20,4,1,0,0,0,8,0,348,72,21529,26477,25994,1,18,13,0,1,1,0,0,339,83,27518,29655,36107,0,9,-11,-5989,-9,-3178,-10113,1,-1,-1,0,8
EUN1_3573221037',2,24,24,0,0,1,0,14,1,294,82,31017,32675,40835,4,26,17,1,0,3,0,3,306,82,29831,29836,38683,1,-12,0,1186,7,2839,2152,-1,0,-2,0,11
EUN1_3572902081',4,27,16,1,0,2,0,5,1,403,88,30628,32837,33954,5,29,10,1,0,0,0,5,357,72,26527,30726,30566,1,46,16,4101,6,2111,3388,0,0,2,0,0
EUN1_3572129705',3,68,15,1,0,1,0,2,0,343,98,29874,30945,33012,7,29,17,1,0,1,0,6,316,82,28442,29505,37905,0,27,16,1432,-2,1440,-4893,0,0,0,0,-4
EUN1_3570484868',1,20,7,1,0,1,0,3,0,390,102,27349,33064,30531,3,25,7,1,0,0,0,6,378,86,24589,29533,26897,0,12,16,2760,0,3531,3634,0,0,1,0,-3
EUN1_3569671147',4,23,12,1,1,1,0,9,1,318,90,27526,31132,25520,3,258,11,1,0,0,0,8,326,102,27189,29218,28923,1,-8,-12,337,1,1914,-3403,0,1,1,0,1
EUN1_3569323959',4,155,9,1,0,0,0,14,0,324,79,24084,27284,19812,3,29,18,0,0,3,0,0,406,67,32765,32358,35399,0,-82,12,-8681,-9,-5074,-15587,1,0,-3,0,14
EUN1_3569290775',5,28,14,0,0,0,0,11,1,331,71,26740,28714,33595,4,26,11,1,0,1,0,3,368,76,27397,29739,38259,1,-37,-5,-657,3,-1025,-4664,-1,0,-1,0,8
EUN1_3569116961',2,18,14,2,1,0,0,7,0,388,96,29129,30526,33306,5,30,13,0,0,0,0,0,374,96,28322,30865,33121,1,14,0,807,1,-339,185,2,1,0,0,7
EUN1_3568810120',3,44,12,1,0,0,0,11,0,385,63,26722,31461,34274,4,32,13,0,0,1,0,1,306,97,27731,29978,30428,0,79,-34,-1009,-1,1483,3846,1,0,-1,0,10
EUN1_3574914823',2,90,17,1,1,1,0,7,1,346,106,28606,31952,26769,5,27,7,1,0,0,0,4,359,74,24951,29065,24970,1,-13,32,3655,10,2887,1799,0,1,1,0,3
EUN1_3574478231',3,29,22,2,0,3,0,7,1,365,82,32798,33237,37360,5,32,14,0,0,1,0,10,299,104,28866,28691,31727,1,66,-22,3932,8,4546,5633,2,0,2,0,-3
EUN1_3574442095',3,27,14,2,0,0,0,11,0,266,82,27657,27805,36148,3,26,14,0,1,2,0,3,335,94,27771,30005,30482,0,-69,-12,-114,0,-2200,5666,2,-1,-2,0,8
EUN1_3574131074',7,35,10,0,0,0,0,6,1,366,88,27353,28244,32517,5,29,14,2,0,0,0,6,366,94,27917,30803,30387,0,0,-6,-564,-4,-2559,2130,-2,0,0,0,0
EUN1_3573918700',4,89,16,2,0,0,0,9,0,288,89,26486,27995,34829,5,74,18,0,0,1,0,1,346,73,29608,29565,40656,0,-58,16,-3122,-2,-1570,-5827,2,0,-1,0,8
EUN1_3573880056',3,27,15,0,0,1,0,10,1,332,78,28401,29271,32909,5,31,20,2,0,3,0,7,351,94,32843,31616,38785,0,-19,-16,-4442,-5,-2345,-5876,-2,0,-2,0,3
EUN1_3573781787',5,63,12,1,0,1,0,19,1,313,62,28000,27429,24191,6,23,17,1,0,5,0,4,329,86,30816,29549,39507,0,-16,-24,-2816,-5,-2120,-15316,0,0,-4,0,15
EUN1_3573680598',5,26,8,1,0,1,0,7,1,367,96,26104,29389,25168,6,100,12,1,0,1,0,1,346,86,25573,30160,28058,1,21,10,531,-4,-771,-2890,0,0,0,0,6
EUN1_3573663681',2,244,18,1,1,1,0,8,1,347,86,29988,31417,32990,3,25,10,1,0,0,0,4,321,91,25032,29346,29485,1,26,-5,4956,8,2071,3505,0,1,1,0,4
EUN1_3573648643',5,130,7,0,0,0,0,8,0,353,102,26413,30591,25831,3,20,15,2,0,1,0,8,391,84,28815,31564,31521,0,-38,18,-2402,-8,-973,-5690,-2,0,-1,0,0
EUN1_3573554280',8,30,19,1,0,4,0,2,1,385,122,34330,32797,38020,7,32,5,0,0,0,0,11,311,70,22521,26687,25587,1,74,52,11809,14,6110,12433,1,0,4,0,-9
EUN1_3573534896',6,150,12,0,1,0,0,5,1,348,100,27332,31124,30868,6,260,9,2,0,1,0,2,410,88,27881,30533,32882,0,-62,12,-549,3,591,-2014,-2,1,-1,0,3
EUN1_3573535466',4,255,21,1,0,2,0,8,1,351,92,32997,30823,37871,3,23,11,1,0,1,0,7,293,76,25378,27162,32591,1,58,16,7619,10,3661,5280,0,0,1,0,1
EUN1_3573391171',7,35,6,0,0,0,0,8,0,328,72,23504,26567,23975,5,26,22,2,0,2,0,2,343,88,32331,30713,35667,0,-15,-16,-8827,-16,-4146,-11692,-2,0,-2,0,6
EUN1_3573345880',1,15,17,1,0,0,0,6,1,396,85,31051,31114,30455,4,29,10,1,0,1,0,5,322,97,26663,29412,29836,1,74,-12,4388,7,1702,619,0,0,-1,0,1
EUN1_3573070254',5,34,8,1,1,1,0,12,1,342,102,26489,28156,22708,4,27,11,1,0,1,0,4,398,124,29013,31352,29261,0,-56,-22,-2524,-3,-3196,-6553,0,1,0,0,8
EUN1_3576009005',2,31,6,0,0,0,0,9,0,347,84,23868,28220,22502,11,37,7,2,0,1,0,3,395,87,26811,30274,25829,1,-48,-3,-2943,-1,-2054,-3327,-2,0,-1,0,6
EUN1_3575977993',1,55,11,1,0,1,0,6,0,354,98,26729,31467,30250,3,60,9,1,0,0,0,2,351,92,25672,29601,33207,0,3,6,1057,2,1866,-2957,0,0,1,0,4
EUN1_3575064156',6,34,7,0,0,0,0,8,0,325,88,24495,28653,27113,2,21,11,2,0,1,0,3,347,88,25406,30271,29258,0,-22,0,-911,-4,-1618,-2145,-2,0,-1,0,5
EUN1_3575032651',3,31,12,0,0,0,0,6,0,363,83,27396,30424,28950,3,29,16,2,1,0,0,4,301,100,27968,29381,36688,1,62,-17,-572,-4,1043,-7738,-2,-1,0,0,2
EUN1_3574997899',3,23,12,1,0,0,0,13,0,281,88,26284,29650,29091,2,23,16,1,0,2,0,0,380,102,32871,31265,30577,1,-99,-14,-6587,-4,-1615,-1486,0,0,-2,0,13
EUN1_3574970015',4,140,12,2,0,0,0,3,1,349,80,27015,28871,28178,2,50,12,0,0,1,0,4,327,115,25976,29969,23259,1,22,-35,1039,0,-1098,4919,2,0,-1,0,-1
EUN1_3574794454',3,26,14,0,0,0,0,5,0,329,78,26875,27956,31605,4,29,15,1,0,0,0,6,296,78,27244,27436,33484,0,33,0,-369,-1,520,-1879,-1,0,0,0,-1
EUN1_3569832914',4,41,13,1,0,1,0,11,1,326,70,26970,27433,33664,5,23,9,1,0,1,0,2,359,82,27365,27892,29252,1,-33,-12,-395,4,-459,4412,0,0,0,0,9
EUN1_3569763441',2,25,14,0,0,1,0,6,1,310,103,27685,27828,33219,3,32,17,1,0,0,0,1,300,83,29102,27443,38896,0,10,20,-1417,-3,385,-5677,-1,0,1,0,5
EUN1_3568769472',6,29,24,1,0,0,0,8,0,301,100,29258,29778,44467,2,26,11,0,0,0,0,3,330,75,25963,28338,30520,1,-29,25,3295,13,1440,13947,1,0,0,0,5
EUN1_3568279701',2,26,16,1,0,1,0,8,1,307,82,29099,30012,38311,3,24,15,1,0,0,0,6,323,78,27884,29400,40351,1,-16,4,1215,1,612,-2040,0,0,1,0,2
EUN1_3567857684',3,24,14,1,0,0,0,5,0,336,88,28672,29653,38026,3,20,13,1,0,1,0,4,342,86,27258,30543,34005,1,-6,2,1414,1,-890,4021,0,0,-1,0,1
EUN1_3567834538',4,34,11,1,0,0,0,6,0,332,103,26121,29201,27063,6,32,14,0,0,0,0,2,368,72,28730,32050,32590,1,-36,31,-2609,-3,-2849,-5527,1,0,0,0,4
EUN1_3567320787',1,36,14,1,0,0,0,4,0,353,110,28512,32292,35110,3,19,8,1,0,0,0,5,364,86,24934,29481,24946,1,-11,24,3578,6,2811,10164,0,0,0,0,-1
EUN1_3567294035',6,48,6,0,0,0,0,7,0,336,110,24823,28569,29146,4,23,12,2,1,1,0,2,363,122,28181,32464,33752,0,-27,-12,-3358,-6,-3895,-4606,-2,-1,-1,0,5
EUN1_3567256750',3,35,12,0,0,0,0,7,1,381,99,28129,31377,35011,0,23,7,1,0,0,0,2,364,85,24503,28390,27260,1,17,14,3626,5,2987,7751,-1,0,0,0,5
EUN1_3567242370',4,25,10,0,0,0,0,8,1,378,84,26620,31329,29488,3,22,8,1,0,0,0,0,363,95,25734,30060,33518,1,15,-11,886,2,1269,-4030,-1,0,0,0,8
EUN1_3566680807',4,30,9,2,0,1,0,8,0,361,82,26930,29640,30831,3,20,12,0,1,0,0,4,379,98,28074,31281,32951,0,-18,-16,-1144,-3,-1641,-2120,2,-1,1,0,4
EUN1_3566668648',3,30,18,0,0,0,0,6,1,366,79,29609,31291,43399,4,39,10,1,0,0,0,4,328,76,24983,29611,39935,1,38,3,4626,8,1680,3464,-1,0,0,0,2
EUN1_3566655308',4,34,8,0,0,0,0,7,0,337,74,25159,26664,30797,5,33,17,1,0,0,0,1,326,98,27512,29347,32852,0,11,-24,-2353,-9,-2683,-2055,-1,0,0,0,6
EUN1_3566407998',7,42,7,2,0,0,0,8,0,294,104,23938,27919,27156,5,42,13,0,0,0,0,1,339,86,27489,29503,28176,0,-45,18,-3551,-6,-1584,-1020,2,0,0,0,7
EUN1_3566397463',4,157,15,0,0,2,0,8,1,330,96,30505,32393,37011,5,26,13,2,0,1,0,9,349,104,28561,29772,32922,1,-19,-8,1944,2,2621,4089,-2,0,1,0,-1
EUN1_3566363812',3,23,13,0,0,0,0,6,0,408,72,28030,30717,27283,5,24,9,2,0,1,0,3,375,80,26326,28632,29030,0,33,-8,1704,4,2085,-1747,-2,0,-1,0,3
EUN1_3566326554',5,34,16,0,0,2,0,4,1,382,99,30970,31499,30034,4,30,10,2,0,0,0,9,360,96,26244,29694,32273,1,22,3,4726,6,1805,-2239,-2,0,2,0,-5
EUN1_3566298579',3,29,8,1,0,0,0,7,1,382,72,24659,29531,26584,3,26,8,0,0,1,0,1,365,116,26873,31481,33273,1,17,-44,-2214,0,-1950,-6689,1,0,-1,0,6
EUN1_3566276235',4,33,11,2,0,1,0,8,1,363,103,27834,30914,31949,1,94,8,0,0,0,0,5,336,84,24942,28311,28571,1,27,19,2892,3,2603,3378,2,0,1,0,3
EUN1_3564564747',4,30,10,1,0,0,0,10,1,345,89,25888,29073,31186,3,25,15,0,0,1,0,0,344,82,28209,30525,29366,0,1,7,-2321,-5,-1452,1820,1,0,-1,0,10
EUN1_3564546417',4,42,13,0,0,1,0,9,0,334,84,28289,28760,34106,3,29,10,1,0,1,0,4,345,92,27208,30113,29424,1,-11,-8,1081,3,-1353,4682,-1,0,0,0,5
EUN1_3564090763',8,25,8,0,0,0,0,9,1,347,94,25030,29355,26764,2,22,11,2,0,1,0,1,361,93,27094,30628,22908,1,-14,1,-2064,-3,-1273,3856,-2,0,-1,0,8
EUN1_3564063219',8,46,11,2,0,0,0,7,1,341,83,27255,26928,28175,4,26,9,0,0,2,0,3,364,76,26175,28060,25688,1,-23,7,1080,2,-1132,2487,2,0,-2,0,4
EUN1_3563859269',5,26,16,1,1,1,0,6,0,335,82,29003,30560,35150,2,23,5,0,0,0,0,4,339,65,22677,26020,27761,1,-4,17,6326,11,4540,7389,1,1,1,0,2
EUN1_3563827670',3,25,12,1,0,0,0,6,1,353,104,27290,31224,36844,3,28,11,0,0,1,0,3,375,101,28544,31244,33270,0,-22,3,-1254,1,-20,3574,1,0,-1,0,3
EUN1_3563787078',5,28,22,1,0,2,0,9,1,355,102,33192,31953,39293,3,59,8,1,1,0,0,7,332,86,26181,28476,26663,1,23,16,7011,14,3477,12630,0,-1,2,0,2
EUN1_3563757593',3,19,7,0,0,0,0,12,1,328,78,25204,26793,30086,5,23,13,2,0,1,0,5,343,58,27736,28340,37859,0,-15,20,-2532,-6,-1547,-7773,-2,0,-1,0,7
EUN1_3576045829',4,31,17,2,0,0,0,6,0,360,100,30089,29852,40192,2,22,16,0,0,0,0,1,341,68,27395,28870,35874,1,19,32,2694,1,982,4318,2,0,0,0,5
EUN1_3575948419',3,23,9,0,0,0,0,9,0,353,92,25269,28568,30639,7,47,13,2,0,1,0,2,348,90,28501,29791,31006,0,5,2,-3232,-4,-1223,-367,-2,0,-1,0,7
EUN1_3575889348',5,33,12,0,0,0,0,6,0,369,90,27197,30867,31695,3,31,12,2,0,0,0,1,297,78,24700,26994,28373,1,72,12,2497,0,3873,3322,-2,0,0,0,5
EUN1_3575868225',2,24,8,0,0,0,0,10,0,307,104,25201,28812,25447,2,25,14,2,0,2,0,2,365,75,28569,30496,29444,0,-58,29,-3368,-6,-1684,-3997,-2,0,-2,0,8
EUN1_3575840017',6,30,13,2,0,0,0,9,0,332,92,27131,29384,35686,4,211,15,0,0,1,0,3,356,88,29038,32307,39958,0,-24,4,-1907,-2,-2923,-4272,2,0,-1,0,6
EUN1_3575821983',2,23,15,1,1,1,0,9,0,333,85,28816,30365,36908,1,22,12,1,0,1,0,6,341,100,26093,27859,31534,1,-8,-15,2723,3,2506,5374,0,1,0,0,3
EUN1_3575797204',2,38,10,1,0,0,0,11,0,354,86,26173,29985,29756,2,21,17,0,0,0,0,2,351,86,30527,31253,34134,1,3,0,-4354,-7,-1268,-4378,1,0,0,0,9
EUN1_3575773749',3,22,11,0,0,0,0,11,0,355,76,26864,28466,31008,4,30,18,2,0,2,0,4,359,96,29676,31029,30058,0,-4,-20,-2812,-7,-2563,950,-2,0,-2,0,7
EUN1_3575329269',3,20,16,1,0,0,0,7,1,314,94,27745,30275,33626,1,25,7,1,0,1,0,1,342,70,24287,25727,32805,0,-28,24,3458,9,4548,821,0,0,-1,0,6
EUN1_3574968999',2,26,15,2,0,1,0,9,1,401,80,32059,32338,31734,3,24,6,0,0,0,0,5,357,99,24618,27901,30432,1,44,-19,7441,9,4437,1302,2,0,1,0,4
EUN1_3574942116',0,19,13,0,0,0,0,8,0,371,72,26578,29671,30910,5,47,18,2,0,0,0,2,312,100,28614,30509,39810,1,59,-28,-2036,-5,-838,-8900,-2,0,0,0,6
EUN1_3574555301',7,48,2,0,0,0,0,5,0,380,90,22719,28883,20301,1,42,10,2,0,0,0,1,425,98,26826,32144,20969,0,-45,-8,-4107,-8,-3261,-668,-2,0,0,0,4
EUN1_3574536657',3,21,7,1,0,1,0,11,1,352,68,24875,26480,28800,4,26,18,1,1,1,0,5,351,92,30097,31611,31063,0,1,-24,-5222,-11,-5131,-2263,0,-1,0,0,6
EUN1_3574508995',1,51,17,2,0,1,0,6,1,336,90,29256,30497,31520,2,40,11,0,0,0,0,3,369,85,27241,29176,32665,1,-33,5,2015,6,1321,-1145,2,0,1,0,3
EUN1_3574494643',5,30,13,1,0,1,0,8,1,341,88,28347,28673,30344,2,21,11,1,0,2,0,8,329,68,25880,27657,28181,1,12,20,2467,2,1016,2163,0,0,-1,0,0
EUN1_3574475603',3,25,12,2,0,0,0,12,1,292,52,25033,24980,31607,0,42,13,0,0,2,0,2,372,85,28905,29582,33647,0,-80,-33,-3872,-1,-4602,-2040,2,0,-2,0,10
EUN1_3574429696',3,133,11,1,0,1,0,7,1,369,107,27885,31646,30649,3,35,14,0,0,0,0,4,318,73,26186,29935,28477,1,51,34,1699,-3,1711,2172,1,0,1,0,3
EUN1_3574404984',2,32,9,1,0,0,0,5,0,328,94,25672,30461,31869,3,35,5,1,0,0,0,5,342,98,23729,27298,27551,1,-14,-4,1943,4,3163,4318,0,0,0,0,0
EUN1_3574385214',2,33,15,2,0,1,0,12,0,283,65,28901,27289,49598,1,30,17,0,0,2,0,10,301,81,28124,26665,46004,1,-18,-16,777,-2,624,3594,2,0,-1,0,2
EUN1_3575556980',3,36,9,0,0,0,0,10,0,295,72,23819,26282,24827,7,34,23,2,0,0,0,1,365,92,30143,31184,38051,0,-70,-20,-6324,-14,-4902,-13224,-2,0,0,0,9
EUN1_3575538331',7,27,16,1,0,1,0,8,1,350,84,28448,31701,35685,4,33,8,1,0,0,0,3,383,88,24933,29922,27391,1,-33,-4,3515,8,1779,8294,0,0,1,0,5
EUN1_3575477637',3,19,13,0,0,1,0,10,1,361,92,27940,30638,32769,3,25,11,2,0,1,0,6,342,103,26840,28476,32401,1,19,-11,1100,2,2162,368,-2,0,0,0,4
EUN1_3575458910',3,26,34,1,1,4,0,9,1,341,96,36760,33109,51356,4,24,7,0,0,1,0,11,298,79,23827,26823,29787,1,43,17,12933,27,6286,21569,1,1,3,0,-2
EUN1_3575049382',6,30,4,1,0,1,0,5,1,384,86,24723,27899,25575,6,38,8,0,0,0,0,4,381,86,25190,29991,22371,0,3,0,-467,-4,-2092,3204,1,0,1,0,1
EUN1_3575019636',1,26,10,1,0,0,0,9,0,302,100,25331,27863,29454,4,137,19,1,0,1,0,5,336,72,30382,33015,38449,0,-34,28,-5051,-9,-5152,-8995,0,0,-1,0,4
EUN1_3569492882',1,23,12,0,0,1,0,13,1,279,80,26857,28562,29606,3,147,20,1,0,2,0,3,355,94,31670,31181,43252,0,-76,-14,-4813,-8,-2619,-13646,-1,0,-1,0,10
EUN1_3569369291',1,29,10,0,0,0,0,14,0,327,56,26045,26160,40216,3,17,26,2,0,4,0,1,329,84,34736,31270,42202,0,-2,-28,-8691,-16,-5110,-1986,-2,0,-4,0,13
EUN1_3569363371',3,30,24,2,0,2,0,7,1,352,108,33207,34065,38416,1,20,9,0,0,1,0,7,290,68,23258,26827,22266,1,62,40,9949,15,7238,16150,2,0,1,0,0
EUN1_3568755577',2,65,11,1,0,1,0,15,0,320,92,27634,29232,32107,5,47,18,1,0,2,0,4,351,96,30602,32064,39453,0,-31,-4,-2968,-7,-2832,-7346,0,0,-1,0,11
EUN1_3566562594',4,28,10,0,0,0,0,8,0,306,103,26941,28732,32624,2,21,27,0,0,1,0,6,297,76,32149,31087,49107,1,9,27,-5208,-17,-2355,-16483,0,0,-1,0,2
EUN1_3565861423',4,38,21,1,0,2,0,5,1,401,88,33433,31552,39804,4,26,13,0,0,0,0,8,319,92,28429,28135,31860,1,82,-4,5004,8,3417,7944,1,0,2,0,-3
EUN1_3565205984',2,30,7,0,0,0,0,11,0,317,72,23585,26455,34469,4,26,22,1,0,1,0,0,337,84,30281,30565,40414,0,-20,-12,-6696,-15,-4110,-5945,-1,0,-1,0,11
EUN1_3564600526',2,26,8,0,0,0,0,9,0,316,86,23623,28436,31806,2,26,16,1,0,0,0,0,353,97,28763,30275,34424,0,-37,-11,-5140,-8,-1839,-2618,-1,0,0,0,9
EUN1_3564585327',9,31,19,1,0,1,0,8,1,282,84,29317,27592,29911,0,22,8,0,0,1,0,6,293,74,24210,25897,20905,0,-11,10,5107,11,1695,9006,1,0,0,0,2
EUN1_3564270209',3,29,13,0,0,1,0,8,0,347,80,28496,29723,33173,4,30,17,1,0,0,0,5,330,80,28522,29643,35042,0,17,0,-26,-4,80,-1869,-1,0,1,0,3
EUN1_3564254307',5,35,16,1,0,0,0,10,1,303,86,28371,26711,36747,1,25,13,0,0,1,0,3,340,78,28040,28788,39821,1,-37,8,331,3,-2077,-3074,1,0,-1,0,7
EUN1_3574161379',3,28,13,0,0,1,0,10,1,393,94,29043,30827,30821,3,35,6,2,0,1,0,5,301,78,22595,27890,28573,1,92,16,6448,7,2937,2248,-2,0,0,0,5
EUN1_3574133962',6,25,8,0,0,0,0,8,1,313,64,24501,29294,28981,4,40,15,0,0,1,0,4,354,92,28749,32372,31869,0,-41,-28,-4248,-7,-3078,-2888,0,0,-1,0,4
EUN1_3570206829',2,23,16,1,0,1,0,8,1,331,95,28788,30445,37201,1,22,9,1,0,1,0,5,317,92,26242,28946,26185,1,14,3,2546,7,1499,11016,0,0,0,0,3
EUN1_3568035185',4,30,11,1,0,0,0,6,0,366,86,27757,29946,36867,3,23,13,1,0,0,0,2,328,78,26507,29854,27992,0,38,8,1250,-2,92,8875,0,0,0,0,4
EUN1_3568014015',4,30,17,0,0,1,0,12,1,317,85,29383,28823,34799,3,27,13,2,0,1,0,2,307,102,27910,28175,30891,0,10,-17,1473,4,648,3908,-2,0,0,0,10
EUN1_3567702711',3,24,13,1,0,0,0,9,0,359,64,27474,29826,27118,2,49,15,0,1,1,0,3,352,100,29293,31000,32914,0,7,-36,-1819,-2,-1174,-5796,1,-1,-1,0,6
EUN1_3567439373',3,20,20,2,0,1,0,6,1,352,78,30569,30755,43037,2,29,9,0,0,0,0,5,352,62,25253,28526,27000,1,0,16,5316,11,2229,16037,2,0,1,0,1
EUN1_3567162430',3,18,15,1,1,0,0,14,1,360,88,28402,30193,33696,1,31,8,1,0,2,0,2,314,79,26519,27050,26676,1,46,9,1883,7,3143,7020,0,1,-2,0,12
EUN1_3567055088',1,21,12,1,0,1,0,4,0,330,100,27885,30581,32713,2,25,9,0,0,1,0,6,329,76,24791,28050,27204,0,1,24,3094,3,2531,5509,1,0,0,0,-2
EUN1_3567040176',3,25,18,1,0,0,0,7,1,366,81,30146,30464,39639,2,23,10,1,0,2,0,1,319,75,25653,26808,29994,1,47,6,4493,8,3656,9645,0,0,-2,0,6
EUN1_3567017947',5,69,8,1,0,0,0,6,0,351,116,25445,30423,26041,2,59,9,0,1,0,0,1,369,100,26395,30046,28507,1,-18,16,-950,-1,377,-2466,1,-1,0,0,5
EUN1_3563723832',3,20,17,1,0,1,0,13,0,311,87,30268,30939,36475,1,24,14,0,0,1,0,4,358,112,29866,29897,38111,0,-47,-25,402,3,1042,-1636,1,0,0,0,9
EUN1_3563165301',1,24,16,2,0,0,0,8,1,320,98,28656,29403,37445,3,45,15,0,0,0,0,0,328,97,28144,27316,38950,1,-8,1,512,1,2087,-1505,2,0,0,0,8
EUN1_3563147571',4,75,14,1,0,1,0,11,0,305,93,28051,29083,29083,0,29,16,1,0,2,0,4,349,101,30791,31477,43615,0,-44,-8,-2740,-2,-2394,-14532,0,0,-1,0,7
EUN1_3573406554',3,46,13,1,0,1,0,6,1,387,82,28237,31307,31513,3,24,7,0,0,0,0,7,285,74,21919,27230,23400,1,102,8,6318,6,4077,8113,1,0,1,0,-1
EUN1_3573340720',3,30,10,1,0,1,0,6,1,356,95,26446,30095,28507,3,25,6,0,0,0,0,1,382,57,22915,27880,24647,1,-26,38,3531,4,2215,3860,1,0,1,0,5
EUN1_3573307042',7,30,13,1,0,1,0,9,1,352,100,28261,30525,34340,1,24,10,0,0,0,0,4,364,64,26053,28285,33798,1,-12,36,2208,3,2240,542,1,0,1,0,5
EUN1_3573275863',2,27,13,0,0,0,0,3,0,369,104,28164,31659,35361,3,63,7,1,0,0,0,4,340,86,23925,28322,25033,1,29,18,4239,6,3337,10328,-1,0,0,0,-1
EUN1_3573189345',8,30,20,1,1,2,0,7,1,382,112,33898,34920,41813,3,29,9,1,0,1,0,9,314,79,23850,27092,29048,0,68,33,10048,11,7828,12765,0,1,1,0,-2
EUN1_3573172132',5,24,8,0,0,0,0,9,0,317,85,24232,26980,29812,6,26,19,2,0,0,0,1,338,73,28979,29076,33019,0,-21,12,-4747,-11,-2096,-3207,-2,0,0,0,8
EUN1_3573147533',6,35,16,0,0,0,0,7,0,369,96,29347,32486,33445,3,45,11,1,0,1,0,6,306,72,26239,28270,27146,1,63,24,3108,5,4216,6299,-1,0,-1,0,1
EUN1_3573115364',3,21,19,0,0,0,0,8,1,312,94,30019,29790,35982,1,29,18,1,0,0,0,2,301,70,28178,28542,40044,0,11,24,1841,1,1248,-4062,-1,0,0,0,6
EUN1_3573093381',0,21,9,0,0,0,0,15,0,279,88,24656,25887,30171,4,69,10,2,0,3,0,2,359,112,27559,28460,25580,0,-80,-24,-2903,-1,-2573,4591,-2,0,-3,0,13
EUN1_3573082389',2,55,25,1,1,1,0,4,0,369,76,33790,31103,44022,2,35,9,0,0,1,0,6,296,60,24714,23501,32049,1,73,16,9076,16,7602,11973,1,1,0,0,-2
EUN1_3572824356',11,34,20,2,0,1,0,10,1,353,92,31460,31524,35625,3,30,13,0,1,0,0,6,342,76,27547,28843,29570,1,11,16,3913,7,2681,6055,2,-1,1,0,4
EUN1_3572786614',3,34,16,0,0,1,0,13,1,307,86,28030,29006,38588,7,25,15,1,0,2,0,6,338,77,29035,29159,40243,0,-31,9,-1005,1,-153,-1655,-1,0,-1,0,7
EUN1_3572765525',2,28,15,2,1,2,0,5,1,413,100,31552,31726,31664,5,43,6,0,0,0,0,9,363,80,23918,28941,23904,1,50,20,7634,9,2785,7760,2,1,2,0,-4
EUN1_3572730196',5,27,8,0,0,0,0,5,0,387,96,25714,29988,25814,4,30,12,2,0,1,0,4,336,76,27025,29772,32421,0,51,20,-1311,-4,216,-6607,-2,0,-1,0,1
EUN1_3575288575',3,78,13,0,0,2,0,6,1,392,88,29544,30601,29750,6,27,13,2,0,1,0,6,338,83,27181,29464,29384,1,54,5,2363,0,1137,366,-2,0,1,0,0
EUN1_3575127113',2,25,19,0,0,1,0,11,0,337,82,30265,29446,45869,3,30,13,2,0,1,0,5,326,83,28152,29069,37757,1,11,-1,2113,6,377,8112,-2,0,0,0,6
EUN1_3575110553',3,70,10,1,0,1,0,10,1,302,93,24584,27908,26564,4,24,6,1,0,1,0,0,379,86,25058,28399,23974,1,-77,7,-474,4,-491,2590,0,0,0,0,10
EUN1_3574934178',6,31,22,1,0,1,0,8,0,328,66,31522,30550,43127,5,37,8,0,0,1,0,6,315,102,24337,26885,31565,1,13,-36,7185,14,3665,11562,1,0,0,0,2
EUN1_3574255012',3,75,19,2,0,2,0,9,1,351,90,30203,32450,37016,2,23,10,0,0,0,0,4,328,74,25387,28570,30817,1,23,16,4816,9,3880,6199,2,0,2,0,5
EUN1_3574220322',4,140,12,1,0,0,0,9,0,332,74,25550,27810,27155,4,37,9,0,1,0,0,1,362,102,27342,30223,26000,0,-30,-28,-1792,3,-2413,1155,1,-1,0,0,8
EUN1_3574193065',1,24,13,1,0,1,0,7,1,374,90,29208,31701,34859,5,48,8,1,0,0,0,7,312,93,23978,28175,32759,1,62,-3,5230,5,3526,2100,0,0,1,0,0
EUN1_3574034716',4,28,10,1,1,0,0,3,0,363,74,26255,29989,27418,8,31,10,1,0,1,0,6,328,86,25211,28896,29368,0,35,-12,1044,0,1093,-1950,0,1,-1,0,-3
EUN1_3574027760',1,27,12,0,0,0,0,9,0,312,68,25602,28271,26978,4,26,9,2,0,0,0,1,346,84,26269,29595,33090,0,-34,-16,-667,3,-1324,-6112,-2,0,0,0,8
EUN1_3574016102',2,27,22,0,0,1,0,8,0,354,90,32471,32971,40011,1,19,13,1,0,1,0,10,300,91,25748,28990,33208,1,54,-1,6723,9,3981,6803,-1,0,0,0,-2
EUN1_3573672015',3,35,5,0,0,0,0,6,0,363,78,23733,27876,28210,2,103,12,2,0,0,0,4,365,93,26943,31650,27522,1,-2,-15,-3210,-7,-3774,688,-2,0,0,0,2
EUN1_3573658608',3,74,7,0,0,0,0,13,0,371,76,24718,29430,27458,5,26,13,2,1,1,0,1,365,124,29875,32094,30708,0,6,-48,-5157,-6,-2664,-3250,-2,-1,-1,0,12
EUN1_3573445583',4,33,17,1,0,0,0,5,1,342,95,28671,30998,33965,3,25,16,1,0,0,0,2,358,80,28235,30691,36081,0,-16,15,436,1,307,-2116,0,0,0,0,3
EUN1_3573418654',5,48,15,1,1,0,0,10,0,306,102,27883,31330,30905,3,36,7,1,0,1,0,3,376,106,26437,30384,28840,1,-70,-4,1446,8,946,2065,0,1,-1,0,7
EUN1_3573321771',1,24,6,0,0,0,0,11,0,363,90,24469,28137,30070,2,29,21,1,0,2,0,4,379,92,32144,32927,40626,0,-16,-2,-7675,-15,-4790,-10556,-1,0,-2,0,7
EUN1_3573298216',3,41,18,1,0,0,0,13,1,329,74,29257,28465,44024,1,26,15,1,0,1,0,4,339,89,29181,27753,31900,0,-10,-15,76,3,712,12124,0,0,-1,0,9
EUN1_3573271618',7,31,18,2,0,2,0,4,1,365,94,30418,30592,36607,2,27,8,0,0,0,0,9,301,93,23584,26486,25911,1,64,1,6834,10,4106,10696,2,0,2,0,-5
EUN1_3573203859',3,82,19,2,0,0,0,6,1,308,94,29177,29422,35333,4,77,15,0,0,1,0,4,325,72,27446,28038,43019,1,-17,22,1731,4,1384,-7686,2,0,-1,0,2
EUN1_3570822018',2,281,14,0,0,3,1,3,1,376,98,29884,31400,39894,0,21,10,2,0,1,0,10,347,84,25695,29441,32525,1,29,14,4189,4,1959,7369,-2,0,2,1,-7
EUN1_3570781012',1,196,17,2,0,0,0,7,1,320,74,26532,29328,34674,0,21,8,0,0,0,0,2,297,98,24324,27049,33028,1,23,-24,2208,9,2279,1646,2,0,0,0,5
EUN1_3570731995',1,24,15,1,0,0,0,9,1,345,80,28334,31720,40420,3,22,16,1,0,1,0,4,352,98,28603,31247,30954,0,-7,-18,-269,-1,473,9466,0,0,-1,0,5
EUN1_3564970788',3,25,15,0,0,1,0,5,0,379,66,28703,30909,34101,4,28,8,2,0,0,0,8,346,84,24381,27964,29703,1,33,-18,4322,7,2945,4398,-2,0,1,0,-3
EUN1_3564948167',5,22,14,1,0,0,0,8,0,367,109,29078,30975,28524,3,30,12,1,0,2,0,4,382,98,30241,30492,28033,1,-15,11,-1163,2,483,491,0,0,-2,0,4
EUN1_3564906685',5,28,9,1,0,1,0,12,1,327,76,26596,28218,20669,3,31,7,1,1,0,0,4,332,104,25240,27651,25688,1,-5,-28,1356,2,567,-5019,0,-1,1,0,8
EUN1_3564880706',2,29,9,0,1,1,0,7,0,363,101,28085,28814,22875,2,22,13,1,0,0,0,6,355,94,27307,30888,23976,0,8,7,778,-4,-2074,-1101,-1,1,1,0,1
EUN1_3564534652',5,28,23,0,0,2,0,5,1,331,80,31934,32741,41537,2,346,11,1,0,0,0,9,333,80,27020,29084,32038,1,-2,0,4914,12,3657,9499,-1,0,2,0,-4
EUN1_3576035038',2,31,10,1,1,0,0,6,0,373,72,25200,29606,28266,4,90,8,1,0,0,0,1,343,96,25253,30489,24970,1,30,-24,-53,2,-883,3296,0,1,0,0,5
EUN1_3576004995',1,23,8,0,0,0,0,11,0,334,74,24717,28528,23538,1,28,12,2,1,2,0,2,366,90,28399,30612,38058,0,-32,-16,-3682,-4,-2084,-14520,-2,-1,-2,0,9
EUN1_3575984247',0,23,13,1,0,0,0,7,1,319,88,26294,28165,36531,3,29,14,1,1,1,0,2,302,88,27917,28219,39751,1,17,0,-1623,-1,-54,-3220,0,-1,-1,0,5
EUN1_3575521434',3,23,10,0,0,1,0,4,1,368,84,27069,30081,29368,5,287,5,2,0,0,0,3,344,99,23143,28198,26856,1,24,-15,3926,5,1883,2512,-2,0,1,0,1
EUN1_3575501214',6,25,12,1,0,1,0,17,0,287,90,26354,27219,25710,4,27,19,1,0,3,0,2,382,102,33164,32848,35556,0,-95,-12,-6810,-7,-5629,-9846,0,0,-2,0,15
EUN1_3574964654',3,27,7,0,0,0,0,8,0,332,70,23130,28141,23289,0,43,10,1,0,1,0,2,388,62,27466,29239,31347,0,-56,8,-4336,-3,-1098,-8058,-1,0,-1,0,6
EUN1_3574947397',0,33,9,0,0,0,0,12,0,254,86,22837,25462,24952,4,28,23,1,0,3,0,3,320,92,31676,29886,42465,0,-66,-6,-8839,-14,-4424,-17513,-1,0,-3,0,9
EUN1_3574899090',4,193,13,1,0,0,0,5,1,356,100,28700,30524,27995,2,203,6,1,0,1,0,9,352,88,25152,29976,24841,0,4,12,3548,7,548,3154,0,0,-1,0,-4
EUN1_3574871488',1,21,14,2,0,1,0,11,1,337,98,29180,30274,34480,2,27,15,0,0,2,0,8,320,78,28269,29304,34861,1,17,20,911,-1,970,-381,2,0,-1,0,3
EUN1_3574378660',2,30,9,0,0,1,0,7,0,313,63,25717,25865,35072,4,27,24,2,0,2,0,5,329,88,32181,30582,47626,0,-16,-25,-6464,-15,-4717,-12554,-2,0,-1,0,2
EUN1_3573870813',2,22,8,2,0,0,0,8,1,334,78,23582,28014,23210,3,42,13,0,0,1,0,0,388,74,27298,31703,34087,0,-54,4,-3716,-5,-3689,-10877,2,0,-1,0,8
EUN1_3573845967',3,189,9,1,0,0,0,7,1,429,88,26650,32674,31453,4,27,4,1,0,2,0,5,373,96,25231,29679,20923,0,56,-8,1419,5,2995,10530,0,0,-2,0,2
EUN1_3573815083',6,39,12,1,0,0,0,13,0,327,98,26787,31163,29145,1,24,16,1,0,1,0,2,373,106,30600,32600,39643,0,-46,-8,-3813,-4,-1437,-10498,0,0,-1,0,11
EUN1_3573778875',6,22,12,0,0,2,0,7,1,360,72,29288,29587,36605,1,141,11,0,0,1,0,6,334,78,25754,28396,30715,1,26,-6,3534,1,1191,5890,0,0,1,0,1
EUN1_3571611869',5,475,10,1,0,2,0,5,0,381,96,28153,31031,31678,5,39,8,1,0,1,0,6,291,92,23459,26808,25350,1,90,4,4694,2,4223,6328,0,0,1,0,-1
EUN1_3567731749',6,36,14,2,0,0,0,10,1,349,80,26353,29482,29215,3,64,5,0,0,0,0,0,386,97,25213,29991,26835,0,-37,-17,1140,9,-509,2380,2,0,0,0,10
EUN1_3565850628',3,25,13,0,0,0,0,11,1,372,88,27472,31949,28887,3,22,9,1,0,2,0,3,350,80,26319,28822,25798,1,22,8,1153,4,3127,3089,-1,0,-2,0,8
EUN1_3565797513',5,30,20,1,0,1,0,16,1,278,64,28586,26533,36616,5,27,11,0,0,2,0,4,338,76,28748,30616,28981,1,-60,-12,-162,9,-4083,7635,1,0,-1,0,12
EUN1_3564456571',4,26,13,0,0,0,0,9,0,322,75,27140,29214,35839,4,31,16,1,0,0,0,4,317,79,27499,29494,34543,0,5,-4,-359,-3,-280,1296,-1,0,0,0,5
EUN1_3564423322',1,86,12,1,0,1,0,4,0,346,90,27721,30860,33478,5,25,13,0,0,0,0,6,327,74,27101,28573,34769,1,19,16,620,-1,2287,-1291,1,0,1,0,-2
EUN1_3563917886',2,33,6,0,0,0,0,5,0,381,79,23946,30118,18217,3,38,10,2,0,0,0,2,360,112,25993,31468,24617,0,21,-33,-2047,-4,-1350,-6400,-2,0,0,0,3
EUN1_3563481107',4,42,13,0,0,0,0,10,1,318,88,26812,29415,27273,5,26,14,1,0,2,0,1,329,100,29545,29754,36055,0,-11,-12,-2733,-1,-339,-8782,-1,0,-2,0,9
EUN1_3563456784',3,27,6,0,0,0,0,12,1,301,52,23361,25933,31796,4,32,28,2,1,3,0,1,413,108,37179,36399,49772,0,-112,-56,-13818,-22,-10466,-17976,-2,-1,-3,0,11
EUN1_3563170123',10,33,5,2,0,0,0,4,1,311,86,23224,25614,24633,0,24,10,0,0,0,0,1,363,82,25060,30418,27641,0,-52,4,-1836,-5,-4804,-3008,2,0,0,0,3
EUN1_3563145817',7,28,13,0,0,2,0,12,0,345,81,29583,28504,37535,4,28,18,2,0,2,0,6,343,86,29602,28393,35853,1,2,-5,-19,-5,111,1682,-2,0,0,0,6
EUN1_3563128906',4,26,12,2,0,0,0,5,1,350,91,26628,31795,27575,3,26,4,0,1,0,0,2,363,88,24471,29900,21736,1,-13,3,2157,8,1895,5839,2,-1,0,0,3
EUN1_3563121939',2,24,14,0,0,2,0,4,0,353,100,29362,32054,35781,2,86,6,1,0,0,0,6,339,84,23546,27554,27650,1,14,16,5816,8,4500,8131,-1,0,2,0,-2
EUN1_3563112049',3,87,3,1,0,0,0,8,1,306,68,20999,25660,28913,5,24,10,1,0,1,0,1,341,94,27035,29804,34031,0,-35,-26,-6036,-7,-4144,-5118,0,0,-1,0,7
EUN1_3562851919',4,47,20,2,0,0,0,11,1,291,76,29236,30407,42889,1,26,17,0,0,1,0,1,362,72,30556,29842,37722,1,-71,4,-1320,3,565,5167,2,0,-1,0,10
EUN1_3559915532',3,32,13,1,0,0,0,3,0,351,75,26898,29982,32820,4,25,9,0,0,0,0,2,343,98,25890,29512,25387,1,8,-23,1008,4,470,7433,1,0,0,0,1
EUN1_3559886166',4,31,8,0,1,1,0,11,0,339,82,25183,28154,22368,7,54,7,2,0,1,0,3,406,98,27088,29848,20562,1,-67,-16,-1905,1,-1694,1806,-2,1,0,0,8
EUN1_3559860210',2,31,10,1,0,0,0,8,1,318,82,26176,26683,25908,3,37,11,0,0,1,0,5,302,96,26124,29371,31023,0,16,-14,52,-1,-2688,-5115,1,0,-1,0,3
EUN1_3559832651',4,43,13,1,0,0,0,7,1,302,112,27477,32502,30082,1,29,2,0,0,0,0,5,365,76,22708,27114,22297,1,-63,36,4769,11,5388,7785,1,0,0,0,2
EUN1_3559699804',1,63,7,0,0,0,0,7,0,333,85,25188,28386,27375,8,44,10,0,0,2,0,5,322,85,26077,28807,34363,1,11,0,-889,-3,-421,-6988,0,0,-2,0,2
EUN1_3572855706',5,30,10,0,0,0,0,8,0,355,75,26774,30156,33869,3,90,10,1,0,0,0,3,341,100,25926,28519,30634,0,14,-25,848,0,1637,3235,-1,0,0,0,5
EUN1_3572854264',2,21,25,1,0,1,0,4,1,382,108,34698,32730,39930,9,32,5,0,0,1,0,7,247,72,20861,24100,34063,1,135,36,13837,20,8630,5867,1,0,0,0,-3
EUN1_3572813532',1,250,22,2,0,1,0,14,0,282,74,30289,29788,37786,1,18,16,0,0,2,0,3,342,94,30471,30420,36460,1,-60,-20,-182,6,-632,1326,2,0,-1,0,11
EUN1_3572657771',2,17,17,0,1,0,0,10,0,345,128,28914,33037,31138,5,18,13,2,0,1,0,3,355,96,28716,28871,32944,0,-10,32,198,4,4166,-1806,-2,1,-1,0,7
EUN1_3575965536',2,23,22,1,0,0,0,8,0,321,86,30068,31458,31052,6,33,15,1,0,1,0,3,331,72,28389,28284,33338,0,-10,14,1679,7,3174,-2286,0,0,-1,0,5
EUN1_3575873512',3,23,7,0,1,1,0,4,0,365,80,27103,28702,20825,2,31,15,2,0,1,0,5,377,78,29842,30564,34263,0,-12,2,-2739,-8,-1862,-13438,-2,1,0,0,-1
EUN1_3575844656',4,21,16,0,0,0,0,11,0,311,74,28186,28410,39735,2,24,24,1,0,2,0,0,366,74,33331,30346,43069,1,-55,0,-5145,-8,-1936,-3334,-1,0,-2,0,11
EUN1_3574631562',2,27,14,0,1,2,0,8,1,331,76,27981,27492,31945,2,35,16,2,0,1,0,6,314,79,27751,28639,36028,1,17,-3,230,-2,-1147,-4083,-2,1,1,0,2
EUN1_3574383734',6,48,7,1,0,0,0,15,0,343,66,23936,29143,25366,0,25,14,0,0,3,0,3,360,73,31136,29222,32437,0,-17,-7,-7200,-7,-79,-7071,1,0,-3,0,12
EUN1_3574148879',2,26,17,1,0,0,0,9,0,360,60,28205,30966,39980,2,26,9,1,0,0,0,2,348,80,25046,28530,32231,1,12,-20,3159,8,2436,7749,0,0,0,0,7
EUN1_3574129044',6,35,23,2,0,2,0,9,1,351,92,33734,30876,41890,1,27,15,0,0,1,0,7,295,76,26992,26605,28465,1,56,16,6742,8,4271,13425,2,0,1,0,2
EUN1_3574118928',0,20,12,0,0,0,0,15,1,223,24,23802,22979,21640,2,15,14,2,1,7,1,3,307,104,31648,29312,24046,0,-84,-80,-7846,-2,-6333,-2406,-2,-1,-7,-1,12
EUN1_3574117198',1,137,10,1,0,1,0,9,1,280,84,24263,26234,34204,2,32,17,1,0,1,0,3,300,84,29810,28104,35473,0,-20,0,-5547,-7,-1870,-1269,0,0,0,0,6
EUN1_3574110187',3,33,13,0,0,1,0,9,0,336,71,28684,26765,27364,6,28,8,1,0,1,0,11,340,105,24466,28188,22764,1,-4,-34,4218,5,-1423,4600,-1,0,0,0,-2
EUN1_3573867790',4,31,17,1,0,4,0,4,1,417,76,32582,30932,29912,4,131,8,0,0,0,0,5,274,64,23030,25111,22332,1,143,12,9552,9,5821,7580,1,0,4,0,-1
EUN1_3573842788',4,24,10,0,0,0,0,9,1,337,60,25040,27477,18462,6,36,19,2,1,2,0,4,339,90,30005,30183,30359,0,-2,-30,-4965,-9,-2706,-11897,-2,-1,-2,0,5
EUN1_3573818767',7,27,13,1,0,0,0,8,0,322,79,26892,28992,31877,2,25,11,0,0,1,0,4,380,84,28310,29931,34476,0,-58,-5,-1418,2,-939,-2599,1,0,-1,0,4
EUN1_3573664699',3,31,12,1,0,0,0,8,1,293,86,26122,27927,30987,3,24,11,1,0,1,0,2,336,74,26187,27480,35356,0,-43,12,-65,1,447,-4369,0,0,-1,0,6
EUN1_3573230305',3,24,12,2,0,1,0,6,1,412,96,30168,30520,30925,2,81,7,0,0,1,0,5,358,80,23535,27376,18948,1,54,16,6633,5,3144,11977,2,0,0,0,1
EUN1_3575937897',3,23,12,1,0,0,0,9,0,348,74,26390,29896,30161,4,24,11,1,0,0,0,1,369,80,27331,29006,25684,1,-21,-6,-941,1,890,4477,0,0,0,0,8
EUN1_3575917844',3,36,17,2,0,1,0,10,1,336,94,29702,27637,33758,9,108,16,0,1,0,0,4,314,82,27074,28804,31538,1,22,12,2628,1,-1167,2220,2,-1,1,0,6
EUN1_3575247068',3,17,9,1,0,1,0,8,0,324,96,25882,28907,35228,1,35,23,1,0,1,0,4,381,84,31006,31158,39794,0,-57,12,-5124,-14,-2251,-4566,0,0,0,0,4
EUN1_3574928008',5,27,18,0,0,0,0,5,1,318,82,28762,31711,38670,1,23,9,2,1,0,0,5,352,117,25932,29951,28027,0,-34,-35,2830,9,1760,10643,-2,-1,0,0,0
EUN1_3573601655',5,33,10,0,0,1,0,6,0,345,78,27086,28647,31532,8,30,13,1,0,1,0,5,352,68,27072,28833,33561,1,-7,10,14,-3,-186,-2029,-1,0,0,0,1
EUN1_3573042737',3,19,21,0,0,0,0,11,0,342,78,28832,29906,39662,1,24,11,1,0,1,0,3,332,78,27731,28369,31971,1,10,0,1101,10,1537,7691,-1,0,-1,0,8
EUN1_3568805167',3,28,14,1,0,1,0,7,0,376,82,28478,32257,32438,0,23,13,1,0,1,0,8,343,94,27622,29850,31484,0,33,-12,856,1,2407,954,0,0,0,0,-1
EUN1_3568753028',2,27,11,0,1,0,0,12,1,326,82,26285,27381,31329,3,92,13,2,0,1,0,1,328,90,27362,29762,31672,0,-2,-8,-1077,-2,-2381,-343,-2,1,-1,0,11
EUN1_3568502640',9,34,14,2,1,2,0,6,1,369,119,29846,31441,34006,5,26,8,0,0,0,0,8,316,75,23968,27946,33569,1,53,44,5878,6,3495,437,2,1,2,0,-2
EUN1_3568492512',0,40,20,1,0,2,0,16,0,300,82,31724,30639,41453,6,27,20,1,0,2,0,6,371,122,33304,31091,45672,0,-71,-40,-1580,0,-452,-4219,0,0,0,0,10
EUN1_3568344503',6,27,14,1,0,1,0,4,0,402,100,29579,31437,31258,2,24,8,1,0,0,0,6,390,92,26379,30031,22183,0,12,8,3200,6,1406,9075,0,0,1,0,-2
EUN1_3568314934',5,29,18,1,0,0,0,9,1,309,70,28850,27770,36777,3,36,16,1,0,0,0,1,298,72,27276,27887,35273,1,11,-2,1574,2,-117,1504,0,0,0,0,8
EUN1_3568094109',4,29,8,2,0,1,0,11,0,372,90,26191,29149,27393,2,26,11,0,0,1,0,6,363,102,28449,32477,30944,1,9,-12,-2258,-3,-3328,-3551,2,0,0,0,5
EUN1_3568072414',4,165,15,1,0,0,0,12,0,310,96,28592,28376,38615,11,55,18,1,0,1,0,3,330,80,30876,29888,44594,0,-20,16,-2284,-3,-1512,-5979,0,0,-1,0,9
EUN1_3568059321',2,45,11,1,0,1,0,4,1,348,78,28571,30108,34876,4,58,13,0,1,0,0,7,336,82,27201,29841,27315,1,12,-4,1370,-2,267,7561,1,-1,1,0,-3
EUN1_3567850528',1,18,17,1,0,0,0,14,1,354,76,30434,30712,35044,4,24,19,1,0,1,0,3,379,84,31990,31470,39659,0,-25,-8,-1556,-2,-758,-4615,0,0,-1,0,11
EUN1_3566719616',4,24,16,2,0,1,0,6,0,376,100,30364,31536,32087,7,30,12,0,0,0,0,5,361,75,27479,29615,32186,1,15,25,2885,4,1921,-99,2,0,1,0,1
EUN1_3570194254',1,24,14,2,0,4,0,6,1,420,124,33325,34343,36997,2,40,8,0,0,0,0,10,350,86,24626,28091,28831,1,70,38,8699,6,6252,8166,2,0,4,0,-4
EUN1_3564997586',3,23,15,0,1,0,0,5,0,379,96,28316,33161,33412,4,43,10,2,0,0,0,6,374,96,27068,31490,37786,0,5,0,1248,5,1671,-4374,-2,1,0,0,-1
EUN1_3564962566',2,37,14,2,0,0,0,2,0,340,102,27535,30388,38192,0,28,9,0,0,0,0,4,329,70,24847,26289,37228,1,11,32,2688,5,4099,964,2,0,0,0,-2
EUN1_3564559063',5,104,12,0,0,0,0,11,1,311,90,26459,27505,29724,5,57,12,2,0,1,0,2,355,79,28340,28834,31103,0,-44,11,-1881,0,-1329,-1379,-2,0,-1,0,9
EUN1_3562467271',3,21,22,2,0,2,0,7,1,353,66,33362,30793,42504,2,63,17,0,0,1,0,7,306,84,28475,27346,38065,1,47,-18,4887,5,3447,4439,2,0,1,0,0
EUN1_3573954651',4,26,15,0,0,0,0,9,0,340,86,28031,30045,29149,6,25,11,1,1,0,0,3,307,78,26074,26804,26901,1,33,8,1957,4,3241,2248,-1,-1,0,0,6
EUN1_3572561779',5,32,19,2,0,1,0,11,1,311,64,28991,29111,37622,1,92,19,0,0,1,0,4,311,76,31388,30366,35739,1,0,-12,-2397,0,-1255,1883,2,0,0,0,7
EUN1_3569135782',1,20,15,0,0,2,0,13,0,361,86,30408,30633,33652,4,28,18,2,0,1,0,4,347,92,29241,30301,40821,0,14,-6,1167,-3,332,-7169,-2,0,1,0,9
EUN1_3568153706',3,40,10,1,0,1,0,12,0,357,82,27991,29208,28749,1,25,14,0,0,1,0,7,377,74,28192,29761,26339,0,-20,8,-201,-4,-553,2410,1,0,0,0,5
EUN1_3568117521',5,24,16,1,0,0,0,8,0,357,66,29522,31234,39012,2,20,13,0,0,0,0,4,330,98,27514,29900,35010,0,27,-32,2008,3,1334,4002,1,0,0,0,4
EUN1_3567702415',0,22,11,2,0,1,0,9,1,311,110,27430,30101,33230,4,32,13,0,0,2,0,5,311,74,24814,27325,27758,0,0,36,2616,-2,2776,5472,2,0,-1,0,4
EUN1_3567193977',7,27,11,2,0,1,0,13,0,347,94,26390,29161,31953,4,243,11,0,0,2,0,2,324,78,27624,28050,34651,1,23,16,-1234,0,1111,-2698,2,0,-1,0,11
EUN1_3567151912',4,129,11,0,0,0,0,5,0,317,82,25039,28927,30953,1,40,12,2,0,0,0,1,362,114,27203,32740,32697,0,-45,-32,-2164,-1,-3813,-1744,-2,0,0,0,4
EUN1_3565715630',5,68,5,1,0,0,0,7,1,358,78,23276,27043,32183,2,21,18,1,1,2,0,1,364,80,31522,33037,36764,0,-6,-2,-8246,-13,-5994,-4581,0,-1,-2,0,6
EUN1_3565352065',5,81,18,2,0,0,0,11,1,305,80,29753,29217,38123,4,32,9,0,0,2,0,3,343,80,27092,28602,35366,0,-38,0,2661,9,615,2757,2,0,-2,0,8
EUN1_3565345405',2,27,3,0,0,0,0,12,0,276,76,20869,23852,21262,4,20,30,2,0,3,0,2,325,108,35856,32536,43742,0,-49,-32,-14987,-27,-8684,-22480,-2,0,-3,0,10
EUN1_3564980160',2,238,19,1,0,1,0,7,0,342,72,30209,30287,47629,4,23,19,0,0,0,0,6,326,76,29035,30378,42218,1,16,-4,1174,0,-91,5411,1,0,1,0,1
EUN1_3564831928',5,31,8,0,0,1,0,8,1,322,75,25297,26426,26669,4,281,11,2,0,0,0,2,361,91,26556,30208,32341,0,-39,-16,-1259,-3,-3782,-5672,-2,0,1,0,6
EUN1_3564467873',5,27,12,0,0,1,0,8,0,387,86,28260,30751,29286,5,21,11,2,0,0,0,4,335,87,27861,30323,26977,0,52,-1,399,1,428,2309,-2,0,1,0,4
EUN1_3561393987',3,26,8,0,0,0,0,11,0,324,76,23993,28972,29501,2,22,17,2,0,2,0,2,346,96,30954,31220,36743,0,-22,-20,-6961,-9,-2248,-7242,-2,0,-2,0,9
EUN1_3567556170',6,30,14,2,0,1,0,5,1,359,74,26615,29186,33938,2,26,7,0,0,0,0,4,287,73,22746,24295,23450,1,72,1,3869,7,4891,10488,2,0,1,0,1
EUN1_3562438555',5,36,8,0,0,0,0,11,0,324,91,24272,28040,29082,3,20,11,2,0,0,0,1,333,94,26106,30358,29075,0,-9,-3,-1834,-3,-2318,7,-2,0,0,0,10
EUN1_3558338723',4,28,9,0,0,0,0,6,1,344,97,27456,29834,34211,4,91,16,2,0,1,0,6,333,86,27817,29515,39720,0,11,11,-361,-7,319,-5509,-2,0,-1,0,0
EUN1_3558303067',6,166,20,1,0,4,0,13,1,370,99,33571,32171,39927,3,95,6,1,0,1,0,7,289,86,23539,25609,26360,1,81,13,10032,14,6562,13567,0,0,3,0,6
EUN1_3558273023',4,27,10,0,0,0,0,10,0,340,62,25361,26985,29901,2,95,11,1,0,0,0,2,342,81,27072,29349,29722,0,-2,-19,-1711,-1,-2364,179,-1,0,0,0,8
EUN1_3557368814',2,29,7,0,0,0,0,9,0,349,92,24911,27383,29020,4,101,14,2,0,0,0,2,321,80,26862,29537,32584,0,28,12,-1951,-7,-2154,-3564,-2,0,0,0,7
EUN1_3557170541',1,22,14,1,0,1,0,5,0,344,100,28294,30521,32815,5,29,11,1,0,0,0,2,352,107,26624,30762,33828,1,-8,-7,1670,3,-241,-1013,0,0,1,0,3
EUN1_3556864559',4,36,12,2,0,1,0,11,1,385,88,28338,29984,33061,0,154,11,0,1,0,0,2,317,83,26715,28631,35198,0,68,5,1623,1,1353,-2137,2,-1,1,0,9
EUN1_3573454177',3,23,11,1,0,1,0,8,1,367,76,27052,29230,27302,2,22,9,0,0,0,0,3,353,92,26376,29266,27317,1,14,-16,676,2,-36,-15,1,0,1,0,5
EUN1_3567120870',4,25,10,0,0,0,0,6,1,292,100,25669,27906,28225,4,29,10,2,1,0,0,1,347,100,26085,28755,33674,0,-55,0,-416,0,-849,-5449,-2,-1,0,0,5
EUN1_3563191943',6,25,15,0,0,0,0,6,0,345,75,27661,29511,36186,2,92,15,1,0,0,0,1,378,100,28179,31953,35072,1,-33,-25,-518,0,-2442,1114,-1,0,0,0,5
EUN1_3561342129',1,61,14,0,0,0,0,10,0,362,70,28100,29774,37292,5,32,12,2,0,1,0,2,336,83,27291,29870,33775,0,26,-13,809,2,-96,3517,-2,0,-1,0,8
EUN1_3561312894',3,33,11,0,0,0,0,8,0,309,86,26766,27035,36474,0,14,24,2,0,2,0,6,352,78,32638,31419,42922,0,-43,8,-5872,-13,-4384,-6448,-2,0,-2,0,2
EUN1_3561002259',6,27,20,2,0,1,0,5,1,337,71,29234,29335,37187,1,22,12,0,0,0,0,3,320,64,26404,27074,37965,1,17,7,2830,8,2261,-778,2,0,1,0,2
EUN1_3557086043',4,31,11,1,0,0,0,8,0,357,81,26052,29269,26282,4,29,10,0,0,1,0,3,370,94,27972,30677,28928,1,-13,-13,-1920,1,-1408,-2646,1,0,-1,0,5
EUN1_3575928742',5,28,9,2,0,0,0,6,0,347,100,25690,29078,26794,2,65,11,0,0,2,0,4,367,96,28339,29999,26853,1,-20,4,-2649,-2,-921,-59,2,0,-2,0,2
EUN1_3575914278',13,61,9,1,0,0,0,8,0,302,102,23988,26823,30593,5,25,16,1,0,0,0,1,391,97,29575,30257,37931,0,-89,5,-5587,-7,-3434,-7338,0,0,0,0,7
EUN1_3575879630',2,29,13,1,0,1,0,14,1,351,72,27533,29017,32670,4,317,19,1,0,3,0,6,307,101,32541,29788,37820,0,44,-29,-5008,-6,-771,-5150,0,0,-2,0,8
EUN1_3575072127',5,33,16,1,0,2,0,9,1,362,102,30173,29974,36765,1,24,8,0,0,0,0,8,285,78,23787,28761,23389,1,77,24,6386,8,1213,13376,1,0,2,0,1
EUN1_3575050541',5,32,9,1,0,0,0,9,1,369,80,25713,28076,24883,3,28,11,1,0,0,0,2,373,76,26293,28387,27802,0,-4,4,-580,-2,-311,-2919,0,0,0,0,7
EUN1_3574360995',6,32,15,1,0,0,0,3,1,359,78,27683,29864,31660,5,27,15,1,0,0,0,0,361,98,29119,30763,31307,0,-2,-20,-1436,0,-899,353,0,0,0,0,3
EUN1_3574344320',2,29,11,1,0,0,0,17,0,354,78,25810,29231,33050,5,35,13,1,0,2,0,1,365,77,29083,28527,39309,0,-11,1,-3273,-2,704,-6259,0,0,-2,0,16
EUN1_3574308638',5,39,11,0,0,1,0,7,1,414,91,28589,31336,36878,3,24,9,0,0,0,0,6,307,76,24652,28895,24277,1,107,15,3937,2,2441,12601,0,0,1,0,1
EUN1_3574290568',4,25,16,2,0,0,0,6,1,367,88,29851,31180,35433,1,21,11,0,0,2,0,6,324,104,28660,29377,27367,1,43,-16,1191,5,1803,8066,2,0,-2,0,0
EUN1_3574271102',2,34,6,1,0,0,0,8,0,371,86,23917,29209,28386,6,111,13,1,0,0,0,2,337,93,26154,30247,33615,1,34,-7,-2237,-7,-1038,-5229,0,0,0,0,6
EUN1_3574252886',5,39,7,2,0,0,0,13,0,301,64,22185,25458,24948,5,26,20,0,0,1,0,3,370,118,32295,31839,45541,0,-69,-54,-10110,-13,-6381,-20593,2,0,-1,0,10
EUN1_3572893170',5,26,10,0,0,0,0,10,0,293,74,24402,26073,31775,4,150,17,2,0,1,0,4,381,94,30800,31908,43132,0,-88,-20,-6398,-7,-5835,-11357,-2,0,-1,0,6
EUN1_3574116461',5,30,15,1,0,0,0,11,0,345,86,28224,30687,33419,0,24,12,1,0,1,0,4,355,82,27236,28272,32210,1,-10,4,988,3,2415,1209,0,0,-1,0,7
EUN1_3574098061',4,25,5,1,0,1,0,9,0,332,105,24432,28949,24366,6,28,14,1,0,1,0,7,361,96,27895,31007,30471,0,-29,9,-3463,-9,-2058,-6105,0,0,0,0,2
EUN1_3573767158',1,25,10,0,0,0,0,6,1,332,84,26041,27624,36449,9,33,20,2,0,1,0,2,314,88,29887,29699,36594,0,18,-4,-3846,-10,-2075,-145,-2,0,-1,0,4
EUN1_3573075632',8,210,6,1,1,0,0,7,0,384,65,24453,28220,26401,4,31,4,0,0,1,0,5,378,100,24599,29194,23599,0,6,-35,-146,2,-974,2802,1,1,-1,0,2
EUN1_3573058421',5,35,12,1,0,1,0,9,1,371,104,27160,30368,30484,4,24,6,0,0,1,0,5,362,95,24998,31339,23028,1,9,9,2162,6,-971,7456,1,0,0,0,4
EUN1_3571966296',4,29,13,2,0,0,0,3,0,340,88,25784,29572,38292,1,23,11,0,0,0,0,0,365,99,25965,31792,33556,1,-25,-11,-181,2,-2220,4736,2,0,0,0,3
EUN1_3575945927',2,44,22,2,0,1,0,12,0,367,100,31200,32511,39534,0,22,7,0,0,1,0,2,359,88,26692,28140,26956,1,8,12,4508,15,4371,12578,2,0,0,0,10
EUN1_3575906142',5,32,17,2,0,3,0,7,1,363,106,32197,32954,37834,3,22,11,0,0,0,0,6,322,66,24592,27809,33355,1,41,40,7605,6,5145,4479,2,0,3,0,1
EUN1_3575880190',5,29,14,1,0,1,0,7,1,309,100,26929,29480,29826,3,29,17,0,0,0,0,3,356,80,29959,30947,37729,1,-47,20,-3030,-3,-1467,-7903,1,0,1,0,4
EUN1_3575855746',4,32,20,1,0,3,0,11,0,391,92,32485,32484,43260,3,27,12,0,0,2,0,7,336,84,28379,28848,48658,1,55,8,4106,8,3636,-5398,1,0,1,0,4
EUN1_3575834768',6,23,11,1,0,0,0,7,0,351,74,24977,29431,31646,4,25,11,1,0,1,0,3,353,90,27140,30533,35302,0,-2,-16,-2163,0,-1102,-3656,0,0,-1,0,4
EUN1_3575817968',3,24,13,1,0,1,0,8,1,325,82,27403,28184,35852,5,28,11,0,0,1,0,6,316,78,25764,26573,35016,1,9,4,1639,2,1611,836,1,0,0,0,2
EUN1_3574962864',4,21,16,2,0,0,0,4,0,405,96,30317,32716,33515,3,26,8,0,0,0,0,5,346,83,25523,28383,25512,0,59,13,4794,8,4333,8003,2,0,0,0,-1
EUN1_3571889275',5,29,11,1,0,0,0,7,1,322,88,25463,28932,30749,7,29,9,0,0,0,0,2,293,92,24109,29634,32849,1,29,-4,1354,2,-702,-2100,1,0,0,0,5
EUN1_3571388410',3,25,15,2,0,0,0,13,1,376,88,28541,30031,31549,5,131,8,0,0,1,0,4,307,76,23652,24519,27396,1,69,12,4889,7,5512,4153,2,0,-1,0,9
EUN1_3571368665',3,237,13,0,1,1,0,9,1,319,86,27348,28853,31995,3,28,16,2,0,1,0,3,356,106,30393,30838,30865,1,-37,-20,-3045,-3,-1985,1130,-2,1,0,0,6
EUN1_3571344608',5,33,14,0,0,1,0,8,1,309,100,27327,28999,33288,4,29,12,1,1,1,0,4,299,80,26634,27854,29929,1,10,20,693,2,1145,3359,-1,-1,0,0,4
EUN1_3571321431',4,32,10,0,0,0,0,7,1,350,111,26317,29354,31723,4,35,10,1,0,0,0,2,351,92,26734,30279,29799,1,-1,19,-417,0,-925,1924,-1,0,0,0,5
EUN1_3571320097',7,33,27,1,1,3,0,7,0,381,90,33584,33945,43524,3,26,9,1,0,0,0,5,316,84,25052,27629,31517,1,65,6,8532,18,6316,12007,0,1,3,0,2
EUN1_3567465076',6,29,15,1,0,2,0,10,1,359,80,29695,30455,29686,2,29,10,0,0,0,0,6,324,102,26718,29474,24032,1,35,-22,2977,5,981,5654,1,0,2,0,4
EUN1_3567434401',5,26,9,2,0,0,0,6,0,374,102,27496,30363,33690,5,38,13,0,0,0,0,3,340,74,26437,29819,31401,0,34,28,1059,-4,544,2289,2,0,0,0,3
EUN1_3566855276',3,55,18,0,0,0,0,7,0,288,86,27748,29231,32560,5,29,11,1,0,1,0,2,336,86,27397,27840,35811,1,-48,0,351,7,1391,-3251,-1,0,-1,0,5
EUN1_3566817992',2,120,20,0,0,1,0,10,1,346,78,30960,30207,40086,3,43,14,1,0,0,0,6,279,86,27159,28002,34456,1,67,-8,3801,6,2205,5630,-1,0,1,0,4
EUN1_3565298962',3,25,14,1,0,1,0,6,0,404,90,28133,32872,31318,2,24,2,0,0,0,0,3,355,94,22758,27828,21478,1,49,-4,5375,12,5044,9840,1,0,1,0,3
EUN1_3565287735',5,21,10,0,0,0,0,12,1,336,105,27487,29404,33079,5,222,20,1,0,2,0,6,356,58,32179,30394,32833,0,-20,47,-4692,-10,-990,246,-1,0,-2,0,6
EUN1_3576075706',5,29,20,0,0,0,0,7,0,350,59,29753,30908,37104,2,21,15,1,0,1,0,4,319,83,29210,28800,34309,0,31,-24,543,5,2108,2795,-1,0,-1,0,3
EUN1_3576045980',3,30,5,0,0,0,0,7,0,323,96,22528,28335,26902,5,28,9,1,0,0,0,0,388,74,24974,30234,32376,0,-65,22,-2446,-4,-1899,-5474,-1,0,0,0,7
EUN1_3576024714',1,23,10,1,0,1,0,8,1,436,100,28660,30741,34735,0,23,11,1,0,0,0,5,330,124,26465,32008,25902,1,106,-24,2195,-1,-1267,8833,0,0,1,0,3
EUN1_3575238958',1,18,14,2,0,0,0,5,1,349,100,27682,31294,33619,2,33,9,0,0,0,0,3,371,96,25499,31498,24993,1,-22,4,2183,5,-204,8626,2,0,0,0,2
EUN1_3575227510',1,20,10,1,0,0,0,7,1,365,106,26684,30136,36964,3,51,11,1,0,0,0,1,380,82,26143,30590,30663,0,-15,24,541,-1,-454,6301,0,0,0,0,6
EUN1_3574384081',3,30,13,2,0,0,0,14,0,372,76,27560,31775,31383,7,28,16,0,1,2,0,2,367,88,29854,30633,37524,0,5,-12,-2294,-3,1142,-6141,2,-1,-2,0,12
EUN1_3573811429',5,142,13,1,0,0,0,7,0,299,64,24556,26375,32524,7,30,14,1,0,1,0,1,315,108,28030,28614,35282,0,-16,-44,-3474,-1,-2239,-2758,0,0,-1,0,6
EUN1_3573793087',4,27,18,1,0,1,0,5,1,382,88,29724,31752,39057,5,109,9,1,0,0,0,6,327,88,26376,28436,30156,0,55,0,3348,9,3316,8901,0,0,1,0,-1
EUN1_3573364851',4,272,11,1,0,0,0,9,0,346,84,27701,29113,29473,5,29,13,0,0,1,0,4,326,87,26430,29619,35245,1,20,-3,1271,-2,-506,-5772,1,0,-1,0,5
EUN1_3573160608',4,29,15,2,0,1,0,11,1,352,103,28114,31681,33911,5,27,12,0,0,0,0,3,337,80,26811,31437,30428,0,15,23,1303,3,244,3483,2,0,1,0,8
EUN1_3573141700',1,22,13,0,0,0,0,15,0,313,88,25948,27400,26741,0,27,22,2,0,2,0,2,345,103,33630,33025,43210,0,-32,-15,-7682,-9,-5625,-16469,-2,0,-2,0,13
EUN1_3573080828',4,33,11,1,0,1,0,10,0,356,94,27958,30279,27328,3,25,10,0,0,1,0,5,357,98,27788,28910,28243,1,-1,-4,170,1,1369,-915,1,0,0,0,5
EUN1_3573070498',6,27,18,2,0,2,0,8,1,311,80,29250,29121,33049,2,20,13,0,0,0,0,5,353,99,26819,28776,33343,1,-42,-19,2431,5,345,-294,2,0,2,0,3
EUN1_3573059236',1,22,8,0,0,0,0,9,0,275,82,22756,26306,20131,3,25,14,2,0,1,0,1,358,106,28600,30050,36713,0,-83,-24,-5844,-6,-3744,-16582,-2,0,-1,0,8
EUN1_3572768874',0,24,17,1,0,1,0,16,1,346,82,29124,31862,34787,5,24,16,1,0,4,0,2,401,90,32414,32762,38913,0,-55,-8,-3290,1,-900,-4126,0,0,-3,0,14
EUN1_3572739927',7,32,17,2,0,0,0,13,1,327,82,27327,28407,36986,6,91,14,0,0,1,0,3,325,94,29963,31531,32822,1,2,-12,-2636,3,-3124,4164,2,0,-1,0,10
EUN1_3572721227',4,30,25,2,0,1,0,9,1,358,102,32762,32379,44903,1,27,9,0,0,2,0,7,311,69,25644,26834,31402,1,47,33,7118,16,5545,13501,2,0,-1,0,2
EUN1_3572694424',2,25,6,1,0,0,0,6,1,334,93,23514,27934,25391,2,140,15,1,0,1,0,1,402,86,29061,32827,36746,0,-68,7,-5547,-9,-4893,-11355,0,0,-1,0,5
EUN1_3572662704',5,30,11,1,0,0,0,5,1,324,88,26456,26760,25121,3,25,8,0,1,1,0,3,360,84,25931,29167,24611,0,-36,4,525,3,-2407,510,1,-1,-1,0,2
EUN1_3572651236',2,147,9,0,0,1,0,13,0,327,93,26745,30017,29292,2,25,11,1,0,2,0,2,389,105,28983,29687,30000,0,-62,-12,-2238,-2,330,-708,-1,0,-1,0,11
EUN1_3575373948',5,34,12,1,0,0,0,8,0,394,86,25674,33538,34270,2,31,7,0,0,1,0,0,406,85,26833,31654,25851,1,-12,1,-1159,5,1884,8419,1,0,-1,0,8
EUN1_3572117102',4,107,6,0,0,0,0,3,0,386,76,24268,30371,24187,4,28,5,1,0,0,0,1,354,110,24359,29313,27989,1,32,-34,-91,1,1058,-3802,-1,0,0,0,2
EUN1_3571541033',5,35,18,0,0,2,0,12,0,336,85,30518,31167,42563,2,25,18,1,0,1,0,7,306,82,29090,29927,36301,1,30,3,1428,0,1240,6262,-1,0,1,0,5
EUN1_3570871516',1,26,14,1,0,1,0,7,1,334,72,27270,28395,35616,4,24,11,0,0,0,0,2,337,76,25994,29442,31734,1,-3,-4,1276,3,-1047,3882,1,0,1,0,5
EUN1_3567674942',3,30,21,1,0,1,0,7,1,431,88,32440,33813,37538,2,25,7,0,0,0,0,9,340,86,25136,28999,29791,1,91,2,7304,14,4814,7747,1,0,1,0,-2
EUN1_3567649672',4,74,10,1,0,0,0,8,0,332,95,27025,26827,29464,3,22,13,1,1,1,0,5,337,88,26781,28920,33835,0,-5,7,244,-3,-2093,-4371,0,-1,-1,0,3
EUN1_3567636598',4,44,12,0,0,0,0,14,0,368,88,28447,30393,34468,4,24,12,2,0,2,0,4,346,83,28266,30255,24225,1,22,5,181,0,138,10243,-2,0,-2,0,10
EUN1_3569527194',3,23,15,0,0,0,0,6,1,375,84,28330,28142,35429,4,27,17,1,0,0,0,5,303,63,28209,28977,35476,0,72,21,121,-2,-835,-47,-1,0,0,0,1
EUN1_3569299282',1,25,8,0,0,0,0,12,0,333,99,25263,28918,25760,6,28,18,2,0,1,0,2,342,87,30095,32169,40048,1,-9,12,-4832,-10,-3251,-14288,-2,0,-1,0,10
EUN1_3568486937',5,23,14,0,0,1,0,11,0,305,90,30128,28663,35975,2,21,21,2,0,2,0,4,329,82,29764,31218,37511,1,-24,8,364,-7,-2555,-1536,-2,0,-1,0,7
EUN1_3566902467',2,20,12,0,0,2,0,14,0,337,94,28719,30281,30864,0,31,19,2,0,2,0,4,347,98,31552,32458,39127,0,-10,-4,-2833,-7,-2177,-8263,-2,0,0,0,10
EUN1_3565615549',5,26,12,1,0,0,0,7,1,352,88,27369,28422,35168,6,28,17,1,0,1,0,1,354,76,29070,30635,33994,0,-2,12,-1701,-5,-2213,1174,0,0,-1,0,6
EUN1_3564316373',2,26,17,1,0,1,0,15,0,324,76,29737,28778,30145,7,32,20,0,0,2,0,4,393,76,31648,32780,38146,1,-69,0,-1911,-3,-4002,-8001,1,0,-1,0,11
EUN1_3560790703',2,22,15,0,0,0,0,8,1,351,81,29525,28446,31320,5,90,16,1,0,1,0,4,320,66,29197,28483,33530,0,31,15,328,-1,-37,-2210,-1,0,-1,0,4
EUN1_3560580808',3,25,12,1,0,2,0,8,1,361,86,28805,29605,34101,5,26,13,1,0,0,0,9,360,90,28144,31528,31959,0,1,-4,661,-1,-1923,2142,0,0,2,0,-1
EUN1_3560489423',3,23,23,2,0,1,0,7,1,332,112,31310,33193,39544,1,22,12,0,0,0,0,3,343,84,26748,27492,28571,1,-11,28,4562,11,5701,10973,2,0,1,0,4
EUN1_3559646486',6,49,22,2,0,1,0,7,1,382,116,33391,33955,40899,3,19,7,0,0,1,0,7,302,70,23654,25699,21843,1,80,46,9737,15,8256,19056,2,0,0,0,0
EUN1_3558531139',2,25,19,0,0,2,0,9,1,365,108,33656,33406,42329,3,20,10,2,0,1,0,10,312,100,26487,28322,27981,1,53,8,7169,9,5084,14348,-2,0,1,0,-1
EUN1_3558233190',2,26,11,0,0,0,0,5,0,371,86,26045,31054,23250,8,33,9,2,0,0,0,3,351,86,24904,30823,26325,0,20,0,1141,2,231,-3075,-2,0,0,0,2
EUN1_3558203182',1,28,12,2,0,0,0,10,0,355,86,27105,29614,34397,5,36,10,0,0,0,0,3,322,90,25507,28673,34811,0,33,-4,1598,2,941,-414,2,0,0,0,7
EUN1_3557887456',4,23,14,1,0,1,0,9,0,402,72,29041,31138,31666,5,28,6,0,0,0,0,8,361,104,25510,29254,24591,0,41,-32,3531,8,1884,7075,1,0,1,0,1
EUN1_3557855390',5,32,14,1,0,0,0,8,0,290,82,28125,28664,33923,2,21,18,1,0,1,0,5,351,84,32437,32069,46658,0,-61,-2,-4312,-4,-3405,-12735,0,0,-1,0,3
EUN1_3557564506',1,18,11,0,0,0,0,11,0,343,87,27088,29723,29537,3,26,16,2,1,1,0,2,360,88,30165,29798,36714,1,-17,-1,-3077,-5,-75,-7177,-2,-1,-1,0,9
EUN1_3557534759',3,77,13,1,1,1,0,10,0,334,116,29275,30625,33266,5,27,11,1,0,0,0,5,319,84,25918,27700,32124,1,15,32,3357,2,2925,1142,0,1,1,0,5
EUN1_3576227134',6,35,12,0,0,0,0,10,0,286,88,26163,26554,32179,5,25,19,2,0,0,0,2,354,80,30339,29628,34675,0,-68,8,-4176,-7,-3074,-2496,-2,0,0,0,8
EUN1_3576121262',4,22,9,0,0,0,0,10,0,359,88,25676,28890,31330,5,23,17,2,0,1,0,6,332,100,29357,30298,35850,0,27,-12,-3681,-8,-1408,-4520,-2,0,-1,0,4
EUN1_3575918061',5,32,8,0,0,0,0,10,0,373,90,26202,30749,26735,1,153,8,2,0,1,0,0,384,100,26444,30064,31292,1,-11,-10,-242,0,685,-4557,-2,0,-1,0,10
EUN1_3575168430',7,30,8,1,1,0,0,7,0,367,92,25535,30403,22234,6,24,7,1,0,1,0,2,393,120,27284,31043,24823,0,-26,-28,-1749,1,-640,-2589,0,1,-1,0,5
EUN1_3572541485',8,33,20,2,0,0,0,12,1,384,92,30722,31376,39429,3,41,13,0,0,1,0,5,353,60,25625,26806,32203,1,31,32,5097,7,4570,7226,2,0,-1,0,7
EUN1_3572526592',1,25,10,0,1,0,0,8,1,324,104,25368,31542,25260,3,36,7,2,0,0,0,5,374,84,25156,30471,31738,0,-50,20,212,3,1071,-6478,-2,1,0,0,3
EUN1_3571987235',6,31,18,0,1,1,0,9,1,329,60,30802,28985,41511,5,45,10,1,0,2,0,6,317,78,25407,26101,34815,0,12,-18,5395,8,2884,6696,-1,1,-1,0,3
EUN1_3571943931',4,26,6,0,0,1,0,3,0,343,68,24333,27090,30283,6,37,13,2,0,0,0,4,345,100,26455,29016,32435,1,-2,-32,-2122,-7,-1926,-2152,-2,0,1,0,-1
EUN1_3571929176',4,28,5,1,0,0,0,10,0,365,98,24338,27837,29466,4,30,12,1,0,2,0,3,386,74,27851,29499,32397,0,-21,24,-3513,-7,-1662,-2931,0,0,-2,0,7
EUN1_3571900011',1,26,16,0,0,0,0,7,0,279,82,26985,28135,33783,2,20,15,2,1,0,0,5,307,101,27369,28542,40515,1,-28,-19,-384,1,-407,-6732,-2,-1,0,0,2
EUN1_3571893678',5,30,9,0,0,0,0,5,0,386,89,25988,30594,33748,3,45,9,2,0,1,0,2,374,84,26574,29616,33905,0,12,5,-586,0,978,-157,-2,0,-1,0,3
EUN1_3571886599',3,28,22,1,0,1,0,7,1,356,121,33865,32552,39194,4,21,16,1,0,0,0,6,375,73,29254,30676,38294,1,-19,48,4611,6,1876,900,0,0,1,0,1
EUN1_3571726270',4,50,18,1,0,1,0,8,0,318,72,28796,28193,38819,8,24,19,1,1,1,0,5,275,80,30377,28843,38242,0,43,-8,-1581,-1,-650,577,0,-1,0,0,3
EUN1_3571542027',3,25,24,1,1,0,0,11,1,359,84,32462,30515,39448,3,23,10,0,0,0,0,5,352,88,27532,29151,28843,1,7,-4,4930,14,1364,10605,1,1,0,0,6
EUN1_3570750283',4,24,19,0,1,1,0,4,1,381,114,32197,33787,31590,3,31,12,2,0,0,0,6,347,76,27066,28978,34346,1,34,38,5131,7,4809,-2756,-2,1,1,0,-2
EUN1_3570544974',4,28,11,2,0,1,0,11,0,359,106,27454,30267,31308,3,20,10,0,0,2,0,3,336,70,27005,28519,31234,1,23,36,449,1,1748,74,2,0,-1,0,8
EUN1_3570544584',6,26,7,1,0,0,0,7,1,351,80,24792,29644,28601,3,36,13,1,1,0,0,4,367,123,28341,32149,32387,0,-16,-43,-3549,-6,-2505,-3786,0,-1,0,0,3
EUN1_3570530741',4,130,13,1,1,2,0,14,0,391,91,30546,31542,36813,0,133,13,0,0,1,0,3,339,104,28445,31714,25925,1,52,-13,2101,0,-172,10888,1,1,1,0,11
EUN1_3570522452',1,20,13,1,0,1,0,10,0,387,98,28598,33248,34014,3,27,7,1,0,1,0,4,368,69,25406,28968,35500,1,19,29,3192,6,4280,-1486,0,0,0,0,6
EUN1_3570506683',0,21,16,0,1,0,0,11,1,364,96,28999,29732,37912,1,24,10,2,0,1,0,6,340,88,26902,28248,28162,1,24,8,2097,6,1484,9750,-2,1,-1,0,5
EUN1_3570500170',1,34,11,2,0,0,0,14,0,271,64,24887,25427,25452,4,27,21,0,0,3,0,1,377,92,32971,32501,37290,0,-106,-28,-8084,-10,-7074,-11838,2,0,-3,0,13
EUN1_3570462327',4,30,17,1,0,1,0,7,1,353,88,29677,31646,38160,2,33,9,0,0,0,0,5,362,88,24814,28411,26046,0,-9,0,4863,8,3235,12114,1,0,1,0,2
EUN1_3570432841',3,38,14,2,0,1,0,9,1,342,74,27762,29549,28401,4,24,8,0,0,0,0,5,323,108,24726,28439,25377,1,19,-34,3036,6,1110,3024,2,0,1,0,4
EUN1_3570413100',1,13,13,0,1,1,0,6,1,369,98,28074,29953,37421,2,26,11,2,0,1,0,5,327,108,25705,30282,38162,1,42,-10,2369,2,-329,-741,-2,1,0,0,1
EUN1_3570375519',5,30,10,0,0,0,0,8,0,321,76,23664,25876,34677,1,21,11,2,0,1,0,1,312,105,26794,28720,35294,0,9,-29,-3130,-1,-2844,-617,-2,0,-1,0,7
EUN1_3570337970',7,71,8,2,0,1,0,4,1,365,110,25966,30532,26792,2,28,6,0,0,0,0,5,338,89,23117,29302,19286,1,27,21,2849,2,1230,7506,2,0,1,0,-1
EUN1_3570303317',3,186,18,1,0,2,0,7,1,377,74,30506,30913,39194,4,27,14,0,0,0,0,8,309,91,28642,29726,39239,0,68,-17,1864,4,1187,-45,1,0,2,0,-1
EUN1_3570268045',4,25,9,0,0,0,0,8,0,348,84,25269,29444,28591,5,28,15,2,0,0,0,1,373,112,28627,32806,41196,0,-25,-28,-3358,-6,-3362,-12605,-2,0,0,0,7
EUN1_3570240053',5,29,13,1,0,1,0,7,0,338,94,27393,31187,27662,3,32,10,1,0,0,0,3,363,96,26964,30701,29187,1,-25,-2,429,3,486,-1525,0,0,1,0,4
EUN1_3570223155',1,21,10,1,0,0,0,7,1,326,104,24958,30640,26589,2,35,8,0,0,0,0,1,359,88,24728,29518,35096,1,-33,16,230,2,1122,-8507,1,0,0,0,6
EUN1_3574100904',2,139,8,0,1,0,0,5,1,353,61,25612,28285,27245,7,30,8,2,0,1,0,3,330,102,23724,28038,23535,0,23,-41,1888,0,247,3710,-2,1,-1,0,2
EUN1_3575747707',0,20,5,2,0,1,0,19,0,329,56,23595,27684,23636,3,102,21,0,0,3,0,0,373,111,33239,33763,38977,0,-44,-55,-9644,-16,-6079,-15341,2,0,-2,0,19
EUN1_3575732857',1,24,14,1,0,0,0,7,1,358,94,28148,29560,31416,3,30,9,0,0,0,0,4,337,90,25405,29641,24056,1,21,4,2743,5,-81,7360,1,0,0,0,3
EUN1_3575726492',3,29,11,2,0,1,0,12,1,366,112,28256,31723,28604,4,29,14,0,0,2,0,7,377,104,29639,31269,25022,1,-11,8,-1383,-3,454,3582,2,0,-1,0,5
EUN1_3575710065',3,21,8,1,0,1,0,2,0,380,106,26008,30961,23121,3,29,9,1,0,0,0,5,359,106,26201,30065,30737,0,21,0,-193,-1,896,-7616,0,0,1,0,-3
EUN1_3575703887',5,27,12,0,0,2,0,7,1,388,77,29467,30408,28564,4,24,11,2,0,1,0,6,346,110,26726,30182,28717,0,42,-33,2741,1,226,-153,-2,0,1,0,1
EUN1_3575698757',2,24,17,0,0,3,0,6,1,340,95,31448,28258,37229,4,206,14,2,0,1,0,14,340,63,28287,28206,31710,0,0,32,3161,3,52,5519,-2,0,2,0,-8
EUN1_3575701130',5,31,6,0,0,1,0,11,0,370,78,25539,29015,23731,6,27,19,2,0,1,0,4,339,81,30138,30341,35032,0,31,-3,-4599,-13,-1326,-11301,-2,0,0,0,7
EUN1_3575680820',4,26,8,1,0,1,0,8,0,305,91,24998,28208,23618,5,22,14,1,0,2,0,3,338,96,29026,31246,28253,0,-33,-5,-4028,-6,-3038,-4635,0,0,-1,0,5
EUN1_3575101690',2,60,15,0,0,1,0,8,1,320,63,28195,30387,31229,8,63,14,1,0,0,0,0,373,97,28301,29853,32535,0,-53,-34,-106,1,534,-1306,-1,0,1,0,8
EUN1_3575095113',7,36,14,2,0,1,0,3,1,342,96,28494,29341,37217,3,24,12,0,0,0,0,4,352,90,26591,30517,29185,1,-10,6,1903,2,-1176,8032,2,0,1,0,-1
EUN1_3574427319',5,30,11,0,0,1,0,3,1,355,90,27023,29013,26576,1,22,7,2,0,0,0,4,322,80,23045,27202,24718,0,33,10,3978,4,1811,1858,-2,0,1,0,-1
EUN1_3574404454',5,31,20,1,0,1,0,10,1,324,102,33639,30259,39226,2,26,17,0,0,1,0,7,359,66,30489,28233,28640,1,-35,36,3150,3,2026,10586,1,0,0,0,3
EUN1_3573911168',3,27,16,2,0,0,0,6,1,344,81,29456,29798,37928,2,11,15,0,1,1,0,4,342,115,29714,31251,34126,1,2,-34,-258,1,-1453,3802,2,-1,-1,0,2
EUN1_3573889103',3,28,14,2,1,1,0,9,1,346,103,27468,29559,26976,1,40,7,0,0,0,0,3,345,56,23644,26828,18055,1,1,47,3824,7,2731,8921,2,1,1,0,6
EUN1_3573842038',2,27,15,0,0,1,0,12,1,359,70,29855,30189,29960,3,24,10,1,0,2,0,7,358,68,25721,29105,30356,1,1,2,4134,5,1084,-396,-1,0,-1,0,5
EUN1_3573801900',3,26,11,1,0,2,0,13,0,371,89,27931,32520,29261,2,28,5,0,0,1,0,5,388,91,26344,28206,17954,1,-17,-2,1587,6,4314,11307,1,0,1,0,8
EUN1_3573744291',2,20,9,0,0,2,0,12,0,340,109,27822,30032,24739,2,19,13,2,0,2,0,8,362,110,29331,31695,33003,1,-22,-1,-1509,-4,-1663,-8264,-2,0,0,0,4
EUN1_3576224201',7,26,15,2,0,1,0,10,1,372,82,28636,30661,37462,2,29,10,0,0,1,0,3,343,88,27205,29535,26681,0,29,-6,1431,5,1126,10781,2,0,0,0,7
EUN1_3575348915',2,35,7,0,0,0,0,15,0,300,86,23242,26545,25946,1,180,16,2,1,3,0,2,391,116,32380,32604,37088,0,-91,-30,-9138,-9,-6059,-11142,-2,-1,-3,0,13
EUN1_3575318045',5,29,12,0,0,1,0,7,1,404,90,29578,31130,32708,3,25,13,2,0,2,0,6,339,94,27079,31142,33488,0,65,-4,2499,-1,-12,-780,-2,0,-1,0,1
EUN1_3575209608',6,27,19,1,0,2,0,11,1,392,78,31689,30260,36633,5,99,9,0,0,0,0,4,352,70,26034,28057,32496,1,40,8,5655,10,2203,4137,1,0,2,0,7
EUN1_3575196507',3,21,12,1,1,0,0,6,0,383,94,27438,30893,28078,0,19,12,1,0,0,0,2,373,90,27056,30254,29854,0,10,4,382,0,639,-1776,0,1,0,0,4
EUN1_3570747990',4,26,17,1,0,1,0,8,1,415,98,29709,32182,30799,1,24,8,1,0,0,0,5,323,94,24105,28147,28119,1,92,4,5604,9,4035,2680,0,0,1,0,3
EUN1_3570729025',3,24,17,2,0,1,0,2,1,378,82,31034,32847,39338,1,21,11,0,0,1,0,6,304,66,24391,28322,23730,1,74,16,6643,6,4525,15608,2,0,0,0,-4
EUN1_3570673594',4,29,17,0,0,1,0,10,1,326,75,29478,28403,42745,2,28,20,2,0,3,0,6,318,96,31318,30401,44929,0,8,-21,-1840,-3,-1998,-2184,-2,0,-2,0,4
EUN1_3570639056',2,24,6,1,0,0,0,12,0,355,88,24523,30872,25981,3,23,7,1,0,2,0,2,392,109,27536,31741,18470,0,-37,-21,-3013,-1,-869,7511,0,0,-2,0,10
EUN1_3570254687',2,29,16,2,0,0,0,5,1,379,94,28836,31456,38397,3,32,12,0,0,0,0,3,349,78,25784,29130,29465,1,30,16,3052,4,2326,8932,2,0,0,0,2
EUN1_3570227466',4,24,12,1,0,1,0,8,1,402,78,28016,31438,26911,4,28,10,0,0,1,0,4,357,113,27027,31550,25848,0,45,-35,989,2,-112,1063,1,0,0,0,4
EUN1_3570198574',1,36,14,0,0,0,0,5,1,339,82,27257,28878,35990,5,26,14,1,0,0,0,3,299,85,25989,27719,32369,0,40,-3,1268,0,1159,3621,-1,0,0,0,2
EUN1_3575898512',4,24,10,0,0,0,0,7,0,342,82,24642,29914,32207,3,42,11,2,0,0,0,2,334,80,26401,29840,29201,0,8,2,-1759,-1,74,3006,-2,0,0,0,5
EUN1_3575882451',7,32,23,1,0,1,0,10,0,355,62,32688,30553,38626,5,22,11,0,0,0,0,2,300,86,25776,26090,38614,1,55,-24,6912,12,4463,12,1,0,1,0,8
EUN1_3575862295',3,22,10,0,0,1,0,12,1,305,84,26481,24459,30363,2,206,23,1,0,1,0,7,278,92,31472,30753,40017,0,27,-8,-4991,-13,-6294,-9654,-1,0,0,0,5
EUN1_3575836863',4,22,10,2,0,0,0,10,1,314,94,24864,27765,31130,3,19,13,0,0,1,0,1,335,94,27592,32299,28525,0,-21,0,-2728,-3,-4534,2605,2,0,-1,0,9
EUN1_3575179299',3,28,17,0,0,0,0,14,0,293,90,26485,28622,31487,6,46,11,2,0,2,0,0,387,82,29145,29999,30558,0,-94,8,-2660,6,-1377,929,-2,0,-2,0,14
EUN1_3575168431',1,20,15,2,0,2,0,2,0,385,86,30250,31026,37253,4,27,9,0,0,0,0,12,298,81,24458,26752,23353,1,87,5,5792,6,4274,13900,2,0,2,0,-10
EUN1_3575159541',5,43,19,1,1,1,0,7,0,310,80,30207,29219,42756,2,28,19,1,0,0,0,3,314,88,30162,29787,38535,0,-4,-8,45,0,-568,4221,0,1,1,0,4
EUN1_3574798340',1,16,19,2,0,1,0,12,0,256,76,28425,28526,40775,2,22,21,0,0,1,0,3,295,64,30556,29244,40777,0,-39,12,-2131,-2,-718,-2,2,0,0,0,9
EUN1_3574775436',3,26,16,1,0,2,0,11,0,320,81,29199,29832,36111,2,20,15,1,0,1,0,8,350,98,29496,29783,32732,0,-30,-17,-297,1,49,3379,0,0,1,0,3
EUN1_3573674391',5,30,12,0,0,0,0,7,0,347,78,27462,32266,37388,3,27,9,2,0,1,0,4,354,86,25328,29997,31396,0,-7,-8,2134,3,2269,5992,-2,0,-1,0,3
EUN1_3573660206',3,24,15,1,0,0,0,9,0,324,71,27029,28086,35293,2,386,16,0,1,1,0,1,369,108,30302,31672,38445,0,-45,-37,-3273,-1,-3586,-3152,1,-1,-1,0,8
EUN1_3573566964',3,42,17,2,0,0,0,9,0,342,76,29172,29549,36300,1,24,13,0,0,1,0,3,325,72,27246,27702,38544,0,17,4,1926,4,1847,-2244,2,0,-1,0,6
EUN1_3573554684',5,19,12,0,0,2,0,7,1,342,106,28018,29777,30109,3,23,11,2,0,0,0,3,322,74,26018,29204,29436,1,20,32,2000,1,573,673,-2,0,2,0,4
EUN1_3573372036',8,24,18,0,0,0,0,6,1,321,98,29031,29999,38578,2,20,15,2,0,0,0,1,327,77,27489,29216,34826,0,-6,21,1542,3,783,3752,-2,0,0,0,5
EUN1_3573311533',5,32,9,1,0,0,0,4,0,358,104,25028,30426,26196,3,53,4,0,0,0,0,0,355,104,23187,29129,17406,1,3,0,1841,5,1297,8790,1,0,0,0,4
EUN1_3573293289',5,23,7,0,0,0,0,9,1,341,76,24067,27292,27400,3,18,19,2,0,1,0,2,341,121,29693,32891,35022,0,0,-45,-5626,-12,-5599,-7622,-2,0,-1,0,7
EUN1_3573218344',0,19,6,1,0,0,0,12,0,300,92,22964,27212,25941,3,24,16,1,0,1,0,0,319,84,26809,29173,34607,0,-19,8,-3845,-10,-1961,-8666,0,0,-1,0,12
EUN1_3576030958',4,24,9,0,0,1,0,7,1,351,79,26505,28176,25013,3,25,11,2,1,1,0,4,378,112,27881,32081,29583,0,-27,-33,-1376,-2,-3905,-4570,-2,-1,0,0,3
EUN1_3575992702',2,29,10,0,0,0,0,12,0,297,68,24530,26947,30905,4,26,21,2,0,1,0,3,350,138,32087,35286,44408,0,-53,-70,-7557,-11,-8339,-13503,-2,0,-1,0,9
EUN1_3575954974',2,26,14,1,0,1,0,6,1,325,118,29409,30605,36135,5,30,10,1,0,0,0,7,333,102,25912,30119,28589,0,-8,16,3497,4,486,7546,0,0,1,0,-1
EUN1_3575595164',1,35,7,2,0,1,0,6,1,362,88,26010,28947,23300,1,20,7,0,0,1,0,7,286,41,19937,24432,13272,1,76,47,6073,0,4515,10028,2,0,0,0,-1
EUN1_3575559127',4,27,12,1,0,1,0,10,0,375,102,27979,30309,32390,1,23,15,1,0,0,0,3,374,67,28114,28393,33222,0,1,35,-135,-3,1916,-832,0,0,1,0,7
EUN1_3575519029',2,25,12,0,0,0,0,11,1,292,90,26221,29390,37876,3,18,21,2,0,3,0,3,336,84,31477,33065,38450,0,-44,6,-5256,-9,-3675,-574,-2,0,-3,0,8
EUN1_3575492905',3,19,18,0,0,2,0,12,0,313,63,28787,27799,32973,3,32,15,2,0,3,0,6,321,84,30359,28780,41725,0,-8,-21,-1572,3,-981,-8752,-2,0,-1,0,6
EUN1_3575470091',6,28,12,1,0,0,0,3,0,343,90,27124,29048,28228,6,28,10,0,0,0,0,1,372,84,24933,28919,27273,1,-29,6,2191,2,129,955,1,0,0,0,2
EUN1_3575437872',5,145,17,1,0,0,0,7,0,314,66,27966,27690,32566,3,20,13,1,0,0,0,3,363,104,27778,28891,29986,1,-49,-38,188,4,-1201,2580,0,0,0,0,4
EUN1_3575407644',8,32,10,1,0,0,0,4,1,371,96,26474,29406,21308,0,15,6,1,0,0,0,2,351,58,22959,26875,17428,1,20,38,3515,4,2531,3880,0,0,0,0,2
EUN1_3575397092',3,23,28,2,1,2,0,7,1,384,101,34142,32369,42669,3,21,7,0,0,0,0,6,321,65,23748,26038,27175,1,63,36,10394,21,6331,15494,2,1,2,0,1
EUN1_3574397035',5,60,14,0,0,0,0,9,0,363,77,28246,30008,39579,1,67,16,1,0,2,0,2,311,91,28260,30045,36263,0,52,-14,-14,-2,-37,3316,-1,0,-2,0,7
EUN1_3574383550',7,32,8,1,0,0,0,16,0,302,77,24430,26723,25061,3,36,19,1,0,3,0,4,367,98,32263,31342,40979,0,-65,-21,-7833,-11,-4619,-15918,0,0,-3,0,12
EUN1_3574353011',1,396,12,0,0,0,0,14,1,297,68,25083,26888,30787,5,28,18,1,0,1,0,0,325,92,30029,29649,45425,0,-28,-24,-4946,-6,-2761,-14638,-1,0,-1,0,14
EUN1_3574327566',5,24,26,0,0,2,0,8,1,334,75,33346,32110,43588,1,33,15,1,0,0,0,5,306,80,27469,28380,43019,1,28,-5,5877,11,3730,569,-1,0,2,0,3
EUN1_3574299066',3,26,6,1,0,0,0,4,1,357,70,24694,27483,25955,3,26,9,0,0,0,0,5,350,110,25729,30192,28705,0,7,-40,-1035,-3,-2709,-2750,1,0,0,0,-1
EUN1_3574285731',2,13,14,1,0,0,0,8,0,361,100,28215,33439,32170,3,26,15,1,0,0,0,3,340,72,27986,29002,38185,1,21,28,229,-1,4437,-6015,0,0,0,0,5
EUN1_3574266816',7,32,20,0,0,1,0,10,0,361,70,29918,29645,35319,6,147,16,2,0,2,0,1,357,86,30465,28416,41589,1,4,-16,-547,4,1229,-6270,-2,0,-1,0,9
EUN1_3572785487',1,61,22,1,0,1,0,3,1,331,100,30833,31498,42720,2,23,14,1,0,0,0,7,294,91,26692,29040,28899,1,37,9,4141,8,2458,13821,0,0,1,0,-4
EUN1_3572768761',6,50,21,1,0,2,0,6,1,374,87,31447,30484,41224,2,24,13,0,0,1,0,10,262,68,24930,23911,21875,1,112,19,6517,8,6573,19349,1,0,1,0,-4
EUN1_3563411380',8,40,20,0,0,0,0,13,0,324,90,30900,29622,35788,7,33,20,2,0,1,0,2,334,98,32447,28988,36997,0,-10,-8,-1547,0,634,-1209,-2,0,-1,0,11
EUN1_3563363792',4,22,20,2,1,2,0,7,1,363,121,33365,33774,32006,3,18,5,0,0,1,0,7,306,82,22382,26363,23690,1,57,39,10983,15,7411,8316,2,1,1,0,0
EUN1_3563353164',4,44,6,0,0,0,0,12,0,310,98,23539,28257,19940,6,25,12,2,0,1,0,2,345,105,27334,29070,34288,0,-35,-7,-3795,-6,-813,-14348,-2,0,-1,0,10
EUN1_3562155377',5,28,12,0,0,1,0,9,1,360,105,27531,30813,33605,5,26,8,1,0,0,0,3,300,90,24537,27250,26821,1,60,15,2994,4,3563,6784,-1,0,1,0,6
EUN1_3562143778',6,22,16,1,0,1,0,6,1,329,87,28942,29048,38966,2,25,7,1,0,0,0,3,348,112,26058,29345,33459,1,-19,-25,2884,9,-297,5507,0,0,1,0,3
EUN1_3561777006',5,24,5,0,0,0,0,13,0,364,94,24313,29933,24259,4,142,10,2,0,2,0,1,398,110,29062,32929,32528,0,-34,-16,-4749,-5,-2996,-8269,-2,0,-2,0,12
EUN1_3561706099',3,89,8,0,0,0,0,8,0,377,64,25365,28013,27935,7,34,14,1,0,1,0,3,364,96,28349,30582,29301,0,13,-32,-2984,-6,-2569,-1366,-1,0,-1,0,5
EUN1_3560712386',3,29,20,1,0,1,0,12,1,319,77,29987,30657,46108,3,61,13,1,1,1,0,2,356,94,29550,30164,38656,1,-37,-17,437,7,493,7452,0,-1,0,0,10
EUN1_3559314245',1,24,10,1,0,0,0,9,0,335,110,26978,29418,29110,4,24,14,1,0,1,0,5,319,96,28258,29318,30644,0,16,14,-1280,-4,100,-1534,0,0,-1,0,4
EUN1_3558905177',0,55,20,2,0,2,0,9,0,335,120,32187,33925,43986,2,57,11,0,0,1,0,6,287,104,26687,27523,31925,1,48,16,5500,9,6402,12061,2,0,1,0,3
EUN1_3558887481',4,28,17,2,0,1,0,5,1,386,118,32510,32041,38266,5,27,8,0,0,0,0,5,307,80,24229,28367,24510,1,79,38,8281,9,3674,13756,2,0,1,0,0
EUN1_3558867387',3,33,8,1,0,1,0,5,1,354,106,26441,30070,31095,4,23,8,1,0,0,0,6,346,82,24665,27016,23062,0,8,24,1776,0,3054,8033,0,0,1,0,-1
EUN1_3558235669',7,49,11,1,0,1,0,6,1,381,74,27908,30493,33845,4,25,10,1,0,0,0,4,371,88,24607,27475,24622,1,10,-14,3301,1,3018,9223,0,0,1,0,2
EUN1_3558207620',5,23,12,0,0,0,0,8,1,333,66,25718,28643,28490,2,168,8,1,1,1,0,1,362,101,27128,30433,32450,1,-29,-35,-1410,4,-1790,-3960,-1,-1,-1,0,7
EUN1_3558186557',5,25,16,1,0,0,0,10,1,383,99,30775,33179,38193,8,28,11,1,0,1,0,4,349,78,27230,28639,30387,1,34,21,3545,5,4540,7806,0,0,-1,0,6
EUN1_3558162773',5,25,15,0,0,2,0,3,1,346,96,29922,30052,35266,3,27,13,1,0,0,0,6,374,96,27790,30844,34621,0,-28,0,2132,2,-792,645,-1,0,2,0,-3
EUN1_3558137893',8,30,8,1,0,0,0,9,0,383,99,25608,29107,24417,3,23,14,1,0,0,0,2,360,106,28678,31694,27438,1,23,-7,-3070,-6,-2587,-3021,0,0,0,0,7
EUN1_3558123281',5,24,10,1,0,0,0,4,0,368,108,27649,31166,24788,2,25,9,0,0,1,0,5,343,80,25501,29211,25349,0,25,28,2148,1,1955,-561,1,0,-1,0,-1
EUN1_3558104450',3,24,13,2,0,0,0,12,0,355,104,28728,29841,29123,5,28,17,0,0,1,0,1,375,88,32064,31166,38223,0,-20,16,-3336,-4,-1325,-9100,2,0,-1,0,11
EUN1_3572016823',3,23,8,1,0,1,0,9,0,315,72,25273,28830,24792,5,38,8,0,0,0,0,3,367,102,25820,29919,35260,1,-52,-30,-547,0,-1089,-10468,1,0,1,0,6
EUN1_3571723969',3,33,14,1,0,0,0,14,1,345,116,28504,30702,36806,4,47,19,1,0,1,0,3,331,84,29745,30630,43604,1,14,32,-1241,-5,72,-6798,0,0,-1,0,11
EUN1_3571519727',2,21,12,0,0,0,0,10,1,325,92,28358,28846,30256,3,43,13,1,0,2,0,3,258,84,27102,29779,30214,1,67,8,1256,-1,-933,42,-1,0,-2,0,7
EUN1_3571152381',4,24,14,2,0,1,0,7,1,373,74,28080,28838,28662,6,48,7,0,0,0,0,2,337,94,24500,29087,24463,1,36,-20,3580,7,-249,4199,2,0,1,0,5
EUN1_3571049408',2,28,7,0,0,1,0,12,0,315,72,24814,28045,27925,4,46,18,2,0,1,0,3,358,82,31015,30634,37048,0,-43,-10,-6201,-11,-2589,-9123,-2,0,0,0,9
EUN1_3570747842',4,32,7,0,0,0,0,8,1,333,92,25663,28444,24209,4,24,8,2,0,2,0,6,356,95,25881,28336,30503,0,-23,-3,-218,-1,108,-6294,-2,0,-2,0,2
EUN1_3570718824',4,24,12,0,0,0,0,6,0,352,73,26755,30168,34323,2,97,12,0,0,0,0,3,343,82,26770,29237,40167,1,9,-9,-15,0,931,-5844,0,0,0,0,3
EUN1_3570688760',6,136,11,0,1,1,0,6,1,360,74,27922,29828,28171,4,65,12,2,0,1,0,3,345,90,27629,29640,29548,1,15,-16,293,-1,188,-1377,-2,1,0,0,3
EUN1_3573500355',4,18,11,0,0,0,0,10,0,328,80,26775,27521,32729,5,28,15,2,0,1,0,4,295,94,26582,29574,36647,1,33,-14,193,-4,-2053,-3918,-2,0,-1,0,6
EUN1_3572727791',1,25,15,0,0,0,0,4,0,340,80,28023,28548,36834,4,36,13,2,0,0,0,2,334,64,26358,28032,32143,1,6,16,1665,2,516,4691,-2,0,0,0,2
EUN1_3572544462',3,26,7,2,0,0,0,7,1,316,80,24304,26330,30218,5,21,22,0,1,3,0,2,344,88,31419,31504,38237,0,-28,-8,-7115,-15,-5174,-8019,2,-1,-3,0,5
EUN1_3572106984',3,26,12,0,0,1,0,12,1,353,69,26500,29130,28048,1,22,7,2,0,1,0,3,320,102,25511,29239,21597,1,33,-33,989,5,-109,6451,-2,0,0,0,9
EUN1_3571164141',2,22,9,0,0,1,0,5,1,373,100,26800,30482,26452,4,23,6,2,0,0,0,3,371,88,23746,29041,22172,1,2,12,3054,3,1441,4280,-2,0,1,0,2
EUN1_3571113415',2,28,18,2,1,1,0,10,1,336,102,29269,30277,36370,1,26,12,0,0,1,0,2,328,90,27139,29684,30374,1,8,12,2130,6,593,5996,2,1,0,0,8
EUN1_3571073816',2,25,13,2,1,1,0,12,0,353,94,27867,31370,38552,4,42,15,0,0,1,0,1,319,82,27363,29456,35406,1,34,12,504,-2,1914,3146,2,1,0,0,11
EUN1_3571001379',2,27,11,0,0,0,0,14,0,337,80,26609,28680,26965,2,31,14,2,0,2,0,0,393,119,30648,33671,32333,1,-56,-39,-4039,-3,-4991,-5368,-2,0,-2,0,14
EUN1_3570891718',1,29,9,1,0,0,0,6,1,297,108,25479,28671,28905,1,29,12,0,0,1,0,3,328,80,26432,29239,26603,0,-31,28,-953,-3,-568,2302,1,0,-1,0,3
EUN1_3570309315',5,33,11,0,0,1,0,7,0,366,101,27695,30806,37302,2,27,9,1,1,1,0,6,303,80,25350,30579,26068,1,63,21,2345,2,227,11234,-1,-1,0,0,1
EUN1_3570262271',5,25,16,0,0,1,0,12,1,349,70,30568,28780,37609,5,27,21,2,0,0,0,4,332,114,30292,30880,44366,1,17,-44,276,-5,-2100,-6757,-2,0,1,0,8
EUN1_3570237305',4,208,5,1,0,0,0,11,0,319,83,22138,24729,27865,2,31,18,1,0,1,0,3,311,73,28107,28398,31331,0,8,10,-5969,-13,-3669,-3466,0,0,-1,0,8
EUN1_3570212737',4,23,24,1,0,1,0,6,1,356,88,34390,33246,44585,5,30,11,0,0,1,0,9,303,65,25990,27979,29819,1,53,23,8400,13,5267,14766,1,0,0,0,-3
EUN1_3563418925',1,22,6,0,0,0,0,6,1,332,78,23325,26291,24832,7,24,14,1,0,0,0,2,353,98,27883,30344,28473,0,-21,-20,-4558,-8,-4053,-3641,-1,0,0,0,4
EUN1_3563398004',1,16,8,1,0,1,0,15,0,307,86,25433,28164,24725,2,35,14,0,0,3,0,1,390,82,30520,31498,35597,0,-83,4,-5087,-6,-3334,-10872,1,0,-2,0,14
EUN1_3563301997',4,24,37,2,1,7,2,7,1,327,121,38960,34439,58646,1,12,10,0,0,0,0,11,264,30,25423,25098,26324,1,63,91,13537,27,9341,32322,2,1,7,2,-4
EUN1_3563070415',5,21,9,1,1,0,0,15,1,289,84,24906,27512,28827,2,19,24,1,0,3,0,0,343,88,32752,31324,42526,0,-54,-4,-7846,-15,-3812,-13699,0,1,-3,0,15
EUN1_3563058595',7,27,22,1,0,0,0,21,0,340,88,32026,32088,38274,3,66,16,1,0,4,0,4,366,98,32887,30025,36869,1,-26,-10,-861,6,2063,1405,0,0,-4,0,17
EUN1_3563043738',4,23,19,0,0,1,0,17,1,331,98,30010,30709,41068,5,20,21,2,0,2,0,4,350,101,32502,32249,47128,0,-19,-3,-2492,-2,-1540,-6060,-2,0,-1,0,13
EUN1_3560048031',4,25,6,0,0,0,0,12,0,330,76,24190,27629,23288,6,37,14,2,0,5,0,2,349,88,30426,30393,35722,0,-19,-12,-6236,-8,-2764,-12434,-2,0,-5,0,10
EUN1_3560035638',2,46,20,1,0,2,0,8,0,349,104,33341,30959,40536,2,46,11,0,0,1,0,5,318,68,25391,25458,36466,1,31,36,7950,9,5501,4070,1,0,1,0,3
EUN1_3560008629',3,26,9,0,1,0,0,5,0,349,89,24945,28028,28143,1,18,7,2,0,0,0,3,364,70,24815,28813,27329,0,-15,19,130,2,-785,814,-2,1,0,0,2
EUN1_3559878389',3,24,12,1,0,0,0,6,0,326,104,27156,29049,32144,2,25,15,1,0,0,0,1,325,72,27985,29289,42619,1,1,32,-829,-3,-240,-10475,0,0,0,0,5
EUN1_3559841043',7,24,6,0,0,1,0,7,0,383,108,26293,30483,24853,2,21,7,2,0,1,0,5,401,90,26656,29783,25088,0,-18,18,-363,-1,700,-235,-2,0,0,0,2
EUN1_3559659228',1,20,13,1,1,1,0,9,1,374,96,28708,30701,36527,1,23,8,0,0,1,0,6,385,84,27078,28939,27510,1,-11,12,1630,5,1762,9017,1,1,0,0,3
EUN1_3559642138',2,20,12,0,0,0,0,13,0,345,75,26753,29172,33150,1,22,20,2,0,2,0,1,368,108,32380,33487,45584,1,-23,-33,-5627,-8,-4315,-12434,-2,0,-2,0,12
EUN1_3576244255',3,25,10,1,0,0,0,8,0,362,101,26037,30265,25310,5,22,12,0,0,0,0,2,357,70,26459,29600,29767,1,5,31,-422,-2,665,-4457,1,0,0,0,6
EUN1_3576223869',2,28,9,0,0,0,0,5,1,347,105,26153,28640,24482,1,29,15,2,0,1,0,4,357,94,28173,31417,32059,0,-10,11,-2020,-6,-2777,-7577,-2,0,-1,0,1
EUN1_3575839358',5,50,10,1,0,1,0,9,1,355,88,27482,29775,29618,4,223,13,1,0,0,0,4,331,112,27224,30126,26293,0,24,-24,258,-3,-351,3325,0,0,1,0,5
EUN1_3575809820',3,28,15,0,0,1,0,9,0,328,76,28439,31571,31474,3,24,12,1,0,1,0,3,289,108,27349,29871,28752,1,39,-32,1090,3,1700,2722,-1,0,0,0,6
EUN1_3575347595',2,148,7,0,0,0,0,11,0,330,84,24091,29829,30786,2,19,14,2,0,1,0,0,393,124,29164,32990,31925,0,-63,-40,-5073,-7,-3161,-1139,-2,0,-1,0,11
EUN1_3575317796',2,25,9,0,0,0,0,17,1,316,93,24945,27647,23175,4,23,14,2,0,3,0,1,415,122,31243,34170,29420,0,-99,-29,-6298,-5,-6523,-6245,-2,0,-3,0,16
EUN1_3575306489',3,20,19,0,0,4,0,8,0,353,112,33661,33806,38113,3,21,12,1,0,0,0,12,327,91,26638,28016,33024,1,26,21,7023,7,5790,5089,-1,0,4,0,-4
EUN1_3575291277',7,26,12,1,0,1,0,5,1,367,78,28770,30029,37091,3,24,6,1,1,0,0,7,307,102,24239,27978,27426,1,60,-24,4531,6,2051,9665,0,-1,1,0,-2
EUN1_3574116662',2,60,13,0,1,1,0,8,0,339,86,26964,30238,32121,3,67,17,2,0,1,0,5,327,108,29329,30664,37705,0,12,-22,-2365,-4,-426,-5584,-2,1,0,0,3
EUN1_3574109684',4,23,22,2,0,1,0,6,1,315,90,30787,31141,37955,2,15,14,0,1,0,0,4,352,100,29079,30852,41625,1,-37,-10,1708,8,289,-3670,2,-1,1,0,2
EUN1_3573658573',8,74,17,1,0,0,0,9,1,349,92,28830,31061,28767,1,18,14,0,0,0,0,4,356,104,28813,31678,31388,1,-7,-12,17,3,-617,-2621,1,0,0,0,5
EUN1_3573619851',4,41,18,2,0,1,0,6,1,305,101,29581,31423,29105,3,32,12,0,1,1,0,2,346,86,27111,28871,25623,1,-41,15,2470,6,2552,3482,2,-1,0,0,4
EUN1_3574415328',5,27,11,1,0,0,0,14,0,340,76,25858,28650,27699,6,30,13,1,0,3,0,3,365,120,30061,30769,32916,0,-25,-44,-4203,-2,-2119,-5217,0,0,-3,0,11
EUN1_3574391179',2,27,7,0,1,1,0,6,1,375,96,27791,31008,24874,4,25,12,1,0,2,0,10,337,87,26144,30146,27833,0,38,9,1647,-5,862,-2959,-1,1,-1,0,-4
EUN1_3574373091',4,132,12,1,0,1,0,5,1,381,120,28116,31148,28788,5,22,3,1,0,0,0,5,316,84,21159,27685,17982,1,65,36,6957,9,3463,10806,0,0,1,0,0
EUN1_3574339019',4,22,17,2,0,3,0,12,0,363,90,30694,29948,36843,5,25,9,0,0,3,0,7,326,69,27122,28717,32875,1,37,21,3572,8,1231,3968,2,0,0,0,5
EUN1_3573621761',4,21,8,0,0,0,0,9,1,351,93,25949,27689,31694,5,26,17,2,0,2,0,4,353,78,28828,29918,34112,0,-2,15,-2879,-9,-2229,-2418,-2,0,-2,0,5
EUN1_3573604032',2,38,13,1,0,2,0,3,1,380,109,31471,31194,32185,2,24,6,1,0,1,0,12,338,90,25564,28879,24440,1,42,19,5907,7,2315,7745,0,0,1,0,-9
EUN1_3572318062',3,21,8,0,0,0,0,7,0,341,67,24855,28893,30621,4,23,14,1,0,1,0,2,368,76,29114,30412,37484,0,-27,-9,-4259,-6,-1519,-6863,-1,0,-1,0,5
EUN1_3571695247',1,32,16,0,0,0,0,4,1,376,94,30906,30176,34539,4,27,20,1,0,0,0,5,368,81,31024,31457,33747,0,8,13,-118,-4,-1281,792,-1,0,0,0,-1
EUN1_3571654699',3,27,14,1,0,0,0,7,0,329,78,27678,29390,31750,2,23,14,0,0,1,0,5,315,90,28366,29371,33235,1,14,-12,-688,0,19,-1485,1,0,-1,0,2
EUN1_3571624796',3,72,21,1,0,2,0,11,1,350,91,32397,31060,43547,4,73,12,0,0,1,0,6,353,80,29150,29644,35658,1,-3,11,3247,9,1416,7889,1,0,1,0,5
EUN1_3571453854',3,27,8,1,0,0,0,6,1,324,83,23858,26131,25827,4,43,12,0,0,0,0,2,336,72,25382,27855,28604,0,-12,11,-1524,-4,-1724,-2777,1,0,0,0,4
EUN1_3571438638',5,34,10,2,0,3,0,4,0,400,116,30218,32394,26050,1,26,6,0,0,0,0,12,373,90,23992,29395,19723,1,27,26,6226,4,2999,6327,2,0,3,0,-8
EUN1_3571419863',4,26,13,2,0,1,0,8,0,362,94,27962,30786,35379,4,43,12,0,0,0,0,5,331,71,25196,27417,25420,1,31,23,2766,1,3369,9959,2,0,1,0,3
EUN1_3571408428',5,29,9,0,0,2,0,8,0,365,72,27293,27903,29014,1,29,9,2,1,0,0,11,312,92,25184,28869,21823,1,53,-20,2109,0,-966,7191,-2,-1,2,0,-3
EUN1_3570364299',3,23,7,0,0,1,0,9,1,343,72,25665,27642,25761,2,21,17,2,0,1,0,5,357,68,27752,30321,34400,0,-14,4,-2087,-10,-2679,-8639,-2,0,0,0,4
EUN1_3570323992',4,49,13,1,0,1,0,10,1,318,103,27959,29096,35712,2,27,17,1,0,1,0,3,345,64,28430,28602,31086,1,-27,39,-471,-4,494,4626,0,0,0,0,7
EUN1_3570294767',2,23,17,1,0,2,0,9,1,347,72,30040,29374,37520,1,43,14,0,0,0,0,7,272,83,26628,27680,38384,1,75,-11,3412,3,1694,-864,1,0,2,0,2
EUN1_3570261695',2,39,13,0,0,1,0,11,1,384,74,29396,28682,28956,0,21,12,1,0,1,0,3,314,94,26495,27454,26997,0,70,-20,2901,1,1228,1959,-1,0,0,0,8
EUN1_3569851662',5,25,17,2,0,0,0,9,1,405,90,29116,32626,29762,4,31,6,0,1,0,0,3,352,106,25539,28128,24025,1,53,-16,3577,11,4498,5737,2,-1,0,0,6
EUN1_3574178451',2,21,13,0,0,0,0,11,0,350,98,29129,28440,33248,3,27,23,2,0,1,0,3,309,82,32337,29855,37947,0,41,16,-3208,-10,-1415,-4699,-2,0,-1,0,8
EUN1_3574131078',4,24,11,0,1,0,0,6,0,374,78,26875,30379,34813,2,25,7,2,0,0,0,5,358,76,24182,28387,22813,1,16,2,2693,4,1992,12000,-2,1,0,0,1
EUN1_3572645029',3,26,7,1,0,0,0,7,1,335,63,24477,27753,30804,4,24,13,0,0,1,0,1,360,92,27666,30374,35948,0,-25,-29,-3189,-6,-2621,-5144,1,0,-1,0,6
EUN1_3572618850',7,35,10,0,0,0,0,10,0,343,90,26133,28609,23814,3,150,13,1,0,1,0,1,362,70,27849,29183,37747,1,-19,20,-1716,-3,-574,-13933,-1,0,-1,0,9
EUN1_3569510404',4,44,7,1,0,1,0,11,1,359,102,25497,27579,26101,4,139,11,0,0,1,0,2,339,90,27005,31365,32973,0,20,12,-1508,-4,-3786,-6872,1,0,0,0,9
EUN1_3569136559',3,118,11,0,0,0,0,6,1,367,80,26587,29266,28321,5,50,16,2,0,0,0,5,304,120,28186,30458,32272,0,63,-40,-1599,-5,-1192,-3951,-2,0,0,0,1
EUN1_3569109441',5,29,12,0,0,0,0,9,1,361,86,28985,30332,30852,2,142,14,2,0,1,0,3,378,126,29112,31838,32605,1,-17,-40,-127,-2,-1506,-1753,-2,0,-1,0,6
EUN1_3566687994',3,25,7,1,0,0,0,9,0,301,96,23379,28342,28001,2,19,14,0,0,1,0,0,382,92,28534,32663,32951,0,-81,4,-5155,-7,-4321,-4950,1,0,-1,0,9
EUN1_3566554661',6,35,14,2,0,0,0,7,1,364,106,29129,31136,26900,4,48,12,0,0,0,0,2,371,82,27191,29300,29349,1,-7,24,1938,2,1836,-2449,2,0,0,0,5
EUN1_3566521055',0,24,16,2,0,2,0,8,1,371,80,29787,30880,29313,1,37,5,0,0,0,0,8,304,84,22986,25903,20338,1,67,-4,6801,11,4977,8975,2,0,2,0,0
EUN1_3565751193',5,40,13,1,0,1,0,5,1,364,83,27840,29119,29076,4,18,7,1,0,0,0,7,373,80,24864,30556,25351,0,-9,3,2976,6,-1437,3725,0,0,1,0,-2
EUN1_3562317582',0,216,15,1,0,2,0,7,1,389,74,31000,32685,40595,4,23,8,0,0,1,0,6,300,94,23939,28692,28858,1,89,-20,7061,7,3993,11737,1,0,1,0,1
EUN1_3562305574',5,28,23,1,0,2,0,8,0,361,108,34527,34230,47655,3,71,10,1,0,1,0,7,354,56,26397,27949,38250,1,7,52,8130,13,6281,9405,0,0,1,0,1
EUN1_3562278079',2,19,9,0,0,0,0,6,0,360,108,25936,30438,27260,3,26,10,1,1,0,0,2,393,100,27049,32128,35469,0,-33,8,-1113,-1,-1690,-8209,-1,-1,0,0,4
EUN1_3562267213',4,127,6,0,0,0,0,7,1,303,76,22717,25597,24784,4,27,15,2,1,0,0,0,377,104,29722,31940,37246,0,-74,-28,-7005,-9,-6343,-12462,-2,-1,0,0,7
EUN1_3561799067',2,23,16,1,0,1,0,8,1,354,98,30234,30714,32854,5,27,6,1,0,0,0,3,332,80,23899,26623,26933,1,22,18,6335,10,4091,5921,0,0,1,0,5
EUN1_3561011788',3,25,14,1,0,1,0,7,1,367,85,28727,31579,35651,3,237,16,0,0,0,0,4,308,80,26980,29210,34267,1,59,5,1747,-2,2369,1384,1,0,1,0,3
EUN1_3560857382',4,261,14,2,0,0,0,10,1,338,108,28885,31931,35954,3,23,7,0,0,2,0,7,374,71,25310,27810,25165,1,-36,37,3575,7,4121,10789,2,0,-2,0,3
EUN1_3560337076',4,19,17,1,0,1,0,5,0,370,92,30451,31464,39684,2,24,12,1,0,0,0,7,311,107,26453,28027,41050,0,59,-15,3998,5,3437,-1366,0,0,1,0,-2
EUN1_3560187005',4,28,9,1,0,0,0,11,0,270,80,25096,26448,25483,4,25,21,0,1,5,0,4,353,127,34058,32026,38998,0,-83,-47,-8962,-12,-5578,-13515,1,-1,-5,0,7
EUN1_3575934724',2,25,19,0,0,0,0,9,1,348,108,30712,30935,45159,4,35,19,1,0,0,0,3,339,84,30126,30243,41274,1,9,24,586,0,692,3885,-1,0,0,0,6
EUN1_3575876343',4,36,5,1,0,0,0,15,0,290,90,22390,26022,28323,5,32,20,1,0,2,0,2,385,74,31081,31668,44135,0,-95,16,-8691,-15,-5646,-15812,0,0,-2,0,13
EUN1_3575846984',4,27,21,1,0,0,0,6,0,313,84,29131,29920,38599,1,28,18,0,0,0,0,2,330,75,29215,28213,40644,0,-17,9,-84,3,1707,-2045,1,0,0,0,4
EUN1_3575833850',5,26,13,1,0,1,0,6,0,354,87,28843,29120,30353,3,29,12,0,0,2,0,8,335,78,27047,27672,30811,1,19,9,1796,1,1448,-458,1,0,-1,0,-2
EUN1_3575427374',5,34,11,2,0,0,0,8,1,318,89,25940,27484,22628,3,20,11,0,0,2,0,3,355,94,27709,27672,30613,1,-37,-5,-1769,0,-188,-7985,2,0,-2,0,5
EUN1_3575387915',2,35,12,0,0,0,0,11,1,298,80,26370,28940,29530,5,35,12,2,0,2,0,3,389,92,29250,30642,29799,1,-91,-12,-2880,0,-1702,-269,-2,0,-2,0,8
EUN1_3575383151',2,37,5,0,0,1,0,9,0,306,112,23768,28498,25049,4,112,19,2,0,1,0,4,372,101,31785,33714,35016,0,-66,11,-8017,-14,-5216,-9967,-2,0,0,0,5
EUN1_3575349020',1,33,9,2,0,1,0,13,0,328,93,25438,27056,28400,3,27,12,0,0,1,0,5,350,102,27440,30405,31945,1,-22,-9,-2002,-3,-3349,-3545,2,0,0,0,8
EUN1_3575328891',6,44,10,1,0,0,0,9,0,370,92,27884,31168,25617,1,26,8,1,0,1,0,3,433,111,27241,31707,27586,0,-63,-19,643,2,-539,-1969,0,0,-1,0,6
EUN1_3575211729',5,27,13,0,0,1,0,7,0,353,84,27933,32017,34186,5,30,10,2,0,1,0,5,293,104,24847,27998,28490,1,60,-20,3086,3,4019,5696,-2,0,0,0,2
EUN1_3575193023',2,33,8,0,0,0,0,3,0,347,96,24335,29588,31755,3,19,10,1,0,0,0,1,382,80,25419,31776,25835,0,-35,16,-1084,-2,-2188,5920,-1,0,0,0,2
EUN1_3575190475',8,31,9,1,1,2,0,7,1,390,89,27266,30282,31386,7,31,4,0,0,0,0,2,374,98,22952,29772,19231,1,16,-9,4314,5,510,12155,1,1,2,0,5
EUN1_3575176315',1,29,9,0,0,0,0,8,0,331,84,24783,28621,25181,1,29,18,2,0,3,0,2,396,112,32403,33812,27026,0,-65,-28,-7620,-9,-5191,-1845,-2,0,-3,0,6
EUN1_3575160872',2,24,15,1,0,0,0,8,1,387,88,28444,30035,37860,1,128,13,1,0,0,0,5,312,76,26612,31466,30608,0,75,12,1832,2,-1431,7252,0,0,0,0,3
EUN1_3574790696',3,38,17,1,0,1,0,6,1,382,80,30664,30469,33028,2,32,12,0,0,1,0,7,327,76,25539,27263,25418,1,55,4,5125,5,3206,7610,1,0,0,0,-1
EUN1_3574781436',4,23,13,0,0,0,0,15,1,350,85,29048,28176,36763,9,33,21,2,0,4,0,1,387,98,34385,32499,38754,0,-37,-13,-5337,-8,-4323,-1991,-2,0,-4,0,14
EUN1_3574747564',11,33,11,1,0,0,0,6,1,322,86,25467,28368,29373,3,27,8,0,0,0,0,3,340,90,25362,27591,33226,0,-18,-4,105,3,777,-3853,1,0,0,0,3
EUN1_3575784297',3,54,10,1,0,0,0,14,0,284,52,25183,26021,25561,5,31,21,0,0,2,0,0,367,76,32724,30082,44424,0,-83,-24,-7541,-11,-4061,-18863,1,0,-2,0,14
EUN1_3575775267',4,30,15,1,0,0,0,13,0,325,88,28649,28177,33288,4,172,27,1,1,2,0,2,360,105,34951,34029,40595,0,-35,-17,-6302,-12,-5852,-7307,0,-1,-2,0,11
EUN1_3575008622',4,29,10,0,0,1,0,6,0,352,84,27420,29366,26681,2,23,11,2,0,0,0,6,311,100,25846,28046,26440,0,41,-16,1574,-1,1320,241,-2,0,1,0,0
EUN1_3574973123',2,43,12,0,0,1,0,12,0,299,92,27635,27367,34981,4,22,17,2,0,1,0,6,351,76,29835,30645,34760,0,-52,16,-2200,-5,-3278,221,-2,0,0,0,6
EUN1_3574779029',7,34,19,1,0,0,0,7,0,328,79,28840,29729,36988,1,27,20,1,0,1,0,0,307,120,31473,31774,40826,1,21,-41,-2633,-1,-2045,-3838,0,0,-1,0,7
EUN1_3574761045',5,28,11,0,0,0,0,16,0,242,47,23574,24130,32991,2,51,32,1,0,4,0,0,328,86,35743,32302,47586,0,-86,-39,-12169,-21,-8172,-14595,-1,0,-4,0,16
EUN1_3574759102',5,29,3,0,0,0,0,6,0,324,76,21619,26572,14949,2,26,9,1,0,0,0,1,394,96,25309,29265,22584,0,-70,-20,-3690,-6,-2693,-7635,-1,0,0,0,5
EUN1_3574708311',3,49,15,0,0,0,0,11,0,331,83,27571,29825,27254,5,26,14,1,0,1,0,4,286,100,27693,29824,31284,1,45,-17,-122,1,1,-4030,-1,0,-1,0,7
EUN1_3574685699',4,27,12,0,0,0,0,7,0,288,54,24641,26076,35419,3,65,18,0,0,1,0,1,335,78,30060,29826,37020,0,-47,-24,-5419,-6,-3750,-1601,0,0,-1,0,6
EUN1_3574302072',0,24,18,1,0,0,0,12,0,332,74,29594,30556,34304,4,40,13,1,0,2,0,6,326,104,26964,27443,31561,1,6,-30,2630,5,3113,2743,0,0,-2,0,6
EUN1_3574278522',4,24,12,2,0,1,0,9,0,362,79,27164,28157,32642,4,45,13,0,0,0,0,3,282,83,26353,25588,30517,0,80,-4,811,-1,2569,2125,2,0,1,0,6
EUN1_3574260186',0,291,27,2,0,2,0,6,0,333,106,34320,30106,45720,2,31,14,0,0,0,0,8,249,70,27168,24638,32980,1,84,36,7152,13,5468,12740,2,0,2,0,-2
EUN1_3574225993',0,54,7,0,0,0,0,8,0,320,74,25218,28431,26361,5,63,19,1,0,1,0,3,355,66,28940,30043,33750,0,-35,8,-3722,-12,-1612,-7389,-1,0,-1,0,5
EUN1_3574222140',3,39,12,0,0,0,0,7,0,273,80,25639,27314,32012,0,77,23,1,0,1,0,1,331,88,31262,31104,42349,0,-58,-8,-5623,-11,-3790,-10337,-1,0,-1,0,6
EUN1_3574190652',1,21,4,1,0,0,0,11,0,339,86,22464,26904,21755,1,35,16,1,0,1,0,1,373,98,29189,30260,30416,1,-34,-12,-6725,-12,-3356,-8661,0,0,-1,0,10
EUN1_3574176313',5,26,10,0,0,0,0,9,0,333,96,26182,29041,31259,0,31,17,2,0,0,0,7,336,84,27480,28630,30084,0,-3,12,-1298,-7,411,1175,-2,0,0,0,2
EUN1_3573605332',5,36,17,0,0,0,0,13,0,314,63,27771,27697,35497,4,63,18,1,0,1,0,3,326,76,29611,30405,36550,0,-12,-13,-1840,-1,-2708,-1053,-1,0,-1,0,10
EUN1_3573583736',5,38,18,2,0,0,0,8,1,329,92,29481,28826,38392,8,32,5,0,0,1,0,3,333,72,22162,25946,24422,1,-4,20,7319,13,2880,13970,2,0,-1,0,5
EUN1_3564546800',2,26,11,0,0,0,0,12,1,300,83,25876,28219,24352,5,28,15,2,0,1,0,1,361,103,29145,31020,35716,0,-61,-20,-3269,-4,-2801,-11364,-2,0,-1,0,11
EUN1_3564519475',3,238,13,2,0,1,0,12,1,317,80,27959,30779,33118,1,94,7,0,0,1,0,2,377,104,25553,28814,22805,1,-60,-24,2406,6,1965,10313,2,0,0,0,10
EUN1_3564492756',2,28,18,1,1,0,0,7,0,308,87,30131,28138,41436,6,277,15,1,0,1,0,2,294,80,27797,29050,30903,1,14,7,2334,3,-912,10533,0,1,-1,0,5
EUN1_3564428912',6,33,10,0,0,1,0,6,0,338,86,26506,28626,28925,3,20,11,2,0,0,0,3,326,90,25593,28492,27710,0,12,-4,913,-1,134,1215,-2,0,1,0,3
EUN1_3564340534',2,24,15,1,0,2,0,10,0,364,68,29472,30944,32152,5,30,12,1,0,0,0,5,312,108,27182,30198,34393,1,52,-40,2290,3,746,-2241,0,0,2,0,5
EUN1_3564114826',3,22,12,0,0,1,0,11,0,326,77,28027,27715,29509,4,28,14,1,0,1,0,5,317,61,27215,28268,32474,1,9,16,812,-2,-553,-2965,-1,0,0,0,6
EUN1_3563487139',5,29,8,1,0,0,0,7,0,329,63,23970,27243,27490,2,46,16,1,0,1,0,0,339,104,29962,30893,37851,0,-10,-41,-5992,-8,-3650,-10361,0,0,-1,0,7
EUN1_3563443976',3,30,14,2,0,0,0,4,1,335,90,26836,28213,35699,1,29,12,0,0,1,0,2,321,76,27287,29756,36029,1,14,14,-451,2,-1543,-330,2,0,-1,0,2
EUN1_3563312216',1,22,12,0,0,1,0,6,0,352,76,27812,28427,27323,3,24,14,1,0,1,0,10,349,84,28003,29375,28348,0,3,-8,-191,-2,-948,-1025,-1,0,0,0,-4
EUN1_3563282928',6,21,27,1,0,2,0,12,1,320,88,35855,30125,51345,1,20,15,0,0,2,0,8,343,60,29014,28399,33287,1,-23,28,6841,12,1726,18058,1,0,0,0,4
EUN1_3563267938',2,153,17,1,0,1,0,10,1,310,72,28379,28386,33931,2,25,8,1,0,0,0,5,329,76,25707,27256,27467,1,-19,-4,2672,9,1130,6464,0,0,1,0,5
EUN1_3563068071',1,24,12,1,0,1,0,4,0,365,93,28694,28923,26986,4,35,5,1,0,0,0,5,326,78,22852,25445,24150,1,39,15,5842,7,3478,2836,0,0,1,0,-1
EUN1_3563065525',9,30,9,0,1,0,0,6,1,358,104,27170,29603,24436,2,23,7,2,0,1,0,6,317,84,23269,28118,25235,1,41,20,3901,2,1485,-799,-2,1,-1,0,0
EUN1_3563056683',3,29,9,0,0,1,0,14,1,313,67,25888,26838,30159,5,25,20,2,0,2,0,6,353,80,31105,33504,34609,0,-40,-13,-5217,-11,-6666,-4450,-2,0,-1,0,8
EUN1_3562955998',5,23,14,0,0,0,0,7,1,323,80,28713,27495,34583,0,28,18,2,0,2,0,5,329,108,29916,30544,34216,0,-6,-28,-1203,-4,-3049,367,-2,0,-2,0,2
EUN1_3562914737',1,18,9,0,0,0,0,7,0,313,91,25242,28764,23313,7,28,13,2,0,0,0,1,312,96,26366,28678,28824,1,1,-5,-1124,-4,86,-5511,-2,0,0,0,6
EUN1_3562882025',2,30,5,0,0,0,0,8,0,317,69,21948,27267,29371,2,43,19,1,0,1,0,1,330,91,29221,30656,36698,0,-13,-22,-7273,-14,-3389,-7327,-1,0,-1,0,7
EUN1_3562858599',3,32,23,2,1,2,0,6,1,344,90,32574,33529,37737,4,27,9,0,0,1,0,6,365,64,26628,28685,33253,1,-21,26,5946,14,4844,4484,2,1,1,0,0
EUN1_3576216465',6,96,16,2,0,1,0,9,1,345,115,29779,31351,32754,3,28,7,0,0,0,0,5,319,84,23992,28687,25502,1,26,31,5787,9,2664,7252,2,0,1,0,4
EUN1_3576212428',3,23,13,1,0,0,0,7,0,383,80,27223,30479,28737,5,47,12,1,1,0,0,4,369,82,26689,30451,33794,1,14,-2,534,1,28,-5057,0,-1,0,0,3
EUN1_3575879297',3,23,16,1,0,3,0,9,1,384,70,29655,30202,30175,7,31,6,1,0,1,0,5,342,85,25439,27387,26814,1,42,-15,4216,10,2815,3361,0,0,2,0,4
EUN1_3575865108',6,26,18,1,0,0,0,8,1,306,107,30309,29760,36074,5,28,10,1,0,1,0,5,349,75,25204,26862,29997,1,-43,32,5105,8,2898,6077,0,0,-1,0,3
EUN1_3575839276',1,22,13,0,0,0,0,13,1,345,72,27020,29764,28424,1,24,17,2,1,2,0,1,336,108,30794,31339,39990,1,9,-36,-3774,-4,-1575,-11566,-2,-1,-2,0,12
EUN1_3575813004',4,206,13,2,0,0,0,10,0,371,88,28155,28433,32299,3,27,19,0,0,3,0,0,366,80,32485,31479,43658,0,5,8,-4330,-6,-3046,-11359,2,0,-3,0,10
EUN1_3575781977',2,22,13,0,0,0,0,5,1,375,64,26832,29729,28969,5,141,13,1,0,0,0,2,346,92,26504,28861,29099,1,29,-28,328,0,868,-130,-1,0,0,0,3
EUN1_3574087844',3,89,12,0,0,0,0,8,1,320,70,25922,26853,31584,4,37,10,2,0,0,0,3,333,86,25912,27652,30686,0,-13,-16,10,2,-799,898,-2,0,0,0,5
EUN1_3574085991',5,24,10,0,0,0,0,9,0,322,64,25225,26721,33820,4,31,23,1,0,2,0,2,343,96,31910,31731,39760,0,-21,-32,-6685,-13,-5010,-5940,-1,0,-2,0,7
EUN1_3574089142',7,91,15,1,0,1,0,6,1,376,102,30495,31315,35014,3,24,6,0,0,0,0,5,367,92,24462,29697,26224,1,9,10,6033,9,1618,8790,1,0,1,0,1
EUN1_3574076773',4,28,6,1,0,0,0,8,0,336,97,23771,29241,26767,2,20,11,1,0,0,0,2,328,82,25134,27865,30993,0,8,15,-1363,-5,1376,-4226,0,0,0,0,6
EUN1_3574077448',4,26,6,2,0,0,0,7,0,367,85,23931,28688,17222,2,34,11,0,0,2,0,2,403,85,29465,31388,28399,0,-36,0,-5534,-5,-2700,-11177,2,0,-2,0,5
EUN1_3574079080',6,25,8,2,0,0,0,7,1,307,62,23573,25435,30394,2,37,16,0,0,1,0,2,358,95,29410,30825,29791,0,-51,-33,-5837,-8,-5390,603,2,0,-1,0,5
EUN1_3574064921',0,35,16,1,0,0,0,11,1,336,90,27699,29991,31130,3,182,20,1,0,2,0,4,308,98,31799,31304,40544,0,28,-8,-4100,-4,-1313,-9414,0,0,-2,0,7
EUN1_3574063702',2,22,3,0,0,0,0,9,0,351,64,21748,26109,30508,5,23,15,2,0,0,0,0,342,92,27691,30419,29422,0,9,-28,-5943,-12,-4310,1086,-2,0,0,0,9
EUN1_3572968984',10,32,16,1,0,2,0,11,0,339,92,31410,31935,38398,2,39,18,1,0,1,0,7,359,84,29572,30363,42885,1,-20,8,1838,-2,1572,-4487,0,0,1,0,4
EUN1_3572973566',6,28,13,0,0,2,0,6,1,415,94,30567,32013,32025,4,30,7,1,0,0,0,8,347,104,24807,29420,24206,1,68,-10,5760,6,2593,7819,-1,0,2,0,-2
EUN1_3572974365',6,67,18,1,0,1,0,10,1,323,100,28939,30608,35234,6,31,2,1,0,1,0,5,303,76,21645,24631,25009,1,20,24,7294,16,5977,10225,0,0,0,0,5
EUN1_3572506930',1,28,11,2,1,0,0,10,0,285,94,25203,27067,29562,5,20,11,0,0,1,0,2,354,102,27132,28764,36812,0,-69,-8,-1929,0,-1697,-7250,2,1,-1,0,8
EUN1_3572048074',3,22,12,0,0,0,0,14,1,277,59,25536,26576,37588,6,29,23,1,0,4,0,1,356,99,33732,32734,45794,0,-79,-40,-8196,-11,-6158,-8206,-1,0,-4,0,13
EUN1_3575794114',7,28,14,2,0,1,0,7,0,344,92,28920,29196,37922,2,20,11,0,0,1,0,5,308,87,25763,27286,40049,1,36,5,3157,3,1910,-2127,2,0,0,0,2
EUN1_3575769346',4,28,10,0,0,0,0,8,1,328,82,26015,27607,28558,3,22,13,1,0,1,0,3,364,81,27062,29098,26538,0,-36,1,-1047,-3,-1491,2020,-1,0,-1,0,5
EUN1_3575580239',4,24,10,1,0,0,0,13,0,375,84,27860,29675,32658,1,36,15,1,0,2,0,2,352,81,29312,30206,26903,0,23,3,-1452,-5,-531,5755,0,0,-2,0,11
EUN1_3575210588',2,30,11,2,0,1,0,8,0,394,89,28149,30932,34427,6,32,12,0,0,0,0,8,349,77,25723,28189,24536,1,45,12,2426,-1,2743,9891,2,0,1,0,0
EUN1_3575041542',1,23,19,0,0,1,0,7,1,344,119,30748,32690,37434,5,59,9,0,0,0,0,4,322,82,24263,27935,35313,1,22,37,6485,10,4755,2121,0,0,1,0,3
EUN1_3575011572',2,22,17,0,0,1,0,13,0,311,67,29675,29400,38298,3,316,23,2,0,1,0,3,300,80,31460,29793,39138,0,11,-13,-1785,-6,-393,-840,-2,0,0,0,10
EUN1_3574982637',2,56,22,1,0,1,0,12,0,324,88,31063,29758,41402,2,49,18,1,0,0,0,2,312,100,31594,32445,49391,1,12,-12,-531,4,-2687,-7989,0,0,1,0,10
EUN1_3574333729',6,30,16,1,1,1,0,9,1,380,86,29865,30840,36101,5,24,9,0,0,0,0,4,296,102,25178,28087,25148,1,84,-16,4687,7,2753,10953,1,1,1,0,5
EUN1_3574313532',3,36,11,1,0,0,0,6,0,366,80,27357,28419,34197,1,24,16,0,0,0,0,4,318,83,28245,27426,35270,1,48,-3,-888,-5,993,-1073,1,0,0,0,2
EUN1_3574304078',0,22,12,0,0,0,0,6,0,305,80,26199,28224,33975,4,43,14,2,0,0,0,7,308,84,25948,27550,31478,1,-3,-4,251,-2,674,2497,-2,0,0,0,-1
EUN1_3563045019',5,24,11,1,0,0,0,8,0,309,93,26741,28091,30406,3,22,16,1,0,1,0,3,316,106,29459,29920,38355,0,-7,-13,-2718,-5,-1829,-7949,0,0,-1,0,5
EUN1_3563036580',3,27,10,1,0,0,0,6,0,366,78,26698,28479,32239,3,35,12,1,0,0,0,2,346,78,27261,27900,34901,1,20,0,-563,-2,579,-2662,0,0,0,0,4
EUN1_3563019495',3,30,6,0,0,1,0,5,1,355,71,24173,26681,25547,3,36,13,1,0,0,0,5,347,96,26788,30205,30585,0,8,-25,-2615,-7,-3524,-5038,-1,0,1,0,0
EUN1_3562979456',2,26,5,1,0,0,0,8,0,369,99,23897,28605,23983,4,92,9,1,0,0,0,1,360,104,26390,29507,28976,0,9,-5,-2493,-4,-902,-4993,0,0,0,0,7
EUN1_3562944694',3,24,14,1,0,1,0,8,0,351,105,29999,29460,41333,0,17,18,0,0,0,0,5,316,74,29929,30667,36127,1,35,31,70,-4,-1207,5206,1,0,1,0,3
EUN1_3562924582',4,32,10,1,0,0,0,10,1,351,89,25533,28335,25940,5,25,12,0,0,0,0,3,336,66,26571,28777,27203,0,15,23,-1038,-2,-442,-1263,1,0,0,0,7
EUN1_3562886814',2,25,13,2,0,1,0,6,1,341,92,28597,29180,36116,0,23,8,0,0,0,0,7,320,97,25162,28223,32196,1,21,-5,3435,5,957,3920,2,0,1,0,-1
EUN1_3562865307',1,22,17,1,0,0,0,5,1,358,76,29561,29648,44577,4,25,12,1,0,0,0,1,341,79,27635,29142,39622,0,17,-3,1926,5,506,4955,0,0,0,0,4
EUN1_3562833838',5,28,9,0,0,0,0,12,0,376,88,25842,30203,31252,2,25,14,2,0,1,0,0,329,112,28596,30164,33236,0,47,-24,-2754,-5,39,-1984,-2,0,-1,0,12
EUN1_3562816406',0,23,4,0,0,0,0,7,1,360,71,22823,27507,25264,6,54,10,2,1,0,0,0,383,120,27761,31579,29483,0,-23,-49,-4938,-6,-4072,-4219,-2,-1,0,0,7
EUN1_3562797553',6,31,12,1,0,0,0,6,0,335,87,25893,31274,32270,2,30,8,1,0,1,0,1,351,76,25147,28528,31635,1,-16,11,746,4,2746,635,0,0,-1,0,5
EUN1_3562786294',1,23,20,2,0,2,0,6,1,357,99,31635,31080,44725,2,35,12,0,0,0,0,5,291,75,25193,28425,28373,1,66,24,6442,8,2655,16352,2,0,2,0,1
EUN1_3562760746',3,27,8,0,0,0,0,10,0,336,101,25520,28887,25955,4,29,13,2,0,1,0,3,359,114,29061,31756,33683,0,-23,-13,-3541,-5,-2869,-7728,-2,0,-1,0,7
EUN1_3562753141',4,29,9,1,0,1,0,11,0,376,94,26612,31562,29376,3,237,9,1,0,0,0,6,369,94,27093,30261,31276,0,7,0,-481,0,1301,-1900,0,0,1,0,5
EUN1_3562727962',5,27,15,2,0,3,0,7,0,334,92,29735,30069,38000,2,45,10,0,0,0,0,8,290,75,25460,26400,30308,1,44,17,4275,5,3669,7692,2,0,3,0,-1
EUN1_3562534041',2,25,9,0,0,0,0,12,1,375,76,26297,27740,27748,1,23,11,0,0,1,0,1,379,92,28009,30554,24928,0,-4,-16,-1712,-2,-2814,2820,0,0,-1,0,11
EUN1_3562527256',3,43,20,1,0,2,0,5,1,340,75,31719,30865,40929,0,24,12,0,0,0,0,8,271,60,25076,26566,31993,1,69,15,6643,8,4299,8936,1,0,2,0,-3
EUN1_3562501932',2,43,23,1,0,1,0,5,1,338,80,32497,31036,39239,3,438,14,0,0,1,0,8,284,68,26525,27438,29777,1,54,12,5972,9,3598,9462,1,0,0,0,-3
EUN1_3575771489',5,25,11,0,0,1,0,9,0,311,64,26430,26788,27953,2,19,15,2,0,0,0,4,316,88,27486,26911,32882,0,-5,-24,-1056,-4,-123,-4929,-2,0,1,0,5
EUN1_3575741591',5,28,13,1,0,2,0,8,1,359,88,27913,28264,30869,5,30,10,0,0,1,0,2,343,87,26034,27946,22539,1,16,1,1879,3,318,8330,1,0,1,0,6
EUN1_3575733480',6,35,18,1,0,1,0,8,1,321,103,30600,30554,38474,3,28,9,1,1,1,0,2,328,76,25102,28144,35852,0,-7,27,5498,9,2410,2622,0,-1,0,0,6
EUN1_3575706711',5,25,21,0,1,4,0,7,1,368,106,32987,33162,42286,2,22,3,1,0,0,0,5,304,76,22303,25836,24999,1,64,30,10684,18,7326,17287,-1,1,4,0,2
EUN1_3575701403',6,26,10,1,0,0,0,8,0,350,100,25313,28614,28083,2,29,9,1,0,0,0,1,346,100,25950,28064,26347,0,4,0,-637,1,550,1736,0,0,0,0,7
EUN1_3573942226',3,25,12,0,0,0,0,10,1,309,68,25488,27980,27636,2,130,22,2,0,2,0,1,349,91,31406,30381,35851,0,-40,-23,-5918,-10,-2401,-8215,-2,0,-2,0,9
EUN1_3573910937',1,29,9,1,0,0,0,9,0,330,86,24556,27430,23663,7,31,17,0,0,1,0,2,357,80,30587,31623,33934,0,-27,6,-6031,-8,-4193,-10271,1,0,-1,0,7
EUN1_3573882482',1,24,6,1,0,0,0,10,0,338,112,24316,28886,22994,0,25,8,1,0,2,0,2,388,64,27034,29354,29574,0,-50,48,-2718,-2,-468,-6580,0,0,-2,0,8
EUN1_3573852679',3,26,17,0,0,1,0,13,1,347,66,29356,29215,41733,7,29,13,2,0,1,0,3,377,92,29182,30710,30612,1,-30,-26,174,4,-1495,11121,-2,0,0,0,10
EUN1_3573621363',6,31,10,0,0,0,0,10,0,329,92,25872,27921,28549,4,23,11,2,0,1,0,1,397,87,27850,30187,28065,0,-68,5,-1978,-1,-2266,484,-2,0,-1,0,9
EUN1_3573603161',3,25,22,1,0,3,0,5,1,339,71,32186,29539,45439,4,24,14,0,0,0,0,6,326,91,28160,29749,33884,1,13,-20,4026,8,-210,11555,1,0,3,0,-1
EUN1_3573572069',6,28,12,0,0,1,0,5,1,344,96,27397,28614,25083,3,24,6,1,0,1,0,5,313,88,23689,28781,27282,1,31,8,3708,6,-167,-2199,-1,0,0,0,0
EUN1_3573563849',2,23,7,1,0,0,0,8,0,394,74,25206,30532,21755,4,30,14,1,0,0,0,0,411,102,28414,32011,33516,0,-17,-28,-3208,-7,-1479,-11761,0,0,0,0,8
EUN1_3573554759',5,26,16,2,0,0,0,7,0,327,84,28887,29753,38615,4,26,11,0,0,1,0,4,323,83,26313,28784,34844,1,4,1,2574,5,969,3771,2,0,-1,0,3
EUN1_3575964922',4,40,17,0,1,0,0,8,0,330,54,28184,29605,32859,3,27,13,2,0,1,0,3,303,98,25530,28941,33990,0,27,-44,2654,4,664,-1131,-2,1,-1,0,5
EUN1_3575872324',2,140,13,1,0,0,0,8,1,335,90,27853,29712,32173,5,29,13,1,0,0,0,5,350,113,27675,30552,37285,0,-15,-23,178,0,-840,-5112,0,0,0,0,3
EUN1_3575421050',2,17,14,0,0,0,0,9,0,364,64,27169,29507,36010,3,27,16,2,0,0,0,2,332,84,28568,29276,34884,0,32,-20,-1399,-2,231,1126,-2,0,0,0,7
EUN1_3575247576',5,33,2,1,0,0,0,13,0,340,90,22059,28099,21776,9,36,11,0,0,1,0,2,400,97,28604,30678,31664,1,-60,-7,-6545,-9,-2579,-9888,1,0,-1,0,11
EUN1_3575224593',5,28,16,1,0,1,0,7,1,350,81,29124,30227,36743,6,28,16,1,1,0,0,6,319,94,27058,29415,31646,1,31,-13,2066,0,812,5097,0,-1,1,0,1
EUN1_3573687277',0,83,20,2,0,1,0,5,1,335,86,29887,30535,39649,4,30,8,0,0,0,0,9,266,82,22886,27015,25805,1,69,4,7001,12,3520,13844,2,0,1,0,-4
EUN1_3572587217',1,24,18,0,0,1,0,6,1,351,94,32030,31034,39149,1,34,15,1,0,2,0,8,321,88,27756,28754,34819,0,30,6,4274,3,2280,4330,-1,0,-1,0,-2
EUN1_3572187973',3,20,11,0,0,0,0,5,0,314,88,25266,29122,31171,4,27,17,1,0,1,0,2,354,84,29333,30280,37115,0,-40,4,-4067,-6,-1158,-5944,-1,0,-1,0,3
EUN1_3572177321',4,54,6,1,0,0,0,14,0,324,80,23197,28042,20900,5,209,13,1,1,2,0,0,373,104,28684,31145,32499,0,-49,-24,-5487,-7,-3103,-11599,0,-1,-2,0,14
EUN1_3572029473',2,21,16,0,0,1,0,9,1,332,82,28992,32317,34696,1,38,13,2,0,2,0,5,338,94,27422,29652,37093,0,-6,-12,1570,3,2665,-2397,-2,0,-1,0,4
EUN1_3571615919',1,289,18,2,0,0,0,13,0,287,70,28502,29675,40510,1,21,16,0,0,3,0,3,298,72,28480,27321,36155,0,-11,-2,22,2,2354,4355,2,0,-3,0,10
EUN1_3571534957',2,29,15,0,0,1,0,4,1,348,94,28644,30626,30895,4,26,13,1,0,0,0,5,348,78,26369,30039,34567,0,0,16,2275,2,587,-3672,-1,0,1,0,-1
EUN1_3569059558',2,25,19,2,0,0,0,10,0,330,84,29741,31110,40358,1,26,15,0,0,0,0,3,311,102,27820,30369,29642,0,19,-18,1921,4,741,10716,2,0,0,0,7
EUN1_3568603143',1,247,17,2,1,0,0,4,1,375,86,28179,31826,39009,2,23,6,0,0,0,0,4,345,82,23641,28064,26443,0,30,4,4538,11,3762,12566,2,1,0,0,0
EUN1_3568574684',0,21,9,0,0,0,0,11,0,341,56,24209,26345,32346,2,407,24,1,1,3,0,1,364,80,32689,33852,38571,0,-23,-24,-8480,-15,-7507,-6225,-1,-1,-3,0,10
EUN1_3568515301',4,20,8,0,0,1,0,10,0,297,76,24511,27588,33641,1,70,18,2,0,2,0,5,328,116,30788,31705,40773,0,-31,-40,-6277,-10,-4117,-7132,-2,0,-1,0,5
EUN1_3568022533',1,29,14,0,0,1,0,7,0,327,82,28499,29138,36258,5,23,17,1,0,0,0,6,281,70,27551,27375,37108,0,46,12,948,-3,1763,-850,-1,0,1,0,1
EUN1_3567979739',0,21,13,0,1,0,0,8,1,383,92,28711,32520,34596,6,33,9,1,0,0,0,3,371,72,25891,28278,33296,0,12,20,2820,4,4242,1300,-1,1,0,0,5
EUN1_3567970956',1,32,11,0,0,0,0,9,0,377,64,26842,29636,26887,2,23,19,2,0,1,0,3,332,108,29925,31985,35402,0,45,-44,-3083,-8,-2349,-8515,-2,0,-1,0,6
EUN1_3567639264',2,20,10,0,0,0,0,11,1,313,82,25776,28395,23951,2,149,17,1,0,0,0,0,367,100,29227,31120,35504,0,-54,-18,-3451,-7,-2725,-11553,-1,0,0,0,11
EUN1_3565681477',4,96,17,2,0,1,0,6,1,354,98,29200,31597,43577,5,30,7,0,0,0,0,5,315,89,25461,27378,26987,1,39,9,3739,10,4219,16590,2,0,1,0,1
EUN1_3565241584',4,25,22,1,0,1,0,9,1,355,97,31555,32693,37961,4,29,10,0,0,1,0,5,252,84,24906,26138,28313,1,103,13,6649,12,6555,9648,1,0,0,0,4
EUN1_3564703598',1,24,7,1,0,0,0,12,1,340,76,25624,27493,30968,7,34,11,0,0,2,0,1,321,96,26974,28902,30992,1,19,-20,-1350,-4,-1409,-24,1,0,-2,0,11
EUN1_3563735662',0,23,10,1,0,0,0,10,0,363,85,26167,29489,25157,3,23,12,1,0,0,0,2,350,110,27693,30919,32766,1,13,-25,-1526,-2,-1430,-7609,0,0,0,0,8
EUN1_3562805841',3,26,11,1,0,0,0,8,0,349,72,25253,29214,29522,6,23,10,1,0,0,0,2,340,91,25831,29572,28328,0,9,-19,-578,1,-358,1194,0,0,0,0,6
EUN1_3569965015',4,227,16,2,0,0,0,11,1,305,84,28081,28575,28540,8,35,15,0,1,2,0,3,313,74,28924,28835,37064,0,-8,10,-843,1,-260,-8524,2,-1,-2,0,8
EUN1_3566513619',4,24,14,1,0,1,0,6,1,366,89,29048,28356,36186,7,264,12,0,0,0,0,3,299,77,25565,26506,27783,1,67,12,3483,2,1850,8403,1,0,1,0,3
EUN1_3566404226',4,249,18,0,0,0,0,5,1,322,70,28685,27712,38290,6,55,20,2,0,0,0,5,297,84,28703,28077,38879,0,25,-14,-18,-2,-365,-589,-2,0,0,0,0
EUN1_3566377681',4,215,8,0,0,0,0,9,1,350,67,25091,28273,37991,2,379,11,1,1,1,0,3,340,86,26519,30871,28481,0,10,-19,-1428,-3,-2598,9510,-1,-1,-1,0,6
EUN1_3562820877',5,23,25,1,0,3,0,10,0,331,100,34701,31695,46291,1,317,11,1,0,1,0,5,287,64,25027,25563,30421,1,44,36,9674,14,6132,15870,0,0,2,0,5
EUN1_3562807695',1,158,20,2,1,2,0,5,1,319,92,30159,29250,46132,1,232,9,0,0,0,0,7,307,64,24187,24900,24078,1,12,28,5972,11,4350,22054,2,1,2,0,-2
EUN1_3562792371',1,28,17,2,0,0,0,14,0,358,84,30496,31121,43027,1,261,17,0,0,3,0,4,319,72,30292,30484,37467,1,39,12,204,0,637,5560,2,0,-3,0,10
EUN1_3562770474',0,27,17,0,1,0,0,12,0,331,88,30362,30344,37374,3,311,21,1,0,2,0,6,300,70,30407,29349,37306,1,31,18,-45,-4,995,68,-1,1,-2,0,6
EUN1_3562747612',2,280,15,1,1,1,0,11,0,273,68,29862,26752,33818,8,32,25,1,0,2,0,6,351,84,32642,29910,47581,1,-78,-16,-2780,-10,-3158,-13763,0,1,-1,0,5
EUN1_3562728901',1,315,11,1,1,1,0,5,1,347,62,26370,28867,32183,2,26,12,0,0,0,0,7,298,74,25659,26408,32680,0,49,-12,711,-1,2459,-497,1,1,1,0,-2
EUN1_3562680433',2,226,20,1,0,0,0,9,1,296,77,29538,29188,37512,5,35,19,1,0,0,0,2,313,65,29295,28446,41376,1,-17,12,243,1,742,-3864,0,0,0,0,7
EUN1_3562666576',2,28,13,1,0,0,0,12,1,348,80,27153,28551,33338,0,211,12,1,0,1,0,2,305,96,25226,29661,22006,0,43,-16,1927,1,-1110,11332,0,0,-1,0,10
EUN1_3562654622',1,22,9,0,0,0,0,7,0,318,82,25214,28470,26694,4,551,20,1,0,0,0,0,304,86,27564,29385,36244,1,14,-4,-2350,-11,-915,-9550,-1,0,0,0,7
EUN1_3562646214',4,28,15,0,0,1,0,10,1,345,86,29318,30728,39261,1,526,13,0,0,2,0,4,346,66,29465,28848,36847,1,-1,20,-147,2,1880,2414,0,0,-1,0,6
EUN1_3562630811',3,26,5,1,0,0,0,5,1,364,80,24295,29746,23447,3,258,7,1,0,0,0,1,380,108,25588,29786,24835,0,-16,-28,-1293,-2,-40,-1388,0,0,0,0,4
EUN1_3562310266',0,603,21,1,0,5,0,4,1,342,91,34341,30184,41986,3,30,10,0,0,0,0,13,253,56,22990,22218,31841,1,89,35,11351,11,7966,10145,1,0,5,0,-9
EUN1_3561940744',2,32,13,1,0,1,0,4,1,392,98,29749,32425,29367,3,28,8,1,1,0,0,3,349,94,25420,28813,26893,1,43,4,4329,5,3612,2474,0,-1,1,0,1
EUN1_3576238602',4,27,16,2,1,1,0,11,1,390,116,32210,31847,31432,2,25,9,0,0,1,0,8,340,71,25091,27052,28312,1,50,45,7119,7,4795,3120,2,1,0,0,3
EUN1_3576235084',6,31,11,0,0,0,0,6,1,366,74,26027,28062,32509,2,25,16,1,0,0,0,2,301,90,28359,28447,31722,0,65,-16,-2332,-5,-385,787,-1,0,0,0,4
EUN1_3573285658',1,23,14,1,0,1,0,9,1,393,60,27977,30848,34356,1,22,11,1,0,1,0,2,363,90,27277,28728,34344,1,30,-30,700,3,2120,12,0,0,0,0,7
EUN1_3572145582',2,65,9,0,1,1,0,7,0,319,124,26959,30443,26188,7,62,9,2,0,1,0,4,325,79,26055,28421,26725,0,-6,45,904,0,2022,-537,-2,1,0,0,3
EUN1_3570092489',2,24,8,0,0,1,0,15,0,354,60,25637,26690,25778,6,22,13,1,1,4,0,4,369,120,30517,30790,27176,0,-15,-60,-4880,-5,-4100,-1398,-1,-1,-3,0,11
EUN1_3569617845',0,27,12,2,0,0,0,12,1,365,95,27221,30275,32865,5,24,12,0,1,2,0,1,319,91,28486,29524,34690,0,46,4,-1265,0,751,-1825,2,-1,-2,0,11
EUN1_3569456707',2,25,15,1,0,0,0,4,1,395,85,29209,31021,33872,5,51,15,0,0,0,0,4,317,98,27704,28376,28076,0,78,-13,1505,0,2645,5796,1,0,0,0,0
EUN1_3569090875',4,21,10,0,0,0,0,6,1,414,74,26575,30869,25689,5,28,7,1,0,0,0,4,343,106,24049,29741,21255,1,71,-32,2526,3,1128,4434,-1,0,0,0,2
EUN1_3569061914',5,28,24,2,1,2,0,7,1,351,128,34068,34508,42276,2,27,7,0,0,2,0,10,299,64,23722,25458,26379,1,52,64,10346,17,9050,15897,2,1,0,0,-3
EUN1_3568753203',1,20,16,0,0,0,0,4,1,355,64,28562,28731,42204,0,35,21,1,0,0,0,6,308,68,29939,30167,38629,1,47,-4,-1377,-5,-1436,3575,-1,0,0,0,-2
EUN1_3568433735',4,26,12,0,0,0,0,12,0,299,76,25008,27303,29341,2,24,12,2,0,2,0,1,344,93,28650,29797,35521,1,-45,-17,-3642,0,-2494,-6180,-2,0,-2,0,11
EUN1_3568190546',2,39,10,1,0,0,0,6,1,388,91,26790,31340,25757,3,23,8,1,1,0,0,2,422,84,26373,29802,35932,0,-34,7,417,2,1538,-10175,0,-1,0,0,4
EUN1_3568025933',2,25,13,1,0,1,0,8,1,370,62,27963,28952,32421,3,188,8,1,1,1,0,2,373,109,27661,29740,35145,0,-3,-47,302,5,-788,-2724,0,-1,0,0,6
EUN1_3566626682',2,19,14,1,0,0,0,8,0,337,80,26439,27945,30203,2,45,20,0,0,1,0,1,354,100,30879,32610,34609,0,-17,-20,-4440,-6,-4665,-4406,1,0,-1,0,7
EUN1_3566034992',2,68,17,0,0,0,0,5,1,393,106,30771,33381,38980,3,29,9,1,0,1,0,8,311,76,25322,27799,31727,1,82,30,5449,8,5582,7253,-1,0,-1,0,-3
EUN1_3566027983',3,31,12,0,0,1,0,9,1,352,88,29827,30757,26928,1,22,11,2,0,2,0,6,355,108,27463,29953,30425,1,-3,-20,2364,1,804,-3497,-2,0,-1,0,3
EUN1_3566036080',6,38,22,0,0,0,0,8,0,319,86,30458,30644,44515,2,27,12,2,1,0,0,3,339,75,26546,26917,26978,0,-20,11,3912,10,3727,17537,-2,-1,0,0,5
EUN1_3565691684',5,25,12,0,0,0,0,10,1,315,67,26920,27810,34406,2,18,11,2,0,0,0,3,353,104,26651,29313,36275,0,-38,-37,269,1,-1503,-1869,-2,0,0,0,7
EUN1_3569303441',2,25,12,2,0,0,0,10,1,341,80,27244,28938,32730,2,23,17,0,0,2,0,1,332,95,30204,31994,34949,0,9,-15,-2960,-5,-3056,-2219,2,0,-2,0,9
EUN1_3569275749',2,35,9,0,0,0,0,8,0,340,71,24992,28781,29270,3,33,14,2,0,0,0,4,360,79,27877,30268,32482,0,-20,-8,-2885,-5,-1487,-3212,-2,0,0,0,4
EUN1_3569256955',2,29,2,0,0,0,0,13,0,293,76,20855,25115,18818,7,33,19,2,0,4,0,0,376,99,31289,30034,35270,0,-83,-23,-10434,-17,-4919,-16452,-2,0,-4,0,13
EUN1_3569234263',4,26,9,0,0,1,0,7,1,365,108,26975,29552,24880,5,23,12,2,0,0,0,4,357,84,25900,29314,28815,1,8,24,1075,-3,238,-3935,-2,0,1,0,3
EUN1_3569209232',3,29,12,2,0,1,0,8,0,359,87,28396,30165,37491,2,20,15,0,0,0,0,7,325,100,28128,30696,37228,0,34,-13,268,-3,-531,263,2,0,1,0,1
EUN1_3569176209',6,29,6,2,0,0,0,11,1,358,94,25013,29665,21734,2,22,14,0,0,0,0,2,396,88,29178,31540,35821,0,-38,6,-4165,-8,-1875,-14087,2,0,0,0,9
EUN1_3568978459',3,37,10,1,0,0,0,5,0,359,81,26101,28535,30575,4,28,8,1,0,0,0,2,358,98,26112,28995,31737,1,1,-17,-11,2,-460,-1162,0,0,0,0,3
EUN1_3568973331',4,28,13,0,0,0,0,8,1,288,72,26262,25374,30668,5,47,17,1,0,2,0,1,364,63,30449,29043,38383,0,-76,9,-4187,-4,-3669,-7715,-1,0,-2,0,7
EUN1_3568952802',4,68,8,1,0,0,0,7,0,360,86,25197,28453,24274,4,49,10,1,0,1,0,4,368,54,26038,28399,26661,0,-8,32,-841,-2,54,-2387,0,0,-1,0,3
EUN1_3568728413',4,20,11,0,0,0,0,7,0,323,65,25492,27583,37637,3,20,24,2,1,0,0,2,338,134,31860,33130,42692,0,-15,-69,-6368,-13,-5547,-5055,-2,-1,0,0,5
EUN1_3568697969',2,34,7,1,1,1,0,5,0,402,98,27714,30689,25173,5,25,8,1,0,0,0,8,366,94,25390,30438,24473,0,36,4,2324,-1,251,700,0,1,1,0,-3
EUN1_3568677443',4,22,14,2,1,3,0,5,1,375,100,30667,31877,28279,3,36,2,0,0,1,0,9,358,91,21620,27424,19113,1,17,9,9047,12,4453,9166,2,1,2,0,-4
EUN1_3568634719',2,16,11,0,0,0,0,7,1,350,88,25650,29144,28689,0,30,9,1,0,0,0,0,336,88,25410,29058,33348,1,14,0,240,2,86,-4659,-1,0,0,0,7
EUN1_3568608894',1,18,8,1,0,0,0,16,0,303,64,23951,26011,30358,1,26,18,1,0,3,0,3,356,94,32988,30962,34433,0,-53,-30,-9037,-10,-4951,-4075,0,0,-3,0,13
EUN1_3568589491',3,25,16,2,0,0,0,5,1,375,107,30109,31172,32936,5,25,9,0,0,1,0,3,354,92,26804,30247,26537,0,21,15,3305,7,925,6399,2,0,-1,0,2
EUN1_3568539626',2,25,14,0,0,1,0,12,0,332,83,27940,30752,36667,2,44,11,1,0,1,0,4,335,80,26446,30396,33906,1,-3,3,1494,3,356,2761,-1,0,0,0,8
EUN1_3568525285',2,41,14,1,0,1,0,5,1,416,92,29556,29964,32165,3,30,13,1,0,0,0,9,315,87,27458,28048,33651,0,101,5,2098,1,1916,-1486,0,0,1,0,-4
EUN1_3568507401',3,28,13,0,0,1,0,10,1,351,86,28625,28682,33316,3,29,22,2,0,1,0,5,334,81,31895,30172,35030,0,17,5,-3270,-9,-1490,-1714,-2,0,0,0,5
EUN1_3568159658',4,26,18,0,0,1,0,3,1,374,95,30826,31494,30481,4,20,9,1,0,0,0,9,330,76,24471,27854,27815,1,44,19,6355,9,3640,2666,-1,0,1,0,-6
EUN1_3568119051',5,33,16,2,0,0,0,7,0,360,78,27985,30466,41877,1,20,5,0,0,1,0,3,367,80,25360,28483,24171,1,-7,-2,2625,11,1983,17706,2,0,-1,0,4
EUN1_3567756279',0,28,7,1,0,0,0,10,1,351,86,25442,29266,34013,8,27,16,1,0,0,0,2,326,100,29011,30080,40179,1,25,-14,-3569,-9,-814,-6166,0,0,0,0,8
EUN1_3567721558',9,30,11,2,0,0,0,12,0,316,98,27781,30701,33815,4,31,20,0,0,3,0,5,327,88,30303,29481,38875,0,-11,10,-2522,-9,1220,-5060,2,0,-3,0,7
EUN1_3567660783',3,297,15,0,0,2,0,9,0,313,76,30495,28718,30779,3,43,26,0,0,0,0,7,297,70,30989,28868,49580,1,16,6,-494,-11,-150,-18801,0,0,2,0,2
EUN1_3564876126',4,44,9,0,0,0,0,7,1,340,73,25475,27274,32063,6,49,16,1,0,1,0,4,332,98,29616,30797,37642,0,8,-25,-4141,-7,-3523,-5579,-1,0,-1,0,3
EUN1_3564845816',1,25,14,0,0,1,0,11,0,287,72,26842,26378,34491,5,224,15,2,0,2,0,2,332,118,30470,29455,37096,0,-45,-46,-3628,-1,-3077,-2605,-2,0,-1,0,9
EUN1_3564797363',3,29,23,1,0,1,0,5,0,308,77,30496,32780,47520,2,27,8,0,0,0,0,3,317,94,25418,28483,32325,1,-9,-17,5078,15,4297,15195,1,0,1,0,2
EUN1_3564779589',5,28,16,2,1,2,0,4,1,411,90,31702,32628,34836,4,34,8,0,0,0,0,8,292,73,23581,26022,24228,1,119,17,8121,8,6606,10608,2,1,2,0,-4
EUN1_3564755890',3,23,9,0,0,1,0,5,1,331,78,25139,29053,30591,3,29,6,2,0,0,0,5,326,106,24050,29043,25843,1,5,-28,1089,3,10,4748,-2,0,1,0,0
EUN1_3564619635',4,25,25,1,0,2,0,12,1,393,115,34382,34834,43458,2,24,6,1,0,2,0,9,282,80,23922,25555,24939,1,111,35,10460,19,9279,18519,0,0,0,0,3
EUN1_3574259304',3,26,9,2,0,0,0,7,0,319,88,24585,28752,28145,4,23,10,0,0,0,0,1,365,86,26145,28552,22455,0,-46,2,-1560,-1,200,5690,2,0,0,0,6
EUN1_3573680201',5,29,17,1,0,1,0,10,1,364,85,31178,31149,36014,1,23,11,1,0,1,0,5,340,78,25827,27415,31918,1,24,7,5351,6,3734,4096,0,0,0,0,5
EUN1_3573120532',4,27,13,2,0,1,0,7,0,393,83,28309,30719,36732,3,24,9,0,0,0,0,3,374,119,26631,30151,23769,0,19,-36,1678,4,568,12963,2,0,1,0,4
EUN1_3572848279',1,20,15,1,0,0,0,7,1,348,76,28937,31539,29033,1,38,16,1,0,0,0,3,316,92,28068,32458,36681,1,32,-16,869,-1,-919,-7648,0,0,0,0,4
EUN1_3572604411',3,35,19,2,0,1,0,12,1,317,74,29587,27828,36095,4,369,17,0,1,1,0,4,308,94,29983,30091,35433,1,9,-20,-396,2,-2263,662,2,-1,0,0,8
EUN1_3572589092',3,34,14,0,0,1,0,6,1,357,72,28874,29007,43817,3,29,10,1,0,2,0,8,316,108,26170,29300,31186,1,41,-36,2704,4,-293,12631,-1,0,-1,0,-2
EUN1_3572176399',4,26,16,1,0,1,0,7,1,355,78,28852,30578,30457,2,30,4,1,0,1,0,3,362,77,23284,28386,23951,1,-7,1,5568,12,2192,6506,0,0,0,0,4
EUN1_3570491823',2,26,15,1,0,1,0,10,1,364,70,29798,31520,34038,2,30,9,0,0,2,0,7,301,90,25797,27466,30999,0,63,-20,4001,6,4054,3039,1,0,-1,0,3
EUN1_3570319612',3,32,11,0,0,0,0,12,0,324,70,27397,27937,36865,2,23,14,1,0,2,0,5,329,102,27802,30652,34030,1,-5,-32,-405,-3,-2715,2835,-1,0,-2,0,7
EUN1_3570200348',3,33,11,0,1,1,0,9,0,360,58,26861,29454,28048,8,82,13,1,0,2,0,3,383,114,29533,31621,35229,1,-23,-56,-2672,-2,-2167,-7181,-1,1,-1,0,6
EUN1_3570084120',3,18,12,1,0,1,0,10,1,316,59,26863,28339,30651,6,52,16,0,0,0,0,5,352,70,28835,29768,38125,1,-36,-11,-1972,-4,-1429,-7474,1,0,1,0,5
EUN1_3569798615',3,42,9,0,0,0,0,6,0,320,84,24623,28607,25674,3,40,14,0,0,1,0,1,374,92,28429,31999,31364,0,-54,-8,-3806,-5,-3392,-5690,0,0,-1,0,5
EUN1_3569769555',0,18,15,1,0,1,0,2,1,396,132,29823,33906,38019,3,21,9,0,0,0,0,7,353,75,24946,29278,27912,1,43,57,4877,6,4628,10107,1,0,1,0,-5
EUN1_3569579484',3,129,9,0,0,0,0,10,0,311,92,24744,29442,28512,7,190,17,2,1,2,0,1,369,88,29800,31302,35267,0,-58,4,-5056,-8,-1860,-6755,-2,-1,-2,0,9
EUN1_3569564103',1,28,14,0,0,1,0,7,0,362,98,28683,31280,31400,2,21,16,2,0,0,0,5,320,97,28103,30581,34396,0,42,1,580,-2,699,-2996,-2,0,1,0,2
EUN1_3575894675',3,25,14,2,0,1,0,7,0,388,110,30332,31629,30670,0,24,9,0,0,0,0,4,344,78,26782,28780,30313,1,44,32,3550,5,2849,357,2,0,1,0,3
EUN1_3575485939',3,24,21,0,0,0,0,7,1,330,84,29035,29943,40424,6,34,12,1,0,1,0,0,365,97,27934,30233,39989,0,-35,-13,1101,9,-290,435,-1,0,-1,0,7
EUN1_3575307054',5,38,10,0,0,1,0,10,0,349,90,26677,29058,26633,4,34,11,2,0,0,0,7,364,89,26704,29999,35132,0,-15,1,-27,-1,-941,-8499,-2,0,1,0,3
EUN1_3575197564',2,26,10,2,0,0,0,4,0,356,91,27294,30243,29972,4,40,12,0,1,0,0,3,342,72,25560,28688,30754,1,14,19,1734,-2,1555,-782,2,-1,0,0,1
EUN1_3575059014',2,19,15,0,0,1,0,8,1,363,79,28769,30883,36947,4,33,13,1,0,1,0,3,341,96,28303,30952,33841,1,22,-17,466,2,-69,3106,-1,0,0,0,5
EUN1_3574837504',2,40,14,1,1,0,0,8,1,327,82,26449,29671,29071,1,28,11,0,0,1,0,2,355,89,27789,29272,35938,0,-28,-7,-1340,3,399,-6867,1,1,-1,0,6
EUN1_3570699417',5,31,14,1,1,1,0,6,0,331,86,28931,29245,34279,2,26,8,0,0,1,0,6,287,74,23187,25607,25157,1,44,12,5744,6,3638,9122,1,1,0,0,0
EUN1_3570661334',2,23,16,1,0,0,0,10,1,345,106,29350,32483,39383,3,54,14,1,0,1,0,2,358,90,28484,29550,34910,0,-13,16,866,2,2933,4473,0,0,-1,0,8
EUN1_3569242770',5,32,8,2,0,0,0,11,0,284,80,23423,26501,34001,3,257,14,0,0,1,0,0,379,80,29175,29718,37947,0,-95,0,-5752,-6,-3217,-3946,2,0,-1,0,11
EUN1_3569207617',4,179,8,1,0,2,0,6,1,376,85,27754,28682,31308,5,50,12,0,0,0,0,8,299,84,27067,28330,27742,1,77,1,687,-4,352,3566,1,0,2,0,-2
EUN1_3569089808',6,27,16,0,0,0,0,9,0,341,88,27959,31561,32836,2,32,4,1,0,1,0,3,370,71,24318,26624,29017,1,-29,17,3641,12,4937,3819,-1,0,-1,0,6
EUN1_3568564530',4,52,22,1,0,2,0,4,1,356,81,34159,28272,44351,2,25,16,0,0,0,0,9,268,68,27492,26328,31667,1,88,13,6667,6,1944,12684,1,0,2,0,-5
EUN1_3568107372',4,31,12,0,0,0,0,10,0,296,84,25749,27988,28315,2,30,21,1,0,1,0,0,350,77,31077,30683,38838,0,-54,7,-5328,-9,-2695,-10523,-1,0,-1,0,10
EUN1_3568078534',1,25,7,0,0,0,0,8,1,351,92,24289,30744,22139,0,23,5,1,1,0,0,2,392,84,24903,29758,29581,0,-41,8,-614,2,986,-7442,-1,-1,0,0,6
EUN1_3567708090',5,31,15,0,0,1,0,7,0,328,96,29214,30534,32525,5,29,9,2,0,1,0,5,345,96,26398,29281,26146,1,-17,0,2816,6,1253,6379,-2,0,0,0,2
EUN1_3567683606',8,32,14,1,0,2,0,11,1,322,69,28486,28918,33831,5,29,12,0,0,0,0,4,319,110,27552,28543,26139,1,3,-41,934,2,375,7692,1,0,2,0,7
EUN1_3567418088',4,30,23,1,0,2,0,5,1,367,98,32369,33953,39281,1,21,6,0,1,0,0,6,254,95,23206,26206,27898,1,113,3,9163,17,7747,11383,1,-1,2,0,-1
EUN1_3574884736',2,36,17,2,0,1,0,10,0,321,88,28886,30470,36397,3,21,12,0,1,1,0,3,311,88,26080,28689,32966,1,10,0,2806,5,1781,3431,2,-1,0,0,7
EUN1_3574870140',8,28,18,2,0,0,0,8,1,288,86,28514,29064,32164,3,364,11,0,0,1,0,2,347,102,27869,31030,28774,0,-59,-16,645,7,-1966,3390,2,0,-1,0,6
EUN1_3574832919',4,28,8,1,0,0,0,11,1,339,80,24693,26971,29520,2,22,13,1,0,1,0,3,356,81,28302,30562,29631,0,-17,-1,-3609,-5,-3591,-111,0,0,-1,0,8
EUN1_3573023375',3,37,14,1,1,0,0,8,0,354,80,28676,30231,33306,6,27,11,1,0,0,0,6,321,76,25911,26940,25670,1,33,4,2765,3,3291,7636,0,1,0,0,2
EUN1_3572295149',9,34,8,1,0,0,0,10,0,363,76,24215,29543,23247,3,63,8,1,0,0,0,0,348,90,24772,29474,24389,1,15,-14,-557,0,69,-1142,0,0,0,0,10
EUN1_3572247746',4,18,13,1,0,1,0,8,1,384,106,29412,32699,26369,4,113,11,0,0,0,0,3,313,79,25336,30481,29362,1,71,27,4076,2,2218,-2993,1,0,1,0,5
EUN1_3571993607',5,28,8,2,0,0,0,11,0,332,88,25604,29815,26138,3,27,9,0,0,3,0,2,366,100,27541,30548,24652,0,-34,-12,-1937,-1,-733,1486,2,0,-3,0,9
EUN1_3571976867',1,35,5,0,0,0,0,8,1,369,84,23122,28077,17823,5,29,7,2,0,1,0,3,362,80,25282,28640,27571,0,7,4,-2160,-2,-563,-9748,-2,0,-1,0,5
EUN1_3571402699',6,27,18,0,0,1,0,6,0,287,86,28895,30432,37671,1,22,12,1,0,0,0,4,330,86,26837,27836,31510,0,-43,0,2058,6,2596,6161,-1,0,1,0,2
EUN1_3571396085',10,26,14,0,0,0,0,11,1,345,88,27513,29081,28411,4,192,11,1,0,0,0,3,336,99,26943,28799,29619,1,9,-11,570,3,282,-1208,-1,0,0,0,8
EUN1_3571386110',2,25,18,1,0,1,0,6,1,349,75,29610,29718,41365,5,36,11,0,1,0,0,3,258,71,24820,24857,38757,1,91,4,4790,7,4861,2608,1,-1,1,0,3
EUN1_3571339921',4,27,23,1,0,2,0,8,0,295,102,31591,28139,35791,6,19,20,0,0,0,0,7,279,70,29187,26932,37389,1,16,32,2404,3,1207,-1598,1,0,2,0,1
EUN1_3571335533',2,22,6,0,0,0,0,6,1,355,108,25160,28745,20977,1,18,10,2,0,0,0,5,391,72,26024,29592,29150,0,-36,36,-864,-4,-847,-8173,-2,0,0,0,1
EUN1_3571320838',4,244,13,1,1,0,0,6,1,366,92,27558,29047,33365,3,43,15,1,0,0,0,5,368,68,28326,30249,33895,1,-2,24,-768,-2,-1202,-530,0,1,0,0,1
EUN1_3571307529',1,146,14,0,0,0,0,8,0,325,72,27085,26846,40932,3,70,22,0,0,0,0,3,281,84,28874,28544,37483,1,44,-12,-1789,-8,-1698,3449,0,0,0,0,5
EUN1_3571292954',7,34,9,1,0,1,0,9,1,371,70,25839,28461,23959,5,34,7,0,0,0,0,3,340,78,23592,27093,21665,1,31,-8,2247,2,1368,2294,1,0,1,0,6
EUN1_3571275411',3,16,17,2,0,0,0,12,1,328,112,29603,30835,33466,5,31,20,0,0,2,0,3,341,64,31636,29749,42275,1,-13,48,-2033,-3,1086,-8809,2,0,-2,0,9
EUN1_3570809417',3,27,14,1,0,0,0,10,1,381,106,28728,31413,27214,4,23,3,1,0,2,0,6,340,102,22609,28120,23590,1,41,4,6119,11,3293,3624,0,0,-2,0,4
EUN1_3570398148',5,162,7,2,0,1,0,5,1,340,112,25266,30411,27492,3,25,6,0,0,0,0,9,290,84,23653,28894,20644,1,50,28,1613,1,1517,6848,2,0,1,0,-4
EUN1_3570353970',6,31,17,1,1,1,0,13,1,309,92,29291,31092,33769,6,34,16,1,0,1,0,4,331,59,27207,26437,34014,1,-22,33,2084,1,4655,-245,0,1,0,0,9
EUN1_3576234476',5,34,11,0,0,0,0,5,1,353,68,27305,31483,32157,2,26,16,0,0,0,0,3,377,80,27721,30603,39163,1,-24,-12,-416,-5,880,-7006,0,0,0,0,2
EUN1_3576229827',1,27,9,0,0,0,0,5,1,331,92,26406,28666,35137,7,30,14,1,0,0,0,4,303,80,24990,29132,31502,1,28,12,1416,-5,-466,3635,-1,0,0,0,1
EUN1_3576221361',6,46,24,0,0,0,0,12,1,312,78,30782,30301,45367,1,22,19,2,1,3,0,2,292,82,30774,30208,40113,0,20,-4,8,5,93,5254,-2,-1,-3,0,10
EUN1_3576214792',9,36,21,2,0,2,0,5,1,361,81,32667,32038,40826,3,134,9,0,0,0,0,7,317,90,25823,28091,27714,1,44,-9,6844,12,3947,13112,2,0,2,0,-2
EUN1_3576213629',8,34,27,1,0,3,0,8,1,318,95,34468,33261,45379,2,25,6,0,0,0,0,7,266,77,22919,24589,28551,1,52,18,11549,21,8672,16828,1,0,3,0,1
EUN1_3576214353',5,24,7,0,0,1,0,7,0,361,94,26125,28257,19385,5,26,18,2,0,1,0,5,391,118,31124,33883,33701,0,-30,-24,-4999,-11,-5626,-14316,-2,0,0,0,2
EUN1_3575786332',9,29,14,0,0,0,0,7,0,320,100,26929,30367,34556,2,26,8,1,0,0,0,2,341,79,25764,28852,24304,1,-21,21,1165,6,1515,10252,-1,0,0,0,5
EUN1_3575776251',3,20,8,0,0,0,0,9,0,323,108,24526,30093,18355,5,60,10,2,0,2,0,0,417,80,27998,30905,24541,0,-94,28,-3472,-2,-812,-6186,-2,0,-2,0,9
EUN1_3575762259',1,27,10,0,0,0,0,8,1,297,68,24794,26875,30276,3,25,12,2,0,1,0,2,317,64,25465,27714,35887,0,-20,4,-671,-2,-839,-5611,-2,0,-1,0,6
EUN1_3575748202',5,85,16,1,0,0,0,8,0,301,78,27189,27827,30826,7,31,14,1,0,1,0,1,349,74,28335,29117,28944,0,-48,4,-1146,2,-1290,1882,0,0,-1,0,7
EUN1_3575726838',4,37,6,0,0,0,0,10,1,308,84,24140,26899,29380,3,26,20,2,0,1,0,0,352,84,30278,32096,38078,0,-44,0,-6138,-14,-5197,-8698,-2,0,-1,0,10
EUN1_3575706658',10,38,8,2,0,0,0,3,0,363,96,24983,29523,28898,2,31,12,0,1,0,0,0,359,72,28623,30763,24508,0,4,24,-3640,-4,-1240,4390,2,-1,0,0,3
EUN1_3575698743',4,24,18,0,0,2,0,10,1,317,82,29725,29432,32699,1,39,17,2,0,2,0,1,332,93,30112,30959,33039,0,-15,-11,-387,1,-1527,-340,-2,0,0,0,9
EUN1_3575694376',8,75,14,1,0,1,0,9,1,266,76,26458,28834,33194,6,29,10,1,0,0,0,3,360,108,26954,28454,32716,1,-94,-32,-496,4,380,478,0,0,1,0,6
EUN1_3575685725',6,80,13,0,0,0,0,6,1,333,76,26056,28673,30913,5,24,10,1,0,0,0,2,333,91,26242,28747,30488,0,0,-15,-186,3,-74,425,-1,0,0,0,4
EUN1_3575685587',2,24,20,2,0,3,0,1,1,357,82,32859,32083,40196,3,16,2,0,0,1,0,9,266,72,19652,24568,20160,1,91,10,13207,18,7515,20036,2,0,2,0,-8
EUN1_3575689190',1,45,24,0,0,3,0,3,0,356,83,33520,32940,40347,2,23,9,1,0,0,0,10,245,80,23195,26339,29759,1,111,3,10325,15,6601,10588,-1,0,3,0,-7
EUN1_3575274620',6,33,3,0,0,1,0,3,0,376,64,23194,27397,25675,4,26,7,2,0,0,0,5,374,100,25604,30682,25834,0,2,-36,-2410,-4,-3285,-159,-2,0,1,0,-2
EUN1_3575170569',3,23,10,1,0,1,0,11,1,340,120,27907,31521,27765,2,19,7,1,0,1,0,2,326,40,21966,25111,21798,1,14,80,5941,3,6410,5967,0,0,0,0,9
EUN1_3576062048',5,47,14,0,0,0,0,8,0,340,98,28386,30052,40595,3,24,16,2,0,1,0,5,292,74,26383,28330,32936,0,48,24,2003,-2,1722,7659,-2,0,-1,0,3
EUN1_3575820022',2,24,22,1,0,0,0,9,1,299,104,29754,29079,45270,0,19,19,1,0,0,0,2,350,66,29489,30525,38130,1,-51,38,265,3,-1446,7140,0,0,0,0,7
EUN1_3575808284',2,21,6,1,0,1,0,9,0,349,94,25034,27777,27787,6,95,13,1,0,1,0,4,313,100,27385,29785,34409,0,36,-6,-2351,-7,-2008,-6622,0,0,0,0,5
EUN1_3575791541',1,14,15,0,0,0,0,10,1,313,74,28126,29201,41971,3,29,23,2,0,0,0,5,335,90,31943,30545,42701,0,-22,-16,-3817,-8,-1344,-730,-2,0,0,0,5
EUN1_3575769592',3,338,18,0,0,0,0,7,0,315,82,28913,29163,41321,1,24,19,2,0,0,0,0,311,62,28593,28009,43146,0,4,20,320,-1,1154,-1825,-2,0,0,0,7
EUN1_3575720353',1,221,7,1,0,0,0,12,0,319,95,23193,27976,23670,5,51,13,1,0,1,0,2,394,88,28330,30594,40496,0,-75,7,-5137,-6,-2618,-16826,0,0,-1,0,10
EUN1_3575568718',2,35,13,0,0,1,0,3,0,353,102,28826,30129,36342,2,22,10,2,0,0,0,7,339,86,25096,29926,27033,0,14,16,3730,3,203,9309,-2,0,1,0,-4
EUN1_3575542958',6,92,22,2,0,1,0,6,1,285,104,30905,31760,38447,7,29,11,0,0,0,0,6,312,71,25545,26988,31234,1,-27,33,5360,11,4772,7213,2,0,1,0,0
EUN1_3575235743',7,30,8,0,0,0,0,7,0,317,79,24574,28468,30235,4,41,11,2,0,0,0,3,339,86,25509,28237,28686,0,-22,-7,-935,-3,231,1549,-2,0,0,0,4
EUN1_3574281409',6,29,17,0,0,3,0,6,0,354,99,32404,30604,35106,3,30,10,1,0,0,0,14,326,92,26304,27794,29961,1,28,7,6100,7,2810,5145,-1,0,3,0,-8
EUN1_3574258380',4,64,6,0,0,0,0,13,1,330,90,23329,27611,33487,4,35,11,2,1,2,0,0,399,106,29310,32167,32575,0,-69,-16,-5981,-5,-4556,912,-2,-1,-2,0,13
EUN1_3570813324',5,101,18,0,0,0,0,8,1,293,76,26766,28573,32764,1,47,14,1,0,0,0,0,365,81,28161,29005,37054,1,-72,-5,-1395,4,-432,-4290,-1,0,0,0,8
EUN1_3570782060',3,60,21,1,0,1,0,6,0,353,75,31225,31062,42268,5,27,10,0,0,1,0,8,281,90,25047,27580,32167,1,72,-15,6178,11,3482,10101,1,0,0,0,-2
EUN1_3570740033',2,140,20,2,0,2,0,6,1,341,98,32504,31435,40851,2,19,15,0,0,1,0,11,312,89,27466,30012,33549,1,29,9,5038,5,1423,7302,2,0,1,0,-5
EUN1_3575010052',2,27,11,0,0,0,0,9,1,337,102,25230,28309,27895,4,29,13,1,0,1,0,1,378,94,28442,31546,29643,0,-41,8,-3212,-2,-3237,-1748,-1,0,-1,0,8
EUN1_3574967770',2,20,7,0,0,1,0,6,0,351,90,25550,29664,29552,6,24,8,2,0,0,0,5,381,102,26677,29961,26291,1,-30,-12,-1127,-1,-297,3261,-2,0,1,0,1
EUN1_3574944687',2,29,6,1,0,1,0,13,1,380,87,24239,28492,23416,5,148,9,1,0,1,0,0,335,80,26722,29500,24853,0,45,7,-2483,-3,-1008,-1437,0,0,0,0,13
EUN1_3574926243',4,30,15,2,0,1,0,4,1,336,100,28759,29903,31673,4,35,9,0,0,0,0,5,317,96,25224,28027,27984,1,19,4,3535,6,1876,3689,2,0,1,0,-1
EUN1_3574892788',0,22,20,2,0,4,0,9,1,317,94,32355,28984,43341,2,21,16,0,0,0,0,10,292,94,27999,29571,33347,1,25,0,4356,4,-587,9994,2,0,4,0,-1
EUN1_3574839849',2,26,7,1,0,1,0,6,0,356,100,24730,29444,32490,4,22,13,1,0,1,0,3,358,80,27746,30260,30774,0,-2,20,-3016,-6,-816,1716,0,0,0,0,3
EUN1_3574829122',3,29,5,1,0,0,0,8,0,364,108,23749,29029,23380,5,28,12,1,0,1,0,1,348,84,27220,29315,28188,0,16,24,-3471,-7,-286,-4808,0,0,-1,0,7
EUN1_3569846222',2,29,14,0,0,1,0,9,1,347,114,29531,31141,33606,4,20,8,1,0,1,0,4,351,65,25167,27146,37239,1,-4,49,4364,6,3995,-3633,-1,0,0,0,5
EUN1_3569738820',5,44,14,0,0,1,0,12,0,330,83,28556,28288,36433,2,19,27,2,0,2,0,4,328,88,34007,32191,50428,0,2,-5,-5451,-13,-3903,-13995,-2,0,-1,0,8
EUN1_3569714535',2,24,21,0,0,0,0,8,1,282,76,28578,28729,38773,1,36,15,1,0,0,0,3,337,80,27444,29376,32248,1,-55,-4,1134,6,-647,6525,-1,0,0,0,5
EUN1_3569223182',3,39,18,0,0,1,0,6,1,333,88,29067,28156,29189,2,19,11,1,0,1,0,0,337,81,26635,26572,34231,0,-4,7,2432,7,1584,-5042,-1,0,0,0,6
EUN1_3569194196',1,23,11,0,0,1,0,13,0,337,70,26632,27200,29135,3,17,15,1,0,2,0,2,326,80,29660,28035,37161,0,11,-10,-3028,-4,-835,-8026,-1,0,-1,0,11
EUN1_3569159354',3,22,11,1,0,1,0,10,0,302,72,26013,27079,28629,4,383,8,1,0,0,0,1,319,76,23832,27454,26863,1,-17,-4,2181,3,-375,1766,0,0,1,0,9
EUN1_3575893549',3,23,12,2,0,1,0,6,0,341,110,28349,31315,31863,2,57,8,0,0,0,0,6,337,78,24848,29098,32732,1,4,32,3501,4,2217,-869,2,0,1,0,0
EUN1_3575861840',2,76,10,1,0,1,0,13,1,347,84,26370,30522,30940,3,27,8,1,0,2,0,3,350,104,26101,28477,30938,1,-3,-20,269,2,2045,2,0,0,-1,0,10
EUN1_3575849426',4,25,20,2,0,2,0,11,1,366,84,31931,31486,42627,4,22,14,0,0,0,0,3,334,76,28639,30233,28992,1,32,8,3292,6,1253,13635,2,0,2,0,8
EUN1_3575762265',1,27,16,1,0,0,0,8,0,310,88,27646,29320,45946,4,28,21,1,0,1,0,3,318,85,29625,30756,36671,0,-8,3,-1979,-5,-1436,9275,0,0,-1,0,5
EUN1_3575739561',6,75,9,1,0,0,0,13,1,320,74,24698,26046,24169,5,31,9,0,1,1,0,4,374,98,27975,29886,27114,0,-54,-24,-3277,0,-3840,-2945,1,-1,-1,0,9
EUN1_3575724059',5,108,15,1,0,1,0,6,0,359,92,28217,31119,35283,1,51,10,1,0,0,0,3,335,88,24722,28717,30275,1,24,4,3495,5,2402,5008,0,0,1,0,3
EUN1_3575491698',7,28,10,2,0,0,0,10,0,369,98,26619,29358,32095,1,25,12,0,0,2,0,4,389,74,28037,31786,26515,0,-20,24,-1418,-2,-2428,5580,2,0,-2,0,6
EUN1_3575368997',0,27,18,1,0,1,0,10,1,371,90,31557,31382,44207,6,48,15,0,0,1,0,7,350,70,28979,29690,31214,0,21,20,2578,3,1692,12993,1,0,0,0,3
EUN1_3575310831',2,24,5,0,0,0,0,9,0,370,75,24087,26939,23187,2,27,9,1,0,1,0,2,387,88,28047,30164,28376,0,-17,-13,-3960,-4,-3225,-5189,-1,0,-1,0,7
EUN1_3575259532',2,35,13,0,0,3,0,7,0,415,86,30778,32019,36426,2,25,12,1,0,0,0,7,334,100,26194,27940,27645,1,81,-14,4584,1,4079,8781,-1,0,3,0,0
EUN1_3575216620',2,62,17,1,0,0,0,7,1,305,98,28299,30348,31646,3,58,9,0,0,0,0,6,331,101,25653,28797,27343,1,-26,-3,2646,8,1551,4303,1,0,0,0,1
EUN1_3574128747',5,29,16,1,0,1,0,5,0,334,82,27580,27748,36705,5,101,10,0,0,0,0,5,283,68,24273,26444,30900,1,51,14,3307,6,1304,5805,1,0,1,0,0
EUN1_3574117362',2,29,18,0,0,0,0,15,1,286,94,29707,29648,36259,2,35,23,1,0,2,0,3,361,74,33227,30789,42715,0,-75,20,-3520,-5,-1141,-6456,-1,0,-2,0,12
EUN1_3574108212',2,200,15,1,0,1,0,13,0,328,89,29774,31531,34116,3,25,12,1,0,0,0,2,362,86,27914,29344,34719,0,-34,3,1860,3,2187,-603,0,0,1,0,11
EUN1_3573735931',2,20,7,1,0,0,0,11,1,366,76,24641,27793,27386,8,30,10,1,0,2,0,3,415,83,28846,31442,34437,0,-49,-7,-4205,-3,-3649,-7051,0,0,-2,0,8
EUN1_3573719826',1,21,10,1,0,2,0,8,0,362,96,28893,30969,30420,4,24,8,1,1,1,0,6,331,75,23378,29916,18609,1,31,21,5515,2,1053,11811,0,-1,1,0,2
EUN1_3573632294',4,28,15,2,0,0,0,5,1,335,96,28187,29586,34932,2,26,17,0,0,0,0,6,340,70,28651,29834,41532,1,-5,26,-464,-2,-248,-6600,2,0,0,0,-1
EUN1_3573599994',3,25,15,0,0,1,0,7,0,377,95,29782,31667,40801,1,29,9,1,0,1,0,5,343,84,25826,30697,34291,1,34,11,3956,6,970,6510,-1,0,0,0,2
EUN1_3573588430',1,21,8,0,1,0,0,16,0,312,80,26133,28559,30559,1,25,16,2,0,1,0,1,341,115,30053,30972,31751,1,-29,-35,-3920,-8,-2413,-1192,-2,1,-1,0,15
EUN1_3573799205',4,30,20,1,0,2,0,9,0,338,89,31739,30535,37987,5,28,18,1,0,1,0,5,318,90,30913,30016,45102,0,20,-1,826,2,519,-7115,0,0,1,0,4
EUN1_3573777633',9,23,7,0,0,0,0,3,0,364,92,24619,29099,26185,5,26,11,2,1,0,0,1,364,92,26901,29925,26253,0,0,0,-2282,-4,-826,-68,-2,-1,0,0,2
EUN1_3573718891',5,63,13,1,0,2,0,12,0,349,86,28712,29083,28696,3,62,14,0,1,1,0,1,388,81,28530,29887,30133,0,-39,5,182,-1,-804,-1437,1,-1,1,0,11
EUN1_3573708357',1,18,12,0,0,0,0,8,0,312,77,25921,28926,29468,2,33,10,1,0,2,0,4,334,77,26624,27502,36331,1,-22,0,-703,2,1424,-6863,-1,0,-2,0,4
EUN1_3573693114',4,27,7,1,1,0,0,12,0,372,108,25776,30991,28182,5,27,8,1,0,2,0,2,381,72,26217,29775,17447,1,-9,36,-441,-1,1216,10735,0,1,-2,0,10
EUN1_3573657837',4,54,8,0,0,1,0,7,0,403,104,27904,29824,28119,7,37,10,2,0,1,0,6,335,92,26549,29262,27809,0,68,12,1355,-2,562,310,-2,0,0,0,1
EUN1_3573651422',6,37,24,1,0,2,0,9,1,384,84,33389,33697,39926,4,25,11,1,0,1,0,8,332,91,27051,27901,33619,1,52,-7,6338,13,5796,6307,0,0,1,0,1
EUN1_3573637118',2,20,15,0,0,0,0,8,1,357,79,26927,30102,32146,2,17,11,1,1,0,0,1,354,79,26112,29463,36192,0,3,0,815,4,639,-4046,-1,-1,0,0,7
EUN1_3573211533',5,29,14,1,0,0,0,8,1,299,85,27020,28601,37187,7,41,18,1,0,0,0,2,335,74,28335,28973,36202,0,-36,11,-1315,-4,-372,985,0,0,0,0,6
EUN1_3573185839',3,34,10,2,0,0,0,11,1,310,78,24371,28895,34478,3,23,16,0,0,1,0,3,347,74,28435,32156,32369,1,-37,4,-4064,-6,-3261,2109,2,0,-1,0,8
EUN1_3573172172',6,29,14,1,0,0,0,11,0,298,77,27437,28942,37057,1,24,12,0,0,1,0,3,342,72,27999,27498,31467,1,-44,5,-562,2,1444,5590,1,0,-1,0,8
EUN1_3572628961',4,32,11,2,0,1,0,12,0,344,78,27627,30304,37460,2,14,24,0,0,1,0,5,336,108,31825,32468,39596,0,8,-30,-4198,-13,-2164,-2136,2,0,0,0,7
EUN1_3572603749',2,17,6,0,0,0,0,11,0,290,70,22644,27158,30910,3,93,22,2,0,2,0,1,329,110,32092,33325,39674,0,-39,-40,-9448,-16,-6167,-8764,-2,0,-2,0,10
EUN1_3571123940',1,25,14,0,0,1,0,12,1,349,72,29136,29862,38722,6,33,20,2,0,1,0,4,364,108,31162,30886,41742,0,-15,-36,-2026,-6,-1024,-3020,-2,0,0,0,8
EUN1_3571105151',1,24,6,0,0,0,0,8,0,339,94,22950,26856,30321,2,22,14,1,0,2,0,3,372,85,29306,31010,36231,0,-33,9,-6356,-8,-4154,-5910,-1,0,-2,0,5
EUN1_3571060384',3,27,19,1,1,1,0,8,1,309,117,31603,32104,33995,2,82,8,1,0,0,0,3,334,82,24447,29133,26940,1,-25,35,7156,11,2971,7055,0,1,1,0,5
EUN1_3571037393',0,55,8,0,0,0,0,10,0,257,72,22197,26346,23015,2,54,18,0,0,2,0,0,370,110,30549,32935,37241,0,-113,-38,-8352,-10,-6589,-14226,0,0,-2,0,10
EUN1_3570998238',2,26,15,1,0,0,0,8,0,350,104,28749,29370,31204,5,27,9,1,0,0,0,5,328,90,25980,27416,23633,1,22,14,2769,6,1954,7571,0,0,0,0,3
EUN1_3570944223',2,21,10,0,0,0,0,8,0,386,125,28020,32913,27129,7,34,7,2,0,0,0,2,395,92,25946,29893,29165,1,-9,33,2074,3,3020,-2036,-2,0,0,0,6
EUN1_3568475339',3,31,19,2,0,1,0,7,1,353,98,30914,30750,33897,2,33,7,0,0,0,0,5,356,82,24950,26623,25151,1,-3,16,5964,12,4127,8746,2,0,1,0,2
EUN1_3568263105',3,21,7,1,0,0,0,7,0,346,86,25689,29065,28083,4,37,7,0,0,0,0,7,291,102,23575,27885,28776,1,55,-16,2114,0,1180,-693,1,0,0,0,0
EUN1_3568227788',7,30,22,0,0,1,0,6,1,363,88,32410,32535,42505,3,27,5,1,0,0,0,7,308,83,22440,25936,27293,1,55,5,9970,17,6599,15212,-1,0,1,0,-1
EUN1_3568024879',1,86,12,0,0,0,0,13,0,329,78,26772,28096,28305,6,26,18,2,0,2,0,3,352,93,31990,30094,38996,0,-23,-15,-5218,-6,-1998,-10691,-2,0,-2,0,10
EUN1_3561386970',5,43,13,1,0,1,0,9,0,342,82,27639,28450,38105,4,24,17,1,0,1,0,5,362,80,30268,31171,36743,1,-20,2,-2629,-4,-2721,1362,0,0,0,0,4
EUN1_3561370497',4,23,10,0,0,0,0,9,1,385,100,27672,31068,31927,6,24,10,2,0,2,0,4,357,72,26946,29520,33632,1,28,28,726,0,1548,-1705,-2,0,-2,0,5
EUN1_3561342946',3,24,5,1,0,0,0,2,1,375,112,25266,30802,27130,2,25,5,0,1,0,0,5,367,100,24154,28874,20344,0,8,12,1112,0,1928,6786,1,-1,0,0,-3
EUN1_3561136205',6,62,18,1,0,0,0,5,0,351,100,30150,31609,33235,0,61,10,0,0,2,0,4,337,68,25713,28310,26807,0,14,32,4437,8,3299,6428,1,0,-2,0,1
EUN1_3560988549',2,27,5,0,0,0,0,6,1,348,90,23228,27228,20474,2,21,6,1,0,1,0,0,400,86,26138,29526,28086,0,-52,4,-2910,-1,-2298,-7612,-1,0,-1,0,6
EUN1_3560950968',3,24,5,0,0,0,0,8,0,379,72,24209,28928,29523,4,26,14,1,0,0,0,4,346,76,27446,32360,34932,0,33,-4,-3237,-9,-3432,-5409,-1,0,0,0,4
EUN1_3558721545',3,19,13,0,0,0,0,3,1,332,92,27083,28903,32732,2,38,13,2,0,0,0,1,334,95,25904,29405,33599,0,-2,-3,1179,0,-502,-867,-2,0,0,0,2
EUN1_3558690866',3,146,12,1,0,0,0,16,0,295,80,25816,27283,32025,5,41,21,1,1,2,0,1,313,87,32202,29063,32937,0,-18,-7,-6386,-9,-1780,-912,0,-1,-2,0,15
EUN1_3558607916',8,28,20,0,0,0,0,9,1,329,78,29393,28094,41003,1,49,19,1,0,0,0,1,309,85,29960,28905,40423,1,20,-7,-567,1,-811,580,-1,0,0,0,8
EUN1_3558413164',4,37,13,1,0,2,0,6,1,347,98,30612,31585,31798,2,57,14,1,0,0,0,7,347,94,27576,30246,34618,1,0,4,3036,-1,1339,-2820,0,0,2,0,-1
EUN1_3558274076',4,33,14,1,0,1,0,10,1,321,70,27405,26746,36096,3,26,15,1,0,0,0,1,349,81,27819,28873,36681,0,-28,-11,-414,-1,-2127,-585,0,0,1,0,9
EUN1_3558240506',3,22,13,1,0,0,0,9,0,325,102,27805,28686,33497,1,316,18,1,1,1,0,3,334,82,30473,29379,31141,1,-9,20,-2668,-5,-693,2356,0,-1,-1,0,6
EUN1_3558181975',1,25,16,0,0,2,0,5,1,397,96,31881,31926,39853,8,32,6,1,0,0,0,9,324,92,23653,25941,23471,1,73,4,8228,10,5985,16382,-1,0,2,0,-4
EUN1_3558162331',8,29,15,2,0,1,0,8,1,334,90,27896,30414,28982,2,29,16,0,0,0,0,1,364,86,29416,30756,36925,0,-30,4,-1520,-1,-342,-7943,2,0,1,0,7
EUN1_3558133306',4,22,23,2,0,2,0,8,0,356,84,34291,32440,45529,5,24,21,0,0,1,0,6,338,76,31472,30580,38916,1,18,8,2819,2,1860,6613,2,0,1,0,2
EUN1_3558078563',2,20,16,0,0,1,0,7,1,385,92,29988,30409,39193,3,41,15,1,0,1,0,6,305,76,28169,28102,29074,0,80,16,1819,1,2307,10119,-1,0,0,0,1
EUN1_3558060978',2,20,15,0,0,1,0,8,1,380,82,29876,31379,31637,3,26,8,2,0,0,0,4,385,90,26070,30066,26847,1,-5,-8,3806,7,1313,4790,-2,0,1,0,4
EUN1_3557928722',1,15,13,2,0,1,0,7,1,347,108,28900,30402,27416,3,23,11,0,0,0,0,7,302,64,25258,27614,32774,1,45,44,3642,2,2788,-5358,2,0,1,0,0
EUN1_3557891519',4,38,16,1,0,1,0,6,1,340,81,28797,31179,35204,6,29,10,0,0,0,0,3,360,70,25217,30268,27075,1,-20,11,3580,6,911,8129,1,0,1,0,3
EUN1_3557876193',3,134,20,2,0,2,0,5,0,397,116,32231,34007,37122,1,23,11,0,0,0,0,5,392,88,26660,28448,23121,1,5,28,5571,9,5559,14001,2,0,2,0,0
EUN1_3557314819',0,42,12,0,0,1,0,7,1,386,86,29841,30104,30130,7,29,14,1,0,1,0,2,341,84,27981,30256,31222,0,45,2,1860,-2,-152,-1092,-1,0,0,0,5
EUN1_3556844991',2,22,16,1,0,2,0,10,0,314,95,31332,30076,30275,4,36,15,0,0,0,0,10,315,92,28241,29379,32904,1,-1,3,3091,1,697,-2629,1,0,2,0,0
EUN1_3556844520',4,37,11,1,0,0,0,7,0,328,84,25255,30167,26697,3,30,14,0,0,0,0,0,367,92,27868,29742,32699,0,-39,-8,-2613,-3,425,-6002,1,0,0,0,7
EUN1_3556831781',5,60,14,2,0,0,0,14,0,323,82,28382,31405,38141,2,21,20,0,0,3,0,1,335,90,31375,31327,38636,1,-12,-8,-2993,-6,78,-495,2,0,-3,0,13
EUN1_3574797537',5,27,13,1,0,1,0,5,0,314,94,27627,28606,32637,3,26,10,1,0,1,0,4,337,98,27607,28624,24662,0,-23,-4,20,3,-18,7975,0,0,0,0,1
EUN1_3574656357',6,33,15,1,0,0,0,10,1,336,71,27477,27037,37964,3,24,16,1,1,1,0,0,365,96,30623,31026,33785,1,-29,-25,-3146,-1,-3989,4179,0,-1,-1,0,10
EUN1_3574507889',7,28,22,1,0,0,0,9,1,355,86,29655,33040,36928,4,27,7,0,0,0,0,6,337,73,24994,26605,29159,1,18,13,4661,15,6435,7769,1,0,0,0,3
EUN1_3574488337',5,30,11,1,1,0,0,11,0,330,87,27319,28522,28944,1,25,17,1,0,1,0,2,390,100,30851,31556,32845,0,-60,-13,-3532,-6,-3034,-3901,0,1,-1,0,9
EUN1_3572168907',8,60,7,0,0,0,0,9,0,269,74,22813,25827,24742,6,26,18,2,0,2,0,3,377,114,31136,32697,37827,0,-108,-40,-8323,-11,-6870,-13085,-2,0,-2,0,6
EUN1_3572035887',5,27,19,1,0,1,0,9,0,341,84,30733,30733,37276,3,27,15,1,0,0,0,7,350,78,28139,29084,33327,1,-9,6,2594,4,1649,3949,0,0,1,0,2
EUN1_3570786392',3,26,7,0,0,0,0,10,1,328,84,24063,27473,27432,3,23,18,2,1,1,0,0,413,80,31329,31863,36470,0,-85,4,-7266,-11,-4390,-9038,-2,-1,-1,0,10
EUN1_3570644628',5,32,15,0,0,1,0,13,1,339,94,29086,30251,36972,4,27,16,2,1,1,0,4,367,97,30417,31947,37519,0,-28,-3,-1331,-1,-1696,-547,-2,-1,0,0,9
EUN1_3574467257',4,22,7,0,0,0,0,8,0,358,80,23478,30388,23524,5,30,13,2,1,2,0,1,401,82,29470,30509,25638,0,-43,-2,-5992,-6,-121,-2114,-2,-1,-2,0,7
EUN1_3574434887',1,26,17,0,0,2,0,12,0,365,88,31181,32551,36453,2,41,15,1,0,2,0,6,371,84,30480,31476,34574,1,-6,4,701,2,1075,1879,-1,0,0,0,6
EUN1_3574207527',4,28,12,0,0,0,0,13,0,374,94,27975,30146,33932,8,36,17,1,0,0,0,2,337,76,28561,30026,33818,1,37,18,-586,-5,120,114,-1,0,0,0,11
EUN1_3574133107',5,36,14,0,1,0,0,5,1,382,82,28716,30550,31786,4,27,14,2,0,0,0,4,367,90,28197,28456,31775,0,15,-8,519,0,2094,11,-2,1,0,0,1
EUN1_3576234469',3,19,20,1,0,1,0,7,0,344,68,29426,31564,36780,4,27,14,1,0,0,0,1,329,91,25794,29217,35681,1,15,-23,3632,6,2347,1099,0,0,1,0,6
EUN1_3576219984',3,23,23,2,1,2,0,7,0,349,94,32852,34588,41067,0,21,5,0,0,1,0,10,328,90,23410,28438,22814,1,21,4,9442,18,6150,18253,2,1,1,0,-3
EUN1_3568535114',3,23,20,0,0,0,0,7,1,339,88,30893,29738,36294,6,24,11,2,0,1,0,5,303,78,26334,26955,32038,1,36,10,4559,9,2783,4256,-2,0,-1,0,2
EUN1_3568509886',4,38,15,0,0,0,0,12,0,296,78,27235,29280,33058,3,32,18,2,0,2,0,1,354,86,29815,28973,34973,1,-58,-8,-2580,-3,307,-1915,-2,0,-2,0,11
EUN1_3568490883',3,26,19,1,0,1,0,14,0,317,72,28931,29916,41259,1,29,14,0,0,1,0,5,288,88,27173,26577,38690,1,29,-16,1758,5,3339,2569,1,0,0,0,9
EUN1_3568475768',4,28,12,0,0,0,0,9,0,365,92,27417,31196,30032,2,18,4,2,0,0,0,3,362,81,22632,27202,27357,1,3,11,4785,8,3994,2675,-2,0,0,0,6
EUN1_3568460974',3,24,8,0,0,0,0,10,0,328,82,24235,29202,27451,3,25,12,1,0,1,0,2,369,102,28089,30832,32530,0,-41,-20,-3854,-4,-1630,-5079,-1,0,-1,0,8
EUN1_3568473115',5,22,19,1,0,3,0,2,0,369,108,32115,31610,32807,1,23,4,1,0,0,0,10,332,83,21616,26594,21049,1,37,25,10499,15,5016,11758,0,0,3,0,-8
EUN1_3564341333',3,26,14,0,0,1,0,7,1,316,86,27759,28725,32841,3,26,17,1,0,0,0,3,311,121,29558,30577,38284,0,5,-35,-1799,-3,-1852,-5443,-1,0,1,0,4
EUN1_3564322619',2,36,17,2,0,1,0,10,0,276,75,28406,28112,39841,2,153,21,0,0,1,0,4,277,76,29529,27631,39269,1,-1,-1,-1123,-4,481,572,2,0,0,0,6
EUN1_3563418687',2,26,9,1,0,0,0,4,1,308,98,25978,28543,35055,7,91,12,0,0,0,0,2,288,58,24911,26368,28244,1,20,40,1067,-3,2175,6811,1,0,0,0,2
EUN1_3563390971',4,29,10,0,0,1,0,10,1,318,68,25872,28354,31457,2,27,12,2,0,1,0,5,364,119,28844,30717,35244,0,-46,-51,-2972,-2,-2363,-3787,-2,0,0,0,5
EUN1_3563383163',3,23,7,0,0,0,0,12,0,284,80,24206,26538,28517,5,25,21,1,1,2,0,0,365,86,32115,31513,37040,0,-81,-6,-7909,-14,-4975,-8523,-1,-1,-2,0,12
EUN1_3563369121',4,27,9,0,0,0,0,14,0,287,57,24617,25467,35251,6,28,28,1,0,2,0,1,367,106,35880,33074,56473,0,-80,-49,-11263,-19,-7607,-21222,-1,0,-2,0,13
EUN1_3563345400',4,30,24,2,1,1,0,10,1,330,80,32300,30161,44383,1,81,13,0,0,1,0,3,327,80,29289,28242,32128,1,3,0,3011,11,1919,12255,2,1,0,0,7
EUN1_3561766201',3,42,11,2,0,0,0,2,1,322,84,24889,28242,27676,3,34,8,0,0,0,0,3,310,88,24127,26890,28189,1,12,-4,762,3,1352,-513,2,0,0,0,-1
EUN1_3561746807',3,30,9,1,0,0,0,6,1,273,84,24791,25315,28939,2,31,18,1,0,0,0,1,358,100,30111,30269,38255,0,-85,-16,-5320,-9,-4954,-9316,0,0,0,0,5
EUN1_3561729007',0,18,22,1,0,1,0,5,0,328,71,31669,30621,41980,6,37,13,0,0,1,0,6,271,70,25642,25963,37973,0,57,1,6027,9,4658,4007,1,0,0,0,-1
EUN1_3561724430',6,28,21,2,0,1,0,10,1,367,110,32420,33472,41492,2,19,9,0,0,0,0,3,296,82,25844,25615,31709,1,71,28,6576,12,7857,9783,2,0,1,0,7
EUN1_3561025498',3,265,18,1,1,1,0,8,0,372,78,30541,32084,34677,5,21,12,1,0,0,0,5,351,98,27250,31381,31026,1,21,-20,3291,6,703,3651,0,1,1,0,3
EUN1_3576058600',4,30,12,2,0,0,0,10,0,359,106,28237,31638,30294,4,132,9,0,0,2,0,4,339,78,25538,29092,27867,0,20,28,2699,3,2546,2427,2,0,-2,0,6
EUN1_3576025662',5,30,16,0,0,0,0,10,0,325,100,26780,31657,32317,3,24,17,1,0,1,0,1,358,80,28837,33586,34876,0,-33,20,-2057,-1,-1929,-2559,-1,0,-1,0,9
EUN1_3575826906',1,25,11,0,0,0,0,7,1,339,76,25984,27716,33708,7,26,15,2,0,2,0,4,334,88,29475,29085,31722,0,5,-12,-3491,-4,-1369,1986,-2,0,-2,0,3
EUN1_3575806797',4,25,17,1,0,1,0,7,1,376,86,30153,31305,33321,2,31,19,1,0,1,0,8,340,102,32509,32578,42683,0,36,-16,-2356,-2,-1273,-9362,0,0,0,0,-1
EUN1_3574229678',1,19,13,1,0,0,0,9,0,344,78,25467,30432,25871,3,148,10,0,1,2,0,0,328,82,27258,28909,29890,0,16,-4,-1791,3,1523,-4019,1,-1,-2,0,9
EUN1_3565245521',7,189,5,0,0,0,0,11,0,331,82,23144,27303,18750,1,23,18,2,0,3,0,4,343,78,29590,30498,35607,0,-12,4,-6446,-13,-3195,-16857,-2,0,-3,0,7
EUN1_3565225598',7,30,8,1,0,1,0,6,1,326,84,24928,28815,27450,2,133,7,1,0,0,0,4,342,95,24785,28267,28895,0,-16,-11,143,1,548,-1445,0,0,1,0,2
EUN1_3565214589',6,30,12,1,0,2,0,9,1,370,92,29457,30876,32164,4,31,5,1,0,0,0,5,385,104,24341,28820,21039,1,-15,-12,5116,7,2056,11125,0,0,2,0,4
EUN1_3564836372',4,45,14,0,0,2,0,9,1,338,72,28797,28868,28412,2,21,14,2,0,1,0,6,313,96,27354,30321,31212,0,25,-24,1443,0,-1453,-2800,-2,0,1,0,3
EUN1_3564826320',3,25,7,0,0,0,0,10,0,299,80,23480,26508,28802,3,30,22,1,0,3,0,2,355,72,31874,31887,40187,0,-56,8,-8394,-15,-5379,-11385,-1,0,-3,0,8
EUN1_3564806973',6,28,10,1,0,0,0,6,1,296,84,24295,26235,27208,3,26,17,0,0,1,0,2,396,72,30099,32186,36028,0,-100,12,-5804,-7,-5951,-8820,1,0,-1,0,4
EUN1_3564793784',2,24,7,0,0,0,0,10,0,286,110,25231,27657,29394,4,31,21,2,1,0,0,1,327,100,29244,31864,35877,0,-41,10,-4013,-14,-4207,-6483,-2,-1,0,0,9
EUN1_3564786416',5,28,12,1,0,2,0,12,1,385,94,28910,30982,31565,2,34,8,0,0,2,0,4,362,86,27587,29907,25169,0,23,8,1323,4,1075,6396,1,0,0,0,8
EUN1_3564762970',1,21,12,0,0,0,0,5,0,379,74,28181,29989,33021,5,152,14,2,0,1,0,1,359,86,28474,31721,39696,0,20,-12,-293,-2,-1732,-6675,-2,0,-1,0,4
EUN1_3564590578',3,23,7,0,0,0,0,11,0,334,72,24343,27014,30863,4,24,20,2,0,1,0,3,367,76,30547,30726,35094,0,-33,-4,-6204,-13,-3712,-4231,-2,0,-1,0,8
EUN1_3564553065',2,88,16,1,1,0,0,8,0,282,74,28113,26992,36485,2,23,13,0,0,1,0,3,326,66,27598,26643,32764,1,-44,8,515,3,349,3721,1,1,-1,0,5
EUN1_3564525602',5,27,14,1,0,2,0,7,1,348,85,28666,30634,28767,1,32,9,0,0,1,0,8,318,94,25733,28669,32054,0,30,-9,2933,5,1965,-3287,1,0,1,0,-1
EUN1_3564494351',0,27,11,1,0,0,0,4,0,350,100,28794,30065,29830,5,30,16,1,0,1,0,6,321,96,27873,30935,30932,1,29,4,921,-5,-870,-1102,0,0,-1,0,-2
EUN1_3564447293',2,21,14,0,0,0,0,12,0,321,76,27671,29171,30921,3,24,17,1,0,1,0,4,343,97,29785,30673,36847,0,-22,-21,-2114,-3,-1502,-5926,-1,0,-1,0,8
EUN1_3574676496',6,30,18,1,1,2,0,9,1,347,86,30053,29476,36498,3,31,13,0,0,0,0,9,295,77,26870,28407,30058,1,52,9,3183,5,1069,6440,1,1,2,0,0
EUN1_3574671181',2,204,13,2,0,1,0,5,0,337,76,27126,29887,26084,4,16,7,0,0,0,0,2,336,86,24221,27862,24819,1,1,-10,2905,6,2025,1265,2,0,1,0,3
EUN1_3573246510',4,60,12,0,0,0,0,12,1,332,86,26896,28139,42687,4,29,16,1,0,2,0,2,352,70,29726,30118,38465,0,-20,16,-2830,-4,-1979,4222,-1,0,-2,0,10
EUN1_3573211062',3,30,13,0,0,0,0,7,0,302,75,26466,29460,32202,4,26,15,1,0,0,0,1,317,72,27384,28253,30910,0,-15,3,-918,-2,1207,1292,-1,0,0,0,6
EUN1_3569783092',7,27,13,1,0,0,0,10,1,329,78,26099,28682,24703,6,33,11,1,0,1,0,2,325,86,26891,28239,28233,1,4,-8,-792,2,443,-3530,0,0,-1,0,8
EUN1_3569743533',5,21,7,0,0,0,0,4,0,364,86,25821,28382,26691,6,71,17,2,0,0,0,7,272,90,25979,29128,30114,0,92,-4,-158,-10,-746,-3423,-2,0,0,0,-3
EUN1_3569713989',3,33,20,2,0,2,0,9,1,402,124,33086,35069,34045,1,134,5,0,0,1,0,4,294,64,21239,26233,29397,1,108,60,11847,15,8836,4648,2,0,1,0,5
EUN1_3569684452',5,22,8,1,0,0,0,7,1,335,81,26261,30497,24553,2,25,10,1,1,2,0,3,360,94,26821,31127,23762,0,-25,-13,-560,-2,-630,791,0,-1,-2,0,4
EUN1_3568687092',3,23,22,2,0,0,0,8,1,319,84,29090,29537,38907,3,270,9,0,0,1,0,1,341,76,24731,27088,29328,1,-22,8,4359,13,2449,9579,2,0,-1,0,7
EUN1_3568647196',0,20,15,1,1,0,0,5,1,348,62,27152,29936,36418,4,53,9,0,0,0,0,4,323,74,24654,28685,32208,1,25,-12,2498,6,1251,4210,1,1,0,0,1
EUN1_3568606609',0,30,18,1,1,0,0,9,1,336,97,28490,31061,34421,5,26,11,0,0,1,0,1,309,68,26329,28516,30272,1,27,29,2161,7,2545,4149,1,1,-1,0,8
EUN1_3568590081',3,19,8,2,0,1,0,8,1,348,98,25716,28372,31264,2,17,8,0,0,0,0,3,282,68,23419,27017,24005,1,66,30,2297,0,1355,7259,2,0,1,0,5
EUN1_3568569621',3,25,7,0,0,0,0,8,0,301,92,23665,26812,24961,8,31,15,2,1,1,0,1,346,90,28103,30510,32771,0,-45,2,-4438,-8,-3698,-7810,-2,-1,-1,0,7
EUN1_3568544458',2,45,3,0,0,0,0,13,1,375,93,23350,29457,17413,2,40,7,2,0,2,0,0,419,98,27794,31289,22103,0,-44,-5,-4444,-4,-1832,-4690,-2,0,-2,0,13
EUN1_3568325297',0,47,9,0,0,0,0,12,0,292,78,24666,26336,25566,7,32,11,1,0,2,0,0,357,72,27898,28436,31925,0,-65,6,-3232,-2,-2100,-6359,-1,0,-2,0,12
EUN1_3568304101',4,22,15,0,0,1,0,7,1,368,78,29514,30193,31902,2,27,10,1,0,0,0,4,321,114,26351,28251,30152,0,47,-36,3163,5,1942,1750,-1,0,1,0,3
EUN1_3568272847',4,30,8,1,1,0,0,4,1,332,76,24198,26261,20411,7,36,8,0,0,0,0,2,358,92,25339,29643,24655,0,-26,-16,-1141,0,-3382,-4244,1,1,0,0,2
EUN1_3566860753',5,30,8,0,1,0,0,7,1,347,74,25041,28717,30973,3,68,11,2,0,1,0,1,356,94,27475,30679,34671,0,-9,-20,-2434,-3,-1962,-3698,-2,1,-1,0,6
EUN1_3566834769',3,31,15,0,0,0,0,15,1,304,58,27206,30583,32450,0,20,12,1,0,3,0,1,350,92,29776,30223,33665,0,-46,-34,-2570,3,360,-1215,-1,0,-3,0,14
EUN1_3575864957',2,16,13,1,0,0,0,7,0,330,82,26721,28713,31500,9,31,21,1,0,2,0,7,348,69,31624,30563,39026,0,-18,13,-4903,-8,-1850,-7526,0,0,-2,0,0
EUN1_3575849829',1,23,22,2,0,3,0,14,0,366,92,33247,33250,43784,2,30,14,0,0,2,0,7,316,80,27864,27855,38355,1,50,12,5383,8,5395,5429,2,0,1,0,7
EUN1_3575828402',3,27,11,0,0,0,0,7,1,396,88,28479,31183,29944,3,22,9,1,1,0,0,5,354,83,25480,31416,23163,1,42,5,2999,2,-233,6781,-1,-1,0,0,2
EUN1_3575783878',3,27,15,2,0,0,0,7,1,335,96,28698,31161,38811,6,144,17,0,0,1,0,2,351,74,28619,30579,37083,1,-16,22,79,-2,582,1728,2,0,-1,0,5
EUN1_3575769197',5,37,10,0,0,0,0,4,0,322,60,25306,27164,27790,3,22,14,1,0,1,0,1,361,80,27045,30241,29830,0,-39,-20,-1739,-4,-3077,-2040,-1,0,-1,0,3
EUN1_3575744804',4,21,6,1,0,0,0,5,0,377,79,24256,29229,24036,4,141,12,0,0,0,0,2,394,94,26965,30814,30667,1,-17,-15,-2709,-6,-1585,-6631,1,0,0,0,3
EUN1_3575622398',4,391,14,1,0,1,0,11,0,370,88,30257,30454,30295,2,135,9,1,1,2,0,9,294,83,24739,28211,20732,1,76,5,5518,5,2243,9563,0,-1,-1,0,2
EUN1_3575582895',3,19,9,1,0,1,0,12,0,286,76,24530,27553,20326,2,32,12,0,0,1,0,1,343,76,27699,29329,41564,1,-57,0,-3169,-3,-1776,-21238,1,0,0,0,11
EUN1_3575761235',1,21,14,1,0,0,0,4,0,344,104,27483,30305,31817,4,28,10,1,0,0,0,1,362,71,27309,28136,27692,1,-18,33,174,4,2169,4125,0,0,0,0,3
EUN1_3573043272',6,27,4,0,0,0,0,7,0,373,90,23707,28276,26469,7,52,11,2,0,0,0,0,375,93,26693,30100,27673,0,-2,-3,-2986,-7,-1824,-1204,-2,0,0,0,7
EUN1_3572994806',0,34,13,0,0,1,0,11,0,347,94,28291,29416,40074,5,27,13,1,0,1,0,5,331,54,27152,27651,32519,1,16,40,1139,0,1765,7555,-1,0,0,0,6
EUN1_3572981669',3,22,10,0,0,0,0,10,0,318,60,24428,27137,30482,0,251,17,2,0,1,0,1,381,72,29108,29516,37313,0,-63,-12,-4680,-7,-2379,-6831,-2,0,-1,0,9
EUN1_3572987126',3,25,31,1,0,2,0,8,1,326,88,35690,32398,55663,6,414,13,0,0,0,0,9,339,56,27398,27140,41282,1,-13,32,8292,18,5258,14381,1,0,2,0,-1
EUN1_3571993851',3,21,7,0,0,0,0,10,1,382,110,26029,29672,30425,4,50,14,2,0,1,0,2,357,86,28638,32320,33066,0,25,24,-2609,-7,-2648,-2641,-2,0,-1,0,8
EUN1_3571981382',2,86,13,1,0,0,0,3,1,346,94,26187,30564,31903,6,29,4,1,0,0,0,2,376,77,22995,27310,22807,0,-30,17,3192,9,3254,9096,0,0,0,0,1
EUN1_3571963694',5,146,16,0,0,1,0,7,1,320,84,28456,28294,37441,3,34,11,2,0,0,0,5,326,52,25604,26217,32394,1,-6,32,2852,5,2077,5047,-2,0,1,0,2
EUN1_3571955099',2,454,10,2,0,1,0,11,1,344,75,25821,26492,23987,4,27,17,0,0,2,0,7,339,68,30399,31337,36436,1,5,7,-4578,-7,-4845,-12449,2,0,-1,0,4
EUN1_3571945080',6,139,8,1,0,1,0,4,1,377,86,25494,28930,25604,9,42,10,1,0,0,0,3,327,106,25144,28905,21532,0,50,-20,350,-2,25,4072,0,0,1,0,1
EUN1_3571899467',4,29,2,0,0,0,0,12,0,380,53,21419,25351,23431,5,35,14,2,1,2,0,2,380,112,28564,31731,30758,0,0,-59,-7145,-12,-6380,-7327,-2,-1,-2,0,10
EUN1_3571890913',2,24,8,2,0,0,0,13,0,337,102,25013,28203,28727,1,288,16,0,0,3,0,3,363,90,30839,31114,33579,0,-26,12,-5826,-8,-2911,-4852,2,0,-3,0,10
EUN1_3569961867',3,143,6,1,0,2,0,4,0,374,90,25646,29589,30185,4,22,3,1,0,0,0,4,341,112,22600,28425,21160,1,33,-22,3046,3,1164,9025,0,0,2,0,0
EUN1_3569963176',6,24,6,0,0,0,0,5,1,357,84,23449,27908,28784,4,39,8,2,0,1,0,1,342,96,24850,28918,29737,1,15,-12,-1401,-2,-1010,-953,-2,0,-1,0,4
EUN1_3569950289',3,30,13,1,0,0,0,11,1,318,82,26075,28151,33177,2,24,11,0,0,0,0,5,333,85,26583,30129,29141,1,-15,-3,-508,2,-1978,4036,1,0,0,0,6
EUN1_3569944377',1,242,13,1,0,1,0,6,1,355,68,27294,29098,32524,0,25,9,1,0,0,0,6,334,104,26089,29815,34185,1,21,-36,1205,4,-717,-1661,0,0,1,0,0
EUN1_3569936816',4,27,11,0,0,1,0,11,0,323,76,27379,28695,31583,5,212,11,2,0,0,0,6,386,72,25569,30421,26220,0,-63,4,1810,0,-1726,5363,-2,0,1,0,5
EUN1_3569372382',2,23,10,1,0,0,0,5,1,407,87,27431,29541,24547,0,46,5,0,0,1,0,6,360,88,23277,29041,26701,1,47,-1,4154,5,500,-2154,1,0,-1,0,-1
EUN1_3569370358',10,39,13,1,0,1,0,10,0,319,84,26606,27658,32019,1,26,11,1,1,2,0,3,308,80,26386,28746,29499,0,11,4,220,2,-1088,2520,0,-1,-1,0,7
EUN1_3569368574',5,43,17,1,0,0,0,6,1,319,82,26962,29162,30702,3,35,8,1,0,0,0,4,346,80,24916,28049,35260,1,-27,2,2046,9,1113,-4558,0,0,0,0,2
EUN1_3569356689',8,37,10,0,0,0,0,7,0,364,80,26566,30620,32785,3,27,10,2,1,1,0,0,396,94,26851,32492,31257,0,-32,-14,-285,0,-1872,1528,-2,-1,-1,0,7
EUN1_3569343721',1,20,15,0,0,2,0,15,1,307,74,29210,28258,29805,4,19,21,1,0,1,0,7,316,98,32069,30737,40120,0,-9,-24,-2859,-6,-2479,-10315,-1,0,1,0,8
EUN1_3569320990',2,368,13,0,0,1,0,14,0,334,60,26410,27255,34943,2,26,20,1,0,2,0,4,277,88,30619,28237,35809,0,57,-28,-4209,-7,-982,-866,-1,0,-1,0,10
EUN1_3569295839',1,36,20,1,0,1,0,7,0,316,72,29400,30189,32559,2,506,7,1,0,0,0,1,294,76,22537,25154,29467,1,22,-4,6863,13,5035,3092,0,0,1,0,6
EUN1_3569135869',4,20,13,2,1,0,0,11,1,333,102,26587,30679,38579,4,33,13,0,0,0,0,1,328,90,26254,30467,37264,1,5,12,333,0,212,1315,2,1,0,0,10
EUN1_3569104864',3,25,14,1,0,1,0,6,0,331,84,28545,27120,34958,3,23,14,1,0,0,0,5,325,84,27785,27833,30205,1,6,0,760,0,-713,4753,0,0,1,0,1
EUN1_3569033966',6,28,16,1,0,1,0,9,0,343,77,28565,32154,36138,5,151,13,0,1,0,0,4,329,74,26420,31912,35621,0,14,3,2145,3,242,517,1,-1,1,0,5
EUN1_3569021361',3,34,7,1,0,0,0,10,1,376,86,24298,29152,26012,1,98,8,1,0,1,0,1,412,86,27640,31555,25123,0,-36,0,-3342,-1,-2403,889,0,0,-1,0,9
EUN1_3561294951',3,29,12,1,0,1,0,9,1,355,108,28906,30899,29424,4,25,11,1,0,0,0,5,342,76,25977,28565,30852,1,13,32,2929,1,2334,-1428,0,0,1,0,4
EUN1_3561285457',6,29,14,1,1,0,0,7,0,317,86,27370,28801,31926,2,38,16,0,0,1,0,0,378,90,29410,30983,44660,1,-61,-4,-2040,-2,-2182,-12734,1,1,-1,0,7
EUN1_3561271158',5,28,20,2,0,1,0,7,1,332,89,31115,29037,38305,3,51,9,0,0,1,0,9,308,81,25258,26859,25658,1,24,8,5857,11,2178,12647,2,0,0,0,-2
EUN1_3573145300',2,99,15,0,0,0,0,15,0,328,76,27305,31144,32222,2,74,5,1,0,3,0,0,376,91,25280,27955,23682,0,-48,-15,2025,10,3189,8540,-1,0,-3,0,15
EUN1_3573030413',4,24,4,0,0,0,0,9,1,373,84,23404,28427,22668,4,27,14,2,0,0,0,3,353,124,28933,32796,35465,0,20,-40,-5529,-10,-4369,-12797,-2,0,0,0,6
EUN1_3572534757',3,26,13,0,0,0,0,8,0,348,90,28066,29237,35870,4,30,19,2,0,1,0,4,360,90,30700,31018,38817,1,-12,0,-2634,-6,-1781,-2947,-2,0,-1,0,4
EUN1_3572509533',3,50,18,1,0,1,0,9,0,334,94,31239,31409,43013,4,78,14,1,0,1,0,7,354,70,28015,28032,36267,1,-20,24,3224,4,3377,6746,0,0,0,0,2
EUN1_3572323359',4,31,13,0,0,0,0,7,0,365,99,29428,29090,24188,1,32,13,2,0,3,0,6,326,80,26457,28521,26557,1,39,19,2971,0,569,-2369,-2,0,-3,0,1
EUN1_3570747240',5,26,17,2,0,0,0,12,1,291,92,29149,29594,41045,2,19,16,0,1,3,0,4,321,72,28407,28705,35333,1,-30,20,742,1,889,5712,2,-1,-3,0,8
EUN1_3570693980',1,23,19,2,0,1,0,7,1,362,124,32970,33554,38798,0,31,10,0,0,0,0,7,335,92,25010,29060,29083,1,27,32,7960,9,4494,9715,2,0,1,0,0
EUN1_3570686155',2,29,16,0,0,0,0,14,0,311,64,27532,28521,32808,1,23,18,2,0,2,0,1,348,86,30602,28912,36581,0,-37,-22,-3070,-2,-391,-3773,-2,0,-2,0,13
EUN1_3568416059',3,18,10,0,0,0,0,10,1,347,62,25416,26607,26265,3,29,17,1,0,1,0,6,369,102,30119,31198,33176,0,-22,-40,-4703,-7,-4591,-6911,-1,0,-1,0,4
EUN1_3568279446',4,23,14,0,0,0,0,10,1,310,76,27318,28756,29116,4,29,19,1,0,1,0,7,326,84,30655,30250,36194,1,-16,-8,-3337,-5,-1494,-7078,-1,0,-1,0,3
EUN1_3568255347',1,25,13,1,1,1,0,9,1,378,96,29128,31059,25746,0,18,13,0,0,0,0,5,300,100,27325,27715,22449,1,78,-4,1803,0,3344,3297,1,1,1,0,4
EUN1_3568188362',5,140,21,2,0,3,0,11,1,383,110,34004,34216,41017,0,30,10,0,0,0,0,5,297,76,26137,29616,24150,1,86,34,7867,11,4600,16867,2,0,3,0,6
EUN1_3568147628',3,29,21,1,0,1,0,10,0,376,98,33138,32565,42995,6,42,9,0,0,1,0,8,306,78,24013,25703,29014,1,70,20,9125,12,6862,13981,1,0,0,0,2
EUN1_3568126969',6,28,9,0,0,0,0,15,0,338,68,24916,26773,30473,6,107,16,2,0,2,0,1,394,92,32239,32314,33159,0,-56,-24,-7323,-7,-5541,-2686,-2,0,-2,0,14
EUN1_3568120242',5,26,16,2,0,0,0,10,0,325,81,27676,28947,34480,4,31,16,0,1,1,0,2,347,81,28291,29270,40647,0,-22,0,-615,0,-323,-6167,2,-1,-1,0,8
EUN1_3566351400',5,27,14,2,0,2,0,12,0,367,80,29557,30009,28861,6,28,16,0,0,2,0,6,320,104,29614,30739,33704,1,47,-24,-57,-2,-730,-4843,2,0,0,0,6
EUN1_3565671502',1,24,11,0,0,0,0,15,1,351,68,26916,27259,29566,1,17,18,2,0,2,0,1,328,104,31165,32095,40232,0,23,-36,-4249,-7,-4836,-10666,-2,0,-2,0,14
EUN1_3565653552',3,30,12,1,0,0,0,7,1,263,75,25392,25137,36329,4,27,23,0,0,1,0,2,334,84,30788,29522,43667,0,-71,-9,-5396,-11,-4385,-7338,1,0,-1,0,5
EUN1_3568456389',4,25,13,1,0,0,0,15,0,313,76,26347,30132,32398,6,321,16,1,0,2,0,1,346,80,29205,28858,36479,1,-33,-4,-2858,-3,1274,-4081,0,0,-2,0,14
EUN1_3568422542',0,11,4,0,0,0,0,14,0,296,80,22216,25540,21746,2,18,16,1,1,4,0,3,379,94,29659,33389,32860,0,-83,-14,-7443,-12,-7849,-11114,-1,-1,-4,0,11
EUN1_3568412009',4,65,7,1,0,1,0,7,1,391,98,26296,30403,21354,2,58,7,1,0,0,0,4,373,98,26039,29140,31383,1,18,0,257,0,1263,-10029,0,0,1,0,3
EUN1_3566842100',2,17,8,0,0,0,0,10,0,321,78,24610,29386,22569,3,22,13,2,0,2,0,3,347,106,28825,30214,41787,0,-26,-28,-4215,-5,-828,-19218,-2,0,-2,0,7
EUN1_3561219424',3,26,21,1,0,0,0,12,1,312,79,32010,28228,44101,3,22,12,1,1,2,0,2,291,75,26113,25508,36865,1,21,4,5897,9,2720,7236,0,-1,-2,0,10
EUN1_3561211366',5,30,16,2,0,0,0,8,1,347,76,29509,31257,36856,7,24,13,0,0,1,0,8,356,108,29859,31037,35245,1,-9,-32,-350,3,220,1611,2,0,-1,0,0
EUN1_3561204322',7,20,18,2,1,0,0,11,1,344,84,30057,30772,40699,3,27,13,0,0,2,0,4,325,66,27538,27889,33163,1,19,18,2519,5,2883,7536,2,1,-2,0,7
EUN1_3561197411',5,29,11,2,0,0,0,6,1,353,96,26669,28736,34251,1,21,9,0,0,0,0,3,360,75,26741,29797,31430,0,-7,21,-72,2,-1061,2821,2,0,0,0,3
EUN1_3560835554',4,301,12,1,0,0,0,8,1,351,92,27393,29241,30290,4,30,14,0,0,1,0,2,382,80,29341,29531,36351,0,-31,12,-1948,-2,-290,-6061,1,0,-1,0,6
EUN1_3560812868',3,168,10,1,1,1,0,4,1,313,72,25330,29362,27309,3,31,16,1,0,0,0,5,323,72,26688,29240,35755,1,-10,0,-1358,-6,122,-8446,0,1,1,0,-1
EUN1_3560802460',5,241,8,0,1,0,0,9,0,335,83,24548,29479,20144,5,26,9,1,0,1,0,4,361,107,27495,29533,24393,0,-26,-24,-2947,-1,-54,-4249,-1,1,-1,0,5
EUN1_3560792102',2,237,11,0,0,0,0,12,0,327,79,27211,30938,30197,0,23,20,2,0,0,0,2,312,108,29094,29698,33225,0,15,-29,-1883,-9,1240,-3028,-2,0,0,0,10
EUN1_3560776296',1,35,14,1,0,1,0,12,1,361,90,30345,30266,36398,7,213,15,1,1,1,0,2,338,94,29390,29683,32425,1,23,-4,955,-1,583,3973,0,-1,0,0,10
EUN1_3559919233',6,119,1,0,0,0,0,7,1,339,94,21296,27057,11022,2,27,9,1,0,1,0,1,414,86,27162,30399,20785,0,-75,8,-5866,-8,-3342,-9763,-1,0,-1,0,6
EUN1_3559862352',3,25,14,0,0,0,0,11,1,358,91,27034,29330,33250,4,256,16,2,1,2,0,2,355,108,30947,30770,34748,0,3,-17,-3913,-2,-1440,-1498,-2,-1,-2,0,9
EUN1_3559829913',7,49,16,1,0,3,0,6,0,385,85,31873,29915,33576,5,31,10,1,0,0,0,6,298,62,26292,26926,28667,1,87,23,5581,6,2989,4909,0,0,3,0,0
EUN1_3559802078',7,62,14,1,0,0,0,11,0,325,92,26881,30330,33841,4,56,13,1,0,2,0,5,315,76,28541,27505,32472,1,10,16,-1660,1,2825,1369,0,0,-2,0,6
EUN1_3559771545',1,27,9,0,1,2,0,5,1,356,98,27171,29333,29837,3,42,5,2,0,0,0,7,332,106,24593,27779,25525,0,24,-8,2578,4,1554,4312,-2,1,2,0,-2
EUN1_3559743577',6,39,11,0,0,0,0,7,1,300,56,25054,23427,29339,5,31,11,1,0,1,0,5,341,88,27305,25947,28160,0,-41,-32,-2251,0,-2520,1179,-1,0,-1,0,2
EUN1_3558395907',2,38,22,1,0,2,0,9,1,314,104,32189,30373,37369,4,42,12,1,0,0,0,3,293,76,26615,28215,34077,1,21,28,5574,10,2158,3292,0,0,2,0,6
EUN1_3558365258',2,28,10,0,0,1,0,12,0,352,74,26475,27439,27274,5,39,17,1,0,1,0,2,335,93,30871,29893,35670,0,17,-19,-4396,-7,-2454,-8396,-1,0,0,0,10
EUN1_3558327066',2,27,15,1,0,0,0,7,0,245,84,26142,25685,35657,4,363,16,1,1,2,0,2,308,88,30749,28937,37074,0,-63,-4,-4607,-1,-3252,-1417,0,-1,-2,0,5
EUN1_3574578848',2,24,12,1,0,0,0,9,1,328,85,27010,29189,34253,4,26,14,0,0,2,0,2,359,94,29321,30683,32359,0,-31,-9,-2311,-2,-1494,1894,1,0,-2,0,7
EUN1_3574575688',0,22,13,1,0,1,0,6,1,372,86,28571,30563,36843,6,25,5,0,0,0,0,4,353,86,23133,30928,23924,1,19,0,5438,8,-365,12919,1,0,1,0,2
EUN1_3573098087',4,24,13,2,0,1,0,11,0,399,106,29507,33860,28986,3,31,7,0,0,0,0,5,402,105,26330,30840,20900,0,-3,1,3177,6,3020,8086,2,0,1,0,6
EUN1_3573064212',0,24,9,0,0,1,0,8,0,334,92,26789,26993,32383,3,28,21,2,0,1,0,4,340,82,30242,29307,33059,1,-6,10,-3453,-12,-2314,-676,-2,0,0,0,4
EUN1_3573043333',2,21,13,0,0,0,0,11,0,320,75,27142,28178,36423,1,34,22,1,1,2,0,5,379,80,32661,31814,41358,0,-59,-5,-5519,-9,-3636,-4935,-1,-1,-2,0,6
EUN1_3572914978',1,131,13,0,0,1,0,6,1,349,90,29613,28687,30018,4,31,21,1,0,0,0,5,319,106,29887,30445,45117,1,30,-16,-274,-8,-1758,-15099,-1,0,1,0,1
EUN1_3568030450',3,28,16,2,0,2,0,10,1,358,80,29535,29627,33629,7,29,12,0,0,0,0,4,339,92,26656,29607,27402,1,19,-12,2879,4,20,6227,2,0,2,0,6
EUN1_3568018468',0,24,16,1,1,2,0,8,1,349,92,29539,29924,32391,4,36,10,1,0,0,0,6,371,87,27638,29265,31463,1,-22,5,1901,6,659,928,0,1,2,0,2
EUN1_3558048126',6,32,15,1,1,0,0,10,0,309,92,27034,28601,30451,3,28,12,0,0,0,0,3,340,88,26632,27983,26223,0,-31,4,402,3,618,4228,1,1,0,0,7
EUN1_3558031499',4,35,10,1,1,0,0,12,1,305,80,26280,27629,27112,0,20,21,0,0,2,0,1,386,92,32549,33268,36596,0,-81,-12,-6269,-11,-5639,-9484,1,1,-2,0,11
EUN1_3523405036',4,27,19,2,0,2,0,11,1,380,92,31315,32435,38135,2,15,6,0,1,1,0,6,339,88,24771,28159,25550,1,41,4,6544,13,4276,12585,2,-1,1,0,5
EUN1_3523388179',7,38,7,1,0,0,0,8,0,297,72,23022,26731,28102,6,27,14,1,1,0,0,0,334,76,26379,30322,33757,0,-37,-4,-3357,-7,-3591,-5655,0,-1,0,0,8
EUN1_3523346566',4,34,15,1,1,0,0,11,1,324,80,27080,30100,29254,4,28,11,0,0,1,0,1,351,92,26958,28440,35392,1,-27,-12,122,4,1660,-6138,1,1,-1,0,10
EUN1_3523317562',4,28,13,1,1,1,0,6,1,317,103,27940,30212,28596,6,31,10,1,0,0,0,4,355,72,25418,28728,20970,1,-38,31,2522,3,1484,7626,0,1,1,0,2
EUN1_3523281954',3,36,16,1,0,1,0,7,1,347,95,28942,31525,27487,3,20,7,1,1,1,0,4,342,96,24521,28467,31831,1,5,-1,4421,9,3058,-4344,0,-1,0,0,3
EUN1_3523098361',5,23,5,0,1,1,0,10,0,287,86,23377,28004,20780,6,48,14,1,0,2,0,6,364,84,29193,32000,32141,0,-77,2,-5816,-9,-3996,-11361,-1,1,-1,0,4
EUN1_3523068359',3,24,15,0,1,1,0,8,0,367,92,30003,32092,33741,3,23,13,1,0,1,0,6,315,89,27865,29064,30874,1,52,3,2138,2,3028,2867,-1,1,0,0,2
EUN1_3565012239',1,33,22,1,0,1,0,8,1,380,78,31930,33613,43250,5,23,12,1,0,1,0,5,368,98,27202,30449,35266,0,12,-20,4728,10,3164,7984,0,0,0,0,3
EUN1_3562919881',3,53,9,0,0,1,0,10,0,322,75,25565,26641,28768,2,301,20,1,0,1,0,4,334,84,31058,29810,40846,0,-12,-9,-5493,-11,-3169,-12078,-1,0,0,0,6
EUN1_3562898545',3,30,12,2,0,0,0,6,1,324,86,25866,29140,27081,1,22,5,0,0,1,0,1,343,102,24338,28071,29655,0,-19,-16,1528,7,1069,-2574,2,0,-1,0,5
EUN1_3562843105',5,389,11,0,0,1,0,6,0,361,80,27329,30470,29081,4,34,10,1,0,0,0,7,352,81,25849,29193,30161,1,9,-1,1480,1,1277,-1080,-1,0,1,0,-1
EUN1_3562826334',2,23,19,2,0,1,0,7,1,357,116,30518,32632,34929,3,33,11,0,0,1,0,4,375,60,26106,29658,29061,1,-18,56,4412,8,2974,5868,2,0,0,0,3
EUN1_3560757869',0,32,8,0,0,0,0,12,0,316,76,24308,26884,27931,4,19,19,1,0,3,0,2,380,80,31866,33106,37908,0,-64,-4,-7558,-11,-6222,-9977,-1,0,-3,0,10
EUN1_3560743911',2,58,17,1,0,1,0,8,1,343,84,29471,32203,36931,2,241,7,1,0,0,0,5,328,86,24066,29320,31845,1,15,-2,5405,10,2883,5086,0,0,1,0,3
EUN1_3560742393',5,26,14,1,0,0,0,9,0,307,82,25839,27671,33908,2,30,14,1,1,1,0,2,350,85,29745,29821,32084,0,-43,-3,-3906,0,-2150,1824,0,-1,-1,0,7
EUN1_3560630104',4,30,15,0,0,0,0,5,1,360,86,27818,29781,30908,6,123,8,1,0,0,0,2,329,85,25180,27543,31743,0,31,1,2638,7,2238,-835,-1,0,0,0,3
EUN1_3560595778',5,37,12,0,0,0,0,9,1,298,76,26884,27779,36591,4,26,17,0,0,0,0,3,341,68,28565,30619,40985,1,-43,8,-1681,-5,-2840,-4394,0,0,0,0,6
EUN1_3560559359',3,32,14,1,0,1,0,14,0,316,94,28445,30196,30515,5,153,13,0,0,1,0,1,360,86,28963,29018,32944,1,-44,8,-518,1,1178,-2429,1,0,0,0,13
EUN1_3560510874',6,31,11,0,0,0,0,9,0,343,76,26603,27213,29362,5,264,16,2,0,1,0,6,331,88,29481,28415,33255,0,12,-12,-2878,-5,-1202,-3893,-2,0,-1,0,3
EUN1_3560475841',6,71,9,1,0,0,0,13,0,349,104,25424,29405,36666,5,186,13,0,0,0,0,3,350,76,27963,30230,39457,1,-1,28,-2539,-4,-825,-2791,1,0,0,0,10
EUN1_3560451469',6,178,7,0,1,0,0,7,0,354,105,25731,28652,27604,5,27,9,1,0,0,0,2,335,87,24952,26848,28256,0,19,18,779,-2,1804,-652,-1,1,0,0,5
EUN1_3560060318',5,27,16,1,0,3,0,8,1,355,92,31199,30621,38956,2,20,9,0,0,1,0,10,336,84,26674,29872,27082,0,19,8,4525,7,749,11874,1,0,2,0,-2
EUN1_3560049257',3,21,16,1,0,0,0,10,1,356,101,30642,31090,31228,5,35,11,1,1,3,0,5,336,90,26852,28937,32599,1,20,11,3790,5,2153,-1371,0,-1,-3,0,5
EUN1_3560025839',1,35,14,0,0,2,0,5,0,324,88,28790,31541,30431,4,29,10,2,0,1,0,5,328,100,25708,29454,25928,0,-4,-12,3082,4,2087,4503,-2,0,1,0,0
EUN1_3559988779',3,26,5,0,0,0,0,6,0,342,80,23946,26323,27645,4,146,10,0,0,1,0,3,337,96,26285,28847,38691,0,5,-16,-2339,-5,-2524,-11046,0,0,-1,0,3
EUN1_3559910473',5,192,12,1,0,0,0,6,0,400,102,27900,31749,30556,3,27,4,1,0,0,0,5,381,70,24652,28471,19495,1,19,32,3248,8,3278,11061,0,0,0,0,1
EUN1_3559881033',1,25,24,0,0,3,0,8,1,326,100,34109,31088,42656,1,64,7,1,0,0,0,10,278,79,23088,25096,34625,1,48,21,11021,17,5992,8031,-1,0,3,0,-2
EUN1_3559841236',4,31,20,0,1,0,0,10,0,331,86,31098,30606,36762,6,29,16,1,0,1,0,2,308,90,27942,29207,39687,0,23,-4,3156,4,1399,-2925,-1,1,-1,0,8
EUN1_3559809464',3,144,14,1,0,0,0,10,1,315,85,28089,28998,34251,4,23,11,1,0,1,0,2,363,98,27205,29173,28694,1,-48,-13,884,3,-175,5557,0,0,-1,0,8
EUN1_3576048649',2,27,5,0,0,1,0,6,0,362,98,25118,28780,23889,0,26,10,1,1,0,0,4,352,104,25541,30470,25523,0,10,-6,-423,-5,-1690,-1634,-1,-1,1,0,2
EUN1_3575752735',4,24,12,1,1,0,0,8,1,321,84,26018,28962,37713,4,95,11,0,0,0,0,0,327,86,25089,28652,30803,1,-6,-2,929,1,310,6910,1,1,0,0,8
EUN1_3575599393',0,31,10,1,0,0,0,8,0,290,78,24799,26767,29840,3,96,13,0,1,3,0,0,367,98,30290,30753,32682,0,-77,-20,-5491,-3,-3986,-2842,1,-1,-3,0,8
EUN1_3575579458',3,31,14,1,0,2,0,7,1,376,72,30769,28701,31712,3,34,7,0,0,0,0,11,338,94,25409,28752,26843,1,38,-22,5360,7,-51,4869,1,0,2,0,-4
EUN1_3575553372',3,38,16,2,0,1,0,7,1,385,66,28575,29068,28051,2,42,7,0,0,1,0,6,367,81,25654,28519,25065,1,18,-15,2921,9,549,2986,2,0,0,0,1
EUN1_3575457945',3,29,9,1,0,2,0,8,0,350,79,27320,28047,30602,9,33,7,0,0,1,0,5,336,96,24831,28575,23994,0,14,-17,2489,2,-528,6608,1,0,1,0,3
EUN1_3575219320',0,44,16,1,0,0,0,10,1,347,92,27852,29622,37257,2,41,12,1,0,0,0,4,325,87,26217,29183,34118,1,22,5,1635,4,439,3139,0,0,0,0,6
EUN1_3575206252',3,26,14,0,1,0,0,10,0,348,108,28552,30989,31222,4,97,13,2,0,0,0,2,322,92,26499,29243,29633,0,26,16,2053,1,1746,1589,-2,1,0,0,8
EUN1_3574781320',2,23,19,2,0,4,0,6,1,363,112,32618,33167,34062,1,22,6,0,0,0,0,9,287,72,23016,26941,27585,1,76,40,9602,13,6226,6477,2,0,4,0,-3
EUN1_3574419834',5,36,15,1,0,0,0,11,1,342,68,27897,29681,28999,4,34,8,0,0,2,0,3,364,82,25848,28870,29681,0,-22,-14,2049,7,811,-682,1,0,-2,0,8
EUN1_3574347957',3,32,12,0,0,1,0,9,1,336,81,27546,29423,30262,3,33,11,1,0,1,0,6,322,87,26276,27534,34051,1,14,-6,1270,1,1889,-3789,-1,0,0,0,3
EUN1_3573957537',4,28,10,2,0,2,0,4,1,369,100,28473,30102,35027,5,38,7,0,0,0,0,9,316,88,23973,28216,25707,1,53,12,4500,3,1886,9320,2,0,2,0,-5
EUN1_3573930783',3,21,10,1,0,1,0,11,1,296,81,25120,25708,34888,6,83,18,1,0,2,0,1,344,59,28606,29864,35157,1,-48,22,-3486,-8,-4156,-269,0,0,-1,0,10
EUN1_3573898949',4,31,17,0,1,2,0,10,1,324,89,30849,29273,35656,0,29,17,2,0,2,0,6,349,98,29849,29743,32284,0,-25,-9,1000,0,-470,3372,-2,1,0,0,4
EUN1_3573753559',2,24,17,1,0,1,0,9,1,344,77,29961,29243,32486,2,27,16,0,0,1,0,5,303,94,29286,28936,40739,0,41,-17,675,1,307,-8253,1,0,0,0,4
EUN1_3573732891',9,35,17,1,0,1,0,8,1,391,80,32031,31467,31955,2,24,10,0,0,1,0,6,360,72,26815,28597,25523,1,31,8,5216,7,2870,6432,1,0,0,0,2
EUN1_3573725246',3,64,17,1,0,1,0,1,1,373,102,30124,32468,39061,1,32,8,1,0,0,0,9,302,78,24793,26599,30801,1,71,24,5331,9,5869,8260,0,0,1,0,-8
EUN1_3573705339',5,47,11,2,0,0,0,13,0,359,98,25624,29031,26972,2,30,10,0,0,2,0,3,365,67,27821,29309,28715,0,-6,31,-2197,1,-278,-1743,2,0,-2,0,10
EUN1_3572968510',2,87,8,1,0,0,0,8,1,324,102,24542,29427,29667,1,61,10,1,0,0,0,1,375,82,27169,32467,25288,0,-51,20,-2627,-2,-3040,4379,0,0,0,0,7
EUN1_3576234535',4,137,18,2,0,0,0,9,1,319,104,28866,30061,42418,2,24,16,0,0,1,0,4,322,72,29845,28864,34665,1,-3,32,-979,2,1197,7753,2,0,-1,0,5
EUN1_3576225935',1,18,13,0,0,0,0,10,0,332,82,27605,28501,26099,6,30,18,1,0,0,0,2,335,74,28584,29924,39984,0,-3,8,-979,-5,-1423,-13885,-1,0,0,0,8
EUN1_3575819998',2,25,14,1,0,1,0,11,1,269,76,26614,25372,40021,5,22,19,1,0,1,0,4,318,88,29754,29804,36686,0,-49,-12,-3140,-5,-4432,3335,0,0,0,0,7
EUN1_3575795321',2,23,20,1,0,1,0,8,0,360,95,31691,32067,36615,0,22,5,0,0,1,0,7,291,87,23647,26473,31096,1,69,8,8044,15,5594,5519,1,0,0,0,1
EUN1_3574962705',2,148,4,0,1,1,0,8,0,379,98,25248,29594,27318,2,28,15,2,0,0,0,1,371,98,26710,31726,30164,0,8,0,-1462,-11,-2132,-2846,-2,1,1,0,7
EUN1_3574881100',7,24,14,1,0,0,0,7,1,343,91,27042,28621,32053,1,55,11,0,0,1,0,1,340,65,25293,29946,33320,1,3,26,1749,3,-1325,-1267,1,0,-1,0,6
EUN1_3574847711',5,23,13,0,0,1,0,7,0,341,64,27503,28691,30356,3,29,18,1,0,0,0,3,320,68,28259,28712,38717,0,21,-4,-756,-5,-21,-8361,-1,0,1,0,4
EUN1_3574737503',2,22,16,0,0,0,0,10,0,329,75,28958,29798,36666,6,33,14,1,0,1,0,3,307,107,28692,27846,43506,1,22,-32,266,2,1952,-6840,-1,0,-1,0,7
EUN1_3574296167',3,133,12,1,1,0,0,10,0,339,72,27168,28026,39744,4,27,15,0,0,1,0,4,273,76,27484,27281,31566,1,66,-4,-316,-3,745,8178,1,1,-1,0,6
EUN1_3574273328',5,78,17,1,0,1,0,10,0,315,82,28907,28512,42564,0,58,21,0,0,1,0,3,295,70,30980,29871,39969,0,20,12,-2073,-4,-1359,2595,1,0,0,0,7
EUN1_3574241378',6,26,16,2,0,1,0,9,0,337,92,28684,30272,34555,7,95,11,0,0,0,0,0,328,71,25873,26654,36088,1,9,21,2811,5,3618,-1533,2,0,1,0,9
EUN1_3574225914',4,19,25,1,0,8,2,7,1,336,72,35134,30006,40598,1,13,4,0,0,1,0,10,250,64,21331,20552,27992,1,86,8,13803,21,9454,12606,1,0,7,2,-3
EUN1_3574204002',4,31,18,1,0,2,0,8,1,347,116,29697,31936,45828,1,19,12,0,0,0,0,7,289,51,25537,27432,31495,1,58,65,4160,6,4504,14333,1,0,2,0,1
EUN1_3574187609',3,24,24,2,0,0,0,11,1,326,92,31644,33595,45030,1,22,11,0,0,0,0,1,338,115,28406,29935,38578,0,-12,-23,3238,13,3660,6452,2,0,0,0,10
EUN1_3573686294',4,24,8,1,0,0,0,9,1,344,101,25810,28365,32496,2,21,13,1,0,1,0,3,336,96,26837,31638,32657,0,8,5,-1027,-5,-3273,-161,0,0,-1,0,6
EUN1_3573656925',9,28,17,2,0,1,0,12,1,332,90,30557,28806,37449,3,23,19,0,0,1,0,6,299,82,29453,29401,39074,1,33,8,1104,-2,-595,-1625,2,0,0,0,6
EUN1_3573637978',4,25,13,1,1,0,0,14,0,319,90,26208,30020,30711,2,17,16,1,0,3,0,2,364,58,29896,29118,31467,0,-45,32,-3688,-3,902,-756,0,1,-3,0,12
EUN1_3575771769',4,22,9,2,0,0,0,7,1,339,76,25534,28821,24997,4,32,10,0,0,1,0,2,349,100,26663,31007,28497,1,-10,-24,-1129,-1,-2186,-3500,2,0,-1,0,5
EUN1_3575758806',6,25,18,2,0,0,0,10,0,315,88,29379,31464,46994,4,22,20,0,0,2,0,2,304,72,31398,29586,47197,0,11,16,-2019,-2,1878,-203,2,0,-2,0,8
EUN1_3574616717',2,21,8,0,0,0,0,13,1,358,86,25517,28739,31414,5,32,13,2,0,0,0,1,309,78,25512,29736,31826,1,49,8,5,-5,-997,-412,-2,0,0,0,12
EUN1_3574372758',6,30,7,0,0,0,0,8,0,378,103,24795,29609,19793,5,174,9,2,0,2,0,2,375,96,28778,29502,23913,1,3,7,-3983,-2,107,-4120,-2,0,-2,0,6
EUN1_3574272311',3,402,10,1,0,0,0,9,1,382,72,27059,30237,29305,2,22,7,1,0,1,0,4,360,88,25058,30712,31459,1,22,-16,2001,3,-475,-2154,0,0,-1,0,5
EUN1_3574146370',5,24,13,0,0,0,0,6,1,378,82,27691,30078,29037,3,124,11,2,0,0,0,4,342,118,27067,30188,29372,0,36,-36,624,2,-110,-335,-2,0,0,0,2
EUN1_3574131438',4,29,17,1,0,1,0,7,1,310,100,29174,30777,34975,1,27,6,0,0,1,0,4,331,80,24401,27818,26378,1,-21,20,4773,11,2959,8597,1,0,0,0,3
EUN1_3573879323',1,46,12,0,0,0,0,10,1,321,86,25821,27542,35425,2,19,19,2,0,1,0,1,331,105,31024,30149,32067,1,-10,-19,-5203,-7,-2607,3358,-2,0,-1,0,9
EUN1_3573858457',3,26,12,1,0,0,0,12,1,310,85,25817,28783,31825,3,22,12,1,1,1,0,2,358,106,29226,31579,39599,0,-48,-21,-3409,0,-2796,-7774,0,-1,-1,0,10
EUN1_3573830498',1,25,12,1,0,1,0,10,0,342,100,28261,29537,29568,1,30,7,1,0,2,0,7,312,76,23704,26716,22555,1,30,24,4557,5,2821,7013,0,0,-1,0,3
EUN1_3573808109',2,26,11,1,0,0,0,10,0,328,99,26893,30021,22926,5,28,15,1,0,3,0,4,361,88,29815,31364,37128,0,-33,11,-2922,-4,-1343,-14202,0,0,-3,0,6
EUN1_3573779625',5,304,12,0,0,0,0,9,1,353,60,26913,28961,35450,4,39,17,1,0,1,0,4,366,87,29870,30845,34633,0,-13,-27,-2957,-5,-1884,817,-1,0,-1,0,5
EUN1_3573736528',2,68,22,1,0,2,0,4,1,376,111,33551,32196,43916,2,18,11,1,0,0,0,8,318,76,26444,29805,29196,1,58,35,7107,11,2391,14720,0,0,2,0,-4
EUN1_3573722147',3,32,17,2,0,1,0,11,1,366,106,30444,32882,35817,2,38,7,0,0,1,0,7,308,94,24246,28041,30006,1,58,12,6198,10,4841,5811,2,0,0,0,4
EUN1_3573349554',6,24,10,0,0,0,0,8,0,341,96,25839,31051,32308,4,31,9,2,0,1,0,2,385,92,27631,31574,25445,0,-44,4,-1792,1,-523,6863,-2,0,-1,0,6
EUN1_3573320587',4,28,12,0,0,2,0,9,1,336,86,28609,30806,31093,7,31,12,2,0,0,0,6,354,94,26426,29717,36422,1,-18,-8,2183,0,1089,-5329,-2,0,2,0,3
EUN1_3573298519',5,33,8,2,0,0,0,9,0,334,84,25020,30368,26780,2,32,11,0,0,0,0,2,340,70,25988,27755,33254,1,-6,14,-968,-3,2613,-6474,2,0,0,0,7
EUN1_3576124220',3,27,13,0,0,2,0,6,0,364,97,29549,30557,36278,4,49,16,2,0,0,0,9,314,84,26608,28789,29014,0,50,13,2941,-3,1768,7264,-2,0,2,0,-3
EUN1_3576100361',0,57,9,0,0,0,0,6,0,340,80,25744,26420,28110,6,32,14,1,0,1,0,7,300,84,27023,27151,37279,0,40,-4,-1279,-5,-731,-9169,-1,0,-1,0,-1
EUN1_3575956222',0,18,12,0,0,0,0,7,0,353,92,27660,30067,25981,1,21,13,1,0,1,0,4,349,86,28598,29369,32603,1,4,6,-938,-1,698,-6622,-1,0,-1,0,3
EUN1_3575926560',6,32,16,1,0,1,0,13,1,382,89,30318,31536,30851,4,39,8,1,0,1,0,6,339,90,25963,28970,23672,1,43,-1,4355,8,2566,7179,0,0,0,0,7
EUN1_3575892878',2,44,15,2,0,1,0,6,1,369,86,29815,31354,33920,2,95,15,0,0,1,0,5,314,90,27422,28721,31598,0,55,-4,2393,0,2633,2322,2,0,0,0,1
EUN1_3575659226',4,109,15,1,0,0,0,5,1,361,69,27923,31109,37819,5,23,12,0,0,0,0,3,329,76,26715,28168,33756,1,32,-7,1208,3,2941,4063,1,0,0,0,2
EUN1_3575651384',6,24,9,1,0,0,0,8,0,363,80,26403,30182,30579,1,33,10,0,0,0,0,3,342,96,25996,28137,24212,0,21,-16,407,-1,2045,6367,1,0,0,0,5
EUN1_3575627797',5,30,7,0,0,0,0,9,1,371,90,26322,29567,19872,7,33,6,1,0,1,0,1,389,88,24938,29613,23015,0,-18,2,1384,1,-46,-3143,-1,0,-1,0,8
EUN1_3575388580',1,20,14,0,0,0,0,10,1,366,92,30008,30998,33646,3,24,11,2,0,2,0,5,338,80,25828,29424,30252,0,28,12,4180,3,1574,3394,-2,0,-2,0,5
EUN1_3575361710',3,22,15,2,0,0,0,10,0,305,76,27682,27884,36032,1,37,17,0,0,1,0,3,314,94,29142,30543,37745,1,-9,-18,-1460,-2,-2659,-1713,2,0,-1,0,7
EUN1_3575199853',1,125,17,1,0,2,0,5,0,346,104,31133,31695,38746,3,17,11,0,0,1,0,8,308,76,25920,27968,27873,1,38,28,5213,6,3727,10873,1,0,1,0,-3
EUN1_3575126309',0,34,16,1,0,1,0,4,0,304,112,30050,29650,34784,2,26,15,0,0,0,0,8,300,56,26366,27365,37229,1,4,56,3684,1,2285,-2445,1,0,1,0,-4
EUN1_3575123262',4,30,6,1,0,0,0,7,1,318,66,22861,26634,28090,4,23,6,0,0,0,0,2,391,98,25207,29427,25184,0,-73,-32,-2346,0,-2793,2906,1,0,0,0,5
EUN1_3575115340',7,46,13,0,0,2,0,6,1,360,84,27437,29892,28280,4,39,9,2,0,1,0,5,322,106,25825,29859,27333,1,38,-22,1612,4,33,947,-2,0,1,0,1
EUN1_3575105689',4,27,10,2,0,0,0,4,0,321,78,25601,28915,34973,4,26,15,0,0,0,0,4,306,77,26105,25824,36426,1,15,1,-504,-5,3091,-1453,2,0,0,0,0
EUN1_3575088795',1,19,10,1,0,1,0,14,1,343,83,28127,28989,27938,5,32,10,1,0,2,0,5,378,100,28188,31107,31033,0,-35,-17,-61,0,-2118,-3095,0,0,-1,0,9
EUN1_3575037273',3,34,12,1,0,1,0,7,0,326,92,26891,29413,31899,3,29,9,0,0,0,0,5,267,68,22703,25003,29565,0,59,24,4188,3,4410,2334,1,0,1,0,2
EUN1_3567529616',1,18,4,1,0,0,0,11,0,343,90,23190,28761,26266,2,23,8,0,0,1,0,2,400,122,27275,31919,23862,1,-57,-32,-4085,-4,-3158,2404,1,0,-1,0,9
EUN1_3566251870',4,29,17,0,0,0,0,7,1,344,98,28820,31597,33086,2,21,7,2,0,1,0,4,314,114,25110,29161,32988,0,30,-16,3710,10,2436,98,-2,0,-1,0,3
EUN1_3566244270',5,31,15,2,0,2,0,8,1,360,94,29866,30933,36896,2,23,12,0,0,1,0,7,339,90,25966,30529,25541,1,21,4,3900,3,404,11355,2,0,1,0,1
EUN1_3566229184',5,24,10,2,0,0,0,8,1,374,110,27014,32057,27768,6,41,6,0,0,0,0,3,351,102,24610,31221,29897,1,23,8,2404,4,836,-2129,2,0,0,0,5
EUN1_3565234520',1,27,12,1,0,0,0,7,0,378,114,28138,31983,27462,7,25,4,0,0,0,0,3,377,82,23353,27735,25923,0,1,32,4785,8,4248,1539,1,0,0,0,4
EUN1_3565221449',3,24,11,0,1,0,0,7,1,360,98,26742,29479,24741,4,30,12,2,0,0,0,1,366,85,28401,29182,30981,0,-6,13,-1659,-1,297,-6240,-2,1,0,0,6
EUN1_3565173854',5,28,8,1,0,0,0,7,0,366,92,25816,29824,33890,3,27,13,1,0,0,0,1,331,110,28064,30844,31299,0,35,-18,-2248,-5,-1020,2591,0,0,0,0,6
EUN1_3565151769',3,22,10,1,0,0,0,8,1,348,94,26204,30790,37336,3,33,15,1,0,0,0,2,320,86,27425,30731,32856,0,28,8,-1221,-5,59,4480,0,0,0,0,6
EUN1_3565144959',5,56,18,2,0,0,0,10,1,358,83,29605,31209,40396,5,34,10,0,0,1,0,2,317,116,25472,30162,35887,1,41,-33,4133,8,1047,4509,2,0,-1,0,8
EUN1_3565141556',6,33,11,2,0,0,0,3,0,376,106,27588,31276,28491,6,40,10,0,1,0,0,7,341,82,25512,28841,27641,1,35,24,2076,1,2435,850,2,-1,0,0,-4
EUN1_3565137289',0,24,13,1,1,0,0,6,1,339,68,26490,28413,27960,7,33,9,1,0,0,0,2,336,94,25746,27525,26304,1,3,-26,744,4,888,1656,0,1,0,0,4
EUN1_3565134252',3,29,11,1,0,0,0,11,0,348,82,26233,28503,31677,1,29,16,1,0,1,0,0,370,122,30084,32585,33464,0,-22,-40,-3851,-5,-4082,-1787,0,0,-1,0,11
EUN1_3565132126',5,25,4,0,1,0,0,6,1,386,112,23895,29764,17443,1,21,5,2,0,1,0,3,409,104,25560,31896,24619,0,-23,8,-1665,-1,-2132,-7176,-2,1,-1,0,3
EUN1_3565117013',4,26,12,2,0,0,0,9,0,357,96,27098,30649,40647,1,41,17,0,0,0,0,5,341,70,27813,30443,31936,0,16,26,-715,-5,206,8711,2,0,0,0,4
EUN1_3565119678',4,46,15,0,0,1,0,7,1,350,98,29300,29798,34535,0,24,15,1,0,0,0,6,299,97,26166,29365,36196,0,51,1,3134,0,433,-1661,-1,0,1,0,1
EUN1_3565117670',3,22,7,1,0,0,0,10,0,360,98,25547,29913,32479,4,50,5,1,0,1,0,6,340,102,25268,29586,20381,1,20,-4,279,2,327,12098,0,0,-1,0,4
EUN1_3565113751',9,31,19,2,0,2,0,8,0,356,86,31053,31132,35324,6,28,14,0,0,0,0,1,327,88,27269,28120,27312,1,29,-2,3784,5,3012,8012,2,0,2,0,7
EUN1_3565105327',3,21,18,0,1,1,0,8,1,390,88,30729,34137,36372,3,25,4,1,0,0,0,5,375,98,23577,29158,24828,1,15,-10,7152,14,4979,11544,-1,1,1,0,3
EUN1_3565096113',5,24,8,1,0,0,0,14,0,331,102,25555,30068,29412,3,41,18,1,0,1,0,4,394,94,31564,33640,37720,0,-63,8,-6009,-10,-3572,-8308,0,0,-1,0,10
EUN1_3575797621',2,20,10,2,1,3,0,5,1,382,76,27673,30576,29791,3,27,4,0,0,0,0,6,318,75,21877,24431,20067,1,64,1,5796,6,6145,9724,2,1,3,0,-1
EUN1_3575787302',2,25,10,0,0,0,0,4,0,371,66,25165,30101,27638,8,32,10,2,0,1,0,2,334,89,26338,28750,27660,1,37,-23,-1173,0,1351,-22,-2,0,-1,0,2
EUN1_3575553283',4,30,15,0,0,0,0,6,0,336,112,28630,30707,36365,1,25,14,2,0,2,0,1,364,81,29008,29999,32909,0,-28,31,-378,1,708,3456,-2,0,-2,0,5
EUN1_3575485249',1,19,11,1,0,0,0,9,1,333,94,25650,29761,24572,8,30,14,1,0,2,0,2,363,113,29492,30203,35246,0,-30,-19,-3842,-3,-442,-10674,0,0,-2,0,7
EUN1_3572506611',3,69,19,2,0,1,0,7,1,317,96,29624,30453,40231,0,33,8,0,0,1,0,7,312,80,24555,28557,35246,1,5,16,5069,11,1896,4985,2,0,0,0,0
EUN1_3571921017',2,22,15,1,0,0,0,9,1,325,94,28481,29697,39217,4,135,16,0,0,1,0,4,321,59,27948,28798,35150,0,4,35,533,-1,899,4067,1,0,-1,0,5
EUN1_3571323093',3,19,14,1,0,1,0,7,1,316,70,28037,27695,33699,2,67,12,1,0,1,0,7,269,100,24856,27435,31439,1,47,-30,3181,2,260,2260,0,0,0,0,0
EUN1_3569642876',1,25,15,1,0,0,0,9,0,281,76,27284,26963,38987,5,30,24,0,0,0,0,1,321,80,31049,31109,43761,0,-40,-4,-3765,-9,-4146,-4774,1,0,0,0,8
EUN1_3569582275',3,29,12,1,0,0,0,8,1,264,58,23798,26563,25596,3,24,8,0,0,3,0,1,383,82,26823,29477,30915,0,-119,-24,-3025,4,-2914,-5319,1,0,-3,0,7
EUN1_3568390926',1,25,11,1,1,1,0,8,0,307,108,26296,29913,32283,6,40,11,1,0,1,0,2,316,62,25580,27371,37543,1,-9,46,716,0,2542,-5260,0,1,0,0,6
EUN1_3567971010',5,51,14,2,1,0,0,15,1,332,72,28303,30683,31875,2,22,9,0,0,3,0,6,340,76,27552,27768,35259,1,-8,-4,751,5,2915,-3384,2,1,-3,0,9
EUN1_3567523860',2,25,14,1,0,0,0,11,0,342,76,26865,30283,29614,3,22,16,0,0,2,0,0,358,74,29286,31042,35339,0,-16,2,-2421,-2,-759,-5725,1,0,-2,0,11
EUN1_3562369544',2,24,19,1,1,2,0,10,1,332,90,31177,32161,32503,2,21,15,1,0,2,0,6,312,101,29409,30324,37328,1,20,-11,1768,4,1837,-4825,0,1,0,0,4
EUN1_3562350285',0,26,7,1,0,1,0,4,0,408,82,27249,30114,28860,6,29,10,1,0,1,0,8,357,78,24424,30179,22631,1,51,4,2825,-3,-65,6229,0,0,0,0,-4
EUN1_3562226224',4,27,30,2,0,0,0,8,0,292,106,33417,31415,51539,2,25,16,0,0,2,0,6,281,82,28848,26766,39131,1,11,24,4569,14,4649,12408,2,0,-2,0,2
EUN1_3562198844',2,16,12,1,0,2,0,16,1,333,103,28598,30676,32700,3,25,18,1,0,3,0,3,385,76,32151,31031,28378,0,-52,27,-3553,-6,-355,4322,0,0,-1,0,13
EUN1_3562191325',3,23,8,1,1,2,0,10,1,365,83,27355,29094,23674,2,40,9,0,0,0,0,5,382,86,25945,29990,21830,1,-17,-3,1410,-1,-896,1844,1,1,2,0,5
EUN1_3562173670',6,63,11,0,0,0,0,16,0,318,85,26793,30304,28597,5,28,21,2,0,2,0,1,399,75,32592,32838,48374,0,-81,10,-5799,-10,-2534,-19777,-2,0,-2,0,15
EUN1_3562161847',6,35,13,0,0,0,0,11,0,301,65,26633,25917,31349,6,27,23,1,0,1,0,1,332,74,31910,30111,43766,0,-31,-9,-5277,-10,-4194,-12417,-1,0,-1,0,10
EUN1_3562100982',1,28,14,2,0,0,0,5,0,324,88,26324,28571,32100,4,48,9,0,0,1,0,3,303,100,24850,27591,26059,1,21,-12,1474,5,980,6041,2,0,-1,0,2
EUN1_3562098528',3,167,14,0,0,0,0,5,0,283,88,27253,28310,32036,0,26,16,1,0,0,0,3,352,80,28043,30135,34072,0,-69,8,-790,-2,-1825,-2036,-1,0,0,0,2
EUN1_3562021437',4,187,13,0,0,0,0,8,0,307,80,25800,29710,33542,4,24,9,2,1,1,0,2,346,98,26726,28847,35482,1,-39,-18,-926,4,863,-1940,-2,-1,-1,0,6
EUN1_3561990753',2,19,23,1,1,2,0,8,1,370,104,32709,31657,29467,4,27,8,0,0,0,0,9,343,80,25453,26525,20787,1,27,24,7256,15,5132,8680,1,1,2,0,-1
EUN1_3561972313',0,22,18,1,0,2,0,7,1,330,90,31027,31813,47573,2,23,8,1,0,1,0,6,313,78,24229,26835,32596,1,17,12,6798,10,4978,14977,0,0,1,0,1
EUN1_3561922618',5,27,17,0,0,0,0,7,0,336,85,28767,30193,35468,3,30,9,1,0,0,0,3,370,96,26309,29251,25095,0,-34,-11,2458,8,942,10373,-1,0,0,0,4
EUN1_3561894267',2,20,13,1,0,0,0,10,0,358,100,28317,31744,30710,4,27,9,0,0,1,0,2,372,80,26812,30068,26649,1,-14,20,1505,4,1676,4061,1,0,-1,0,8
EUN1_3561873041',2,26,30,1,0,5,0,8,1,383,94,38061,33081,58167,0,14,9,0,0,0,0,10,269,53,24136,23294,25955,1,114,41,13925,21,9787,32212,1,0,5,0,-2
EUN1_3561800437',3,22,16,1,0,0,0,9,0,347,92,29013,31196,37157,6,32,14,1,0,0,0,2,340,91,28639,30001,30659,0,7,1,374,2,1195,6498,0,0,0,0,7
EUN1_3561782512',3,25,12,1,0,0,0,6,0,304,68,25567,28373,28793,5,30,15,1,1,0,0,0,399,92,28568,31834,32308,0,-95,-24,-3001,-3,-3461,-3515,0,-1,0,0,6
EUN1_3561624587',3,162,10,1,0,1,0,8,1,304,82,25194,27839,28318,1,24,9,0,0,0,0,4,346,101,25478,30267,26183,0,-42,-19,-284,1,-2428,2135,1,0,1,0,4
EUN1_3561610870',8,32,24,1,0,0,0,17,1,292,64,31392,27835,44264,3,15,30,1,0,2,0,1,307,102,34948,32127,47719,0,-15,-38,-3556,-6,-4292,-3455,0,0,-2,0,16
EUN1_3562918098',3,18,8,0,0,0,0,11,0,331,86,24840,27738,25832,3,26,18,2,0,0,0,1,363,102,29550,31487,32431,1,-32,-16,-4710,-10,-3749,-6599,-2,0,0,0,10
EUN1_3562815655',0,27,11,2,0,1,0,7,0,347,101,27549,29536,30804,2,28,13,0,0,1,0,2,300,90,27653,30669,32805,0,47,11,-104,-2,-1133,-2001,2,0,0,0,5
EUN1_3562808188',7,29,25,2,1,3,0,8,1,353,90,35228,33609,43107,4,24,8,0,0,1,0,7,269,81,23750,25466,26972,1,84,9,11478,17,8143,16135,2,1,2,0,1
EUN1_3561429854',5,29,22,2,0,1,0,7,1,376,82,31975,31985,38098,2,23,5,0,0,2,0,4,268,82,21513,24481,27692,1,108,0,10462,17,7504,10406,2,0,-1,0,3
EUN1_3561408836',4,25,17,0,1,0,0,8,0,359,80,29163,30963,34699,5,27,7,2,0,0,0,1,327,108,25282,28537,32700,1,32,-28,3881,10,2426,1999,-2,1,0,0,7
EUN1_3561021181',4,27,20,1,0,1,0,4,1,395,98,31758,32788,34879,1,26,7,1,0,1,0,6,335,78,24124,26880,26477,1,60,20,7634,13,5908,8402,0,0,0,0,-2
EUN1_3560975818',5,41,12,0,0,0,0,9,0,370,86,27788,29865,30803,4,25,13,2,0,0,0,0,357,110,27332,31223,30086,1,13,-24,456,-1,-1358,717,-2,0,0,0,9
EUN1_3560950631',4,42,20,1,0,3,0,7,0,333,95,32584,30863,35548,1,40,12,1,0,0,0,6,317,80,26221,28010,31129,0,16,15,6363,8,2853,4419,0,0,3,0,1
EUN1_3560920913',3,27,16,0,0,0,0,8,0,345,75,28547,31267,32691,5,22,15,1,0,2,0,3,384,111,31074,31884,34723,0,-39,-36,-2527,1,-617,-2032,-1,0,-2,0,5
EUN1_3560907131',5,28,20,0,0,0,0,5,0,299,87,28578,29257,35130,7,39,12,0,0,0,0,1,291,75,25748,26660,32328,1,8,12,2830,8,2597,2802,0,0,0,0,4
EUN1_3575738935',2,34,7,0,0,1,0,12,0,361,95,26354,29902,23827,3,24,7,2,1,1,0,5,387,108,27666,29745,25676,1,-26,-13,-1312,0,157,-1849,-2,-1,0,0,7
EUN1_3575556582',5,58,11,0,0,0,0,13,0,262,87,24812,24401,28256,3,31,28,2,0,3,0,3,333,88,35157,30433,44948,0,-71,-1,-10345,-17,-6032,-16692,-2,0,-3,0,10
EUN1_3575537166',2,24,14,2,0,0,0,11,0,337,96,27890,30120,28622,2,24,8,0,0,0,0,2,362,87,26144,28186,26737,1,-25,9,1746,6,1934,1885,2,0,0,0,9
EUN1_3575374137',2,16,16,1,0,0,0,10,0,303,63,26835,27994,31895,2,24,21,1,0,2,0,0,333,71,30747,28952,42553,0,-30,-8,-3912,-5,-958,-10658,0,0,-2,0,10
EUN1_3572488757',3,28,14,1,0,2,0,6,0,410,102,30429,31087,25729,3,54,7,1,0,0,0,10,381,105,26310,29598,17422,1,29,-3,4119,7,1489,8307,0,0,2,0,-4
EUN1_3569008259',5,22,14,2,0,1,0,6,1,378,111,28810,31274,33541,3,28,6,0,1,0,0,6,347,80,23863,29765,22389,1,31,31,4947,8,1509,11152,2,-1,1,0,0
EUN1_3568698901',4,45,16,0,0,1,0,6,0,302,112,28588,30084,35451,4,25,10,1,0,0,0,6,309,72,25100,26881,23159,1,-7,40,3488,6,3203,12292,-1,0,1,0,0
EUN1_3568298516',4,23,11,0,0,0,0,16,0,271,92,26092,28096,28490,0,67,21,1,1,3,0,1,361,108,33496,30920,37858,0,-90,-16,-7404,-10,-2824,-9368,-1,-1,-3,0,15
EUN1_3567788838',2,28,14,2,0,0,0,8,0,345,87,28772,30196,40642,4,21,11,0,0,1,0,2,359,76,27667,29059,25959,0,-14,11,1105,3,1137,14683,2,0,-1,0,6
EUN1_3567763012',5,27,12,0,0,0,0,7,0,336,84,27251,28628,28602,3,32,11,2,0,2,0,2,338,84,26720,30010,33107,1,-2,0,531,1,-1382,-4505,-2,0,-2,0,5
EUN1_3567731940',2,56,16,2,1,0,0,6,1,338,106,27533,31192,29951,7,57,6,0,0,0,0,1,338,76,24329,28460,26962,1,0,30,3204,10,2732,2989,2,1,0,0,5
EUN1_3569765681',2,17,14,1,0,1,0,9,0,352,102,29483,31265,29417,2,23,18,1,0,2,0,5,330,81,29622,30930,34068,1,22,21,-139,-4,335,-4651,0,0,-1,0,4
EUN1_3568101290',3,65,14,0,0,0,0,11,0,280,90,27529,30635,31376,4,26,14,2,0,2,0,1,367,73,28485,29953,34260,1,-87,17,-956,0,682,-2884,-2,0,-2,0,10
EUN1_3565862802',1,75,16,0,0,2,0,13,1,316,80,29512,28351,37874,1,30,13,1,1,2,0,5,277,92,28484,26975,34478,0,39,-12,1028,3,1376,3396,-1,-1,0,0,8
EUN1_3563503714',3,26,10,0,0,1,0,6,0,373,82,26903,28825,21351,2,75,18,1,0,0,0,3,372,89,30243,31009,35998,0,1,-7,-3340,-8,-2184,-14647,-1,0,1,0,3
EUN1_3562994411',2,64,9,0,0,0,0,11,0,323,83,25248,29101,24476,2,56,11,1,0,0,0,1,363,86,27073,29241,32011,0,-40,-3,-1825,-2,-140,-7535,-1,0,0,0,10
EUN1_3561312788',3,92,15,1,0,0,0,12,1,331,68,29129,28764,38188,2,23,20,1,0,2,0,1,341,96,32073,30174,45316,0,-10,-28,-2944,-5,-1410,-7128,0,0,-2,0,11
EUN1_3576155847',5,23,16,1,0,3,0,2,0,371,108,31332,33075,33582,3,38,8,0,0,0,0,8,314,75,23791,25587,25579,1,57,33,7541,8,7488,8003,1,0,3,0,-6
EUN1_3576130905',3,22,14,0,0,0,0,6,1,354,90,28818,30426,30920,5,131,11,2,1,1,0,5,344,102,27231,29530,33045,0,10,-12,1587,3,896,-2125,-2,-1,-1,0,1
EUN1_3575859261',3,22,10,2,0,0,0,16,1,342,86,26773,31553,30897,5,21,9,0,0,4,0,3,390,90,28797,30005,37911,0,-48,-4,-2024,1,1548,-7014,2,0,-4,0,13
EUN1_3575839097',2,39,7,0,0,0,0,12,0,329,50,25514,24035,24391,5,43,24,1,0,3,0,5,341,114,32940,31562,43684,0,-12,-64,-7426,-17,-7527,-19293,-1,0,-3,0,7
EUN1_3575823205',1,24,5,0,0,0,0,12,0,344,88,23491,27479,19134,8,32,14,2,1,2,0,3,390,88,30112,30470,29101,0,-46,0,-6621,-9,-2991,-9967,-2,-1,-2,0,9
EUN1_3575622666',3,21,12,2,0,0,0,9,0,296,92,25619,28735,29436,2,26,22,0,0,1,0,2,301,76,30366,30658,46122,0,-5,16,-4747,-10,-1923,-16686,2,0,-1,0,7
EUN1_3575598238',4,21,17,0,0,1,0,7,0,336,96,30829,31459,37595,6,24,21,2,1,0,0,6,326,88,30886,33098,37056,1,10,8,-57,-4,-1639,539,-2,-1,1,0,1
EUN1_3575576369',4,25,11,1,0,0,0,13,1,347,107,26054,30358,27314,2,22,13,0,0,0,0,0,370,80,27550,31557,33344,1,-23,27,-1496,-2,-1199,-6030,1,0,0,0,13
EUN1_3575350733',5,136,20,1,1,2,0,12,0,352,93,31688,30544,36048,2,19,8,0,0,2,0,8,303,84,24124,26146,23223,1,49,9,7564,12,4398,12825,1,1,0,0,4
EUN1_3575084970',6,24,13,0,0,2,0,10,0,393,84,30141,30213,38461,1,25,11,2,0,1,0,8,344,76,27377,30612,25406,0,49,8,2764,2,-399,13055,-2,0,1,0,2
EUN1_3575070918',7,30,13,0,0,1,0,8,0,340,82,28238,30803,32917,4,24,15,2,0,0,0,7,338,80,26613,31049,27417,1,2,2,1625,-2,-246,5500,-2,0,1,0,1
EUN1_3575058667',2,29,15,2,0,0,0,11,0,316,80,27702,28423,34140,4,55,21,0,0,2,0,2,318,104,31034,30963,37884,0,-2,-24,-3332,-6,-2540,-3744,2,0,-2,0,9
EUN1_3574741488',3,27,14,2,0,1,0,10,1,350,90,30682,30104,31997,5,32,12,0,0,1,0,4,363,90,27227,29965,37848,1,-13,0,3455,2,139,-5851,2,0,0,0,6
EUN1_3574564329',3,79,10,1,0,0,0,11,1,306,78,24738,25231,31364,3,21,14,1,0,3,0,2,380,73,30577,30409,35466,0,-74,5,-5839,-4,-5178,-4102,0,0,-3,0,9
EUN1_3574545788',3,24,16,1,0,0,0,9,0,340,90,28482,30309,33520,10,38,12,0,0,0,0,3,361,78,28155,30377,33838,0,-21,12,327,4,-68,-318,1,0,0,0,6
EUN1_3574526855',3,25,21,1,0,1,0,11,0,379,86,32559,30518,38443,5,26,13,1,0,0,0,6,297,71,26735,26573,37527,1,82,15,5824,8,3945,916,0,0,1,0,5
EUN1_3561982426',3,62,20,0,0,1,0,10,0,327,108,30850,31249,37954,0,24,15,1,0,0,0,5,304,95,29595,29598,38504,0,23,13,1255,5,1651,-550,-1,0,1,0,5
EUN1_3559751716',1,25,17,2,0,0,0,8,0,323,72,29355,29952,43119,4,26,16,0,0,2,0,4,330,72,29616,29133,37485,1,-7,0,-261,1,819,5634,2,0,-2,0,4
EUN1_3559723791',3,22,11,0,0,0,0,10,1,330,84,25987,30878,31094,5,30,6,1,0,1,0,4,334,96,25177,30098,33647,0,-4,-12,810,5,780,-2553,-1,0,-1,0,6
EUN1_3572154650',1,20,11,1,0,0,0,14,0,313,81,25509,27345,29130,1,85,10,1,0,3,0,1,449,75,30030,32851,36309,0,-136,6,-4521,1,-5506,-7179,0,0,-3,0,13
EUN1_3572128274',9,31,6,1,0,1,0,8,1,331,94,24150,27381,28309,0,20,9,1,0,0,0,3,315,90,24379,27153,27469,1,16,4,-229,-3,228,840,0,0,1,0,5
EUN1_3572106543',2,23,6,0,0,0,0,12,0,315,98,23952,28361,25829,4,31,12,2,0,0,0,1,401,86,27776,31896,31197,0,-86,12,-3824,-6,-3535,-5368,-2,0,0,0,11
EUN1_3572080911',0,26,12,0,0,0,0,9,0,324,78,25826,27683,24084,3,25,13,2,0,1,0,2,352,102,28052,29796,29838,1,-28,-24,-2226,-1,-2113,-5754,-2,0,-1,0,7
EUN1_3572063335',4,50,12,1,0,0,0,5,1,366,82,27156,28762,28276,1,25,8,1,0,0,0,2,355,113,25549,29815,32009,1,11,-31,1607,4,-1053,-3733,0,0,0,0,3
EUN1_3572043225',6,29,13,2,0,0,0,7,1,366,89,27046,29505,28051,5,50,7,0,0,1,0,2,351,87,25459,29675,27601,0,15,2,1587,6,-170,450,2,0,-1,0,5
EUN1_3571939008',3,27,10,1,0,1,0,14,1,358,75,26441,28825,28531,3,30,11,0,0,2,0,5,356,112,29124,31494,31688,0,2,-37,-2683,-1,-2669,-3157,1,0,-1,0,9
EUN1_3571931631',4,24,10,0,0,1,0,11,1,346,92,27110,28690,28456,2,24,13,2,0,2,0,6,379,102,29205,30881,28317,1,-33,-10,-2095,-3,-2191,139,-2,0,-1,0,5
EUN1_3571652101',5,42,10,0,0,0,0,11,1,323,88,25457,27953,31159,4,27,13,1,0,1,0,0,343,66,28171,28362,26739,0,-20,22,-2714,-3,-409,4420,-1,0,-1,0,11
EUN1_3571475280',7,26,12,0,0,0,0,7,1,326,90,26755,27720,36669,0,29,14,1,0,1,0,2,338,98,28453,29552,37995,0,-12,-8,-1698,-2,-1832,-1326,-1,0,-1,0,5
EUN1_3571419895',3,33,26,1,0,0,0,4,1,302,78,31310,28100,48565,0,67,20,0,0,0,0,4,297,58,29272,25990,44499,1,5,20,2038,6,2110,4066,1,0,0,0,0
EUN1_3571392924',1,20,11,1,1,1,0,10,0,331,82,27617,28110,31513,4,19,18,1,0,2,0,5,372,95,30013,31576,36618,1,-41,-13,-2396,-7,-3466,-5105,0,1,-1,0,5
EUN1_3573331821',3,23,20,1,0,5,1,5,1,405,82,33956,33637,37258,0,87,3,0,0,1,0,8,251,16,19959,20735,15555,1,154,66,13997,17,12902,21703,1,0,4,1,-3
EUN1_3572580014',4,26,14,2,0,0,0,8,0,355,98,28031,29883,30745,3,22,14,0,0,1,0,4,360,86,28948,30127,27581,0,-5,12,-917,0,-244,3164,2,0,-1,0,4
EUN1_3572586074',2,22,12,0,0,0,0,10,0,319,76,27182,27761,35486,8,31,19,2,1,2,0,2,340,106,31000,31572,44328,0,-21,-30,-3818,-7,-3811,-8842,-2,-1,-2,0,8
EUN1_3566077637',3,25,18,2,0,0,0,9,0,320,94,29337,29534,39038,7,29,7,0,0,2,0,3,367,73,25783,26586,24358,1,-47,21,3554,11,2948,14680,2,0,-2,0,6
EUN1_3566073142',6,26,4,0,0,0,0,9,1,291,81,21920,24065,28794,2,25,16,2,0,0,0,1,323,94,28103,29151,36374,0,-32,-13,-6183,-12,-5086,-7580,-2,0,0,0,8
EUN1_3565204297',0,14,7,0,0,0,0,15,0,266,70,22372,23545,25768,2,27,25,1,1,4,0,0,376,86,35475,31710,50576,0,-110,-16,-13103,-18,-8165,-24808,-1,-1,-4,0,15
EUN1_3565176596',11,36,6,0,0,1,0,6,1,380,77,26441,29401,28529,3,34,8,2,0,1,0,7,347,90,24761,28834,28264,1,33,-13,1680,-2,567,265,-2,0,0,0,-1
EUN1_3565169157',3,28,14,1,0,0,0,6,0,310,62,26251,26732,36199,5,31,16,1,1,0,0,2,354,90,27919,29534,35775,1,-44,-28,-1668,-2,-2802,424,0,-1,0,0,4
EUN1_3575683761',5,26,10,0,0,0,0,11,0,344,68,25482,27853,27977,6,56,23,1,0,2,0,4,283,109,31934,30219,41218,0,61,-41,-6452,-13,-2366,-13241,-1,0,-2,0,7
EUN1_3575127802',6,32,9,0,0,0,0,11,0,299,72,24344,26166,24764,4,38,17,2,0,2,0,3,321,80,28621,28715,37408,1,-22,-8,-4277,-8,-2549,-12644,-2,0,-2,0,8
EUN1_3574604347',1,15,8,1,0,0,0,9,1,314,78,24839,27427,35703,6,27,21,1,1,2,0,3,359,102,30930,34006,42903,0,-45,-24,-6091,-13,-6579,-7200,0,-1,-2,0,6
EUN1_3574354190',4,25,9,0,1,0,0,4,0,332,89,25060,29514,27612,6,31,13,1,0,0,0,3,333,80,26072,28892,26194,1,-1,9,-1012,-4,622,1418,-1,1,0,0,1
EUN1_3574161690',2,32,12,0,0,2,0,10,0,340,80,28017,29330,25451,6,28,17,1,0,0,0,7,369,80,29247,30140,32719,0,-29,0,-1230,-5,-810,-7268,-1,0,2,0,3
EUN1_3574151143',6,33,18,1,1,2,0,6,1,348,114,31211,31764,38748,5,27,13,1,0,0,0,9,316,86,26178,27993,32850,1,32,28,5033,5,3771,5898,0,1,2,0,-3
EUN1_3574072189',4,48,12,0,0,0,0,9,1,375,88,26940,28761,29487,2,23,11,2,0,1,0,6,338,67,27368,31082,34143,0,37,21,-428,1,-2321,-4656,-2,0,-1,0,3
EUN1_3573832797',2,32,9,2,0,0,0,12,0,295,102,23526,29346,37132,2,23,23,0,0,2,0,2,290,82,31110,31151,34530,0,5,20,-7584,-14,-1805,2602,2,0,-2,0,10
EUN1_3573473557',5,27,15,0,0,2,0,11,0,345,98,30477,29923,37746,6,24,16,1,1,2,0,8,362,94,30001,30573,32233,1,-17,4,476,-1,-650,5513,-1,-1,0,0,3
EUN1_3576061809',2,170,11,0,0,1,0,8,1,352,78,27812,29470,32376,4,31,17,2,0,1,0,4,351,84,28711,31493,38203,0,1,-6,-899,-6,-2023,-5827,-2,0,0,0,4
EUN1_3576026994',2,18,22,2,0,1,0,12,0,319,80,30838,29305,39064,4,21,17,0,0,2,0,5,327,64,29139,27881,29674,1,-8,16,1699,5,1424,9390,2,0,-1,0,7
EUN1_3575525210',4,37,14,1,1,1,0,8,0,369,96,30854,30621,33782,4,38,17,1,0,1,0,10,311,70,27527,28115,34480,1,58,26,3327,-3,2506,-698,0,1,0,0,-2
EUN1_3575497305',8,34,13,2,0,0,0,6,0,340,92,26926,27613,30670,2,30,8,0,0,1,0,3,332,92,25260,27312,23255,1,8,0,1666,5,301,7415,2,0,-1,0,3
EUN1_3575460424',6,30,21,1,0,0,0,10,0,379,98,32391,33279,36496,4,23,12,1,0,1,0,4,297,74,25924,28222,27969,1,82,24,6467,9,5057,8527,0,0,-1,0,6
EUN1_3575426959',2,19,8,0,0,1,0,8,0,351,84,26054,28192,29540,5,26,12,2,0,1,0,6,355,91,27041,29623,33071,1,-4,-7,-987,-4,-1431,-3531,-2,0,0,0,2
EUN1_3575407827',7,28,15,1,0,0,0,11,1,326,83,27861,29349,36360,4,25,14,1,0,1,0,3,351,100,28719,29902,35353,0,-25,-17,-858,1,-553,1007,0,0,-1,0,8
EUN1_3575286878',9,36,17,1,0,2,0,7,1,315,104,29186,29585,33788,4,22,12,0,0,1,0,8,336,79,26503,27719,26076,1,-21,25,2683,5,1866,7712,1,0,1,0,-1
EUN1_3575170409',4,24,4,0,0,0,0,9,0,329,112,22935,28551,23122,5,28,13,2,0,0,0,1,403,102,27966,32980,26450,0,-74,10,-5031,-9,-4429,-3328,-2,0,0,0,8
EUN1_3574847073',2,27,8,1,0,0,0,15,1,310,90,24578,28031,25772,7,375,21,1,0,3,0,3,352,80,32106,32905,41306,0,-42,10,-7528,-13,-4874,-15534,0,0,-3,0,12
EUN1_3574634090',2,145,12,0,0,0,0,14,0,287,81,26668,28953,26968,3,28,22,2,0,2,0,2,362,100,33189,31073,45994,0,-75,-19,-6521,-10,-2120,-19026,-2,0,-2,0,12
EUN1_3574235063',4,27,8,1,0,0,0,10,0,326,100,24767,28890,30534,5,66,11,1,0,1,0,0,400,84,27459,30450,32117,0,-74,16,-2692,-3,-1560,-1583,0,0,-1,0,10
EUN1_3574222092',2,26,22,1,0,1,0,11,0,326,76,31659,31286,47236,3,286,23,0,0,0,0,2,323,84,30340,28613,36935,0,3,-8,1319,-1,2673,10301,1,0,1,0,9
EUN1_3575957207',5,31,12,0,1,1,0,7,1,332,94,28540,28874,26206,5,47,10,2,0,0,0,5,331,94,25266,27850,30568,0,1,0,3274,2,1024,-4362,-2,1,1,0,2
EUN1_3575933332',2,378,12,0,0,2,0,13,0,326,75,28886,28736,37930,0,38,21,1,0,2,0,7,327,84,30981,30663,42251,0,-1,-9,-2095,-9,-1927,-4321,-1,0,0,0,6
EUN1_3575911304',2,30,8,1,0,1,0,11,0,404,80,26132,29100,25056,6,25,11,1,0,0,0,2,336,76,26398,29121,26154,0,68,4,-266,-3,-21,-1098,0,0,1,0,9
EUN1_3575884635',5,23,17,2,0,0,0,10,1,336,89,27848,30974,33633,3,67,6,0,0,0,0,1,357,90,24111,28123,34388,0,-21,-1,3737,11,2851,-755,2,0,0,0,9
EUN1_3575859868',1,58,10,0,0,1,0,6,1,380,94,27146,30037,25674,2,31,11,2,0,0,0,7,331,106,26869,30321,29172,0,49,-12,277,-1,-284,-3498,-2,0,1,0,-1
EUN1_3575845447',0,23,9,1,1,0,0,7,0,354,98,26175,30147,32421,3,26,15,1,0,1,0,3,327,90,28273,29000,35167,0,27,8,-2098,-6,1147,-2746,0,1,-1,0,4
EUN1_3575832094',4,24,13,1,1,1,0,14,1,313,90,28186,29805,29658,4,29,16,1,0,1,0,0,347,74,28908,28759,34315,0,-34,16,-722,-3,1046,-4657,0,1,0,0,14
EUN1_3575310761',2,21,21,1,0,1,0,9,0,325,82,30468,30699,39618,4,39,15,1,0,0,0,2,227,100,25093,25936,39979,1,98,-18,5375,6,4763,-361,0,0,1,0,7
EUN1_3575291657',3,35,16,0,0,1,0,4,1,338,67,27870,31470,41853,4,26,7,1,0,1,0,4,314,84,23892,27270,24846,1,24,-17,3978,9,4200,17007,-1,0,0,0,0
EUN1_3575276344',5,29,16,1,0,1,0,6,1,378,98,29295,30921,34978,0,28,6,0,0,0,0,7,295,78,23059,26472,23402,1,83,20,6236,10,4449,11576,1,0,1,0,-1
EUN1_3574769240',5,29,13,2,0,1,0,9,1,352,86,27818,29883,28543,2,172,4,0,0,0,0,4,361,74,23376,27773,24799,1,-9,12,4442,9,2110,3744,2,0,1,0,5
EUN1_3574729786',2,30,8,1,0,0,0,15,0,342,62,24569,27413,29168,6,43,20,1,0,3,0,3,328,92,31381,32009,35632,0,14,-30,-6812,-12,-4596,-6464,0,0,-3,0,12
EUN1_3574713477',2,24,13,1,1,0,0,5,1,388,96,27292,32497,28814,6,31,5,0,0,0,0,2,370,79,23329,28872,19948,1,18,17,3963,8,3625,8866,1,1,0,0,3
EUN1_3574652806',4,25,13,1,0,0,0,7,0,343,116,27933,29726,33401,2,20,13,0,0,1,0,5,360,80,27513,27313,25202,1,-17,36,420,0,2413,8199,1,0,-1,0,2
EUN1_3575669335',2,27,8,1,0,1,0,8,1,327,82,25468,27228,27183,3,24,11,1,0,0,0,3,318,98,24650,28958,27006,1,9,-16,818,-3,-1730,177,0,0,1,0,5
EUN1_3575656823',0,144,11,1,0,1,0,11,0,329,78,25163,28131,32662,1,26,13,0,1,1,0,2,343,84,27195,30138,34247,0,-14,-6,-2032,-2,-2007,-1585,1,-1,0,0,9
EUN1_3575650784',1,26,20,0,0,0,0,7,0,309,74,28677,29410,33582,2,23,15,1,0,1,0,4,331,78,28448,27957,36217,0,-22,-4,229,5,1453,-2635,-1,0,-1,0,3
EUN1_3575642572',3,49,8,0,0,1,0,10,0,358,78,25559,28491,25205,3,26,12,1,0,0,0,5,337,74,26055,28906,32407,0,21,4,-496,-4,-415,-7202,-1,0,1,0,5
EUN1_3575629731',6,27,16,0,0,0,0,7,1,322,78,27679,30820,35641,2,24,12,1,0,1,0,1,335,104,27259,28604,34828,0,-13,-26,420,4,2216,813,-1,0,-1,0,6
EUN1_3575614006',2,23,14,1,0,0,0,9,1,342,110,27820,31056,27912,2,25,3,0,0,2,0,4,345,98,23256,26562,22965,1,-3,12,4564,11,4494,4947,1,0,-2,0,5
EUN1_3575481859',3,30,20,2,0,1,0,8,0,373,70,30523,32138,43938,1,180,7,0,0,1,0,3,308,80,25069,27065,37562,1,65,-10,5454,13,5073,6376,2,0,0,0,5
EUN1_3575457417',8,31,14,1,0,0,0,6,0,345,72,27037,27862,32426,5,48,9,0,0,0,0,1,351,92,24832,27767,30088,0,-6,-20,2205,5,95,2338,1,0,0,0,5
EUN1_3575434096',3,206,17,0,0,1,0,10,1,347,88,29577,31869,36252,2,44,11,2,0,0,0,2,310,92,25520,28577,33101,0,37,-4,4057,6,3292,3151,-2,0,1,0,8
EUN1_3575402834',3,14,18,0,0,1,0,11,1,259,90,27083,26380,32502,3,28,21,2,0,3,0,4,334,110,32145,31507,39197,0,-75,-20,-5062,-3,-5127,-6695,-2,0,-2,0,7
EUN1_3575104553',2,21,19,1,0,2,0,6,1,340,100,30950,32068,32538,0,16,9,0,0,1,0,6,280,72,24116,25688,27877,1,60,28,6834,10,6380,4661,1,0,1,0,0
EUN1_3575097177',4,32,23,1,0,1,0,11,0,286,77,31070,29702,42360,5,31,20,1,0,1,0,3,350,86,31838,30625,42272,0,-64,-9,-768,3,-923,88,0,0,0,0,8
EUN1_3575080811',2,131,4,0,0,1,0,9,0,299,68,22806,26025,26005,2,34,16,1,0,0,0,4,312,86,26942,28551,33614,0,-13,-18,-4136,-12,-2526,-7609,-1,0,1,0,5
EUN1_3575066688',0,26,6,2,0,0,0,14,0,275,76,22947,26110,18845,4,45,20,0,0,2,0,1,419,96,33227,32085,35007,0,-144,-20,-10280,-14,-5975,-16162,2,0,-2,0,13
EUN1_3575026009',1,27,15,2,0,1,0,16,1,324,94,28683,30013,36625,6,80,20,0,0,2,0,7,365,85,31550,31446,37936,1,-41,9,-2867,-5,-1433,-1311,2,0,-1,0,9
EUN1_3575001307',5,338,10,1,0,1,0,12,0,363,79,27447,29751,35657,3,29,18,0,0,3,0,2,366,88,32493,30533,40949,0,-3,-9,-5046,-8,-782,-5292,1,0,-2,0,10
EUN1_3573195756',6,38,16,0,0,2,0,12,1,333,94,29960,30851,32076,4,22,9,2,0,1,0,5,369,81,26226,29546,28496,1,-36,13,3734,7,1305,3580,-2,0,1,0,7
EUN1_3573182590',5,141,6,0,0,0,0,11,0,335,66,24416,28820,21502,3,30,20,1,0,2,0,1,417,145,32605,33624,35093,0,-82,-79,-8189,-14,-4804,-13591,-1,0,-2,0,10
EUN1_3573166434',5,24,12,1,0,0,0,4,1,345,103,27506,30268,37069,8,28,5,0,0,1,0,6,345,64,22670,26850,28663,1,0,39,4836,7,3418,8406,1,0,-1,0,-2
EUN1_3573151179',2,25,18,0,1,0,0,13,0,292,84,28437,30765,38946,3,29,9,2,0,1,0,2,375,104,26842,29099,38212,0,-83,-20,1595,9,1666,734,-2,1,-1,0,11
EUN1_3576207498',2,22,12,0,0,2,0,7,1,417,116,30118,32844,29265,2,65,6,2,0,0,0,8,348,80,23443,28490,25746,1,69,36,6675,6,4354,3519,-2,0,2,0,-1
EUN1_3575714228',0,19,13,0,0,1,0,9,0,358,88,28417,29455,27373,3,19,15,2,0,0,0,4,343,88,28405,30206,33502,1,15,0,12,-2,-751,-6129,-2,0,1,0,5
EUN1_3571118846',3,20,16,1,0,1,0,11,0,371,94,29507,31716,39796,3,22,16,0,0,0,0,5,341,64,27450,29520,30404,1,30,30,2057,0,2196,9392,1,0,1,0,6
EUN1_3570316029',2,22,12,0,0,0,0,6,1,367,110,27586,30992,27163,5,25,10,1,0,0,0,3,346,78,25157,29004,29091,1,21,32,2429,2,1988,-1928,-1,0,0,0,3
EUN1_3569594148',5,25,13,0,0,0,0,9,0,293,64,25499,28491,29157,2,20,11,2,0,1,0,1,334,92,28223,30143,36654,0,-41,-28,-2724,2,-1652,-7497,-2,0,-1,0,8
EUN1_3569556954',6,29,20,1,0,0,0,8,1,293,71,29179,27596,40598,6,23,18,1,0,0,0,3,280,102,29275,28247,43776,1,13,-31,-96,2,-651,-3178,0,0,0,0,5
EUN1_3569407605',9,27,10,0,0,0,0,8,0,325,70,24850,26862,26586,4,24,16,2,1,0,0,2,334,106,29406,31656,39706,0,-9,-36,-4556,-6,-4794,-13120,-2,-1,0,0,6
EUN1_3569113997',3,282,8,0,0,1,0,16,0,344,78,26476,29317,22947,4,29,22,2,0,3,0,6,366,90,32396,33545,40724,0,-22,-12,-5920,-14,-4228,-17777,-2,0,-2,0,10
EUN1_3569082638',7,31,13,1,0,1,0,12,1,347,104,28061,30961,33654,1,176,10,1,0,3,0,6,369,80,27513,30711,30863,1,-22,24,548,3,250,2791,0,0,-2,0,6
EUN1_3569065421',5,30,10,0,1,0,0,8,0,336,92,26376,30148,25616,1,27,13,2,0,2,0,4,388,100,28911,31982,29769,0,-52,-8,-2535,-3,-1834,-4153,-2,1,-2,0,4
EUN1_3568906932',4,23,13,2,0,1,0,3,1,384,88,28672,31280,33342,4,219,3,0,0,0,0,8,336,100,22949,27742,25041,1,48,-12,5723,10,3538,8301,2,0,1,0,-5
EUN1_3568898516',4,22,14,0,0,0,0,10,1,307,76,26934,29368,35717,3,94,7,2,0,1,0,7,379,90,27061,30333,31217,1,-72,-14,-127,7,-965,4500,-2,0,-1,0,3
EUN1_3568894001',4,184,12,1,0,2,0,9,1,348,96,28851,28631,33825,4,291,13,1,0,2,0,5,363,80,28486,29758,30005,0,-15,16,365,-1,-1127,3820,0,0,0,0,4
EUN1_3568506225',2,28,8,0,0,0,0,6,1,391,72,26223,28985,34079,1,26,16,1,0,0,0,5,302,97,26953,29693,33685,1,89,-25,-730,-8,-708,394,-1,0,0,0,1
EUN1_3568434194',5,25,6,0,0,0,0,5,1,339,94,23734,28154,22132,2,23,5,2,0,0,0,3,380,94,24012,29123,23766,0,-41,0,-278,1,-969,-1634,-2,0,0,0,2
EUN1_3568405549',2,25,17,0,0,0,0,12,1,314,88,29799,29925,32286,2,31,12,1,0,3,0,3,326,100,28083,29700,33168,1,-12,-12,1716,5,225,-882,-1,0,-3,0,9
EUN1_3568223181',2,42,9,0,0,0,0,7,1,326,90,25202,26646,32434,8,27,15,2,1,1,0,4,309,102,28130,34005,37963,0,17,-12,-2928,-6,-7359,-5529,-2,-1,-1,0,3
EUN1_3568194693',5,30,22,1,0,1,0,4,1,334,77,31392,29739,43294,11,33,14,1,0,0,0,6,301,81,26407,26134,34281,1,33,-4,4985,8,3605,9013,0,0,1,0,-2
EUN1_3568027470',3,26,17,1,1,2,0,10,1,337,90,30558,29245,36007,2,30,11,1,0,0,0,6,312,78,25915,29499,29064,0,25,12,4643,6,-254,6943,0,1,2,0,4
EUN1_3567984454',3,35,11,1,0,1,0,10,1,311,80,26194,30642,35230,6,31,10,1,0,1,0,4,366,103,26448,31172,28644,0,-55,-23,-254,1,-530,6586,0,0,0,0,6
EUN1_3563380685',3,24,9,1,0,0,0,5,0,390,83,25214,28479,23797,3,23,10,0,1,0,0,1,352,92,26600,29850,30640,0,38,-9,-1386,-1,-1371,-6843,1,-1,0,0,4
EUN1_3563308955',1,21,23,2,0,3,1,6,1,392,66,33442,33308,47578,5,37,14,0,0,2,0,5,273,90,26306,27361,33889,1,119,-24,7136,9,5947,13689,2,0,1,1,1
EUN1_3563231300',2,24,13,2,0,1,0,7,1,348,86,28582,30276,30223,4,30,12,0,0,0,0,6,369,82,26886,29394,29547,0,-21,4,1696,1,882,676,2,0,1,0,1
EUN1_3574982057',1,32,10,1,0,2,0,10,1,389,86,26965,29039,28068,3,25,3,0,0,1,0,7,351,94,24363,27342,25369,1,38,-8,2602,7,1697,2699,1,0,1,0,3
EUN1_3574956862',4,25,9,0,0,0,0,9,1,416,84,27610,30356,33677,6,46,13,1,0,1,0,2,320,89,26714,29979,28855,1,96,-5,896,-4,377,4822,-1,0,-1,0,7
EUN1_3574718286',2,22,10,1,0,1,0,13,1,347,80,26919,30087,32258,1,26,14,0,0,2,0,4,404,98,29293,30889,31128,0,-57,-18,-2374,-4,-802,1130,1,0,-1,0,9
EUN1_3574254627',1,19,24,0,0,3,0,6,1,389,82,33371,32548,48125,1,26,10,1,0,0,0,11,319,89,26875,28626,27030,1,70,-7,6496,14,3922,21095,-1,0,3,0,-5
EUN1_3574016946',7,27,8,1,0,1,0,12,0,305,69,23284,27274,21711,3,25,14,1,0,0,0,4,336,93,27927,29832,30371,0,-31,-24,-4643,-6,-2558,-8660,0,0,1,0,8
EUN1_3574005118',3,31,21,1,0,0,0,10,1,322,85,30742,29956,42271,1,23,13,0,0,2,0,3,300,62,26239,28043,31541,0,22,23,4503,8,1913,10730,1,0,-2,0,7
EUN1_3573988743',5,32,11,2,0,0,0,12,1,316,77,24974,30559,33478,2,29,16,0,0,2,0,3,355,86,30363,31478,43791,0,-39,-9,-5389,-5,-919,-10313,2,0,-2,0,9
EUN1_3573967344',3,22,17,0,0,0,0,15,1,278,78,26859,28809,33970,1,125,18,2,0,3,0,2,338,86,31664,30632,37824,0,-60,-8,-4805,-1,-1823,-3854,-2,0,-3,0,13
EUN1_3576149809',6,36,16,2,1,2,0,9,1,312,87,28811,27084,32093,2,36,10,0,0,1,0,9,366,108,28030,28797,32779,1,-54,-21,781,6,-1713,-686,2,1,1,0,0
EUN1_3576139702',2,24,14,1,0,0,0,10,0,319,95,28351,29953,36956,6,28,12,1,0,1,0,5,288,84,26332,27328,32585,1,31,11,2019,2,2625,4371,0,0,-1,0,5
EUN1_3576130170',3,27,9,0,0,1,0,13,0,317,84,26316,29229,27251,5,22,10,2,0,1,0,3,391,84,27696,30733,30035,1,-74,0,-1380,-1,-1504,-2784,-2,0,0,0,10
EUN1_3576099503',5,20,8,0,1,0,0,9,0,362,74,25851,27949,35572,3,23,18,2,0,2,0,6,361,78,30292,31481,33263,0,1,-4,-4441,-10,-3532,2309,-2,1,-2,0,3
EUN1_3576080155',4,26,15,1,0,1,0,8,1,355,80,29488,30449,34109,2,35,5,0,0,1,0,7,263,84,22525,25975,20959,1,92,-4,6963,10,4474,13150,1,0,0,0,1
EUN1_3576049245',3,38,5,0,0,1,0,14,0,341,84,25233,28574,28161,7,33,11,2,0,2,0,5,376,108,27144,30982,22452,0,-35,-24,-1911,-6,-2408,5709,-2,0,-1,0,9
EUN1_3576012281',2,19,13,1,0,2,0,12,0,329,70,27666,27469,32057,4,43,18,1,0,0,0,4,326,86,28920,28780,38593,0,3,-16,-1254,-5,-1311,-6536,0,0,2,0,8
EUN1_3575991495',2,18,28,1,0,1,0,13,1,344,54,33566,31046,46370,6,34,13,1,0,2,0,6,343,94,28743,29104,36139,1,1,-40,4823,15,1942,10231,0,0,-1,0,7
EUN1_3575960839',3,24,9,0,0,1,0,9,0,330,92,26049,30031,27437,4,23,14,2,0,1,0,2,373,68,26688,29656,30343,0,-43,24,-639,-5,375,-2906,-2,0,0,0,7
EUN1_3575935335',1,23,22,0,0,2,0,8,1,346,94,32254,31879,43923,1,26,5,1,0,1,0,8,366,74,23560,27791,22767,0,-20,20,8694,17,4088,21156,-1,0,1,0,0
EUN1_3575917271',6,28,17,1,0,0,0,8,1,353,80,28843,30660,36886,3,525,6,0,0,1,0,2,344,83,23874,26508,27536,1,9,-3,4969,11,4152,9350,1,0,-1,0,6
EUN1_3573898667',3,38,9,2,0,1,0,7,1,355,84,26408,28660,27542,10,35,11,0,0,0,0,4,338,84,26030,31316,31374,0,17,0,378,-2,-2656,-3832,2,0,1,0,3
EUN1_3573865945',5,33,12,2,0,1,0,11,0,368,98,27575,30135,31266,1,32,9,0,0,1,0,0,344,86,26184,29759,23706,1,24,12,1391,3,376,7560,2,0,0,0,11
EUN1_3573842596',5,21,10,0,0,0,0,12,0,338,82,25730,29334,26660,3,26,20,2,0,4,0,2,379,102,33703,32945,37556,0,-41,-20,-7973,-10,-3611,-10896,-2,0,-4,0,10
EUN1_3573805535',6,68,19,2,0,3,0,5,1,399,100,32243,34510,32905,2,75,6,0,0,0,0,6,363,82,24901,28796,23989,1,36,18,7342,13,5714,8916,2,0,3,0,-1
EUN1_3572388056',2,22,11,0,0,1,0,8,0,344,76,26062,28783,30260,3,25,16,2,0,0,0,3,319,116,28538,30867,31040,0,25,-40,-2476,-5,-2084,-780,-2,0,1,0,5
EUN1_3572379581',4,19,19,0,0,1,0,8,1,409,105,32444,33896,36649,5,30,9,2,0,2,0,4,235,77,23752,26367,26580,1,174,28,8692,10,7529,10069,-2,0,-1,0,4
EUN1_3572373375',1,47,23,2,0,2,0,7,1,353,112,34261,31340,42129,2,34,9,0,0,1,0,10,304,75,27218,28163,29089,1,49,37,7043,14,3177,13040,2,0,1,0,-3
EUN1_3572360209',8,63,20,1,0,1,0,8,1,305,84,29819,29816,34144,9,31,17,1,0,0,0,4,295,78,27159,28335,37188,1,10,6,2660,3,1481,-3044,0,0,1,0,4
EUN1_3575876159',2,19,10,2,0,1,0,7,1,384,108,27244,30573,28168,3,108,12,0,0,0,0,4,350,77,25381,29676,25116,1,34,31,1863,-2,897,3052,2,0,1,0,3
EUN1_3573650698',3,30,8,0,0,0,0,11,0,324,88,24243,28965,28339,0,21,18,2,1,1,0,0,338,120,30448,31624,32081,0,-14,-32,-6205,-10,-2659,-3742,-2,-1,-1,0,11
EUN1_3572551410',2,32,18,1,0,0,0,7,1,299,92,29265,29932,42061,4,27,20,0,0,1,0,2,312,92,30937,28637,33569,1,-13,0,-1672,-2,1295,8492,1,0,-1,0,5
EUN1_3572522402',5,27,13,1,0,0,0,7,1,370,84,27883,31213,32908,2,27,17,1,0,1,0,1,339,95,28818,30462,36090,0,31,-11,-935,-4,751,-3182,0,0,-1,0,6
EUN1_3572510416',6,88,9,2,0,1,0,6,1,370,100,26338,29354,31238,4,24,14,0,0,0,0,2,339,91,27478,31371,25938,1,31,9,-1140,-5,-2017,5300,2,0,1,0,4
EUN1_3572493542',5,25,16,0,0,0,0,10,0,332,93,27379,29836,36117,5,22,11,2,0,1,0,1,324,78,26305,29325,34965,1,8,15,1074,5,511,1152,-2,0,-1,0,9
EUN1_3572486816',5,25,9,0,0,0,0,5,1,366,104,25676,29900,24859,0,25,7,2,0,1,0,1,412,71,25812,30025,28977,0,-46,33,-136,2,-125,-4118,-2,0,-1,0,4
EUN1_3572297722',7,29,15,2,0,0,0,12,0,330,102,28133,31574,34804,4,131,11,0,0,2,0,4,364,93,28220,29855,29106,1,-34,9,-87,4,1719,5698,2,0,-2,0,8
EUN1_3572272515',0,26,15,1,0,2,0,9,1,348,80,29143,29399,37469,3,17,9,0,0,0,0,6,321,84,25904,29180,32005,1,27,-4,3239,6,219,5464,1,0,2,0,3
EUN1_3572209242',2,31,11,0,0,0,0,8,1,347,106,27511,29841,34178,4,28,15,2,0,0,0,3,381,90,27297,31905,34700,1,-34,16,214,-4,-2064,-522,-2,0,0,0,5
EUN1_3572017472',4,21,6,0,0,0,0,8,0,346,74,23774,28099,29524,5,24,14,1,0,1,0,2,370,72,28495,29453,36788,0,-24,2,-4721,-8,-1354,-7264,-1,0,-1,0,6
EUN1_3571994944',2,24,14,1,0,1,0,6,0,367,82,29267,30637,33620,7,29,11,1,0,0,0,5,358,102,27027,29879,29312,1,9,-20,2240,3,758,4308,0,0,1,0,1
EUN1_3571969663',2,24,15,0,0,1,0,9,0,341,73,29230,29970,44014,2,22,22,2,0,0,0,2,327,98,30620,31444,37754,0,14,-25,-1390,-7,-1474,6260,-2,0,1,0,7
EUN1_3571959669',4,24,16,1,0,1,0,4,1,395,87,29940,31337,33747,7,31,13,1,0,0,0,4,310,94,26533,27726,25849,1,85,-7,3407,3,3611,7898,0,0,1,0,0
EUN1_3571951422',2,19,10,0,0,0,0,11,0,308,80,24837,27837,30920,4,32,21,1,1,1,0,0,386,88,33488,32742,40083,0,-78,-8,-8651,-11,-4905,-9163,-1,-1,-1,0,11
EUN1_3571930245',3,21,15,1,1,2,0,6,0,313,79,28579,28898,32971,3,25,14,1,0,0,0,5,285,67,25576,26013,30697,1,28,12,3003,1,2885,2274,0,1,2,0,1
EUN1_3571913609',6,27,10,2,0,1,0,9,1,372,93,26881,30713,34443,4,26,10,0,1,0,0,4,343,94,25645,31287,26525,0,29,-1,1236,0,-574,7918,2,-1,1,0,5
EUN1_3558751157',2,73,7,0,0,2,0,3,1,382,90,26248,29236,27567,6,28,8,2,0,0,0,5,354,106,24383,30123,22767,1,28,-16,1865,-1,-887,4800,-2,0,2,0,-2
EUN1_3558713675',2,29,7,0,0,0,0,7,1,334,82,24095,26244,25929,3,29,17,2,0,0,0,2,360,92,28406,28892,38286,0,-26,-10,-4311,-10,-2648,-12357,-2,0,0,0,5
EUN1_3558688432',0,21,10,1,0,1,0,4,1,380,112,27913,29781,32606,7,28,5,0,0,0,0,8,332,84,23697,28596,21569,0,48,28,4216,5,1185,11037,1,0,1,0,-4
EUN1_3558672140',7,28,10,1,0,1,0,7,0,405,112,29131,31841,30915,7,26,3,1,0,0,0,4,349,92,23311,27500,20726,1,56,20,5820,7,4341,10189,0,0,1,0,3
EUN1_3558637563',5,27,11,2,0,2,0,5,1,385,94,29445,30098,31665,4,26,8,0,0,0,0,4,326,82,24039,27102,27098,0,59,12,5406,3,2996,4567,2,0,2,0,1
EUN1_3558606965',3,44,23,1,1,1,0,5,1,370,102,32142,33247,36839,2,30,5,0,0,0,0,3,339,64,22819,26527,27365,1,31,38,9323,18,6720,9474,1,1,1,0,2
EUN1_3558596720',1,94,4,0,0,1,0,13,0,329,70,23437,24891,21206,5,65,16,1,0,1,0,3,375,77,29423,30486,33749,0,-46,-7,-5986,-12,-5595,-12543,-1,0,0,0,10
EUN1_3558541424',6,23,19,2,0,0,0,10,0,335,88,29436,30185,33683,2,28,19,0,0,1,0,2,351,82,31436,29419,38096,0,-16,6,-2000,0,766,-4413,2,0,-1,0,8
EUN1_3558521792',5,29,17,2,0,1,0,8,0,350,96,31403,30381,41670,5,25,14,0,0,0,0,7,363,68,27310,28910,36169,1,-13,28,4093,3,1471,5501,2,0,1,0,1
EUN1_3558520311',4,22,15,0,0,1,0,12,1,353,72,30234,28777,32218,3,25,15,2,0,2,0,5,284,80,28504,27366,35804,1,69,-8,1730,0,1411,-3586,-2,0,-1,0,7
EUN1_3558482921',3,24,11,0,0,0,0,7,0,300,91,25348,27902,28828,2,16,10,2,0,1,0,2,381,92,26651,30360,31180,0,-81,-1,-1303,1,-2458,-2352,-2,0,-1,0,5
EUN1_3558480556',5,29,9,0,0,0,0,7,1,346,109,25996,27684,23174,7,34,18,2,0,1,0,0,366,86,30805,30432,33154,0,-20,23,-4809,-9,-2748,-9980,-2,0,-1,0,7
EUN1_3558325936',8,32,9,1,0,0,0,9,1,337,74,26078,27743,26063,3,145,16,1,0,0,0,1,360,123,29612,31050,31870,0,-23,-49,-3534,-7,-3307,-5807,0,0,0,0,8
EUN1_3558299964',3,21,19,0,0,0,0,5,1,333,102,30244,30472,39318,3,28,9,2,0,1,0,5,251,78,23965,26347,30393,0,82,24,6279,10,4125,8925,-2,0,-1,0,0
EUN1_3558114892',5,32,18,2,1,1,0,4,1,335,110,30989,31010,31027,5,36,6,0,0,0,0,5,350,84,24662,27045,29124,1,-15,26,6327,12,3965,1903,2,1,1,0,-1
EUN1_3558096858',3,19,15,1,0,2,0,10,0,322,74,29593,29691,34504,2,23,9,0,0,0,0,3,333,82,25396,28481,30703,1,-11,-8,4197,6,1210,3801,1,0,2,0,7
EUN1_3558063271',3,23,19,1,0,0,0,7,1,296,94,29889,30991,36165,4,27,16,0,0,2,0,4,301,64,29092,28716,38640,1,-5,30,797,3,2275,-2475,1,0,-2,0,3
EUN1_3571313123',4,24,13,1,0,0,0,12,0,311,88,27833,29981,26751,4,28,25,1,1,2,0,2,348,100,34694,32442,45569,0,-37,-12,-6861,-12,-2461,-18818,0,-1,-2,0,10
EUN1_3568426788',3,25,16,2,1,0,0,5,1,398,74,29451,32293,37938,2,22,12,0,0,0,0,3,346,90,27589,29234,28796,0,52,-16,1862,4,3059,9142,2,1,0,0,2
EUN1_3566963143',2,58,14,0,0,1,0,7,1,349,84,28698,29170,33335,1,26,9,2,0,0,0,6,360,92,25825,27894,29220,1,-11,-8,2873,5,1276,4115,-2,0,1,0,1
EUN1_3564720247',5,69,10,1,0,0,0,10,0,374,74,27114,30606,32340,3,101,14,1,1,1,0,4,330,113,28557,31641,33448,1,44,-39,-1443,-4,-1035,-1108,0,-1,-1,0,6
EUN1_3574581548',4,18,7,1,0,0,0,8,1,338,78,25300,27587,28121,3,42,12,1,0,1,0,2,334,94,27081,31011,31832,0,4,-16,-1781,-5,-3424,-3711,0,0,-1,0,6
EUN1_3572459978',3,28,8,0,0,1,0,4,1,364,82,26103,28579,38156,0,26,12,2,0,0,0,6,299,66,24798,28792,31495,1,65,16,1305,-4,-213,6661,-2,0,1,0,-2
EUN1_3572454166',5,26,16,1,0,1,0,12,0,367,86,30403,29830,35333,8,30,12,0,0,0,0,4,361,66,26878,27974,25571,1,6,20,3525,4,1856,9762,1,0,1,0,8
EUN1_3572996964',4,94,17,1,0,2,0,8,1,400,98,32451,31717,44452,4,27,7,0,0,1,0,9,317,66,23615,26205,31032,1,83,32,8836,10,5512,13420,1,0,1,0,-1
EUN1_3572993964',4,28,9,0,0,0,0,9,0,313,95,25396,28423,29346,2,28,18,2,0,1,0,3,335,72,28864,30869,31584,0,-22,23,-3468,-9,-2446,-2238,-2,0,-1,0,6
EUN1_3569132916',4,149,12,0,0,1,0,6,1,363,108,28078,29409,32940,4,37,18,2,1,0,0,7,310,90,29447,30926,41025,0,53,18,-1369,-6,-1517,-8085,-2,-1,1,0,-1
EUN1_3568472857',1,41,12,0,0,0,0,9,0,332,78,26256,27341,38327,5,38,19,2,0,0,0,3,331,94,28709,29132,39983,0,1,-16,-2453,-7,-1791,-1656,-2,0,0,0,6
EUN1_3567576173',4,25,11,1,0,1,0,11,0,344,103,27427,28532,33335,5,31,16,1,0,1,0,5,336,96,30246,31496,36023,0,8,7,-2819,-5,-2964,-2688,0,0,0,0,6
EUN1_3567565114',5,29,11,2,0,1,0,7,1,348,96,27033,29392,34193,4,44,16,0,0,0,0,4,321,96,28481,30748,36508,1,27,0,-1448,-5,-1356,-2315,2,0,1,0,3
EUN1_3567501574',6,29,10,2,1,1,0,11,0,335,116,27773,31455,32768,4,43,5,0,0,1,0,5,342,84,23830,28395,23985,0,-7,32,3943,5,3060,8783,2,1,0,0,6
EUN1_3566425091',1,26,17,1,0,1,0,8,1,346,92,30192,30485,39788,4,23,10,0,0,1,0,6,304,84,25361,28490,32707,1,42,8,4831,7,1995,7081,1,0,0,0,2
EUN1_3573674218',1,21,7,0,0,0,0,8,0,384,78,24581,30616,24904,5,35,16,2,0,0,0,1,356,102,27515,31289,34328,0,28,-24,-2934,-9,-673,-9424,-2,0,0,0,7
EUN1_3573662187',1,37,21,2,1,0,0,7,1,344,108,32176,34297,39756,1,18,10,0,0,3,0,6,342,75,26972,28339,28363,1,2,33,5204,11,5958,11393,2,1,-3,0,1
EUN1_3570692914',4,29,17,1,0,1,0,9,1,325,84,29656,28738,33056,1,25,12,1,0,0,0,2,321,80,26963,26837,41082,1,4,4,2693,5,1901,-8026,0,0,1,0,7
EUN1_3569534819',2,23,12,1,0,2,0,4,1,356,86,27959,30356,30041,5,136,7,1,0,0,0,7,353,90,24783,29091,26558,0,3,-4,3176,5,1265,3483,0,0,2,0,-3
EUN1_3559538957',4,27,9,0,1,1,0,3,1,366,98,26503,29485,26747,6,33,7,2,0,0,0,6,369,98,24812,28643,23414,1,-3,0,1691,2,842,3333,-2,1,1,0,-3
EUN1_3559264619',5,32,16,0,0,2,0,6,1,355,84,29596,29327,31844,4,29,9,2,0,0,0,5,314,90,25391,26672,25744,0,41,-6,4205,7,2655,6100,-2,0,2,0,1
EUN1_3557614011',1,34,8,2,0,1,0,14,0,318,91,26728,29842,22052,2,19,8,0,0,3,0,6,300,83,25318,27294,26532,0,18,8,1410,0,2548,-4480,2,0,-2,0,8
EUN1_3557168212',1,19,7,1,0,0,0,9,0,336,93,24003,27782,23148,4,26,17,1,0,2,0,1,369,93,31648,31795,34462,0,-33,0,-7645,-10,-4013,-11314,0,0,-2,0,8
EUN1_3555656441',5,230,16,2,1,2,0,4,1,406,97,29967,31329,31101,3,26,8,0,0,0,0,11,287,98,25155,27254,24445,1,119,-1,4812,8,4075,6656,2,1,2,0,-7
EUN1_3555621455',2,22,17,1,0,0,0,4,0,302,64,26718,29129,34097,3,25,12,0,0,0,0,0,336,100,28183,30468,32017,0,-34,-36,-1465,5,-1339,2080,1,0,0,0,4
EUN1_3555385050',2,28,8,1,0,0,0,8,0,342,100,25735,28302,24727,3,25,13,1,0,0,0,2,370,84,27669,30530,29126,0,-28,16,-1934,-5,-2228,-4399,0,0,0,0,6
EUN1_3555376648',5,19,25,1,0,0,0,7,1,344,74,35171,30675,37097,2,25,10,0,0,4,0,7,325,77,26356,27515,29398,1,19,-3,8815,15,3160,7699,1,0,-4,0,0
EUN1_3555339020',5,23,20,1,0,2,0,7,1,398,90,32070,32910,42078,4,66,5,0,0,0,0,4,318,76,22617,26169,27900,1,80,14,9453,15,6741,14178,1,0,2,0,3
EUN1_3555289375',5,30,16,2,0,3,0,7,0,384,103,31971,31776,36924,2,21,7,0,0,0,0,7,273,96,22939,25451,26360,1,111,7,9032,9,6325,10564,2,0,3,0,0
EUN1_3555257857',5,27,14,2,0,2,0,9,1,384,96,30545,32180,31195,2,23,8,0,0,1,0,6,351,79,25288,29838,33001,1,33,17,5257,6,2342,-1806,2,0,1,0,3
EUN1_3575583875',3,24,12,0,0,0,0,9,0,298,78,26415,28531,27926,0,24,11,2,0,1,0,4,339,89,26108,30431,25644,0,-41,-11,307,1,-1900,2282,-2,0,-1,0,5
EUN1_3568625215',8,24,17,1,0,2,0,5,0,349,88,29264,30466,31333,3,25,4,0,0,0,0,4,325,72,23088,27431,29217,1,24,16,6176,13,3035,2116,1,0,2,0,1
EUN1_3568591499',1,48,8,1,0,0,0,9,0,309,76,24383,27943,26867,3,32,11,1,0,1,0,3,374,100,27369,30518,32960,1,-65,-24,-2986,-3,-2575,-6093,0,0,-1,0,6
EUN1_3567771540',0,20,10,0,0,1,0,10,0,305,68,25261,27415,28437,4,30,20,1,0,2,0,3,311,71,30313,30646,31047,0,-6,-3,-5052,-10,-3231,-2610,-1,0,-1,0,7
EUN1_3567749529',2,32,19,1,0,1,0,11,1,360,115,31771,31737,34182,0,22,8,0,0,1,0,10,365,44,25867,28249,24366,1,-5,71,5904,11,3488,9816,1,0,0,0,1
EUN1_3567721739',4,204,14,0,0,1,0,1,0,364,78,28482,29519,30483,1,32,9,1,0,0,0,8,324,86,24308,27796,30238,1,40,-8,4174,5,1723,245,-1,0,1,0,-7
EUN1_3567189970',8,36,15,0,0,0,0,8,1,319,85,27981,28199,33336,3,26,16,1,0,0,0,2,327,94,29382,31116,32849,1,-8,-9,-1401,-1,-2917,487,-1,0,0,0,6
EUN1_3567165564',3,25,23,0,0,0,0,8,0,340,71,31813,29746,38302,4,28,18,1,0,2,0,6,327,78,31014,28840,35373,0,13,-7,799,5,906,2929,-1,0,-2,0,2
EUN1_3567153165',3,48,12,1,0,1,0,4,0,374,80,28194,30557,31730,5,18,15,1,1,0,0,2,364,91,28395,31046,35417,1,10,-11,-201,-3,-489,-3687,0,-1,1,0,2
EUN1_3565508345',3,58,12,0,0,0,0,9,0,314,82,26878,27541,35830,7,74,20,1,0,0,0,3,301,70,27905,30777,34351,0,13,12,-1027,-8,-3236,1479,-1,0,0,0,6
EUN1_3565300835',1,35,7,0,0,0,0,4,1,349,80,24096,29135,24375,4,26,8,2,1,0,0,0,396,104,26589,31423,33834,0,-47,-24,-2493,-1,-2288,-9459,-2,-1,0,0,4
EUN1_3565278781',2,23,15,0,0,0,0,7,1,339,63,27459,29919,31051,2,18,10,1,0,0,0,0,351,74,25436,27326,29556,1,-12,-11,2023,5,2593,1495,-1,0,0,0,7
EUN1_3565264340',2,47,12,1,0,0,0,10,0,314,86,26531,30409,32677,1,24,13,0,0,2,0,0,396,92,29289,30904,31733,0,-82,-6,-2758,-1,-495,944,1,0,-2,0,10
EUN1_3565239798',3,29,7,0,0,1,0,11,0,324,100,26001,28424,22394,2,30,13,2,0,2,0,6,347,79,28367,29994,28716,0,-23,21,-2366,-6,-1570,-6322,-2,0,-1,0,5
EUN1_3564869118',1,23,7,1,0,0,0,12,1,343,85,24938,28976,23774,4,26,10,1,1,1,0,2,351,90,26935,29938,24585,1,-8,-5,-1997,-3,-962,-811,0,-1,-1,0,10
EUN1_3564394353',3,29,21,2,1,1,0,9,1,339,82,31587,32020,39306,5,30,13,0,0,1,0,7,344,82,27556,29299,36653,1,-5,0,4031,8,2721,2653,2,1,0,0,2
EUN1_3564370364',3,262,17,2,0,0,0,4,1,364,76,28559,30461,38761,8,63,13,0,0,1,0,7,284,84,27354,29167,37599,1,80,-8,1205,4,1294,1162,2,0,-1,0,-3
EUN1_3564255417',4,25,10,1,0,0,0,12,0,369,91,26729,29260,28640,6,26,12,1,0,1,0,3,355,102,27778,30005,24184,0,14,-11,-1049,-2,-745,4456,0,0,-1,0,9
EUN1_3575757651',1,19,17,1,0,2,0,5,0,359,88,30152,31432,40222,4,23,10,1,0,0,0,7,327,84,24418,27465,29647,1,32,4,5734,7,3967,10575,0,0,2,0,-2
EUN1_3575744459',4,26,5,1,0,0,0,7,1,356,90,23707,27389,23761,5,27,4,0,1,0,0,3,385,86,23754,30428,23198,0,-29,4,-47,1,-3039,563,1,-1,0,0,4
EUN1_3575738142',2,25,8,0,0,0,0,14,0,346,102,25637,28702,23564,4,29,14,2,1,2,0,4,346,90,29428,29998,31012,0,0,12,-3791,-6,-1296,-7448,-2,-1,-2,0,10
EUN1_3574282815',4,30,7,0,1,0,0,7,0,333,92,23984,28805,24229,4,31,7,1,0,1,0,2,337,76,25183,27614,26123,1,-4,16,-1199,0,1191,-1894,-1,1,-1,0,5
EUN1_3574261001',4,26,9,1,0,0,0,15,0,307,68,24220,28672,29182,3,27,14,0,0,3,0,4,374,100,31012,33987,35564,0,-67,-32,-6792,-5,-5315,-6382,1,0,-3,0,11
EUN1_3574171188',1,21,8,0,0,0,0,13,0,320,80,24111,27179,29329,6,24,17,2,0,2,0,3,305,116,28634,32411,30837,0,15,-36,-4523,-9,-5232,-1508,-2,0,-2,0,10
EUN1_3573799384',3,27,10,0,0,0,0,13,0,309,84,25276,27656,26120,3,78,10,2,0,1,0,2,364,88,28077,29176,33166,1,-55,-4,-2801,0,-1520,-7046,-2,0,-1,0,11
EUN1_3573744021',5,31,8,1,0,0,0,9,1,316,74,24382,26004,29405,2,61,19,0,1,1,0,2,379,90,31898,30872,37857,0,-63,-16,-7516,-11,-4868,-8452,1,-1,-1,0,7
EUN1_3573727632',3,23,12,1,0,0,0,9,1,384,83,26391,31965,32167,4,31,15,0,0,1,0,4,355,80,28610,31940,37279,1,29,3,-2219,-3,25,-5112,1,0,-1,0,5
EUN1_3575008222',1,38,20,1,1,1,0,2,1,321,104,30697,30930,41631,0,16,13,1,0,0,0,8,349,94,27204,29755,37265,0,-28,10,3493,7,1175,4366,0,1,1,0,-6
EUN1_3576012835',3,20,17,1,1,0,0,9,1,356,108,30042,30626,31695,3,23,13,0,0,0,0,2,351,92,28535,29395,34299,1,5,16,1507,4,1231,-2604,1,1,0,0,7
EUN1_3575327787',4,23,11,1,0,1,0,8,0,344,84,26276,28831,27456,5,31,12,1,0,1,0,3,344,96,26372,28814,30547,1,0,-12,-96,-1,17,-3091,0,0,0,0,5
EUN1_3575309027',1,24,22,2,0,0,0,11,0,339,117,30152,33894,40103,3,97,8,0,0,0,0,2,354,102,26071,29269,33890,1,-15,15,4081,14,4625,6213,2,0,0,0,9
EUN1_3574840056',3,20,17,2,0,1,0,9,0,345,97,29604,31471,36248,2,184,14,0,1,0,0,4,303,78,26805,28833,29347,1,42,19,2799,3,2638,6901,2,-1,1,0,5
EUN1_3574827533',4,25,7,2,0,0,0,10,0,377,111,24999,30256,26511,2,19,11,0,0,1,0,0,352,78,27553,30238,33611,0,25,33,-2554,-4,18,-7100,2,0,-1,0,10
EUN1_3574809623',5,27,18,1,0,1,0,7,1,352,91,30542,30831,38421,5,28,16,1,0,0,0,5,305,73,27084,29002,36274,1,47,18,3458,2,1829,2147,0,0,1,0,2
EUN1_3574444579',4,24,11,0,0,0,0,8,0,340,91,26761,30584,31008,6,33,14,2,0,0,0,1,362,92,27712,31522,36543,1,-22,-1,-951,-3,-938,-5535,-2,0,0,0,7
EUN1_3574411565',4,28,10,0,0,0,0,9,1,296,97,24336,27063,27413,0,24,13,0,0,0,0,2,344,84,26338,28547,28229,0,-48,13,-2002,-3,-1484,-816,0,0,0,0,7
EUN1_3574395551',1,24,16,2,0,2,0,9,1,381,120,30431,33170,35721,4,34,6,0,0,0,0,4,345,68,23507,26430,25085,1,36,52,6924,10,6740,10636,2,0,2,0,5
EUN1_3573942602',3,24,19,1,1,3,0,5,0,372,92,32307,32230,40166,4,22,8,1,0,0,0,7,310,92,25858,25847,27040,1,62,0,6449,11,6383,13126,0,1,3,0,-2
EUN1_3573913281',3,30,24,1,1,2,0,10,1,372,98,34151,31982,38257,5,23,8,1,0,0,0,8,340,94,25327,27399,19594,1,32,4,8824,16,4583,18663,0,1,2,0,2
EUN1_3573698182',4,24,14,1,1,2,0,8,0,363,84,29207,30412,29815,3,23,13,1,0,0,0,6,346,97,27464,30110,27210,0,17,-13,1743,1,302,2605,0,1,2,0,2
EUN1_3573678160',3,50,13,0,0,0,0,9,0,323,84,26582,29966,22424,5,29,12,1,0,1,0,1,381,99,28218,30131,33094,0,-58,-15,-1636,1,-165,-10670,-1,0,-1,0,8
EUN1_3573640932',0,19,12,0,0,1,0,5,0,358,79,27017,30613,30759,4,32,14,2,0,0,0,0,372,116,28036,31624,30485,0,-14,-37,-1019,-2,-1011,274,-2,0,1,0,5
EUN1_3573614687',4,28,24,1,0,3,0,9,1,375,98,34351,31859,42721,2,24,17,1,0,0,0,6,301,85,27548,27857,31344,1,74,13,6803,7,4002,11377,0,0,3,0,3
EUN1_3573610175',1,16,15,1,0,0,0,10,1,296,70,26504,25996,31100,4,31,18,1,0,0,0,2,373,46,28136,29981,36683,1,-77,24,-1632,-3,-3985,-5583,0,0,0,0,8
EUN1_3573166958',2,24,17,0,0,0,0,5,0,350,97,29082,31975,35716,3,191,7,1,0,0,0,1,333,78,23714,26625,31238,0,17,19,5368,10,5350,4478,-1,0,0,0,4
EUN1_3573156362',1,31,12,0,0,0,0,10,0,336,100,27769,29917,29228,4,25,15,2,0,0,0,2,321,100,28190,28948,36365,0,15,0,-421,-3,969,-7137,-2,0,0,0,8
EUN1_3573100442',4,27,14,1,0,0,0,14,0,325,94,28476,26901,37443,2,91,19,1,0,1,0,2,341,86,31610,29550,37662,1,-16,8,-3134,-5,-2649,-219,0,0,-1,0,12
EUN1_3572525983',6,27,19,1,0,1,0,8,1,355,80,31158,29829,31919,2,96,10,1,0,0,0,3,326,86,26338,27231,29342,1,29,-6,4820,9,2598,2577,0,0,1,0,5
EUN1_3575506386',3,31,13,1,0,0,0,7,0,367,78,26423,30371,37338,1,24,6,1,0,0,0,1,336,94,24614,28236,28231,0,31,-16,1809,7,2135,9107,0,0,0,0,6
EUN1_3575449901',2,22,17,2,0,0,0,9,0,294,78,28508,29374,37093,1,13,14,0,0,0,0,6,367,78,29147,30131,41665,1,-73,0,-639,3,-757,-4572,2,0,0,0,3
EUN1_3575433382',3,27,13,1,0,0,0,9,1,343,113,29638,30032,37399,5,36,11,1,0,2,0,6,326,61,25355,27712,28734,1,17,52,4283,2,2320,8665,0,0,-2,0,3
EUN1_3575401988',2,18,8,1,0,0,0,5,1,342,64,25988,27599,27023,3,20,12,1,0,2,0,7,331,80,26467,28253,32449,0,11,-16,-479,-4,-654,-5426,0,0,-2,0,-2
EUN1_3574924926',3,33,13,0,0,0,0,9,0,379,88,27793,30966,34852,3,22,11,2,0,0,0,6,364,88,27318,29190,28194,0,15,0,475,2,1776,6658,-2,0,0,0,3
EUN1_3574897896',2,18,17,0,0,1,0,6,1,354,82,30112,32038,39840,3,43,9,2,0,0,0,5,346,89,25281,28984,31099,1,8,-7,4831,8,3054,8741,-2,0,1,0,1
EUN1_3574879811',3,24,5,1,0,0,0,9,0,362,72,23047,26883,22641,2,24,17,1,1,1,0,0,383,102,30133,31331,33971,0,-21,-30,-7086,-12,-4448,-11330,0,-1,-1,0,9
EUN1_3574869231',4,67,12,1,0,0,0,11,0,316,107,27406,28077,29676,3,24,24,1,0,2,0,6,355,64,32513,31225,44353,0,-39,43,-5107,-12,-3148,-14677,0,0,-2,0,5
EUN1_3574843906',2,23,9,1,0,0,0,14,0,322,98,24916,29199,18487,1,21,19,1,1,2,0,1,417,82,32664,32754,38312,0,-95,16,-7748,-10,-3555,-19825,0,-1,-2,0,13
EUN1_3574298416',1,17,7,1,0,0,0,7,1,346,76,24361,28861,26788,7,30,14,1,0,1,0,2,352,84,28296,30404,34157,1,-6,-8,-3935,-7,-1543,-7369,0,0,-1,0,5
EUN1_3574287279',4,25,22,1,0,3,0,8,1,350,87,33485,31397,39069,3,22,3,0,0,3,0,10,331,104,23685,26362,22705,1,19,-17,9800,19,5035,16364,1,0,0,0,-2
EUN1_3574265597',0,27,9,2,0,0,0,7,0,401,107,26389,30792,26053,4,25,8,0,0,0,0,0,372,88,25374,30787,27223,1,29,19,1015,1,5,-1170,2,0,0,0,7
EUN1_3574251544',1,39,14,1,0,2,0,7,0,358,104,29161,30950,32716,4,22,8,1,0,0,0,6,335,98,24431,27277,24628,1,23,6,4730,6,3673,8088,0,0,2,0,1
EUN1_3574237359',3,31,11,2,1,1,0,5,0,352,99,27616,29298,27110,4,42,7,0,0,0,0,4,366,100,25672,28444,26836,1,-14,-1,1944,4,854,274,2,1,1,0,1
EUN1_3574219455',3,26,9,1,1,1,0,11,1,331,67,26109,27263,27509,3,28,13,1,0,1,0,3,351,96,27264,31696,32408,0,-20,-29,-1155,-4,-4433,-4899,0,1,0,0,8
EUN1_3574207135',2,43,8,2,0,0,0,8,0,365,92,25672,31435,31229,2,17,9,0,0,0,0,1,347,87,25378,29673,31214,1,18,5,294,-1,1762,15,2,0,0,0,7
EUN1_3574188203',1,16,18,1,0,1,0,7,0,350,102,30395,31178,32696,4,52,13,1,0,1,0,6,356,84,26506,28006,40136,1,-6,18,3889,5,3172,-7440,0,0,0,0,1
EUN1_3574161820',5,28,12,0,0,0,0,10,1,297,79,24593,28433,27729,6,39,11,2,0,1,0,0,353,80,26166,28404,36552,0,-56,-1,-1573,1,29,-8823,-2,0,-1,0,10
EUN1_3572220627',7,35,24,2,0,2,0,4,0,361,101,32805,31792,43872,3,20,7,0,0,0,0,10,309,76,23147,25810,33206,1,52,25,9658,17,5982,10666,2,0,2,0,-6
EUN1_3558436221',6,28,13,2,0,0,0,9,0,331,82,26644,29477,29077,3,32,11,0,0,1,0,1,350,90,27938,29640,32914,0,-19,-8,-1294,2,-163,-3837,2,0,-1,0,8
EUN1_3558418832',4,20,17,0,0,0,0,7,1,376,102,28705,32804,32770,3,24,3,2,0,0,0,1,367,106,23075,27960,23824,1,9,-4,5630,14,4844,8946,-2,0,0,0,6
EUN1_3558409394',5,225,13,1,0,1,0,5,1,365,102,28276,30308,29315,1,30,8,1,0,0,0,4,365,69,25274,27895,28471,1,0,33,3002,5,2413,844,0,0,1,0,1
EUN1_3558388871',5,44,12,1,0,0,0,10,0,319,72,25716,26999,27302,3,24,18,1,0,2,0,2,351,104,31061,32106,33424,0,-32,-32,-5345,-6,-5107,-6122,0,0,-2,0,8
EUN1_3558370424',2,23,14,2,0,0,0,5,1,351,96,28995,30514,37267,3,28,10,0,1,1,0,5,384,92,28288,30375,36639,1,-33,4,707,4,139,628,2,-1,-1,0,0
EUN1_3557728957',7,58,16,2,0,0,0,16,1,315,102,28587,30900,25491,7,28,6,0,1,2,0,2,367,114,27102,28964,27083,1,-52,-12,1485,10,1936,-1592,2,-1,-2,0,14
EUN1_3557617444',5,135,10,0,0,0,0,10,1,270,78,24935,25579,28067,5,33,18,2,0,0,0,1,360,90,29869,31827,36710,1,-90,-12,-4934,-8,-6248,-8643,-2,0,0,0,9
EUN1_3557592919',1,22,17,2,1,5,0,7,1,391,96,33155,32283,47802,2,218,12,0,0,0,0,9,337,102,27611,30157,33437,1,54,-6,5544,5,2126,14365,2,1,5,0,-2
EUN1_3557567924',1,24,14,0,0,0,0,10,1,303,72,26320,27305,30414,3,31,13,1,0,1,0,2,294,92,27666,27904,39638,0,9,-20,-1346,1,-599,-9224,-1,0,-1,0,8
EUN1_3557374908',2,25,23,1,0,0,0,9,1,324,89,32561,28903,44528,2,23,21,0,0,2,0,5,290,88,29570,30788,38905,1,34,1,2991,2,-1885,5623,1,0,-2,0,4
EUN1_3557365884',3,62,19,1,0,1,0,7,0,333,83,30755,31578,37957,7,60,16,0,0,0,0,3,269,84,26993,27506,35693,1,64,-1,3762,3,4072,2264,1,0,1,0,4
EUN1_3557356738',0,16,12,1,0,1,0,11,0,359,81,27687,28609,34404,2,44,15,1,0,0,0,7,346,95,29890,30139,36894,1,13,-14,-2203,-3,-1530,-2490,0,0,1,0,4
EUN1_3557352096',1,61,18,0,1,2,0,11,1,336,98,31397,31178,37812,7,34,20,1,0,1,0,6,346,69,30080,29257,36853,0,-10,29,1317,-2,1921,959,-1,1,1,0,5
EUN1_3559112016',3,44,16,1,0,1,0,9,1,337,120,30237,31832,37600,2,26,8,0,0,1,0,4,309,83,25144,28379,30435,1,28,37,5093,8,3453,7165,1,0,0,0,5
EUN1_3558522209',4,102,13,2,0,1,0,6,0,358,92,29070,32118,27537,3,69,8,0,0,1,0,9,378,96,26881,31015,27303,0,-20,-4,2189,5,1103,234,2,0,0,0,-3
EUN1_3557580202',4,30,13,0,0,1,0,5,0,383,92,28124,30010,27252,2,140,9,1,0,1,0,5,333,87,25955,29301,35825,1,50,5,2169,4,709,-8573,-1,0,0,0,0
EUN1_3557452260',4,25,7,2,0,0,0,5,1,359,108,26292,29418,27925,4,23,6,0,0,1,0,3,352,100,24374,28678,19608,1,7,8,1918,1,740,8317,2,0,-1,0,2
EUN1_3557443256',5,39,3,0,0,0,0,14,0,278,96,22013,26718,17418,6,69,15,2,1,4,0,0,393,135,33121,34237,34820,0,-115,-39,-11108,-12,-7519,-17402,-2,-1,-4,0,14
EUN1_3557440122',0,22,14,0,0,0,0,15,0,289,67,26582,26169,32809,6,189,26,2,1,3,0,0,345,112,33170,31655,46117,0,-56,-45,-6588,-12,-5486,-13308,-2,-1,-3,0,15
EUN1_3557192286',0,70,11,0,0,2,0,2,0,318,89,26697,27980,33570,4,40,17,2,0,0,0,5,242,86,26031,28177,37514,0,76,3,666,-6,-197,-3944,-2,0,2,0,-3
EUN1_3554609733',3,68,24,1,0,3,0,7,1,364,110,34881,34700,40543,1,39,7,1,1,0,0,13,305,102,24589,29014,36581,1,59,8,10292,17,5686,3962,0,-1,3,0,-6
EUN1_3554593891',4,26,18,2,0,0,0,3,0,360,102,29355,31857,36262,3,25,7,0,0,1,0,4,355,102,24374,29446,18513,1,5,0,4981,11,2411,17749,2,0,-1,0,-1
EUN1_3554497339',5,31,11,1,1,1,0,6,1,390,123,29092,32663,34150,5,32,10,1,0,0,0,5,331,90,25918,30505,34778,0,59,33,3174,1,2158,-628,0,1,1,0,1
EUN1_3553999595',6,78,13,1,0,0,0,11,0,314,120,27441,30765,38234,4,22,12,1,0,1,0,3,342,100,27317,29859,33013,0,-28,20,124,1,906,5221,0,0,-1,0,8
EUN1_3553986337',4,70,15,2,0,0,0,12,0,352,116,30093,31849,37874,3,29,19,0,0,3,0,4,331,64,31041,30626,41822,1,21,52,-948,-4,1223,-3948,2,0,-3,0,8
EUN1_3553965843',6,26,15,2,0,1,0,7,1,337,110,30064,32601,40407,4,177,10,0,1,0,0,6,365,102,26013,30047,36849,1,-28,8,4051,5,2554,3558,2,-1,1,0,1
EUN1_3553945042',6,44,19,2,1,4,0,12,1,292,116,32413,30473,35890,2,24,8,0,0,1,0,12,349,82,25535,27015,25723,1,-57,34,6878,11,3458,10167,2,1,3,0,0
EUN1_3553070585',6,78,14,1,1,2,0,6,1,320,113,29959,31109,31366,1,26,9,0,0,0,0,10,317,78,25637,29095,29413,1,3,35,4322,5,2014,1953,1,1,2,0,-4
EUN1_3553028559',1,27,16,0,0,1,0,11,1,319,90,29791,30904,37456,3,67,17,1,1,0,0,6,323,100,28595,30096,41282,0,-4,-10,1196,-1,808,-3826,-1,-1,1,0,5
EUN1_3576233331',2,25,10,0,0,0,0,10,0,291,79,24407,27584,26214,4,28,18,2,0,1,0,0,399,124,31262,33345,34810,0,-108,-45,-6855,-8,-5761,-8596,-2,0,-1,0,10
EUN1_3569729223',1,22,14,0,0,0,0,9,1,344,86,28269,29698,38702,1,23,18,1,0,0,0,4,378,102,30372,33820,41942,0,-34,-16,-2103,-4,-4122,-3240,-1,0,0,0,5
EUN1_3569677929',7,27,11,1,0,1,0,7,0,385,70,28186,29567,35042,5,26,15,0,0,1,0,5,382,90,30578,31360,40060,0,3,-20,-2392,-4,-1793,-5018,1,0,0,0,2
EUN1_3568826483',11,37,4,0,0,0,0,8,0,364,90,23302,27508,27166,5,20,8,2,1,0,0,3,396,106,26184,31876,24766,0,-32,-16,-2882,-4,-4368,2400,-2,-1,0,0,5
EUN1_3566601248',4,26,10,0,1,2,0,8,0,400,89,28750,31191,30865,2,25,16,1,0,1,0,7,323,93,28059,30186,33067,0,77,-4,691,-6,1005,-2202,-1,1,1,0,1
EUN1_3564834548',2,29,19,1,0,1,0,12,0,359,77,30351,30175,39760,2,28,13,1,0,2,0,3,317,78,27485,28289,37278,0,42,-1,2866,6,1886,2482,0,0,-1,0,9
EUN1_3575615716',1,24,17,0,0,1,0,6,0,328,91,29745,29766,38541,3,29,13,2,0,0,0,7,329,82,27326,29438,32615,0,-1,9,2419,4,328,5926,-2,0,1,0,-1
EUN1_3575062360',4,256,9,1,0,0,0,3,1,354,96,24843,29116,25791,3,40,8,1,0,0,0,1,383,111,25610,31279,27831,0,-29,-15,-767,1,-2163,-2040,0,0,0,0,2
EUN1_3575028899',3,20,18,0,0,1,0,6,1,362,80,30622,30965,34266,1,28,10,1,0,1,0,6,315,84,26038,28828,26817,0,47,-4,4584,8,2137,7449,-1,0,0,0,0
EUN1_3574553414',2,24,11,0,0,0,0,14,1,295,68,25698,26532,33243,5,22,22,2,0,1,0,2,367,123,32686,33577,49001,0,-72,-55,-6988,-11,-7045,-15758,-2,0,-1,0,12
EUN1_3574039298',1,116,10,0,0,0,0,4,1,309,108,25296,28911,32305,4,25,19,2,1,0,0,2,294,100,28196,30202,33559,0,15,8,-2900,-9,-1291,-1254,-2,-1,0,0,2
EUN1_3573955943',3,83,14,0,0,1,0,8,1,356,86,29171,30126,36123,4,28,16,0,0,0,0,2,327,78,28167,29374,39621,0,29,8,1004,-2,752,-3498,0,0,1,0,6
EUN1_3573939291',2,26,12,0,0,0,0,11,0,299,75,26346,27023,27420,5,31,20,2,0,4,0,2,336,100,33292,30360,42845,0,-37,-25,-6946,-8,-3337,-15425,-2,0,-4,0,9
EUN1_3573873670',4,28,19,2,0,1,0,7,0,300,98,28664,29655,30746,1,25,7,0,1,2,0,2,310,73,24238,24731,26239,1,-10,25,4426,12,4924,4507,2,-1,-1,0,5
EUN1_3573859169',1,19,11,1,0,0,0,11,0,316,84,26131,29882,29086,2,41,16,1,0,2,0,1,379,92,30144,33118,47888,0,-63,-8,-4013,-5,-3236,-18802,0,0,-2,0,10
EUN1_3573825871',2,25,20,1,0,1,0,7,1,353,104,32118,33315,40749,2,30,7,1,0,0,0,8,319,80,23869,27222,26717,1,34,24,8249,13,6093,14032,0,0,1,0,-1
EUN1_3573183682',4,31,7,0,0,0,0,6,0,341,80,24252,27951,27713,3,34,12,2,0,0,0,2,357,88,26510,28915,30785,0,-16,-8,-2258,-5,-964,-3072,-2,0,0,0,4
EUN1_3573170470',2,29,20,2,0,2,0,8,0,374,109,32174,34563,38661,5,34,7,0,0,1,0,8,318,82,24089,27357,25670,1,56,27,8085,13,7206,12991,2,0,1,0,0
EUN1_3573151517',5,38,12,0,0,0,0,13,0,286,75,26712,24947,32432,3,26,22,1,0,2,0,7,328,74,31246,28159,37300,0,-42,1,-4534,-10,-3212,-4868,-1,0,-2,0,6
EUN1_3573058477',4,26,13,0,0,0,0,11,1,303,71,27004,28294,29588,4,24,21,2,0,1,0,3,338,98,31342,30855,40490,0,-35,-27,-4338,-8,-2561,-10902,-2,0,-1,0,8
EUN1_3571756075',3,65,13,0,0,0,0,2,1,385,93,28440,31037,28851,4,26,21,1,1,0,0,7,339,94,31226,32077,36615,0,46,-1,-2786,-8,-1040,-7764,-1,-1,0,0,-5
EUN1_3570511556',3,26,18,0,0,1,0,8,0,304,90,29465,29495,37623,6,30,15,2,0,0,0,4,272,71,26392,25900,38246,1,32,19,3073,3,3595,-623,-2,0,1,0,4
EUN1_3576240879',2,26,12,0,0,0,0,9,1,407,116,30890,31613,34872,6,41,11,1,0,1,0,1,330,64,25665,27612,29904,1,77,52,5225,1,4001,4968,-1,0,-1,0,8
EUN1_3576231002',5,70,15,0,0,1,0,12,0,330,72,28297,30406,27960,7,26,10,1,1,2,0,4,369,103,27709,29706,31409,1,-39,-31,588,5,700,-3449,-1,-1,-1,0,8
EUN1_3576125975',0,24,18,1,0,0,0,7,1,336,76,28502,32113,37059,1,16,16,1,1,1,0,4,336,100,29996,32652,36441,0,0,-24,-1494,2,-539,618,0,-1,-1,0,3
EUN1_3576093909',5,31,13,2,0,0,0,15,0,338,96,28036,31765,34141,2,16,18,0,0,2,0,4,327,84,28801,31034,39176,1,11,12,-765,-5,731,-5035,2,0,-2,0,11
EUN1_3576062934',1,25,11,0,1,1,0,8,0,322,96,27339,29202,28274,3,29,7,2,0,0,0,4,345,96,24807,28992,22668,0,-23,0,2532,4,210,5606,-2,1,1,0,4
EUN1_3576043607',3,24,14,2,0,0,0,11,1,364,88,27561,30094,32649,1,20,11,0,0,1,0,3,358,84,27915,31363,29420,1,6,4,-354,3,-1269,3229,2,0,-1,0,8
EUN1_3576021676',5,53,22,0,0,2,0,10,0,322,84,31203,32944,41250,2,23,11,2,0,0,0,5,292,72,24124,27299,28646,1,30,12,7079,11,5645,12604,-2,0,2,0,5
EUN1_3575631561',7,39,19,1,0,0,0,10,0,286,95,28662,28855,33642,3,29,22,1,0,1,0,3,323,83,31068,28183,44816,1,-37,12,-2406,-3,672,-11174,0,0,-1,0,7
EUN1_3575618287',3,32,11,1,0,0,0,12,1,315,68,26559,27450,30119,3,61,22,1,0,2,0,3,340,76,31867,31882,39410,0,-25,-8,-5308,-11,-4432,-9291,0,0,-2,0,9
EUN1_3575602138',3,25,12,2,1,1,0,7,1,362,124,27022,31426,28746,4,39,7,0,0,0,0,4,331,78,23633,29231,28809,0,31,46,3389,5,2195,-63,2,1,1,0,3
EUN1_3575577388',2,26,10,0,0,0,0,6,1,351,74,25626,28934,30442,3,24,15,2,0,1,0,3,321,98,27381,29686,37172,0,30,-24,-1755,-5,-752,-6730,-2,0,-1,0,3
EUN1_3575244812',3,24,18,2,1,1,0,13,0,315,76,27903,30336,34951,4,28,10,0,0,1,0,1,332,84,27461,27947,32009,0,-17,-8,442,8,2389,2942,2,1,0,0,12
EUN1_3575223980',4,27,13,1,0,1,0,17,0,379,88,29169,31251,34853,3,28,9,1,1,2,0,1,368,99,27670,32021,26909,1,11,-11,1499,4,-770,7944,0,-1,-1,0,16
EUN1_3575209895',0,26,15,0,0,0,0,11,1,368,72,29067,31102,33192,3,17,14,1,0,1,0,5,315,107,29102,29204,27082,0,53,-35,-35,1,1898,6110,-1,0,-1,0,6
EUN1_3571664283',3,44,12,1,0,0,0,11,1,324,85,26318,28351,29434,2,18,9,1,0,1,0,5,317,98,26097,28933,22942,1,7,-13,221,3,-582,6492,0,0,-1,0,6
EUN1_3574220741',2,26,17,1,1,0,0,8,0,340,94,30551,30091,31268,5,36,19,0,0,1,0,5,333,74,28950,29411,36033,0,7,20,1601,-2,680,-4765,1,1,-1,0,3
EUN1_3574203511',0,39,13,0,0,0,0,9,0,321,86,25980,28901,25386,5,121,10,2,0,1,0,1,426,95,28355,31712,29558,0,-105,-9,-2375,3,-2811,-4172,-2,0,-1,0,8
EUN1_3574132193',5,34,17,1,0,0,0,11,1,296,66,27215,26277,40088,4,29,22,1,0,0,0,2,346,90,30892,30848,42339,0,-50,-24,-3677,-5,-4571,-2251,0,0,0,0,9
EUN1_3573781962',6,30,11,1,0,0,0,11,0,347,77,27372,28452,31510,6,22,17,1,0,3,0,6,389,94,33413,32717,33954,1,-42,-17,-6041,-6,-4265,-2444,0,0,-3,0,5
EUN1_3573777256',7,34,11,0,1,1,0,6,1,379,100,28493,31818,32668,5,23,10,1,0,0,0,5,407,72,26811,30254,34562,1,-28,28,1682,1,1564,-1894,-1,1,1,0,1
EUN1_3573580253',6,33,17,1,1,0,0,8,0,343,108,29034,31564,33128,2,26,9,0,0,2,0,4,359,72,26971,27396,30274,1,-16,36,2063,8,4168,2854,1,1,-2,0,4
EUN1_3576027854',5,33,19,0,1,3,0,10,1,417,78,34459,33750,37322,4,329,7,1,0,0,0,10,342,72,24222,26858,18683,1,75,6,10237,12,6892,18639,-1,1,3,0,0
EUN1_3575997793',7,33,19,0,0,1,0,9,0,299,75,28938,27765,35955,3,32,11,2,0,0,0,7,364,84,27119,30575,30472,1,-65,-9,1819,8,-2810,5483,-2,0,1,0,2
EUN1_3575272578',7,36,17,2,0,0,0,15,1,361,94,29502,30285,45016,6,99,8,0,1,2,0,2,317,94,27297,27526,36332,0,44,0,2205,9,2759,8684,2,-1,-2,0,13
EUN1_3575251850',0,258,5,1,0,0,0,9,0,351,90,23567,29339,36250,6,33,18,1,0,2,0,4,367,77,30789,29588,35462,0,-16,13,-7222,-13,-249,788,0,0,-2,0,5
EUN1_3574426691',4,30,15,1,1,0,0,11,0,343,84,28901,29177,33545,0,18,20,1,0,2,0,8,337,113,32610,32505,35146,0,6,-29,-3709,-5,-3328,-1601,0,1,-2,0,3
EUN1_3574404729',5,30,16,1,0,2,0,9,1,333,88,30026,30333,32918,5,29,17,1,0,0,0,8,330,98,29253,30993,34748,1,3,-10,773,-1,-660,-1830,0,0,2,0,1
EUN1_3574381979',1,29,10,0,0,1,0,5,1,371,84,27113,28052,33837,4,33,13,0,0,1,0,6,297,82,26504,26929,26793,1,74,2,609,-3,1123,7044,0,0,0,0,-1
EUN1_3574127823',5,29,14,1,0,0,0,10,1,322,90,27706,30294,37317,2,22,13,1,0,2,0,3,331,98,28917,30972,40349,1,-9,-8,-1211,1,-678,-3032,0,0,-2,0,7
EUN1_3572743439',3,23,15,1,0,0,0,9,1,350,110,28353,28621,33961,7,139,13,1,0,0,0,2,325,84,25496,28269,28281,1,25,26,2857,2,352,5680,0,0,0,0,7
EUN1_3572720506',1,44,22,1,0,0,0,7,1,323,69,31474,30389,35822,4,35,13,0,0,1,0,5,334,94,26323,27439,31840,1,-11,-25,5151,9,2950,3982,1,0,-1,0,2
EUN1_3572696563',6,32,15,2,0,1,0,10,1,322,89,27884,28991,31278,3,33,15,0,0,1,0,3,321,78,27539,27870,31352,1,1,11,345,0,1121,-74,2,0,0,0,7
EUN1_3572640481',5,30,18,2,0,0,0,8,1,366,88,29679,32898,35805,1,20,13,0,0,0,0,5,370,74,27222,30636,30579,1,-4,14,2457,5,2262,5226,2,0,0,0,3
EUN1_3572091190',1,23,12,0,0,0,0,14,1,298,86,26113,28057,29711,6,23,25,2,0,4,0,1,354,67,34617,29776,39419,0,-56,19,-8504,-13,-1719,-9708,-2,0,-4,0,13
EUN1_3572067574',4,25,7,0,0,0,0,7,0,303,86,23792,27573,27612,4,23,21,2,0,1,0,2,350,74,30302,31567,42460,0,-47,12,-6510,-14,-3994,-14848,-2,0,-1,0,5
EUN1_3571013477',5,61,10,1,0,1,0,7,1,368,95,25530,30509,24322,3,25,10,1,0,0,0,3,397,86,26145,32630,24246,1,-29,9,-615,0,-2121,76,0,0,1,0,4
EUN1_3557980135',1,24,8,1,0,0,0,10,1,361,90,25302,28982,26643,3,207,16,1,0,2,0,1,348,102,29943,30333,29544,1,13,-12,-4641,-8,-1351,-2901,0,0,-2,0,9
EUN1_3557978074',0,21,7,1,0,0,0,7,0,331,100,23876,30945,24021,3,32,7,1,0,0,0,1,400,88,25598,30626,26408,1,-69,12,-1722,0,319,-2387,0,0,0,0,6
EUN1_3557578286',6,148,12,2,0,0,0,5,0,339,100,27911,28724,31108,7,31,10,0,0,1,0,4,347,88,26792,28910,23096,1,-8,12,1119,2,-186,8012,2,0,-1,0,1
EUN1_3557424166',2,21,20,1,1,2,0,6,1,373,92,30712,32315,35588,2,14,6,0,0,0,0,7,325,96,24315,29066,27804,1,48,-4,6397,14,3249,7784,1,1,2,0,-1
EUN1_3557385166',2,26,19,0,0,2,0,6,0,375,102,31455,31517,33305,1,21,8,0,0,0,0,10,334,81,25581,28637,30821,1,41,21,5874,11,2880,2484,0,0,2,0,-4
EUN1_3553055788',1,40,13,0,0,2,0,10,1,344,76,28658,27690,26072,3,22,15,1,0,2,0,5,285,84,27704,28255,34115,1,59,-8,954,-2,-565,-8043,-1,0,0,0,5
EUN1_3553029155',2,21,11,0,0,0,0,6,0,342,92,27249,30207,29064,4,31,12,2,0,1,0,3,371,78,26395,29755,31273,1,-29,14,854,-1,452,-2209,-2,0,-1,0,3
EUN1_3552787500',2,48,14,1,0,0,0,7,0,373,78,28251,29230,27587,3,30,18,1,0,0,0,4,320,98,29158,28808,30084,0,53,-20,-907,-4,422,-2497,0,0,0,0,3
EUN1_3552638086',5,54,8,1,0,0,0,10,0,310,84,24016,27312,28523,7,73,18,1,0,1,0,2,383,96,30701,32409,40038,0,-73,-12,-6685,-10,-5097,-11515,0,0,-1,0,8
EUN1_3552603257',5,81,14,1,0,0,0,10,0,310,94,26605,30659,35159,3,79,10,0,0,1,0,3,342,77,26729,28643,32098,1,-32,17,-124,4,2016,3061,1,0,-1,0,7
EUN1_3552522507',0,21,15,1,0,1,0,17,0,352,96,29745,31556,33927,1,190,13,0,0,1,0,2,318,84,29304,29461,39600,1,34,12,441,2,2095,-5673,1,0,0,0,15
EUN1_3552448356',3,23,6,0,0,0,0,5,0,431,77,26210,30957,20297,5,40,8,2,0,1,0,4,338,118,24679,28755,17641,0,93,-41,1531,-2,2202,2656,-2,0,-1,0,1
EUN1_3552358467',1,24,8,0,0,0,0,8,0,327,92,25838,27360,27088,5,141,19,1,0,1,0,2,382,72,30279,31617,33295,0,-55,20,-4441,-11,-4257,-6207,-1,0,-1,0,6
EUN1_3552323784',3,25,4,0,0,0,0,6,0,359,88,24080,27786,16493,4,28,12,2,0,0,0,2,342,108,26753,30084,28531,0,17,-20,-2673,-8,-2298,-12038,-2,0,0,0,4
EUN1_3552301771',1,27,18,2,1,2,0,5,1,401,112,32700,33099,37683,0,30,5,0,0,1,0,4,343,80,23288,27964,22665,1,58,32,9412,13,5135,15018,2,1,1,0,1
EUN1_3552282520',2,24,18,2,0,1,0,8,1,315,99,29677,31168,36884,2,24,7,0,1,1,0,4,348,96,27268,28236,29032,1,-33,3,2409,11,2932,7852,2,-1,0,0,4
EUN1_3552051587',5,36,11,0,0,0,0,9,1,294,96,26314,27997,30417,3,24,20,1,0,0,0,2,338,80,29139,30123,35499,0,-44,16,-2825,-9,-2126,-5082,-1,0,0,0,7
EUN1_3552039546',3,26,14,1,0,1,0,10,1,340,111,28978,30336,30987,5,40,11,0,0,0,0,4,335,80,26357,28682,28369,1,5,31,2621,3,1654,2618,1,0,1,0,6
EUN1_3568935763',6,31,1,0,0,0,0,15,0,310,69,19858,25838,17444,7,39,11,1,0,3,0,2,391,100,29673,30611,29967,0,-81,-31,-9815,-10,-4773,-12523,-1,0,-3,0,13
EUN1_3568929221',7,32,9,1,0,2,0,9,1,323,84,26034,28073,28381,2,24,11,1,0,0,0,3,325,80,25254,28744,31035,0,-2,4,780,-2,-671,-2654,0,0,2,0,6
EUN1_3568538181',3,22,14,1,0,0,0,11,0,353,92,27985,30639,34398,0,17,12,1,0,1,0,3,343,79,28441,30075,30001,1,10,13,-456,2,564,4397,0,0,-1,0,8
EUN1_3568443678',0,20,10,0,0,0,0,7,0,277,64,23877,25381,22791,3,26,17,2,0,1,0,3,355,108,31406,32326,40757,0,-78,-44,-7529,-7,-6945,-17966,-2,0,-1,0,4
EUN1_3566142020',6,59,10,1,0,0,0,11,0,225,73,23494,23549,34065,4,27,20,0,0,2,0,2,326,91,32154,29966,42777,0,-101,-18,-8660,-10,-6417,-8712,1,0,-2,0,9
EUN1_3566117080',7,29,16,1,0,1,0,6,1,339,100,28812,29734,38842,5,40,17,1,0,0,0,3,278,96,28716,28661,33930,1,61,4,96,-1,1073,4912,0,0,1,0,3
EUN1_3566098291',1,22,12,2,0,1,0,9,1,327,96,26920,28618,29095,5,24,18,0,0,1,0,3,343,80,30138,30970,36880,1,-16,16,-3218,-6,-2352,-7785,2,0,0,0,6
EUN1_3560868640',7,32,9,1,0,0,0,10,1,365,90,25395,29045,29815,6,27,11,1,0,0,0,0,350,98,26472,29744,25167,1,15,-8,-1077,-2,-699,4648,0,0,0,0,10
EUN1_3560856274',6,31,16,2,0,2,0,9,0,400,80,30112,30762,27798,3,23,7,0,0,0,0,4,312,113,25202,26983,23385,1,88,-33,4910,9,3779,4413,2,0,2,0,5
EUN1_3560840254',1,24,16,1,0,0,0,9,1,359,80,28792,31340,38080,2,445,7,1,0,1,0,4,314,84,24078,27232,28770,1,45,-4,4714,9,4108,9310,0,0,-1,0,5
EUN1_3560823279',6,72,13,0,0,1,0,7,0,394,78,29256,30944,27177,6,32,7,1,0,0,0,5,393,117,26458,30106,23613,1,1,-39,2798,6,838,3564,-1,0,1,0,2
EUN1_3560803480',3,88,18,1,0,1,0,5,1,381,78,30099,31874,31175,5,126,6,1,0,0,0,5,361,78,24365,29470,24163,1,20,0,5734,12,2404,7012,0,0,1,0,0
EUN1_3560783979',3,27,18,2,1,1,0,8,1,392,106,31559,34055,39870,2,70,7,0,0,0,0,8,321,78,24309,27411,33356,1,71,28,7250,11,6644,6514,2,1,1,0,0
EUN1_3560751712',3,30,21,0,1,3,0,16,1,304,88,33174,30724,38943,1,19,14,2,0,2,0,9,337,72,29698,27918,37489,1,-33,16,3476,7,2806,1454,-2,1,1,0,7
EUN1_3560745328',7,29,19,1,0,0,0,7,0,370,108,29640,32621,31511,1,20,3,0,0,0,0,3,378,83,22759,27339,23390,1,-8,25,6881,16,5282,8121,1,0,0,0,4
EUN1_3576129946',2,44,14,0,0,1,0,7,0,347,89,27741,29846,30132,4,28,13,2,0,0,0,3,332,78,26769,29411,31824,0,15,11,972,1,435,-1692,-2,0,1,0,4
EUN1_3566607124',2,26,8,1,0,0,0,10,0,306,98,24524,26834,32238,4,21,18,1,0,1,0,3,353,102,30251,32517,40103,0,-47,-4,-5727,-10,-5683,-7865,0,0,-1,0,7
EUN1_3566591233',0,24,13,0,1,1,0,7,0,405,90,29382,32228,30275,6,31,10,1,0,0,0,5,378,86,26355,30382,30071,1,27,4,3027,3,1846,204,-1,1,1,0,2
EUN1_3566544492',3,24,8,2,0,0,0,11,0,347,66,24786,27466,29505,8,32,16,0,1,3,0,4,347,117,31873,31627,35991,0,0,-51,-7087,-8,-4161,-6486,2,-1,-3,0,7
EUN1_3565623834',6,156,13,2,0,0,0,7,1,359,100,27917,30805,31600,1,25,5,0,0,0,0,3,371,96,25332,28801,26684,1,-12,4,2585,8,2004,4916,2,0,0,0,4
EUN1_3565170080',5,41,8,0,0,0,0,5,0,359,82,25370,28074,24384,3,32,17,2,0,0,0,2,354,92,28346,31639,34753,0,5,-10,-2976,-9,-3565,-10369,-2,0,0,0,3
EUN1_3565079012',3,27,16,1,0,2,0,11,1,372,82,30033,32182,36429,1,17,11,1,0,0,0,4,320,80,25896,28072,29938,1,52,2,4137,5,4110,6491,0,0,2,0,7
EUN1_3564504067',4,23,8,0,0,1,0,6,1,318,83,26810,27041,27375,6,26,18,2,0,0,0,9,325,80,27761,29549,38438,0,-7,3,-951,-10,-2508,-11063,-2,0,1,0,-3
EUN1_3563258810',6,29,10,2,0,1,0,5,1,356,92,27210,30280,33556,8,34,10,0,0,0,0,3,354,56,24869,28473,27394,1,2,36,2341,0,1807,6162,2,0,1,0,2
EUN1_3563055241',3,24,6,0,0,0,0,11,0,347,78,24146,28504,23921,5,29,12,2,0,1,0,0,360,81,27339,30548,28613,0,-13,-3,-3193,-6,-2044,-4692,-2,0,-1,0,11
EUN1_3563047118',3,24,13,0,0,2,0,3,1,399,104,29855,30858,31571,0,37,7,1,0,1,0,7,300,83,23568,28242,22541,1,99,21,6287,6,2616,9030,-1,0,1,0,-4
EUN1_3562431657',4,25,12,1,0,0,0,10,1,335,60,27227,28745,30419,4,34,26,0,0,2,0,2,345,96,33223,33903,43141,0,-10,-36,-5996,-14,-5158,-12722,1,0,-2,0,8
EUN1_3562290606',1,18,21,1,0,1,0,4,1,324,86,30775,29661,42257,1,44,17,1,0,0,0,7,292,70,29562,28161,41983,0,32,16,1213,4,1500,274,0,0,1,0,-3
EUN1_3562267887',9,35,15,1,0,1,0,7,0,388,82,28539,30818,32305,4,28,12,1,0,0,0,3,332,70,26405,28135,27613,1,56,12,2134,3,2683,4692,0,0,1,0,4
EUN1_3576040556',2,23,11,1,0,1,0,4,0,371,93,27529,30674,28503,5,56,8,1,0,0,0,5,329,92,23646,27266,27785,1,42,1,3883,3,3408,718,0,0,1,0,-1
EUN1_3576013409',5,54,11,1,0,0,0,9,0,387,87,27068,30450,31549,7,27,11,0,0,0,0,1,393,85,27544,30730,28814,1,-6,2,-476,0,-280,2735,1,0,0,0,8
EUN1_3575906984',6,32,16,2,0,0,0,7,1,371,77,28423,32130,32924,8,25,11,0,0,0,0,0,346,86,26735,29544,34510,1,25,-9,1688,5,2586,-1586,2,0,0,0,7
EUN1_3575889743',3,37,11,0,0,0,0,4,1,339,69,26878,27301,29719,4,24,15,1,1,1,0,5,341,74,29050,30471,38988,0,-2,-5,-2172,-4,-3170,-9269,-1,-1,-1,0,-1
EUN1_3575861985',3,23,9,1,0,0,0,9,0,322,77,23371,28565,27022,4,51,9,0,0,1,0,2,383,98,27775,30724,35344,0,-61,-21,-4404,0,-2159,-8322,1,0,-1,0,7
EUN1_3575850513',1,24,8,0,0,1,0,7,1,385,81,26316,28459,31651,5,36,14,2,0,1,0,2,354,74,28230,29504,29345,0,31,7,-1914,-6,-1045,2306,-2,0,0,0,5
EUN1_3575573566',2,50,14,1,0,1,0,7,1,315,84,27678,27106,30218,4,20,11,1,0,1,0,4,317,76,25975,27815,29243,1,-2,8,1703,3,-709,975,0,0,0,0,3
EUN1_3575351671',1,21,5,1,0,0,0,6,0,360,92,23083,29464,20923,3,26,10,1,0,1,0,2,413,84,27585,31332,30400,0,-53,8,-4502,-5,-1868,-9477,0,0,-1,0,4
EUN1_3575330881',3,29,7,0,0,0,0,11,0,281,74,22907,26749,25658,7,26,16,2,0,2,0,1,362,100,30280,30871,43618,1,-81,-26,-7373,-9,-4122,-17960,-2,0,-2,0,10
EUN1_3575091551',3,23,7,0,0,0,0,10,0,290,24,20751,23137,29993,5,18,24,1,0,2,0,1,308,88,30478,31830,37900,0,-18,-64,-9727,-17,-8693,-7907,-1,0,-2,0,9
EUN1_3575066979',4,26,12,1,0,0,0,14,0,300,39,25587,26095,39931,7,49,24,1,0,2,0,2,313,88,32351,30855,50420,0,-13,-49,-6764,-12,-4760,-10489,0,0,-2,0,12
EUN1_3575046767',4,80,19,1,0,0,0,12,1,302,72,28949,27651,33062,3,69,15,1,0,2,0,1,300,68,27986,26739,31968,1,2,4,963,4,912,1094,0,0,-2,0,11
EUN1_3575031569',2,48,20,2,0,3,0,4,1,357,107,32947,31523,41343,1,31,9,0,0,0,0,12,231,71,22763,24568,23150,1,126,36,10184,11,6955,18193,2,0,3,0,-8
EUN1_3574803705',4,20,11,1,1,1,0,5,0,336,78,25962,28372,27647,2,30,7,1,0,0,0,6,308,77,23731,27792,26642,1,28,1,2231,4,580,1005,0,1,1,0,-1
EUN1_3574783855',3,43,13,1,0,0,0,10,1,315,60,25842,28617,25668,0,22,14,1,1,1,0,4,337,103,28301,30412,34999,0,-22,-43,-2459,-1,-1795,-9331,0,-1,-1,0,6
EUN1_3574337715',2,22,16,0,0,0,0,12,1,295,74,28407,27526,36523,1,21,24,1,0,1,0,4,322,81,30559,31748,39176,0,-27,-7,-2152,-8,-4222,-2653,-1,0,-1,0,8
EUN1_3575984671',3,15,19,2,0,0,0,11,1,352,106,31530,32597,42502,2,21,10,0,0,2,0,5,308,82,25901,28365,29274,1,44,24,5629,9,4232,13228,2,0,-2,0,6
EUN1_3575970242',3,34,12,2,0,2,0,6,1,418,113,30899,31934,33739,7,38,2,0,0,1,0,7,340,87,20592,26304,16569,1,78,26,10307,10,5630,17170,2,0,1,0,-1
EUN1_3575924165',4,27,22,2,0,3,0,3,0,366,92,33333,30870,40217,5,21,12,0,0,0,0,9,276,98,26029,27217,26565,1,90,-6,7304,10,3653,13652,2,0,3,0,-6
EUN1_3575640020',1,70,10,1,0,0,0,11,0,279,98,24331,28516,37133,3,59,9,1,0,1,0,0,341,102,26560,29280,35994,0,-62,-4,-2229,1,-764,1139,0,0,-1,0,11
EUN1_3575641089',3,24,16,1,0,0,0,6,1,317,112,29233,31011,35877,3,24,13,1,0,1,0,1,361,91,26838,30281,38494,0,-44,21,2395,3,730,-2617,0,0,-1,0,5
EUN1_3575619732',3,22,11,1,0,0,0,7,0,344,92,25372,30178,31170,6,26,11,0,0,0,0,2,311,68,24853,29262,30186,1,33,24,519,0,916,984,1,0,0,0,5
EUN1_3575608289',5,30,11,0,0,0,0,9,0,339,90,26027,29815,24059,1,35,7,2,0,2,0,2,364,90,25698,28565,23722,1,-25,0,329,4,1250,337,-2,0,-2,0,7
EUN1_3575584195',2,28,19,1,0,0,0,11,1,402,94,30709,34126,36596,2,21,10,1,0,1,0,6,352,60,25866,29439,32488,1,50,34,4843,9,4687,4108,0,0,-1,0,5
EUN1_3575520602',4,101,11,1,0,0,0,5,0,357,98,26589,31242,30099,4,30,8,0,1,0,0,0,365,90,25235,30163,23670,1,-8,8,1354,3,1079,6429,1,-1,0,0,5
EUN1_3576012064',2,24,15,0,0,0,0,8,0,308,66,28322,28716,37361,5,32,18,2,0,1,0,3,325,106,29981,30666,39229,0,-17,-40,-1659,-3,-1950,-1868,-2,0,-1,0,5
EUN1_3575985671',2,36,14,2,0,2,0,8,1,289,81,27300,27973,41890,7,25,8,0,0,0,0,7,286,64,24047,26084,33263,0,3,17,3253,6,1889,8627,2,0,2,0,1
EUN1_3575965253',4,28,14,0,0,1,0,8,0,368,64,28709,32367,31643,5,222,6,2,0,1,0,5,358,103,25290,28845,30075,0,10,-39,3419,8,3522,1568,-2,0,0,0,3
EUN1_3575928612',7,29,20,0,0,1,0,4,1,321,80,30084,30557,39141,3,38,18,2,0,0,0,10,302,68,26689,28461,38522,1,19,12,3395,2,2096,619,-2,0,1,0,-6
EUN1_3574350129',3,30,16,1,0,0,0,10,0,260,74,26432,27957,31614,5,40,17,1,0,1,0,0,342,77,28588,29256,36500,1,-82,-3,-2156,-1,-1299,-4886,0,0,-1,0,10
EUN1_3574326206',5,39,16,1,0,1,0,4,0,298,73,27480,26162,42747,8,36,23,1,0,0,0,3,314,70,30443,29137,40585,1,-16,3,-2963,-7,-2975,2162,0,0,1,0,1
EUN1_3574311184',3,75,13,1,0,0,0,8,0,311,84,25778,29346,29496,7,33,12,1,0,0,0,4,350,103,27659,28133,27118,0,-39,-19,-1881,1,1213,2378,0,0,0,0,4
EUN1_3574293223',6,27,7,1,0,0,0,6,1,383,91,24989,28442,33309,1,29,7,1,0,1,0,1,299,93,23121,27814,20604,0,84,-2,1868,0,628,12705,0,0,-1,0,5
EUN1_3573138485',8,25,18,1,0,0,0,13,1,345,80,29524,29765,34218,2,25,15,1,0,1,0,5,358,96,29866,30885,34792,1,-13,-16,-342,3,-1120,-574,0,0,-1,0,8
EUN1_3573112981',3,20,6,0,0,1,0,10,0,362,98,25615,28646,36032,8,37,23,2,0,1,0,5,391,74,30757,34954,38910,1,-29,24,-5142,-17,-6308,-2878,-2,0,0,0,5
EUN1_3573102635',1,51,17,0,0,0,0,11,0,320,77,28502,27925,36652,2,28,17,1,0,2,0,3,310,74,28432,27766,40304,1,10,3,70,0,159,-3652,-1,0,-2,0,8
EUN1_3573084218',3,27,12,1,0,0,0,16,0,287,80,25451,27784,27123,4,23,19,1,1,3,0,2,280,112,30356,29787,33038,0,7,-32,-4905,-7,-2003,-5915,0,-1,-3,0,14
EUN1_3573076332',2,19,8,0,0,0,0,8,0,307,70,23853,26770,27878,4,24,20,2,0,1,0,0,372,83,29222,31673,43350,0,-65,-13,-5369,-12,-4903,-15472,-2,0,-1,0,8
EUN1_3572855404',2,258,11,1,0,0,0,12,1,313,84,26078,29183,28779,6,31,23,1,0,2,0,1,367,88,31640,32154,42246,0,-54,-4,-5562,-12,-2971,-13467,0,0,-2,0,11
EUN1_3572836334',5,31,9,1,1,0,0,5,0,369,101,25952,30100,27005,5,31,7,0,0,0,0,3,319,81,23951,28336,24538,1,50,20,2001,2,1764,2467,1,1,0,0,2
EUN1_3572802337',1,22,12,1,0,1,0,13,1,330,95,26939,27846,34436,5,32,10,1,0,1,0,3,341,89,26826,28515,30116,1,-11,6,113,2,-669,4320,0,0,0,0,10
EUN1_3573150466',4,31,4,2,0,0,0,9,0,362,91,22971,30791,23803,3,33,12,0,0,1,0,0,383,96,27635,30707,25903,1,-21,-5,-4664,-8,84,-2100,2,0,-1,0,9
EUN1_3573110737',4,23,13,0,0,0,0,6,1,305,78,25372,27697,27937,4,26,10,2,0,0,0,1,315,86,25404,26713,31682,1,-10,-8,-32,3,984,-3745,-2,0,0,0,5
EUN1_3575982809',2,25,18,1,0,1,0,7,1,366,82,31197,30969,39106,3,22,12,0,0,0,0,5,337,82,25572,27518,28152,1,29,0,5625,6,3451,10954,1,0,1,0,2
EUN1_3571934397',4,69,9,0,0,2,0,11,1,361,94,27855,30140,26429,8,66,16,1,1,0,0,6,320,81,28348,28373,31666,1,41,13,-493,-7,1767,-5237,-1,-1,2,0,5
EUN1_3571915032',5,38,16,0,0,1,0,7,1,309,98,30848,31851,38167,3,26,15,1,0,1,0,7,329,86,26466,29363,37332,0,-20,12,4382,1,2488,835,-1,0,0,0,0
EUN1_3571818523',4,21,14,0,0,0,0,13,0,335,87,28819,29318,35791,5,29,18,1,0,5,0,7,340,96,32124,30437,37339,1,-5,-9,-3305,-4,-1119,-1548,-1,0,-5,0,6
EUN1_3571797985',5,27,13,0,0,0,0,11,0,327,76,27039,28831,31480,1,18,11,1,0,2,0,3,364,92,28600,28432,34611,0,-37,-16,-1561,2,399,-3131,-1,0,-2,0,8
EUN1_3571312954',1,21,15,0,0,2,0,8,1,363,92,29922,31176,35322,3,87,14,2,0,0,0,6,319,91,27007,30579,37487,0,44,1,2915,1,597,-2165,-2,0,2,0,2
EUN1_3571169866',3,30,25,0,0,0,0,10,1,326,98,32525,32185,40060,3,21,15,2,0,0,0,2,323,86,27578,29496,35831,0,3,12,4947,10,2689,4229,-2,0,0,0,8
EUN1_3571125342',2,48,18,2,0,2,0,10,1,343,86,29050,31407,35344,5,23,8,0,0,1,0,1,296,82,24833,25968,27082,1,47,4,4217,10,5439,8262,2,0,1,0,9
EUN1_3571983438',5,28,21,0,0,2,0,6,1,290,88,32222,31571,38345,5,31,20,2,0,2,0,10,329,88,30756,30272,36662,0,-39,0,1466,1,1299,1683,-2,0,0,0,-4
EUN1_3571967615',6,33,19,1,0,0,0,10,1,356,100,30689,30228,40068,3,25,18,1,0,2,0,4,272,102,30010,29445,38694,1,84,-2,679,1,783,1374,0,0,-2,0,6
EUN1_3571955527',5,32,20,0,0,0,0,12,1,254,68,28339,27176,40101,7,38,18,2,0,1,0,3,319,92,31505,29098,46197,1,-65,-24,-3166,2,-1922,-6096,-2,0,-1,0,9
EUN1_3569505699',2,97,14,0,1,0,0,9,1,311,88,27975,29248,39573,3,93,22,1,0,0,0,5,325,72,30096,31125,37696,0,-14,16,-2121,-8,-1877,1877,-1,1,0,0,4
EUN1_3569484948',5,62,14,0,0,0,0,12,1,355,64,27622,30162,35524,5,365,17,2,0,2,0,0,393,91,30552,33173,41901,1,-38,-27,-2930,-3,-3011,-6377,-2,0,-2,0,12
EUN1_3569475544',6,30,7,0,0,0,0,11,0,315,78,23762,25521,21789,2,24,13,2,0,1,0,4,371,89,28535,30182,26548,0,-56,-11,-4773,-6,-4661,-4759,-2,0,-1,0,7
EUN1_3573584083',2,31,8,2,0,0,0,9,1,393,120,27737,31904,28246,2,35,12,0,0,2,0,7,348,99,27849,30539,24383,1,45,21,-112,-4,1365,3863,2,0,-2,0,2
EUN1_3573561845',2,26,7,1,0,0,0,6,0,354,86,24941,26743,22603,2,31,5,0,0,1,0,4,324,85,22338,26394,20375,1,30,1,2603,2,349,2228,1,0,-1,0,2
EUN1_3573558203',3,189,9,0,1,1,0,10,0,349,86,26434,27900,31110,3,30,10,2,0,2,0,4,367,74,27083,29450,27743,0,-18,12,-649,-1,-1550,3367,-2,1,-1,0,6
EUN1_3558651684',3,25,17,2,0,2,0,7,1,365,90,30766,30112,37548,6,26,16,0,0,0,0,4,305,94,28099,30856,38952,1,60,-4,2667,1,-744,-1404,2,0,2,0,3
EUN1_3557542804',6,22,17,1,0,0,0,8,1,327,80,28724,31323,35453,2,18,10,0,1,0,0,4,317,108,26479,28777,27154,1,10,-28,2245,7,2546,8299,1,-1,0,0,4
EUN1_3557530190',3,135,9,1,0,0,0,11,1,339,104,26705,28790,29396,4,44,13,1,0,1,0,3,305,88,27249,27595,29072,0,34,16,-544,-4,1195,324,0,0,-1,0,8
EUN1_3557503971',6,56,25,1,0,0,0,8,1,289,74,31252,28011,42751,4,30,20,1,0,0,0,1,300,68,30745,28401,43600,1,-11,6,507,5,-390,-849,0,0,0,0,7
EUN1_3554759877',4,22,18,1,0,1,0,6,0,342,114,29324,33116,44349,6,346,8,1,0,0,0,3,328,90,25531,29961,32242,0,14,24,3793,10,3155,12107,0,0,1,0,3
EUN1_3554262859',1,26,6,0,0,0,0,15,0,312,78,24059,26924,24188,1,30,20,2,0,2,0,2,384,90,31013,31568,43347,0,-72,-12,-6954,-14,-4644,-19159,-2,0,-2,0,13
EUN1_3554237108',3,24,9,0,1,0,0,12,0,305,104,25850,27181,27787,4,26,18,2,0,1,0,6,339,76,29621,30124,34856,1,-34,28,-3771,-9,-2943,-7069,-2,1,-1,0,6
EUN1_3554189953',2,23,9,0,0,0,0,8,1,338,87,24771,27947,27925,3,262,10,2,0,1,0,1,370,79,27030,30610,26603,0,-32,8,-2259,-1,-2663,1322,-2,0,-1,0,7
EUN1_3553616402',2,19,10,0,0,1,0,9,1,346,109,28650,30293,30800,2,24,7,2,0,1,0,5,369,82,24644,30742,29423,0,-23,27,4006,3,-449,1377,-2,0,0,0,4
EUN1_3551234921',5,28,9,0,0,0,0,11,1,310,74,24330,26752,28231,3,188,14,0,0,2,0,0,366,86,29060,29564,37323,0,-56,-12,-4730,-5,-2812,-9092,0,0,-2,0,11
EUN1_3551211249',2,204,11,1,0,2,0,7,1,381,88,29963,29923,35758,5,30,11,0,0,1,0,8,333,80,26682,29767,29394,1,48,8,3281,0,156,6364,1,0,1,0,-1
EUN1_3551178323',3,145,7,1,0,0,0,4,1,328,76,23846,26569,25703,5,136,18,1,0,2,0,1,342,100,29343,31435,33090,0,-14,-24,-5497,-11,-4866,-7387,0,0,-2,0,3
EUN1_3551140627',1,24,14,1,0,0,0,11,0,351,88,27923,31394,36392,4,21,17,0,0,0,0,3,355,112,30748,32692,42739,0,-4,-24,-2825,-3,-1298,-6347,1,0,0,0,8
EUN1_3551087468',2,24,6,0,0,0,0,4,0,337,84,23621,27963,22719,0,21,17,1,0,2,0,3,402,116,30356,34736,32112,0,-65,-32,-6735,-11,-6773,-9393,-1,0,-2,0,1
EUN1_3576074174',3,63,10,0,0,1,0,7,1,371,89,26868,29724,28045,3,29,12,2,1,0,0,5,366,97,28029,31351,30340,0,5,-8,-1161,-2,-1627,-2295,-2,-1,1,0,2
EUN1_3576039793',2,24,11,1,0,0,0,5,1,371,88,27311,30265,31157,5,24,12,1,0,0,0,2,309,92,25494,29404,25324,1,62,-4,1817,-1,861,5833,0,0,0,0,3
EUN1_3575965260',1,18,8,1,0,0,0,8,1,341,94,24726,28437,27339,2,20,16,1,1,0,0,2,340,94,29352,31467,31884,0,1,0,-4626,-8,-3030,-4545,0,-1,0,0,6
EUN1_3575856531',6,28,25,2,0,3,0,6,1,327,104,34228,31493,35525,1,33,5,0,0,1,0,11,284,75,22111,24318,26289,1,43,29,12117,20,7175,9236,2,0,2,0,-5
EUN1_3575837026',5,28,15,1,0,3,0,7,1,370,128,32064,33396,38568,4,27,9,1,0,1,0,10,348,76,25282,28254,29656,1,22,52,6782,6,5142,8912,0,0,2,0,-3
EUN1_3575803174',3,27,13,0,0,0,0,9,1,327,56,26403,28396,32518,3,37,21,2,0,0,0,1,335,110,30731,31391,39602,0,-8,-54,-4328,-8,-2995,-7084,-2,0,0,0,8
EUN1_3575773059',2,27,8,1,0,0,0,8,0,352,97,24932,29181,28408,2,20,11,0,0,1,0,1,345,78,26952,30332,29467,0,7,19,-2020,-3,-1151,-1059,1,0,-1,0,7
EUN1_3575574978',3,56,13,1,0,0,0,8,0,319,100,26970,30610,33245,3,55,8,1,0,0,0,3,344,84,24172,26798,27475,1,-25,16,2798,5,3812,5770,0,0,0,0,5
EUN1_3575561181',1,26,9,0,1,1,0,12,0,338,92,26323,29727,25426,4,25,14,1,0,1,0,6,333,92,29205,29798,31346,0,5,0,-2882,-5,-71,-5920,-1,1,0,0,6
EUN1_3575471990',2,23,13,1,0,0,0,12,1,299,70,27474,28759,31442,2,23,21,0,0,3,0,4,364,93,32267,32345,42020,0,-65,-23,-4793,-8,-3586,-10578,1,0,-3,0,8
EUN1_3575447889',0,26,16,1,0,1,0,15,0,336,89,29359,30795,38550,2,37,21,0,0,4,0,6,310,90,32459,31074,41856,0,26,-1,-3100,-5,-279,-3306,1,0,-3,0,9
EUN1_3575376860',3,23,10,2,0,0,0,8,1,360,78,25489,31555,28986,3,25,12,0,0,1,0,3,346,90,27510,30701,29424,1,14,-12,-2021,-2,854,-438,2,0,-1,0,5
EUN1_3575362330',2,19,14,1,0,0,0,10,1,326,72,27438,28531,33711,2,61,15,1,0,2,0,5,322,107,29560,32304,34504,0,4,-35,-2122,-1,-3773,-793,0,0,-2,0,5
EUN1_3575261591',3,27,4,1,0,0,0,9,1,294,62,21325,25562,26945,5,54,13,0,0,2,0,1,407,102,29125,32179,32472,0,-113,-40,-7800,-9,-6617,-5527,1,0,-2,0,8
EUN1_3575252259',5,31,12,0,0,1,0,16,0,275,94,26604,27605,30015,6,25,21,2,0,3,0,0,329,102,32015,32073,37314,0,-54,-8,-5411,-9,-4468,-7299,-2,0,-2,0,16
EUN1_3575218739',3,134,13,0,0,1,0,7,0,424,104,30633,32161,27447,2,36,13,1,0,1,0,6,369,87,28699,30835,34267,1,55,17,1934,0,1326,-6820,-1,0,0,0,1
EUN1_3575202821',2,22,13,1,0,0,0,9,0,370,92,28750,31150,31864,4,307,9,1,0,2,0,6,373,60,26796,29052,26677,1,-3,32,1954,4,2098,5187,0,0,-2,0,3
EUN1_3575006234',4,29,4,0,0,0,0,10,0,301,73,21039,26195,25121,5,42,21,1,0,1,0,0,350,102,31184,31772,40899,0,-49,-29,-10145,-17,-5577,-15778,-1,0,-1,0,10
EUN1_3574977439',7,47,19,1,0,1,0,6,0,349,92,30032,29835,42118,4,29,9,0,0,1,0,8,312,80,23728,27887,25798,1,37,12,6304,10,1948,16320,1,0,0,0,-2
EUN1_3575471677',2,59,14,1,0,0,0,7,1,327,84,26131,30910,34105,3,57,10,1,0,0,0,2,346,97,26592,29793,31248,1,-19,-13,-461,4,1117,2857,0,0,0,0,5
EUN1_3573872400',6,46,10,1,0,0,0,10,1,302,93,24392,28277,28832,1,68,8,1,0,1,0,3,373,94,26636,29606,29150,0,-71,-1,-2244,2,-1329,-318,0,0,-1,0,7
EUN1_3573662710',0,20,9,0,0,0,0,11,1,295,88,23875,25133,27126,2,16,15,1,1,2,0,0,369,76,30092,30185,35807,1,-74,12,-6217,-6,-5052,-8681,-1,-1,-2,0,11
EUN1_3573645108',4,28,16,2,0,2,0,7,1,331,100,30203,30011,33161,3,29,10,0,1,0,0,8,349,78,26205,27772,26663,0,-18,22,3998,6,2239,6498,2,-1,2,0,-1
EUN1_3573217849',5,135,13,1,0,0,0,6,1,358,68,28035,28505,36181,2,27,13,1,0,1,0,5,376,72,27371,29626,37831,0,-18,-4,664,0,-1121,-1650,0,0,-1,0,1
EUN1_3573174845',2,23,8,1,0,0,0,9,0,339,100,24363,30030,25959,7,26,11,1,0,2,0,2,402,88,28450,33360,28637,0,-63,12,-4087,-3,-3330,-2678,0,0,-2,0,7
EUN1_3573161713',3,15,17,1,0,2,0,6,0,330,84,30640,30164,33491,4,23,14,1,1,1,0,7,331,77,27199,28930,31324,1,-1,7,3441,3,1234,2167,0,-1,1,0,-1
EUN1_3573039029',0,21,7,0,0,0,0,9,1,343,98,24398,28574,24346,2,45,18,2,0,2,0,1,368,118,29963,33595,32203,0,-25,-20,-5565,-11,-5021,-7857,-2,0,-2,0,8
EUN1_3573028799',4,38,8,0,0,0,0,9,1,384,79,26666,30675,21154,4,26,10,1,0,1,0,4,359,91,26194,29070,30532,1,25,-12,472,-2,1605,-9378,-1,0,-1,0,5
EUN1_3573011815',1,18,9,1,0,0,0,5,1,362,103,25698,30263,23534,2,22,6,1,0,0,0,1,331,92,23283,27132,26580,1,31,11,2415,3,3131,-3046,0,0,0,0,4
EUN1_3571066550',2,32,11,1,0,0,0,7,0,349,86,26803,29992,33185,8,32,13,1,0,1,0,2,347,86,27629,28869,31186,0,2,0,-826,-2,1123,1999,0,0,-1,0,5
EUW1_6882635576',5,25,14,0,0,0,0,7,1,351,131,28962,32037,36563,4,26,13,1,0,2,0,7,307,64,27088,29324,30570,0,44,67,1874,1,2713,5993,-1,0,-2,0,0
EUW1_6882466143',3,22,16,1,0,0,0,10,0,334,101,27451,32274,34257,3,28,10,1,0,1,0,2,365,82,26923,29390,28852,0,-31,19,528,6,2884,5405,0,0,-1,0,8
EUW1_6875038138',4,32,9,1,0,0,0,7,1,351,91,25120,28924,34318,2,21,3,1,0,0,0,1,364,80,22214,28464,29589,1,-13,11,2906,6,460,4729,0,0,0,0,6
EUW1_6873682339',4,23,20,1,0,2,0,9,1,333,74,31031,28827,42293,6,38,14,0,0,1,0,6,316,62,27973,28176,36614,1,17,12,3058,6,651,5679,1,0,1,0,3
EUW1_6873671210',1,29,8,0,0,0,0,7,0,309,86,24251,26209,28159,7,29,21,1,0,1,0,1,349,100,30462,29668,39026,0,-40,-14,-6211,-13,-3459,-10867,-1,0,-1,0,6
EUW1_6883504411',6,30,15,1,0,0,0,10,1,391,90,29256,29469,33448,6,30,11,1,0,1,0,0,320,90,26599,28765,30083,0,71,0,2657,4,704,3365,0,0,-1,0,10
EUW1_6883464995',3,21,4,0,0,0,0,8,0,385,75,23400,28148,20646,3,28,5,1,0,1,0,3,377,112,24490,30162,18808,0,8,-37,-1090,-1,-2014,1838,-1,0,-1,0,5
EUW1_6883413278',5,37,12,1,0,2,0,7,1,398,102,31229,30696,27724,4,20,7,1,1,1,0,5,342,98,25534,29091,20802,1,56,4,5695,5,1605,6922,0,-1,1,0,2
EUW1_6883054242',2,22,8,0,0,0,0,3,1,386,72,25470,29933,26569,5,26,7,0,0,0,0,3,393,86,24867,30803,21700,0,-7,-14,603,1,-870,4869,0,0,0,0,0
EUW1_6883003443',6,34,9,1,0,0,0,15,1,368,86,26213,27838,30769,4,45,12,1,0,2,0,4,374,74,28993,30769,33298,0,-6,12,-2780,-3,-2931,-2529,0,0,-2,0,11
EUW1_6882953043',4,27,12,1,0,0,0,10,1,345,98,28042,29910,28736,5,27,14,0,0,1,0,2,354,80,27774,30034,32714,0,-9,18,268,-2,-124,-3978,1,0,-1,0,8
EUW1_6882888025',5,147,9,1,0,0,0,9,0,368,88,25347,30493,22361,8,26,12,1,1,1,0,0,389,96,28582,31189,28649,0,-21,-8,-3235,-3,-696,-6288,0,-1,-1,0,9
EUW1_6882844660',6,32,10,2,0,1,0,3,0,375,94,28057,29996,31650,3,21,6,0,0,0,0,7,327,85,23683,27951,21280,1,48,9,4374,4,2045,10370,2,0,1,0,-4
EUW1_6882767317',2,29,15,1,0,1,0,10,1,316,98,28936,30862,32344,5,27,15,1,0,1,0,5,365,80,28521,30704,32430,1,-49,18,415,0,158,-86,0,0,0,0,5
EUW1_6882738409',6,22,11,0,0,0,0,7,0,284,80,25468,28297,27201,3,28,14,1,0,0,0,0,340,82,28093,30293,41763,0,-56,-2,-2625,-3,-1996,-14562,-1,0,0,0,7
EUW1_6882708777',6,149,6,0,0,1,0,9,0,365,92,25805,27418,27557,4,155,15,1,1,1,0,3,389,104,29779,31023,32489,0,-24,-12,-3974,-9,-3605,-4932,-1,-1,0,0,6
EUW1_6882673465',5,26,8,1,0,0,0,12,0,375,87,25220,30009,25280,3,24,14,0,1,1,0,3,408,112,29986,32679,31435,0,-33,-25,-4766,-6,-2670,-6155,1,-1,-1,0,9
EUW1_6882590253',5,27,12,1,0,0,0,13,0,363,80,26473,30247,22513,1,38,11,0,0,2,0,0,393,100,28751,31721,27658,1,-30,-20,-2278,1,-1474,-5145,1,0,-2,0,13
EUW1_6882553365',4,30,4,0,0,1,0,6,0,380,102,25564,29593,21185,5,28,10,1,0,0,0,6,408,82,26739,31259,26620,0,-28,20,-1175,-6,-1666,-5435,-1,0,1,0,0
EUW1_6881848382',8,33,19,2,0,2,0,8,0,373,104,31839,31146,37616,6,31,11,0,0,0,0,5,287,90,26227,26689,27893,1,86,14,5612,8,4457,9723,2,0,2,0,3
EUW1_6883567105',6,29,12,1,0,1,0,13,1,350,83,28045,29151,33742,4,26,11,1,0,2,0,5,335,113,27495,30098,31170,1,15,-30,550,1,-947,2572,0,0,-1,0,8
EUW1_6883524204',3,26,15,2,0,1,0,8,0,353,92,29478,32511,35865,6,27,8,0,0,0,0,5,390,75,25221,28794,28774,1,-37,17,4257,7,3717,7091,2,0,1,0,3
EUW1_6883493246',2,22,17,1,0,4,0,7,1,379,101,32368,31049,39792,5,63,7,1,0,0,0,11,303,91,24064,27602,25174,1,76,10,8304,10,3447,14618,0,0,4,0,-4
EUW1_6883390586',4,27,32,1,0,3,0,10,1,369,109,36690,34966,55583,1,39,6,1,0,0,0,11,339,72,24038,27516,28844,1,30,37,12652,26,7450,26739,0,0,3,0,-1
EUW1_6882870173',2,25,15,1,0,1,0,13,1,341,92,29191,29523,42158,1,31,20,1,0,0,0,5,342,82,29792,30210,39822,1,-1,10,-601,-5,-687,2336,0,0,1,0,8
EUW1_6882819452',2,87,14,2,0,0,0,13,0,290,72,26842,27138,36614,4,41,13,0,1,1,0,4,313,94,28380,28645,34752,1,-23,-22,-1538,1,-1507,1862,2,-1,-1,0,9
EUW1_6882774195',4,78,5,1,0,0,0,10,0,354,88,25319,28724,24322,2,40,10,1,0,3,0,1,394,88,27207,30696,33867,0,-40,0,-1888,-5,-1972,-9545,0,0,-3,0,9
EUW1_6882710164',6,24,13,0,0,0,0,12,1,261,104,27376,27582,29154,1,19,15,2,0,2,0,2,355,89,28478,30119,39516,0,-94,15,-1102,-2,-2537,-10362,-2,0,-2,0,10
EUW1_6882666321',5,31,18,1,0,2,0,9,1,360,74,31980,30671,45005,6,28,18,0,0,1,0,7,304,77,30062,28314,35750,1,56,-3,1918,0,2357,9255,1,0,1,0,2
EUW1_6881899211',4,28,13,0,0,0,0,13,0,357,67,28014,28665,37102,6,30,21,1,0,2,0,1,363,84,32056,30468,45076,1,-6,-17,-4042,-8,-1803,-7974,-1,0,-2,0,12
EUW1_6880711385',0,19,16,0,0,0,0,10,0,359,87,28705,30408,29270,3,28,12,2,0,1,0,2,380,73,27844,27937,28724,0,-21,14,861,4,2471,546,-2,0,-1,0,8
EUW1_6880683954',4,36,16,1,1,0,0,8,1,359,110,28346,32618,35196,7,93,7,1,0,1,0,2,370,86,25768,29967,28743,1,-11,24,2578,9,2651,6453,0,1,-1,0,6
EUW1_6874086655',3,26,9,2,0,0,0,8,1,368,86,25748,28815,29033,5,29,12,0,0,0,0,4,329,112,26508,30561,31943,1,39,-26,-760,-3,-1746,-2910,2,0,0,0,4
EUW1_6874054688',1,159,13,1,0,1,0,9,1,323,52,27616,28506,34925,1,30,13,1,0,0,0,8,278,112,25706,27039,27581,1,45,-60,1910,0,1467,7344,0,0,1,0,1
EUW1_6874001038',6,28,14,0,0,2,0,14,1,350,80,28567,27522,32282,4,23,18,1,0,1,0,5,335,90,30168,29856,34732,0,15,-10,-1601,-4,-2334,-2450,-1,0,1,0,9
EUW1_6873964198',7,42,9,0,0,0,0,13,0,344,88,25659,29987,27570,2,28,17,1,0,3,0,1,379,100,31790,31856,38388,0,-35,-12,-6131,-8,-1869,-10818,-1,0,-3,0,12
EUW1_6873923548',2,28,16,1,0,1,0,7,0,369,78,30226,29867,39133,2,22,13,1,0,0,0,3,310,86,26079,27385,26633,1,59,-8,4147,3,2482,12500,0,0,1,0,4
EUW1_6882713252',7,52,17,1,1,2,0,9,1,323,100,31155,29533,35231,4,75,13,1,0,0,0,8,325,64,26762,27893,34530,1,-2,36,4393,4,1640,701,0,1,2,0,1
EUW1_6882682465',5,24,11,2,0,0,0,13,1,346,114,26410,30336,32741,2,32,14,0,0,3,0,3,391,81,31133,31287,38319,0,-45,33,-4723,-3,-951,-5578,2,0,-3,0,10
EUW1_6882603516',4,23,14,0,0,1,0,13,1,345,70,30269,27378,40133,1,18,15,1,1,2,0,8,334,125,29534,29559,32847,0,11,-55,735,-1,-2181,7286,-1,-1,-1,0,5
EUW1_6883538907',3,23,17,1,0,0,0,11,1,284,82,28210,27578,33162,5,23,18,1,0,1,0,1,358,98,30452,31156,46043,0,-74,-16,-2242,-1,-3578,-12881,0,0,-1,0,10
EUW1_6883496680',4,28,12,0,1,0,0,10,1,372,99,27600,30973,28750,3,24,8,2,0,1,0,3,387,80,26138,29904,26257,0,-15,19,1462,4,1069,2493,-2,1,-1,0,7
EUW1_6883441159',1,24,22,2,0,2,0,2,1,363,106,32358,33529,40717,3,130,7,0,0,0,0,6,341,74,24451,26476,29439,1,22,32,7907,15,7053,11278,2,0,2,0,-4
EUW1_6883390684',3,90,17,1,0,0,0,9,1,321,88,28869,27281,34335,3,38,18,1,1,2,0,2,361,82,31933,29208,35887,0,-40,6,-3064,-1,-1927,-1552,0,-1,-2,0,7
EUW1_6882794989',9,31,17,1,0,0,0,8,0,348,110,29058,30977,35915,3,27,10,1,0,0,0,2,372,86,26979,30173,28420,1,-24,24,2079,7,804,7495,0,0,0,0,6
EUW1_6882600820',5,34,9,0,0,0,0,9,0,346,64,24976,28242,28287,3,24,21,2,0,1,0,0,361,104,31618,32345,49007,0,-15,-40,-6642,-12,-4103,-20720,-2,0,-1,0,9
EUW1_6882573257',5,32,26,2,1,1,0,6,1,393,108,34503,34052,50739,4,24,5,0,0,2,0,11,300,63,21558,23444,27121,1,93,45,12945,21,10608,23618,2,1,-1,0,-5
EUW1_6882545425',3,25,21,0,0,1,0,10,1,332,97,30300,28691,42179,4,29,17,2,0,1,0,7,315,90,31499,29078,42541,0,17,7,-1199,4,-387,-362,-2,0,0,0,3
EUW1_6882523469',4,32,18,0,0,1,0,10,0,326,68,28770,29211,41103,3,25,13,1,0,1,0,7,366,76,30247,28976,31821,1,-40,-8,-1477,5,235,9282,-1,0,0,0,3
EUW1_6882501673',1,23,10,1,1,0,0,7,0,420,104,27775,32803,26001,2,28,4,1,0,1,0,5,351,108,24288,28424,25469,1,69,-4,3487,6,4379,532,0,1,-1,0,2
EUW1_6882462354',1,30,14,0,0,0,0,7,1,323,82,27160,30501,32786,4,25,17,1,0,0,0,0,360,80,27628,30518,42117,0,-37,2,-468,-3,-17,-9331,-1,0,0,0,7
EUW1_6882249709',3,21,21,1,0,1,0,7,1,334,102,30610,32245,40966,6,30,10,0,0,0,0,3,340,67,26339,28145,32268,1,-6,35,4271,11,4100,8698,1,0,1,0,4
EUW1_6882230591',1,22,17,2,0,1,0,10,0,324,126,31024,31836,30272,3,253,10,0,1,2,0,9,324,86,26109,28381,26912,1,0,40,4915,7,3455,3360,2,-1,-1,0,1
EUW1_6882181324',1,25,15,1,0,2,0,9,1,325,77,28589,30320,34324,4,28,14,1,0,0,0,3,305,69,26271,27613,36097,1,20,8,2318,1,2707,-1773,0,0,2,0,6
EUW1_6882150705',2,24,20,0,0,2,0,10,1,345,82,30684,31191,43424,2,69,14,2,0,0,0,4,344,98,28376,31260,41717,0,1,-16,2308,6,-69,1707,-2,0,2,0,6
EUW1_6883371310',3,34,10,0,0,0,0,6,0,331,64,24685,26451,30659,0,42,17,1,0,0,0,2,320,91,27852,28615,42809,0,11,-27,-3167,-7,-2164,-12150,-1,0,0,0,4
EUW1_6883133772',3,26,18,2,0,1,0,7,0,355,70,29714,29619,32394,2,48,11,0,0,0,0,4,312,95,26000,28336,33074,1,43,-25,3714,7,1283,-680,2,0,1,0,3
EUW1_6882999687',3,28,9,0,0,0,0,10,0,345,84,25260,29956,21546,4,33,13,1,0,2,0,2,392,83,29880,30073,31499,0,-47,1,-4620,-4,-117,-9953,-1,0,-2,0,8
EUW1_6882950500',1,20,19,0,0,0,0,7,0,333,84,30466,30386,36822,3,27,7,2,0,1,0,5,335,91,23195,25929,27343,1,-2,-7,7271,12,4457,9479,-2,0,-1,0,2
EUW1_6882755790',2,30,10,1,0,1,0,8,0,345,94,27034,29242,28328,4,28,7,1,0,0,0,4,392,80,25188,28628,29893,1,-47,14,1846,3,614,-1565,0,0,1,0,4
EUW1_6882718458',4,40,7,1,0,0,0,10,0,334,84,24616,28400,27087,6,31,13,0,1,1,0,4,369,90,28077,30422,25342,0,-35,-6,-3461,-6,-2022,1745,1,-1,-1,0,6
EUW1_6882693538',4,26,17,2,0,1,0,9,1,394,83,29639,32040,38100,4,24,4,0,0,1,0,3,282,108,21853,26359,18468,1,112,-25,7786,13,5681,19632,2,0,0,0,6
EUW1_6882597023',4,24,3,0,0,0,0,2,0,384,83,22383,28867,17929,6,29,9,2,0,0,0,0,375,66,24492,28138,22179,1,9,17,-2109,-6,729,-4250,-2,0,0,0,2
EUW1_6882055214',4,29,4,2,0,0,0,8,1,326,95,23497,27772,22301,3,22,8,0,0,1,0,4,372,88,26715,28740,24480,0,-46,7,-3218,-4,-968,-2179,2,0,-1,0,4
EUW1_6881382916',3,23,22,1,1,2,0,7,1,354,76,32252,31028,46397,1,21,11,1,0,0,0,10,296,91,24790,28083,29132,0,58,-15,7462,11,2945,17265,0,1,2,0,-3
EUW1_6881327342',2,28,18,1,0,1,0,8,1,388,92,31338,33308,35467,8,34,16,1,0,0,0,4,367,78,27431,30223,34835,1,21,14,3907,2,3085,632,0,0,1,0,4
EUW1_6881194887',2,25,16,0,0,0,0,7,1,353,60,28862,30381,35487,3,28,6,1,0,1,0,5,341,83,23656,27563,26296,1,12,-23,5206,10,2818,9191,-1,0,-1,0,2
EUW1_6881108682',3,26,13,0,0,1,0,11,1,329,89,27573,26743,25212,4,30,11,0,0,1,0,2,361,73,27147,29234,29818,0,-32,16,426,2,-2491,-4606,0,0,0,0,9
EUW1_6880733410',3,24,11,0,0,0,0,12,0,357,67,27006,27528,28899,5,116,19,0,0,2,0,2,385,69,32982,31413,33822,1,-28,-2,-5976,-8,-3885,-4923,0,0,-2,0,10
EUW1_6880719940',4,29,19,1,0,1,0,8,1,323,92,30713,29525,38417,1,30,19,1,0,0,0,7,305,78,28562,28627,33125,1,18,14,2151,0,898,5292,0,0,1,0,1
EUW1_6880695537',5,25,12,1,0,1,0,13,1,315,71,26704,26510,26682,6,33,17,1,1,1,0,5,311,76,28405,26652,29860,1,4,-5,-1701,-5,-142,-3178,0,-1,0,0,8
EUW1_6880651359',3,29,11,1,0,1,0,4,1,388,94,27236,31582,26679,4,21,6,0,1,0,0,3,340,89,24006,27976,25027,1,48,5,3230,5,3606,1652,1,-1,1,0,1
EUW1_6880608448',0,22,18,2,0,0,0,9,0,366,74,29111,29898,41161,0,18,20,0,0,1,0,4,343,102,33205,33226,34390,0,23,-28,-4094,-2,-3328,6771,2,0,-1,0,5
EUW1_6883188427',9,25,14,1,0,1,0,6,1,387,82,29340,31951,31679,6,28,9,0,1,0,0,6,358,76,25352,30383,30886,1,29,6,3988,5,1568,793,1,-1,1,0,0
EUW1_6883109248',4,28,10,1,0,0,0,10,1,348,86,26856,29274,29899,8,30,18,0,0,1,0,2,400,95,29881,32798,38611,0,-52,-9,-3025,-8,-3524,-8712,1,0,-1,0,8
EUW1_6883064049',5,28,12,1,0,1,0,6,1,424,101,28429,33134,28986,4,57,5,1,0,0,0,3,365,98,24224,30231,18567,1,59,3,4205,7,2903,10419,0,0,1,0,3
EUW1_6882843898',4,24,7,1,0,0,0,6,0,329,92,23765,28840,29312,3,22,9,0,0,1,0,0,374,93,26060,29936,28826,0,-45,-1,-2295,-2,-1096,486,1,0,-1,0,6
EUW1_6882798991',4,31,5,1,1,0,0,8,0,351,106,24175,29763,23653,4,26,12,1,0,0,0,3,356,106,26707,31578,30053,0,-5,0,-2532,-7,-1815,-6400,0,1,0,0,5
EUW1_6882275176',3,122,11,0,0,0,0,11,0,360,82,26952,31260,25107,2,28,14,2,0,1,0,1,409,130,29733,33034,30546,0,-49,-48,-2781,-3,-1774,-5439,-2,0,-1,0,10
EUW1_6882257119',4,34,17,2,1,0,0,8,1,343,96,28010,30198,35078,5,33,15,0,0,0,0,1,327,103,28692,29447,38115,0,16,-7,-682,2,751,-3037,2,1,0,0,7
EUW1_6882237729',5,25,14,1,0,0,0,6,1,338,100,27777,31434,35367,7,28,11,1,0,0,0,1,336,88,25545,29896,31714,1,2,12,2232,3,1538,3653,0,0,0,0,5
EUW1_6882207171',4,27,13,2,0,0,0,8,1,373,90,27747,29380,32488,2,26,7,0,0,1,0,3,338,71,23068,25320,21599,1,35,19,4679,6,4060,10889,2,0,-1,0,5
EUW1_6882181676',3,31,10,2,1,0,0,12,0,334,95,25658,26859,25627,2,29,9,0,0,3,0,5,339,92,26764,27673,21853,1,-5,3,-1106,1,-814,3774,2,1,-3,0,7
EUW1_6882144835',2,20,16,1,0,2,0,8,1,354,98,31048,32948,34562,4,23,11,1,0,0,0,1,346,95,27300,27713,31396,1,8,3,3748,5,5235,3166,0,0,2,0,7
EUW1_6882163802',6,272,16,1,0,0,0,11,1,335,80,27878,29533,31645,1,25,13,0,0,0,0,1,319,96,27063,31054,30360,0,16,-16,815,3,-1521,1285,1,0,0,0,10
EUW1_6882108921',2,24,12,0,0,1,0,9,0,351,92,27100,29052,26467,5,28,16,1,0,2,0,7,332,86,28320,29889,33276,0,19,6,-1220,-4,-837,-6809,-1,0,-1,0,2
EUW1_6882052132',1,36,6,0,0,1,0,12,0,335,62,24079,24625,22012,1,42,14,1,0,1,0,3,370,88,29466,29415,27159,1,-35,-26,-5387,-8,-4790,-5147,-1,0,0,0,9
EUW1_6881971121',2,60,4,0,0,0,0,7,1,406,76,23670,29199,19797,9,70,9,2,0,0,0,1,394,83,25915,29469,27493,1,12,-7,-2245,-5,-270,-7696,-2,0,0,0,6
EUW1_6881889798',2,24,14,1,0,1,0,9,0,336,102,28229,31347,28633,6,30,10,1,0,1,0,4,419,86,27252,30862,25003,1,-83,16,977,4,485,3630,0,0,0,0,5
EUW1_6881820726',6,53,16,1,0,1,0,9,1,388,83,30173,31442,35799,4,30,13,1,0,1,0,7,309,88,27468,27235,33503,1,79,-5,2705,3,4207,2296,0,0,0,0,2
EUW1_6880495482',3,22,10,0,0,0,0,9,0,362,88,26356,29966,25563,4,29,9,2,0,1,0,3,362,111,27103,29860,29015,0,0,-23,-747,1,106,-3452,-2,0,-1,0,6
EUW1_6880430926',3,26,10,0,1,0,0,8,0,340,108,26660,30158,38651,5,38,13,1,0,1,0,3,355,56,27448,28002,31295,1,-15,52,-788,-3,2156,7356,-1,1,-1,0,5
EUW1_6880364622',6,28,13,1,0,1,0,9,0,370,70,27338,28898,24725,7,200,15,0,0,0,0,2,368,78,28785,30746,28160,1,2,-8,-1447,-2,-1848,-3435,1,0,1,0,7
EUW1_6879837374',9,30,9,2,0,0,0,11,0,364,80,25322,29477,24125,11,36,15,0,0,1,0,3,383,80,29939,31882,33788,0,-19,0,-4617,-6,-2405,-9663,2,0,-1,0,8
EUW1_6879801020',4,69,18,1,1,2,0,14,0,360,96,31627,31518,36550,4,29,11,1,0,1,0,4,369,72,26187,29752,30071,1,-9,24,5440,7,1766,6479,0,1,1,0,10
EUW1_6879130975',4,19,14,1,0,1,0,9,0,319,78,27982,28532,40609,4,32,12,0,0,0,0,4,318,78,26694,28170,35178,0,1,0,1288,2,362,5431,1,0,1,0,5
EUW1_6879049635',2,20,19,1,1,2,0,10,0,336,102,30039,33976,29602,0,142,4,0,0,0,0,4,332,80,23266,27245,27388,1,4,22,6773,15,6731,2214,1,1,2,0,6
EUW1_6878974442',3,21,18,1,1,0,0,12,0,281,84,27737,26761,34714,5,27,19,1,0,1,0,1,311,84,30648,28007,37453,1,-30,0,-2911,-1,-1246,-2739,0,1,-1,0,11
EUW1_6878877878',4,34,13,0,0,0,0,10,1,395,76,27830,30723,32949,1,27,11,2,0,1,0,4,359,99,27914,31077,32520,0,36,-23,-84,2,-354,429,-2,0,-1,0,6
EUW1_6878833465',2,21,15,1,0,1,0,2,1,388,92,30550,31663,38303,3,25,5,1,0,0,0,7,312,91,23212,28180,27716,1,76,1,7338,10,3483,10587,0,0,1,0,-5
EUW1_6883009403',4,36,11,1,1,1,0,8,0,417,99,29816,31093,34180,2,32,9,1,0,1,0,6,313,96,24960,27539,19230,1,104,3,4856,2,3554,14950,0,1,0,0,2
EUW1_6882918959',3,43,8,0,0,0,0,8,0,400,79,26997,28432,29466,1,25,17,1,1,1,0,3,346,80,28939,31498,37020,1,54,-1,-1942,-9,-3066,-7554,-1,-1,-1,0,5
EUW1_6881615495',3,27,17,0,0,0,0,11,1,377,96,29801,30698,33519,5,39,18,2,0,1,0,4,347,87,29759,30553,36013,0,30,9,42,-1,145,-2494,-2,0,-1,0,7
EUW1_6881549797',2,32,14,0,0,1,0,8,1,338,74,27858,29036,32573,6,33,14,1,0,1,0,3,368,97,28604,29920,35624,0,-30,-23,-746,0,-884,-3051,-1,0,0,0,5
EUW1_6881471948',0,23,15,1,0,0,0,6,0,336,70,26698,28793,33397,3,20,6,1,0,0,0,1,309,78,22070,23982,24654,1,27,-8,4628,9,4811,8743,0,0,0,0,5
EUW1_6881392551',1,30,8,1,0,0,0,8,0,353,85,24832,28144,29660,4,25,11,1,0,0,0,4,330,90,26155,29179,26579,0,23,-5,-1323,-3,-1035,3081,0,0,0,0,4
EUW1_6881316579',4,25,6,0,0,0,0,9,0,326,83,24231,27874,23817,4,35,7,1,0,2,0,3,377,78,25965,28274,27314,0,-51,5,-1734,-1,-400,-3497,-1,0,-2,0,6
EUW1_6881261494',0,27,14,2,1,1,0,7,1,420,102,30548,32572,35859,4,309,6,0,0,0,0,2,353,81,24024,28876,23426,1,67,21,6524,8,3696,12433,2,1,1,0,5
EUW1_6880998102',5,30,12,0,0,2,0,9,1,399,76,29319,29762,30790,1,25,9,2,0,0,0,5,343,89,25547,27343,29492,0,56,-13,3772,3,2419,1298,-2,0,2,0,4
EUW1_6880979617',3,24,11,2,0,0,0,9,0,417,79,27564,29584,32003,4,41,11,0,0,1,0,8,396,103,29209,31970,30203,1,21,-24,-1645,0,-2386,1800,2,0,-1,0,1
EUW1_6880914905',4,32,9,0,0,0,0,8,1,364,91,25705,28889,30154,3,28,14,2,0,0,0,3,370,104,29469,31501,34882,1,-6,-13,-3764,-5,-2612,-4728,-2,0,0,0,5
EUW1_6883029492',5,40,4,0,0,0,0,10,0,349,88,22054,27361,17657,7,24,12,2,0,1,0,0,395,112,28616,32438,27925,0,-46,-24,-6562,-8,-5077,-10268,-2,0,-1,0,10
EUW1_6882898935',7,88,20,1,0,1,0,9,1,302,98,30489,29377,40106,3,28,12,0,0,1,0,4,312,97,27085,28485,30429,0,-10,1,3404,8,892,9677,1,0,0,0,5
EUW1_6882848744',5,22,15,2,0,0,0,7,1,299,86,27141,27359,28216,8,35,14,0,1,1,0,2,340,90,28255,29239,32503,1,-41,-4,-1114,1,-1880,-4287,2,-1,-1,0,5
EUW1_6882788734',4,26,12,0,0,0,0,5,1,357,104,27161,29434,28830,3,28,9,2,0,0,0,3,382,76,26008,29571,24363,0,-25,28,1153,3,-137,4467,-2,0,0,0,2
EUW1_6882705870',1,24,8,0,0,1,0,8,0,342,99,25408,29706,35753,8,37,6,1,0,1,0,4,346,68,23939,28792,36830,0,-4,31,1469,2,914,-1077,-1,0,0,0,4
EUW1_6882666004',2,21,12,2,0,2,0,6,1,385,120,29701,32820,29347,2,37,10,0,0,0,0,6,306,68,23888,27554,21544,1,79,52,5813,2,5266,7803,2,0,2,0,0
EUW1_6882634563',4,27,14,1,0,1,0,7,0,377,90,29541,32530,34415,6,28,14,1,0,0,0,2,354,98,28711,32769,32771,1,23,-8,830,0,-239,1644,0,0,1,0,5
EUW1_6882563945',3,26,16,1,0,2,0,4,1,361,94,29896,31390,29192,6,127,8,1,0,0,0,5,321,90,24499,27595,31460,1,40,4,5397,8,3795,-2268,0,0,2,0,-1
EUW1_6882523638',3,65,4,2,0,0,0,6,0,344,100,22142,29613,20610,2,22,6,0,1,0,0,1,393,88,24285,31330,22515,0,-49,12,-2143,-2,-1717,-1905,2,-1,0,0,5
EUW1_6882492773',3,26,10,1,0,1,0,11,0,347,98,26238,29434,30341,2,33,13,1,0,2,0,4,398,105,29813,30958,36629,0,-51,-7,-3575,-3,-1524,-6288,0,0,-1,0,7
EUW1_6882028735',2,22,16,0,0,2,0,8,1,382,90,29247,33027,31019,1,25,5,2,0,1,0,6,351,97,24912,28648,28183,1,31,-7,4335,11,4379,2836,-2,0,1,0,2
EUW1_6881963761',3,26,16,0,0,2,0,11,1,359,84,29914,30970,33201,6,33,8,1,0,1,0,6,311,88,25596,27264,25758,1,48,-4,4318,8,3706,7443,-1,0,1,0,5
EUW1_6881868282',2,30,9,1,0,0,0,9,0,331,84,24922,28664,27065,3,33,10,0,0,1,0,3,371,80,26510,29944,32198,0,-40,4,-1588,-1,-1280,-5133,1,0,-1,0,6
EUW1_6881794000',2,23,14,1,1,0,0,16,0,340,90,28283,28715,25073,5,29,20,1,0,1,0,1,373,77,31466,31874,39514,1,-33,13,-3183,-6,-3159,-14441,0,1,-1,0,15
EUW1_6881704843',2,14,11,1,0,1,0,10,0,344,102,27114,30864,23142,2,22,9,0,0,0,0,4,364,106,26980,31025,33049,1,-20,-4,134,2,-161,-9907,1,0,1,0,6
EUW1_6881652676',11,33,13,0,0,1,0,5,0,364,76,29216,30291,27713,5,35,19,1,0,1,0,7,378,84,30831,30928,32615,1,-14,-8,-1615,-6,-637,-4902,-1,0,0,0,-2
EUW1_6881590334',2,38,16,0,0,1,0,7,1,361,77,29190,31924,31243,8,30,7,2,1,0,0,4,358,86,24699,28152,27776,1,3,-9,4491,9,3772,3467,-2,-1,1,0,3
EUW1_6880982568',5,25,16,0,0,0,0,8,1,319,70,27993,27108,29331,10,146,6,2,0,1,0,5,302,86,22747,24401,26577,1,17,-16,5246,10,2707,2754,-2,0,-1,0,3
EUW1_6880946767',4,24,12,1,0,1,0,8,0,331,79,26942,29296,35916,5,30,9,0,0,0,0,4,374,78,25104,30219,31857,1,-43,1,1838,3,-923,4059,1,0,1,0,4
EUW1_6882759000',4,38,5,0,0,1,0,9,0,391,104,26315,30230,23041,5,31,9,1,0,0,0,3,375,84,25601,29532,21040,0,16,20,714,-4,698,2001,-1,0,1,0,6
EUW1_6882689855',2,23,11,1,0,0,0,12,0,325,65,26250,27620,31336,2,18,23,0,0,1,0,3,349,101,31986,32846,39685,0,-24,-36,-5736,-12,-5226,-8349,1,0,-1,0,9
EUW1_6882658814',6,33,25,1,0,3,0,9,1,323,92,35523,30316,44026,9,28,17,0,0,0,0,6,266,80,27314,25838,27330,1,57,12,8209,8,4478,16696,1,0,3,0,3
EUW1_6882626227',0,22,18,1,0,4,0,7,1,363,72,31988,31067,40825,2,28,14,1,0,0,0,11,364,96,28070,31145,34397,1,-1,-24,3918,4,-78,6428,0,0,4,0,-4
EUW1_6882566332',5,22,16,2,0,0,0,8,1,355,86,29969,30556,41900,3,34,9,0,0,1,0,7,283,78,23462,26235,26532,1,72,8,6507,7,4321,15368,2,0,-1,0,1
EUW1_6882548333',2,29,6,0,0,0,0,15,0,335,80,23677,29255,21816,1,27,21,2,0,4,0,1,385,96,34688,34672,38990,0,-50,-16,-11011,-15,-5417,-17174,-2,0,-4,0,14
EUW1_6881800052',2,21,20,1,1,2,0,6,1,315,72,30871,30462,40748,3,20,12,1,0,0,0,8,257,127,26105,28358,29599,1,58,-55,4766,8,2104,11149,0,1,2,0,-2
EUW1_6881749314',2,22,28,1,0,3,0,12,1,377,96,37287,32498,48537,2,43,10,1,0,2,0,3,274,64,25449,24705,30219,1,103,32,11838,18,7793,18318,0,0,1,0,9
EUW1_6881215586',2,22,15,1,0,0,0,7,0,367,101,28667,30911,34770,3,296,12,0,0,0,0,0,357,90,25955,31375,35511,0,10,11,2712,3,-464,-741,1,0,0,0,7
EUW1_6881173837',4,21,21,2,0,1,0,5,0,325,100,32354,31887,37702,2,23,12,0,0,1,0,6,316,90,26139,29513,29741,1,9,10,6215,9,2374,7961,2,0,0,0,-1
EUW1_6881124735',2,17,10,0,1,0,0,11,1,365,94,26366,30993,25675,4,65,11,2,0,2,0,1,343,90,27962,29953,37390,0,22,4,-1596,-1,1040,-11715,-2,1,-2,0,10
EUW1_6879567112',0,37,7,0,0,0,0,10,0,344,68,23638,26707,24106,7,29,14,2,0,2,0,1,390,76,29640,30139,30114,0,-46,-8,-6002,-7,-3432,-6008,-2,0,-2,0,9
EUW1_6878902534',10,31,19,2,1,0,0,4,0,380,106,31894,32140,32807,3,26,12,0,0,1,0,9,322,78,26537,27674,32581,1,58,28,5357,7,4466,226,2,1,-1,0,-5
EUW1_6877642431',1,20,10,0,0,0,0,13,0,301,116,25638,28882,32576,1,45,19,1,0,2,0,1,358,78,31306,31700,42127,0,-57,38,-5668,-9,-2818,-9551,-1,0,-2,0,12
EUW1_6877572903',3,19,20,0,0,0,0,11,1,288,74,29757,29644,36914,2,27,22,1,0,0,0,1,294,70,30218,27756,43450,1,-6,4,-461,-2,1888,-6536,-1,0,0,0,10
EUW1_6877467102',4,29,14,1,0,0,0,6,1,331,73,26732,29877,25751,2,30,15,1,0,1,0,1,378,94,29317,31435,29368,0,-47,-21,-2585,-1,-1558,-3617,0,0,-1,0,5
EUW1_6877403497',4,48,17,0,0,0,0,8,1,365,77,30132,29464,30468,1,27,13,2,0,2,0,2,313,86,27775,27276,36206,1,52,-9,2357,4,2188,-5738,-2,0,-2,0,6
EUW1_6877344173',1,30,19,2,0,1,0,7,0,341,92,31296,31413,39841,3,35,13,0,1,0,0,4,332,83,26630,29112,30252,1,9,9,4666,6,2301,9589,2,-1,1,0,3
EUW1_6883656079',3,25,16,1,0,0,0,9,1,368,80,29162,29727,30638,4,30,15,0,0,1,0,3,355,78,29385,30864,33515,0,13,2,-223,1,-1137,-2877,1,0,-1,0,6
EUW1_6883647004',2,65,22,2,0,1,0,4,0,354,61,31725,30820,42481,4,408,11,0,0,1,0,6,305,85,25611,28252,35558,1,49,-24,6114,11,2568,6923,2,0,0,0,-2
EUW1_6883623849',4,25,10,1,0,1,0,13,1,322,92,26871,27735,31468,7,19,17,1,0,2,0,3,370,100,30034,32281,38577,0,-48,-8,-3163,-7,-4546,-7109,0,0,-1,0,10
EUW1_6883611851',4,30,14,1,0,1,0,9,1,403,120,31208,31691,34709,1,26,13,0,0,1,0,4,299,44,25332,23514,30203,1,104,76,5876,1,8177,4506,1,0,0,0,5
EUW1_6883573424',3,29,10,1,0,0,0,10,0,342,106,26329,29768,24099,0,25,14,0,0,3,0,3,365,84,29391,30163,36540,0,-23,22,-3062,-4,-395,-12441,1,0,-3,0,7
EUW1_6883558749',5,27,12,2,0,0,0,5,1,358,88,26924,30233,28966,3,35,5,0,0,1,0,3,347,87,23116,28108,33146,1,11,1,3808,7,2125,-4180,2,0,-1,0,2
EUW1_6883437504',4,27,16,1,0,0,0,6,1,318,104,27647,30917,27492,2,26,9,1,1,1,0,4,358,96,26185,29334,26889,1,-40,8,1462,7,1583,603,0,-1,-1,0,2
EUW1_6883322105',4,24,12,1,0,0,0,13,1,325,78,27277,28332,28490,2,30,10,1,0,1,0,3,373,98,26285,29278,29026,0,-48,-20,992,2,-946,-536,0,0,-1,0,10
EUW1_6883244018',2,21,11,0,0,0,0,7,1,343,84,26069,29894,31136,0,25,13,2,0,0,0,5,362,104,27708,32847,31829,0,-19,-20,-1639,-2,-2953,-693,-2,0,0,0,2
EUW1_6882641953',1,27,6,1,0,1,0,8,0,389,106,26197,30760,22764,2,39,11,1,0,1,0,7,414,104,29025,32935,29514,0,-25,2,-2828,-5,-2175,-6750,0,0,0,0,1
EUW1_6882575888',3,25,11,0,0,1,0,12,0,315,57,26947,26124,32345,3,105,19,2,0,4,0,4,317,90,31939,30291,43050,0,-2,-33,-4992,-8,-4167,-10705,-2,0,-3,0,8
EUW1_6882535884',3,94,14,2,0,0,0,12,0,298,65,26741,28058,31168,0,28,12,0,0,2,0,2,330,89,28678,27481,32832,0,-32,-24,-1937,2,577,-1664,2,0,-2,0,10
EUW1_6880826193',5,31,11,1,0,0,0,11,1,315,75,24809,27692,35163,3,35,17,0,0,1,0,3,312,79,27891,28272,34070,0,3,-4,-3082,-6,-580,1093,1,0,-1,0,8
EUW1_6880760468',4,30,12,0,0,1,0,11,1,380,97,29195,30322,32108,1,74,16,1,0,1,0,4,343,82,28628,31211,32278,0,37,15,567,-4,-889,-170,-1,0,0,0,7
EUW1_6880660841',3,28,7,1,0,0,0,7,0,361,82,23587,29405,23715,1,160,11,1,0,0,0,1,354,110,26182,30064,25272,0,7,-28,-2595,-4,-659,-1557,0,0,0,0,6
EUW1_6875027793',5,24,15,0,0,1,0,13,0,356,82,29706,31473,31438,5,34,18,1,0,2,0,7,374,102,30314,31973,35221,0,-18,-20,-608,-3,-500,-3783,-1,0,-1,0,6
EUW1_6875005147',1,39,5,0,0,0,0,10,0,353,82,24048,28892,26536,7,34,14,2,0,1,0,2,391,106,27886,32425,29945,1,-38,-24,-3838,-9,-3533,-3409,-2,0,-1,0,8
EUW1_6874939714',4,29,13,0,0,1,0,9,0,370,90,28454,30235,36016,3,22,10,1,0,1,0,9,292,86,26083,27147,32931,1,78,4,2371,3,3088,3085,-1,0,0,0,0
EUW1_6874895089',4,68,18,2,0,0,0,3,0,331,80,29013,29295,42402,2,35,16,0,0,0,0,4,303,81,28720,29212,40450,1,28,-1,293,2,83,1952,2,0,0,0,-1
EUW1_6883020211',4,18,9,0,0,0,0,11,0,290,90,23402,27066,24803,5,26,18,2,0,3,0,2,377,94,31206,33231,34504,0,-87,-4,-7804,-9,-6165,-9701,-2,0,-3,0,9
EUW1_6882979499',6,34,10,0,0,0,0,11,1,351,75,25916,28158,28905,4,38,19,1,0,1,0,2,359,92,30655,31780,34309,0,-8,-17,-4739,-9,-3622,-5404,-1,0,-1,0,9
EUW1_6882909438',1,26,11,0,0,0,0,8,1,345,64,26067,27243,28059,4,24,12,2,0,0,0,1,355,108,27048,30012,31751,1,-10,-44,-981,-1,-2769,-3692,-2,0,0,0,7
EUW1_6882862976',0,23,18,0,0,1,0,6,1,355,116,29979,33226,34676,5,22,6,2,0,0,0,7,298,94,23329,27056,30024,1,57,22,6650,12,6170,4652,-2,0,1,0,-1
EUW1_6882658944',1,27,9,0,1,1,0,4,0,368,86,27205,29891,27521,5,30,9,1,0,1,0,5,387,89,26951,29975,24967,0,-19,-3,254,0,-84,2554,-1,1,0,0,-1
EUW1_6882561124',2,19,9,0,1,0,0,9,0,369,110,28262,31507,33110,2,34,11,1,0,2,0,4,362,96,25956,30531,28599,1,7,14,2306,-2,976,4511,-1,1,-2,0,5
EUW1_6882216662',5,28,9,0,0,0,0,6,1,343,90,24196,27508,28047,4,32,15,1,0,1,0,1,353,84,29223,30056,33988,0,-10,6,-5027,-6,-2548,-5941,-1,0,-1,0,5
EUW1_6882165268',1,92,9,1,0,2,0,6,0,340,88,27044,29322,34625,1,34,8,1,0,0,0,8,354,104,25546,29713,28362,1,-14,-16,1498,1,-391,6263,0,0,2,0,-2
EUW1_6882143703',3,20,7,0,0,0,0,17,0,294,75,23710,26726,24742,5,347,18,1,0,4,0,1,355,108,33956,31328,34441,0,-61,-33,-10246,-11,-4602,-9699,-1,0,-4,0,16
EUW1_6882117483',2,25,11,2,0,0,0,13,1,306,84,25173,27543,33206,2,17,19,0,0,2,0,1,330,90,30244,32591,42474,0,-24,-6,-5071,-8,-5048,-9268,2,0,-2,0,12
EUW1_6882067659',5,31,15,1,1,1,0,8,1,359,86,29046,31597,33439,3,23,4,0,0,0,0,4,346,82,22426,27407,24422,1,13,4,6620,11,4190,9017,1,1,1,0,4
EUW1_6881854828',4,30,10,1,0,1,0,10,0,336,86,26956,28650,28458,3,97,9,0,0,0,0,3,360,77,26180,30508,31130,0,-24,9,776,1,-1858,-2672,1,0,1,0,7
EUW1_6881550722',4,23,19,1,1,1,0,8,0,355,84,30342,30785,36793,6,25,10,0,0,2,0,5,339,88,26360,27196,29200,1,16,-4,3982,9,3589,7593,1,1,-1,0,3
EUW1_6881488572',3,37,9,0,0,1,0,11,1,363,88,26432,28818,35089,1,16,12,2,0,0,0,6,318,84,25764,29978,29520,1,45,4,668,-3,-1160,5569,-2,0,1,0,5
EUW1_6881416999',1,18,13,1,0,0,0,7,0,320,104,27686,28589,31725,4,48,15,0,0,0,0,5,273,73,27037,26664,35152,0,47,31,649,-2,1925,-3427,1,0,0,0,2
EUW1_6881351214',4,21,15,1,0,1,0,6,1,404,99,29776,31297,35235,1,29,9,1,0,0,0,7,379,84,25388,28838,21962,1,25,15,4388,6,2459,13273,0,0,1,0,-1
EUW1_6882557700',1,25,19,1,0,0,0,12,1,326,74,29851,30398,38939,4,31,12,1,0,1,0,0,340,106,28187,30454,36617,1,-14,-32,1664,7,-56,2322,0,0,-1,0,12
EUW1_6882518304',4,32,15,2,0,1,0,5,1,363,88,29083,31305,33976,4,32,9,0,0,0,0,7,339,106,25610,28688,30522,1,24,-18,3473,6,2617,3454,2,0,1,0,-2
EUW1_6882811269',4,25,9,1,0,1,0,9,1,362,96,26141,33275,31663,2,33,3,0,0,1,0,3,351,74,23480,27518,26376,1,11,22,2661,6,5757,5287,1,0,0,0,6
EUW1_6882639843',2,27,5,0,0,1,0,8,0,395,80,25300,28190,25202,4,27,13,1,0,2,0,6,324,104,27829,30365,29765,0,71,-24,-2529,-8,-2175,-4563,-1,0,-1,0,2
EUW1_6882525061',4,27,3,0,0,0,0,3,0,349,82,22321,28025,24024,4,29,13,2,0,0,0,3,373,82,27098,31744,39842,1,-24,0,-4777,-10,-3719,-15818,-2,0,0,0,0
EUW1_6882467519',4,27,10,1,0,0,0,8,1,382,110,27909,31564,29212,2,37,11,1,0,1,0,5,335,70,26240,29560,33225,1,47,40,1669,-1,2004,-4013,0,0,-1,0,3
EUW1_6881146615',4,57,2,1,0,0,0,7,0,385,76,22339,28482,21932,5,46,10,1,0,0,0,1,342,96,25468,30598,30505,0,43,-20,-3129,-8,-2116,-8573,0,0,0,0,6
EUW1_6880906559',2,33,14,2,0,0,0,5,1,413,92,28828,31749,33848,3,26,4,0,0,1,0,3,347,95,24099,28555,22320,0,66,-3,4729,10,3194,11528,2,0,-1,0,2
EUW1_6880878242',4,27,15,1,0,0,0,9,0,327,72,26817,29545,31981,1,13,15,0,0,1,0,2,400,128,31625,33217,35665,0,-73,-56,-4808,0,-3672,-3684,1,0,-1,0,7
EUW1_6880185206',3,142,7,1,0,1,0,6,0,375,74,25228,28904,31128,6,24,10,0,0,0,0,4,327,82,24954,30618,30428,0,48,-8,274,-3,-1714,700,1,0,1,0,2
EUW1_6880029180',4,29,15,1,0,1,0,11,0,363,75,27918,31343,36493,3,22,13,0,0,1,0,5,400,110,30297,32954,30465,1,-37,-35,-2379,2,-1611,6028,1,0,0,0,6
EUW1_6879875205',4,27,16,0,0,2,0,6,0,412,110,32324,33008,27523,7,30,16,1,0,1,0,7,405,74,29813,31430,30690,1,7,36,2511,0,1578,-3167,-1,0,1,0,-1
EUW1_6879822056',3,21,12,1,0,0,0,8,0,332,88,26518,29958,30576,5,22,11,1,1,2,0,4,361,91,28294,30369,37643,0,-29,-3,-1776,1,-411,-7067,0,-1,-2,0,4
EUW1_6879651924',3,37,15,2,1,1,0,7,1,339,102,30337,31144,36219,5,32,13,0,0,2,0,5,293,82,27420,28017,30725,1,46,20,2917,2,3127,5494,2,1,-1,0,2
EUW1_6879473415',5,20,9,0,0,1,0,6,0,346,85,26085,28553,27766,5,19,10,2,0,0,0,5,359,105,25876,29478,36094,0,-13,-20,209,-1,-925,-8328,-2,0,1,0,1
EUW1_6879440584',4,77,15,0,0,0,0,9,1,335,79,29055,28048,31312,7,30,15,1,0,1,0,5,332,100,27776,31076,30600,1,3,-21,1279,0,-3028,712,-1,0,-1,0,4
EUW1_6879416175',6,25,13,1,1,0,0,4,1,363,76,27556,29398,31685,5,48,5,1,0,0,0,4,338,108,23108,27856,25283,1,25,-32,4448,8,1542,6402,0,1,0,0,0
EUW1_6878720304',4,59,26,0,0,1,0,8,0,345,79,33276,34059,39604,4,57,10,0,0,0,0,10,347,86,26600,28099,33134,1,-2,-7,6676,16,5960,6470,0,0,1,0,-2
EUW1_6878646325',5,172,12,1,0,0,0,8,0,358,92,27617,30124,27092,3,20,14,1,0,1,0,5,361,97,28475,31649,37257,0,-3,-5,-858,-2,-1525,-10165,0,0,-1,0,3
EUW1_6882841990',3,17,18,1,0,4,0,4,1,346,100,33005,32344,41550,1,19,5,0,0,1,0,9,297,84,22794,26660,25160,1,49,16,10211,13,5684,16390,1,0,3,0,-5
EUW1_6882803751',4,31,27,1,0,2,0,11,1,381,49,35703,32141,49313,2,25,17,0,0,0,0,8,313,94,29303,29230,35937,1,68,-45,6400,10,2911,13376,1,0,2,0,3
EUW1_6882753177',2,28,4,0,0,0,0,8,1,381,113,24343,29997,16290,1,19,3,2,0,0,0,3,387,86,24034,30018,18795,1,-6,27,309,1,-21,-2505,-2,0,0,0,5
EUW1_6882693845',3,17,11,0,0,0,0,10,0,355,74,24876,30000,29465,2,23,11,1,0,1,0,1,385,109,27414,31323,30021,1,-30,-35,-2538,0,-1323,-556,-1,0,-1,0,9
EUW1_6882628299',0,44,7,0,0,0,0,14,0,324,83,23591,28842,25804,1,24,22,2,1,5,1,0,384,104,33606,33546,35262,0,-60,-21,-10015,-15,-4704,-9458,-2,-1,-5,-1,14
EUW1_6881358205',7,67,11,0,0,0,0,9,1,313,92,26232,26703,29031,6,59,14,2,0,1,0,2,342,84,28486,30498,30810,0,-29,8,-2254,-3,-3795,-1779,-2,0,-1,0,7
EUW1_6881303186',2,27,10,0,0,1,0,7,0,376,105,28135,29729,31218,4,29,13,1,0,0,0,6,377,82,27680,29945,33461,1,-1,23,455,-3,-216,-2243,-1,0,1,0,1
EUW1_6881254978',4,25,18,1,0,0,0,14,0,366,80,29009,30814,41540,1,23,12,1,0,2,0,2,386,88,29371,29591,37564,1,-20,-8,-362,6,1223,3976,0,0,-2,0,12
EUW1_6881206165',0,285,14,1,0,1,0,12,0,385,107,29807,32789,39943,1,199,14,1,0,1,0,4,358,80,28861,29946,30261,1,27,27,946,0,2843,9682,0,0,0,0,8
EUW1_6881150616',6,26,6,0,0,0,0,7,1,378,87,25665,28024,27899,3,29,17,1,0,0,0,5,356,102,28846,31259,34234,0,22,-15,-3181,-11,-3235,-6335,-1,0,0,0,2
EUW1_6881112660',2,22,16,0,0,1,0,17,0,327,104,29458,30535,32524,4,24,12,1,0,2,0,3,357,76,28754,29932,33857,1,-30,28,704,4,603,-1333,-1,0,-1,0,14
EUW1_6878409220',6,25,22,1,0,0,0,4,0,369,84,31768,31446,40663,3,24,10,0,0,2,0,4,356,104,27001,28813,39662,1,13,-20,4767,12,2633,1001,1,0,-2,0,0
EUW1_6877164762',1,27,12,1,1,2,0,12,0,357,90,28269,29545,26144,2,166,9,1,0,1,0,3,379,105,27049,29490,23280,1,-22,-15,1220,3,55,2864,0,1,1,0,9
EUW1_6877116885',3,23,14,0,0,1,0,6,1,359,104,29058,31482,38768,6,32,12,1,0,0,0,4,365,88,27388,28632,33710,0,-6,16,1670,2,2850,5058,-1,0,1,0,2
EUW1_6882724999',1,23,20,1,0,0,0,11,0,366,90,30830,33436,41944,6,27,6,0,0,2,0,3,343,85,25519,28355,35312,1,23,5,5311,14,5081,6632,1,0,-2,0,8
EUW1_6882552895',6,45,5,1,1,0,0,10,1,347,109,25203,29422,29196,5,30,11,0,0,2,0,4,382,89,28144,31444,33961,1,-35,20,-2941,-6,-2022,-4765,1,1,-2,0,6
EUW1_6882502103',3,63,18,1,0,1,0,8,0,338,100,31229,33001,41104,4,60,10,1,0,0,0,1,331,71,25098,27701,34055,1,7,29,6131,8,5300,7049,0,0,1,0,7
EUW1_6882479770',5,26,14,1,0,0,0,9,0,363,100,28073,30704,31895,2,24,6,1,1,0,0,2,380,80,25942,28392,25703,1,-17,20,2131,8,2312,6192,0,-1,0,0,7
EUW1_6881696008',2,24,22,1,0,1,0,9,1,367,77,31580,30921,35809,5,28,11,1,1,1,0,7,309,94,27396,27663,31498,1,58,-17,4184,11,3258,4311,0,-1,0,0,2
EUW1_6881604556',4,33,19,0,0,1,0,9,1,345,92,31362,31478,31524,5,132,16,2,0,1,0,2,343,78,29234,29661,43682,1,2,14,2128,3,1817,-12158,-2,0,0,0,7
EUW1_6881319125',1,26,13,0,1,3,0,15,1,330,109,30467,30388,33152,8,32,13,2,0,2,0,4,332,82,27182,28841,29401,0,-2,27,3285,0,1547,3751,-2,1,1,0,11
EUW1_6881050896',2,19,15,1,0,0,0,7,1,375,79,27895,30627,29639,6,31,9,0,0,1,0,6,372,108,26908,29926,31232,0,3,-29,987,6,701,-1593,1,0,-1,0,1
EUW1_6880140932',2,18,15,0,0,0,0,5,1,312,91,27055,29469,30047,0,15,9,1,0,0,0,3,328,80,25277,28221,27448,1,-16,11,1778,6,1248,2599,-1,0,0,0,2
EUW1_6880014110',2,27,12,0,1,1,0,6,0,372,102,28335,32559,37395,4,25,9,1,0,0,0,6,321,86,24477,28190,25463,1,51,16,3858,3,4369,11932,-1,1,1,0,0
EUW1_6879714540',2,24,5,0,0,1,0,13,0,351,78,24094,26629,21888,5,25,23,1,0,3,0,4,418,68,33797,31856,38474,0,-67,10,-9703,-18,-5227,-16586,-1,0,-2,0,9
EUW1_6878997432',7,28,6,0,0,0,0,6,0,350,58,24431,27128,23884,2,22,14,2,0,0,0,2,348,90,27121,29393,25542,0,2,-32,-2690,-8,-2265,-1658,-2,0,0,0,4
EUW1_6878902735',2,21,4,0,0,0,0,13,0,356,80,23161,28162,27645,5,25,12,1,0,1,0,0,399,86,28616,31257,26627,0,-43,-6,-5455,-8,-3095,1018,-1,0,-1,0,13
EUW1_6878785610',6,27,14,0,0,2,0,7,0,383,91,29876,32405,28847,4,34,16,2,0,0,0,5,361,84,28688,31461,32867,0,22,7,1188,-2,944,-4020,-2,0,2,0,2
EUW1_6878615252',4,31,12,1,0,0,0,8,0,322,102,26356,29893,30204,6,35,14,0,0,1,0,1,320,76,26018,29309,33575,0,2,26,338,-2,584,-3371,1,0,-1,0,7
EUW1_6878476582',1,26,13,2,0,1,0,8,1,372,80,28001,29497,36690,4,24,9,0,0,0,0,3,364,84,25879,28186,27069,1,8,-4,2122,4,1311,9621,2,0,1,0,5
EUW1_6877497625',2,20,13,1,0,0,0,12,1,390,80,27992,30473,35559,3,20,13,1,1,2,0,2,326,84,28818,30572,28058,1,64,-4,-826,0,-99,7501,0,-1,-2,0,10
EUW1_6877429551',4,23,16,0,0,0,0,4,1,346,101,29363,30916,36561,3,20,14,2,0,0,0,6,297,97,26932,29055,40402,1,49,4,2431,2,1861,-3841,-2,0,0,0,-2
EUW1_6877304678',5,24,33,1,0,1,0,13,1,355,87,33929,32185,49800,2,27,9,1,0,1,0,2,335,88,27336,28607,35208,1,20,-1,6593,24,3578,14592,0,0,0,0,11
EUW1_6883781283',4,132,7,0,0,0,0,5,0,361,81,24458,29742,28484,3,93,7,2,0,0,0,2,375,90,24796,30091,26883,1,-14,-9,-338,0,-349,1601,-2,0,0,0,3
EUW1_6883745431',2,40,13,1,0,0,0,9,1,394,70,29485,31745,34849,3,102,12,1,0,1,0,1,351,81,26769,29964,30208,1,43,-11,2716,1,1781,4641,0,0,-1,0,8
EUW1_6883727436',5,27,18,2,0,2,0,7,1,406,112,32603,32851,32867,5,28,4,0,0,3,0,12,271,92,22941,24916,18094,1,135,20,9662,14,7935,14773,2,0,-1,0,-5
EUW1_6883713299',6,28,11,0,0,1,0,13,0,297,77,25742,28751,24342,5,29,15,2,1,2,0,3,358,80,28718,30271,39965,0,-61,-3,-2976,-4,-1520,-15623,-2,-1,-1,0,10
EUW1_6883721487',2,24,16,1,0,0,0,14,0,346,73,29819,28816,33862,4,29,24,1,0,3,0,5,355,110,34791,32062,42500,1,-9,-37,-4972,-8,-3246,-8638,0,0,-3,0,9
EUW1_6883614953',5,35,6,0,0,0,0,7,1,334,98,23312,27207,35048,2,29,17,1,0,1,0,2,366,92,29134,30758,35923,0,-32,6,-5822,-11,-3551,-875,-1,0,-1,0,5
EUW1_6883589281',3,47,11,1,0,1,0,4,1,404,124,29186,33549,34017,1,40,4,0,0,1,0,8,357,84,22828,27469,20925,1,47,40,6358,7,6080,13092,1,0,0,0,-4
EUW1_6883569042',5,28,17,1,0,1,0,12,1,309,66,29286,28190,35372,3,25,16,0,0,3,0,6,380,82,31997,30067,33940,1,-71,-16,-2711,1,-1877,1432,1,0,-2,0,6
EUW1_6883536421',4,64,12,0,0,1,0,7,0,364,79,28263,29788,31487,3,58,12,2,0,1,0,10,320,90,26960,28718,35990,0,44,-11,1303,0,1070,-4503,-2,0,0,0,-3
EUW1_6883508761',4,24,19,1,0,0,0,5,1,356,90,31453,29436,34208,5,30,6,0,1,2,0,9,329,77,23343,26770,27829,1,27,13,8110,13,2666,6379,1,-1,-2,0,-4
EUW1_6883461924',2,39,16,2,0,1,0,8,1,318,90,29068,29824,34997,3,28,17,0,0,0,0,7,325,78,27023,29048,35685,0,-7,12,2045,-1,776,-688,2,0,1,0,1
EUW1_6883386493',2,27,16,1,1,1,0,5,1,382,90,30133,30508,32400,1,22,14,0,0,1,0,6,333,90,27703,29351,28000,0,49,0,2430,2,1157,4400,1,1,0,0,-1
EUW1_6882567542',3,30,7,0,0,0,0,12,0,323,66,23941,28016,24839,6,29,19,2,0,3,0,2,349,109,31096,31130,42370,0,-26,-43,-7155,-12,-3114,-17531,-2,0,-3,0,10
EUW1_6882536674',3,29,13,1,0,0,0,11,0,334,84,26935,28221,34268,5,153,15,0,0,1,0,4,381,71,28350,29078,34782,0,-47,13,-1415,-2,-857,-514,1,0,-1,0,7
EUW1_6882504430',3,41,23,2,0,1,0,13,1,339,68,33800,28863,35647,1,22,16,0,0,3,0,7,316,72,30327,28661,39024,1,23,-4,3473,7,202,-3377,2,0,-2,0,6
EUW1_6882486941',4,26,19,2,0,2,0,10,0,344,102,32128,29323,36158,8,27,16,0,0,1,0,7,378,73,30166,28506,29570,1,-34,29,1962,3,817,6588,2,0,1,0,3
EUW1_6882467715',7,47,9,2,0,0,0,11,1,297,80,24054,27215,22899,5,26,13,0,1,2,0,1,402,104,30740,32008,33153,0,-105,-24,-6686,-4,-4793,-10254,2,-1,-2,0,10
EUW1_6882435731',9,31,3,0,0,0,0,9,0,340,89,21670,26573,19693,7,27,15,2,0,1,0,0,383,92,28669,30637,34719,1,-43,-3,-6999,-12,-4064,-15026,-2,0,-1,0,9
EUW1_6882407956',4,26,8,1,0,0,0,8,1,309,86,24887,29023,27678,6,34,10,0,0,0,0,1,338,102,25117,28949,31663,0,-29,-16,-230,-2,74,-3985,1,0,0,0,7
EUW1_6882390854',7,31,16,2,0,2,0,6,1,333,86,28568,28763,29644,3,27,5,0,0,0,0,6,341,86,23189,26648,23218,1,-8,0,5379,11,2115,6426,2,0,2,0,0
EUW1_6883764903',5,24,14,1,0,0,0,14,1,322,80,27411,28192,28932,3,162,22,1,0,2,0,1,376,88,32866,31506,32800,0,-54,-8,-5455,-8,-3314,-3868,0,0,-2,0,13
EUW1_6883097586',5,24,11,2,1,0,0,5,1,323,68,24563,29003,24296,3,23,8,0,0,0,0,0,350,86,24863,29050,30718,1,-27,-18,-300,3,-47,-6422,2,1,0,0,5
EUW1_6883050899',1,22,3,0,0,0,0,15,1,318,72,20517,24159,21491,3,21,21,2,0,4,0,1,352,84,32036,33206,42908,0,-34,-12,-11519,-18,-9047,-21417,-2,0,-4,0,14
EUW1_6880615646',0,25,8,0,0,0,0,11,0,337,82,24615,28250,23970,3,25,14,2,0,3,0,0,377,82,29692,30631,37734,0,-40,0,-5077,-6,-2381,-13764,-2,0,-3,0,11
EUW1_6877698061',6,70,20,1,0,3,0,8,1,373,78,33296,30489,45910,10,34,12,1,0,0,0,11,260,76,25851,26321,34882,1,113,2,7445,8,4168,11028,0,0,3,0,-3
EUW1_6877635445',3,39,10,2,0,1,0,11,0,303,76,25955,27466,32318,8,39,13,0,1,0,0,0,341,87,26677,28573,35710,1,-38,-11,-722,-3,-1107,-3392,2,-1,1,0,11
EUW1_6877587386',0,23,14,0,0,0,0,9,1,338,88,28122,29059,27748,5,22,17,2,0,2,0,3,286,84,28579,29229,36560,0,52,4,-457,-3,-170,-8812,-2,0,-2,0,6
EUW1_6883461150',4,20,18,2,0,2,0,5,0,350,86,30225,31374,45061,2,324,14,0,0,0,0,6,353,78,27486,30743,32870,1,-3,8,2739,4,631,12191,2,0,2,0,-1
EUW1_6883407678',6,261,10,0,0,0,0,3,1,378,92,27174,30145,29865,3,31,12,2,0,0,0,5,384,94,26796,30776,31668,1,-6,-2,378,-2,-631,-1803,-2,0,0,0,-2
EUW1_6882887528',4,27,16,0,0,1,0,9,1,319,86,29003,27285,34875,2,246,16,1,0,0,0,4,306,74,28361,27357,42943,0,13,12,642,0,-72,-8068,-1,0,1,0,5
EUW1_6882119152',2,28,7,0,0,0,0,6,1,340,84,24731,27359,24744,2,302,12,1,0,0,0,2,395,84,27085,31279,36031,0,-55,0,-2354,-5,-3920,-11287,-1,0,0,0,4
EUW1_6882089524',7,276,20,2,0,2,0,9,1,367,89,32161,31299,36764,3,25,7,0,0,1,0,8,332,70,24133,25331,25903,1,35,19,8028,13,5968,10861,2,0,1,0,1
EUW1_6881729997',5,26,3,1,0,0,0,7,0,354,78,22155,27306,22546,0,199,14,1,0,1,0,2,386,70,28309,30968,29836,0,-32,8,-6154,-11,-3662,-7290,0,0,-1,0,5
EUW1_6881683100',5,37,9,0,0,0,0,17,1,283,67,23921,24510,27954,4,295,22,2,0,4,0,0,361,95,34802,31479,44042,0,-78,-28,-10881,-13,-6969,-16088,-2,0,-4,0,17
EUW1_6881645662',4,26,13,2,0,0,0,6,1,362,86,28455,29758,34658,9,240,11,0,0,0,0,2,341,78,25746,26978,23610,1,21,8,2709,2,2780,11048,2,0,0,0,4
EUW1_6881579370',2,148,12,2,0,0,0,12,1,357,72,26399,28931,29035,4,24,9,0,0,0,0,2,382,96,26281,28392,25448,1,-25,-24,118,3,539,3587,2,0,0,0,10
EUW1_6881525257',4,14,15,0,0,0,0,6,1,354,78,27470,30851,29763,1,408,13,2,0,0,0,7,336,74,27002,29671,39068,0,18,4,468,2,1180,-9305,-2,0,0,0,-1
EUW1_6880781957',4,297,10,0,0,0,0,8,1,378,62,27201,27266,38414,6,25,15,1,0,1,0,2,334,64,27145,29032,37230,0,44,-2,56,-5,-1766,1184,-1,0,-1,0,6
EUW1_6880770877',0,283,26,2,0,2,0,4,1,360,70,33246,31363,46490,3,26,11,0,0,0,0,12,274,90,26742,26071,32992,1,86,-20,6504,15,5292,13498,2,0,2,0,-8
EUW1_6880510708',3,36,13,1,0,0,0,12,0,320,78,27263,28727,36263,2,323,15,1,0,1,0,2,391,82,28281,29896,36825,0,-71,-4,-1018,-2,-1169,-562,0,0,-1,0,10
EUW1_6879167457',4,30,12,0,0,1,0,15,0,355,104,27751,32152,32634,4,293,15,2,0,3,0,3,352,64,30069,30512,37799,1,3,40,-2318,-3,1640,-5165,-2,0,-2,0,12
EUW1_6879116776',6,50,15,2,0,0,0,7,1,367,80,29282,29771,30095,6,69,11,0,0,0,0,0,370,92,26173,30211,32687,1,-3,-12,3109,4,-440,-2592,2,0,0,0,7
EUW1_6879065943',2,65,19,0,0,3,0,8,1,330,106,31701,31317,40206,3,22,11,2,0,0,0,11,268,90,24782,27844,32761,1,62,16,6919,8,3473,7445,-2,0,3,0,-3
EUW1_6879020817',0,182,13,2,0,1,0,15,1,306,63,26088,27552,27832,5,31,20,0,1,2,0,2,334,90,31866,30302,40173,0,-28,-27,-5778,-7,-2750,-12341,2,-1,-1,0,13
EUW1_6883531808',2,25,25,1,1,1,0,5,1,355,73,31877,32057,42534,3,27,9,0,0,0,0,6,364,94,26462,27882,35342,1,-9,-21,5415,16,4175,7192,1,1,1,0,-1
EUW1_6883018116',5,29,18,1,1,2,0,12,0,356,108,31899,32042,32166,9,31,14,1,0,1,0,5,340,72,29124,27588,33222,1,16,36,2775,4,4454,-1056,0,1,1,0,7
EUW1_6882979569',3,20,24,2,0,2,0,8,1,339,82,33776,28616,42698,4,33,12,0,0,1,0,8,305,74,28154,27478,24879,1,34,8,5622,12,1138,17819,2,0,1,0,0
EUW1_6882933403',7,33,19,2,0,3,0,5,1,389,106,32312,31903,35108,3,26,7,0,0,0,0,7,263,72,22482,24985,28948,1,126,34,9830,12,6918,6160,2,0,3,0,-2
EUW1_6882873991',4,45,13,0,0,1,0,10,0,378,80,28949,31021,31554,3,24,14,1,1,1,0,6,371,96,29750,31611,28758,0,7,-16,-801,-1,-590,2796,-1,-1,0,0,4
EUW1_6882086497',2,22,11,1,0,1,0,10,0,284,84,24616,28748,37815,3,98,19,0,0,2,0,1,327,92,29565,30339,42159,1,-43,-8,-4949,-8,-1591,-4344,1,0,-1,0,9
EUW1_6881320395',4,29,9,0,0,0,0,11,0,332,60,24967,28232,26393,9,34,21,2,0,1,0,0,347,98,31470,31594,40402,0,-15,-38,-6503,-12,-3362,-14009,-2,0,-1,0,11
EUW1_6881287747',4,30,21,1,0,2,0,8,0,373,116,33117,34353,41979,1,28,11,1,0,0,0,6,307,80,24875,26616,30205,1,66,36,8242,10,7737,11774,0,0,2,0,2
EUW1_6880574155',5,32,10,0,0,0,0,13,0,349,101,27201,27688,26242,3,27,15,2,0,3,0,3,370,98,29819,30916,32693,0,-21,3,-2618,-5,-3228,-6451,-2,0,-3,0,10
EUW1_6880538600',5,172,13,1,1,1,0,8,1,365,95,28969,29233,24793,4,30,2,1,0,1,0,9,366,80,22434,27386,22360,1,-1,15,6535,11,1847,2433,0,1,0,0,-1
EUW1_6880379827',6,23,15,1,0,0,0,11,0,355,112,29125,31057,42929,5,26,12,1,0,1,0,2,335,74,26474,28330,36594,1,20,38,2651,3,2727,6335,0,0,-1,0,9
EUW1_6876316903',2,135,12,1,1,2,0,9,0,327,77,28272,27809,40062,5,80,14,0,0,1,0,4,305,62,27180,27509,28992,1,22,15,1092,-2,300,11070,1,1,1,0,5
EUW1_6876166781',5,46,10,0,0,0,0,10,0,312,80,25291,28633,22047,5,27,15,2,0,2,0,0,377,95,29996,30647,34841,0,-65,-15,-4705,-5,-2014,-12794,-2,0,-2,0,10
EUW1_6876078427',5,45,14,0,1,0,0,7,0,306,102,27605,29166,35453,5,36,16,2,0,0,0,1,317,67,27316,27032,25920,0,-11,35,289,-2,2134,9533,-2,1,0,0,6
EUW1_6875786033',0,28,13,1,0,1,0,7,0,353,94,28430,30776,39362,4,44,13,1,0,0,0,5,315,93,26665,29393,29327,0,38,1,1765,0,1383,10035,0,0,1,0,2
EUW1_6875737881',1,20,12,1,0,0,0,6,1,327,88,27023,29014,33087,5,112,13,0,1,0,0,3,322,80,26887,29923,31296,0,5,8,136,-1,-909,1791,1,-1,0,0,3
EUW1_6875690618',4,20,19,1,0,2,0,9,1,355,96,32289,30465,44250,3,32,16,0,0,1,0,13,317,96,29007,32395,41109,1,38,0,3282,3,-1930,3141,1,0,1,0,-4
EUW1_6875644316',5,53,25,2,0,3,0,6,1,408,76,34844,31806,41305,2,27,5,0,0,1,0,10,332,60,22885,26029,27315,1,76,16,11959,20,5777,13990,2,0,2,0,-4
EUW1_6882430310',1,21,10,0,0,1,0,9,1,340,78,25375,27681,38049,1,142,14,2,0,1,0,5,311,86,27355,30751,33332,0,29,-8,-1980,-4,-3070,4717,-2,0,0,0,4
EUW1_6882404475',6,47,8,1,0,1,0,10,1,386,100,25977,31786,23358,1,24,8,1,0,1,0,2,378,88,26571,29668,28361,0,8,12,-594,0,2118,-5003,0,0,0,0,8
EUW1_6882250491',6,28,18,2,0,1,0,10,1,382,96,29388,33437,31824,3,63,6,0,0,1,0,5,394,84,25541,29612,29079,1,-12,12,3847,12,3825,2745,2,0,0,0,5
EUW1_6882225195',3,24,27,1,0,1,0,7,0,358,92,33255,34474,42267,1,64,15,0,0,0,0,7,342,82,29245,29194,27426,1,16,10,4010,12,5280,14841,1,0,1,0,0
EUW1_6882122849',4,24,18,1,1,1,0,6,1,349,101,30055,32001,41626,7,22,9,0,0,1,0,4,358,78,25615,29505,29569,1,-9,23,4440,9,2496,12057,1,1,0,0,2
EUW1_6880758980',4,20,21,1,1,2,0,8,1,379,87,32320,33213,38338,6,44,3,1,0,0,0,6,348,88,22126,27194,31173,1,31,-1,10194,18,6019,7165,0,1,2,0,2
EUW1_6880744664',2,68,19,1,0,3,0,11,1,318,92,32467,28931,41255,4,22,23,1,0,0,0,7,321,99,33670,31336,40190,0,-3,-7,-1203,-4,-2405,1065,0,0,3,0,4
EUW1_6880673994',2,19,6,1,0,1,0,8,1,362,85,25176,27606,29917,3,19,15,1,1,1,0,6,373,102,29260,32887,41156,0,-11,-17,-4084,-9,-5281,-11239,0,-1,0,0,2
EUW1_6880646423',3,23,17,1,1,0,0,10,1,375,100,30707,32687,32451,3,26,6,1,0,1,0,6,338,96,24619,27851,26957,1,37,4,6088,11,4836,5494,0,1,-1,0,4
EUW1_6880318480',4,42,19,0,0,1,0,11,1,327,54,28595,29507,41518,2,22,10,1,0,0,0,3,289,94,23671,28243,24372,0,38,-40,4924,9,1264,17146,-1,0,1,0,8
EUW1_6880123476',2,40,16,1,0,2,0,12,1,313,94,29299,27324,36264,1,25,17,1,1,1,0,3,346,101,30157,30921,34676,0,-33,-7,-858,-1,-3597,1588,0,-1,1,0,9
EUW1_6879139572',5,26,14,1,0,2,0,10,1,350,87,29633,29106,26983,5,30,12,1,1,0,0,4,334,78,26743,27620,31503,0,16,9,2890,2,1486,-4520,0,-1,2,0,6
EUW1_6879084864',3,29,10,1,1,0,0,10,1,380,96,26498,30853,24291,7,38,5,0,0,0,0,1,368,100,24820,29294,25521,1,12,-4,1678,5,1559,-1230,1,1,0,0,9
EUW1_6879033516',3,28,13,2,0,1,0,5,1,376,89,28548,32105,37368,2,28,3,0,0,0,0,4,363,86,22396,28300,21715,1,13,3,6152,10,3805,15653,2,0,1,0,1
EUW1_6878772267',6,22,17,0,0,1,0,4,1,390,89,30900,32236,36118,5,26,8,1,0,1,0,6,285,100,24401,28532,25609,1,105,-11,6499,9,3704,10509,-1,0,0,0,-2
EUW1_6878660660',9,27,20,2,0,0,0,15,1,320,86,28085,29711,38383,1,23,11,0,0,2,0,2,283,88,26073,27126,27889,1,37,-2,2012,9,2585,10494,2,0,-2,0,13
EUW1_6878612460',2,23,9,0,0,0,0,13,0,297,88,25589,27834,27359,5,19,20,1,0,1,0,1,392,90,31304,32420,39658,0,-95,-2,-5715,-11,-4586,-12299,-1,0,-1,0,12
EUW1_6878544278',8,28,16,1,0,1,0,9,0,322,78,29892,27783,36965,6,28,18,1,1,0,0,1,347,76,28852,29627,36775,1,-25,2,1040,-2,-1844,190,0,-1,1,0,8
EUW1_6882482631',3,25,3,1,0,0,0,6,1,371,98,22612,28683,23533,7,32,11,1,1,0,0,1,377,96,26904,31386,27811,0,-6,2,-4292,-8,-2703,-4278,0,-1,0,0,5
EUW1_6882067230',4,66,6,2,0,0,0,11,1,359,94,25343,29056,23855,2,84,2,0,0,0,0,1,374,82,22794,28965,24473,1,-15,12,2549,4,91,-618,2,0,0,0,10
EUW1_6882027743',7,29,18,0,0,0,0,5,1,330,80,28723,29445,35764,2,28,18,1,0,1,0,2,349,80,30195,31103,35957,1,-19,0,-1472,0,-1658,-193,-1,0,-1,0,3
EUW1_6881682633',6,32,18,2,0,1,0,9,1,328,82,29370,28822,38115,2,29,10,0,0,0,0,7,291,62,25379,27014,26660,1,37,20,3991,8,1808,11455,2,0,1,0,2
EUW1_6881612431',3,29,16,1,0,0,0,10,0,333,75,29672,30463,38679,3,22,13,0,0,1,0,1,310,72,25890,26953,28012,1,23,3,3782,3,3510,10667,1,0,-1,0,9
EUW1_6881561951',4,48,19,1,0,2,0,6,1,371,104,31575,32553,33702,5,26,9,0,0,0,0,2,344,59,25053,27872,28048,1,27,45,6522,10,4681,5654,1,0,2,0,4
EUW1_6881514771',2,25,4,1,0,0,0,13,0,388,65,24528,28220,19839,5,28,11,1,0,2,0,1,384,96,29546,33178,28618,0,4,-31,-5018,-7,-4958,-8779,0,0,-2,0,12
EUW1_6881444515',5,45,5,1,0,0,0,8,0,383,108,24620,30204,25328,10,41,12,0,1,1,0,3,422,72,28912,30807,29409,1,-39,36,-4292,-7,-603,-4081,1,-1,-1,0,5
EUW1_6881379472',5,25,11,1,0,0,0,9,1,348,71,25861,27161,34005,2,30,16,0,0,2,0,2,345,84,30149,29175,40485,1,3,-13,-4288,-5,-2014,-6480,1,0,-2,0,7
EUW1_6881336934',4,31,21,2,0,1,0,7,1,344,108,31901,33816,44457,8,102,5,0,0,1,0,5,325,64,22243,26182,33084,1,19,44,9658,16,7634,11373,2,0,0,0,2
EUW1_6877386664',8,29,12,2,0,0,0,4,1,361,75,27417,27903,32239,5,25,17,0,1,1,0,5,325,77,27466,27879,38792,0,36,-2,-49,-5,24,-6553,2,-1,-1,0,-1
EUW1_6877327016',3,33,12,2,0,0,0,6,0,367,67,27402,29129,35565,4,20,13,0,0,1,0,2,352,74,27157,30383,31324,0,15,-7,245,-1,-1254,4241,2,0,-1,0,4
EUW1_6877274710',0,25,22,0,1,0,0,11,0,268,90,30906,31847,49923,5,27,17,1,0,2,0,8,339,89,30155,30519,41363,0,-71,1,751,5,1328,8560,-1,1,-2,0,3
EUW1_6877217928',8,30,15,0,0,0,0,11,1,330,99,28607,27267,36239,5,44,19,2,0,2,0,5,348,72,29275,30946,36406,0,-18,27,-668,-4,-3679,-167,-2,0,-2,0,6
EUW1_6883424535',2,28,12,0,0,0,0,9,0,368,90,27823,30600,28088,4,32,6,1,0,0,0,3,393,90,25260,29748,28488,1,-25,0,2563,6,852,-400,-1,0,0,0,6
EUW1_6883374594',4,27,10,0,1,1,0,12,1,313,96,27509,29242,29657,1,33,6,2,0,1,0,5,372,81,25330,29404,21708,1,-59,15,2179,4,-162,7949,-2,1,0,0,7
EUW1_6883252462',6,77,13,0,1,0,0,13,1,326,88,28120,30238,33882,2,24,17,2,0,1,0,1,353,104,29433,30898,35479,1,-27,-16,-1313,-4,-660,-1597,-2,1,-1,0,12
EUW1_6882235497',5,29,10,1,0,0,0,3,0,348,90,25845,30009,27248,3,27,6,1,0,0,0,1,361,102,24345,28537,27911,0,-13,-12,1500,4,1472,-663,0,0,0,0,2
EUW1_6882207615',1,54,15,1,0,2,0,2,1,397,95,30331,33732,29464,7,63,8,0,0,0,0,7,405,80,25223,29967,30650,1,-8,15,5108,7,3765,-1186,1,0,2,0,-5
EUW1_6880724374',3,37,10,1,1,0,0,13,0,344,76,24691,26871,32110,1,29,9,0,0,1,0,4,317,72,24910,28098,24844,0,27,4,-219,1,-1227,7266,1,1,-1,0,9
EUW1_6880701400',2,24,10,1,1,1,0,9,0,384,98,28161,30044,25695,5,28,10,1,0,1,0,4,328,112,26827,26959,20241,1,56,-14,1334,0,3085,5454,0,1,0,0,5
EUW1_6880677712',1,26,10,2,0,1,0,9,1,361,86,27341,27711,25805,7,30,8,0,0,1,0,3,382,96,25506,28609,21455,1,-21,-10,1835,2,-898,4350,2,0,0,0,6
EUW1_6878148951',2,20,6,0,0,0,0,10,0,327,100,23590,26799,24031,2,25,14,2,0,2,0,2,361,92,29276,30055,27489,1,-34,8,-5686,-8,-3256,-3458,-2,0,-2,0,8
EUW1_6876951336',3,38,18,0,0,0,0,4,1,359,100,29388,31466,45149,4,25,17,1,0,0,0,3,305,82,27947,28946,41221,1,54,18,1441,1,2520,3928,-1,0,0,0,1
EUW1_6876236786',2,24,9,1,0,0,0,4,0,365,100,25748,31219,26331,4,50,5,1,0,0,0,6,377,108,24065,30774,25453,1,-12,-8,1683,4,445,878,0,0,0,0,-2
EUW1_6883597605',1,20,5,1,0,0,0,10,0,319,109,23162,28051,16788,3,31,6,1,0,1,0,0,344,97,24705,28035,19540,1,-25,12,-1543,-1,16,-2752,0,0,-1,0,10
EUW1_6883565278',4,20,10,0,1,0,0,7,1,381,74,26119,31822,28455,0,24,5,2,0,1,0,1,356,93,23590,28433,20295,0,25,-19,2529,5,3389,8160,-2,1,-1,0,6
EUW1_6883543369',3,32,11,1,0,0,0,5,0,338,110,26140,31099,36774,5,26,11,1,0,0,0,0,304,85,25714,27621,27878,1,34,25,426,0,3478,8896,0,0,0,0,5
EUW1_6883521811',3,29,11,0,0,0,0,11,1,314,68,25468,26982,27203,4,27,14,1,0,1,0,3,333,78,28417,28797,36224,0,-19,-10,-2949,-3,-1815,-9021,-1,0,-1,0,8
EUW1_6883459441',3,35,7,0,0,0,0,7,1,380,87,25552,28843,23707,0,32,13,1,0,0,0,2,341,108,27816,31303,31810,1,39,-21,-2264,-6,-2460,-8103,-1,0,0,0,5
EUW1_6882953143',4,26,10,1,0,1,0,5,1,364,90,26858,30191,36564,2,23,12,1,1,0,0,1,355,86,26476,30923,32329,1,9,4,382,-2,-732,4235,0,-1,1,0,4
EUW1_6882895315',3,135,9,2,0,1,0,7,1,322,89,25713,27279,33197,7,245,19,0,1,1,0,3,351,78,30257,30476,37123,1,-29,11,-4544,-10,-3197,-3926,2,-1,0,0,4
EUW1_6882705294',3,27,14,1,0,0,0,10,0,341,90,28444,29800,31990,3,24,9,1,1,1,0,2,396,113,28631,30485,27334,1,-55,-23,-187,5,-685,4656,0,-1,-1,0,8
EUW1_6882682026',1,20,15,0,0,0,0,10,0,339,90,28253,29483,29971,7,31,12,1,0,1,0,3,337,82,27668,26316,32996,1,2,8,585,3,3167,-3025,-1,0,-1,0,7
EUW1_6882216945',2,28,19,1,0,2,0,11,1,334,120,29808,32318,34109,4,26,6,0,0,0,0,2,316,96,24194,27556,25602,1,18,24,5614,13,4762,8507,1,0,2,0,9
EUW1_6882185318',4,24,16,0,0,0,0,6,0,364,85,29359,31805,35185,2,20,13,1,0,0,0,5,373,101,27061,30151,31866,1,-9,-16,2298,3,1654,3319,-1,0,0,0,1
EUW1_6881602876',5,29,12,1,1,1,0,7,0,341,92,28453,28648,30126,1,29,11,1,0,0,0,6,314,94,25551,27398,28446,1,27,-2,2902,1,1250,1680,0,1,1,0,1
EUW1_6881557160',7,27,17,2,0,2,0,10,0,360,80,30367,31891,42226,1,22,10,0,0,1,0,7,297,84,24057,26962,26261,1,63,-4,6310,7,4929,15965,2,0,1,0,3
EUW1_6881287233',5,30,9,2,0,1,0,10,1,389,96,26826,28556,30151,4,39,4,0,0,0,0,4,364,98,23565,27438,27080,1,25,-2,3261,5,1118,3071,2,0,1,0,6
EUW1_6881235392',4,32,9,0,0,0,0,15,0,277,72,23848,25037,29342,2,21,19,2,0,3,0,1,348,106,32009,30786,40037,0,-71,-34,-8161,-10,-5749,-10695,-2,0,-3,0,14
EUW1_6881193840',2,23,5,0,0,0,0,7,0,375,68,23801,27592,19787,4,29,8,1,0,0,0,2,397,107,25924,30962,25996,0,-22,-39,-2123,-3,-3370,-6209,-1,0,0,0,5
EUW1_6881143887',3,33,7,0,0,0,0,8,0,368,90,26226,29195,23843,7,36,15,2,0,1,0,5,418,106,28747,32152,30573,0,-50,-16,-2521,-8,-2957,-6730,-2,0,-1,0,3
EUW1_6881098942',4,42,14,1,0,0,0,10,1,357,96,29081,30057,30082,1,23,14,1,0,2,0,5,398,92,28053,31576,30859,0,-41,4,1028,0,-1519,-777,0,0,-2,0,5
EUW1_6880642991',2,23,11,1,0,0,0,7,1,380,104,27525,29897,30749,4,26,13,0,1,1,0,3,362,96,28474,31471,26726,0,18,8,-949,-2,-1574,4023,1,-1,-1,0,4
EUW1_6882123591',6,33,7,0,0,1,0,15,0,334,58,24081,25591,28412,4,241,16,2,0,1,0,0,387,80,30288,32353,34077,0,-53,-22,-6207,-9,-6762,-5665,-2,0,0,0,15
EUW1_6882047259',2,68,9,1,0,1,0,7,1,370,102,27334,30066,26199,6,27,10,1,0,0,0,7,367,86,26126,29318,32283,0,3,16,1208,-1,748,-6084,0,0,1,0,0
EUW1_6882004401',1,22,5,0,0,0,0,9,0,318,72,22553,24275,27738,3,33,21,2,0,1,0,4,341,94,29155,30900,36534,0,-23,-22,-6602,-16,-6625,-8796,-2,0,-1,0,5
EUW1_6881945338',2,27,15,1,0,0,0,11,0,311,80,27763,30191,32124,4,170,13,1,0,2,0,2,383,99,29336,30698,35977,0,-72,-19,-1573,2,-507,-3853,0,0,-2,0,9
EUW1_6881897263',2,21,4,2,1,0,0,9,1,322,74,22381,25742,26262,1,30,15,0,0,2,0,1,392,97,30562,32555,33999,0,-70,-23,-8181,-11,-6813,-7737,2,1,-2,0,8
EUW1_6883651714',1,71,14,1,0,0,0,11,0,335,86,27258,30490,45429,8,29,14,0,0,1,0,0,361,76,29160,30853,36180,0,-26,10,-1902,0,-363,9249,1,0,-1,0,11
EUW1_6883592285',0,156,10,0,0,0,0,4,1,354,84,24402,28799,31889,3,34,11,1,0,0,0,3,358,92,26144,29226,33934,1,-4,-8,-1742,-1,-427,-2045,-1,0,0,0,1
EUW1_6883320437',4,32,10,0,0,0,0,9,0,334,83,26666,27735,25507,4,26,14,1,1,1,0,5,338,92,28566,29199,30256,1,-4,-9,-1900,-4,-1464,-4749,-1,-1,-1,0,4
EUW1_6883244862',2,15,11,0,0,0,0,11,0,347,78,26148,28075,28212,2,22,24,1,0,1,0,2,308,90,32178,30818,40513,1,39,-12,-6030,-13,-2743,-12301,-1,0,-1,0,9
EUW1_6882925839',4,26,11,2,0,1,0,6,0,349,89,27125,28880,30195,5,24,11,0,0,0,0,4,333,89,27030,29300,30919,1,16,0,95,0,-420,-724,2,0,1,0,2
EUW1_6882870949',3,23,11,1,0,1,0,13,1,392,114,28286,32519,33018,4,30,11,1,0,0,0,3,333,98,27382,30753,31877,1,59,16,904,0,1766,1141,0,0,1,0,10
EUW1_6882528054',3,28,12,2,0,0,0,8,1,326,72,25252,27519,27021,5,61,11,0,0,0,0,1,363,84,26487,28985,36453,0,-37,-12,-1235,1,-1466,-9432,2,0,0,0,7
EUW1_6882201567',4,47,17,2,0,1,0,9,1,298,77,27503,28669,33531,2,49,9,0,1,1,0,2,344,80,26775,28265,35863,1,-46,-3,728,8,404,-2332,2,-1,0,0,7
EUW1_6881881246',1,26,8,1,0,0,0,11,0,362,84,26061,31276,29861,3,29,9,1,0,2,0,6,334,108,26912,30329,22591,1,28,-24,-851,-1,947,7270,0,0,-2,0,5
EUW1_6878664134',5,31,17,0,0,1,0,12,0,333,86,29706,29820,34357,7,48,26,2,0,2,0,3,349,82,33887,31334,50874,0,-16,4,-4181,-9,-1514,-16517,-2,0,-1,0,9
EUW1_6877163741',6,25,21,1,1,1,0,5,1,372,94,32108,32504,37362,2,23,15,1,0,0,0,4,352,78,28566,29375,37771,1,20,16,3542,6,3129,-409,0,1,1,0,1
EUW1_6874564277',3,25,8,0,0,0,0,7,0,394,72,26837,30909,26647,2,21,8,1,0,2,0,6,397,76,25361,30073,26653,1,-3,-4,1476,0,836,-6,-1,0,-2,0,1
EUW1_6874335340',4,32,9,2,0,1,0,4,0,381,95,27053,30345,33980,4,26,5,0,0,0,0,7,403,76,24714,29724,23043,1,-22,19,2339,4,621,10937,2,0,1,0,-3
EUW1_6872976973',1,21,8,1,0,0,0,10,0,369,57,25690,28885,30706,3,265,26,0,0,2,0,1,373,118,33298,32679,42965,1,-4,-61,-7608,-18,-3794,-12259,1,0,-2,0,9
EUW1_6871839669',6,27,17,1,1,1,0,7,1,311,83,29276,30266,38982,3,20,16,1,0,1,0,5,343,74,28058,27892,30627,1,-32,9,1218,1,2374,8355,0,1,0,0,2
EUW1_6873380001',1,28,14,0,1,2,0,5,1,362,86,29675,28120,39408,4,27,16,1,0,0,0,7,289,81,26737,28561,34490,0,73,5,2938,-2,-441,4918,-1,1,2,0,-2
EUW1_6870193114',5,40,11,2,0,1,0,9,1,370,94,27417,30975,27478,1,21,1,0,0,0,0,4,319,86,20870,27632,20337,1,51,8,6547,10,3343,7141,2,0,1,0,5
EUW1_6870113148',1,27,9,0,0,0,0,10,0,310,80,24680,27450,31820,4,40,13,2,0,2,0,4,332,86,27708,29775,33464,1,-22,-6,-3028,-4,-2325,-1644,-2,0,-2,0,6
EUW1_6870031072',5,87,14,0,0,0,0,8,0,321,84,26000,28999,28451,5,120,9,2,0,0,0,3,337,85,25869,27860,27335,1,-16,-1,131,5,1139,1116,-2,0,0,0,5
EUW1_6869908830',1,21,16,0,0,1,0,9,0,335,68,27834,28845,32583,3,26,14,2,0,0,0,2,298,112,27726,29096,29937,0,37,-44,108,2,-251,2646,-2,0,1,0,7
EUW1_6869834869',4,26,12,2,0,1,0,7,0,341,108,28077,31473,33771,0,20,14,0,0,0,0,3,323,80,26335,31644,27296,1,18,28,1742,-2,-171,6475,2,0,1,0,4
EUW1_6882857832',1,43,13,0,0,0,0,7,1,359,80,26358,30320,27721,3,35,7,1,0,0,0,3,305,68,23454,24288,31790,1,54,12,2904,6,6032,-4069,-1,0,0,0,4
EUW1_6882056356',1,19,11,0,1,0,0,6,1,370,98,27040,31754,30252,5,40,8,2,0,0,0,4,343,97,24194,28914,23796,1,27,1,2846,3,2840,6456,-2,1,0,0,2
EUW1_6881998058',6,26,12,1,0,0,0,9,0,335,92,26729,29254,28988,3,23,18,0,0,2,0,6,385,80,31152,32153,32964,0,-50,12,-4423,-6,-2899,-3976,1,0,-2,0,3
EUW1_6881901455',2,13,12,0,0,0,0,11,0,315,102,25621,29733,21081,3,27,12,1,1,1,0,1,355,98,27798,30022,36375,1,-40,4,-2177,0,-289,-15294,-1,-1,-1,0,10
EUW1_6881848540',3,27,13,1,0,0,0,13,1,367,70,26747,30041,32081,1,21,9,1,1,1,0,1,412,110,27317,30829,29505,1,-45,-40,-570,4,-788,2576,0,-1,-1,0,12
EUW1_6881779595',6,45,9,0,0,0,0,11,0,336,80,25032,28709,25853,4,47,14,1,0,1,0,1,350,107,29019,30081,27927,0,-14,-27,-3987,-5,-1372,-2074,-1,0,-1,0,10
EUW1_6881688442',4,30,11,2,1,2,0,6,0,353,104,29548,29650,29764,3,48,15,0,0,1,0,10,354,96,28074,29496,28955,1,-1,8,1474,-4,154,809,2,1,1,0,-4
EUW1_6881619227',2,62,11,2,1,0,0,11,1,325,86,26221,27649,27267,2,59,11,0,0,1,0,5,304,86,25516,28286,33020,1,21,0,705,0,-637,-5753,2,1,-1,0,6
EUW1_6881550067',3,23,13,1,0,0,0,12,1,328,75,26031,27655,29368,4,30,18,1,0,2,0,4,358,76,31125,30844,36875,0,-30,-1,-5094,-5,-3189,-7507,0,0,-2,0,8
EUW1_6879647628',1,22,14,0,0,1,0,12,0,360,131,30375,32182,29609,5,34,14,2,0,0,0,4,361,75,27285,32101,32100,1,-1,56,3090,0,81,-2491,-2,0,1,0,8
EUW1_6879614150',4,70,4,0,0,0,0,10,0,317,76,21625,26437,18551,7,29,8,2,0,1,0,0,433,110,28510,31227,25886,0,-116,-34,-6885,-4,-4790,-7335,-2,0,-1,0,10
EUW1_6879358388',3,22,8,0,0,0,0,11,1,343,122,25301,31328,27471,1,22,8,1,0,1,0,3,336,86,25260,29691,30888,1,7,36,41,0,1637,-3417,-1,0,-1,0,8
EUW1_6879355019',2,24,13,1,0,6,0,2,1,411,80,31324,29713,27044,0,18,4,0,0,0,0,13,200,91,19150,20295,15103,1,211,-11,12174,9,9418,11941,1,0,6,0,-11
EUW1_6879341382',7,34,20,0,0,1,0,11,0,308,106,30617,29166,38641,5,29,16,1,1,1,0,2,277,70,28226,28013,27835,1,31,36,2391,4,1153,10806,-1,-1,0,0,9
EUW1_6878588169',2,36,15,1,0,1,0,9,1,341,92,29037,27438,41932,5,50,10,0,0,1,0,6,358,88,27045,29550,31339,1,-17,4,1992,5,-2112,10593,1,0,0,0,3
EUW1_6878541313',5,21,27,2,0,2,0,13,1,419,102,36500,35152,46592,3,31,13,0,0,0,0,4,333,101,28489,29286,35384,1,86,1,8011,14,5866,11208,2,0,2,0,9
EUW1_6878488554',3,24,9,0,0,1,0,14,1,375,84,25274,30426,26258,3,20,5,1,0,1,0,1,374,88,24827,29620,25374,0,1,-4,447,4,806,884,-1,0,0,0,13
EUW1_6878428846',1,33,6,0,0,1,0,11,1,337,86,23927,29381,24582,2,22,11,1,0,1,0,1,378,89,27181,30691,31116,0,-41,-3,-3254,-5,-1310,-6534,-1,0,0,0,10
EUW1_6878362957',3,63,12,1,0,1,0,5,0,394,90,28449,31322,30107,6,72,10,0,0,0,0,5,371,104,26600,29196,26772,1,23,-14,1849,2,2126,3335,1,0,1,0,0
EUW1_6883118158',5,29,11,1,0,0,0,10,1,312,97,25612,27446,31370,3,24,9,1,0,2,0,4,362,86,27233,28966,35370,0,-50,11,-1621,2,-1520,-4000,0,0,-2,0,6
EUW1_6882242598',5,152,13,1,0,1,0,12,1,372,86,28325,29369,32439,1,25,16,1,0,1,0,6,343,86,28935,31521,32810,0,29,0,-610,-3,-2152,-371,0,0,0,0,6
EUW1_6882220555',3,26,18,1,0,1,0,10,0,372,72,31034,32111,40222,2,23,15,1,1,1,0,3,356,110,29475,29524,29553,1,16,-38,1559,3,2587,10669,0,-1,0,0,7
EUW1_6882174059',3,25,11,1,0,1,0,9,0,363,78,27481,29273,35600,7,38,8,1,1,0,0,5,354,94,25999,28504,25145,1,9,-16,1482,3,769,10455,0,-1,1,0,4
EUW1_6882140366',2,18,22,2,0,2,0,9,1,319,90,32510,29510,46348,3,89,9,0,0,0,0,5,314,90,25554,28366,32701,1,5,0,6956,13,1144,13647,2,0,2,0,4
EUW1_6882061795',1,34,22,1,0,0,0,5,0,293,100,29524,30066,47773,1,73,17,0,0,0,0,0,278,66,27396,28820,41319,1,15,34,2128,5,1246,6454,1,0,0,0,5
EUW1_6882018872',6,21,22,0,1,0,0,7,1,320,92,30400,30971,40031,3,29,8,1,0,0,0,5,351,64,25742,26826,34802,1,-31,28,4658,14,4145,5229,-1,1,0,0,2
EUW1_6881949320',6,71,8,1,0,0,0,9,0,365,74,25158,27559,28072,6,35,19,0,0,0,0,0,365,96,29926,31829,36905,0,0,-22,-4768,-11,-4270,-8833,1,0,0,0,9
EUW1_6877816580',3,33,19,0,0,1,0,4,1,383,120,31218,32893,39563,4,61,12,2,0,0,0,4,327,84,26925,30622,31348,1,56,36,4293,7,2271,8215,-2,0,1,0,0
EUW1_6877782024',9,31,11,1,0,0,0,5,0,357,96,26855,29845,28551,4,44,14,1,0,0,0,3,269,75,25312,25733,28151,1,88,21,1543,-3,4112,400,0,0,0,0,2
EUW1_6877748762',3,305,18,1,0,1,0,9,1,362,78,30197,32484,36895,5,60,7,0,0,0,0,2,333,90,23736,27448,29385,1,29,-12,6461,11,5036,7510,1,0,1,0,7
EUW1_6883575052',4,29,10,0,0,1,0,7,1,341,84,27047,28654,29283,4,29,12,1,0,0,0,7,366,91,26308,30342,28287,0,-25,-7,739,-2,-1688,996,-1,0,1,0,0
EUW1_6883542645',6,35,17,1,0,2,0,4,1,364,99,31020,31471,31068,2,91,6,0,0,0,0,9,338,79,24685,28297,23615,1,26,20,6335,11,3174,7453,1,0,2,0,-5
EUW1_6883342066',6,24,18,1,0,1,0,7,1,333,71,27962,28984,31749,5,31,4,0,0,0,0,3,341,92,24026,27336,27432,1,-8,-21,3936,14,1648,4317,1,0,1,0,4
EUW1_6882176087',5,29,9,0,0,0,0,12,0,326,77,25588,27879,27075,4,32,20,1,0,1,0,4,358,88,30979,31851,33644,0,-32,-11,-5391,-11,-3972,-6569,-1,0,-1,0,8
EUW1_6882141250',7,32,22,1,1,0,0,12,1,341,93,31393,30014,44084,0,26,13,1,0,1,0,2,312,86,26058,28309,30785,0,29,7,5335,9,1705,13299,0,1,-1,0,10
EUW1_6882052360',11,35,12,2,0,0,0,2,1,348,79,26290,28358,26707,3,20,16,0,0,0,0,4,349,84,28566,29932,36292,0,-1,-5,-2276,-4,-1574,-9585,2,0,0,0,-2
EUW1_6881993609',1,35,9,0,0,0,0,8,1,362,86,25223,30592,32236,3,34,7,1,0,1,0,2,307,86,24444,29132,26166,0,55,0,779,2,1460,6070,-1,0,-1,0,6
EUW1_6880654555',2,71,12,0,0,1,0,10,1,357,76,27361,30352,32507,1,147,15,2,0,1,0,5,358,120,29337,32213,38450,1,-1,-44,-1976,-3,-1861,-5943,-2,0,0,0,5
EUW1_6880607593',4,17,21,0,0,0,0,11,1,337,79,30497,28603,38001,1,25,19,2,0,2,0,2,300,72,30700,29339,38152,0,37,7,-203,2,-736,-151,-2,0,-2,0,9
EUW1_6839762970',1,54,8,1,0,0,0,5,1,343,78,24941,28571,29523,3,27,12,0,1,0,0,3,301,69,23652,28913,29577,1,42,9,1289,-4,-342,-54,1,-1,0,0,2
EUW1_6839725584',4,28,14,1,0,4,0,7,0,398,84,31279,30697,43129,3,24,8,1,0,0,0,6,335,72,25400,26869,30634,1,63,12,5879,6,3828,12495,0,0,4,0,1
EUW1_6839665323',3,37,11,2,0,1,0,10,0,323,78,27497,27541,36412,3,26,16,0,0,2,0,6,298,58,27588,27144,37834,0,25,20,-91,-5,397,-1422,2,0,-1,0,4
EUW1_6839625333',6,23,20,1,0,3,0,7,1,356,95,31510,31625,39282,6,33,7,0,0,0,0,7,293,80,24266,25793,34207,1,63,15,7244,13,5832,5075,1,0,3,0,0
EUW1_6839577459',5,153,14,1,0,0,0,10,0,357,84,28124,30874,40774,4,25,10,1,0,1,0,2,349,84,27622,29195,29908,1,8,0,502,4,1679,10866,0,0,-1,0,8
EUW1_6836288006',3,24,5,2,0,0,0,9,0,333,88,22505,26891,22566,2,52,13,0,0,3,0,2,395,91,29611,31659,30946,0,-62,-3,-7106,-8,-4768,-8380,2,0,-3,0,7
EUW1_6836215839',2,18,16,1,1,2,0,7,1,364,92,30906,30720,29990,7,31,10,0,0,0,0,9,301,76,25528,27652,35523,1,63,16,5378,6,3068,-5533,1,1,2,0,-2
EUW1_6832976687',3,27,21,2,0,1,0,13,1,316,90,30655,30405,29876,3,21,10,0,0,2,0,6,369,83,28699,31521,27528,1,-53,7,1956,11,-1116,2348,2,0,-1,0,7
EUW1_6883597311',2,21,18,0,0,0,0,14,1,343,38,27788,27418,32548,7,32,15,1,0,2,0,3,334,86,30682,29640,35554,0,9,-48,-2894,3,-2222,-3006,-1,0,-2,0,11
EUW1_6883570958',5,25,13,2,0,1,0,10,0,305,85,26430,27888,24172,2,25,16,0,0,3,0,4,360,78,30138,31052,35123,1,-55,7,-3708,-3,-3164,-10951,2,0,-2,0,6
EUW1_6883522351',6,44,8,0,0,0,0,12,1,306,76,23691,25643,27437,3,32,18,2,0,2,0,0,391,82,31003,31257,31977,0,-85,-6,-7312,-10,-5614,-4540,-2,0,-2,0,12
EUW1_6883368775',3,26,16,2,0,1,0,6,0,382,93,31471,31346,35422,1,46,16,0,0,0,0,6,325,76,27900,28712,33050,0,57,17,3571,0,2634,2372,2,0,1,0,0
EUW1_6882258420',3,22,20,1,0,4,0,8,0,362,97,34059,33553,41842,6,21,11,1,0,0,0,11,306,78,27031,28690,27779,1,56,19,7028,9,4863,14063,0,0,4,0,-3
EUW1_6882148396',3,66,6,1,0,0,0,9,1,373,108,24998,30826,24325,4,28,16,1,0,1,0,2,367,90,29266,33789,31265,0,6,18,-4268,-10,-2963,-6940,0,0,-1,0,7
EUW1_6880772899',2,24,10,0,0,1,0,9,0,336,89,26712,28093,36230,3,43,17,1,0,1,0,7,338,93,28975,30514,35273,0,-2,-4,-2263,-7,-2421,957,-1,0,0,0,2
EUW1_6880742304',3,27,9,1,0,1,0,12,1,337,80,27618,27954,27083,4,45,17,1,0,1,0,5,384,103,30101,33112,31886,0,-47,-23,-2483,-8,-5158,-4803,0,0,0,0,7
EUW1_6880723073',3,21,7,1,0,0,0,10,0,350,78,24069,29227,26092,2,45,11,1,0,0,0,2,362,90,27197,30267,26115,0,-12,-12,-3128,-4,-1040,-23,0,0,0,0,8
EUW1_6880705784',6,26,7,2,0,1,0,8,0,368,98,27114,28331,23644,4,25,13,0,0,1,0,6,376,106,29132,32229,31877,0,-8,-8,-2018,-6,-3898,-8233,2,0,0,0,2
EUW1_6880632576',5,24,11,1,0,1,0,7,0,361,93,27025,29731,30058,4,31,11,1,0,0,0,6,362,81,27337,29003,27671,1,-1,12,-312,0,728,2387,0,0,1,0,1
EUW1_6880578307',5,25,5,0,0,0,0,11,0,351,102,23798,29235,23647,0,86,11,1,0,2,0,0,361,64,27842,29323,26581,0,-10,38,-4044,-6,-88,-2934,-1,0,-2,0,11
EUW1_6880527784',2,59,16,0,0,0,0,8,1,298,66,28979,28751,39243,5,65,15,1,0,1,0,1,322,69,27191,26707,43792,1,-24,-3,1788,1,2044,-4549,-1,0,-1,0,7
EUW1_6879335342',6,79,17,2,0,0,0,6,1,281,86,27703,28861,38149,1,31,12,0,0,0,0,5,296,76,25868,28096,30054,1,-15,10,1835,5,765,8095,2,0,0,0,1
EUW1_6879330224',5,32,19,2,1,4,0,8,0,400,81,32215,32430,44012,1,26,10,0,0,1,0,10,315,110,27232,29220,28103,1,85,-29,4983,9,3210,15909,2,1,3,0,-2
EUW1_6879318180',4,286,10,0,0,0,0,7,1,350,72,26051,29228,30582,3,29,10,2,0,0,0,5,323,82,24324,28083,26286,1,27,-10,1727,0,1145,4296,-2,0,0,0,2
EUW1_6879300743',2,22,22,1,0,0,0,13,1,345,96,31502,31654,35708,5,144,16,1,1,1,0,3,335,99,29395,29565,33177,1,10,-3,2107,6,2089,2531,0,-1,-1,0,10
EUW1_6883622523',2,59,14,2,0,0,0,8,1,294,96,27381,29704,31462,3,58,17,0,0,1,0,4,341,74,28081,29232,33544,0,-47,22,-700,-3,472,-2082,2,0,-1,0,4
EUW1_6883413215',7,28,11,0,0,0,0,9,0,322,83,25841,28492,29161,0,34,17,2,0,1,0,1,359,84,29852,30242,45572,0,-37,-1,-4011,-6,-1750,-16411,-2,0,-1,0,8
EUW1_6883263675',7,29,7,1,0,2,0,9,0,394,75,26771,29331,21869,1,46,8,0,0,1,0,8,343,116,25363,30012,22493,0,51,-41,1408,-1,-681,-624,1,0,1,0,1
EUW1_6883210584',7,41,14,2,1,0,0,6,1,407,98,29644,32687,30326,7,32,7,0,0,2,0,5,308,89,24583,27757,29160,1,99,9,5061,7,4930,1166,2,1,-2,0,1
EUW1_6882788576',7,30,16,2,0,0,0,10,0,349,81,28835,30441,34567,7,30,12,0,1,1,0,4,319,80,28136,28353,35007,1,30,1,699,4,2088,-440,2,-1,-1,0,6
EUW1_6882742500',4,39,14,2,0,0,0,6,1,365,88,27515,30153,42046,4,27,13,0,0,0,0,6,349,60,26927,29688,30193,0,16,28,588,1,465,11853,2,0,0,0,0
EUW1_6882176364',7,205,15,1,0,1,0,11,0,315,70,27999,28211,33961,3,29,18,1,0,2,0,4,352,96,29395,29645,37435,0,-37,-26,-1396,-3,-1434,-3474,0,0,-1,0,7
EUW1_6882151618',6,27,11,0,0,0,0,7,0,331,88,26200,29531,27510,5,32,12,2,0,1,0,5,372,104,27005,31170,26932,0,-41,-16,-805,-1,-1639,578,-2,0,-1,0,2
EUW1_6879005775',3,20,7,1,0,0,0,11,0,289,84,23510,27147,25754,4,28,26,1,1,2,0,1,387,102,33689,35614,38444,0,-98,-18,-10179,-19,-8467,-12690,0,-1,-2,0,10
EUW1_6878942392',4,27,17,0,0,0,0,7,1,343,112,29661,31294,32795,6,31,9,2,0,0,0,1,324,88,25101,28381,24016,1,19,24,4560,8,2913,8779,-2,0,0,0,6
EUW1_6878894757',3,30,7,1,0,0,0,11,1,378,86,25784,29364,26286,4,35,10,1,0,2,0,7,355,96,28515,31746,32037,0,23,-10,-2731,-3,-2382,-5751,0,0,-2,0,4
EUW1_6878403364',3,30,8,0,0,2,0,9,1,366,100,27033,28440,32136,6,25,9,2,0,0,0,5,360,84,24797,29077,25518,1,6,16,2236,-1,-637,6618,-2,0,2,0,4
EUW1_6878353283',3,31,20,1,0,1,0,9,0,348,94,31305,29865,35395,1,26,19,1,0,2,0,5,332,70,32112,28494,38767,0,16,24,-807,1,1371,-3372,0,0,-1,0,4
EUW1_6877672263',5,24,13,0,0,1,0,5,1,345,88,28230,28618,24398,3,43,8,1,0,0,0,6,313,68,23641,27703,26059,0,32,20,4589,5,915,-1661,-1,0,1,0,-1
EUW1_6877102726',3,25,22,1,0,1,0,4,1,386,68,31905,31151,32850,4,29,10,0,0,1,0,5,375,84,26565,29506,32382,1,11,-16,5340,12,1645,468,1,0,0,0,-1
EUW1_6875830327',4,134,6,1,0,0,0,6,0,375,96,23926,30636,25094,6,29,9,1,0,1,0,0,426,76,27330,32084,29997,0,-51,20,-3404,-3,-1448,-4903,0,0,-1,0,6
EUW1_6875748010',3,42,10,0,0,0,0,8,0,308,82,24761,26644,31666,6,152,18,1,0,1,0,0,339,94,30286,29169,34867,1,-31,-12,-5525,-8,-2525,-3201,-1,0,-1,0,8
EUW1_6874099885',5,26,13,2,0,1,0,4,0,342,86,28772,28692,31385,6,33,11,0,1,1,0,9,342,86,25846,29279,26937,1,0,0,2926,2,-587,4448,2,-1,0,0,-5
EUW1_6874048302',2,25,12,0,1,1,0,3,1,378,88,29255,31044,29225,3,90,7,1,0,0,0,7,310,91,23122,27795,31085,0,68,-3,6133,5,3249,-1860,-1,1,1,0,-4
EUW1_6882173707',2,29,12,0,0,0,0,8,0,292,85,27341,26973,30671,2,29,10,0,0,1,0,3,380,80,26877,28593,32838,1,-88,5,464,2,-1620,-2167,0,0,-1,0,5
EUW1_6882149647',8,69,4,0,0,0,0,13,1,270,86,20965,24649,24260,8,53,23,1,0,2,0,0,367,98,33539,32528,44637,0,-97,-12,-12574,-19,-7879,-20377,-1,0,-2,0,13
EUW1_6882058895',5,27,14,0,1,0,0,11,0,301,73,27011,26679,32372,2,61,18,1,0,2,0,4,346,73,30336,28581,39733,0,-45,0,-3325,-4,-1902,-7361,-1,1,-2,0,7
EUW1_6881622378',0,22,13,0,0,0,0,15,0,299,106,27580,28657,38914,3,49,24,2,1,4,0,2,369,84,34324,33123,43209,1,-70,22,-6744,-11,-4466,-4295,-2,-1,-4,0,13
EUW1_6881587653',7,26,20,1,0,3,0,5,1,408,75,33506,32761,41457,6,30,11,0,0,0,0,8,270,68,25193,27678,29245,1,138,7,8313,9,5083,12212,1,0,3,0,-3
EUW1_6875403744',4,26,13,1,0,0,0,6,1,345,80,27334,28631,33729,4,27,16,1,0,0,0,5,346,88,29126,31320,37414,1,-1,-8,-1792,-3,-2689,-3685,0,0,0,0,1
EUW1_6875363140',5,30,15,0,0,1,0,12,1,360,102,30183,31821,31543,2,25,9,2,0,1,0,4,387,86,28165,28793,28230,1,-27,16,2018,6,3028,3313,-2,0,0,0,8
EUW1_6869231389',3,23,12,1,0,2,0,4,0,387,80,28562,28869,34371,2,42,11,0,0,0,0,7,323,76,25520,27913,25250,1,64,4,3042,1,956,9121,1,0,2,0,-3
EUW1_6869210828',2,40,10,1,0,0,0,13,0,315,79,25427,26348,27118,5,24,15,1,0,2,0,1,374,106,30289,31916,28971,1,-59,-27,-4862,-5,-5568,-1853,0,0,-2,0,12
EUW1_6869196710',3,21,20,1,0,3,0,8,0,372,107,33371,33695,40915,2,31,8,1,0,0,0,9,294,70,23469,26357,34967,1,78,37,9902,12,7338,5948,0,0,3,0,-1
EUW1_6869164888',5,26,17,2,0,3,0,12,1,334,80,31859,30834,33100,1,18,9,0,0,3,0,13,337,87,28134,28402,29731,1,-3,-7,3725,8,2432,3369,2,0,0,0,-1
EUW1_6869128854',1,40,14,2,0,1,0,9,1,354,88,27180,30589,30847,2,23,13,0,0,2,0,2,363,88,29602,30068,37756,1,-9,0,-2422,1,521,-6909,2,0,-1,0,7
EUW1_6867001903',6,28,15,0,0,0,0,8,1,328,90,28035,30527,33303,4,26,18,1,0,1,0,2,311,65,27715,26935,43321,0,17,25,320,-3,3592,-10018,-1,0,-1,0,6
EUW1_6866947089',2,20,14,1,0,0,0,11,0,297,60,27083,28074,26527,3,21,13,0,0,1,0,3,377,88,28522,29280,33178,0,-80,-28,-1439,1,-1206,-6651,1,0,-1,0,8
EUW1_6866895384',1,26,16,2,0,1,0,6,0,390,112,29805,35562,34373,6,27,8,0,0,0,0,6,340,75,25424,30725,34179,1,50,37,4381,8,4837,194,2,0,1,0,0
EUW1_6866855852',4,26,20,2,0,1,0,11,1,317,74,31466,29186,44338,2,17,13,0,0,3,0,6,302,90,29168,28710,35381,1,15,-16,2298,7,476,8957,2,0,-2,0,5
EUW1_6866436194',4,25,15,1,0,1,0,12,1,326,74,29050,28921,31074,5,26,6,0,0,1,0,6,328,85,23477,27999,27711,1,-2,-11,5573,9,922,3363,1,0,0,0,6
EUW1_6866404097',2,23,11,0,0,0,0,9,1,313,94,25197,28505,28566,1,15,16,2,0,2,0,2,364,82,29799,32398,39522,0,-51,12,-4602,-5,-3893,-10956,-2,0,-2,0,7
EUW1_6866371359',4,22,7,0,0,0,0,8,0,356,64,23492,26621,24111,2,22,27,2,0,1,0,2,372,100,32698,32819,39880,0,-16,-36,-9206,-20,-6198,-15769,-2,0,-1,0,6
EUW1_6883622847',0,18,12,0,0,0,0,13,1,295,64,26848,26942,35463,5,29,18,2,0,2,0,2,357,104,32042,30981,42425,0,-62,-40,-5194,-6,-4039,-6962,-2,0,-2,0,11
EUW1_6883592798',6,27,24,0,0,0,0,4,0,328,86,33624,33201,44289,2,88,14,1,0,2,0,5,307,62,26632,27083,37403,1,21,24,6992,10,6118,6886,-1,0,-2,0,-1
EUW1_6883565098',3,28,13,2,1,2,0,5,0,337,104,28701,30092,27635,3,25,11,0,0,0,0,6,304,56,25224,27174,29941,1,33,48,3477,2,2918,-2306,2,1,2,0,-1
EUW1_6883550491',6,30,14,1,0,1,0,13,0,297,54,28028,29112,28728,3,23,24,0,0,3,0,1,348,101,35109,33130,41077,0,-51,-47,-7081,-10,-4018,-12349,1,0,-2,0,12
EUW1_6883430309',2,20,10,0,0,0,0,13,0,302,85,24742,25778,30686,1,16,15,2,0,1,0,1,402,104,30271,33024,33834,0,-100,-19,-5529,-5,-7246,-3148,-2,0,-1,0,12
EUW1_6883374475',3,27,16,0,0,0,0,7,0,276,47,26836,25734,43032,4,28,26,2,0,1,0,0,315,72,32101,29661,39887,0,-39,-25,-5265,-10,-3927,3145,-2,0,-1,0,7
EUW1_6883214953',4,72,8,0,0,0,0,13,0,333,92,24472,29708,25952,3,28,13,1,0,2,0,1,375,102,29300,31343,25850,0,-42,-10,-4828,-5,-1635,102,-1,0,-2,0,12
EUW1_6883026168',1,25,9,0,0,0,0,11,0,355,70,26117,28190,27271,4,27,24,2,0,1,0,4,361,110,32308,32952,42595,0,-6,-40,-6191,-15,-4762,-15324,-2,0,-1,0,7
EUW1_6882973987',4,29,13,0,0,0,0,9,1,370,90,28369,29222,40350,1,23,17,2,0,0,0,5,314,100,28765,31685,32518,1,56,-10,-396,-4,-2463,7832,-2,0,0,0,4
EUW1_6882319834',4,21,14,2,1,0,0,6,0,330,60,27515,27994,30148,6,28,13,0,0,1,0,2,358,96,27912,29150,36187,0,-28,-36,-397,1,-1156,-6039,2,1,-1,0,4
EUW1_6882298324',5,21,15,1,0,0,0,10,0,349,84,27950,30425,38974,8,35,12,1,0,0,0,4,328,100,27723,29121,31635,0,21,-16,227,3,1304,7339,0,0,0,0,6
EUW1_6882287987',3,25,9,1,0,1,0,7,1,339,85,26366,28851,31436,5,23,8,0,0,0,0,6,340,75,24636,27621,24472,1,-1,10,1730,1,1230,6964,1,0,1,0,1
EUW1_6882274651',4,34,10,1,0,0,0,9,1,329,100,26084,28854,29242,4,66,14,1,0,1,0,1,359,60,27757,28358,37697,0,-30,40,-1673,-4,496,-8455,0,0,-1,0,8
EUW1_6882248823',1,26,21,2,0,3,0,8,1,351,80,33904,32954,46126,1,32,19,0,0,0,0,10,270,82,27738,28846,31305,1,81,-2,6166,2,4108,14821,2,0,3,0,-2
EUW1_6882232706',3,26,10,0,0,0,0,8,1,342,76,26354,26218,31556,5,29,12,1,0,2,0,5,342,80,27670,30109,27416,0,0,-4,-1316,-2,-3891,4140,-1,0,-2,0,3
EUW1_6882211151',5,27,19,2,0,2,0,12,1,358,84,30555,30750,36081,3,25,9,0,0,1,0,5,346,83,25613,28193,17835,1,12,1,4942,10,2557,18246,2,0,1,0,7
EUW1_6883801461',8,74,15,1,0,1,0,7,1,357,95,29109,31595,32158,6,30,11,1,0,0,0,4,322,80,24489,29243,28215,1,35,15,4620,4,2352,3943,0,0,1,0,3
EUW1_6882114485',4,26,15,1,0,0,0,12,1,337,80,27036,30115,35206,6,28,13,1,0,1,0,5,366,103,29362,30935,30759,0,-29,-23,-2326,2,-820,4447,0,0,-1,0,7
EUW1_6882020851',2,202,12,2,0,2,0,9,1,338,112,29270,29722,27418,4,29,7,0,0,1,0,10,313,73,24411,26938,21619,1,25,39,4859,5,2784,5799,2,0,1,0,-1
EUW1_6881959754',6,31,10,1,0,0,0,5,0,337,62,24838,27658,29925,7,32,19,1,0,0,0,2,323,102,30078,30687,35180,0,14,-40,-5240,-9,-3029,-5255,0,0,0,0,3
EUW1_6881284944',5,25,18,0,0,1,0,8,1,357,82,30308,30290,30479,3,31,10,1,0,2,0,7,312,90,25817,26802,27524,1,45,-8,4491,8,3488,2955,-1,0,-1,0,1
EUW1_6877610377',3,27,10,2,0,0,0,8,0,332,69,25924,27747,28965,4,24,13,0,0,1,0,2,344,95,28476,28518,29612,1,-12,-26,-2552,-3,-771,-647,2,0,-1,0,6
EUW1_6883499226',7,27,11,0,0,0,0,6,0,356,79,26486,27965,30075,5,24,11,0,0,0,0,3,332,81,25247,29381,23808,1,24,-2,1239,0,-1416,6267,0,0,0,0,3
EUW1_6883465750',4,20,9,0,0,0,0,11,0,269,66,23708,26505,21623,6,26,21,1,0,1,0,0,407,93,30614,33199,32658,0,-138,-27,-6906,-12,-6694,-11035,-1,0,-1,0,11
EUW1_6883396903',5,125,9,0,0,0,0,5,1,365,66,24936,29634,23737,3,23,8,1,0,0,0,2,351,104,24840,29136,25103,0,14,-38,96,1,498,-1366,-1,0,0,0,3
EUW1_6881395647',7,24,8,1,0,0,0,7,0,356,81,25291,27099,33764,5,25,14,0,0,0,0,4,312,81,26616,28325,32918,1,44,0,-1325,-6,-1226,846,1,0,0,0,3
EUW1_6881332949',5,29,11,2,0,1,0,11,0,351,92,26558,29404,28735,6,32,18,0,0,1,0,1,375,84,30968,30387,30284,0,-24,8,-4410,-7,-983,-1549,2,0,0,0,10
EUW1_6878013097',5,36,9,0,0,0,0,6,1,367,86,26543,29993,23374,8,28,6,2,0,1,0,5,400,109,26075,29262,22583,1,-33,-23,468,3,731,791,-2,0,-1,0,1
EUW1_6877999747',5,30,22,1,0,3,0,9,1,377,85,34778,33727,37019,2,27,6,0,0,0,0,10,310,94,23969,26898,26575,1,67,-9,10809,16,6829,10444,1,0,3,0,-1
EUW1_6877745129',5,43,6,0,0,0,0,12,1,318,80,23895,27851,24825,0,24,15,1,1,2,0,1,363,87,29617,31502,29096,0,-45,-7,-5722,-9,-3651,-4271,-1,-1,-2,0,11
EUW1_6877717670',2,67,5,0,0,0,0,8,0,354,71,22888,26478,25189,11,34,22,2,0,1,0,2,374,102,31863,34027,43468,0,-20,-31,-8975,-17,-7549,-18279,-2,0,-1,0,6
EUW1_6877595533',3,28,10,0,0,1,0,6,1,374,77,27167,28994,24961,3,31,7,1,0,0,0,3,322,82,23357,27142,26072,1,52,-5,3810,3,1852,-1111,-1,0,1,0,3
EUW1_6877430973',2,28,31,1,0,1,0,14,1,337,106,36332,32952,42979,2,36,13,0,0,2,0,3,287,62,27516,28559,35339,1,50,44,8816,18,4393,7640,1,0,-1,0,11
EUW1_6876788014',3,28,10,2,0,0,0,8,1,382,108,26763,31596,23344,0,16,4,0,1,0,0,3,365,90,24162,29561,23093,1,17,18,2601,6,2035,251,2,-1,0,0,5
EUW1_6876690630',5,35,9,1,0,1,0,2,1,360,96,27185,30585,32075,1,25,4,1,0,1,0,2,357,88,23028,27858,26015,1,3,8,4157,5,2727,6060,0,0,0,0,0
EUW1_6876650840',6,24,17,1,0,1,0,5,1,349,106,29659,32384,35146,7,154,12,1,0,0,0,6,400,86,27401,30880,31831,1,-51,20,2258,5,1504,3315,0,0,1,0,-1
EUW1_6876616654',4,88,11,0,0,1,0,8,1,386,84,29203,30050,32818,2,23,9,1,0,1,0,2,365,104,27183,28803,27535,0,21,-20,2020,2,1247,5283,-1,0,0,0,6
EUW1_6876585575',5,31,7,0,0,0,0,9,0,352,96,24026,29895,27348,2,31,9,1,0,0,0,1,379,88,25625,30701,31200,0,-27,8,-1599,-2,-806,-3852,-1,0,0,0,8
EUW1_6876560568',3,27,10,1,0,0,0,7,0,331,124,27971,29993,31144,6,27,9,1,0,1,0,6,329,80,24191,27770,20565,1,2,44,3780,1,2223,10579,0,0,-1,0,1
EUW1_6883757588',1,22,11,1,0,0,0,9,0,324,82,25872,26303,38312,3,34,13,0,0,0,0,6,303,86,26400,27360,35893,0,21,-4,-528,-2,-1057,2419,1,0,0,0,3
EUW1_6883730109',1,18,12,2,0,2,0,9,0,375,101,29035,31939,34143,4,22,9,0,0,2,0,10,334,77,25177,27071,25689,1,41,24,3858,3,4868,8454,2,0,0,0,-1
EUW1_6883718951',5,26,8,1,0,1,0,15,0,310,82,24942,28813,27301,3,34,13,0,0,2,0,0,364,98,27906,31066,37370,1,-54,-16,-2964,-5,-2253,-10069,1,0,-1,0,15
EUW1_6883706187',4,53,6,1,1,0,0,13,0,327,96,24269,29259,29227,5,27,12,1,0,3,0,2,365,91,28129,30275,27799,0,-38,5,-3860,-6,-1016,1428,0,1,-3,0,11
EUW1_6883673835',3,25,27,2,0,4,0,5,1,392,98,35485,34800,47412,0,33,6,0,0,0,0,12,324,64,22983,26205,20215,1,68,34,12502,21,8595,27197,2,0,4,0,-7
EUW1_6883653094',1,21,10,2,0,0,0,7,0,319,78,24851,26902,28224,0,23,14,0,0,1,0,2,374,86,28712,31043,38566,0,-55,-8,-3861,-4,-4141,-10342,2,0,-1,0,5
EUW1_6883633462',2,19,7,0,0,1,0,6,1,327,82,24367,26462,27037,4,22,15,1,1,1,0,0,323,90,26676,28844,32102,1,4,-8,-2309,-8,-2382,-5065,-1,-1,0,0,6
EUW1_6883605861',4,30,13,0,0,2,0,8,1,357,107,28340,31177,30086,4,23,9,2,0,1,0,5,345,79,25685,30088,22658,1,12,28,2655,4,1089,7428,-2,0,1,0,3
EUW1_6883565352',0,29,13,0,0,0,0,4,1,344,65,26997,27711,30703,4,24,16,2,0,0,0,4,300,78,27458,27359,27339,1,44,-13,-461,-3,352,3364,-2,0,0,0,0
EUW1_6883379717',2,55,9,0,0,1,0,9,1,357,76,26067,27876,28456,2,39,12,0,0,1,0,3,359,79,27766,30026,29186,0,-2,-3,-1699,-3,-2150,-730,0,0,0,0,6
EUW1_6882542159',1,87,19,1,0,1,0,4,1,387,100,31214,32934,40468,3,21,5,0,0,0,0,5,366,90,24011,27677,24358,1,21,10,7203,14,5257,16110,1,0,1,0,-1
EUW1_6882514845',2,38,21,2,0,0,0,11,0,302,88,29027,29008,36972,5,30,16,0,0,0,0,3,355,84,30344,29997,30602,1,-53,4,-1317,5,-989,6370,2,0,0,0,8
EUW1_6882499713',2,21,0,1,0,0,0,12,0,322,88,20217,26077,15821,4,24,6,0,0,3,0,1,413,108,28291,30645,21865,0,-91,-20,-8074,-6,-4568,-6044,1,0,-3,0,11
EUW1_6882453295',5,99,12,0,0,0,0,10,1,324,75,24940,27645,36854,3,26,11,2,0,1,0,1,377,80,28609,29805,34241,1,-53,-5,-3669,1,-2160,2613,-2,0,-1,0,9
EUW1_6882435433',3,22,16,1,0,1,0,14,1,351,78,29343,30614,36969,3,30,13,1,1,1,0,1,355,109,29700,29186,39340,0,-4,-31,-357,3,1428,-2371,0,-1,0,0,13
EUW1_6882415422',7,168,19,0,0,0,0,8,1,344,88,29588,30301,36458,3,23,15,1,0,0,0,4,324,92,28284,29246,34295,1,20,-4,1304,4,1055,2163,-1,0,0,0,4
EUW1_6882402132',4,32,18,2,1,1,0,6,1,364,104,31873,32348,36411,0,21,7,0,0,0,0,8,305,84,25246,27630,27618,1,59,20,6627,11,4718,8793,2,1,1,0,-2
EUW1_6882389704',0,22,9,0,0,0,0,7,0,307,86,24812,28282,31374,6,123,14,0,0,2,0,4,360,73,28418,31377,34147,0,-53,13,-3606,-5,-3095,-2773,0,0,-2,0,3
EUW1_6882368980',1,19,18,2,0,0,0,14,0,362,96,28975,32302,34819,2,25,11,0,0,4,0,4,334,100,29590,30330,33396,0,28,-4,-615,7,1972,1423,2,0,-4,0,10
EUW1_6882363587',2,93,10,0,0,1,0,7,0,313,72,26260,28509,26278,2,30,11,1,0,0,0,5,337,96,25776,29732,32909,1,-24,-24,484,-1,-1223,-6631,-1,0,1,0,2
EUW1_6883545717',5,30,1,0,0,0,0,9,1,311,78,20515,25374,22029,1,91,13,2,1,1,0,1,368,118,28260,32119,27471,0,-57,-40,-7745,-12,-6745,-5442,-2,-1,-1,0,8
EUW1_6883496260',4,26,10,2,0,2,0,6,1,355,94,27278,30589,22595,0,138,6,0,0,1,0,6,360,96,24334,30022,21230,1,-5,-2,2944,4,567,1365,2,0,1,0,0
EUW1_6883455984',2,27,8,1,0,1,0,13,1,324,92,25897,27015,28071,2,20,17,1,0,0,0,3,348,99,29256,32166,34412,0,-24,-7,-3359,-9,-5151,-6341,0,0,1,0,10
EUW1_6883402752',4,24,13,1,0,1,0,13,0,315,96,28459,30257,30168,5,24,21,1,0,1,0,4,368,72,30489,31667,33468,0,-53,24,-2030,-8,-1410,-3300,0,0,0,0,9
EUW1_6882162606',4,30,22,1,1,1,0,10,1,300,71,31223,28973,38133,4,27,12,0,0,2,0,7,306,89,28532,28022,36155,1,-6,-18,2691,10,951,1978,1,1,-1,0,3
EUW1_6882109954',3,27,11,2,0,1,0,8,0,356,92,27668,31271,32071,0,24,12,0,1,0,0,4,360,104,27297,30940,27867,1,-4,-12,371,-1,331,4204,2,-1,1,0,4
EUW1_6880648194',4,277,14,0,0,2,0,6,0,324,114,31392,31066,30247,3,37,24,2,0,0,0,6,341,73,31506,31608,40349,0,-17,41,-114,-10,-542,-10102,-2,0,2,0,0
EUW1_6880608009',2,25,16,1,0,2,0,6,1,349,96,30290,31183,39270,7,29,16,0,0,0,0,12,344,80,29096,32004,43516,0,5,16,1194,0,-821,-4246,1,0,2,0,-6
EUW1_6866078078',5,32,10,0,0,1,0,7,1,364,104,28147,29082,26465,5,45,12,1,0,1,0,5,324,82,26899,29107,26322,1,40,22,1248,-2,-25,143,-1,0,0,0,2
EUW1_6866029331',4,26,21,0,0,1,0,8,1,351,83,30452,31325,41392,2,16,6,1,1,0,0,9,356,88,24818,27478,28495,0,-5,-5,5634,15,3847,12897,-1,-1,1,0,-1
EUW1_6865994564',2,76,9,1,0,0,0,6,1,347,95,25676,29636,26440,3,29,11,1,1,0,0,1,384,80,26727,30655,29080,0,-37,15,-1051,-2,-1019,-2640,0,-1,0,0,5
EUW1_6862845948',3,35,16,1,1,0,0,6,0,364,112,30262,31313,31755,5,28,9,0,0,1,0,6,325,96,25281,28152,20897,1,39,16,4981,7,3161,10858,1,1,-1,0,0
EUW1_6862775815',4,83,13,1,0,1,0,8,0,331,72,26898,28857,35411,6,31,12,0,0,0,0,2,339,82,27237,29909,31748,1,-8,-10,-339,1,-1052,3663,1,0,1,0,6
EUW1_6862690167',5,32,11,1,0,0,0,8,1,362,64,26443,29516,28283,2,30,10,1,0,1,0,0,363,112,27770,30584,33132,0,-1,-48,-1327,1,-1068,-4849,0,0,-1,0,8
EUW1_6861984164',1,26,20,1,0,0,0,11,1,370,111,30031,32493,38794,3,26,17,0,0,1,0,1,365,65,29943,31412,30841,1,5,46,88,3,1081,7953,1,0,-1,0,10
EUW1_6861980512',2,25,16,1,0,2,0,8,1,320,100,29174,30515,33297,5,25,11,0,0,0,0,7,306,76,25161,26688,32230,1,14,24,4013,5,3827,1067,1,0,2,0,1
EUW1_6861956905',2,60,12,1,0,0,0,12,0,272,91,25097,26489,31870,3,28,12,0,0,1,0,5,329,82,27133,27879,24507,0,-57,9,-2036,0,-1390,7363,1,0,-1,0,7
EUW1_6860659573',3,30,13,1,1,0,0,7,0,323,60,27365,28548,34716,7,28,14,1,0,0,0,4,323,92,27535,29729,32533,0,0,-32,-170,-1,-1181,2183,0,1,0,0,3
EUW1_6882955767',5,34,3,2,0,0,0,14,0,323,83,21652,26429,14589,4,378,9,0,1,3,0,0,357,106,27592,31085,25703,0,-34,-23,-5940,-6,-4656,-11114,2,-1,-3,0,14
EUW1_6882842386',5,26,19,0,0,0,0,6,1,342,109,30011,32294,36507,6,151,16,2,0,0,0,4,310,97,28568,29089,43363,1,32,12,1443,3,3205,-6856,-2,0,0,0,2
EUW1_6882769009',3,26,12,1,0,1,0,8,0,370,74,28494,29719,36594,4,320,16,0,0,1,0,6,283,82,26707,26986,36038,1,87,-8,1787,-4,2733,556,1,0,0,0,2
EUW1_6882744022',7,30,4,0,0,0,0,13,0,368,98,22886,27731,25968,2,28,16,1,1,1,0,0,376,82,29478,32846,29926,0,-8,16,-6592,-12,-5115,-3958,-1,-1,-1,0,13
EUW1_6882707972',4,27,18,0,1,2,0,7,1,341,76,30198,30124,41047,2,18,12,1,0,0,0,5,306,82,25873,28690,27775,0,35,-6,4325,6,1434,13272,-1,1,2,0,2
EUW1_6882651600',2,42,6,1,0,0,0,1,0,404,89,24866,31009,21609,7,46,7,1,0,0,0,4,347,94,24251,29194,24444,1,57,-5,615,-1,1815,-2835,0,0,0,0,-3
EUW1_6882608439',1,33,5,1,0,0,0,7,1,382,76,23760,29134,26636,5,47,11,1,0,0,0,4,351,107,26583,31334,30127,0,31,-31,-2823,-6,-2200,-3491,0,0,0,0,3
EUW1_6882579868',7,35,10,0,0,1,0,11,1,312,83,25476,28193,29968,3,23,16,1,1,2,0,2,345,88,29079,29074,30207,0,-33,-5,-3603,-6,-881,-239,-1,-1,-1,0,9
EUW1_6882546352',2,20,13,1,0,2,0,8,0,333,104,29252,30354,34061,4,20,10,1,0,1,0,6,335,68,26519,27600,30742,1,-2,36,2733,3,2754,3319,0,0,1,0,2
EUW1_6882518197',2,29,14,1,0,1,0,10,0,331,70,28617,28964,33934,0,20,12,0,0,1,0,3,378,92,28325,29911,31773,0,-47,-22,292,2,-947,2161,1,0,0,0,7
EUW1_6882263020',3,21,13,1,0,0,0,10,1,416,81,29564,32178,33599,2,24,9,0,0,1,0,3,342,78,24637,29673,23188,1,74,3,4927,4,2505,10411,1,0,-1,0,7
EUW1_6882240219',2,29,15,2,0,0,0,6,1,353,82,27682,30098,37263,4,27,12,0,0,0,0,4,317,68,25399,27984,26755,1,36,14,2283,3,2114,10508,2,0,0,0,2
EUW1_6882221419',3,24,7,1,1,0,0,9,0,349,100,24288,30973,32027,0,66,7,1,0,1,0,0,375,64,24883,28435,28741,0,-26,36,-595,0,2538,3286,0,1,-1,0,9
EUW1_6882210558',4,33,11,2,0,2,0,9,1,370,82,29877,30573,26583,2,24,8,0,0,2,0,8,374,101,26524,30184,25156,1,-4,-19,3353,3,389,1427,2,0,0,0,1
EUW1_6882115715',4,31,20,2,0,2,0,8,1,382,108,31055,33163,38153,3,24,6,0,0,0,0,4,322,104,22743,26652,24220,1,60,4,8312,14,6511,13933,2,0,2,0,4
EUW1_6881989053',3,41,12,0,0,0,0,9,1,352,90,26502,29059,29588,1,23,18,2,1,1,0,1,357,84,31411,31313,35440,1,-5,6,-4909,-6,-2254,-5852,-2,-1,-1,0,8
EUW1_6881924011',4,23,6,0,0,0,0,15,0,304,90,23621,26238,26340,5,141,19,2,0,3,0,4,336,86,31076,30205,40713,0,-32,4,-7455,-13,-3967,-14373,-2,0,-3,0,11
EUW1_6881870643',10,38,16,0,0,2,0,8,1,354,82,29836,31189,38809,1,21,11,0,0,0,0,6,295,82,25450,26718,34205,1,59,0,4386,5,4471,4604,0,0,2,0,2
EUW1_6877384139',4,30,12,0,0,2,0,5,1,358,84,28634,28486,31988,3,155,5,2,0,0,0,8,256,106,21413,24988,22277,0,102,-22,7221,7,3498,9711,-2,0,2,0,-3
EUW1_6860630261',6,26,20,0,0,0,0,6,1,346,99,31289,32273,40024,1,28,10,1,0,0,0,6,318,72,24600,26274,29585,1,28,27,6689,10,5999,10439,-1,0,0,0,0
EUW1_6883403119',1,50,10,0,0,0,0,10,0,321,97,25463,28585,25465,6,56,7,1,0,0,0,0,380,68,24535,27493,27864,0,-59,29,928,3,1092,-2399,-1,0,0,0,10
EUW1_6883350807',2,30,18,0,0,2,0,11,0,371,103,32947,32506,35813,6,65,13,1,0,2,0,4,357,74,27519,27733,32250,0,14,29,5428,5,4773,3563,-1,0,0,0,7
EUW1_6883281719',3,23,13,1,0,0,0,8,0,349,82,27120,29100,35577,5,41,15,0,0,1,0,2,368,122,29677,32280,33803,1,-19,-40,-2557,-2,-3180,1774,1,0,-1,0,6
EUW1_6883199411',4,24,7,1,0,0,0,4,0,383,76,25129,29576,22344,8,153,6,1,0,0,0,0,379,73,24354,29134,25450,1,4,3,775,1,442,-3106,0,0,0,0,4
EUW1_6883019327',4,29,8,2,0,0,0,10,1,349,83,24314,28293,22702,2,22,13,0,1,1,0,2,381,91,28238,32058,30318,0,-32,-8,-3924,-5,-3765,-7616,2,-1,-1,0,8
EUW1_6882380556',3,60,20,1,0,0,0,11,0,311,88,29579,28178,37896,8,53,13,1,0,1,0,2,317,76,27042,26403,36920,1,-6,12,2537,7,1775,976,0,0,-1,0,9
EUW1_6881876968',7,88,14,1,0,0,0,8,0,359,80,29003,28273,33280,4,30,15,0,0,1,0,0,286,66,27744,27839,31084,0,73,14,1259,-1,434,2196,1,0,-1,0,8
EUW1_6881797885',6,44,13,0,0,0,0,7,1,333,87,25768,27644,32293,4,23,14,1,0,2,0,1,391,92,29953,32068,37243,1,-58,-5,-4185,-1,-4424,-4950,-1,0,-2,0,6
EUW1_6881397730',5,21,18,1,0,2,0,10,1,367,62,32073,28766,44664,1,26,9,0,0,1,0,6,256,66,22384,24405,29844,1,111,-4,9689,9,4361,14820,1,0,1,0,4
EUW1_6881336082',8,33,11,1,0,0,0,11,0,323,76,25039,28331,23715,8,30,7,0,0,0,0,0,343,74,24736,27975,30312,0,-20,2,303,4,356,-6597,1,0,0,0,11
EUW1_6881292505',2,24,14,0,0,0,0,5,1,351,68,27142,29386,30253,1,39,7,1,0,0,0,5,315,108,24333,30002,28374,1,36,-40,2809,7,-616,1879,-1,0,0,0,0
EUW1_6881233872',0,19,13,1,0,1,0,9,0,334,67,27849,28616,32611,5,162,19,0,0,0,0,4,360,108,30029,29521,35782,0,-26,-41,-2180,-6,-905,-3171,1,0,1,0,5
EUW1_6881183890',1,26,19,0,0,1,0,13,1,321,99,29599,30970,36219,4,33,12,2,0,0,0,3,296,80,25877,28463,27525,1,25,19,3722,7,2507,8694,-2,0,1,0,10
EUW1_6881136387',5,28,8,0,1,0,0,6,0,371,86,24946,30416,21078,4,29,9,1,0,1,0,4,378,98,27039,29202,21800,0,-7,-12,-2093,-1,1214,-722,-1,1,-1,0,2
EUW1_6881107627',6,35,11,0,0,1,0,10,1,368,82,27132,27566,24338,1,28,16,2,0,2,0,7,344,82,30312,28577,31170,0,24,0,-3180,-5,-1011,-6832,-2,0,-1,0,3
EUW1_6881040141',2,68,12,0,0,0,0,5,1,360,77,26171,30463,22944,4,57,9,1,0,0,0,2,353,60,24354,27443,26023,1,7,17,1817,3,3020,-3079,-1,0,0,0,3
EUW1_6880710022',2,46,8,0,0,0,0,10,1,293,66,23404,26645,25318,4,74,11,1,0,2,0,0,357,103,27161,29733,33316,0,-64,-37,-3757,-3,-3088,-7998,-1,0,-2,0,10
EUW1_6880681280',4,24,14,0,0,0,0,10,1,337,98,28750,28817,32868,5,26,14,2,0,0,0,1,338,82,28010,28588,35909,1,-1,16,740,0,229,-3041,-2,0,0,0,9
EUW1_6882134539',5,24,14,0,0,0,0,9,0,355,75,26168,28593,29851,8,41,16,1,0,2,0,2,385,84,30575,32977,42067,0,-30,-9,-4407,-2,-4384,-12216,-1,0,-2,0,7
EUW1_6881335407',3,19,16,1,0,0,0,11,1,359,84,29386,30977,35064,5,28,11,0,0,0,0,6,370,84,27243,30880,29418,1,-11,0,2143,5,97,5646,1,0,0,0,5
EUW1_6880459233',1,24,6,1,0,0,0,11,1,321,84,23989,27822,27805,5,60,14,1,0,1,0,2,320,75,27276,27182,30998,0,1,9,-3287,-8,640,-3193,0,0,-1,0,9
EUW1_6879896359',5,26,16,1,1,0,0,13,0,346,88,29765,31476,40283,3,22,14,1,0,3,0,7,343,84,29295,28406,33697,1,3,4,470,2,3070,6586,0,1,-3,0,6
EUW1_6879811420',3,33,11,0,0,0,0,8,0,320,82,26789,28833,26133,5,17,6,2,0,1,0,4,360,72,23175,27445,20150,1,-40,10,3614,5,1388,5983,-2,0,-1,0,4
EUW1_6878993128',5,22,7,2,0,0,0,3,0,379,84,22564,29901,16782,3,27,6,0,1,0,0,0,377,120,25103,31256,21908,1,2,-36,-2539,1,-1355,-5126,2,-1,0,0,3
EUW1_6878952133',5,80,17,2,0,3,0,5,1,372,100,30655,31499,35448,6,31,13,0,0,0,0,11,298,84,27692,28889,31351,1,74,16,2963,4,2610,4097,2,0,3,0,-6
EUW1_6878882427',4,29,15,1,0,0,0,9,0,354,98,27937,30114,28240,2,57,9,1,0,0,0,3,393,80,26478,29190,31392,1,-39,18,1459,6,924,-3152,0,0,0,0,6
EUW1_6878385303',4,27,17,1,1,0,0,6,1,353,96,30276,29991,37188,1,23,15,1,0,1,0,3,342,96,28339,28855,31887,1,11,0,1937,2,1136,5301,0,1,-1,0,3
EUW1_6876998765',4,22,14,1,0,2,0,9,0,368,98,30167,31711,34144,4,22,10,1,0,0,0,7,334,88,26174,29671,25718,1,34,10,3993,4,2040,8426,0,0,2,0,2
EUW1_6876925879',5,26,12,0,0,1,0,8,1,366,93,28368,30561,32982,4,19,8,2,0,1,0,6,343,84,25931,29386,23747,1,23,9,2437,4,1175,9235,-2,0,0,0,2
EUW1_6876869507',2,27,16,1,0,1,0,6,0,386,92,29252,32269,35591,3,23,8,1,0,1,0,3,377,102,26155,30287,37792,1,9,-10,3097,8,1982,-2201,0,0,0,0,3
EUW1_6876797790',4,25,6,1,0,0,0,5,1,373,68,23168,27748,19419,3,18,6,1,0,0,0,1,396,124,26070,30385,25028,0,-23,-56,-2902,0,-2637,-5609,0,0,0,0,4
EUW1_6876723330',2,20,20,0,0,1,0,6,0,369,74,32017,31792,34335,6,25,13,2,0,2,0,5,329,86,26546,28291,32187,1,40,-12,5471,7,3501,2148,-2,0,-1,0,1
EUW1_6876708579',2,21,17,2,0,1,0,8,0,310,117,30055,32002,35136,4,29,11,0,0,1,0,7,325,86,26106,27952,27455,1,-15,31,3949,6,4050,7681,2,0,0,0,1
EUW1_6882611852',2,28,11,2,1,1,0,8,1,366,88,27181,28796,29504,2,25,12,0,0,1,0,5,408,78,27957,29992,29761,1,-42,10,-776,-1,-1196,-257,2,1,0,0,3
EUW1_6882577627',4,36,17,0,0,0,0,10,0,313,80,28041,27488,38706,2,41,20,2,0,1,0,2,348,104,31477,29989,37702,0,-35,-24,-3436,-3,-2501,1004,-2,0,-1,0,8
EUW1_6882496401',1,30,14,0,0,0,0,9,1,368,100,28365,31560,32308,1,21,14,2,0,1,0,3,321,100,27654,29305,36337,0,47,0,711,0,2255,-4029,-2,0,-1,0,6
EUW1_6882456942',3,24,15,0,0,1,0,8,1,345,78,27991,28391,37484,4,27,15,2,1,1,0,4,396,110,31186,33621,35276,0,-51,-32,-3195,0,-5230,2208,-2,-1,0,0,4
EUW1_6882431972',3,25,2,1,0,0,0,13,1,397,84,23600,28518,18616,3,30,11,1,0,2,0,1,389,70,28057,29935,26626,0,8,14,-4457,-9,-1417,-8010,0,0,-2,0,12
EUW1_6882418728',5,28,5,1,0,0,0,11,0,353,85,23556,27069,28878,1,82,11,0,0,1,0,1,369,90,27624,31114,29757,0,-16,-5,-4068,-6,-4045,-879,1,0,-1,0,10
EUW1_6882118943',6,52,13,1,0,1,0,8,1,356,66,27907,27459,35691,2,25,16,0,0,1,0,5,361,74,30859,30109,37229,0,-5,-8,-2952,-3,-2650,-1538,1,0,0,0,3
EUW1_6882058859',3,31,22,0,0,2,0,7,1,400,82,31833,31640,38635,1,19,13,2,0,0,0,7,269,92,24691,27489,29715,0,131,-10,7142,9,4151,8920,-2,0,2,0,0
EUW1_6881906887',2,39,11,0,0,2,0,11,1,373,72,28129,28995,28159,4,26,15,2,0,1,0,6,320,100,28338,30240,31721,0,53,-28,-209,-4,-1245,-3562,-2,0,1,0,5
EUW1_6881835094',5,37,11,0,0,1,0,8,1,359,56,26489,28060,33651,8,384,12,1,0,2,0,1,355,102,28471,30769,30154,1,4,-46,-1982,-1,-2709,3497,-1,0,-1,0,7
EUW1_6881754756',4,25,10,0,0,1,0,9,1,324,54,26302,27360,29846,6,33,10,1,0,1,0,2,310,80,25147,26999,34049,1,14,-26,1155,0,361,-4203,-1,0,0,0,7
EUW1_6881706941',5,29,6,0,1,0,0,9,0,302,60,23714,24537,26302,5,30,18,1,0,1,0,1,385,76,30985,31563,39098,0,-83,-16,-7271,-12,-7026,-12796,-1,1,-1,0,8
EUW1_6881628884',2,28,12,1,0,1,0,10,1,353,76,26857,28142,38690,3,131,14,1,0,1,0,5,319,91,28307,28542,36402,0,34,-15,-1450,-2,-400,2288,0,0,0,0,5
EUW1_6881256146',1,26,17,1,0,0,0,12,1,324,96,28898,29739,40018,1,24,14,1,0,2,0,3,357,93,29900,31032,33585,0,-33,3,-1002,3,-1293,6433,0,0,-2,0,9
EUW1_6881013996',2,17,5,0,0,0,0,12,1,325,75,23437,25591,22721,3,26,22,1,0,2,0,1,401,100,33935,34229,33031,0,-76,-25,-10498,-17,-8638,-10310,-1,0,-2,0,11
EUW1_6880539031',1,28,15,1,0,0,0,6,0,386,84,29410,31391,34552,1,27,13,0,0,1,0,2,347,84,26945,29883,33175,1,39,0,2465,2,1508,1377,1,0,-1,0,4
EUW1_6880459758',1,32,13,2,0,1,0,11,1,354,88,28285,27556,30653,5,44,8,0,0,2,0,4,350,114,26941,30329,31169,1,4,-26,1344,5,-2773,-516,2,0,-1,0,7
EUW1_6879995434',2,40,8,0,0,0,0,14,0,372,76,24695,29228,33100,4,30,16,0,1,2,0,3,406,100,31510,32421,38091,0,-34,-24,-6815,-8,-3193,-4991,0,-1,-2,0,11
EUW1_6879667895',2,28,14,0,0,1,0,8,0,326,30,27535,26435,35618,8,25,25,2,0,1,0,4,324,90,31663,31284,39553,0,2,-60,-4128,-11,-4849,-3935,-2,0,0,0,4
EUW1_6883234582',7,26,11,0,0,1,0,6,0,346,107,27699,29543,36381,3,28,11,1,0,0,0,5,325,84,26910,30214,35216,0,21,23,789,0,-671,1165,-1,0,1,0,1
EUW1_6879523269',4,23,6,1,0,1,0,8,1,349,100,24684,28966,27281,3,30,6,1,0,1,0,2,372,100,26395,30849,26872,0,-23,0,-1711,0,-1883,409,0,0,0,0,6
EUW1_6879495232',4,31,13,1,0,1,0,8,0,335,92,27895,30783,36266,5,30,10,0,0,0,0,5,323,72,25316,27225,28141,1,12,20,2579,3,3558,8125,1,0,1,0,3
EUW1_6877477679',3,22,15,0,0,1,0,11,1,346,98,29191,29392,39913,2,24,14,1,0,1,0,8,350,64,26114,29281,31502,1,-4,34,3077,1,111,8411,-1,0,0,0,3
EUW1_6877391097',2,40,12,2,0,0,0,13,1,413,104,29489,32463,28396,5,33,4,0,0,2,0,6,366,84,24797,27847,24065,1,47,20,4692,8,4616,4331,2,0,-2,0,7
EUW1_6877266112',4,62,7,1,0,0,0,6,0,302,62,23783,27723,34427,6,73,14,0,0,1,0,1,369,74,27904,30108,31683,0,-67,-12,-4121,-7,-2385,2744,1,0,-1,0,5
EUW1_6754027872',1,25,17,1,0,0,0,13,1,314,88,29391,30460,34009,2,28,26,0,1,3,0,0,386,86,33993,33856,46857,0,-72,2,-4602,-9,-3396,-12848,1,-1,-3,0,13
EUW1_6882093688',5,33,10,0,0,0,0,6,0,374,75,25993,28622,32850,3,33,16,2,0,0,0,0,363,92,28419,30859,31210,0,11,-17,-2426,-6,-2237,1640,-2,0,0,0,6
EUW1_6876985301',5,29,6,0,0,0,0,9,0,372,84,24823,28710,21082,7,272,5,2,0,2,0,4,362,111,25302,29117,24485,0,10,-27,-479,1,-407,-3403,-2,0,-2,0,5
EUW1_6875703254',4,31,11,1,0,0,0,6,1,320,75,25646,26995,34622,4,101,16,0,0,0,0,3,326,73,27307,29910,39113,0,-6,2,-1661,-5,-2915,-4491,1,0,0,0,3
EUW1_6874920049',5,30,11,1,0,1,0,6,0,398,106,27976,32140,29194,1,24,8,1,0,0,0,5,379,100,25636,29091,27228,1,19,6,2340,3,3049,1966,0,0,1,0,1
EUW1_6874869451',5,28,7,1,1,0,0,6,1,396,98,26877,30664,30292,5,31,12,1,0,1,0,3,392,78,26421,30252,30708,0,4,20,456,-5,412,-416,0,1,-1,0,3
EUW1_6874664472',4,22,16,0,0,3,0,7,1,383,84,30369,29929,36792,1,38,7,1,0,0,0,9,341,98,23594,28093,24064,1,42,-14,6775,9,1836,12728,-1,0,3,0,-2
EUW1_6874270503',4,26,22,0,0,1,0,6,1,395,70,33069,31778,37951,3,28,9,1,0,1,0,8,323,69,24951,26604,26645,1,72,1,8118,13,5174,11306,-1,0,0,0,-2
EUW1_6874234918',6,26,18,1,0,1,0,2,0,376,100,30960,35629,31986,2,26,2,1,0,1,0,9,333,92,20781,25930,31947,1,43,8,10179,16,9699,39,0,0,0,0,-7
EUW1_6874172860',6,25,14,0,0,2,0,9,1,350,88,29831,29522,28302,2,24,15,1,0,0,0,5,363,96,27920,31122,35945,1,-13,-8,1911,-1,-1600,-7643,-1,0,2,0,4
EUW1_6874130949',7,250,17,1,0,0,0,8,0,352,76,29326,30110,37152,6,154,12,0,0,1,0,5,356,67,26479,28247,29676,1,-4,9,2847,5,1863,7476,1,0,-1,0,3
EUW1_6874105053',7,30,14,1,0,1,0,3,1,398,70,29073,31549,32766,5,99,1,0,0,1,0,8,302,78,20459,27003,18096,1,96,-8,8614,13,4546,14670,1,0,0,0,-5
EUW1_6873999316',3,48,25,2,0,3,0,7,1,357,77,34955,30572,44568,2,23,12,0,0,0,0,10,293,58,25710,26433,25489,1,64,19,9245,13,4139,19079,2,0,3,0,-3
EUW1_6882729722',6,50,15,0,0,0,0,7,1,317,68,27890,28239,31557,4,26,16,1,0,0,0,2,364,66,27180,28260,36768,1,-47,2,710,-1,-21,-5211,-1,0,0,0,5
EUW1_6882549246',4,22,13,0,0,1,0,5,1,358,90,28635,30047,30621,2,31,7,1,0,0,0,6,343,102,25299,30013,30437,1,15,-12,3336,6,34,184,-1,0,1,0,-1
EUW1_6882523837',2,28,9,1,0,0,0,6,1,340,93,24641,30034,30094,1,22,12,0,0,1,0,2,386,82,27983,31444,37924,1,-46,11,-3342,-3,-1410,-7830,1,0,-1,0,4
EUW1_6883159385',6,31,7,0,0,0,0,7,1,367,92,26077,29242,26389,5,29,9,2,0,2,0,3,382,88,26588,29919,20779,0,-15,4,-511,-2,-677,5610,-2,0,-2,0,4
EUW1_6883090971',3,27,8,0,0,0,0,10,1,316,82,24372,29141,26560,3,137,15,2,0,2,0,3,371,92,29796,31554,36496,0,-55,-10,-5424,-7,-2413,-9936,-2,0,-2,0,7
EUW1_6882757821',2,60,11,0,1,1,0,14,1,330,88,27760,30693,32809,6,65,17,1,0,1,0,5,335,93,29001,30068,38855,0,-5,-5,-1241,-6,625,-6046,-1,1,0,0,9
EUW1_6882733611',4,129,2,0,0,0,0,8,0,334,94,21654,27534,24392,6,124,11,1,0,2,0,0,347,71,26758,31920,31517,0,-13,23,-5104,-9,-4386,-7125,-1,0,-2,0,8
EUW1_6882686265',4,28,18,1,0,0,0,5,1,378,80,30037,31177,32335,6,34,9,1,0,0,0,4,368,100,25865,29169,30242,1,10,-20,4172,9,2008,2093,0,0,0,0,1
EUW1_6881922549',5,33,20,1,0,1,0,10,1,329,76,30562,29068,37352,1,22,13,1,0,1,0,8,329,82,27067,28494,31023,1,0,-6,3495,7,574,6329,0,0,0,0,2
EUW1_6881846408',3,60,9,0,0,0,0,11,0,369,62,24981,29178,38470,4,29,10,2,0,1,0,0,378,80,27084,28857,29314,1,-9,-18,-2103,-1,321,9156,-2,0,-1,0,11
EUW1_6881788959',4,35,15,2,0,0,0,7,1,376,102,28256,32256,34544,1,21,11,0,0,1,0,3,343,73,26474,27900,30249,0,33,29,1782,4,4356,4295,2,0,-1,0,4
EUW1_6881723959',5,26,17,0,0,1,0,7,1,369,96,30481,30372,37191,3,32,10,1,0,0,0,5,326,71,24972,26802,25065,1,43,25,5509,7,3570,12126,-1,0,1,0,2
EUW1_6881558812',1,136,12,1,0,2,0,8,1,379,66,27989,28642,27219,7,29,11,1,0,1,0,5,350,104,27182,30751,25306,0,29,-38,807,1,-2109,1913,0,0,1,0,3
EUW1_6881507697',4,26,8,0,0,1,0,10,1,333,95,25667,28413,26727,6,48,16,2,0,1,0,6,362,68,28556,29365,34972,1,-29,27,-2889,-8,-952,-8245,-2,0,0,0,4
EUW1_6881435439',4,67,14,0,0,0,0,13,1,324,90,27395,30188,26657,13,48,13,1,0,3,0,4,362,106,29993,30759,33833,1,-38,-16,-2598,1,-571,-7176,-1,0,-3,0,9
EUW1_6881382436',8,31,6,1,1,0,0,9,0,335,113,24782,28349,26671,1,24,11,0,0,1,0,2,377,108,28862,30369,23062,0,-42,5,-4080,-5,-2020,3609,1,1,-1,0,7
EUW1_6880166572',4,27,9,0,0,0,0,11,0,315,64,25342,28182,32097,6,42,18,2,0,0,0,3,401,97,29757,32203,30516,0,-86,-33,-4415,-9,-4021,1581,-2,0,0,0,8
EUW1_6880115268',6,74,8,2,0,0,0,7,0,344,82,24870,29298,27111,2,37,17,0,0,1,0,1,374,110,30615,34103,34275,0,-30,-28,-5745,-9,-4805,-7164,2,0,-1,0,6
EUW1_6879954252',5,144,7,0,0,0,0,11,1,400,59,24902,29186,22709,5,27,10,1,1,1,0,1,383,90,26838,31087,28046,0,17,-31,-1936,-3,-1901,-5337,-1,-1,-1,0,10
EUW1_6879603333',0,24,11,0,0,0,0,11,1,357,86,25912,28177,26753,3,48,13,1,0,1,0,4,375,73,28019,30032,33949,1,-18,13,-2107,-2,-1855,-7196,-1,0,-1,0,7
EUW1_6879563859',8,46,6,0,0,0,0,10,0,348,78,24192,26895,28791,5,106,13,1,0,0,0,2,391,70,27192,31550,28528,0,-43,8,-3000,-7,-4655,263,-1,0,0,0,8
EUW1_6882226121',5,45,21,0,0,1,0,13,1,392,56,31360,30677,32674,5,211,14,1,1,2,0,7,361,84,31137,30497,35432,0,31,-28,223,7,180,-2758,-1,-1,-1,0,6
EUW1_6882206029',4,38,11,0,0,0,0,6,1,366,78,28288,29338,33696,3,31,13,1,0,1,0,6,334,74,26928,29943,39917,0,32,4,1360,-2,-605,-6221,-1,0,-1,0,0
EUW1_6882185477',3,21,17,0,0,2,0,9,0,286,86,29389,29429,37102,1,38,18,1,0,0,0,6,293,74,27450,27542,38145,1,-7,12,1939,-1,1887,-1043,-1,0,2,0,3
EUW1_6882093016',3,35,8,1,0,0,0,14,1,336,76,24286,26845,28595,2,28,11,0,0,3,0,3,366,80,29051,30301,28269,1,-30,-4,-4765,-3,-3456,326,1,0,-3,0,11
EUW1_6881885340',1,22,6,2,0,0,0,5,0,363,97,24117,27886,21043,7,50,10,0,0,0,0,1,334,79,24849,28396,22777,0,29,18,-732,-4,-510,-1734,2,0,0,0,4
EUW1_6877649008',0,26,5,1,0,2,0,9,0,365,92,27328,28634,25200,7,30,10,0,0,1,0,7,389,68,26641,31177,28544,0,-24,24,687,-5,-2543,-3344,1,0,1,0,2
EUW1_6877606777',1,21,8,0,0,0,0,15,1,288,77,24162,26728,31689,5,26,27,2,0,4,0,2,341,108,34520,33863,41287,0,-53,-31,-10358,-19,-7135,-9598,-2,0,-4,0,13
EUW1_6877545974',3,24,6,2,0,0,0,9,0,341,106,23568,29183,21556,14,40,11,0,0,0,0,2,377,68,26795,28036,23528,0,-36,38,-3227,-5,1147,-1972,2,0,0,0,7
EUW1_6877094998',8,28,10,1,0,2,0,5,0,415,86,28392,31333,21787,2,32,9,1,0,0,0,7,383,73,25281,29110,23631,1,32,13,3111,1,2223,-1844,0,0,2,0,-2
EUW1_6876386668',2,29,11,0,1,0,0,3,0,360,78,25776,30067,30405,2,28,7,2,0,0,0,3,322,94,23717,26552,28490,1,38,-16,2059,4,3515,1915,-2,1,0,0,0
EUW1_6876357198',5,29,16,0,0,1,0,7,1,372,92,30045,30851,34947,3,25,12,1,0,1,0,4,315,92,25235,27377,35635,1,57,0,4810,4,3474,-688,-1,0,0,0,3
EUW1_6876252293',3,34,4,0,0,0,0,10,0,369,79,24543,28358,26812,5,29,16,1,0,0,0,2,358,68,27803,30618,30575,0,11,11,-3260,-12,-2260,-3763,-1,0,0,0,8
EUW1_6876215080',4,229,15,1,0,1,0,7,0,356,78,29010,29397,32151,3,26,15,1,0,2,0,5,330,98,30331,29066,35963,0,26,-20,-1321,0,331,-3812,0,0,-1,0,2
EUW1_6876167570',5,26,20,0,0,1,0,6,1,382,74,33318,30087,41115,5,33,12,1,0,1,0,10,285,94,26659,26746,29649,1,97,-20,6659,8,3341,11466,-1,0,0,0,-4
EUW1_6874974552',4,26,8,0,0,0,0,13,0,346,87,24913,28312,23202,7,226,14,2,0,1,0,1,360,92,28501,29271,27711,0,-14,-5,-3588,-6,-959,-4509,-2,0,-1,0,12
EUW1_6874944590',2,25,21,1,0,1,0,12,1,313,76,30439,29400,38384,4,24,14,0,0,3,0,4,316,88,29123,27077,33118,0,-3,-12,1316,7,2323,5266,1,0,-2,0,8
EUW1_6874901670',4,24,11,1,0,0,0,5,1,325,88,25447,30133,25687,3,21,7,1,0,0,0,5,340,88,24573,29138,28280,1,-15,0,874,4,995,-2593,0,0,0,0,0
EUW1_6874561406',0,22,8,2,0,1,0,4,1,405,117,26976,32784,24783,3,23,1,0,0,0,0,4,332,86,20708,26665,16384,1,73,31,6268,7,6119,8399,2,0,1,0,0
EUW1_6874498615',4,61,7,1,0,0,0,4,0,346,92,25062,28133,25261,6,29,14,1,0,0,0,1,344,84,26531,29181,27660,1,2,8,-1469,-7,-1048,-2399,0,0,0,0,3
EUW1_6881904468',4,35,9,2,1,2,0,9,0,416,116,28151,32023,26493,5,31,4,0,0,0,0,6,377,92,24636,27539,17618,1,39,24,3515,5,4484,8875,2,1,2,0,3
EUW1_6881818885',5,138,11,0,0,0,0,11,1,323,91,25563,28487,24529,8,38,11,1,0,1,0,1,434,94,28008,32381,28426,0,-111,-3,-2445,0,-3894,-3897,-1,0,-1,0,10
EUW1_6881757828',2,20,23,1,0,2,0,3,1,345,88,32132,32953,43500,5,24,9,0,0,0,0,9,303,78,24883,26546,29793,1,42,10,7249,14,6407,13707,1,0,2,0,-6
EUW1_6881214263',5,31,13,1,1,1,0,14,0,335,101,28895,30718,38782,9,31,16,1,0,1,0,7,342,98,29377,29911,42709,1,-7,3,-482,-3,807,-3927,0,1,0,0,7
EUW1_6881163293',2,26,4,0,0,0,0,12,0,299,90,21921,26009,19893,6,28,12,1,0,3,0,1,386,80,29173,30118,28514,0,-87,10,-7252,-8,-4109,-8621,-1,0,-3,0,11
EUW1_6881124584',3,32,5,0,0,0,0,7,1,383,78,24131,29185,23989,5,25,6,1,0,1,0,0,407,86,25634,30568,23026,1,-24,-8,-1503,-1,-1383,963,-1,0,-1,0,7
EUW1_6881069634',8,33,9,2,0,0,0,4,0,368,86,25907,29805,28921,3,25,8,0,0,1,0,0,367,73,24825,29318,27689,1,1,13,1082,1,487,1232,2,0,-1,0,4
EUW1_6881020318',2,22,10,1,0,0,0,11,1,321,67,24901,25442,28314,3,42,21,1,0,2,0,3,374,116,32972,32293,38061,0,-53,-49,-8071,-11,-6851,-9747,0,0,-2,0,8
EUW1_6880969912',8,80,10,1,1,0,0,13,0,302,72,27516,27751,33850,2,48,18,1,0,2,0,5,334,111,30286,29962,38645,0,-32,-39,-2770,-8,-2211,-4795,0,1,-2,0,8
EUW1_6880949339',1,23,4,1,0,0,0,13,0,338,90,22504,25744,21947,9,26,19,1,0,3,0,2,377,89,31546,31563,35047,0,-39,1,-9042,-15,-5819,-13100,0,0,-3,0,11
EUW1_6880302976',5,31,10,0,0,0,0,11,1,357,96,27949,30996,32632,4,55,9,1,0,2,0,3,408,100,27427,30382,23694,1,-51,-4,522,1,614,8938,-1,0,-2,0,8
EUW1_6880240350',0,24,7,0,0,0,0,13,0,308,87,23850,27319,24866,7,28,16,2,0,3,0,1,381,71,31201,30135,32724,0,-73,16,-7351,-9,-2816,-7858,-2,0,-3,0,12
EUW1_6880188544',5,28,7,2,1,1,0,9,0,429,90,27069,31940,21549,6,97,5,0,0,0,0,1,378,81,23742,28273,18332,1,51,9,3327,2,3667,3217,2,1,1,0,8
EUW1_6880137604',14,46,13,0,0,0,0,16,1,348,84,28579,28896,35243,6,134,29,2,0,2,0,4,355,88,34450,33648,47669,0,-7,-4,-5871,-16,-4752,-12426,-2,0,-2,0,12
EUW1_6878822353',6,36,24,1,0,2,0,11,1,390,92,34221,33312,40605,8,47,9,1,0,2,0,7,333,72,24987,25629,29923,1,57,20,9234,15,7683,10682,0,0,0,0,4
EUW1_6878769153',6,38,22,1,1,1,0,7,1,380,96,32248,30565,43364,2,25,11,1,0,0,0,4,302,74,26110,26958,29717,0,78,22,6138,11,3607,13647,0,1,1,0,3
EUW1_6878574297',8,44,15,2,0,1,0,3,1,407,94,30079,31996,32618,1,19,6,0,0,0,0,5,335,90,23847,29169,29343,1,72,4,6232,9,2827,3275,2,0,1,0,-2
EUW1_6878536032',4,27,6,0,0,0,0,10,0,346,80,24612,28108,23898,7,101,20,2,0,2,0,1,384,83,31876,33230,42642,0,-38,-3,-7264,-14,-5122,-18744,-2,0,-2,0,9
EUW1_6878484291',5,25,18,1,0,0,0,8,0,303,75,28629,27784,39017,3,96,17,1,0,1,0,4,272,91,27711,29375,44094,0,31,-16,918,1,-1591,-5077,0,0,-1,0,4
EUW1_6883363475',2,30,17,0,0,0,0,11,1,311,110,27939,29659,31713,5,27,14,1,0,0,0,2,331,86,27720,28104,38515,0,-20,24,219,3,1555,-6802,-1,0,0,0,9
EUW1_6883303760',5,29,13,2,1,2,0,5,1,426,108,31430,32648,27472,5,26,3,0,0,1,0,12,372,90,22606,27819,23061,1,54,18,8824,10,4829,4411,2,1,1,0,-7
EUW1_6879138514',0,25,9,0,0,1,0,9,0,327,96,25918,30111,32923,1,26,10,2,0,1,0,6,367,83,26446,29971,22710,0,-40,13,-528,-1,140,10213,-2,0,0,0,3
EUW1_6879079794',4,27,12,0,0,0,0,4,0,333,84,26087,30182,27930,4,31,11,2,0,0,0,0,371,104,26827,29757,31554,0,-38,-20,-740,1,425,-3624,-2,0,0,0,4
EUW1_6879016422',1,45,14,0,0,0,0,13,0,313,80,27033,28094,31697,4,18,22,2,0,2,0,2,346,77,32865,30994,44166,0,-33,3,-5832,-8,-2900,-12469,-2,0,-2,0,11
EUW1_6878954721',4,26,9,1,0,0,0,3,0,357,74,24651,28386,25126,6,32,8,1,0,0,0,0,335,122,24578,29260,19593,0,22,-48,73,1,-874,5533,0,0,0,0,3
EUW1_6878463921',4,39,10,0,0,1,0,14,1,391,96,28162,32955,28276,4,43,11,2,0,1,0,5,390,112,28363,32645,31305,0,1,-16,-201,-1,310,-3029,-2,0,0,0,9
EUW1_6878334425',2,23,22,1,0,0,0,11,1,367,73,30128,30515,37289,5,94,13,0,0,1,0,1,325,78,28090,27197,34801,1,42,-5,2038,9,3318,2488,1,0,-1,0,10
EUW1_6878284826',3,26,23,0,0,2,0,8,0,320,94,32813,30741,42938,7,92,22,1,0,1,0,2,286,58,29832,27589,42401,0,34,36,2981,1,3152,537,-1,0,1,0,6
EUW1_6878245292',4,139,17,2,0,1,0,3,1,344,104,30243,29611,33438,7,47,9,0,0,1,0,5,336,68,24495,26618,22213,1,8,36,5748,8,2993,11225,2,0,0,0,-2
EUW1_6876171387',5,36,17,1,1,3,0,8,1,383,98,31804,31366,32741,1,27,8,0,0,0,0,5,368,66,25233,27864,29404,1,15,32,6571,9,3502,3337,1,1,3,0,3
EUW1_6876119471',5,54,19,0,0,0,0,3,1,386,123,31784,34055,39252,5,71,8,1,0,2,0,5,354,68,25267,27810,29903,1,32,55,6517,11,6245,9349,-1,0,-2,0,-2
EUW1_6883010905',3,23,19,2,0,0,0,6,1,340,91,31042,29980,31798,5,26,14,0,0,3,0,6,342,87,29281,29261,31844,0,-2,4,1761,5,719,-46,2,0,-3,0,0
EUW1_6882962760',1,35,7,0,0,1,0,15,1,341,72,25484,27729,29725,3,31,15,2,0,2,0,3,336,103,29840,31490,39045,0,5,-31,-4356,-8,-3761,-9320,-2,0,-1,0,12
EUW1_6882903087',1,23,12,0,1,2,0,7,0,326,80,29102,28331,39132,6,30,15,2,0,0,0,7,314,84,27146,27280,31338,1,12,-4,1956,-3,1051,7794,-2,1,2,0,0
EUW1_6881954093',2,23,9,0,0,0,0,12,0,329,86,24267,27331,33483,3,26,29,1,1,3,0,2,320,102,34411,34533,49369,0,9,-16,-10144,-20,-7202,-15886,-1,-1,-3,0,10
EUW1_6881797877',0,21,12,1,0,0,0,8,0,302,92,25983,28777,28578,2,21,16,0,0,1,0,2,381,71,28290,31575,37199,0,-79,21,-2307,-4,-2798,-8621,1,0,-1,0,6
EUW1_6881726922',2,25,12,0,0,2,0,6,0,326,70,27813,28285,33900,1,22,14,1,0,0,0,9,323,86,28106,29398,35425,0,3,-16,-293,-2,-1113,-1525,-1,0,2,0,-3
EUW1_6878109797',3,144,11,1,0,0,0,7,0,365,89,28026,31074,28739,1,48,10,1,0,1,0,7,370,90,24909,31113,25344,0,-5,-1,3117,1,-39,3395,0,0,-1,0,0
EUW1_6876303767',7,49,20,0,0,0,0,13,1,326,77,31414,30140,46186,2,75,16,2,0,3,0,2,335,90,29755,28830,42930,1,-9,-13,1659,4,1310,3256,-2,0,-3,0,11
EUW1_6876260907',3,35,10,0,0,0,0,11,0,315,92,26124,28750,34125,1,16,19,1,0,1,0,4,338,96,29830,31199,37800,0,-23,-4,-3706,-9,-2449,-3675,-1,0,-1,0,7
EUW1_6876220930',6,27,14,0,0,0,0,12,1,387,78,29538,29973,34280,5,27,17,2,1,1,0,3,284,78,28292,27709,35637,0,103,0,1246,-3,2264,-1357,-2,-1,-1,0,9
EUW1_6876157167',6,30,17,0,0,1,0,12,1,354,98,29863,32172,40486,1,24,10,0,0,0,0,3,340,69,25276,28433,27597,1,14,29,4587,7,3739,12889,0,0,1,0,9
EUW1_6876111564',4,54,19,0,0,1,0,3,1,397,79,30891,30237,32604,5,28,7,1,0,0,0,6,335,77,24202,27040,22415,1,62,2,6689,12,3197,10189,-1,0,1,0,-3
EUW1_6876023270',1,24,13,0,0,0,0,15,0,288,86,26802,29554,34136,4,24,16,2,0,2,0,3,368,122,30797,32585,38412,1,-80,-36,-3995,-3,-3031,-4276,-2,0,-2,0,12
EUW1_6875571955',4,22,4,2,0,0,0,11,1,340,112,23511,29048,25988,2,23,12,0,0,1,0,1,349,88,26359,31102,30602,0,-9,24,-2848,-8,-2054,-4614,2,0,-1,0,10
EUW1_6875530603',4,25,20,0,0,0,0,11,1,320,67,31755,29151,39871,1,33,23,2,0,1,0,3,333,104,32038,30971,44428,0,-13,-37,-283,-3,-1820,-4557,-2,0,-1,0,8
EUW1_6875489849',2,40,10,2,0,1,0,5,1,372,89,27357,29108,32248,4,23,14,0,0,0,0,6,296,106,27106,29856,28035,0,76,-17,251,-4,-748,4213,2,0,1,0,-1
EUW1_6875457558',3,31,6,1,0,0,0,11,0,286,68,23039,25691,25866,5,40,18,1,0,1,0,1,357,95,30457,30407,38171,0,-71,-27,-7418,-12,-4716,-12305,0,0,-1,0,10
EUW1_6875416303',6,28,12,2,0,0,0,12,0,345,94,26684,29582,30702,3,26,19,0,1,1,0,4,307,106,30182,31142,35806,0,38,-12,-3498,-7,-1560,-5104,2,-1,-1,0,8
EUW1_6875382369',3,32,10,0,0,0,0,7,1,347,64,25612,27424,25717,4,66,9,2,0,0,0,3,323,80,23734,28499,23288,1,24,-16,1878,1,-1075,2429,-2,0,0,0,4
EUW1_6883642268',4,20,16,0,0,1,0,13,1,295,54,27992,26203,27457,2,29,19,1,0,2,0,3,322,92,30803,29401,35465,0,-27,-38,-2811,-3,-3198,-8008,-1,0,-1,0,10
EUW1_6883621288',1,22,9,1,0,0,0,11,0,282,87,24589,25157,25382,2,26,16,1,1,2,0,2,343,108,29206,31242,36725,0,-61,-21,-4617,-7,-6085,-11343,0,-1,-2,0,9
EUW1_6883572817',2,24,23,1,1,0,0,11,1,319,88,33301,29688,50431,3,24,24,1,0,2,0,3,317,95,33839,30595,40479,1,2,-7,-538,-1,-907,9952,0,1,-2,0,8
EUW1_6883547369',2,22,14,1,0,1,0,8,1,353,103,28738,32729,37441,1,47,9,0,0,1,0,4,343,80,24748,29532,35227,1,10,23,3990,5,3197,2214,1,0,0,0,4
EUW1_6883445030',6,34,11,1,0,0,0,8,0,361,108,25674,29829,28088,4,28,12,1,0,0,0,2,370,84,27758,29031,31850,1,-9,24,-2084,-1,798,-3762,0,0,0,0,6
EUW1_6883380609',2,24,15,0,0,0,0,13,1,354,114,30138,30158,35783,1,54,17,2,0,3,0,4,341,86,30974,31330,38607,0,13,28,-836,-2,-1172,-2824,-2,0,-3,0,9
EUW1_6882696733',2,28,17,1,0,1,0,9,1,365,94,30796,31425,35954,0,27,15,1,0,1,0,6,361,94,28468,30633,32421,0,4,0,2328,2,792,3533,0,0,0,0,3
EUW1_6882659815',3,29,9,0,0,0,0,14,0,321,69,24491,28538,20904,3,25,18,2,0,2,0,0,412,127,33075,33698,35920,0,-91,-58,-8584,-9,-5160,-15016,-2,0,-2,0,14
EUW1_6882286266',4,23,22,0,1,4,0,7,1,380,88,36015,32613,48350,0,24,15,2,0,0,0,11,257,80,27158,27440,36530,1,123,8,8857,7,5173,11820,-2,1,4,0,-4
EUW1_6882197895',5,30,14,0,1,2,0,6,0,388,90,30944,30434,37189,4,56,12,1,0,0,0,10,342,90,26688,27989,26079,1,46,0,4256,2,2445,11110,-1,1,2,0,-4
EUW1_6882123349',8,33,17,1,0,1,0,8,0,336,92,28244,30750,30575,3,38,17,1,0,2,0,4,382,78,32574,31397,39013,0,-46,14,-4330,0,-647,-8438,0,0,-1,0,4
EUW1_6883135058',6,132,10,1,1,0,0,7,1,359,103,26536,30036,26955,4,132,8,0,0,0,0,4,390,100,26803,30541,23417,1,-31,3,-267,2,-505,3538,1,1,0,0,3
EUW1_6883075869',3,29,14,1,0,1,0,5,1,398,91,29953,31808,39468,5,28,10,0,0,0,0,5,332,72,25068,27558,29917,1,66,19,4885,4,4250,9551,1,0,1,0,0
EUW1_6881957884',5,28,13,0,1,1,0,5,0,357,82,27170,30178,27297,5,24,8,2,0,1,0,0,380,86,27161,30354,32041,0,-23,-4,9,5,-176,-4744,-2,1,0,0,5
EUW1_6881514130',11,34,16,1,0,0,0,5,1,363,86,31727,30738,33666,2,28,13,1,0,1,0,6,316,100,26883,27858,32242,1,47,-14,4844,3,2880,1424,0,0,-1,0,-1
EUW1_6881451222',4,24,9,0,0,0,0,13,1,376,84,25617,30290,23889,6,25,12,2,0,2,0,2,391,91,29803,31783,24771,1,-15,-7,-4186,-3,-1493,-882,-2,0,-2,0,11
EUW1_6881317307',3,30,11,1,0,0,0,10,0,326,80,24920,28096,27031,2,44,16,1,1,1,0,1,342,119,29948,32260,34247,0,-16,-39,-5028,-5,-4164,-7216,0,-1,-1,0,9
EUW1_6881257938',7,74,12,0,0,0,0,12,1,377,88,29455,30708,35314,2,24,7,2,0,2,0,8,390,100,26126,29373,20534,1,-13,-12,3329,5,1335,14780,-2,0,-2,0,4
EUW1_6881185528',4,29,12,0,0,0,0,5,1,383,100,28548,29619,33133,5,21,15,1,0,1,0,6,338,88,27791,29525,33608,1,45,12,757,-3,94,-475,-1,0,-1,0,-1
EUW1_6880291872',5,29,12,2,1,1,0,5,1,350,101,28267,30415,30391,2,52,11,0,0,0,0,6,356,90,26966,29388,32205,0,-6,11,1301,1,1027,-1814,2,1,1,0,-1
EUW1_6879930500',2,23,8,1,1,0,0,5,1,323,103,24594,28117,23069,4,25,11,1,0,0,0,4,347,104,26213,31393,24042,0,-24,-1,-1619,-3,-3276,-973,0,1,0,0,1
EUW1_6878958051',6,28,4,2,0,0,0,4,0,394,84,23962,28650,23894,6,33,8,0,0,0,0,4,379,80,24914,30155,25169,0,15,4,-952,-4,-1505,-1275,2,0,0,0,0
EUW1_6878901154',5,28,16,2,0,2,0,6,1,331,108,28851,29761,30693,3,24,8,0,0,1,0,4,347,80,25275,27787,20092,1,-16,28,3576,8,1974,10601,2,0,1,0,2
EUW1_6878538567',1,29,18,0,0,0,0,11,0,265,76,27577,27621,36378,0,17,15,1,0,0,0,2,291,86,27483,27543,37240,1,-26,-10,94,3,78,-862,-1,0,0,0,9
EUW1_6878486792',4,25,6,0,0,0,0,7,0,339,98,23417,27919,22056,6,21,15,1,0,0,0,0,345,94,27415,30887,30010,0,-6,4,-3998,-9,-2968,-7954,-1,0,0,0,7
EUW1_6857606520',4,36,19,0,0,1,0,8,1,312,76,30310,27395,41286,3,137,15,2,0,1,0,1,312,119,28960,29335,30957,0,0,-43,1350,4,-1940,10329,-2,0,0,0,7
EUW1_6883198375',5,24,15,1,0,1,0,12,0,364,101,28606,31427,34145,1,34,13,1,0,1,0,0,356,86,27734,30233,33417,1,8,15,872,2,1194,728,0,0,0,0,12
EUW1_6883128161',2,19,13,2,0,2,0,10,1,384,96,28888,31493,34113,3,39,7,0,0,1,0,6,349,91,24752,28607,24874,1,35,5,4136,6,2886,9239,2,0,1,0,4
EUW1_6882514221',3,35,8,2,0,1,0,4,0,384,100,26424,30228,28583,7,26,11,0,1,0,0,3,353,92,25872,31415,25512,0,31,8,552,-3,-1187,3071,2,-1,1,0,1
EUW1_6881102250',3,22,6,1,0,0,0,12,0,368,63,24657,27737,20859,3,23,16,1,1,1,0,3,366,103,29958,31831,35020,0,2,-40,-5301,-10,-4094,-14161,0,-1,-1,0,9
EUW1_6876770959',4,33,9,1,0,0,0,4,0,370,92,26462,29550,32859,8,25,15,1,0,1,0,2,353,88,27056,29458,33763,1,17,4,-594,-6,92,-904,0,0,-1,0,2
EUW1_6876735526',1,21,14,1,0,1,0,5,0,372,114,31027,31936,33472,4,318,14,0,0,0,0,3,312,66,26710,28389,35802,1,60,48,4317,0,3547,-2330,1,0,1,0,2
EUW1_6876526086',2,64,7,0,0,0,0,8,0,296,80,22656,27620,24983,5,24,11,0,1,1,0,1,384,96,27918,31034,29049,0,-88,-16,-5262,-4,-3414,-4066,0,-1,-1,0,7
EUW1_6883526057',3,56,18,0,0,1,0,7,1,343,95,30748,29947,35030,2,13,5,1,0,2,0,10,376,66,25034,27318,22622,1,-33,29,5714,13,2629,12408,-1,0,-1,0,-3
EUW1_6881825562',5,31,13,1,0,0,0,7,0,329,97,28207,28866,28758,2,21,20,0,0,0,0,4,360,65,30061,30809,32489,0,-31,32,-1854,-7,-1943,-3731,1,0,0,0,3
EUW1_6881199739',3,318,15,1,0,2,0,11,0,350,84,29137,30738,29986,1,23,9,1,0,0,0,7,369,99,26697,28777,27020,1,-19,-15,2440,6,1961,2966,0,0,2,0,4
EUW1_6879719303',5,120,19,1,0,2,0,7,0,356,69,31307,31452,39530,4,19,12,1,0,0,0,3,349,94,26569,29628,31174,1,7,-25,4738,7,1824,8356,0,0,2,0,4
EUW1_6879635337',3,25,10,0,0,0,0,9,0,342,76,25374,28481,24910,4,31,13,2,0,1,0,4,334,100,28194,30582,27884,0,8,-24,-2820,-3,-2101,-2974,-2,0,-1,0,5
EUW1_6879572992',5,37,11,2,0,1,0,15,1,351,95,26145,28993,37020,1,17,19,0,0,3,0,6,323,88,32480,30194,32420,0,28,7,-6335,-8,-1201,4600,2,0,-2,0,9
EUW1_6877004039',2,23,9,2,0,0,0,8,1,380,72,25091,30850,27362,0,19,8,0,0,1,0,4,358,104,26295,31522,24274,0,22,-32,-1204,1,-672,3088,2,0,-1,0,4
EUW1_6875861698',2,22,14,0,0,2,0,11,1,385,74,29562,30131,32075,4,39,8,2,1,0,0,7,321,78,24819,27646,28132,1,64,-4,4743,6,2485,3943,-2,-1,2,0,4
EUW1_6875556847',1,73,7,1,0,0,0,11,0,301,82,22975,24938,30678,3,23,25,1,0,1,0,0,341,85,30398,31622,41703,0,-40,-3,-7423,-18,-6684,-11025,0,0,-1,0,11
EUW1_6875509391',1,15,12,0,0,0,0,15,1,316,79,26686,28400,31228,3,39,16,2,0,3,0,3,371,95,31063,32384,29482,0,-55,-16,-4377,-4,-3984,1746,-2,0,-3,0,12
EUW1_6875389544',3,24,6,0,0,1,0,7,0,380,108,26803,29782,25387,4,26,13,1,1,0,0,4,383,96,27767,32841,24879,0,-3,12,-964,-7,-3059,508,-1,-1,1,0,3
EUW1_6874579391',2,21,10,1,0,0,0,9,1,352,94,26346,28681,28142,4,144,17,1,0,1,0,4,354,77,29070,30159,32611,1,-2,17,-2724,-7,-1478,-4469,0,0,-1,0,5
EUW1_6874530666',0,96,9,1,0,0,0,9,1,338,90,25405,29003,26988,1,16,12,1,1,1,0,1,389,94,28545,31920,35665,1,-51,-4,-3140,-3,-2917,-8677,0,-1,-1,0,8
EUW1_6874207403',6,26,13,2,0,0,0,4,0,330,83,27406,28988,35913,5,39,17,0,0,0,0,3,316,88,26724,31302,31746,0,14,-5,682,-4,-2314,4167,2,0,0,0,1
EUW1_6883216018',4,229,10,0,0,0,0,12,1,349,65,25327,28926,27086,3,27,13,0,0,2,0,2,396,102,30247,31582,34855,0,-47,-37,-4920,-3,-2656,-7769,0,0,-2,0,10
EUW1_6882974111',3,28,9,1,1,0,0,8,1,355,86,25973,29049,23876,6,26,13,1,0,4,0,2,403,90,30262,31242,30992,0,-48,-4,-4289,-4,-2193,-7116,0,1,-4,0,6
EUW1_6881612924',4,24,14,1,0,1,0,6,0,379,90,29085,31505,36335,8,30,14,1,0,0,0,4,347,82,28512,29151,30746,0,32,8,573,0,2354,5589,0,0,1,0,2
EUW1_6881554428',2,75,13,0,0,0,0,12,0,334,101,27242,29533,28267,2,26,19,1,0,2,0,4,368,60,31436,30039,36187,0,-34,41,-4194,-6,-506,-7920,-1,0,-2,0,8
EUW1_6879575148',10,45,5,0,0,0,0,8,0,313,73,22736,26785,26697,4,28,14,1,1,2,0,0,370,130,30024,32512,28446,0,-57,-57,-7288,-9,-5727,-1749,-1,-1,-2,0,8
EUW1_6879534951',1,28,15,0,0,0,0,11,1,310,84,27724,28961,42917,4,27,23,2,0,1,0,0,347,104,31069,33912,41501,0,-37,-20,-3345,-8,-4951,1416,-2,0,-1,0,11
EUW1_6879502616',4,26,7,0,0,0,0,5,0,384,78,24573,29330,25745,6,29,11,0,0,0,0,0,388,86,26880,30999,28716,0,-4,-8,-2307,-4,-1669,-2971,0,0,0,0,5
EUW1_6879470227',5,27,10,1,0,0,0,11,1,316,82,26238,27809,22842,3,25,12,0,0,1,0,4,361,80,27938,29843,37544,0,-45,2,-1700,-2,-2034,-14702,1,0,-1,0,7
EUW1_6879447298',2,24,8,1,0,0,0,9,0,320,102,25091,28073,32230,4,27,15,1,0,1,0,5,346,82,27818,30239,29920,0,-26,20,-2727,-7,-2166,2310,0,0,-1,0,4
EUW1_6878163495',5,38,9,0,0,0,0,10,0,348,84,25014,27880,28000,3,185,13,2,0,1,0,3,328,113,28243,29978,34759,0,20,-29,-3229,-4,-2098,-6759,-2,0,-1,0,7
EUW1_6878108529',2,23,12,1,0,1,0,10,1,364,84,28893,31274,32626,2,22,9,1,0,3,0,9,353,91,26532,29385,29173,1,11,-7,2361,3,1889,3453,0,0,-2,0,1
EUW1_6877992737',3,29,16,2,0,0,0,9,0,373,72,28675,31000,41520,2,27,12,0,0,0,0,4,361,87,27384,29021,38660,1,12,-15,1291,4,1979,2860,2,0,0,0,5
EUW1_6877250624',4,68,18,0,0,0,0,11,0,325,65,28497,28212,34772,2,65,14,1,0,1,0,2,332,104,30018,29591,33285,0,-7,-39,-1521,4,-1379,1487,-1,0,-1,0,9
EUW1_6876050937',7,28,18,1,0,2,0,8,0,364,106,30781,32609,33542,0,30,9,1,0,0,0,6,319,90,24918,26690,33148,1,45,16,5863,9,5919,394,0,0,2,0,2
EUW1_6875984959',3,27,15,0,0,1,0,11,0,378,80,31038,30825,37409,5,23,16,2,0,1,0,8,326,111,28527,31359,34469,1,52,-31,2511,-1,-534,2940,-2,0,0,0,3
EUW1_6875591411',8,32,14,1,0,1,0,6,1,389,66,28100,29299,41876,1,19,7,1,0,0,0,5,340,78,23739,26835,24828,1,49,-12,4361,7,2464,17048,0,0,1,0,1
EUW1_6882028663',6,28,18,1,0,1,0,9,1,349,98,29052,30439,41235,3,53,6,0,0,1,0,7,338,82,23087,27270,26906,1,11,16,5965,12,3169,14329,1,0,0,0,2
EUW1_6881950940',2,24,16,0,0,1,0,7,0,344,96,28654,30464,33325,2,31,12,1,0,0,0,5,359,104,27947,30933,31872,1,-15,-8,707,4,-469,1453,-1,0,1,0,2
EUW1_6881816782',6,36,7,2,0,1,0,8,1,370,96,25846,28247,22898,2,44,12,0,0,1,0,7,373,100,27803,30379,25453,1,-3,-4,-1957,-5,-2132,-2555,2,0,0,0,1
EUW1_6878835118',9,32,14,1,0,0,0,8,1,333,103,27191,29146,31452,5,27,9,1,0,0,0,0,360,72,24307,27828,31163,0,-27,31,2884,5,1318,289,0,0,0,0,8
EUW1_6878737620',5,41,7,0,0,1,0,7,0,333,96,25622,28247,28127,3,16,16,2,0,0,0,4,350,108,28417,33148,38698,1,-17,-12,-2795,-9,-4901,-10571,-2,0,1,0,3
EUW1_6878687920',2,25,14,1,0,0,0,8,1,351,95,28784,30347,31026,3,223,12,0,0,0,0,1,248,83,25272,27657,32700,1,103,12,3512,2,2690,-1674,1,0,0,0,7
EUW1_6878314125',4,34,15,1,0,3,0,9,1,357,133,31239,31738,31587,5,32,7,1,0,0,0,8,323,78,25039,26935,25070,1,34,55,6200,8,4803,6517,0,0,3,0,1
EUW1_6878271617',4,52,11,0,0,1,0,16,0,318,74,26311,26957,31752,5,46,15,2,0,2,0,1,346,94,29940,28964,29960,0,-28,-20,-3629,-4,-2007,1792,-2,0,-1,0,15
EUW1_6851377470',2,15,12,1,0,2,0,16,1,360,98,28672,31614,30091,4,24,22,1,0,1,0,4,381,78,31473,33389,37883,0,-21,20,-2801,-10,-1775,-7792,0,0,1,0,12
EUW1_6851311750',1,226,11,1,0,0,0,9,1,374,92,27512,28561,32435,7,43,18,0,1,1,0,2,351,80,29981,30797,36347,0,23,12,-2469,-7,-2236,-3912,1,-1,-1,0,7
EUW1_6851107229',8,30,17,1,1,1,0,6,0,338,103,30449,30993,33261,4,28,9,0,0,1,0,7,327,92,26391,27889,28957,1,11,11,4058,8,3104,4304,1,1,0,0,-1
EUW1_6851049614',3,27,9,0,0,0,0,10,0,306,84,24004,28281,23668,4,65,18,2,0,1,0,0,384,88,30869,32270,36340,0,-78,-4,-6865,-9,-3989,-12672,-2,0,-1,0,10
EUW1_6850990949',3,24,7,0,0,0,0,13,0,301,91,24333,27599,22832,8,37,19,2,0,2,0,1,368,108,31613,33449,37120,0,-67,-17,-7280,-12,-5850,-14288,-2,0,-2,0,12
EUW1_6883785187',3,19,14,1,0,0,0,10,0,329,118,27366,31595,33670,6,34,15,1,0,1,0,4,337,98,29123,31241,35776,0,-8,20,-1757,-1,354,-2106,0,0,-1,0,6
EUW1_6882732750',4,23,10,1,0,0,0,5,0,392,88,27240,31235,27570,1,58,11,1,0,1,0,2,360,92,27826,30975,25184,1,32,-4,-586,-1,260,2386,0,0,-1,0,3
EUW1_6882694818',5,58,7,1,0,1,0,10,0,371,102,27034,29801,24102,7,59,11,1,0,1,0,7,333,86,25241,26560,24282,1,38,16,1793,-4,3241,-180,0,0,0,0,3
EUW1_6882648426',4,28,11,0,0,1,0,7,1,376,84,28761,29561,32300,6,27,9,1,0,0,0,6,340,84,24772,28610,30715,1,36,0,3989,2,951,1585,-1,0,1,0,1
EUW1_6881961459',5,29,21,2,1,2,0,8,1,342,124,31509,32071,38333,5,36,8,0,0,0,0,4,276,62,23663,25049,27234,1,66,62,7846,13,7022,11099,2,1,2,0,4
EUW1_6881805714',3,23,13,2,1,1,0,9,1,381,96,28799,31076,28109,6,102,6,0,0,0,0,4,313,96,23253,26844,23215,0,68,0,5546,7,4232,4894,2,1,1,0,5
EUW1_6881741497',2,28,14,1,0,1,0,6,1,412,102,31092,32623,32297,1,92,10,1,0,0,0,6,343,80,25317,29232,34599,0,69,22,5775,4,3391,-2302,0,0,1,0,0
EUW1_6881589993',4,24,14,0,0,1,0,2,1,338,82,26834,31140,28518,4,28,4,2,0,0,0,1,356,126,23440,28938,25065,1,-18,-44,3394,10,2202,3453,-2,0,1,0,1
EUW1_6881493103',6,26,20,1,0,1,0,13,1,324,82,30384,31050,38435,6,31,12,1,0,1,0,7,334,76,26985,27327,32804,1,-10,6,3399,8,3723,5631,0,0,0,0,6
EUW1_6881416286',3,28,12,1,0,0,0,9,1,307,70,26180,26623,32054,6,37,20,1,0,0,0,1,383,110,30996,32749,39179,0,-76,-40,-4816,-8,-6126,-7125,0,0,0,0,8
EUW1_6881166765',6,33,11,0,0,0,0,1,1,411,80,27356,28836,27164,5,23,10,2,0,0,0,2,358,76,24996,30813,29949,0,53,4,2360,1,-1977,-2785,-2,0,0,0,-1
EUW1_6880698937',5,44,24,2,0,3,0,8,1,367,92,34013,33562,42196,8,36,8,0,0,1,0,10,287,92,23903,26006,25332,1,80,0,10110,16,7556,16864,2,0,2,0,-2
EUW1_6880655278',3,21,21,1,0,1,0,3,0,312,96,30334,29953,43087,5,148,15,1,0,0,0,7,288,96,27079,27278,35160,1,24,0,3255,6,2675,7927,0,0,1,0,-4
EUW1_6880463019',3,50,12,0,0,0,0,16,1,297,84,25823,26604,20928,2,32,10,2,0,3,0,2,327,91,27169,28973,22738,0,-30,-7,-1346,2,-2369,-1810,-2,0,-3,0,14
EUW1_6880405256',3,27,8,0,0,0,0,11,1,367,80,25469,28797,26777,1,24,16,2,0,1,0,3,347,64,28012,28867,34016,0,20,16,-2543,-8,-70,-7239,-2,0,-1,0,8
EUW1_6880342912',8,208,15,1,0,1,0,12,0,334,91,29774,28535,38187,6,28,19,1,1,3,0,5,345,87,31930,31016,36268,0,-11,4,-2156,-4,-2481,1919,0,-1,-2,0,7
EUW1_6880246527',2,16,18,1,0,1,0,10,0,342,104,29746,31829,37930,2,66,13,1,0,0,0,7,313,96,27780,30157,32750,1,29,8,1966,5,1672,5180,0,0,1,0,3
EUW1_6883159070',1,68,16,0,0,3,0,8,0,377,92,32101,32826,38986,1,26,10,2,0,0,0,12,282,84,24131,26978,33018,1,95,8,7970,6,5848,5968,-2,0,3,0,-4
EUW1_6882802398',2,25,8,0,0,0,0,3,0,372,102,25425,29430,22973,4,34,9,1,0,1,0,1,364,88,25725,29168,33528,0,8,14,-300,-1,262,-10555,-1,0,-1,0,2
EUW1_6881620887',6,37,10,1,0,1,0,6,0,394,116,28075,31174,25827,7,31,10,1,0,0,0,2,392,72,26736,28522,33112,1,2,44,1339,0,2652,-7285,0,0,1,0,4
EUW1_6881340105',3,267,20,2,1,0,0,4,1,359,83,30696,29590,34379,7,24,11,0,0,1,0,3,321,80,24917,27273,27905,1,38,3,5779,9,2317,6474,2,1,-1,0,1
EUW1_6880130342',3,49,5,0,0,0,0,10,0,358,84,23815,27317,19700,6,114,17,1,1,1,0,0,395,100,31785,32317,39462,0,-37,-16,-7970,-12,-5000,-19762,-1,-1,-1,0,10
EUW1_6879855895',3,23,9,1,0,0,0,8,0,368,92,25407,30489,30540,4,51,7,1,0,0,0,1,347,88,23446,29265,29142,1,21,4,1961,2,1224,1398,0,0,0,0,7
EUW1_6879512576',4,39,10,1,0,0,0,9,0,362,97,25967,30727,30854,4,23,11,1,0,2,0,1,383,86,27972,30360,31529,1,-21,11,-2005,-1,367,-675,0,0,-2,0,8
EUW1_6878443254',3,59,15,0,0,1,0,15,1,314,102,28505,29711,34425,2,27,15,1,0,1,0,5,373,98,29441,32062,41672,1,-59,4,-936,0,-2351,-7247,-1,0,0,0,10
EUW1_6878004517',6,31,10,1,0,0,0,8,1,340,86,25888,28217,27188,3,23,18,1,0,1,0,4,396,90,30475,32912,39660,0,-56,-4,-4587,-8,-4695,-12472,0,0,-1,0,4
EUW1_6877643570',2,29,13,1,0,0,0,13,1,281,80,26409,26775,28358,3,21,25,0,0,3,0,3,330,91,32122,28501,40438,1,-49,-11,-5713,-12,-1726,-12080,1,0,-3,0,10
EUW1_6876968804',3,23,18,1,0,1,0,12,1,331,90,30566,30168,34371,2,30,18,0,0,1,0,4,314,72,29671,29895,31054,0,17,18,895,0,273,3317,1,0,0,0,8
EUW1_6875839996',8,31,10,1,0,1,0,7,1,392,72,27189,28893,27597,2,23,6,1,0,0,0,4,320,104,24320,28406,25637,1,72,-32,2869,4,487,1960,0,0,1,0,3
EUW1_6875643689',5,39,13,2,0,1,0,3,1,410,92,29947,31461,32437,3,28,6,0,0,0,0,8,350,95,24663,29707,20934,1,60,-3,5284,7,1754,11503,2,0,1,0,-5
EUW1_6875494949',6,59,7,0,1,0,0,7,0,349,85,24553,28474,22780,3,29,12,0,0,1,0,1,426,82,29025,29654,28847,0,-77,3,-4472,-5,-1180,-6067,0,1,-1,0,6
EUW1_6875451326',5,86,17,0,0,0,0,2,0,353,84,29055,28827,37121,4,29,12,2,0,0,0,2,312,79,25985,26213,31421,0,41,5,3070,5,2614,5700,-2,0,0,0,0
EUW1_6875291178',2,19,10,0,1,1,0,9,1,333,128,26504,31024,24029,3,30,16,2,0,0,0,3,396,103,28648,32235,35377,0,-63,25,-2144,-6,-1211,-11348,-2,1,1,0,6
EUW1_6875116375',1,27,10,2,1,1,0,7,1,366,116,28198,29292,26448,6,92,8,0,0,0,0,3,359,84,25552,28277,27513,1,7,32,2646,2,1015,-1065,2,1,1,0,4
EUW1_6874685005',7,31,9,1,1,0,0,1,0,384,112,26184,30291,29912,4,42,9,1,0,0,0,1,409,96,26476,31901,20796,1,-25,16,-292,0,-1610,9116,0,1,0,0,0
EUW1_6874476481',6,30,10,0,0,0,0,9,1,311,81,25237,27204,24620,5,34,15,1,0,2,0,1,312,90,27442,28341,32489,0,-1,-9,-2205,-5,-1137,-7869,-1,0,-2,0,8
EUW1_6881753973',5,68,11,1,1,2,0,8,0,370,72,27522,28442,34526,6,68,12,1,0,0,0,7,375,96,27459,28420,31981,1,-5,-24,63,-1,22,2545,0,1,2,0,1
EUW1_6881701349',2,170,7,0,0,0,0,15,0,358,76,23941,28298,28094,8,43,13,1,0,2,0,0,397,96,30240,31802,33147,0,-39,-20,-6299,-6,-3504,-5053,-1,0,-2,0,15
EUW1_6881641186',5,21,10,0,0,0,0,9,1,346,76,27368,28078,33536,2,54,9,1,0,2,0,9,380,76,26725,29046,25807,0,-34,0,643,1,-968,7729,-1,0,-2,0,0
EUW1_6881606755',5,70,13,0,0,0,0,14,1,321,68,25533,27622,24594,6,37,18,2,0,5,0,4,349,121,32913,33292,37089,0,-28,-53,-7380,-5,-5670,-12495,-2,0,-5,0,10
EUW1_6881490883',5,136,14,0,1,2,0,5,1,323,116,29403,30356,28942,5,28,9,1,0,1,0,11,341,72,26038,29507,30600,0,-18,44,3365,5,849,-1658,-1,1,1,0,-6
EUW1_6881099782',3,23,5,1,0,1,0,7,0,382,86,25278,28875,25363,4,26,9,1,0,1,0,4,365,121,26271,30587,29999,0,17,-35,-993,-4,-1712,-4636,0,0,0,0,3
EUW1_6881058464',5,30,11,1,0,1,0,8,0,365,74,27019,29727,36413,2,47,11,1,0,1,0,2,374,106,27732,32794,36488,1,-9,-32,-713,0,-3067,-75,0,0,0,0,6
EUW1_6881022914',3,25,12,0,0,0,0,9,1,329,81,26198,29194,30215,3,26,16,2,0,1,0,0,337,118,30443,30924,36457,0,-8,-37,-4245,-4,-1730,-6242,-2,0,-1,0,9
EUW1_6880325523',3,52,14,2,0,1,0,6,1,333,83,28493,29077,29423,6,34,6,0,0,1,0,5,376,87,24335,28132,23527,1,-43,-4,4158,8,945,5896,2,0,0,0,1
EUW1_6880227587',9,28,7,2,0,0,0,7,1,348,90,23769,27300,26919,6,32,12,0,1,0,0,3,349,93,27992,28735,32915,1,-1,-3,-4223,-5,-1435,-5996,2,-1,0,0,4
EUW1_6880169917',3,24,12,0,0,2,0,15,0,342,74,28398,28348,32259,7,31,13,2,0,2,0,5,325,128,28649,31112,31883,0,17,-54,-251,-1,-2764,376,-2,0,0,0,10
EUW1_6880110605',0,25,12,1,0,0,0,7,0,309,85,25661,28584,35308,8,28,15,1,0,0,0,2,309,84,27029,28642,31970,0,0,1,-1368,-3,-58,3338,0,0,0,0,5
EUW1_6880055246',5,28,9,0,0,1,0,5,0,401,92,27534,29667,31629,3,22,11,2,0,0,0,4,320,74,25568,28489,31046,1,81,18,1966,-2,1178,583,-2,0,1,0,1
EUW1_6879831956',5,22,7,1,0,0,0,10,0,291,78,22900,26681,22209,5,24,18,1,1,2,0,1,330,90,30235,31726,37564,0,-39,-12,-7335,-11,-5045,-15355,0,-1,-2,0,9
EUW1_6879786588',5,28,12,0,0,3,0,6,0,356,81,30096,31646,31795,6,43,7,1,0,0,0,10,335,105,23198,28218,28343,1,21,-24,6898,5,3428,3452,-1,0,3,0,-4
EUW1_6879728638',4,28,9,0,0,0,0,11,0,364,78,25523,29496,25020,5,21,12,2,0,1,0,2,374,94,29275,30238,37278,0,-10,-16,-3752,-3,-742,-12258,-2,0,-1,0,9
EUW1_6879684116',2,32,7,0,0,0,0,10,1,345,85,24581,28664,22631,6,47,14,1,0,1,0,3,331,114,27709,31849,33764,0,14,-29,-3128,-7,-3185,-11133,-1,0,-1,0,7
EUW1_6883207478',6,92,13,1,0,1,0,9,0,354,84,28556,28829,36276,4,27,11,1,0,1,0,7,329,88,26083,29948,29676,0,25,-4,2473,2,-1119,6600,0,0,0,0,2
EUW1_6882728604',4,28,5,1,1,0,0,8,0,384,104,24702,30707,24089,3,30,5,1,0,1,0,3,384,86,24626,28777,18841,1,0,18,76,0,1930,5248,0,1,-1,0,5
EUW1_6881957058',5,35,4,1,0,0,0,7,0,341,90,22772,27684,23573,4,33,14,1,0,1,0,3,395,85,29433,32660,32436,0,-54,5,-6661,-10,-4976,-8863,0,0,-1,0,4
EUW1_6881871296',5,300,10,1,0,2,0,10,0,377,92,28432,28966,34318,4,26,17,1,0,0,0,8,311,60,27876,28595,29899,0,66,32,556,-7,371,4419,0,0,2,0,2
EUW1_6875542549',3,23,10,2,0,0,0,6,1,354,97,26581,30232,29681,3,21,10,0,0,0,0,0,408,84,26471,30126,32328,1,-54,13,110,0,106,-2647,2,0,0,0,6
EUW1_6875504575',2,59,14,2,0,1,0,5,1,375,104,29646,31440,34636,4,56,3,0,0,0,0,5,374,68,21850,26762,24255,1,1,36,7796,11,4678,10381,2,0,1,0,0
EUW1_6859121394',5,30,13,1,1,2,0,9,0,301,79,28992,29556,28942,2,77,10,1,0,1,0,7,342,84,25477,28827,28382,1,-41,-5,3515,3,729,560,0,1,1,0,2
EUW1_6855121495',4,31,9,0,1,1,0,3,1,386,98,28004,31076,25946,4,141,8,2,0,0,0,6,328,118,24846,30661,28256,0,58,-20,3158,1,415,-2310,-2,1,1,0,-3
EUW1_6854930921',8,34,12,1,0,0,0,6,0,355,72,26136,27335,29643,5,27,11,1,0,2,0,4,357,92,27139,28323,27259,0,-2,-20,-1003,1,-988,2384,0,0,-2,0,2
EUW1_6854885025',3,25,11,2,0,0,0,7,1,368,82,26029,29340,31687,5,47,3,0,1,0,0,1,342,85,23063,28335,22437,1,26,-3,2966,8,1005,9250,2,-1,0,0,6
EUW1_6852654503',2,37,10,1,0,0,0,7,1,379,81,26054,29574,46371,4,30,8,1,0,1,0,2,319,94,25068,29764,25273,0,60,-13,986,2,-190,21098,0,0,-1,0,5
EUW1_6852576743',1,24,16,0,0,0,0,12,1,312,82,27026,29029,33696,5,23,16,2,1,2,0,2,329,98,30513,30480,37175,0,-17,-16,-3487,0,-1451,-3479,-2,-1,-2,0,10
EUW1_6852469249',4,27,15,1,0,1,0,8,0,341,90,29532,28803,40342,5,31,19,1,0,0,0,5,305,81,29851,29933,33373,0,36,9,-319,-4,-1130,6969,0,0,1,0,3
EUW1_6883409916',4,30,6,1,0,0,0,15,1,360,73,24091,29352,23076,6,27,14,1,0,3,0,0,413,139,31742,34602,27444,0,-53,-66,-7651,-8,-5250,-4368,0,0,-3,0,15
EUW1_6883325944',3,26,9,1,1,0,0,11,0,346,68,25489,29744,29566,5,56,11,0,0,2,0,1,344,98,26450,30275,32661,0,2,-30,-961,-2,-531,-3095,1,1,-2,0,10
EUW1_6883232020',5,151,11,0,0,0,0,5,1,370,86,27102,30968,27199,5,29,11,1,0,0,0,3,366,87,25608,29049,26294,0,4,-1,1494,0,1919,905,-1,0,0,0,2
EUW1_6883169541',4,30,10,2,0,0,0,8,0,352,68,25223,27439,23374,2,25,11,0,0,1,0,1,411,116,27971,31819,29676,0,-59,-48,-2748,-1,-4380,-6302,2,0,-1,0,7
EUW1_6883024998',7,73,10,2,0,0,0,11,0,369,109,26530,31175,33314,6,64,16,0,0,1,0,3,378,98,30018,31691,35156,0,-9,11,-3488,-6,-516,-1842,2,0,-1,0,8
EUW1_6882974085',2,23,15,2,0,0,0,8,0,386,95,29208,31466,34814,3,31,9,0,0,0,0,4,375,100,25964,28754,25047,1,11,-5,3244,6,2712,9767,2,0,0,0,4
EUW1_6882921554',5,25,11,1,0,1,0,11,0,352,76,26598,29180,31480,6,290,13,1,0,1,0,5,360,91,28922,29478,27850,1,-8,-15,-2324,-2,-298,3630,0,0,0,0,6
EUW1_6881968653',6,27,8,0,1,0,0,10,0,348,84,25580,27451,23297,2,24,17,1,0,2,0,7,371,115,30384,33711,35198,0,-23,-31,-4804,-9,-6260,-11901,-1,1,-2,0,3
EUW1_6881887096',2,36,14,2,0,2,0,6,1,375,88,29463,30725,30905,4,189,12,0,0,0,0,8,309,88,26397,28648,27093,1,66,0,3066,2,2077,3812,2,0,2,0,-2
EUW1_6881687799',6,31,12,1,0,2,0,6,0,373,96,28393,31638,27638,8,33,4,0,0,0,0,8,330,92,23558,26698,22672,1,43,4,4835,8,4940,4966,1,0,2,0,-2
EUW1_6881624038',5,34,5,0,0,0,0,9,0,409,88,24540,29696,34473,3,33,9,2,0,1,0,1,370,94,26556,28533,32166,0,39,-6,-2016,-4,1163,2307,-2,0,-1,0,8
EUW1_6881323878',4,65,13,1,1,2,0,9,1,394,108,31099,33383,28346,5,62,6,0,0,1,0,7,369,96,24909,29606,23184,1,25,12,6190,7,3777,5162,1,1,1,0,2
EUW1_6881266683',0,22,14,2,0,0,0,3,0,436,95,29343,33688,28262,5,25,7,0,0,1,0,6,342,83,23017,27901,25816,1,94,12,6326,7,5787,2446,2,0,-1,0,-3
EUW1_6881188434',3,28,12,0,0,0,0,10,1,344,98,26924,30811,34078,3,24,20,1,0,0,0,1,358,69,28926,31781,38682,1,-14,29,-2002,-8,-970,-4604,-1,0,0,0,9
EUW1_6881148456',7,26,14,1,1,1,0,10,0,331,94,28182,29570,28933,4,27,11,1,0,0,0,2,342,102,25385,28008,25361,1,-11,-8,2797,3,1562,3572,0,1,1,0,8
EUW1_6881094104',4,22,16,1,0,1,0,9,0,346,111,30660,33579,36703,3,26,14,1,0,1,0,6,377,112,28689,30235,31103,1,-31,-1,1971,2,3344,5600,0,0,0,0,3
EUW1_6881055254',5,27,11,0,0,0,0,10,0,340,108,26658,29721,28966,4,28,16,2,0,1,0,2,344,76,28906,30238,34659,0,-4,32,-2248,-5,-517,-5693,-2,0,-1,0,8
EUW1_6880180693',3,27,6,1,0,0,0,5,0,354,106,23973,27744,25832,3,33,7,1,0,0,0,4,355,90,25463,30219,19114,0,-1,16,-1490,-1,-2475,6718,0,0,0,0,1
EUW1_6880038181',5,26,12,1,0,1,0,7,1,349,82,26931,28565,29537,5,26,12,1,0,1,0,5,375,97,27837,30377,32138,1,-26,-15,-906,0,-1812,-2601,0,0,0,0,2
EUW1_6881283794',5,33,7,0,0,0,0,8,0,338,81,24323,27669,25268,5,25,13,1,0,2,0,2,387,85,28614,30544,27865,0,-49,-4,-4291,-6,-2875,-2597,-1,0,-2,0,6
EUW1_6881227914',6,29,15,1,0,1,0,6,1,373,79,29597,31155,33953,6,27,6,0,0,0,0,5,351,80,24212,27467,23690,1,22,-1,5385,9,3688,10263,1,0,1,0,1
EUW1_6881193867',5,36,26,1,1,1,0,8,1,330,90,35645,31036,38684,2,24,6,0,0,2,0,8,284,90,22377,23808,19380,1,46,0,13268,20,7228,19304,1,1,-1,0,0
EUW1_6881125243',0,21,12,2,0,1,0,10,0,351,86,28111,28004,25871,6,28,13,0,1,1,0,3,331,82,29253,27220,34243,0,20,4,-1142,-1,784,-8372,2,-1,0,0,7
EUW1_6881070947',6,30,15,2,0,0,0,14,1,364,79,29331,32529,31182,5,29,15,0,1,2,0,2,389,108,30766,33284,34914,0,-25,-29,-1435,0,-755,-3732,2,-1,-2,0,12
EUW1_6880213084',4,73,18,2,0,1,0,6,1,333,83,29306,30151,47327,2,25,13,0,1,0,0,3,319,84,27758,29345,35781,0,14,-1,1548,5,806,11546,2,-1,1,0,3
EUW1_6880143596',5,22,13,0,0,0,0,10,0,300,80,26653,27182,28077,6,28,13,2,0,0,0,4,356,64,27170,29603,30780,1,-56,16,-517,0,-2421,-2703,-2,0,0,0,6
EUW1_6877993157',3,34,7,0,0,0,0,13,0,327,68,23716,26816,21412,4,40,16,2,0,3,0,1,387,132,30848,31527,32215,0,-60,-64,-7132,-9,-4711,-10803,-2,0,-3,0,12
EUW1_6877978519',7,32,14,1,0,2,0,9,1,364,97,29305,31775,27546,7,35,6,1,0,0,0,6,368,70,24197,27586,21630,1,-4,27,5108,8,4189,5916,0,0,2,0,3
EUW1_6877962024',2,33,20,1,0,2,0,7,0,392,108,33070,34413,42001,3,26,11,1,0,0,0,2,331,72,25974,29554,29414,1,61,36,7096,9,4859,12587,0,0,2,0,5
EUW1_6876543471',8,47,10,1,0,0,0,10,1,364,82,26638,29947,27974,5,33,15,1,0,0,0,4,372,100,28579,31608,32965,1,-8,-18,-1941,-5,-1661,-4991,0,0,0,0,6
EUW1_6882050498',3,19,14,0,0,1,0,9,0,311,62,27826,28448,32667,2,27,21,2,1,2,0,3,352,92,31024,31829,40161,1,-41,-30,-3198,-7,-3381,-7494,-2,-1,-1,0,6
EUW1_6882010472',4,103,24,2,0,0,0,9,1,364,86,32643,31449,41567,3,25,4,0,0,2,0,6,294,86,21937,24471,28679,1,70,0,10706,20,6978,12888,2,0,-2,0,3
EUW1_6881932010',3,19,14,1,0,0,0,8,0,342,104,28115,30677,34515,5,81,17,1,0,0,0,6,327,80,28389,30623,34423,0,15,24,-274,-3,54,92,0,0,0,0,2
EUW1_6881608092',2,23,19,1,0,1,0,9,1,352,86,30127,30949,36472,4,328,12,1,0,1,0,5,366,102,28357,30446,28958,1,-14,-16,1770,7,503,7514,0,0,0,0,4
EUW1_6881512780',3,56,13,0,0,1,0,10,1,303,86,27195,28021,36090,1,122,13,1,1,1,0,5,355,95,28998,32010,40383,0,-52,-9,-1803,0,-3989,-4293,-1,-1,0,0,5
EUW1_6880377170',2,32,16,2,0,1,0,10,1,339,92,29675,30853,36985,2,17,19,0,0,1,0,2,348,76,29221,29562,36863,1,-9,16,454,-3,1291,122,2,0,0,0,8
EUW1_6880307952',2,24,13,1,0,0,0,12,0,319,75,26751,27144,27962,2,26,16,1,0,1,0,3,367,116,30957,31546,39924,0,-48,-41,-4206,-3,-4402,-11962,0,0,-1,0,9
EUW1_6880178484',4,29,15,1,0,0,0,14,1,286,72,27806,26931,25576,3,34,14,0,1,2,0,2,397,128,31942,32395,36967,0,-111,-56,-4136,1,-5464,-11391,1,-1,-2,0,12
EUW1_6879744558',5,28,8,0,0,0,0,6,1,354,76,24413,27182,29486,4,24,22,2,0,0,0,1,338,117,29727,32108,33812,0,16,-41,-5314,-14,-4926,-4326,-2,0,0,0,5
EUW1_6879683369',6,25,8,0,0,0,0,10,0,339,74,24583,28917,19572,5,30,15,2,0,2,0,2,378,92,30399,29486,32651,0,-39,-18,-5816,-7,-569,-13079,-2,0,-2,0,8
EUW1_6879291520',4,33,13,1,0,1,0,8,0,351,83,28101,29569,34177,6,31,16,1,1,0,0,2,348,56,28399,30417,34364,0,3,27,-298,-3,-848,-187,0,-1,1,0,6
EUW1_6876843270',7,37,11,0,0,0,0,12,0,329,66,27062,29541,28964,3,31,12,0,0,0,0,2,344,77,26484,29630,31364,0,-15,-11,578,-1,-89,-2400,0,0,0,0,10
EUW1_6876797441',5,26,6,1,0,0,0,10,0,345,78,23323,27559,25831,3,19,11,0,0,1,0,2,360,100,27288,29488,35613,0,-15,-22,-3965,-5,-1929,-9782,1,0,-1,0,8
EUW1_6876754370',4,45,14,0,0,0,0,14,0,377,97,28715,30263,32958,7,53,12,2,0,2,0,2,364,78,28245,28543,28743,0,13,19,470,2,1720,4215,-2,0,-2,0,12
EUW1_6876617646',2,23,22,1,0,2,0,7,0,403,114,33129,33829,38039,5,24,8,1,0,1,0,6,322,74,25159,26875,23110,1,81,40,7970,14,6954,14929,0,0,1,0,1
EUW1_6876374966',2,88,13,2,0,2,0,8,1,355,106,28551,30581,32210,3,28,7,0,1,1,0,4,341,100,24695,29823,26371,1,14,6,3856,6,758,5839,2,-1,1,0,4
EUW1_6876350073',2,25,14,1,0,1,0,7,1,359,86,28167,30728,31375,5,27,9,0,0,1,0,7,350,82,26641,29236,32250,1,9,4,1526,5,1492,-875,1,0,0,0,0
EUW1_6876309754',4,22,6,1,1,0,0,8,1,377,80,24989,29690,27487,4,96,10,1,0,1,0,2,367,88,26676,29985,31462,0,10,-8,-1687,-4,-295,-3975,0,1,-1,0,6
EUW1_6876258413',2,27,6,0,0,0,0,6,0,340,105,23993,29115,28106,4,21,16,1,0,0,0,2,374,76,28127,30902,29346,0,-34,29,-4134,-10,-1787,-1240,-1,0,0,0,4
EUW1_6883649862',4,27,23,2,0,1,0,8,0,363,78,32390,32700,39447,3,31,15,0,0,0,0,4,369,80,28735,29154,31013,0,-6,-2,3655,8,3546,8434,2,0,1,0,4
EUW1_6883631161',3,31,16,2,0,1,0,11,1,345,94,29410,30575,37164,6,103,14,0,0,1,0,2,332,86,27771,28391,31617,1,13,8,1639,2,2184,5547,2,0,0,0,9
EUW1_6883584213',2,138,10,0,1,0,0,7,1,315,92,24689,27524,30824,1,22,11,2,0,0,0,1,372,78,26401,29641,31388,1,-57,14,-1712,-1,-2117,-564,-2,1,0,0,6
EUW1_6883554929',3,29,11,1,0,0,0,9,0,351,103,27331,31707,25961,7,28,15,1,0,1,0,2,406,97,29376,30687,31188,0,-55,6,-2045,-4,1020,-5227,0,0,-1,0,7
EUW1_6883512054',1,29,12,1,0,0,0,5,1,330,99,27173,29614,37720,4,34,16,1,0,0,0,3,357,88,28657,29807,37493,0,-27,11,-1484,-4,-193,227,0,0,0,0,2
EUW1_6883466250',5,33,16,1,0,0,0,4,1,382,104,28458,31831,33045,3,94,5,0,0,0,0,5,319,104,22896,28152,19815,1,63,0,5562,11,3679,13230,1,0,0,0,-1
EUW1_6882166123',5,25,16,0,0,2,0,10,0,337,78,29051,28633,33208,3,37,16,1,0,1,0,5,332,94,29420,30092,32814,0,5,-16,-369,0,-1459,394,-1,0,1,0,5
EUW1_6882046228',6,31,16,2,0,1,0,3,1,346,93,28062,30362,36705,9,30,5,0,1,0,0,3,324,83,22101,28463,22752,1,22,10,5961,11,1899,13953,2,-1,1,0,0
EUW1_6881976929',0,23,8,1,0,0,0,12,0,358,100,24251,30743,25966,1,27,13,1,1,1,0,1,380,92,28174,32284,31739,0,-22,8,-3923,-5,-1541,-5773,0,-1,-1,0,11
EUW1_6881898807',2,22,8,1,0,0,0,12,0,326,82,25282,29872,31801,4,26,17,1,0,1,0,3,363,113,29529,32877,33982,1,-37,-31,-4247,-9,-3005,-2181,0,0,-1,0,9
EUW1_6881750277',4,28,11,0,0,0,0,11,1,349,94,26519,29119,30671,4,143,11,2,0,2,0,1,316,98,26801,28825,31507,0,33,-4,-282,0,294,-836,-2,0,-2,0,10
EUW1_6881690057',0,27,7,1,0,0,0,12,0,314,76,23660,26615,26116,4,33,22,1,0,2,0,3,357,100,31747,31731,42690,0,-43,-24,-8087,-15,-5116,-16574,0,0,-2,0,9
EUW1_6881636974',7,24,8,0,0,1,0,12,1,336,82,25520,29085,24511,3,33,11,2,1,1,0,4,393,114,27485,32550,33810,0,-57,-32,-1965,-3,-3465,-9299,-2,-1,0,0,8
EUW1_6881525452',4,28,15,1,0,0,0,8,1,294,104,26404,30825,33621,3,30,10,0,0,1,0,0,357,96,27096,30066,32310,1,-63,8,-692,5,759,1311,1,0,-1,0,8
EUW1_6880776640',4,20,13,2,0,1,0,9,0,309,84,27232,28785,27569,5,21,14,0,0,0,0,6,333,83,27294,27749,34387,1,-24,1,-62,-1,1036,-6818,2,0,1,0,3
EUW1_6883149395',1,25,20,0,0,3,0,8,1,362,99,32029,29803,41810,1,117,17,2,0,1,0,9,267,78,27678,28102,32795,1,95,21,4351,3,1701,9015,-2,0,2,0,-1
EUW1_6883100294',2,27,15,1,0,1,0,10,1,307,67,28274,28459,34265,1,95,17,1,0,1,0,8,303,80,28377,28661,33560,0,4,-13,-103,-2,-202,705,0,0,0,0,2
EUW1_6882508494',0,28,18,1,0,3,0,7,1,349,93,32014,31494,34167,3,63,13,1,0,2,0,8,333,89,27690,29061,32490,0,16,4,4324,5,2433,1677,0,0,1,0,-1
EUW1_6882479918',3,39,15,0,0,1,0,8,0,309,75,26580,26696,31149,5,30,14,2,0,1,0,6,304,88,29133,27870,32452,0,5,-13,-2553,1,-1174,-1303,-2,0,0,0,2
EUW1_6882457025',7,26,15,1,0,2,0,5,1,367,90,28470,30761,33680,3,31,6,1,0,0,0,5,362,97,25195,29702,25881,0,5,-7,3275,9,1059,7799,0,0,2,0,0
EUW1_6882008220',9,31,11,1,1,1,0,7,1,401,89,28651,29527,26533,4,97,3,0,0,1,0,8,341,94,23048,27010,18907,1,60,-5,5603,8,2517,7626,1,1,0,0,-1
EUW1_6883532957',6,26,12,0,0,1,0,6,1,380,99,28547,31185,35113,7,34,12,2,0,0,0,6,338,67,26190,28533,30531,1,42,32,2357,0,2652,4582,-2,0,1,0,0
EUW1_6883498620',4,26,11,0,0,1,0,4,0,357,95,28819,27432,32883,3,24,17,1,0,1,0,8,326,84,27695,28715,34268,0,31,11,1124,-6,-1283,-1385,-1,0,0,0,-4
EUW1_6883455625',4,30,24,0,1,2,0,8,0,355,92,33140,32317,43540,1,28,9,2,0,1,0,7,362,116,27792,29215,33550,1,-7,-24,5348,15,3102,9990,-2,1,1,0,1
EUW1_6883405290',3,24,11,1,0,1,0,11,1,369,108,29077,29493,22589,2,22,15,0,0,1,0,4,350,100,29724,32236,33651,0,19,8,-647,-4,-2743,-11062,1,0,0,0,7
EUW1_6883354285',2,25,8,1,0,0,0,11,0,309,68,24063,26995,30630,3,142,18,0,1,1,0,1,344,84,29937,31362,39039,0,-35,-16,-5874,-10,-4367,-8409,1,-1,-1,0,10
EUW1_6883037165',3,31,9,0,0,0,0,6,1,354,96,24980,29592,26217,3,24,10,2,0,0,0,2,356,96,26282,30380,31284,1,-2,0,-1302,-1,-788,-5067,-2,0,0,0,4
EUW1_6882982218',4,26,10,0,0,0,0,14,0,340,80,26305,29485,29835,9,35,14,2,0,2,0,2,362,76,29605,29743,29425,0,-22,4,-3300,-4,-258,410,-2,0,-2,0,12
EUW1_6882915278',6,31,15,1,0,0,0,7,1,355,78,27765,29556,32622,2,23,5,0,0,0,0,2,351,78,23809,28041,22214,1,4,0,3956,10,1515,10408,1,0,0,0,5
EUW1_6880554881',0,50,8,1,0,0,0,4,0,378,78,24580,28322,24627,2,24,11,1,0,1,0,3,370,114,28070,31333,30921,0,8,-36,-3490,-3,-3011,-6294,0,0,-1,0,1
EUW1_6880408501',7,31,10,1,0,0,0,6,0,374,98,26873,30088,35249,3,137,9,0,0,0,0,3,361,109,26321,30977,35375,1,13,-11,552,1,-889,-126,1,0,0,0,3
EUW1_6880317049',4,24,14,0,0,0,0,4,1,385,103,29126,31377,28839,5,22,14,2,0,0,0,0,343,72,27389,28658,30336,0,42,31,1737,0,2719,-1497,-2,0,0,0,4
EUW1_6880250460',1,24,9,1,0,0,0,4,1,383,84,26134,29073,30051,5,29,14,0,0,0,0,3,343,92,27337,31876,28278,1,40,-8,-1203,-5,-2803,1773,1,0,0,0,1
EUW1_6879921696',4,24,13,2,0,1,0,7,1,356,86,28785,29498,30587,4,44,6,0,0,2,0,8,337,94,23899,29014,24378,1,19,-8,4886,7,484,6209,2,0,-1,0,-1
EUW1_6879860111',3,21,8,1,0,0,0,9,1,331,65,24023,26828,26621,2,24,15,1,0,1,0,1,367,94,29804,31257,37310,0,-36,-29,-5781,-7,-4429,-10689,0,0,-1,0,8
EUW1_6879782356',3,21,20,0,1,0,0,6,1,344,104,29882,32514,40054,1,18,13,1,0,0,0,5,362,87,27522,28377,34830,1,-18,17,2360,7,4137,5224,-1,1,0,0,1
EUW1_6879737610',6,27,15,2,0,1,0,6,0,349,92,28623,30375,34161,6,243,9,0,0,0,0,5,344,76,24574,27451,30648,0,5,16,4049,6,2924,3513,2,0,1,0,1
EUW1_6879685797',6,34,12,0,0,0,0,4,0,350,81,27218,28559,26661,2,20,16,1,0,1,0,1,368,78,30504,30371,37041,0,-18,3,-3286,-4,-1812,-10380,-1,0,-1,0,3
EUW1_6879115339',5,29,9,1,0,1,0,9,0,389,85,26788,31021,30379,2,18,10,0,0,1,0,2,403,74,27995,31570,35639,1,-14,11,-1207,-1,-549,-5260,1,0,0,0,7
EUW1_6879078813',3,24,1,0,0,0,0,11,0,330,78,21978,26579,24073,4,45,16,1,1,1,0,3,385,102,30382,33201,30296,0,-55,-24,-8404,-15,-6622,-6223,-1,-1,-1,0,8
EUW1_6883432019',4,28,17,0,0,1,0,10,1,245,84,28039,24423,35703,0,14,15,0,0,2,0,5,309,84,28929,26900,35943,0,-64,0,-890,2,-2477,-240,0,0,-1,0,5
EUW1_6883396514',3,30,17,2,0,3,0,2,1,398,88,31719,32270,35138,2,31,4,0,0,0,0,12,316,96,21840,26037,16731,1,82,-8,9879,13,6233,18407,2,0,3,0,-10
EUW1_6883341789',3,23,15,0,0,0,0,7,1,350,98,29324,29815,34674,5,30,15,2,0,1,0,5,323,93,26725,29473,35349,0,27,5,2599,0,342,-675,-2,0,-1,0,2
EUW1_6883267479',2,21,10,0,0,0,0,3,1,416,88,26568,31340,31308,3,25,5,0,0,0,0,3,348,90,22713,28364,24384,1,68,-2,3855,5,2976,6924,0,0,0,0,0
EUW1_6882871565',0,48,9,1,0,0,0,15,1,328,86,24739,28451,29100,3,27,13,0,0,1,0,0,388,82,28342,30588,32663,0,-60,4,-3603,-4,-2137,-3563,1,0,-1,0,15
EUW1_6882812296',5,72,11,1,0,1,0,7,0,365,96,26741,29534,31185,4,27,11,1,0,1,0,3,335,80,26817,28356,25698,0,30,16,-76,0,1178,5487,0,0,0,0,4
EUW1_6882780806',5,28,13,0,0,1,0,13,0,314,84,28352,28767,31131,2,25,16,2,0,1,0,0,344,74,29326,29061,34321,0,-30,10,-974,-3,-294,-3190,-2,0,0,0,13
EUW1_6882738894',3,20,15,2,0,1,0,11,0,333,84,28908,28406,33580,4,28,18,0,0,0,0,1,307,104,28777,30356,37486,1,26,-20,131,-3,-1950,-3906,2,0,1,0,10
EUW1_6882692128',5,28,9,1,0,0,0,9,0,336,110,24824,28893,26776,4,24,8,1,0,2,0,2,373,106,27240,28612,23525,0,-37,4,-2416,1,281,3251,0,0,-2,0,7
EUW1_6882532293',5,77,16,0,0,0,0,7,1,359,71,27306,30192,29653,7,32,14,1,1,0,0,3,378,83,28533,30686,31912,0,-19,-12,-1227,2,-494,-2259,-1,-1,0,0,4
EUW1_6882507518',1,18,8,0,0,0,0,13,1,374,78,25213,27845,27625,9,30,17,2,0,1,0,2,337,80,28917,31615,30946,0,37,-2,-3704,-9,-3770,-3321,-2,0,-1,0,11
EUW1_6882473135',3,27,12,0,0,0,0,5,0,324,76,25537,27791,25988,9,49,12,1,0,0,0,5,336,92,27103,29040,32432,0,-12,-16,-1566,0,-1249,-6444,-1,0,0,0,0
EUW1_6882154482',2,77,12,0,0,0,0,9,1,303,84,25976,29434,34433,8,40,11,2,0,1,0,2,400,99,28857,30382,23972,1,-97,-15,-2881,1,-948,10461,-2,0,-1,0,7
EUW1_6882095102',5,30,8,0,0,0,0,11,0,355,74,24822,28811,25819,3,29,20,1,0,2,0,4,351,99,30766,32249,45324,0,4,-25,-5944,-12,-3438,-19505,-1,0,-2,0,7
EUW1_6881049829',1,25,12,1,0,1,0,9,0,368,110,27996,30963,32471,3,28,12,1,0,1,0,4,331,92,27665,29515,26156,1,37,18,331,0,1448,6315,0,0,0,0,5
EUW1_6880619978',2,20,13,2,1,2,0,9,1,356,98,29496,29551,33381,2,23,11,0,0,0,0,4,323,88,26201,28036,27739,1,33,10,3295,2,1515,5642,2,1,2,0,5
EUW1_6880548187',2,42,22,0,1,1,0,12,1,299,94,30118,29849,38887,7,26,16,0,0,0,0,2,282,96,26711,28433,31769,1,17,-2,3407,6,1416,7118,0,1,1,0,10
EUW1_6876152564',8,35,16,1,0,0,0,6,1,291,73,27405,28014,37652,1,23,9,0,0,0,0,4,306,102,24475,27285,32472,1,-15,-29,2930,7,729,5180,1,0,0,0,2
EUW1_6881307115',5,23,9,1,0,0,0,11,1,350,81,25578,28856,26668,4,25,11,0,0,2,0,2,372,78,27562,30277,31260,1,-22,3,-1984,-2,-1421,-4592,1,0,-2,0,9
EUW1_6881252476',4,20,12,2,0,0,0,8,0,363,80,27972,28700,32757,3,27,12,0,0,1,0,3,359,80,26304,29666,31279,0,4,0,1668,0,-966,1478,2,0,-1,0,5
EUW1_6880721044',1,25,23,0,0,5,0,7,0,382,110,35492,32619,41394,6,24,15,1,0,1,0,10,251,80,26715,23937,31838,1,131,30,8777,8,8682,9556,-1,0,4,0,-3
EUW1_6880693109',1,19,18,1,0,0,0,6,1,357,90,30859,33417,29366,1,43,13,1,0,2,0,5,359,85,28928,31146,35110,1,-2,5,1931,5,2271,-5744,0,0,-2,0,1
EUW1_6880662861',4,57,11,2,1,0,0,7,1,356,106,25872,32068,27785,1,134,5,0,0,0,0,1,406,94,24508,29826,19738,1,-50,12,1364,6,2242,8047,2,1,0,0,6
EUW1_6880618676',2,26,15,0,0,1,0,14,0,331,99,28181,30798,37309,5,145,14,2,0,2,0,6,346,83,29649,31554,39052,0,-15,16,-1468,1,-756,-1743,-2,0,-1,0,8
EUW1_6880552039',5,333,10,1,0,0,0,7,0,341,82,25563,27675,35077,2,31,15,1,0,0,0,4,340,90,27254,30380,42224,0,1,-8,-1691,-5,-2705,-7147,0,0,0,0,3
EUW1_6877105933',4,36,10,1,0,0,0,12,0,342,65,27064,26980,28501,6,28,20,0,0,2,0,3,352,80,30821,30410,35879,0,-10,-15,-3757,-10,-3430,-7378,1,0,-2,0,9
EUW1_6876250538',3,45,13,0,0,0,0,9,0,353,80,27475,30008,27127,7,23,20,1,1,1,0,5,362,94,31913,32882,43142,0,-9,-14,-4438,-7,-2874,-16015,-1,-1,-1,0,4
EUW1_6876180442',4,24,4,0,0,0,0,11,1,357,84,22992,27951,26693,2,28,9,2,0,1,0,0,390,83,26679,31277,27982,0,-33,1,-3687,-5,-3326,-1289,-2,0,-1,0,11
EUW1_6876038933',4,38,16,1,0,0,0,11,1,358,69,28598,30521,35151,2,25,13,1,0,0,0,2,356,105,28914,29874,30944,0,2,-36,-316,3,647,4207,0,0,0,0,9
EUW1_6872597263',1,30,22,1,0,3,1,6,1,372,80,32864,30036,36904,1,38,7,0,0,1,0,9,363,60,23844,27072,23689,1,9,20,9020,15,2964,13215,1,0,2,1,-3
EUW1_6872541509',5,104,14,0,0,1,0,14,0,295,72,27513,29002,36563,3,70,23,1,0,2,0,2,353,92,33451,30511,42596,0,-58,-20,-5938,-9,-1509,-6033,-1,0,-1,0,12
EUW1_6872499217',2,29,11,1,0,1,0,11,0,358,97,28377,30458,26360,0,22,19,0,0,0,0,7,374,94,30211,31764,42581,0,-16,3,-1834,-8,-1306,-16221,1,0,1,0,4
EUW1_6881721883',2,28,8,0,0,0,0,10,0,349,74,25166,28554,25030,5,23,10,2,0,0,0,4,374,98,26650,30352,25769,0,-25,-24,-1484,-2,-1798,-739,-2,0,0,0,6
EUW1_6881268947',1,32,15,2,0,0,0,8,0,347,60,27022,28204,37883,3,26,12,0,0,0,0,2,349,71,26553,28193,32693,1,-2,-11,469,3,11,5190,2,0,0,0,6
EUW1_6881193933',4,23,13,1,1,1,0,11,1,351,68,28550,29236,31335,5,37,11,0,0,0,0,5,375,112,27424,31115,27251,0,-24,-44,1126,2,-1879,4084,1,1,1,0,6
EUW1_6881163568',8,29,17,0,0,2,0,6,1,331,70,29945,29304,45133,3,22,8,1,0,1,0,5,334,76,24071,27579,31130,1,-3,-6,5874,9,1725,14003,-1,0,1,0,1
EUW1_6881107580',6,32,11,1,0,0,0,5,1,358,108,26903,31459,32341,4,29,11,1,0,0,0,1,388,95,27390,31658,30517,0,-30,13,-487,0,-199,1824,0,0,0,0,4
EUW1_6881062878',5,27,10,0,1,1,0,9,0,312,78,25955,28571,33243,2,23,10,2,0,0,0,2,340,102,26672,29583,26674,0,-28,-24,-717,0,-1012,6569,-2,1,1,0,7
EUW1_6881038597',3,30,3,1,0,0,0,10,0,365,62,21695,26810,17845,3,21,10,1,1,2,0,3,390,103,28953,31495,22257,0,-25,-41,-7258,-7,-4685,-4412,0,-1,-2,0,7
EUW1_6880645239',4,26,8,1,0,0,0,9,1,385,78,25686,29671,22033,1,190,4,0,0,1,0,3,362,98,24742,28724,17849,1,23,-20,944,4,947,4184,1,0,-1,0,6
EUW1_6880599430',6,29,5,2,0,0,0,11,0,379,80,23192,29609,23448,4,28,9,0,1,1,0,0,376,96,26862,30987,25114,0,3,-16,-3670,-4,-1378,-1666,2,-1,-1,0,11
EUW1_6880556963',3,119,11,0,0,1,0,9,0,333,78,27467,27415,32862,3,29,14,1,0,0,0,8,343,77,27835,28351,31922,0,-10,1,-368,-3,-936,940,-1,0,1,0,1
EUW1_6880248184',3,25,14,1,0,1,0,6,1,369,102,28567,32038,26276,2,27,3,0,0,0,0,5,341,90,22912,27713,18928,1,28,12,5655,11,4325,7348,1,0,1,0,1
EUW1_6880196752',5,26,9,0,0,0,0,13,0,336,68,25555,26972,28428,5,40,19,2,0,2,0,0,390,86,31125,31347,35347,0,-54,-18,-5570,-10,-4375,-6919,-2,0,-2,0,13
EUW1_6880141695',5,37,17,0,0,0,0,9,1,342,84,28138,29400,31053,4,29,18,2,0,2,0,0,397,83,32106,33316,43954,0,-55,1,-3968,-1,-3916,-12901,-2,0,-2,0,9
EUW1_6880080171',1,24,10,0,0,0,0,8,0,375,78,27263,28955,26128,7,29,12,2,0,0,0,2,382,94,27717,27450,27471,1,-7,-16,-454,-2,1505,-1343,-2,0,0,0,6
EUW1_6879963647',3,26,10,1,0,2,0,8,1,381,71,27543,30701,28175,4,23,8,0,0,0,0,3,349,112,25588,29018,22500,1,32,-41,1955,2,1683,5675,1,0,2,0,5
EUW1_6879913575',4,36,6,1,0,0,0,13,0,355,96,23677,29480,22033,5,34,7,1,0,1,0,0,363,108,25631,29406,27741,0,-8,-12,-1954,-1,74,-5708,0,0,-1,0,13
EUW1_6879836169',5,23,14,2,0,1,0,6,1,379,98,29227,32619,30823,5,31,8,0,0,0,0,6,378,86,26347,29983,26490,1,1,12,2880,6,2636,4333,2,0,1,0,0
EUW1_6883249354',7,33,7,0,0,0,0,6,0,326,94,23823,27354,32758,3,30,16,0,0,1,0,2,340,70,28361,31633,32986,0,-14,24,-4538,-9,-4279,-228,0,0,-1,0,4
EUW1_6883193534',3,28,15,1,0,1,0,10,1,350,89,28390,29420,33093,3,25,11,0,0,0,0,3,339,76,25802,29360,27815,1,11,13,2588,4,60,5278,1,0,1,0,7
EUW1_6881812073',4,28,18,0,0,1,0,7,1,376,102,30462,31895,36247,4,21,8,1,0,1,0,7,320,82,24711,27033,28202,1,56,20,5751,10,4862,8045,-1,0,0,0,0
EUW1_6880444509',3,152,11,1,0,0,0,8,1,306,88,25818,25963,24702,6,30,16,0,0,2,0,4,373,88,29287,30581,32742,0,-67,0,-3469,-5,-4618,-8040,1,0,-2,0,4
EUW1_6879992500',2,29,17,0,0,2,0,13,0,345,100,31372,31288,38057,9,30,13,2,0,1,0,1,362,75,27995,28654,32195,0,-17,25,3377,4,2634,5862,-2,0,1,0,12
EUW1_6879933907',4,27,7,0,0,1,0,6,0,326,76,24822,25129,24889,2,31,13,2,0,0,0,2,339,94,25350,27905,32746,0,-13,-18,-528,-6,-2776,-7857,-2,0,1,0,4
EUW1_6879145894',6,23,13,0,0,0,0,6,0,324,76,26717,30231,30808,4,27,13,1,0,0,0,3,372,92,27382,30969,34081,1,-48,-16,-665,0,-738,-3273,-1,0,0,0,3
EUW1_6878701166',3,127,6,0,0,0,0,11,1,361,64,23086,26746,27864,1,29,11,2,1,2,0,2,417,112,29428,33486,28911,0,-56,-48,-6342,-5,-6740,-1047,-2,-1,-2,0,9
EUW1_6878662786',3,25,11,1,0,1,0,7,1,329,94,28988,29848,34584,6,28,18,1,0,0,0,6,314,61,27619,29109,36569,0,15,33,1369,-7,739,-1985,0,0,1,0,1
EUW1_6852345427',3,57,7,2,0,0,0,12,1,349,92,25512,28398,26745,3,97,10,0,0,2,0,2,390,88,25925,30079,24651,1,-41,4,-413,-3,-1681,2094,2,0,-2,0,10
EUW1_6851244970',1,29,18,0,0,1,0,9,1,355,86,31611,30610,40176,5,28,13,2,0,1,0,7,327,73,26960,27427,27966,0,28,13,4651,5,3183,12210,-2,0,0,0,2
EUW1_6851185517',4,31,13,1,0,0,0,8,1,325,80,27295,27901,32853,8,28,17,1,0,0,0,3,337,85,28532,29688,40287,0,-12,-5,-1237,-4,-1787,-7434,0,0,0,0,5
EUW1_6850358711',4,26,20,2,0,1,0,5,1,348,83,29456,32100,39331,1,20,7,0,0,0,0,4,300,72,23240,26335,22337,1,48,11,6216,13,5765,16994,2,0,1,0,1
EUW1_6849786802',2,20,7,1,0,0,0,7,1,317,86,23502,27425,26011,3,19,18,1,0,2,0,2,402,98,30617,35686,44513,0,-85,-12,-7115,-11,-8261,-18502,0,0,-2,0,5
EUW1_6849697324',4,60,15,1,0,1,0,10,1,320,83,27481,29510,34072,0,32,13,1,0,1,0,4,348,91,28507,30917,36116,0,-28,-8,-1026,2,-1407,-2044,0,0,0,0,6
EUW1_6831640179',5,41,11,0,0,0,0,11,0,352,80,27533,30528,27728,10,31,16,2,0,1,0,1,415,96,29790,31238,35114,0,-63,-16,-2257,-5,-710,-7386,-2,0,-1,0,10
EUW1_6821057327',7,135,10,2,0,1,0,6,1,373,86,27054,31104,24231,6,24,4,0,0,1,0,3,379,106,24499,30734,26306,1,-6,-20,2555,6,370,-2075,2,0,0,0,3
EUW1_6820991436',4,28,8,0,0,2,0,4,1,425,76,27547,31443,21361,2,113,7,2,0,0,0,7,375,128,25805,31556,17098,0,50,-52,1742,1,-113,4263,-2,0,2,0,-3
EUW1_6883788537',3,29,13,1,0,1,0,5,0,345,98,28794,30359,33186,0,28,10,1,0,1,0,7,299,81,25160,27752,26913,1,46,17,3634,3,2607,6273,0,0,0,0,-2
EUW1_6883752048',4,42,11,2,0,0,0,11,0,316,78,25546,27957,27732,3,29,14,0,0,2,0,3,340,78,28243,28681,37342,0,-24,0,-2697,-3,-724,-9610,2,0,-2,0,8
EUW1_6883749644',0,22,11,1,0,0,0,11,1,311,78,26082,26039,31112,3,26,17,0,1,1,0,3,319,78,29976,29168,45527,0,-8,0,-3894,-6,-3129,-14415,1,-1,-1,0,8
EUW1_6883721132',6,24,13,0,0,2,0,8,1,338,99,28647,28878,26963,4,27,13,1,0,0,0,6,335,76,27728,28401,29464,0,3,23,919,0,477,-2501,-1,0,2,0,2
EUW1_6883703289',5,32,14,0,0,0,0,11,0,320,94,26189,29464,30640,2,22,13,1,0,2,0,2,350,78,28745,27979,40824,0,-30,16,-2556,1,1485,-10184,-1,0,-2,0,9
EUW1_6883672901',3,25,11,2,0,2,0,5,1,354,108,29556,31187,29371,3,29,6,0,0,0,0,6,360,93,23902,29404,22348,1,-6,15,5654,5,1783,7023,2,0,2,0,-1
EUW1_6883646885',7,31,14,1,0,1,0,10,1,342,87,28804,28498,33941,3,53,17,1,0,2,0,5,337,94,30224,30551,32943,0,5,-7,-1420,-3,-2053,998,0,0,-1,0,5
EUW1_6883624937',3,26,9,0,0,0,0,11,1,359,79,26367,27654,26019,3,151,14,2,0,2,0,4,374,85,29939,31560,38333,0,-15,-6,-3572,-5,-3906,-12314,-2,0,-2,0,7
EUW1_6883605820',2,39,16,0,1,3,0,4,0,357,108,30301,32810,34975,4,28,7,2,0,0,0,9,348,68,24761,28073,23506,1,9,40,5540,9,4737,11469,-2,1,3,0,-5
EUW1_6883334088',2,22,10,0,0,0,0,13,0,318,91,26489,28601,29152,5,27,19,2,1,3,0,0,363,104,32802,30632,36458,0,-45,-13,-6313,-9,-2031,-7306,-2,-1,-3,0,13
EUW1_6883249772',5,31,20,2,0,3,0,5,0,359,90,33610,30231,44420,6,30,14,0,0,1,0,12,299,94,26271,27165,32554,1,60,-4,7339,6,3066,11866,2,0,2,0,-7
EUW1_6882324576',6,26,14,1,0,2,0,9,1,353,69,28341,29456,28801,3,25,9,1,1,0,0,5,325,77,24724,28152,29616,0,28,-8,3617,5,1304,-815,0,-1,2,0,4
EUW1_6882305316',3,23,4,0,0,0,0,7,0,376,92,22709,28707,15360,8,30,13,2,1,2,0,0,385,104,28296,32526,31642,0,-9,-12,-5587,-9,-3819,-16282,-2,-1,-2,0,7
EUW1_6882293315',9,32,14,1,0,0,0,10,0,340,100,28448,29393,31179,9,369,14,1,0,2,0,3,389,80,30119,31103,33207,1,-49,20,-1671,0,-1710,-2028,0,0,-2,0,7
EUW1_6882276145',5,43,12,0,0,0,0,14,0,308,68,25302,26083,31826,3,25,20,2,0,2,0,1,364,96,31584,31766,35769,0,-56,-28,-6282,-8,-5683,-3943,-2,0,-2,0,13
EUW1_6882259886',3,24,19,1,0,1,0,6,0,404,96,30813,32587,37132,2,160,8,1,0,0,0,5,309,100,24912,27921,32655,0,95,-4,5901,11,4666,4477,0,0,1,0,1
EUW1_6882238692',2,150,16,0,0,0,0,11,0,365,92,28992,32969,40601,4,24,12,1,0,0,0,2,357,94,27474,28796,30432,1,8,-2,1518,4,4173,10169,-1,0,0,0,9
EUW1_6882209854',4,28,12,0,0,1,0,9,0,328,87,26091,29083,25759,4,25,12,1,0,0,0,2,341,92,26512,28837,29248,0,-13,-5,-421,0,246,-3489,-1,0,1,0,7
EUW1_6882177326',3,27,6,0,0,0,0,6,0,363,107,24153,29194,23451,9,43,8,2,0,0,0,1,393,92,26286,30919,30659,0,-30,15,-2133,-2,-1725,-7208,-2,0,0,0,5
EUW1_6881500704',7,299,17,2,0,2,0,9,0,385,86,30362,31547,34262,1,130,7,0,0,0,0,5,326,102,24952,28017,29688,1,59,-16,5410,10,3530,4574,2,0,2,0,4
EUW1_6881457424',5,33,19,2,0,1,0,8,1,380,82,31422,31618,33012,1,34,5,0,0,0,0,4,334,102,23111,27090,29048,1,46,-20,8311,14,4528,3964,2,0,1,0,4
EUW1_6881356834',2,54,9,1,0,0,0,11,0,293,88,25688,27130,31195,3,56,25,0,0,1,0,0,373,95,34082,32713,45270,0,-80,-7,-8394,-16,-5583,-14075,1,0,-1,0,11
EUW1_6881304799',3,24,18,2,1,0,0,10,1,365,88,29186,31906,38127,3,33,7,0,0,1,0,5,334,92,26123,28744,28328,1,31,-4,3063,11,3162,9799,2,1,-1,0,5
EUW1_6878971887',1,18,10,0,0,0,0,9,1,323,88,25449,27383,24805,2,32,16,2,0,1,0,2,377,116,29702,31594,30400,0,-54,-28,-4253,-6,-4211,-5595,-2,0,-1,0,7
EUW1_6874443466',2,31,10,1,0,0,0,5,1,364,88,27387,30264,33252,4,30,13,0,0,1,0,7,335,84,26814,31285,40504,0,29,4,573,-3,-1021,-7252,1,0,-1,0,-2
EUW1_6874385114',4,25,23,2,1,2,0,10,1,344,100,34061,31779,44420,3,37,10,0,0,0,0,6,358,104,26767,27677,28775,1,-14,-4,7294,13,4102,15645,2,1,2,0,4
EUW1_6874321231',6,27,11,1,0,0,0,7,1,361,90,26499,28213,30084,4,28,10,1,1,1,0,4,355,102,27034,30438,26115,0,6,-12,-535,1,-2225,3969,0,-1,-1,0,3
EUW1_6868846359',3,65,10,1,0,0,0,16,0,284,76,25915,25418,29141,5,45,27,1,0,5,0,4,371,100,37733,34278,54355,0,-87,-24,-11818,-17,-8860,-25214,0,0,-5,0,12
EUW1_6868778325',5,30,7,0,0,0,0,6,0,374,113,26354,30782,25450,3,34,9,1,0,1,0,5,360,98,25727,30478,24142,1,14,15,627,-2,304,1308,-1,0,-1,0,1
EUW1_6868257638',4,15,19,1,0,1,0,3,1,349,86,31098,31222,39392,1,24,12,1,0,1,0,9,311,72,25672,28314,35115,1,38,14,5426,7,2908,4277,0,0,0,0,-6
EUW1_6868157291',3,313,13,1,0,0,0,11,1,347,78,26567,29692,31892,5,21,12,1,0,0,0,1,320,102,26992,28961,31107,0,27,-24,-425,1,731,785,0,0,0,0,10
EUW1_6865619949',3,22,11,1,0,1,0,10,1,349,88,28014,31098,35990,0,73,11,1,0,1,0,5,371,100,27518,30958,35997,0,-22,-12,496,0,140,-7,0,0,0,0,5
EUW1_6865546028',1,28,10,1,0,0,0,10,1,323,66,25382,27827,30611,1,70,20,0,0,1,0,3,377,98,31347,32146,38892,0,-54,-32,-5965,-10,-4319,-8281,1,0,-1,0,7
EUW1_6859944964',0,34,13,0,0,0,0,10,1,303,104,28147,30752,32688,5,23,14,2,0,0,0,3,310,76,26678,29661,33928,0,-7,28,1469,-1,1091,-1240,-2,0,0,0,7
EUW1_6859909560',3,19,20,1,0,2,0,8,0,380,83,31897,31769,37850,1,26,12,1,0,1,0,9,323,72,26580,27695,31659,1,57,11,5317,8,4074,6191,0,0,1,0,-1
EUW1_6858775333',7,30,12,1,0,0,0,6,0,345,76,27675,28117,33389,3,21,15,1,1,0,0,3,378,100,28324,31873,32030,1,-33,-24,-649,-3,-3756,1359,0,-1,0,0,3
EUW1_6857618504',7,32,10,1,0,1,0,7,0,407,100,27995,31559,33062,6,33,18,1,1,0,0,4,397,110,29946,34207,33937,0,10,-10,-1951,-8,-2648,-875,0,-1,1,0,3
EUW1_6883153272',3,24,14,2,0,1,0,8,1,411,116,30452,34424,32474,4,28,5,0,0,1,0,1,349,69,22886,27620,22312,1,62,47,7566,9,6804,10162,2,0,0,0,7
EUW1_6883095937',2,33,6,0,1,1,0,6,1,380,113,25979,29204,21774,5,28,6,2,0,1,0,5,349,93,23841,27639,18401,1,31,20,2138,0,1565,3373,-2,1,0,0,1
EUW1_6883051195',4,30,14,1,0,1,0,8,1,389,128,30722,32058,32989,1,26,10,1,0,1,0,7,369,74,24929,29473,30933,1,20,54,5793,4,2585,2056,0,0,0,0,1
EUW1_6883009591',5,33,13,1,0,0,0,8,0,383,84,27796,31980,32977,6,32,8,0,0,0,0,5,334,66,24082,29196,27397,1,49,18,3714,5,2784,5580,1,0,0,0,3
EUW1_6882739410',3,27,17,0,0,1,0,11,1,373,96,31546,31344,36637,7,36,8,2,0,1,0,3,332,100,25071,27290,22971,1,41,-4,6475,9,4054,13666,-2,0,0,0,8
EUW1_6882707929',2,21,12,2,0,0,0,10,0,373,82,27445,30455,36160,3,31,14,0,0,2,0,3,381,93,29896,31810,32260,1,-8,-11,-2451,-2,-1355,3900,2,0,-2,0,7
EUW1_6882678534',3,27,13,1,0,0,0,6,0,354,108,28436,30619,35989,2,32,14,0,0,1,0,4,290,75,26670,29866,30819,1,64,33,1766,-1,753,5170,1,0,-1,0,2
EUW1_6881726373',4,28,15,0,1,0,0,7,1,386,62,30903,30806,38195,1,20,16,1,0,1,0,6,324,106,29320,29604,31905,1,62,-44,1583,-1,1202,6290,-1,1,-1,0,1
EUW1_6881610773',1,78,12,1,0,0,0,9,1,330,79,25971,31205,28788,3,27,7,0,0,0,0,4,348,87,24254,29615,31030,0,-18,-8,1717,5,1590,-2242,1,0,0,0,5
EUW1_6881543234',7,30,13,2,0,1,0,7,0,365,80,29344,29302,35941,3,31,11,0,0,1,0,7,314,116,25789,28681,27592,1,51,-36,3555,2,621,8349,2,0,0,0,0
EUW1_6881491856',5,211,20,2,0,0,0,7,1,387,62,29147,31986,31771,4,31,5,0,1,0,0,3,380,103,25129,29771,27982,1,7,-41,4018,15,2215,3789,2,-1,0,0,4
EUW1_6881436793',9,35,12,0,0,0,0,12,0,267,70,24670,28338,28497,2,31,14,1,0,1,0,1,336,112,29832,29011,44112,0,-69,-42,-5162,-2,-673,-15615,-1,0,-1,0,11
EUW1_6881373635',5,34,12,1,1,0,0,6,1,343,116,27063,31854,24705,5,145,10,1,0,0,0,3,345,86,25383,28776,28860,0,-2,30,1680,2,3078,-4155,0,1,0,0,3
EUW1_6881292644',4,32,10,2,1,0,0,11,0,372,118,27715,32673,26715,4,26,8,0,0,2,0,6,394,82,26379,28850,27801,1,-22,36,1336,2,3823,-1086,2,1,-2,0,5
EUW1_6881232780',4,25,7,1,1,0,0,8,0,400,104,25238,30192,22211,3,32,12,0,0,1,0,2,364,84,28104,29288,31027,0,36,20,-2866,-5,904,-8816,1,1,-1,0,6
EUW1_6881183727',7,29,18,2,0,2,0,8,1,370,110,32799,30059,42194,6,25,9,0,0,0,0,8,322,78,25677,26762,34403,1,48,32,7122,9,3297,7791,2,0,2,0,0
EUW1_6880643881',3,18,9,0,0,0,0,11,0,385,87,26089,29516,31780,2,39,12,1,0,2,0,2,389,108,29041,30653,29811,0,-4,-21,-2952,-3,-1137,1969,-1,0,-2,0,9
EUW1_6880617005',3,33,26,1,0,2,0,5,1,344,85,34113,31056,47331,7,24,16,1,0,0,0,8,318,85,28216,29382,35382,1,26,0,5897,10,1674,11949,0,0,2,0,-3
EUW1_6880556844',5,40,3,1,0,0,0,9,0,354,100,23712,27438,19745,7,31,11,1,0,1,0,1,445,84,29195,31977,26871,0,-91,16,-5483,-8,-4539,-7126,0,0,-1,0,8
EUW1_6883289290',5,31,16,1,1,3,0,6,0,375,96,31506,31128,36766,3,21,16,0,0,0,0,8,318,64,27773,29451,29884,1,57,32,3733,0,1677,6882,1,1,3,0,-2
EUW1_6883215222',5,26,13,0,0,0,0,13,1,269,87,27684,27084,28512,8,35,22,1,0,2,0,1,343,63,32260,29608,40584,0,-74,24,-4576,-9,-2524,-12072,-1,0,-2,0,12
EUW1_6883147437',4,29,5,0,0,1,0,11,1,399,114,25907,29563,26317,5,30,8,1,0,0,0,2,352,110,26270,29655,21271,0,47,4,-363,-3,-92,5046,-1,0,1,0,9
EUW1_6882116791',4,180,14,2,1,0,0,6,0,397,106,30091,32951,34957,7,36,7,0,0,1,0,4,339,82,23240,27311,21334,1,58,24,6851,7,5640,13623,2,1,-1,0,2
EUW1_6881840055',3,24,12,1,0,0,0,9,1,323,72,26179,28088,29701,6,33,18,1,0,1,0,2,347,88,30250,31413,36850,0,-24,-16,-4071,-6,-3325,-7149,0,0,-1,0,7
EUW1_6881658889',2,25,20,2,1,0,0,10,1,339,79,30446,31322,35866,4,276,21,0,0,1,0,2,347,107,32871,30230,41647,1,-8,-28,-2425,-1,1092,-5781,2,1,-1,0,8
EUW1_6881294534',4,28,10,0,0,0,0,10,0,315,76,26092,26296,30572,5,74,18,1,0,2,0,2,334,98,31663,30024,37522,0,-19,-22,-5571,-8,-3728,-6950,-1,0,-2,0,8
EUW1_6881132501',4,33,8,1,0,0,0,8,0,405,94,26041,31293,27979,5,30,15,1,0,0,0,4,390,85,29634,32052,37498,0,15,9,-3593,-7,-759,-9519,0,0,0,0,4
EUW1_6881026886',7,31,9,0,1,0,0,14,1,330,90,26006,28206,32879,5,135,15,2,0,3,0,5,355,121,31382,32129,28605,0,-25,-31,-5376,-6,-3923,4274,-2,1,-3,0,9
EUW1_6880988156',3,26,12,1,0,0,0,15,0,361,91,27801,30713,35325,4,66,12,1,0,2,0,1,376,102,30165,30937,36497,1,-15,-11,-2364,0,-224,-1172,0,0,-2,0,14
EUW1_6880549997',8,44,8,1,0,0,0,7,0,391,48,25038,29724,28626,4,92,5,0,0,1,0,4,344,120,25017,28279,21432,1,47,-72,21,3,1445,7194,1,0,-1,0,3
EUW1_6880637925',1,27,15,0,0,0,0,9,0,334,66,25759,27069,33289,4,313,9,1,0,0,0,1,365,88,25896,27440,26685,0,-31,-22,-137,6,-371,6604,-1,0,0,0,8
EUW1_6880591464',2,27,10,1,0,0,0,8,1,321,88,25926,27125,23894,5,24,14,0,0,0,0,1,373,72,27617,29446,23075,1,-52,16,-1691,-4,-2321,819,1,0,0,0,7
EUW1_6880539895',3,29,9,1,0,1,0,8,0,382,110,26395,30638,22144,2,19,9,1,0,1,0,4,369,94,27582,31320,22813,0,13,16,-1187,0,-682,-669,0,0,0,0,4
EUW1_6880488961',2,23,5,1,0,0,0,8,1,353,82,23235,28429,21130,3,22,13,0,0,1,0,0,381,100,29142,32812,34578,0,-28,-18,-5907,-8,-4383,-13448,1,0,-1,0,8
EUW1_6880379249',1,41,6,1,0,0,0,11,0,342,44,21899,24946,20194,6,78,18,1,0,1,0,2,339,118,31148,31267,31477,0,3,-74,-9249,-12,-6321,-11283,0,0,-1,0,9
EUW1_6879021304',4,29,12,0,0,0,0,5,1,387,102,27777,30227,27611,6,39,8,1,0,0,0,0,377,80,24115,28588,19843,0,10,22,3662,4,1639,7768,-1,0,0,0,5
EUW1_6878976541',5,24,10,1,0,1,0,8,1,361,92,26997,28948,31273,4,22,9,1,0,1,0,3,344,87,26162,29137,24901,1,17,5,835,1,-189,6372,0,0,0,0,5
EUW1_6878916436',2,31,16,0,1,3,0,7,1,352,79,30751,31695,29596,5,25,12,1,0,1,0,9,346,87,26569,28854,30820,1,6,-8,4182,4,2841,-1224,-1,1,2,0,-2
EUW1_6804494903',5,42,4,0,0,0,0,9,0,316,73,22266,25990,20912,4,33,16,1,0,3,0,1,412,102,31939,32242,33611,0,-96,-29,-9673,-12,-6252,-12699,-1,0,-3,0,8
EUW1_6804427286',2,24,6,0,0,1,0,9,0,295,114,25249,26581,22692,5,96,13,2,1,1,0,3,348,96,27794,31431,30157,0,-53,18,-2545,-7,-4850,-7465,-2,-1,0,0,6
EUW1_6883132608',1,22,12,0,0,1,0,9,0,268,66,26377,26410,38347,8,29,16,2,0,0,0,6,302,102,27624,27807,39413,0,-34,-36,-1247,-4,-1397,-1066,-2,0,1,0,3
EUW1_6881858550',4,24,17,1,0,1,0,11,1,327,82,29061,28864,34215,3,24,13,1,0,1,0,5,366,103,28882,30453,36791,1,-39,-21,179,4,-1589,-2576,0,0,0,0,6
EUW1_6881102260',1,124,7,0,0,1,0,3,1,361,92,26877,30021,23915,2,33,4,1,0,0,0,8,403,84,23290,29405,25596,1,-42,8,3587,3,616,-1681,-1,0,1,0,-5
EUW1_6881077179',5,39,6,0,1,0,0,16,0,329,93,24460,27538,19480,2,38,20,2,0,2,0,1,356,94,31248,32875,39186,0,-27,-1,-6788,-14,-5337,-19706,-2,1,-2,0,15
EUW1_6880933824',5,195,12,2,0,2,0,6,1,425,94,29617,33162,24945,3,24,4,0,0,0,0,5,342,104,23104,28758,15821,1,83,-10,6513,8,4404,9124,2,0,2,0,1
EUW1_6880363744',3,27,17,2,0,0,0,7,0,371,86,29597,31149,32058,4,22,17,0,0,1,0,3,307,85,27070,27308,29399,1,64,1,2527,0,3841,2659,2,0,-1,0,4
EUW1_6880319515',3,26,6,0,0,0,0,10,0,343,98,23875,28188,20989,4,24,13,2,0,4,0,2,434,102,30740,31650,26807,0,-91,-4,-6865,-7,-3462,-5818,-2,0,-4,0,8
EUW1_6880246282',0,273,6,0,0,0,0,14,0,335,82,24054,27765,23969,3,25,14,2,0,3,0,2,366,110,30537,31531,31537,0,-31,-28,-6483,-8,-3766,-7568,-2,0,-3,0,12
EUW1_6879822295',4,128,10,0,0,1,0,9,0,368,93,26992,29843,25411,7,29,11,1,0,0,0,0,356,92,26778,29963,26973,0,12,1,214,-1,-120,-1562,-1,0,1,0,9
EUW1_6879761943',1,24,15,1,0,2,0,7,1,345,118,29990,30792,28425,2,24,13,1,0,1,0,4,330,102,28716,31927,32382,1,15,16,1274,2,-1135,-3957,0,0,1,0,3
EUW1_6879504553',2,23,27,1,0,3,0,11,1,319,98,34070,29760,43133,1,25,17,0,0,0,0,8,292,33,27890,26040,33007,1,27,65,6180,10,3720,10126,1,0,3,0,3
EUW1_6879472090',4,24,11,1,0,0,0,14,0,288,90,25060,27176,25434,0,23,22,1,0,2,0,1,379,86,32754,30757,37296,0,-91,4,-7694,-11,-3581,-11862,0,0,-2,0,13
EUW1_6879453550',1,23,6,2,0,2,0,4,0,417,123,27647,31609,25758,7,29,11,0,0,0,0,8,351,99,26079,29856,24317,1,66,24,1568,-5,1753,1441,2,0,2,0,-4
EUW1_6878506432',1,65,13,1,0,0,0,13,0,336,85,27546,30967,34988,4,23,14,1,0,3,0,6,322,68,28523,29510,40479,1,14,17,-977,-1,1457,-5491,0,0,-3,0,7
EUW1_6878333149',2,21,7,0,0,0,0,9,1,348,96,25316,29093,25326,5,44,10,2,0,3,0,3,375,64,26893,29016,32233,1,-27,32,-1577,-3,77,-6907,-2,0,-3,0,6
EUW1_6878282138',1,16,3,0,0,0,0,13,0,299,90,21553,25209,24390,6,28,12,1,0,3,0,0,405,74,29552,29643,30707,0,-106,16,-7999,-9,-4434,-6317,-1,0,-3,0,13
EUW1_6877448197',3,27,19,1,1,0,0,9,1,350,102,31290,32428,37136,5,27,13,1,0,1,0,4,322,88,26060,28049,27791,1,28,14,5230,6,4379,9345,0,1,-1,0,5
EUW1_6877385299',3,29,7,0,0,0,0,11,0,300,92,23782,26457,22545,5,31,14,2,0,2,0,1,349,114,30045,29335,33797,0,-49,-22,-6263,-7,-2878,-11252,-2,0,-2,0,10
EUW1_6877071388',3,28,19,0,0,0,0,6,1,323,98,29457,30544,44680,1,28,16,2,0,0,0,3,319,64,27341,28780,43657,1,4,34,2116,3,1764,1023,-2,0,0,0,3
EUW1_6859058276',5,30,18,1,0,2,0,4,0,379,70,30944,30552,35456,2,26,5,1,0,0,0,12,305,82,22591,26929,23986,0,74,-12,8353,13,3623,11470,0,0,2,0,-8
EUW1_6859003390',3,259,18,0,0,1,0,8,0,315,98,30161,30766,42080,3,19,18,1,0,1,0,5,319,46,30157,30011,40590,1,-4,52,4,0,755,1490,-1,0,0,0,3
EUW1_6858949664',2,52,14,1,0,0,0,8,1,295,100,27549,28971,30851,2,23,14,0,1,1,0,2,365,79,28288,30890,37856,1,-70,21,-739,0,-1919,-7005,1,-1,-1,0,6
EUW1_6858895434',4,33,12,1,0,0,0,10,0,375,80,27357,29871,31615,2,21,10,1,0,1,0,4,360,92,26767,30405,27037,1,15,-12,590,2,-534,4578,0,0,-1,0,6
EUW1_6849723955',2,20,11,0,0,2,0,6,1,325,94,28182,26928,29413,5,27,13,2,0,0,0,5,284,107,26116,27972,27123,1,41,-13,2066,-2,-1044,2290,-2,0,2,0,1
EUW1_6849669289',2,21,12,0,0,0,0,11,1,370,84,26304,29362,28123,3,27,16,2,1,1,0,2,381,96,30298,32313,34416,0,-11,-12,-3994,-4,-2951,-6293,-2,-1,-1,0,9
EUW1_6849615949',6,23,13,1,0,0,0,7,1,306,86,27076,29943,38976,2,25,9,1,0,1,0,2,296,94,24221,28568,22498,1,10,-8,2855,4,1375,16478,0,0,-1,0,5
EUW1_6849535018',2,23,12,1,0,0,0,10,0,348,88,27298,29788,30518,4,25,16,0,1,1,0,1,342,68,28427,30200,33652,1,6,20,-1129,-4,-412,-3134,1,-1,-1,0,9
EUW1_6848175289',4,22,13,0,0,0,0,11,0,351,78,28337,28963,34269,5,29,14,1,0,2,0,3,355,80,28714,30621,32754,0,-4,-2,-377,-1,-1658,1515,-1,0,-2,0,8
EUW1_6880725465',3,33,17,1,0,0,0,5,1,331,73,28140,28903,40905,0,25,17,0,0,1,0,4,305,90,30089,30323,34368,0,26,-17,-1949,0,-1420,6537,1,0,-1,0,1
EUW1_6880703580',1,16,12,0,0,0,0,13,0,293,88,26254,29459,30094,2,25,17,2,1,3,0,4,360,103,32427,31353,41205,0,-67,-15,-6173,-5,-1894,-11111,-2,-1,-3,0,9
EUW1_6880666325',1,31,11,0,0,1,0,3,1,404,84,28535,30172,24782,2,126,9,0,0,0,0,7,350,90,25602,29124,26033,1,54,-6,2933,2,1048,-1251,0,0,1,0,-4
EUW1_6880632721',4,79,18,1,0,1,0,8,1,293,75,28273,28287,42230,2,37,12,1,1,0,0,2,327,77,27288,27811,33353,1,-34,-2,985,6,476,8877,0,-1,1,0,6
EUW1_6880589608',4,18,6,2,0,0,0,13,0,362,129,24551,31380,22121,5,32,9,0,0,2,0,1,389,62,26803,29258,23985,0,-27,67,-2252,-3,2122,-1864,2,0,-2,0,12
EUW1_6879633555',2,27,15,0,0,0,0,8,0,350,98,28128,31746,37884,4,24,11,1,0,1,0,3,324,85,25822,29954,34682,1,26,13,2306,4,1792,3202,-1,0,-1,0,5
EUW1_6879571396',2,27,7,1,0,0,0,9,1,385,82,24525,29169,19521,2,47,12,1,0,1,0,1,389,109,28626,30868,29615,0,-4,-27,-4101,-5,-1699,-10094,0,0,-1,0,8
EUW1_6878456898',2,27,11,2,0,0,0,9,0,326,116,25490,29074,27252,6,36,10,0,1,1,0,1,364,92,27029,29128,31610,0,-38,24,-1539,1,-54,-4358,2,-1,-1,0,8
EUW1_6877797980',5,40,12,1,1,1,0,7,1,318,82,27696,26893,28673,6,29,12,1,0,0,0,6,342,78,26824,28255,28720,0,-24,4,872,0,-1362,-47,0,1,1,0,1
EUW1_6877755838',4,25,15,1,0,1,0,5,0,363,76,28535,31641,34251,2,25,9,0,0,0,0,2,357,104,26796,31615,29521,1,6,-28,1739,6,26,4730,1,0,1,0,3
EUW1_6877708324',3,22,14,0,0,0,0,8,0,375,89,28526,30410,32136,4,29,15,1,0,2,0,5,365,86,28236,31109,29644,0,10,3,290,-1,-699,2492,-1,0,-2,0,3
EUW1_6877670282',5,28,12,2,0,2,0,8,0,391,76,28002,30540,32538,3,42,6,0,0,0,0,8,368,77,25204,27791,33362,1,23,-1,2798,6,2749,-824,2,0,2,0,0
EUW1_6877628491',6,43,10,0,0,0,0,9,0,380,30,24531,27587,27372,1,28,8,1,0,1,0,3,378,95,25944,29727,32588,1,2,-65,-1413,2,-2140,-5216,-1,0,-1,0,6
EUW1_6877562099',8,41,13,2,0,0,0,9,1,275,64,26634,25430,42848,4,25,22,0,0,0,0,3,314,76,29927,28324,37997,0,-39,-12,-3293,-9,-2894,4851,2,0,0,0,6
EUW1_6877508719',6,38,15,0,0,0,0,11,0,340,71,27659,28433,35879,3,36,10,1,0,1,0,5,333,84,26172,28400,24543,1,7,-13,1487,5,33,11336,-1,0,-1,0,6
EUW1_6877441793',2,35,12,1,0,0,0,7,1,377,99,28467,31110,26343,4,26,8,0,0,0,0,2,347,91,25041,29825,27765,1,30,8,3426,4,1285,-1422,1,0,0,0,5
EUW1_6871102319',6,25,14,1,0,2,0,6,1,344,84,29232,27701,30739,3,77,10,1,0,0,0,6,340,92,26496,28517,29202,1,4,-8,2736,4,-816,1537,0,0,2,0,0
EUW1_6871073171',0,23,12,0,0,0,0,8,1,342,94,26658,31400,32969,4,24,14,2,0,2,0,3,365,97,29618,30815,33367,0,-23,-3,-2960,-2,585,-398,-2,0,-2,0,5
EUW1_6870431259',6,22,17,1,1,1,0,7,1,322,74,29151,28973,33290,7,33,10,1,0,0,0,6,376,80,26020,28518,26726,1,-54,-6,3131,7,455,6564,0,1,1,0,1
EUW1_6882950076',5,31,12,1,0,2,0,7,0,410,79,29888,31995,30687,3,88,7,1,0,1,0,8,362,96,25601,27969,24925,1,48,-17,4287,5,4026,5762,0,0,1,0,-1
EUW1_6881131051',4,27,12,1,0,0,0,8,1,368,84,28038,29328,42084,4,18,11,1,0,0,0,2,370,72,26097,30749,28918,1,-2,12,1941,1,-1421,13166,0,0,0,0,6
EUW1_6881092884',3,19,10,0,0,1,0,11,0,372,83,26812,28875,33763,3,240,13,2,0,2,0,5,376,92,28383,30114,35355,0,-4,-9,-1571,-3,-1239,-1592,-2,0,-1,0,6
EUW1_6880558327',3,24,6,1,0,0,0,8,1,327,63,22846,26503,29550,5,52,12,1,1,0,0,0,343,70,25983,29673,28472,1,-16,-7,-3137,-6,-3170,1078,0,-1,0,0,8
EUW1_6880497425',2,26,11,1,0,0,0,5,0,334,74,25380,27745,25191,4,22,14,1,0,1,0,0,347,108,28546,30674,32501,0,-13,-34,-3166,-3,-2929,-7310,0,0,-1,0,5
EUW1_6876988152',1,25,17,2,1,3,0,7,1,378,104,31795,31855,42490,4,39,1,0,0,1,0,7,332,103,21245,26778,19579,1,46,1,10550,16,5077,22911,2,1,2,0,0
EUW1_6870215499',4,35,14,1,0,2,0,8,0,313,88,28216,29301,29626,2,18,10,1,0,1,0,1,354,104,27018,30021,24436,1,-41,-16,1198,4,-720,5190,0,0,1,0,7
EUW1_6869701420',2,22,10,1,0,0,0,11,1,316,82,25340,27968,24194,3,39,14,1,0,2,0,2,346,90,28632,28054,37052,1,-30,-8,-3292,-4,-86,-12858,0,0,-2,0,9
EUW1_6883757102',2,33,12,0,0,1,0,13,0,339,83,27153,28040,27093,3,152,12,1,1,3,0,3,330,88,29595,29607,32545,0,9,-5,-2442,0,-1567,-5452,-1,-1,-2,0,10
EUW1_6883730981',3,27,11,0,1,1,0,9,1,398,64,29183,28619,27748,5,41,4,1,0,1,0,3,324,79,22609,24648,23376,1,74,-15,6574,7,3971,4372,-1,1,0,0,6
EUW1_6883618635',3,18,8,0,0,0,0,10,1,244,97,23190,26105,28885,2,27,16,2,1,1,0,0,356,106,28447,30409,33631,0,-112,-9,-5257,-8,-4304,-4746,-2,-1,-1,0,10
EUW1_6883575370',7,28,16,2,0,0,0,5,0,361,74,28879,30649,41403,7,24,17,0,0,0,0,2,330,76,27842,28471,43733,1,31,-2,1037,-1,2178,-2330,2,0,0,0,3
EUW1_6882166867',5,24,6,1,0,0,0,13,0,338,80,23242,27314,24877,1,181,18,1,0,3,0,4,329,87,31058,30416,34963,0,9,-7,-7816,-12,-3102,-10086,0,0,-3,0,9
EUW1_6882082807',4,24,8,0,0,0,0,8,1,323,94,24188,29112,24709,3,24,21,2,1,2,0,1,383,94,31427,33069,37427,0,-60,0,-7239,-13,-3957,-12718,-2,-1,-2,0,7
EUW1_6882026087',3,36,8,1,0,1,0,8,1,381,82,25968,30280,28680,1,24,13,0,0,0,0,2,353,70,26673,29386,30283,1,28,12,-705,-5,894,-1603,1,0,1,0,6
EUW1_6881971969',7,26,15,0,0,0,0,8,1,342,80,28036,28260,34484,3,92,18,1,0,0,0,1,324,60,27873,30191,33883,0,18,20,163,-3,-1931,601,-1,0,0,0,7
EUW1_6881917552',4,21,14,0,0,0,0,6,1,282,74,25686,25961,36639,4,28,25,2,0,0,0,4,300,78,30299,28158,45281,0,-18,-4,-4613,-11,-2197,-8642,-2,0,0,0,2
EUW1_6881830518',5,159,17,1,0,0,0,6,1,339,96,28542,30795,37047,6,38,10,1,0,0,0,3,360,95,26271,28355,27302,0,-21,1,2271,7,2440,9745,0,0,0,0,3
EUW1_6881763314',3,23,12,0,0,1,0,10,0,324,78,27400,31313,35139,9,34,14,2,0,1,0,3,378,94,28830,30582,32028,1,-54,-16,-1430,-2,731,3111,-2,0,0,0,7
EUW1_6881705692',6,28,13,1,0,3,0,9,1,395,92,31267,30420,35904,2,25,11,1,0,0,0,6,348,86,26761,29043,29086,1,47,6,4506,2,1377,6818,0,0,3,0,3
EUW1_6881656671',0,36,10,0,0,0,0,12,1,273,74,24562,26245,28152,3,21,18,2,1,2,0,0,343,106,29368,31209,36538,0,-70,-32,-4806,-8,-4964,-8386,-2,-1,-2,0,12
EUW1_6881471787',5,27,15,0,0,0,0,14,1,356,70,27644,29391,30670,3,43,13,2,0,1,0,0,340,86,28145,29265,29354,0,16,-16,-501,2,126,1316,-2,0,-1,0,14
EUW1_6881413223',4,31,16,0,0,1,0,9,1,349,99,28597,28143,35770,1,21,19,2,1,2,0,6,316,91,30801,30650,32139,0,33,8,-2204,-3,-2507,3631,-2,-1,-1,0,3
EUW1_6881354061',1,25,11,1,1,1,0,6,1,310,106,26774,28265,30845,2,68,9,1,0,0,0,4,317,90,25344,29357,25752,1,-7,16,1430,2,-1092,5093,0,1,1,0,2
EUW1_6881314808',3,39,8,0,0,0,0,11,0,306,93,25361,27788,23493,2,23,17,2,0,1,0,0,357,102,29033,31650,34600,0,-51,-9,-3672,-9,-3862,-11107,-2,0,-1,0,11
EUW1_6881257796',4,24,20,1,0,0,0,10,0,307,80,30426,29283,38869,3,21,18,0,0,1,0,5,284,76,28418,27175,35199,0,23,4,2008,2,2108,3670,1,0,-1,0,5
EUW1_6881213692',3,39,16,2,0,2,0,5,1,389,83,30420,31239,38470,1,22,6,0,0,0,0,9,307,88,22712,27107,25723,1,82,-5,7708,10,4132,12747,2,0,2,0,-4
EUW1_6881166636',7,35,9,0,0,1,0,9,0,314,80,25531,26361,30454,3,43,18,2,0,0,0,8,320,100,29276,28355,36690,0,-6,-20,-3745,-9,-1994,-6236,-2,0,1,0,1
EUW1_6883805498',3,23,14,1,0,0,0,11,0,319,86,27450,27916,32773,2,25,22,0,0,1,0,4,332,82,32443,30996,41589,0,-13,4,-4993,-8,-3080,-8816,1,0,-1,0,7
EUW1_6883619026',1,22,8,2,0,0,0,6,1,356,76,23898,27671,26608,7,39,8,0,0,0,0,5,328,104,25185,28330,22305,1,28,-28,-1287,0,-659,4303,2,0,0,0,1
EUW1_6883595498',9,32,7,0,0,0,0,9,0,379,80,24248,28774,27471,6,40,9,2,0,1,0,1,374,107,25964,28808,23280,0,5,-27,-1716,-2,-34,4191,-2,0,-1,0,8
EUW1_6883554199',3,55,13,1,0,2,0,13,1,377,100,29932,29556,32034,4,173,21,1,0,2,0,7,373,89,32492,31780,41736,0,4,11,-2560,-8,-2224,-9702,0,0,0,0,6
EUW1_6883167385',3,22,15,0,0,1,0,8,1,369,75,30545,28545,32982,5,56,12,1,0,2,0,9,345,83,28634,27196,29669,0,24,-8,1911,3,1349,3313,-1,0,-1,0,-1
EUW1_6882804220',9,32,6,1,0,0,0,14,1,304,80,22298,26584,25129,6,36,13,0,0,2,0,2,371,116,29422,30746,29504,0,-67,-36,-7124,-7,-4162,-4375,1,0,-2,0,12
EUW1_6882767005',1,21,18,0,0,0,0,13,0,295,82,28159,27777,37061,5,35,23,1,0,1,0,1,361,86,33894,30876,45452,0,-66,-4,-5735,-5,-3099,-8391,-1,0,-1,0,12
EUW1_6882693620',2,25,5,0,0,0,0,3,0,386,104,24868,30653,28569,3,37,9,1,0,0,0,0,391,95,25763,31793,24401,0,-5,9,-895,-4,-1140,4168,-1,0,0,0,3
EUW1_6882637199',3,26,9,1,0,0,0,11,0,365,67,25525,31372,24358,5,24,14,1,0,1,0,1,394,95,29592,31969,30234,0,-29,-28,-4067,-5,-597,-5876,0,0,-1,0,10
EUW1_6882606826',5,44,13,2,0,0,0,9,0,341,128,28615,30504,33939,8,73,14,0,0,1,0,4,349,68,28262,30415,31525,0,-8,60,353,-1,89,2414,2,0,-1,0,5
EUW1_6882200772',2,44,11,0,0,0,0,8,0,386,106,27757,31386,34131,9,33,10,2,0,0,0,3,339,92,25650,28004,30714,1,47,14,2107,1,3382,3417,-2,0,0,0,5
EUW1_6881795746',5,208,15,0,1,0,0,20,0,335,120,28513,31777,36595,3,25,12,1,0,3,0,4,369,107,29204,31082,34137,1,-34,13,-691,3,695,2458,-1,1,-3,0,16
EUW1_6880998231',7,34,8,1,0,1,0,6,1,382,93,26238,28677,22454,7,29,9,0,0,1,0,5,348,82,25479,29201,29578,1,34,11,759,-1,-524,-7124,1,0,0,0,1
EUW1_6880929558',4,31,5,0,0,0,0,7,0,409,105,24657,30063,22961,4,55,11,1,0,1,0,1,385,98,27730,31024,23953,1,24,7,-3073,-6,-961,-992,-1,0,-1,0,6
EUW1_6880734208',4,46,8,1,0,0,0,5,0,351,106,25567,30754,29984,1,34,12,0,0,0,0,2,389,81,25877,32400,30804,0,-38,25,-310,-4,-1646,-820,1,0,0,0,3
EUW1_6880712104',4,22,15,0,1,2,0,10,1,349,110,30658,30458,28652,4,24,15,1,0,2,0,7,326,75,27816,28035,33332,0,23,35,2842,0,2423,-4680,-1,1,0,0,3
EUW1_6880698744',10,243,19,0,1,0,0,10,1,346,66,29441,29039,35949,1,41,10,1,0,0,0,5,330,76,24974,26154,29880,1,16,-10,4467,9,2885,6069,-1,1,0,0,5
EUW1_6880658778',2,35,12,1,0,0,0,11,0,284,94,25903,27593,27953,6,47,19,0,0,1,0,5,337,78,29095,31030,38538,1,-53,16,-3192,-7,-3437,-10585,1,0,-1,0,6
EUW1_6880611173',3,346,9,1,0,0,0,8,1,344,88,25385,30061,25298,5,44,13,1,0,0,0,5,356,116,27753,32059,36636,0,-12,-28,-2368,-4,-1998,-11338,0,0,0,0,3
EUW1_6880564458',1,39,10,2,0,1,0,13,1,347,89,26378,28384,31980,7,32,15,0,0,2,0,4,364,82,29629,31250,30548,1,-17,7,-3251,-5,-2866,1432,2,0,-1,0,9
EUW1_6880489968',4,59,16,1,1,3,0,10,1,366,108,31686,32601,37425,5,44,7,1,0,0,0,6,306,95,24667,27197,23864,1,60,13,7019,9,5404,13561,0,1,3,0,4
EUW1_6880329371',5,29,20,1,0,1,0,9,0,357,94,30090,31863,35123,5,22,7,0,0,1,0,6,370,86,25691,28130,30509,1,-13,8,4399,13,3733,4614,1,0,0,0,3
EUW1_6878117015',1,19,16,1,0,0,0,10,1,355,102,30161,32439,35727,2,27,8,1,0,3,0,5,369,82,26500,28320,22371,1,-14,20,3661,8,4119,13356,0,0,-3,0,5
EUW1_6878076229',7,146,15,1,0,0,0,8,0,365,97,28573,30309,32860,6,35,12,1,1,0,0,5,343,78,26747,30093,24931,1,22,19,1826,3,216,7929,0,-1,0,0,3
EUW1_6878047420',3,102,18,1,0,0,0,9,0,361,104,30499,30851,27729,2,24,10,1,0,0,0,5,344,104,27702,28831,25949,1,17,0,2797,8,2020,1780,0,0,0,0,4
EUW1_6875736450',3,31,11,0,0,1,0,11,1,306,94,27909,27429,31054,7,32,22,2,0,3,0,9,339,101,31325,29977,40297,0,-33,-7,-3416,-11,-2548,-9243,-2,0,-2,0,2
EUW1_6875695816',3,25,5,1,0,0,0,8,0,371,100,24329,31073,21432,4,29,8,1,1,0,0,3,406,104,26359,31494,22117,0,-35,-4,-2030,-3,-421,-685,0,-1,0,0,5
EUW1_6875594290',4,36,21,0,1,2,0,5,1,372,101,34230,32638,36800,4,30,11,1,0,0,0,8,335,88,26056,28420,27294,1,37,13,8174,10,4218,9506,-1,1,2,0,-3
EUW1_6875452211',1,23,18,1,0,1,0,13,0,288,86,30207,29531,42784,3,23,31,0,0,2,0,6,328,89,34996,33511,49553,0,-40,-3,-4789,-13,-3980,-6769,1,0,-1,0,7
EUW1_6867731663',4,29,7,1,0,0,0,13,0,308,80,24169,28141,30775,6,245,18,1,0,2,0,2,360,79,29916,30122,39780,1,-52,1,-5747,-11,-1981,-9005,0,0,-2,0,11
EUW1_6867706288',3,206,15,0,0,0,0,7,0,362,88,28734,31784,38526,5,24,10,2,0,0,0,1,337,72,26104,28343,35030,1,25,16,2630,5,3441,3496,-2,0,0,0,6
EUW1_6864816597',4,35,28,2,0,0,0,9,1,344,86,34841,31324,48576,8,36,16,0,0,3,0,6,308,82,29219,29161,31179,1,36,4,5622,12,2163,17397,2,0,-3,0,3
EUW1_6864783596',1,18,11,0,0,1,0,5,1,352,98,26961,29556,32268,5,30,16,1,0,0,0,1,305,82,27277,29366,30179,1,47,16,-316,-5,190,2089,-1,0,1,0,4
EUW1_6862960861',7,39,13,0,0,0,0,5,1,352,96,29208,28358,37249,9,97,18,2,0,1,0,4,328,78,29065,29735,36388,0,24,18,143,-5,-1377,861,-2,0,-1,0,1
EUW1_6862912702',0,27,7,1,0,0,0,12,0,312,80,24298,27279,29040,8,34,21,1,0,2,0,0,371,103,33012,33332,41229,0,-59,-23,-8714,-14,-6053,-12189,0,0,-2,0,12
EUW1_6862858155',4,23,12,0,0,0,0,6,0,347,76,26310,29379,37912,6,29,14,1,0,0,0,4,391,83,29318,32095,31446,0,-44,-7,-3008,-2,-2716,6466,-1,0,0,0,2
EUW1_6862747055',1,23,10,2,0,0,0,15,0,358,72,26724,29518,30382,4,28,11,0,1,2,0,3,327,128,29715,30270,35671,0,31,-56,-2991,-1,-752,-5289,2,-1,-2,0,12
EUW1_6862384413',7,64,12,1,0,0,0,8,1,302,84,26336,29926,28548,7,61,11,1,1,1,0,0,384,111,28532,30855,32331,1,-82,-27,-2196,1,-929,-3783,0,-1,-1,0,8
EUW1_6862354171',7,33,8,0,0,1,0,6,0,370,87,26716,27900,29878,5,34,11,2,0,1,0,8,339,84,27033,28799,23821,1,31,3,-317,-3,-899,6057,-2,0,0,0,-2
EUW1_6883424776',9,35,13,1,0,0,0,7,0,304,69,26168,28348,34040,2,25,14,1,0,1,0,2,333,89,27633,28645,37467,0,-29,-20,-1465,-1,-297,-3427,0,0,-1,0,5
EUW1_6883238750',7,27,15,2,0,1,0,5,1,384,96,29296,31578,26862,8,33,5,0,0,0,0,1,377,104,24302,28971,23636,1,7,-8,4994,10,2607,3226,2,0,1,0,4
EUW1_6882924505',2,27,15,1,0,0,0,10,0,358,78,28281,29550,30288,4,28,10,1,1,1,0,4,367,89,27271,29361,24618,1,-9,-11,1010,5,189,5670,0,-1,-1,0,6
EUW1_6882805280',2,31,18,1,0,1,0,6,1,340,116,30373,31347,39951,6,103,11,1,0,1,0,6,340,66,26996,28518,34336,1,0,50,3377,7,2829,5615,0,0,0,0,0
EUW1_6882156356',5,29,14,1,0,0,0,7,1,358,98,28926,29641,25155,3,27,12,0,1,3,0,2,393,88,29557,30376,26298,0,-35,10,-631,2,-735,-1143,1,-1,-3,0,5
EUW1_6882101664',4,23,13,0,0,2,0,8,1,343,98,28438,29055,36629,4,34,12,1,0,2,0,9,362,78,27866,30625,36583,1,-19,20,572,1,-1570,46,-1,0,0,0,-1
EUW1_6881934861',5,24,6,2,0,0,0,8,0,337,97,24979,28134,26737,8,39,17,0,0,1,0,5,298,84,28217,27481,32501,1,39,13,-3238,-11,653,-5764,2,0,-1,0,3
EUW1_6881839525',5,28,13,0,0,0,0,11,1,349,78,27314,29086,31433,3,30,16,1,0,1,0,1,371,76,29571,31337,34245,0,-22,2,-2257,-3,-2251,-2812,-1,0,-1,0,10
EUW1_6880695613',4,20,18,2,0,1,0,7,1,379,96,30254,33129,33351,4,60,11,0,0,0,0,3,325,104,26253,29393,33768,1,54,-8,4001,7,3736,-417,2,0,1,0,4
EUW1_6880663961',0,16,2,0,0,0,0,15,0,296,82,20244,24246,18362,3,23,19,0,1,4,0,1,337,122,32805,32781,33162,0,-41,-40,-12561,-17,-8535,-14800,0,-1,-4,0,14
EUW1_6880617775',2,23,7,0,0,0,0,7,1,344,85,24378,27721,20135,3,25,12,2,0,0,0,3,371,98,25894,31207,36673,0,-27,-13,-1516,-5,-3486,-16538,-2,0,0,0,4
EUW1_6880586526',3,29,20,2,0,2,0,8,1,338,117,32150,34873,38732,2,27,8,0,0,0,0,5,355,77,25059,27721,32481,1,-17,40,7091,12,7152,6251,2,0,2,0,3
EUW1_6880535212',2,23,19,2,1,1,0,8,1,345,81,29884,31530,36538,6,25,7,0,0,1,0,4,358,72,24466,27606,32407,1,-13,9,5418,12,3924,4131,2,1,0,0,4
EUW1_6879808372',3,23,7,0,0,0,0,12,0,324,81,24594,27349,24447,4,26,12,1,0,2,0,4,343,78,27008,29106,31116,0,-19,3,-2414,-5,-1757,-6669,-1,0,-2,0,8
EUW1_6879775569',4,27,20,0,0,2,0,9,1,339,100,31911,30049,43172,8,25,12,2,1,0,0,7,285,108,26339,27648,32747,1,54,-8,5572,8,2401,10425,-2,-1,2,0,2
EUW1_6878625912',6,26,5,0,0,0,0,9,1,313,69,21575,24939,20056,3,23,15,2,0,1,0,1,385,76,28338,29759,29563,0,-72,-7,-6763,-10,-4820,-9507,-2,0,-1,0,8
EUW1_6878499023',5,32,12,1,0,1,0,4,1,333,102,27599,30932,37409,2,130,5,0,0,0,0,6,325,77,23338,26899,27697,1,8,25,4261,7,4033,9712,1,0,1,0,-2
EUW1_6878457946',5,305,14,1,0,1,0,8,1,343,74,28395,30169,33726,3,35,16,1,0,2,0,3,364,90,30009,30502,37763,0,-21,-16,-1614,-2,-333,-4037,0,0,-1,0,5
EUW1_6883645811',2,29,12,1,0,0,0,13,0,284,70,25739,27514,29027,6,28,20,1,1,2,0,2,384,106,33651,31100,38321,0,-100,-36,-7912,-8,-3586,-9294,0,-1,-2,0,11
EUW1_6883632655',3,84,13,1,0,0,0,4,1,351,76,28371,28859,25600,3,27,13,1,0,0,0,4,357,82,27675,29555,35785,0,-6,-6,696,0,-696,-10185,0,0,0,0,0
EUW1_6883609053',2,145,14,1,0,1,0,13,0,338,101,29113,30489,31118,3,26,14,1,0,1,0,4,374,62,28216,27755,25559,1,-36,39,897,0,2734,5559,0,0,0,0,9
EUW1_6883585466',2,22,14,0,1,0,0,4,1,344,80,27023,30932,34246,7,34,14,2,0,0,0,2,341,80,27678,30472,36449,0,3,0,-655,0,460,-2203,-2,1,0,0,2
EUW1_6883551818',2,25,12,1,0,1,0,6,1,345,93,28453,28777,32005,5,36,15,0,0,0,0,5,355,54,27787,29121,38534,0,-10,39,666,-3,-344,-6529,1,0,1,0,1
EUW1_6883497950',4,81,18,1,0,0,0,11,1,314,74,29288,27375,31973,7,65,18,0,0,0,0,2,317,52,27706,27018,33553,1,-3,22,1582,0,357,-1580,1,0,0,0,9
EUW1_6883438996',3,28,12,1,0,0,0,8,1,363,76,26457,28549,30682,3,89,9,0,0,0,0,3,394,65,27010,29907,29898,1,-31,11,-553,3,-1358,784,1,0,0,0,5
EUW1_6883373329',1,28,12,0,0,1,0,12,0,371,69,27790,30254,33879,5,36,16,1,0,1,0,5,344,103,29601,30347,37992,0,27,-34,-1811,-4,-93,-4113,-1,0,0,0,7
EUW1_6883301296',7,26,13,1,0,0,0,10,0,365,96,27103,29806,31270,5,23,11,1,1,1,0,0,394,96,28322,29558,32920,0,-29,0,-1219,2,248,-1650,0,-1,-1,0,10
EUW1_6883219108',6,29,10,1,0,1,0,10,1,358,68,26683,28306,31355,4,21,12,0,0,0,0,2,368,112,28181,29254,33275,1,-10,-44,-1498,-2,-948,-1920,1,0,1,0,8
EUW1_6883154322',3,26,8,0,0,0,0,9,1,351,82,25631,28268,28400,2,94,16,2,1,0,0,5,340,102,28859,32607,34936,0,11,-20,-3228,-8,-4339,-6536,-2,-1,0,0,4
EUW1_6883097994',5,30,16,0,0,0,0,10,1,354,98,29458,31362,38219,2,71,11,0,0,0,0,2,335,88,26039,29366,28465,1,19,10,3419,5,1996,9754,0,0,0,0,8
EUW1_6883003835',4,26,13,0,1,1,0,18,0,314,83,26732,30348,33733,3,31,15,2,0,3,0,5,364,93,30551,30834,33609,0,-50,-10,-3819,-2,-486,124,-2,1,-2,0,13
EUW1_6882928256',5,31,8,1,1,1,0,9,0,369,93,26061,29605,26931,3,28,9,1,0,1,0,6,394,88,27433,31350,29013,0,-25,5,-1372,-1,-1745,-2082,0,1,0,0,3
EUW1_6882827869',4,27,13,1,0,0,0,9,1,321,60,26283,30070,34223,3,40,16,0,0,0,0,4,347,98,28778,31018,38143,0,-26,-38,-2495,-3,-948,-3920,1,0,0,0,5
EUW1_6882782975',4,23,17,1,0,2,0,10,1,339,86,30633,30439,35039,5,26,6,0,0,0,0,7,353,74,24096,28484,27184,1,-14,12,6537,11,1955,7855,1,0,2,0,3
EUW1_6882750674',5,25,12,1,0,0,0,8,1,319,88,26923,27821,33341,3,22,17,1,0,1,0,2,371,72,30817,31131,41884,0,-52,16,-3894,-5,-3310,-8543,0,0,-1,0,6
EUW1_6882716967',4,39,10,1,1,0,0,9,1,404,99,28263,30021,33914,3,30,8,0,0,1,0,1,362,84,25948,28589,24478,1,42,15,2315,2,1432,9436,1,1,-1,0,8
EUW1_6880924613',6,22,12,0,0,0,0,12,0,332,68,26297,26868,24301,1,21,15,2,0,1,0,2,349,80,29257,30053,30951,0,-17,-12,-2960,-3,-3185,-6650,-2,0,-1,0,10
EUW1_6880516568',4,70,13,0,0,1,0,11,1,339,68,27734,28714,31985,0,22,19,1,0,2,0,3,341,99,30946,30510,36638,0,-2,-31,-3212,-6,-1796,-4653,-1,0,-1,0,8
EUW1_6880256147',7,27,12,1,0,0,0,6,0,382,88,27361,31041,30320,2,24,10,0,0,1,0,0,361,100,26672,29661,21765,1,21,-12,689,2,1380,8555,1,0,-1,0,6
EUW1_6880195222',2,60,18,1,0,0,0,11,1,274,76,27085,25064,35066,5,28,19,1,0,1,0,2,302,62,29940,27845,43470,0,-28,14,-2855,-1,-2781,-8404,0,0,-1,0,9
EUW1_6880022022',8,31,12,0,0,0,0,7,1,367,106,27908,30216,29007,2,42,12,2,0,0,0,6,357,96,26869,29743,28527,1,10,10,1039,0,473,480,-2,0,0,0,1
EUW1_6879970584',5,26,5,0,1,1,0,7,1,390,74,26523,27493,28400,6,32,12,2,0,1,0,10,280,103,26342,28790,28246,1,110,-29,181,-7,-1297,154,-2,1,0,0,-3
EUW1_6879911870',3,26,11,1,0,1,0,10,0,358,84,26846,29411,32173,5,45,11,1,0,0,0,4,343,76,26622,29132,24191,1,15,8,224,0,279,7982,0,0,1,0,6
EUW1_6879884651',0,15,3,0,0,0,0,14,0,304,88,21339,25887,14499,6,43,13,1,1,2,0,3,348,84,28837,29076,34906,0,-44,4,-7498,-10,-3189,-20407,-1,-1,-2,0,11
EUW1_6879825933',6,216,10,1,0,1,0,8,1,323,80,26646,29384,25833,3,37,8,1,0,1,0,3,359,88,25669,29574,30747,1,-36,-8,977,2,-190,-4914,0,0,0,0,5
EUW1_6879767001',5,28,17,1,0,0,0,8,1,319,92,29401,28483,35989,3,28,15,1,0,0,0,5,352,96,28940,29215,36017,0,-33,-4,461,2,-732,-28,0,0,0,0,3
EUW1_6879716907',6,31,6,1,0,0,0,9,0,332,67,23453,27982,32018,1,25,14,1,0,0,0,4,362,100,27958,32123,30301,1,-30,-33,-4505,-8,-4141,1717,0,0,0,0,5
EUW1_6879661285',3,39,10,0,0,1,0,8,1,360,78,26654,29601,25720,8,32,9,1,0,0,0,5,346,89,25847,28975,25145,1,14,-11,807,1,626,575,-1,0,1,0,3
EUW1_6879532955',1,26,18,1,1,0,0,5,1,319,98,29472,27991,31086,3,26,18,1,0,0,0,1,347,86,29311,29357,35088,0,-28,12,161,0,-1366,-4002,0,1,0,0,4
EUW1_6879490294',5,31,14,1,0,1,0,6,0,345,117,29859,30437,35791,5,30,16,1,0,1,0,6,310,92,29300,29156,36609,0,35,25,559,-2,1281,-818,0,0,0,0,0
EUW1_6879250430',3,71,13,1,0,1,0,9,0,300,100,26446,30185,31202,4,61,13,1,0,1,0,1,323,103,27753,29190,34168,1,-23,-3,-1307,0,995,-2966,0,0,0,0,8
EUW1_6879224057',3,28,13,2,0,1,0,6,1,372,78,28950,29316,37524,4,21,10,0,0,0,0,4,381,92,26466,31058,24372,0,-9,-14,2484,3,-1742,13152,2,0,1,0,2
EUW1_6879203592',3,28,9,0,0,0,0,9,0,380,80,26214,28276,31832,4,30,19,2,0,1,0,6,337,104,32189,30141,40130,0,43,-24,-5975,-10,-1865,-8298,-2,0,-1,0,3
EUW1_6879164246',4,35,13,1,1,1,0,5,1,359,88,28222,31053,27149,7,30,10,0,0,0,0,2,338,75,24089,28734,28430,1,21,13,4133,3,2319,-1281,1,1,1,0,3
EUW1_6881657097',2,27,7,1,0,0,0,9,1,361,68,23871,28360,28076,3,41,7,1,0,0,0,3,369,88,24259,29356,26755,1,-8,-20,-388,0,-996,1321,0,0,0,0,6
EUW1_6880283351',5,25,12,1,0,0,0,8,0,366,88,27365,31025,32328,3,24,11,1,0,1,0,4,379,101,27723,32002,26358,0,-13,-13,-358,1,-977,5970,0,0,-1,0,4
EUW1_6878145243',4,22,10,1,0,0,0,15,1,328,74,25115,27441,31507,6,32,19,0,1,3,0,5,351,89,31930,31064,37508,1,-23,-15,-6815,-9,-3623,-6001,1,-1,-3,0,10
EUW1_6875802578',0,23,9,0,0,0,0,13,0,329,78,24790,26618,26707,5,36,18,2,0,2,0,2,321,101,30572,29371,38766,0,8,-23,-5782,-9,-2753,-12059,-2,0,-2,0,11
EUW1_6875738826',0,21,13,1,0,0,0,6,1,356,108,27269,29595,36784,4,311,17,1,0,0,0,2,301,88,27917,30379,33536,1,55,20,-648,-4,-784,3248,0,0,0,0,4
EUW1_6875614666',3,22,13,1,1,0,0,11,1,347,86,27093,31322,30372,2,32,12,1,0,1,0,2,348,90,27642,31450,28438,0,-1,-4,-549,1,-128,1934,0,1,-1,0,9
EUW1_6875136377',3,21,10,1,0,2,0,9,0,376,92,28334,29761,26120,3,23,11,0,0,0,0,8,334,76,26319,29005,24756,1,42,16,2015,-1,756,1364,1,0,2,0,1
EUW1_6882716489',1,24,14,0,0,0,0,8,1,363,76,27139,28924,30100,3,25,11,0,0,0,0,3,325,100,25917,29869,32744,1,38,-24,1222,3,-945,-2644,0,0,0,0,5
EUW1_6882661743',2,18,6,1,0,0,0,9,1,399,96,24825,30694,20121,2,148,7,1,0,1,0,4,378,90,25445,30721,23380,0,21,6,-620,-1,-27,-3259,0,0,-1,0,5
EUW1_6882639691',2,25,6,0,0,0,0,8,0,352,80,22715,29452,23636,4,27,16,2,0,1,0,2,371,96,29634,31684,32874,0,-19,-16,-6919,-10,-2232,-9238,-2,0,-1,0,6
EUW1_6882439297',3,24,13,1,0,1,0,10,0,364,92,27821,30163,27023,3,135,13,1,0,1,0,4,372,104,28852,30949,30999,0,-8,-12,-1031,0,-786,-3976,0,0,0,0,6
EUW1_6880432953',4,21,12,0,0,0,0,17,0,339,74,26399,27970,28724,1,27,19,2,1,2,0,1,363,114,32727,31974,38451,0,-24,-40,-6328,-7,-4004,-9727,-2,-1,-2,0,16
EUW1_6880231400',4,22,9,1,0,0,0,11,0,385,78,25911,30340,25006,3,35,9,1,0,0,0,3,373,101,26107,29922,29033,0,12,-23,-196,0,418,-4027,0,0,0,0,8
EUW1_6880141637',6,58,13,0,0,0,0,7,0,352,92,27840,30905,32062,3,94,13,2,0,1,0,4,310,108,27028,30494,33451,0,42,-16,812,0,411,-1389,-2,0,-1,0,3
EUW1_6880075329',9,30,2,2,0,0,0,4,1,378,86,23704,29893,29135,5,38,3,0,0,0,0,4,378,86,22470,29728,25964,1,0,0,1234,-1,165,3171,2,0,0,0,0
EUW1_6880021321',3,23,12,1,0,1,0,11,1,353,80,26817,29520,29172,5,29,14,0,1,1,0,4,364,72,28693,28414,32679,0,-11,8,-1876,-2,1106,-3507,1,-1,0,0,7
EUW1_6879975148',5,25,2,0,0,0,0,13,1,343,89,22225,26109,16909,6,34,15,2,0,2,0,3,390,131,30418,32323,31672,0,-47,-42,-8193,-13,-6214,-14763,-2,0,-2,0,10
EUW1_6879920064',3,201,5,0,0,0,0,9,0,349,78,23415,27726,22464,5,135,15,2,0,2,0,1,406,109,29901,31809,27835,0,-57,-31,-6486,-10,-4083,-5371,-2,0,-2,0,8
EUW1_6879792769',1,28,11,2,0,0,0,8,0,357,90,27681,29774,33814,4,23,19,0,0,1,0,2,356,88,30484,31415,34746,1,1,2,-2803,-8,-1641,-932,2,0,-1,0,6
EUW1_6879731227',1,26,16,0,0,1,0,10,0,361,72,30091,30744,39126,4,25,24,1,1,0,0,8,327,101,31034,30652,41559,1,34,-29,-943,-8,92,-2433,-1,-1,1,0,2
EUW1_6882587125',2,30,19,1,0,4,0,6,1,352,112,31466,30870,34896,2,227,8,0,0,0,0,8,327,68,23652,25793,26610,1,25,44,7814,11,5077,8286,1,0,4,0,-2
EUW1_6882555339',5,279,16,1,0,0,0,8,1,327,85,27987,29423,32338,10,35,6,0,0,0,0,5,324,90,23694,26489,26064,1,3,-5,4293,10,2934,6274,1,0,0,0,3
EUW1_6881034616',7,32,11,2,1,1,0,9,0,320,89,26145,29605,21616,6,393,5,0,0,0,0,5,385,90,25033,29177,25704,1,-65,-1,1112,6,428,-4088,2,1,1,0,4
EUW1_6880982785',4,208,12,0,0,1,0,8,0,352,78,27312,31218,28831,7,29,9,1,0,1,0,5,373,97,27398,30227,27590,0,-21,-19,-86,3,991,1241,-1,0,0,0,3
EUW1_6876127795',4,43,12,1,0,0,0,4,1,375,100,27528,31716,31048,3,26,7,0,0,1,0,2,358,84,24850,29142,24662,1,17,16,2678,5,2574,6386,1,0,-1,0,2
EUW1_6876035546',5,30,15,1,0,1,0,5,1,365,112,28551,32172,34485,4,33,5,0,0,0,0,6,345,84,22971,27021,27140,0,20,28,5580,10,5151,7345,1,0,1,0,-1
EUW1_6875470845',5,26,10,0,0,1,0,7,1,373,89,27703,29009,32973,3,32,14,2,0,1,0,4,373,99,29918,30592,26964,0,0,-10,-2215,-4,-1583,6009,-2,0,0,0,3
EUW1_6875427639',6,31,8,2,0,0,0,9,1,352,94,24797,27624,29787,5,30,13,0,0,1,0,1,381,93,28645,32786,34836,1,-29,1,-3848,-5,-5162,-5049,2,0,-1,0,8
EUW1_6874796339',3,26,15,0,0,3,0,7,1,350,96,30088,31308,31152,5,35,11,2,0,1,0,8,341,95,27212,29002,32605,0,9,1,2876,4,2306,-1453,-2,0,2,0,-1
EUW1_6874740592',5,48,15,0,0,1,0,10,1,373,90,28474,31150,31826,5,31,4,2,0,0,0,3,357,86,23271,27476,29264,0,16,4,5203,11,3674,2562,-2,0,1,0,7
EUW1_6874250098',3,26,11,1,0,2,0,10,1,363,88,29451,29827,31463,5,242,10,1,0,0,0,4,310,70,25077,25969,28152,1,53,18,4374,1,3858,3311,0,0,2,0,6
EUW1_6874199347',3,22,7,0,0,0,0,6,1,401,106,25589,30592,25347,6,34,11,2,0,0,0,1,398,80,25674,32344,30803,0,3,26,-85,-4,-1752,-5456,-2,0,0,0,5
EUW1_6874160489',4,31,10,2,0,0,0,6,1,382,99,28043,29618,31463,4,25,9,0,0,1,0,6,286,80,23281,26468,27351,1,96,19,4762,1,3150,4112,2,0,-1,0,0
EUW1_6874062457',4,139,18,1,0,2,0,10,0,362,104,31668,31423,35915,4,230,16,0,0,0,0,7,322,72,28147,28711,32177,1,40,32,3521,2,2712,3738,1,0,2,0,3
EUW1_6873904706',2,236,7,1,0,1,0,17,0,353,98,25452,27585,24051,7,31,15,1,0,2,0,1,365,90,29401,30160,32786,0,-12,8,-3949,-8,-2575,-8735,0,0,-1,0,16
EUW1_6873878750',5,33,13,2,1,0,0,8,1,367,124,28976,31004,30617,4,120,6,0,0,1,0,7,359,76,23860,28856,19911,1,8,48,5116,7,2148,10706,2,1,-1,0,1
EUW1_6873560649',3,33,13,2,0,1,0,10,1,315,74,28029,27224,34686,3,275,20,0,0,1,0,9,329,72,30242,27563,37717,1,-14,2,-2213,-7,-339,-3031,2,0,0,0,1
EUW1_6873396407',6,26,4,0,0,0,0,6,0,334,78,22752,28365,22668,4,368,12,0,1,1,0,0,386,88,28007,31464,34903,0,-52,-10,-5255,-8,-3099,-12235,0,-1,-1,0,6
EUW1_6873321513',4,27,7,1,0,0,0,9,0,331,90,24248,27717,25619,6,226,15,0,0,2,0,0,384,81,30321,30394,30583,0,-53,9,-6073,-8,-2677,-4964,1,0,-2,0,9
EUW1_6881675731',0,22,19,1,0,3,0,9,1,393,75,32940,32655,40610,3,22,9,0,0,1,0,9,308,88,25239,30076,24566,1,85,-13,7701,10,2579,16044,1,0,2,0,0
EUW1_6881605223',10,56,14,1,0,1,0,7,1,334,92,30579,28620,30410,4,28,16,1,0,0,0,3,351,79,29241,29075,32342,1,-17,13,1338,-2,-455,-1932,0,0,1,0,4
EUW1_6880791205',4,20,22,1,0,1,0,6,1,354,96,31649,33761,38899,3,20,9,1,0,0,0,8,302,92,23802,27039,37078,0,52,4,7847,13,6722,1821,0,0,1,0,-2
EUW1_6880774424',3,87,17,1,0,2,0,7,1,351,84,29131,31024,41433,5,101,6,0,0,0,0,4,341,64,22976,27578,25954,1,10,20,6155,11,3446,15479,1,0,2,0,3
EUW1_6880771581',4,28,14,0,0,0,0,10,1,301,64,26474,26110,38226,3,32,12,2,0,1,0,4,308,104,27526,26689,32314,0,-7,-40,-1052,2,-579,5912,-2,0,-1,0,6
EUW1_6880747487',3,35,22,0,0,1,0,7,1,345,96,30607,32037,39479,3,28,11,2,0,0,0,6,362,74,26180,27916,30482,1,-17,22,4427,11,4121,8997,-2,0,1,0,1
EUW1_6880714349',1,136,7,1,0,0,0,9,0,314,92,23895,27655,23922,5,43,19,1,0,2,0,4,359,92,32778,31429,37080,0,-45,0,-8883,-12,-3774,-13158,0,0,-2,0,5
EUW1_6880703751',1,28,28,1,0,4,1,10,1,302,79,36211,27298,40642,2,19,8,0,0,1,0,8,227,91,22646,19411,22738,1,75,-12,13565,20,7887,17904,1,0,3,1,2
EUW1_6880667390',3,34,19,2,0,0,0,11,1,338,90,30589,29526,32636,7,54,15,0,0,1,0,3,355,68,28020,29020,31756,1,-17,22,2569,4,506,880,2,0,-1,0,8
EUW1_6880632900',4,20,13,1,0,0,0,9,0,362,94,27240,29972,29252,3,29,12,1,1,0,0,5,318,96,27089,29594,26906,1,44,-2,151,1,378,2346,0,-1,0,0,4
EUW1_6880610040',1,21,19,1,0,2,0,7,1,360,71,32084,30184,36770,2,245,6,0,0,1,0,10,270,77,21890,25293,23432,1,90,-6,10194,13,4891,13338,1,0,1,0,-3
EUW1_6880544506',3,25,11,0,0,0,0,13,0,335,96,27153,30245,28666,7,37,17,2,0,1,0,3,404,88,30087,32137,41280,0,-69,8,-2934,-6,-1892,-12614,-2,0,-1,0,10
EUW1_6880423405',1,27,6,0,0,0,0,18,0,341,64,24362,25551,24604,4,29,25,2,0,4,0,5,355,108,34445,32933,39679,0,-14,-44,-10083,-19,-7382,-15075,-2,0,-4,0,13
EUW1_6880279954',2,34,4,1,0,1,0,2,1,351,91,23375,28726,26314,4,27,6,1,0,0,0,2,390,100,24545,29179,20597,1,-39,-9,-1170,-2,-453,5717,0,0,1,0,0
EUW1_6879734460',5,29,22,1,0,1,0,9,1,350,90,31731,30499,41924,10,30,15,1,0,0,0,0,336,66,27329,27337,34703,1,14,24,4402,7,3162,7221,0,0,1,0,9
EUW1_6879687637',11,44,7,0,0,1,0,8,0,434,73,27048,31236,21878,6,28,7,2,0,0,0,3,382,112,25901,29828,22229,1,52,-39,1147,0,1408,-351,-2,0,1,0,5
EUW1_6877944530',5,33,10,0,0,0,0,6,0,376,88,25723,30484,35729,5,34,9,1,0,0,0,0,401,92,26301,31113,28361,1,-25,-4,-578,1,-629,7368,-1,0,0,0,6
EUW1_6877923253',3,47,21,1,0,2,0,10,1,362,90,31983,33931,37742,1,31,8,0,0,0,0,5,304,73,24679,28639,27998,1,58,17,7304,13,5292,9744,1,0,2,0,5
EUW1_6877911264',5,26,10,2,0,1,0,4,1,417,98,27961,31327,23715,3,44,5,0,0,0,0,6,378,73,24260,29684,24021,1,39,25,3701,5,1643,-306,2,0,1,0,-2
EUW1_6880297594',3,35,12,0,0,1,0,8,0,343,104,26990,30788,31231,4,30,11,2,1,0,0,2,324,84,25776,29455,32338,0,19,20,1214,1,1333,-1107,-2,-1,1,0,6
EUW1_6880231952',3,27,9,0,0,0,0,9,0,331,92,26211,29223,27469,5,37,17,1,1,1,0,2,346,75,28432,30936,40157,0,-15,17,-2221,-8,-1713,-12688,-1,-1,-1,0,7
EUW1_6875655042',2,26,13,1,0,1,0,6,1,323,60,26598,28278,27955,5,30,11,1,0,1,0,1,383,88,26631,29588,27529,0,-60,-28,-33,2,-1310,426,0,0,0,0,5
EUW1_6875609927',1,29,20,2,1,2,0,18,1,357,68,33430,29565,38259,3,97,14,0,0,4,0,8,305,70,28459,27875,30684,0,52,-2,4971,6,1690,7575,2,1,-2,0,10
EUW1_6875560850',1,21,12,0,0,0,0,7,0,347,94,27834,30260,26487,1,21,7,1,0,0,0,3,331,82,23894,27189,28747,1,16,12,3940,5,3071,-2260,-1,0,0,0,4
EUW1_6866775878',1,32,10,1,0,0,0,9,0,325,56,25680,28914,29188,5,27,17,1,0,0,0,6,310,84,26331,29808,35141,0,15,-28,-651,-7,-894,-5953,0,0,0,0,3
EUW1_6866721837',0,26,15,1,0,0,0,11,1,338,78,28606,29969,29739,2,25,13,1,0,1,0,4,383,94,29478,31192,37753,0,-45,-16,-872,2,-1223,-8014,0,0,-1,0,7
EUW1_6862602415',3,17,12,0,0,0,0,3,1,348,110,26188,30124,22423,1,27,6,2,0,0,0,1,341,82,23601,28460,23567,1,7,28,2587,6,1664,-1144,-2,0,0,0,2
EUW1_6862548214',3,29,18,0,1,1,0,7,1,384,79,30434,31317,35463,4,33,10,1,0,0,0,6,332,86,25710,27887,28146,1,52,-7,4724,8,3430,7317,-1,1,1,0,1
EUW1_6854802150',7,29,16,1,0,2,0,11,0,341,70,30352,28801,36364,3,21,13,1,0,0,0,9,325,117,28190,30604,30413,1,16,-47,2162,3,-1803,5951,0,0,2,0,2
EUW1_6883779854',2,19,10,0,0,0,0,13,0,360,98,27764,31777,27395,3,30,12,2,1,3,0,4,380,120,30321,33029,30882,0,-20,-22,-2557,-2,-1252,-3487,-2,-1,-3,0,9
EUW1_6883753965',8,29,13,1,0,1,0,9,1,345,98,27695,29863,36478,5,31,10,1,0,0,0,3,313,86,25674,28723,29897,1,32,12,2021,3,1140,6581,0,0,1,0,6
EUW1_6883716620',3,42,9,1,0,0,0,2,1,355,83,24700,27986,23136,2,28,3,0,0,0,0,2,340,84,22053,27294,25382,1,15,-1,2647,6,692,-2246,1,0,0,0,0
EUW1_6883705133',3,25,20,1,1,1,0,7,0,315,94,29558,28782,32104,3,50,11,1,0,0,0,5,338,84,26491,28251,32267,1,-23,10,3067,9,531,-163,0,1,1,0,2
EUW1_6882598765',1,26,5,1,0,0,0,6,0,406,84,24346,29798,19905,6,101,7,1,0,0,0,2,347,90,24503,28897,24047,1,59,-6,-157,-2,901,-4142,0,0,0,0,4
EUW1_6882560257',3,25,3,1,0,0,0,11,0,357,104,23878,28338,23503,6,23,13,1,1,2,0,6,398,76,29115,30780,23986,0,-41,28,-5237,-10,-2442,-483,0,-1,-2,0,5
EUW1_6882528553',1,20,9,0,0,0,0,15,1,273,106,24398,27822,29761,7,29,13,2,0,3,0,3,325,66,27941,29218,34056,0,-52,40,-3543,-4,-1396,-4295,-2,0,-3,0,12
EUW1_6882485589',3,22,19,1,0,1,0,7,1,350,97,30697,31256,36764,4,31,11,1,0,0,0,4,324,57,25406,26526,33238,1,26,40,5291,8,4730,3526,0,0,1,0,3
EUW1_6882455684',3,25,8,1,0,0,0,13,1,365,77,25813,29185,35198,0,35,9,0,0,2,0,2,356,110,26125,30026,32718,1,9,-33,-312,-1,-841,2480,1,0,-2,0,11
EUW1_6882384433',6,330,7,0,0,1,0,8,1,356,96,26566,27970,32118,4,25,16,2,0,0,0,6,402,84,29287,32872,33558,0,-46,12,-2721,-9,-4902,-1440,-2,0,1,0,2
EUW1_6882379663',5,24,6,0,0,1,0,8,1,356,103,25525,30410,24792,3,26,5,2,0,0,0,4,328,84,22850,27547,20343,1,28,19,2675,1,2863,4449,-2,0,1,0,4
EUW1_6882355347',6,32,6,0,0,0,0,12,0,305,78,22892,25654,21209,4,27,17,2,1,2,0,0,361,110,30777,31950,33276,0,-56,-32,-7885,-11,-6296,-12067,-2,-1,-2,0,12
EUW1_6882350894',3,33,14,0,0,0,0,12,1,272,60,24730,24852,37903,4,25,15,2,0,1,0,0,373,72,28878,29843,36298,0,-101,-12,-4148,-1,-4991,1605,-2,0,-1,0,12
EUW1_6882337333',0,27,4,0,0,0,0,12,0,291,93,22182,25099,23237,3,98,25,2,0,2,0,1,336,93,33427,32823,38120,0,-45,0,-11245,-21,-7724,-14883,-2,0,-2,0,11
EUW1_6880863860',5,32,7,2,0,0,0,10,0,352,73,24178,28266,25291,0,21,9,0,0,1,0,1,395,94,26823,30113,29169,0,-43,-21,-2645,-2,-1847,-3878,2,0,-1,0,9
EUW1_6880841419',4,17,17,2,0,2,0,10,1,342,116,30470,32740,37273,5,29,12,0,0,0,0,10,351,56,26105,28528,29134,1,-9,60,4365,5,4212,8139,2,0,2,0,0
EUW1_6879795791',5,28,9,0,0,0,0,9,0,325,99,24799,29117,29304,3,25,17,2,0,1,0,1,406,88,30278,32755,40607,0,-81,11,-5479,-8,-3638,-11303,-2,0,-1,0,8
EUW1_6879711202',4,27,10,0,0,0,0,5,0,384,83,26518,29382,35616,4,42,11,2,0,0,0,2,354,107,26317,29551,29247,0,30,-24,201,-1,-169,6369,-2,0,0,0,3
EUW1_6879653326',9,33,6,1,0,0,0,9,0,353,66,23168,27088,17580,6,29,15,1,0,2,0,1,378,89,29883,30909,30677,1,-25,-23,-6715,-9,-3821,-13097,0,0,-2,0,8
EUW1_6878424397',3,26,6,1,0,1,0,8,0,400,89,26420,30711,24290,5,29,11,1,0,0,0,4,409,86,27221,31303,28976,0,-9,3,-801,-5,-592,-4686,0,0,1,0,4
EUW1_6878371449',2,32,13,2,0,0,0,9,0,360,72,26493,30365,30637,1,91,15,0,0,1,0,2,345,73,27463,30632,32272,0,15,-1,-970,-2,-267,-1635,2,0,-1,0,7
EUW1_6876994358',3,25,15,1,1,1,0,8,1,352,90,30293,31858,35984,0,33,11,0,0,1,0,6,317,75,25309,29309,28156,0,35,15,4984,4,2549,7828,1,1,0,0,2
EUW1_6876961549',5,23,11,1,0,0,0,9,1,347,79,25550,28427,29399,2,28,19,0,0,1,0,2,330,80,29634,30369,40459,0,17,-1,-4084,-8,-1942,-11060,1,0,-1,0,7
EUW1_6876902854',3,75,24,0,0,1,0,9,1,308,78,32855,30685,48474,1,52,17,1,0,0,0,5,328,88,28265,27364,38791,1,-20,-10,4590,7,3321,9683,-1,0,1,0,4
EUW1_6876854216',3,21,14,2,0,1,0,7,1,371,98,29808,32222,32051,3,36,8,0,0,0,0,6,399,72,25497,29069,29828,1,-28,26,4311,6,3153,2223,2,0,1,0,1
EUW1_6876806261',3,24,16,1,1,0,0,7,1,363,86,28629,30606,30957,3,23,6,0,0,0,0,2,314,92,23707,27347,26190,0,49,-6,4922,10,3259,4767,1,1,0,0,5
EUW1_6876607415',2,27,5,0,0,0,0,15,0,347,89,23503,29245,22208,8,27,10,2,1,3,0,2,406,104,30021,31861,26439,0,-59,-15,-6518,-5,-2616,-4231,-2,-1,-3,0,13
EUW1_6876586556',5,33,13,0,0,2,0,7,0,332,86,28926,29390,39324,3,28,13,2,0,1,0,7,320,90,27570,27097,35971,0,12,-4,1356,0,2293,3353,-2,0,1,0,0
EUW1_6875713459',3,28,18,1,1,1,0,5,1,345,107,30224,29423,31106,7,43,9,1,0,0,0,5,309,60,24133,24361,26931,1,36,47,6091,9,5062,4175,0,1,1,0,0
EUW1_6875527833',4,25,10,2,0,0,0,12,0,269,92,24689,28376,33904,3,27,18,0,0,2,0,2,378,88,31567,30693,35498,1,-109,4,-6878,-8,-2317,-1594,2,0,-2,0,10
EUW1_6875489975',4,25,16,0,0,1,0,6,1,373,84,29367,31476,35482,7,36,13,2,1,0,0,5,348,112,28231,31935,39296,1,25,-28,1136,3,-459,-3814,-2,-1,1,0,1
EUW1_6873002486',3,24,23,2,0,0,0,7,1,328,81,30975,30083,41392,6,24,13,0,0,0,0,4,303,78,26142,26030,31538,1,25,3,4833,10,4053,9854,2,0,0,0,3
EUW1_6883169072',3,20,11,0,0,0,0,11,0,337,76,25935,27856,23921,4,20,16,1,0,1,0,3,339,84,27988,28879,35363,1,-2,-8,-2053,-5,-1023,-11442,-1,0,-1,0,8
EUW1_6881192249',3,21,10,1,1,1,0,8,0,380,82,27928,30375,28314,4,186,11,1,0,1,0,1,370,96,28923,30666,28002,0,10,-14,-995,-1,-291,312,0,1,0,0,7
EUW1_6879795870',4,28,11,1,0,2,0,8,1,365,84,28428,29179,32449,6,27,12,1,1,0,0,7,362,84,26337,29997,27579,0,3,0,2091,-1,-818,4870,0,-1,2,0,1
EUW1_6879741134',8,34,11,0,0,0,0,13,0,289,64,24247,25424,30560,3,174,20,1,0,2,0,1,367,100,31515,32671,39063,0,-78,-36,-7268,-9,-7247,-8503,-1,0,-2,0,12
EUW1_6879698095',3,135,5,2,0,0,0,14,0,330,106,23190,28415,23866,2,51,13,0,1,2,0,2,382,91,30008,31442,35078,0,-52,15,-6818,-8,-3027,-11212,2,-1,-2,0,12
EUW1_6878761800',4,28,4,0,0,0,0,9,0,331,74,22415,28597,25802,5,29,17,1,0,2,0,3,383,79,30058,31764,36089,0,-52,-5,-7643,-13,-3167,-10287,-1,0,-2,0,6
EUW1_6841075484',3,30,6,0,0,0,0,9,0,312,76,23157,26218,24792,3,30,14,2,0,1,0,2,352,79,28557,29312,35030,0,-40,-3,-5400,-8,-3094,-10238,-2,0,-1,0,7
EUW1_6830293804',5,26,15,2,0,1,0,8,1,310,84,29481,28107,34296,2,26,15,0,0,1,0,5,351,93,29519,30707,33574,1,-41,-9,-38,0,-2600,722,2,0,0,0,3
EUW1_6830238961',5,35,12,2,0,0,0,6,0,355,80,28303,30112,33431,6,63,14,0,0,1,0,3,380,80,29050,29021,27069,0,-25,0,-747,-2,1091,6362,2,0,-1,0,3
EUW1_6823285472',6,33,10,1,0,0,0,16,1,320,76,25879,26594,25220,2,41,8,1,0,2,0,4,345,112,27549,28763,25522,0,-25,-36,-1670,2,-2169,-302,0,0,-2,0,12
EUW1_6823205782',6,32,14,1,0,0,0,10,1,339,81,27648,30376,28587,4,27,11,1,0,1,0,2,361,98,28868,30224,28277,1,-22,-17,-1220,3,152,310,0,0,-1,0,8
EUW1_6882674490',8,31,10,1,0,2,0,10,0,368,62,26971,28927,37960,6,30,11,1,0,1,0,5,355,90,26867,29469,29883,1,13,-28,104,-1,-542,8077,0,0,1,0,5
EUW1_6882643458',6,35,6,0,0,0,0,8,0,316,75,23767,26957,25916,7,41,16,1,0,1,0,0,361,95,29316,31137,35775,0,-45,-20,-5549,-10,-4180,-9859,-1,0,-1,0,8
EUW1_6882608894',6,34,14,1,0,0,0,5,0,389,92,28657,32822,31353,2,23,4,0,0,1,0,6,362,96,23442,27650,30796,1,27,-4,5215,10,5172,557,1,0,-1,0,-1
EUW1_6882578718',5,21,10,1,0,0,0,10,1,298,84,23458,28141,25316,1,27,7,1,0,1,0,1,350,116,26150,29239,27935,0,-52,-32,-2692,3,-1098,-2619,0,0,-1,0,9
EUW1_6882540860',3,23,16,1,0,1,0,3,0,382,98,31678,31251,33906,3,30,13,0,0,1,0,8,314,90,26071,27628,30702,0,68,8,5607,3,3623,3204,1,0,0,0,-5
EUW1_6882514624',2,17,13,2,0,1,0,9,0,336,113,28748,31003,29739,2,24,17,0,0,1,0,2,327,89,29161,30151,37287,0,9,24,-413,-4,852,-7548,2,0,0,0,7
EUW1_6882490486',3,61,10,1,1,0,0,10,0,334,102,25703,31375,26727,4,65,10,1,0,0,0,2,359,106,26761,29807,24835,0,-25,-4,-1058,0,1568,1892,0,1,0,0,8
EUW1_6882455999',2,19,17,1,0,1,0,8,0,344,80,29780,30252,38271,4,33,19,1,1,0,0,3,307,80,28988,31266,37888,1,37,0,792,-2,-1014,383,0,-1,1,0,5
EUW1_6882433208',7,40,16,1,0,1,0,9,1,327,79,28269,30129,33952,3,24,8,1,0,1,0,4,368,100,26896,29896,24845,1,-41,-21,1373,8,233,9107,0,0,0,0,5
EUW1_6882410711',2,21,11,1,0,0,0,13,1,322,85,26176,28612,33400,3,24,20,1,0,2,0,2,396,85,31131,31170,34425,0,-74,0,-4955,-9,-2558,-1025,0,0,-2,0,11
EUW1_6882394770',1,125,11,1,0,0,0,5,1,316,86,25955,30025,27978,2,25,11,1,1,1,0,1,369,98,27557,30851,27567,0,-53,-12,-1602,0,-826,411,0,-1,-1,0,4
EUW1_6882376989',3,31,17,0,0,0,0,11,0,288,57,27674,27088,44507,3,46,24,2,0,2,0,3,289,72,32161,28134,45301,0,-1,-15,-4487,-7,-1046,-794,-2,0,-2,0,8
EUW1_6881350397',3,30,10,1,0,1,0,9,1,369,100,28479,29307,31225,3,34,9,1,0,1,0,6,335,84,24812,30054,28205,1,34,16,3667,1,-747,3020,0,0,0,0,3
EUW1_6881287804',5,29,19,1,0,1,0,6,1,349,76,30489,29281,41129,2,267,13,1,0,1,0,6,278,72,25605,27326,33096,1,71,4,4884,6,1955,8033,0,0,0,0,0
EUW1_6882834134',2,26,14,0,0,1,0,5,0,368,82,28688,31639,35644,4,27,17,2,0,0,0,8,362,98,29375,31379,42221,1,6,-16,-687,-3,260,-6577,-2,0,1,0,-3
EUW1_6881030342',4,109,11,1,0,0,0,9,1,377,84,27027,31249,32164,2,28,9,1,0,1,0,1,404,108,27735,31858,27750,1,-27,-24,-708,2,-609,4414,0,0,-1,0,8
EUW1_6880998591',4,30,10,1,0,0,0,4,0,392,93,26578,30402,23865,5,32,8,1,0,0,0,4,362,102,25670,29564,27778,0,30,-9,908,2,838,-3913,0,0,0,0,0
EUW1_6880964297',6,63,2,0,0,0,0,12,0,296,114,21881,28296,24848,5,28,14,2,1,1,0,2,384,106,29441,32666,38379,0,-88,8,-7560,-12,-4370,-13531,-2,-1,-1,0,10
EUW1_6880931128',10,52,18,1,0,0,0,7,0,329,81,29718,26716,33161,7,32,15,1,0,1,0,5,306,74,27337,26939,33679,0,23,7,2381,3,-223,-518,0,0,-1,0,2
EUW1_6880913505',4,23,13,1,0,1,0,7,1,341,88,28263,30120,28557,6,26,13,1,0,0,0,1,330,96,26790,29709,30342,1,11,-8,1473,0,411,-1785,0,0,1,0,6
EUW1_6880895494',3,47,20,2,0,2,0,8,1,343,104,31749,30948,31685,5,22,12,0,0,0,0,7,330,88,26389,27670,22267,1,13,16,5360,8,3278,9418,2,0,2,0,1
EUW1_6880868986',3,23,8,0,0,0,0,7,0,295,99,24692,27051,23871,1,45,10,2,0,0,0,2,368,72,26703,29692,28007,1,-73,27,-2011,-2,-2641,-4136,-2,0,0,0,5
EUW1_6880850437',3,28,7,1,0,0,0,16,0,309,70,23091,26128,29228,2,38,31,1,0,3,0,3,347,70,35527,32233,44507,0,-38,0,-12436,-24,-6105,-15279,0,0,-3,0,13
EUW1_6880840259',2,28,7,1,0,1,0,14,0,297,90,24472,28190,37999,4,29,22,1,1,3,0,5,339,100,32115,31568,38245,0,-42,-10,-7643,-15,-3378,-246,0,-1,-2,0,9
EUW1_6880835783',6,32,20,2,0,0,0,9,1,320,87,33646,30777,41936,3,28,14,0,0,3,0,10,340,81,28465,29530,31646,1,-20,6,5181,6,1247,10290,2,0,-3,0,-1
EUW1_6880824743',3,25,12,2,0,1,0,9,1,338,86,26789,27813,30682,2,32,10,0,0,1,0,6,346,66,25838,26897,27259,0,-8,20,951,2,916,3423,2,0,0,0,3
EUW1_6880817486',8,67,17,0,0,1,0,4,1,381,84,31970,32691,39789,3,63,4,2,0,2,0,10,293,81,21532,26953,24350,1,88,3,10438,13,5738,15439,-2,0,-1,0,-6
EUW1_6880808527',5,28,16,1,0,2,0,10,0,407,87,31945,31187,38506,3,26,7,1,0,1,0,6,277,55,24152,24885,27745,1,130,32,7793,9,6302,10761,0,0,1,0,4
EUW1_6880792830',3,27,16,1,0,0,0,5,0,303,86,28028,28469,39989,3,32,23,1,0,1,0,3,293,92,30349,30264,39380,0,10,-6,-2321,-7,-1795,609,0,0,-1,0,2
EUW1_6880779073',5,29,16,1,0,2,0,5,1,340,105,30959,30869,35585,2,41,10,0,0,1,0,8,278,76,24099,23051,31734,1,62,29,6860,6,7818,3851,1,0,1,0,-3
EUW1_6880066820',5,32,6,1,0,0,0,9,0,396,112,25509,29258,28338,10,39,9,0,0,1,0,2,392,88,27252,30250,27457,1,4,24,-1743,-3,-992,881,1,0,-1,0,7
EUW1_6880011650',3,23,15,1,0,1,0,8,0,318,84,27687,26199,34848,5,34,19,0,0,0,0,5,327,88,29811,29041,40127,1,-9,-4,-2124,-4,-2842,-5279,1,0,1,0,3
EUW1_6879774140',4,41,20,0,0,0,0,12,1,356,90,31004,31547,33170,5,27,12,0,0,1,0,4,317,73,24348,25927,34945,1,39,17,6656,8,5620,-1775,0,0,-1,0,8
EUW1_6879794606',4,35,11,1,1,1,0,8,1,372,97,28694,30615,32802,6,30,11,1,0,2,0,6,327,69,25833,28271,28140,1,45,28,2861,0,2344,4662,0,1,-1,0,2
EUW1_6879745987',3,29,6,0,0,0,0,10,0,372,84,23587,27718,21142,6,44,13,2,0,1,0,3,344,86,28015,28670,32063,0,28,-2,-4428,-7,-952,-10921,-2,0,-1,0,7
EUW1_6758997856',4,178,8,1,0,0,0,11,0,315,71,23130,28067,21143,4,186,8,0,1,1,0,1,354,100,25941,29319,24465,0,-39,-29,-2811,0,-1252,-3322,1,-1,-1,0,10
EUW1_6758468710',4,25,7,0,0,0,0,7,0,362,88,24772,30351,31228,5,81,9,1,1,1,0,1,376,95,26704,31924,25858,1,-14,-7,-1932,-2,-1573,5370,-1,-1,-1,0,6
EUW1_6758451043',8,32,4,1,0,0,0,10,1,370,74,22467,27999,15521,2,26,6,1,1,1,0,0,390,105,26222,31499,26428,0,-20,-31,-3755,-2,-3500,-10907,0,-1,-1,0,10
EUW1_6758445649',1,21,12,0,1,0,0,11,1,281,91,26609,28744,28456,5,23,18,1,0,3,0,4,349,84,30868,30423,32812,0,-68,7,-4259,-6,-1679,-4356,-1,1,-3,0,7
EUW1_6758426663',2,25,10,1,0,1,0,11,1,358,96,25996,31331,28377,5,28,8,0,1,0,0,1,377,90,27400,32451,26271,1,-19,6,-1404,2,-1120,2106,1,-1,1,0,10
EUW1_6758411963',5,26,20,1,1,3,0,13,1,339,100,30097,32174,33449,1,18,4,0,0,0,0,4,278,89,21699,24870,26860,1,61,11,8398,16,7304,6589,1,1,3,0,9
EUW1_6758395965',9,36,11,0,1,0,0,12,1,328,93,26493,27720,24301,3,18,11,1,0,1,0,3,333,80,25921,28063,25077,0,-5,13,572,0,-343,-776,-1,1,-1,0,9
EUW1_6757923058',4,27,14,2,1,1,0,6,1,381,104,29204,30769,29823,5,56,6,0,0,0,0,6,301,80,23599,27672,26995,1,80,24,5605,8,3097,2828,2,1,1,0,0
EUW1_6757864847',4,34,14,2,1,1,0,6,0,380,85,29291,31235,30560,3,38,11,0,0,0,0,6,346,71,26319,28857,30953,1,34,14,2972,3,2378,-393,2,1,1,0,0
EUW1_6757772320',4,35,10,0,0,1,0,6,0,401,84,27699,31226,24086,9,37,10,1,1,0,0,5,358,81,25599,28136,26510,0,43,3,2100,0,3090,-2424,-1,-1,1,0,1
EUW1_6757697753',4,20,9,0,0,0,0,6,0,316,88,25005,29159,31407,4,44,10,0,1,0,0,3,341,104,26349,29878,25505,0,-25,-16,-1344,-1,-719,5902,0,-1,0,0,3
EUW1_6757564103',1,16,8,0,1,2,0,8,0,329,76,27136,30410,26612,6,28,14,2,0,0,0,6,333,88,26961,31943,34108,0,-4,-12,175,-6,-1533,-7496,-2,1,2,0,2
EUW1_6757360199',3,27,13,0,0,0,0,13,0,346,71,25921,29562,29268,6,40,13,1,1,0,0,1,316,76,26315,25690,39705,0,30,-5,-394,0,3872,-10437,-1,-1,0,0,12
EUW1_6757318332',3,44,16,2,0,1,0,7,0,360,104,31692,31237,37744,7,28,16,0,1,1,0,3,320,80,28263,29779,27538,1,40,24,3429,0,1458,10206,2,-1,0,0,4
EUW1_6757034050',5,20,12,0,1,1,0,9,1,325,76,26434,27524,28420,5,27,17,1,0,0,0,5,350,100,29547,31640,35187,1,-25,-24,-3113,-5,-4116,-6767,-1,1,1,0,4
EUW1_6757021001',4,27,6,1,0,0,0,10,0,318,72,23855,27723,19244,3,25,9,0,0,0,0,2,334,84,25359,28744,21320,1,-16,-12,-1504,-3,-1021,-2076,1,0,0,0,8
EUW1_6882080533',8,20,20,0,0,1,0,6,0,326,82,32067,29017,35556,5,26,16,2,0,0,0,6,284,88,27031,26066,33333,1,42,-6,5036,4,2951,2223,-2,0,1,0,0
EUW1_6881999363',3,26,13,0,0,0,0,9,0,387,92,29225,31886,36105,7,29,12,2,0,1,0,2,362,88,26477,28437,30494,1,25,4,2748,1,3449,5611,-2,0,-1,0,7
EUW1_6881936977',3,24,7,0,0,0,0,4,0,395,86,25394,29770,27965,4,33,9,1,0,0,0,3,357,82,24772,29232,24400,0,38,4,622,-2,538,3565,-1,0,0,0,1
EUW1_6881864336',1,57,16,2,0,0,0,10,0,286,97,28023,30089,33799,5,62,17,0,0,1,0,4,355,74,29849,29532,41366,1,-69,23,-1826,-1,557,-7567,2,0,-1,0,6
EUW1_6881793846',2,25,12,2,0,0,0,14,1,332,92,26598,30048,35541,6,27,18,0,0,2,0,2,363,94,30813,31858,37947,0,-31,-2,-4215,-6,-1810,-2406,2,0,-2,0,12
EUW1_6881649022',4,88,5,1,0,0,0,10,1,342,72,22830,27452,19451,5,55,7,1,0,3,0,1,376,92,28147,29735,24949,1,-34,-20,-5317,-2,-2283,-5498,0,0,-3,0,9
EUW1_6881605470',2,27,9,0,0,1,0,14,0,320,96,26682,26136,36190,3,44,20,1,1,3,0,3,305,100,31732,30478,30482,0,15,-4,-5050,-11,-4342,5708,-1,-1,-2,0,11
EUW1_6881528245',1,25,14,0,0,0,0,13,0,312,86,27108,29746,38428,3,28,18,1,0,3,0,2,310,72,30146,28205,39314,1,2,14,-3038,-4,1541,-886,-1,0,-3,0,11
EUW1_6881460015',3,23,14,0,0,1,0,8,0,330,73,29014,27815,37989,6,38,18,2,0,1,0,3,308,82,29760,28340,38618,1,22,-9,-746,-4,-525,-629,-2,0,0,0,5
EUW1_6881416950',5,28,18,1,0,1,0,10,0,317,98,30136,28431,32926,2,34,10,0,0,1,0,8,342,72,25544,26269,26454,1,-25,26,4592,8,2162,6472,1,0,0,0,2
EUW1_6881362891',8,26,6,0,0,0,0,7,1,403,95,24872,29860,25962,5,30,14,2,0,0,0,1,387,100,28798,31905,31765,0,16,-5,-3926,-8,-2045,-5803,-2,0,0,0,6
EUW1_6880722108',1,20,5,0,0,1,0,11,0,325,81,23037,27512,26296,0,9,26,1,0,2,0,4,330,79,32535,31230,43993,0,-5,2,-9498,-21,-3718,-17697,-1,0,-1,0,7
EUW1_6880698932',1,25,18,2,1,1,0,8,0,315,86,29578,28979,41134,4,29,18,0,0,1,0,4,286,101,29855,29244,40847,1,29,-15,-277,0,-265,287,2,1,0,0,4
EUW1_6880671707',6,31,17,1,0,0,0,6,0,339,92,29102,31324,45394,7,37,17,1,0,1,0,3,334,76,28999,30786,41641,1,5,16,103,0,538,3753,0,0,-1,0,3
EUW1_6880623237',6,28,12,0,0,1,0,8,1,350,95,29251,30519,31420,2,22,12,1,0,2,0,7,306,88,26798,30387,30149,0,44,7,2453,0,132,1271,-1,0,-1,0,1
EUW1_6880577380',2,22,8,1,0,0,0,9,1,352,82,24079,27780,25601,2,30,11,0,0,0,0,2,338,78,25736,28638,29633,0,14,4,-1657,-3,-858,-4032,1,0,0,0,7
EUW1_6880533587',5,137,11,0,1,1,0,12,0,349,84,27350,28909,35649,9,28,18,2,0,2,0,5,400,92,32076,32860,39960,1,-51,-8,-4726,-7,-3951,-4311,-2,1,-1,0,7
EUW1_6880473018',5,35,15,1,0,1,0,7,0,342,74,28627,29765,41465,7,33,14,0,0,0,0,7,317,70,26623,28203,30406,1,25,4,2004,1,1562,11059,1,0,1,0,0
EUW1_6880397835',6,29,9,0,1,0,0,7,1,368,94,25548,29864,31938,2,32,7,2,0,1,0,3,351,78,25079,29481,29505,1,17,16,469,2,383,2433,-2,1,-1,0,4
EUW1_6880356511',2,27,24,0,0,0,0,10,0,335,96,31742,32808,45463,1,27,15,1,0,1,0,7,356,82,29140,28926,37693,1,-21,14,2602,9,3882,7770,-1,0,-1,0,3
EUW1_6881313222',5,155,14,1,0,0,0,9,0,378,80,29712,29539,35679,1,24,9,1,0,2,0,3,368,80,26223,28729,29511,1,10,0,3489,5,810,6168,0,0,-2,0,6
EUW1_6879774321',2,23,12,1,0,0,0,10,1,326,96,27369,29569,29007,3,28,15,0,0,1,0,3,366,96,28677,30755,34315,0,-40,0,-1308,-3,-1186,-5308,1,0,-1,0,7
EUW1_6879713624',3,31,13,1,0,0,0,8,1,396,80,28997,30886,30143,1,97,10,1,0,1,0,2,361,108,26601,30088,27114,1,35,-28,2396,3,798,3029,0,0,-1,0,6
EUW1_6879651737',6,47,11,2,0,0,0,6,1,366,88,26520,30981,24878,4,29,7,0,0,0,0,1,398,88,26196,30309,25026,0,-32,0,324,4,672,-148,2,0,0,0,5
EUW1_6879602850',1,19,12,0,0,0,0,5,1,323,86,26674,30625,29608,5,22,11,1,0,1,0,4,364,102,26647,30295,26895,1,-41,-16,27,1,330,2713,-1,0,-1,0,1
EUW1_6879571569',3,32,12,1,0,1,0,7,0,395,88,28165,31754,30496,1,20,13,1,0,0,0,4,385,97,28748,32399,38432,1,10,-9,-583,-1,-645,-7936,0,0,1,0,3
EUW1_6883589639',3,30,11,1,1,1,0,8,1,326,80,26461,26915,30707,7,37,13,0,0,1,0,4,367,92,27398,29757,26261,1,-41,-12,-937,-2,-2842,4446,1,1,0,0,4
EUW1_6883563636',4,36,14,0,0,0,0,7,0,355,98,28590,31379,33719,4,27,10,2,0,0,0,5,339,93,26309,28232,33202,1,16,5,2281,4,3147,517,-2,0,0,0,2
EUW1_6883509827',3,23,9,0,0,1,0,13,0,378,88,27435,28905,26601,6,32,16,2,0,1,0,5,372,69,29302,30009,32876,0,6,19,-1867,-7,-1104,-6275,-2,0,0,0,8
EUW1_6883456294',0,47,9,0,1,2,0,6,1,364,104,27818,31301,27782,4,46,9,1,0,0,0,4,340,76,24852,28562,31193,0,24,28,2966,0,2739,-3411,-1,1,2,0,2
EUW1_6883410393',3,25,6,0,0,0,0,7,0,376,103,24240,29058,28518,4,29,13,2,0,0,0,1,337,85,26971,30723,33975,0,39,18,-2731,-7,-1665,-5457,-2,0,0,0,6
EUW1_6882914382',7,227,15,2,0,2,0,6,1,367,91,29532,32053,33194,3,29,8,0,0,0,0,5,353,83,25613,29411,25303,1,14,8,3919,7,2642,7891,2,0,2,0,1
EUW1_6882122510',4,36,12,0,1,1,0,8,0,372,102,28076,31923,29391,5,26,12,2,0,1,0,7,313,82,27159,28637,27741,1,59,20,917,0,3286,1650,-2,1,0,0,1
EUW1_6882058126',5,30,15,0,0,0,0,3,1,365,88,27626,30120,31685,3,25,8,2,0,0,0,3,359,96,24665,28624,29393,1,6,-8,2961,7,1496,2292,-2,0,0,0,0
EUW1_6882005517',5,27,9,0,0,0,0,6,1,363,83,25371,29541,28671,4,25,12,2,0,0,0,1,384,96,26801,32232,31065,0,-21,-13,-1430,-3,-2691,-2394,-2,0,0,0,5
EUW1_6881241768',4,53,10,0,0,0,0,6,0,334,110,25991,30787,30341,6,30,10,1,0,0,0,1,363,78,26608,28077,27847,1,-29,32,-617,0,2710,2494,-1,0,0,0,5
EUW1_6881192984',7,29,7,0,0,0,0,7,0,343,64,25089,27527,26728,8,35,15,2,0,1,0,1,382,96,29260,32411,31616,0,-39,-32,-4171,-8,-4884,-4888,-2,0,-1,0,6
EUW1_6881149467',4,31,11,0,0,0,0,7,1,309,73,26520,27048,29148,9,78,17,2,0,1,0,3,323,81,29227,29907,31436,1,-14,-8,-2707,-6,-2859,-2288,-2,0,-1,0,4
EUW1_6881109152',2,34,14,1,0,0,0,9,1,410,85,30784,31543,30819,5,27,2,1,0,1,0,5,285,87,20897,25713,25711,1,125,-2,9887,12,5830,5108,0,0,-1,0,4
EUW1_6881067369',4,25,15,1,0,1,0,11,0,301,102,28195,26852,30237,3,29,20,0,0,2,0,4,380,82,32037,31120,38894,0,-79,20,-3842,-5,-4268,-8657,1,0,-1,0,7
EUW1_6883487473',4,27,17,1,0,1,0,7,1,352,92,30130,31086,42302,2,51,14,0,0,0,0,7,359,78,27774,30426,32705,1,-7,14,2356,3,660,9597,1,0,1,0,0
EUW1_6883183054',3,55,24,1,0,0,0,7,1,365,82,34428,30202,47970,2,91,14,0,0,2,0,5,264,62,26191,26039,36198,1,101,20,8237,10,4163,11772,1,0,-2,0,2
EUW1_6883127448',4,35,17,0,0,0,0,9,1,378,84,30208,31881,31525,1,23,12,2,0,1,0,7,362,84,26334,30093,33096,1,16,0,3874,5,1788,-1571,-2,0,-1,0,2
EUW1_6882726227',3,42,9,0,0,0,0,13,1,323,83,25035,28530,29685,3,77,10,2,0,3,0,1,387,107,28806,31693,32264,0,-64,-24,-3771,-1,-3163,-2579,-2,0,-3,0,12
EUW1_6882671264',7,32,15,2,0,1,0,6,0,353,111,29027,32217,32761,4,39,13,0,0,0,0,4,351,80,27428,30090,33777,0,2,31,1599,2,2127,-1016,2,0,1,0,2
EUW1_6882637547',6,37,13,1,0,0,0,6,0,355,86,27214,29101,28818,2,31,14,1,0,0,0,4,357,89,28218,29480,36618,1,-2,-3,-1004,-1,-379,-7800,0,0,0,0,2
EUW1_6882232017',2,27,12,0,0,3,0,6,0,403,98,30424,31692,37400,4,24,4,1,0,0,0,10,364,74,22603,26540,22529,1,39,24,7821,8,5152,14871,-1,0,3,0,-4
EUW1_6882210717',4,23,4,1,0,1,0,9,1,363,84,25277,28825,20297,4,23,10,1,1,1,0,6,407,103,27582,32577,26427,1,-44,-19,-2305,-6,-3752,-6130,0,-1,0,0,3
EUW1_6882183888',0,32,18,0,0,2,0,9,1,431,67,33189,33310,43937,1,20,6,2,0,1,0,7,333,90,23672,28225,26819,1,98,-23,9517,12,5085,17118,-2,0,1,0,2
EUW1_6881903473',3,29,10,0,0,0,0,9,1,375,100,26932,29439,28864,3,32,12,1,0,0,0,2,378,70,27527,28392,33163,0,-3,30,-595,-2,1047,-4299,-1,0,0,0,7
EUW1_6881815529',4,24,17,1,0,1,0,8,0,331,94,28529,30921,39545,1,21,9,1,0,0,0,4,308,72,24767,27499,28389,1,23,22,3762,8,3422,11156,0,0,1,0,4
EUW1_6881147629',3,23,7,1,0,0,0,11,1,411,88,25772,30189,24670,4,26,8,0,0,1,0,2,416,124,27519,31780,25352,0,-5,-36,-1747,-1,-1591,-682,1,0,-1,0,9
EUW1_6881103817',5,31,9,1,0,0,0,9,1,360,84,26177,29340,24654,5,104,13,1,1,1,0,2,369,92,27890,30584,29318,0,-9,-8,-1713,-4,-1244,-4664,0,-1,-1,0,7
EUW1_6880419197',5,25,10,0,0,0,0,6,1,398,69,26297,27642,27772,2,24,14,1,0,0,0,0,340,109,27146,30838,28846,0,58,-40,-849,-4,-3196,-1074,-1,0,0,0,6
EUW1_6880354059',2,22,12,1,0,1,0,8,1,362,94,28157,30632,32348,4,24,12,1,0,1,0,4,331,86,26661,29791,33030,1,31,8,1496,0,841,-682,0,0,0,0,4
EUW1_6880279305',5,26,8,1,0,0,0,7,0,372,81,24338,28844,26338,2,41,8,1,0,0,0,3,409,86,25972,29774,26992,0,-37,-5,-1634,0,-930,-654,0,0,0,0,4
EUW1_6879752841',5,35,12,1,0,2,0,9,1,381,94,28622,30538,25257,0,21,14,1,0,0,0,7,323,92,27277,30576,33257,1,58,2,1345,-2,-38,-8000,0,0,2,0,2
EUW1_6879609377',1,22,13,1,0,0,0,15,0,353,88,27986,31087,34375,2,34,20,1,0,4,0,2,399,96,33038,33024,44216,0,-46,-8,-5052,-7,-1937,-9841,0,0,-4,0,13
EUW1_6879568424',4,38,20,2,0,2,0,3,1,394,101,32231,33026,44108,3,24,7,0,0,0,0,9,356,94,24727,27633,33461,1,38,7,7504,13,5393,10647,2,0,2,0,-6
EUW1_6880929863',4,29,7,1,0,0,0,6,0,366,84,24679,28448,29436,3,21,16,0,0,1,0,1,383,76,28600,31305,25901,1,-17,8,-3921,-9,-2857,3535,1,0,-1,0,5
EUW1_6880912517',4,25,11,0,0,0,0,8,0,299,93,25138,28569,37604,4,27,18,1,1,2,0,1,391,107,31027,32863,36753,0,-92,-14,-5889,-7,-4294,851,-1,-1,-2,0,7
EUW1_6880884371',3,25,18,2,0,2,0,6,1,350,69,31283,30469,37997,7,31,21,0,0,0,0,8,320,90,29291,28940,31378,1,30,-21,1992,-3,1529,6619,2,0,2,0,-2
EUW1_6880878640',4,26,20,1,1,3,0,11,1,355,94,33074,32297,41166,5,27,12,0,0,2,0,9,317,85,27598,26749,34579,1,38,9,5476,8,5548,6587,1,1,1,0,2
EUW1_6880852417',3,20,12,1,0,0,0,7,1,351,74,28071,29274,30090,6,26,16,1,0,0,0,6,351,84,29357,30242,29252,0,0,-10,-1286,-4,-968,838,0,0,0,0,1
EUW1_6880517249',1,24,14,1,1,4,1,9,1,358,107,30622,31553,20268,0,9,5,0,0,1,0,6,242,52,19467,22886,15273,1,116,55,11155,9,8667,4995,1,1,3,1,3
EUW1_6880475985',1,30,13,0,0,2,0,8,0,370,100,30735,28978,35719,2,186,18,1,1,0,0,7,352,75,29200,29681,35076,0,18,25,1535,-5,-703,643,-1,-1,2,0,1
EUW1_6880408308',6,26,12,2,1,0,0,10,0,304,102,25815,28192,31510,2,22,12,0,0,0,0,2,394,90,27125,30196,29951,0,-90,12,-1310,0,-2004,1559,2,1,0,0,8
EUW1_6880361518',4,27,10,0,0,0,0,13,0,339,59,26039,27686,33827,6,45,19,2,0,2,0,4,337,114,31490,32593,35105,0,2,-55,-5451,-9,-4907,-1278,-2,0,-2,0,9
EUW1_6880289266',2,32,14,1,0,2,0,4,1,357,72,28232,30043,31100,2,22,8,1,0,0,0,5,353,91,24544,29050,30780,0,4,-19,3688,6,993,320,0,0,2,0,-1
EUW1_6880237532',4,29,9,2,0,1,0,11,0,377,72,28433,28854,28113,2,22,23,0,0,2,0,6,347,110,31473,31998,40484,0,30,-38,-3040,-14,-3144,-12371,2,0,-1,0,5
EUW1_6880164819',8,32,14,0,0,0,0,7,0,362,93,28965,31660,29733,8,34,14,1,0,1,0,2,370,70,28004,29367,27557,1,-8,23,961,0,2293,2176,-1,0,-1,0,5
EUW1_6880118170',5,26,15,0,1,2,0,6,0,398,120,31082,33399,40582,5,94,9,0,0,0,0,7,337,44,23203,27514,29238,1,61,76,7879,6,5885,11344,0,1,2,0,-1
EUW1_6880091578',5,26,15,0,0,0,0,12,1,301,4,25377,24977,30339,2,32,19,2,0,1,0,2,311,95,30067,28517,38152,0,-10,-91,-4690,-4,-3540,-7813,-2,0,-1,0,10
EUW1_6880015930',5,38,12,1,0,1,0,8,1,384,86,27754,30317,34333,3,23,11,0,0,1,0,4,343,78,26699,29435,30303,0,41,8,1055,1,882,4030,1,0,0,0,4
EUW1_6879974072',1,135,22,1,0,0,0,8,1,326,82,31165,28910,35423,3,190,19,1,0,2,0,5,275,82,28373,28001,34945,1,51,0,2792,3,909,478,0,0,-2,0,3
EUW1_6879897866',5,79,16,2,0,2,0,11,0,402,86,31214,31873,37313,7,31,6,0,0,0,0,4,342,77,23275,27116,26881,1,60,9,7939,10,4757,10432,2,0,2,0,7
EUW1_6879736895',5,26,12,0,0,0,0,10,1,296,90,26845,28458,27112,6,32,10,1,0,0,0,4,355,105,27215,30023,31512,1,-59,-15,-370,2,-1565,-4400,-1,0,0,0,6
EUW1_6881150123',3,26,9,0,1,0,0,11,0,345,95,26063,29706,34062,5,79,20,1,0,2,0,2,366,95,32008,32093,35440,0,-21,0,-5945,-11,-2387,-1378,-1,1,-2,0,9
EUW1_6880217881',2,43,5,0,0,0,0,13,0,298,80,22318,26545,21741,2,320,11,1,0,2,0,1,406,87,28798,31028,30729,0,-108,-7,-6480,-6,-4483,-8988,-1,0,-2,0,12
EUW1_6879927045',0,22,11,1,0,0,0,13,1,358,68,26414,28194,32458,5,30,12,0,0,0,0,4,342,84,27037,27684,37283,1,16,-16,-623,-1,510,-4825,1,0,0,0,9
EUW1_6876903513',6,34,16,2,0,0,0,15,0,296,79,27568,28297,33693,4,32,17,0,0,1,0,2,308,82,30527,27899,37917,1,-12,-3,-2959,-1,398,-4224,2,0,-1,0,13
EUW1_6876811336',2,19,9,2,0,0,0,13,1,367,80,25083,30468,25479,4,30,12,0,1,0,0,1,370,108,28179,31331,36063,1,-3,-28,-3096,-3,-863,-10584,2,-1,0,0,12
EUW1_6876780986',6,33,4,0,0,0,0,14,0,284,76,21483,24708,26226,5,25,25,1,1,3,0,1,400,75,32624,34334,48857,0,-116,1,-11141,-21,-9626,-22631,-1,-1,-3,0,13
EUW1_6876623416',8,33,17,0,0,0,0,15,1,338,74,28291,27284,35430,4,28,15,1,0,2,0,2,364,95,31284,28951,32598,0,-26,-21,-2993,2,-1667,2832,-1,0,-2,0,13
EUW1_6875304332',3,27,10,0,0,0,0,8,0,366,67,26500,29675,26242,2,30,12,1,0,1,0,4,401,92,28659,32247,35134,0,-35,-25,-2159,-2,-2572,-8892,-1,0,-1,0,4
EUW1_6873994871',8,32,11,1,0,0,0,5,0,352,86,25608,28793,34082,2,24,7,1,0,0,0,2,362,98,24816,29844,25961,1,-10,-12,792,4,-1051,8121,0,0,0,0,3
EUW1_6872733288',4,34,11,0,0,0,0,10,1,376,84,26618,28753,29841,6,26,17,1,1,1,0,3,375,92,29682,32347,34584,0,1,-8,-3064,-6,-3594,-4743,-1,-1,-1,0,7
EUW1_6872705623',3,26,15,1,0,0,0,8,1,324,66,27639,27932,33303,0,23,18,1,0,1,0,7,362,101,31118,31566,44955,0,-38,-35,-3479,-3,-3634,-11652,0,0,-1,0,1
EUW1_6872646411',9,34,14,1,0,0,0,15,1,380,77,27828,28703,32443,1,25,11,0,0,1,0,3,355,96,27873,30157,37086,1,25,-19,-45,3,-1454,-4643,1,0,-1,0,12
EUW1_6872606200',3,25,13,2,0,0,0,6,1,422,82,27620,31097,28161,8,29,10,0,0,0,0,3,341,118,26800,30623,23895,1,81,-36,820,3,474,4266,2,0,0,0,3
EUW1_6872430147',1,23,10,0,0,0,0,6,0,337,82,25653,30659,30496,5,35,12,2,0,1,0,5,315,94,26293,30770,39896,0,22,-12,-640,-2,-111,-9400,-2,0,-1,0,1
EUW1_6870198867',5,28,10,0,0,0,0,13,1,311,78,24495,26220,24774,3,157,20,2,1,2,0,1,364,82,32840,31156,38046,0,-53,-4,-8345,-10,-4936,-13272,-2,-1,-2,0,12
EUW1_6883515387',5,30,15,1,1,0,0,9,1,393,94,27546,31562,32462,2,20,7,0,0,0,0,2,345,78,23727,28308,24106,1,48,16,3819,8,3254,8356,1,1,0,0,7
EUW1_6883477181',2,24,7,0,0,0,0,11,1,300,87,23809,29144,18947,4,39,8,2,0,2,0,1,388,120,26868,32463,27031,0,-88,-33,-3059,-1,-3319,-8084,-2,0,-2,0,10
EUW1_6883206005',7,83,10,1,0,1,0,7,1,354,78,26526,30468,26988,5,26,11,1,0,0,0,5,318,102,26793,29701,32854,0,36,-24,-267,-1,767,-5866,0,0,1,0,2
EUW1_6883144908',1,31,15,1,0,0,0,7,1,370,89,27862,29926,35371,6,34,15,0,0,0,0,0,337,66,27396,27624,26820,1,33,23,466,0,2302,8551,1,0,0,0,7
EUW1_6882967936',1,22,10,1,0,1,0,9,0,403,100,28646,31430,31448,4,144,12,1,0,0,0,5,407,91,27318,31222,34828,0,-4,9,1328,-2,208,-3380,0,0,1,0,4
EUW1_6882905123',3,26,14,0,1,0,0,5,1,324,87,27363,28787,31263,5,98,11,2,0,0,0,2,334,72,26248,27675,29860,1,-10,15,1115,3,1112,1403,-2,1,0,0,3
EUW1_6882848980',3,24,12,1,0,1,0,11,0,300,101,26884,27839,26729,2,25,13,1,0,1,0,5,385,86,29063,30482,33083,0,-85,15,-2179,-1,-2643,-6354,0,0,0,0,6
EUW1_6882802740',2,31,10,1,0,0,0,8,0,391,110,27951,32848,27535,6,271,6,1,0,1,0,4,369,76,24234,27064,29564,1,22,34,3717,4,5784,-2029,0,0,-1,0,4
EUW1_6882760688',7,22,15,2,0,0,0,9,1,346,112,28791,31573,40443,2,15,9,0,0,2,0,4,297,100,24476,28996,25859,1,49,12,4315,6,2577,14584,2,0,-2,0,5
EUW1_6882726231',5,28,21,1,0,1,0,6,1,383,88,31912,33616,44909,6,105,9,0,0,0,0,3,328,69,24700,28189,29320,1,55,19,7212,12,5427,15589,1,0,1,0,3
EUW1_6882202024',5,28,20,0,0,0,0,3,0,318,77,28894,27954,39862,1,54,14,0,0,0,0,2,331,73,27713,27241,38301,0,-13,4,1181,6,713,1561,0,0,0,0,1
EUW1_6882076819',1,31,22,1,0,0,0,7,1,340,77,30427,30347,49820,1,21,14,0,0,1,0,7,315,74,27873,27385,35451,0,25,3,2554,8,2962,14369,1,0,-1,0,0
EUW1_6882017423',6,34,11,1,0,1,0,5,1,356,90,27977,31492,36179,4,33,4,1,0,1,0,6,370,94,23424,28666,22744,1,-14,-4,4553,7,2826,13435,0,0,0,0,-1
EUW1_6881320862',10,29,7,1,0,1,0,12,0,380,109,25321,28395,19958,4,31,13,1,0,1,0,5,357,72,27998,26934,23722,0,23,37,-2677,-6,1461,-3764,0,0,0,0,7
EUW1_6881255601',4,28,15,2,0,0,0,10,1,378,98,29049,31442,34417,4,25,8,0,0,2,0,2,349,93,25393,28597,23987,1,29,5,3656,7,2845,10430,2,0,-2,0,8
EUW1_6881196663',4,218,8,1,1,1,0,4,0,378,84,26883,29417,26135,4,96,8,0,0,0,0,8,318,96,24203,27513,24990,1,60,-12,2680,0,1904,1145,1,1,1,0,-4
EUW1_6881156733',6,68,13,0,0,0,0,13,1,355,64,26080,29389,27172,2,61,14,2,0,2,0,3,392,89,30091,32047,39573,0,-37,-25,-4011,-1,-2658,-12401,-2,0,-2,0,10
EUW1_6880227410',5,63,12,1,0,0,0,4,0,372,91,27335,31236,35748,6,56,11,0,0,0,0,7,356,107,26325,29710,26663,1,16,-16,1010,1,1526,9085,1,0,0,0,-3
EUW1_6880177005',4,27,5,0,0,0,0,10,0,405,86,25847,29358,28312,5,51,18,1,0,1,0,5,359,98,31218,31513,31049,0,46,-12,-5371,-13,-2155,-2737,-1,0,-1,0,5
EUW1_6882738434',3,22,7,0,0,0,0,11,0,307,94,23903,27706,28815,5,29,16,2,0,2,0,1,389,94,29977,31631,34746,0,-82,0,-6074,-9,-3925,-5931,-2,0,-2,0,10
EUW1_6882704776',5,26,8,2,0,0,0,11,0,340,78,24779,28713,29214,5,97,7,0,0,1,0,3,311,73,24604,26411,24096,1,29,5,175,1,2302,5118,2,0,-1,0,8
EUW1_6882668968',3,21,17,1,0,0,0,10,0,332,88,28608,31381,30973,2,22,14,1,0,1,0,1,346,92,28610,30822,36938,0,-14,-4,-2,3,559,-5965,0,0,-1,0,9
EUW1_6881507986',3,34,16,0,0,2,0,5,1,359,94,29880,32361,40275,5,104,8,2,0,0,0,2,354,96,24593,29475,29971,1,5,-2,5287,8,2886,10304,-2,0,2,0,3
EUW1_6881260724',7,33,10,1,0,0,0,8,0,345,72,26757,29575,34456,6,34,10,1,0,0,0,3,348,114,26544,30258,26440,0,-3,-42,213,0,-683,8016,0,0,0,0,5
EUW1_6881201869',6,24,11,0,0,0,0,3,0,368,88,27349,29817,23672,3,28,9,2,0,0,0,6,362,88,25346,28318,23329,0,6,0,2003,2,1499,343,-2,0,0,0,-3
EUW1_6871986498',4,28,8,0,0,0,0,13,0,322,80,23885,27088,23843,1,21,22,2,0,2,0,0,382,84,33088,31690,46470,0,-60,-4,-9203,-14,-4602,-22627,-2,0,-2,0,13
EUW1_6871708713',3,19,12,1,0,0,0,6,0,363,88,26320,29977,30453,2,19,10,1,0,1,0,5,390,80,28064,31186,28980,1,-27,8,-1744,2,-1209,1473,0,0,-1,0,1
EUW1_6870071315',2,29,7,1,0,0,0,3,1,406,97,25604,29977,26899,5,27,7,1,0,0,0,2,386,78,24698,29368,26242,1,20,19,906,0,609,657,0,0,0,0,1
EUW1_6869974083',5,42,9,0,0,0,0,8,0,303,60,23487,25827,28408,3,57,21,2,0,1,0,1,324,86,30789,30055,37525,1,-21,-26,-7302,-12,-4228,-9117,-2,0,-1,0,7
EUW1_6869901033',5,24,11,2,1,0,0,10,0,375,94,27203,31198,31938,4,29,12,0,0,1,0,2,355,112,29856,29873,32921,1,20,-18,-2653,-1,1325,-983,2,1,-1,0,8
EUW1_6869839404',6,59,7,1,0,0,0,5,1,317,88,23762,27631,25988,7,30,9,1,0,0,0,2,342,92,25039,30071,30489,0,-25,-4,-1277,-2,-2440,-4501,0,0,0,0,3
EUW1_6869783092',6,27,18,2,0,1,0,8,0,364,80,29505,30725,40119,5,115,15,0,0,0,0,4,344,70,28635,29605,35783,1,20,10,870,3,1120,4336,2,0,1,0,4
EUW1_6868270533',2,24,9,1,0,0,0,10,1,290,91,24127,28445,31656,4,28,21,1,1,0,0,1,338,94,29688,33154,36858,0,-48,-3,-5561,-12,-4709,-5202,0,-1,0,0,9
EUW1_6868203349',4,71,17,0,0,2,0,11,1,288,104,29027,30031,33239,3,64,10,1,0,1,0,3,339,90,26854,28497,34105,1,-51,14,2173,7,1534,-866,-1,0,1,0,8
EUW1_6868140126',5,27,12,0,0,0,0,10,1,334,118,27091,30878,30619,6,37,8,2,0,0,0,1,388,86,25249,30539,26982,1,-54,32,1842,4,339,3637,-2,0,0,0,9
EUW1_6866899293',1,22,13,2,0,1,0,10,0,356,76,27644,29979,32086,2,22,10,0,0,0,0,2,331,87,25968,27759,29340,1,25,-11,1676,3,2220,2746,2,0,1,0,8
EUW1_6866774013',2,37,13,1,0,0,0,13,1,347,78,26987,29273,29396,1,32,8,1,0,0,0,2,383,89,26753,30148,31317,0,-36,-11,234,5,-875,-1921,0,0,0,0,11
EUW1_6882830530',4,30,7,0,0,0,0,8,1,358,88,25010,30464,24780,0,23,7,2,0,1,0,1,395,88,25848,29931,29596,0,-37,0,-838,0,533,-4816,-2,0,-1,0,7
EUW1_6881018136',3,30,12,0,0,1,0,12,1,341,98,28169,30142,32772,3,27,8,1,0,1,0,3,329,80,25310,28292,24289,1,12,18,2859,4,1850,8483,-1,0,0,0,9
EUW1_6880945817',5,30,14,1,0,0,0,6,1,311,104,27462,31369,33463,2,24,7,1,0,1,0,5,320,76,25060,27648,28278,1,-9,28,2402,7,3721,5185,0,0,-1,0,1
EUW1_6880913631',0,20,15,1,0,0,0,9,0,379,92,28729,31228,34024,4,45,11,1,0,1,0,2,388,92,28967,30178,29277,1,-9,0,-238,4,1050,4747,0,0,-1,0,7
EUW1_6879850603',2,34,17,1,0,0,0,5,0,407,79,29905,31734,38363,4,177,14,1,0,1,0,4,352,100,28384,31880,32644,1,55,-21,1521,3,-146,5719,0,0,-1,0,1
EUW1_6879740471',4,30,18,1,0,1,0,10,1,340,87,30307,29738,36863,6,38,14,0,0,0,0,3,346,78,26854,28640,37787,0,-6,9,3453,4,1098,-924,1,0,1,0,7
EUW1_6879578296',4,27,23,0,0,1,0,8,1,364,89,33759,33098,43409,1,67,12,1,0,2,0,10,332,90,27728,29583,31680,1,32,-1,6031,11,3515,11729,-1,0,-1,0,-2
EUW1_6876849695',3,31,12,1,0,0,0,12,0,341,96,27093,28956,35018,3,254,17,0,0,1,0,2,324,76,28535,30861,34836,1,17,20,-1442,-5,-1905,182,1,0,-1,0,10
EUW1_6876752722',5,34,4,1,0,0,0,12,0,286,83,21916,25148,23379,3,29,17,0,0,4,0,0,423,80,32524,32298,30465,0,-137,3,-10608,-13,-7150,-7086,1,0,-4,0,12
EUW1_6875266132',2,25,11,1,0,0,0,10,0,363,92,25888,30410,28974,3,30,7,1,0,0,0,2,382,76,25051,28353,29398,1,-19,16,837,4,2057,-424,0,0,0,0,8
EUW1_6875227121',5,29,13,2,1,0,0,8,0,316,72,26077,28613,34589,5,30,14,0,0,0,0,4,344,108,27867,30272,41614,1,-28,-36,-1790,-1,-1659,-7025,2,1,0,0,4
EUW1_6874444913',2,23,8,0,0,0,0,9,0,367,86,25809,29853,28450,4,26,5,2,0,1,0,2,381,114,25639,30135,21432,0,-14,-28,170,3,-282,7018,-2,0,-1,0,7
EUW1_6874368270',2,26,10,1,0,0,0,12,0,331,75,26743,29817,28742,6,35,10,1,1,2,0,2,352,104,27148,29362,35629,0,-21,-29,-405,0,455,-6887,0,-1,-2,0,10
EUW1_6874325590',2,22,31,1,0,2,0,12,1,391,70,37628,33381,48269,2,22,18,0,0,1,0,9,352,106,31093,31652,40935,1,39,-36,6535,13,1729,7334,1,0,1,0,3
EUW1_6872784640',8,35,9,1,0,0,0,17,1,329,61,24968,26869,28317,3,55,14,0,0,2,0,2,383,96,30509,30645,34539,1,-54,-35,-5541,-5,-3776,-6222,1,0,-2,0,15
EUW1_6869790510',6,123,4,1,0,0,0,7,0,398,84,23476,29378,21207,2,27,6,1,1,1,0,0,385,108,25554,30879,27007,0,13,-24,-2078,-2,-1501,-5800,0,-1,-1,0,7
EUW1_6869723176',4,27,10,0,0,0,0,8,1,378,115,27575,31563,27672,6,23,14,1,0,0,0,0,371,92,27271,32600,27382,0,7,23,304,-4,-1037,290,-1,0,0,0,8
EUW1_6882743271',3,23,10,2,0,2,0,4,1,390,96,28549,30975,34637,3,75,8,0,0,0,0,7,366,92,25568,30717,30548,1,24,4,2981,2,258,4089,2,0,2,0,-3
EUW1_6881830525',8,29,9,1,1,0,0,11,0,316,96,24329,28105,21864,3,18,13,1,0,1,0,2,362,96,28558,30118,31992,0,-46,0,-4229,-4,-2013,-10128,0,1,-1,0,9
EUW1_6881758571',4,27,8,0,0,1,0,11,1,349,94,25928,29142,23120,3,37,13,2,1,1,0,1,342,98,27339,31125,24696,1,7,-4,-1411,-5,-1983,-1576,-2,-1,0,0,10
EUW1_6881676070',4,33,11,1,0,1,0,12,1,349,72,27585,29399,29085,5,50,13,1,0,1,0,6,329,82,27871,28887,28809,1,20,-10,-286,-2,512,276,0,0,0,0,6
EUW1_6881618626',4,23,10,2,0,1,0,13,0,339,80,27221,28936,33400,4,22,17,0,0,1,0,5,377,84,29941,30618,36578,0,-38,-4,-2720,-7,-1682,-3178,2,0,0,0,8
EUW1_6881504210',3,26,12,1,0,1,0,9,1,372,100,29316,30981,34746,6,27,11,1,0,1,0,5,332,80,24794,27857,31603,1,40,20,4522,1,3124,3143,0,0,0,0,4
EUW1_6881471388',10,31,18,2,0,2,0,6,1,377,92,31607,31786,35468,2,27,5,0,0,0,0,7,344,84,23066,26003,18277,1,33,8,8541,13,5783,17191,2,0,2,0,-1
EUW1_6881097514',6,285,11,2,0,0,0,9,1,410,79,26509,31130,36091,5,32,7,0,0,0,0,2,386,90,25641,29770,28458,1,24,-11,868,4,1360,7633,2,0,0,0,7
EUW1_6881059564',3,52,17,1,0,2,0,11,0,333,80,29532,30608,34965,3,22,13,0,0,0,0,6,329,78,25703,27785,37321,1,4,2,3829,4,2823,-2356,1,0,2,0,5
EUW1_6881025773',0,18,6,0,0,0,0,8,0,344,99,24438,27843,25166,3,149,14,2,0,2,0,0,388,80,29144,31765,34337,0,-44,19,-4706,-8,-3922,-9171,-2,0,-2,0,8
EUW1_6880991321',5,26,6,1,0,1,0,12,1,373,92,25608,28534,20540,4,28,14,1,0,2,0,5,384,95,30645,32655,30642,0,-11,-3,-5037,-8,-4121,-10102,0,0,-1,0,7
EUW1_6880958714',3,187,4,1,0,0,0,6,0,319,88,22777,27191,23333,0,41,12,1,0,1,0,1,366,94,28212,30973,30836,1,-47,-6,-5435,-8,-3782,-7503,0,0,-1,0,5
EUW1_6880926060',2,38,8,1,1,1,0,12,0,360,94,26633,28952,27673,2,23,9,0,0,0,0,5,370,90,25916,30517,27549,0,-10,4,717,-1,-1565,124,1,1,1,0,7
EUW1_6880260149',1,21,15,1,0,1,0,5,0,375,108,29069,33100,35756,4,26,3,1,0,0,0,4,310,100,21630,25568,23462,1,65,8,7439,12,7532,12294,0,0,1,0,1
EUW1_6880197510',3,18,7,1,0,1,0,10,0,345,113,25552,30726,21039,5,41,10,1,0,1,0,6,411,86,27624,29866,28095,0,-66,27,-2072,-3,860,-7056,0,0,0,0,4
EUW1_6880146929',0,38,6,1,0,0,0,8,1,346,80,23324,27672,26915,4,23,13,1,1,2,0,0,349,88,28010,30063,29431,0,-3,-8,-4686,-7,-2391,-2516,0,-1,-2,0,8
EUW1_6880082653',3,23,12,0,0,0,0,10,0,360,87,28199,31102,27748,4,26,16,2,0,1,0,6,358,82,29895,30955,36362,1,2,5,-1696,-4,147,-8614,-2,0,-1,0,4
EUW1_6880043973',3,20,9,2,0,0,0,8,0,343,79,26485,27784,33177,4,35,16,0,0,0,0,1,317,100,27710,30508,32707,0,26,-21,-1225,-7,-2724,470,2,0,0,0,7
EUW1_6879983286',3,33,7,1,0,0,0,6,1,365,76,24553,27853,26880,2,28,15,1,0,0,0,1,373,114,29596,31744,31762,0,-8,-38,-5043,-8,-3891,-4882,0,0,0,0,5
EUW1_6883546309',6,136,20,0,0,2,0,9,1,363,96,30801,31022,37046,2,22,9,1,0,0,0,6,344,91,26302,28957,25020,0,19,5,4499,11,2065,12026,-1,0,2,0,3
EUW1_6883514871',3,25,11,1,0,0,0,7,0,335,90,26389,29869,33867,0,21,13,1,0,0,0,0,341,94,26239,27742,33081,1,-6,-4,150,-2,2127,786,0,0,0,0,7
EUW1_6880819447',2,30,19,1,0,0,0,6,1,308,98,28151,29966,42671,7,32,9,0,0,0,0,4,343,66,24218,28822,29424,1,-35,32,3933,10,1144,13247,1,0,0,0,2
EUW1_6880810677',4,44,6,0,0,0,0,7,0,311,56,22237,24992,24382,4,31,19,0,0,1,0,1,332,110,30754,29954,32768,0,-21,-54,-8517,-13,-4962,-8386,0,0,-1,0,6
EUW1_6880793558',1,29,8,0,0,0,0,7,1,382,90,26174,31273,27859,4,30,9,1,0,0,0,1,378,92,25587,30056,25078,1,4,-2,587,-1,1217,2781,-1,0,0,0,6
EUW1_6880747325',1,19,11,0,0,0,0,8,0,338,102,26468,30562,28636,3,24,14,1,0,1,0,1,355,87,27558,29951,32608,1,-17,15,-1090,-3,611,-3972,-1,0,-1,0,7
EUW1_6880729325',6,32,20,0,0,2,0,6,1,361,100,31808,30658,39858,3,25,12,1,0,0,0,6,315,75,25549,29369,29255,1,46,25,6259,8,1289,10603,-1,0,2,0,0
EUW1_6880405077',3,26,2,0,0,0,0,8,0,345,69,21459,27427,15822,1,32,8,2,1,2,0,2,392,100,27188,30546,30671,0,-47,-31,-5729,-6,-3119,-14849,-2,-1,-2,0,6
EUW1_6878231564',3,135,20,1,0,0,0,14,1,327,104,30077,29822,37570,2,25,20,1,0,2,0,3,288,66,28647,28193,31753,1,39,38,1430,0,1629,5817,0,0,-2,0,11
EUW1_6877086456',6,32,19,1,0,1,0,5,1,368,104,32453,32818,39505,1,325,9,0,0,0,0,9,368,88,25167,29232,29498,1,0,16,7286,10,3586,10007,1,0,1,0,-4
EUW1_6876176966',5,28,22,2,0,0,0,15,1,342,80,31254,32914,33538,6,26,11,0,0,3,0,4,383,80,28543,29428,40750,1,-41,0,2711,11,3486,-7212,2,0,-3,0,11
EUW1_6874183691',2,22,20,1,0,2,0,6,1,380,80,31419,30390,41762,3,23,14,1,0,0,0,5,308,82,27797,28451,32885,1,72,-2,3622,6,1939,8877,0,0,2,0,1
EUW1_6874131990',5,31,12,0,0,0,0,6,0,355,80,25709,28331,32394,2,33,16,2,0,1,0,0,326,62,29625,29306,42426,0,29,18,-3916,-4,-975,-10032,-2,0,-1,0,6
EUW1_6874061451',7,40,17,1,0,0,0,7,0,361,99,30160,30664,36170,6,27,11,1,0,1,0,1,356,72,25694,27592,26723,1,5,27,4466,6,3072,9447,0,0,-1,0,6
EUW1_6882909419',2,23,14,1,0,1,0,9,1,353,68,27690,29557,35381,5,25,13,1,0,1,0,3,327,76,27609,28638,38536,1,26,-8,81,1,919,-3155,0,0,0,0,6
EUW1_6879875144',5,38,11,0,0,0,0,11,0,388,73,28700,29348,34047,6,28,26,1,0,2,0,5,343,82,32062,31832,40812,0,45,-9,-3362,-15,-2484,-6765,-1,0,-2,0,6
EUW1_6879835307',0,18,21,1,0,0,0,12,1,309,94,31265,30781,42708,6,31,20,1,0,2,0,4,336,97,32121,33162,41624,0,-27,-3,-856,1,-2381,1084,0,0,-2,0,8
EUW1_6879752011',2,29,12,0,0,0,0,12,1,324,87,26053,28030,25895,4,29,12,2,1,1,0,2,349,84,27928,27255,32286,0,-25,3,-1875,0,775,-6391,-2,-1,-1,0,10
EUW1_6879051129',5,33,14,1,0,1,0,8,1,378,90,29974,29827,28338,4,26,14,0,1,0,0,7,333,85,28034,29270,35211,0,45,5,1940,0,557,-6873,1,-1,1,0,1
EUW1_6879006914',2,31,9,0,0,0,0,11,0,337,86,26839,29509,29813,5,29,18,2,0,3,0,2,354,94,30454,32723,37179,0,-17,-8,-3615,-9,-3214,-7366,-2,0,-3,0,9
EUW1_6878948307',3,26,13,1,0,0,0,4,1,373,96,27559,30528,31091,6,32,9,0,1,0,0,2,340,76,25142,28338,28732,1,33,20,2417,4,2190,2359,1,-1,0,0,2
EUW1_6878553511',8,30,21,1,0,1,0,8,0,319,86,32597,30058,35749,5,63,17,1,0,1,0,2,336,78,29965,28191,35383,1,-17,8,2632,4,1867,366,0,0,0,0,6
EUW1_6878507008',6,173,16,1,0,0,0,15,1,338,73,29115,28071,28614,4,29,11,1,1,4,0,8,315,88,28288,28130,34382,1,23,-15,827,5,-59,-5768,0,-1,-4,0,7
EUW1_6878454395',2,24,17,1,0,1,0,9,1,379,82,29995,30323,33642,4,31,18,1,0,2,0,6,262,92,29835,28999,36957,1,117,-10,160,-1,1324,-3315,0,0,-1,0,3
EUW1_6878428643',6,28,12,1,0,1,0,13,1,411,85,30053,31124,25343,6,41,5,0,0,1,0,4,358,71,24654,27773,20361,1,53,14,5399,7,3351,4982,1,0,0,0,9
EUW1_6878359921',5,28,19,0,0,1,0,9,1,307,83,30481,28462,42741,3,39,17,1,0,1,0,5,310,88,28371,28768,29343,0,-3,-5,2110,2,-306,13398,-1,0,0,0,4
EUW1_6878319628',4,33,19,1,0,0,0,12,0,313,84,29911,30510,42024,2,30,14,0,0,1,0,2,359,83,29521,29626,42888,1,-46,1,390,5,884,-864,1,0,-1,0,10
EUW1_6877593140',1,21,12,0,0,0,0,12,0,330,92,28136,29106,31167,4,28,22,2,1,1,0,6,348,80,31505,30314,40613,0,-18,12,-3369,-10,-1208,-9446,-2,-1,-1,0,6
EUW1_6877547494',5,26,6,0,1,1,0,9,0,373,80,25758,28457,27103,4,29,12,2,0,0,0,7,360,87,26618,30475,26023,0,13,-7,-860,-6,-2018,1080,-2,1,1,0,2
EUW1_6877493714',6,38,7,0,0,0,0,7,0,343,87,24706,29288,27967,4,26,15,2,0,0,0,3,378,100,27772,31317,30441,0,-35,-13,-3066,-8,-2029,-2474,-2,0,0,0,4
EUW1_6877275468',4,34,10,2,0,4,0,5,0,423,95,31170,30490,25365,1,138,8,0,0,0,0,13,301,68,23378,24713,20907,1,122,27,7792,2,5777,4458,2,0,4,0,-8
EUW1_6877224562',7,228,15,2,0,3,0,1,1,412,98,32365,33061,34426,5,29,5,0,0,0,0,11,341,77,22613,26865,19497,1,71,21,9752,10,6196,14929,2,0,3,0,-10
EUW1_6876155620',2,26,9,0,0,0,0,16,0,324,62,25225,26639,32133,5,150,27,2,0,2,0,4,333,79,32035,32120,46358,0,-9,-17,-6810,-18,-5481,-14225,-2,0,-2,0,12
EUW1_6880217395',4,27,16,1,0,0,0,7,1,337,91,27552,30245,29059,4,27,12,0,0,1,0,5,348,72,27089,28304,31212,0,-11,19,463,4,1941,-2153,1,0,-1,0,2
EUW1_6880169225',3,35,14,0,0,1,0,9,1,338,88,28747,29161,35090,5,31,15,2,0,2,0,5,292,102,28016,29425,37722,0,46,-14,731,-1,-264,-2632,-2,0,-1,0,4
EUW1_6880134467',2,53,16,2,0,0,0,8,0,315,92,26760,28666,35194,5,29,11,0,0,1,0,1,359,64,27416,27861,34180,0,-44,28,-656,5,805,1014,2,0,-1,0,7
EUW1_6879954712',5,26,18,0,0,0,0,3,0,399,106,29374,34187,35998,4,27,8,1,0,0,0,4,356,102,24601,30001,29382,1,43,4,4773,10,4186,6616,-1,0,0,0,-1
EUW1_6879811535',6,37,9,1,0,0,0,8,0,334,87,24805,28292,21992,6,28,12,1,0,0,0,3,371,72,27317,28993,28322,0,-37,15,-2512,-3,-701,-6330,0,0,0,0,5
EUW1_6879733742',2,25,7,1,0,1,0,9,1,406,95,26922,30156,23404,2,21,11,1,1,0,0,6,386,92,27582,30685,25511,1,20,3,-660,-4,-529,-2107,0,-1,1,0,3
EUW1_6879704857',5,28,22,2,0,3,0,11,1,364,97,33889,34267,41517,3,23,2,0,0,1,0,7,381,90,22458,26031,25998,1,-17,7,11431,20,8236,15519,2,0,2,0,4
EUW1_6879652102',5,32,16,0,0,1,0,6,0,361,57,29354,30025,36095,1,22,10,2,0,1,0,6,354,102,26102,29466,26778,0,7,-45,3252,6,559,9317,-2,0,0,0,0
EUW1_6879531165',2,24,19,0,0,0,0,7,0,321,78,29962,28869,39175,2,24,13,2,0,1,0,5,340,94,27808,29728,41389,0,-19,-16,2154,6,-859,-2214,-2,0,-1,0,2
EUW1_6877333615',1,151,20,1,0,2,0,7,1,351,107,32210,31708,39956,2,29,10,1,0,1,0,11,327,72,26181,27058,31708,1,24,35,6029,10,4650,8248,0,0,1,0,-4
EUW1_6877285543',9,43,6,1,0,0,0,7,1,369,82,23651,28624,18321,7,29,9,1,0,2,0,0,415,101,27528,32270,26051,0,-46,-19,-3877,-3,-3646,-7730,0,0,-2,0,7
EUW1_6877226038',3,30,17,1,0,1,0,9,0,319,96,29612,31306,35670,1,85,14,1,0,0,0,7,347,80,28380,31091,39186,1,-28,16,1232,3,215,-3516,0,0,1,0,2
EUW1_6877170264',3,28,12,1,0,0,0,11,0,358,79,27571,28746,38268,2,27,15,1,0,2,0,4,322,91,28754,30171,31425,1,36,-12,-1183,-3,-1425,6843,0,0,-2,0,7
EUW1_6877119067',4,34,13,2,1,3,0,13,1,388,76,30868,30391,21709,1,26,12,0,0,3,0,7,330,104,27672,27883,26963,0,58,-28,3196,1,2508,-5254,2,1,0,0,6
EUW1_6881506029',5,32,4,1,0,0,0,15,0,315,83,22411,26062,28749,3,48,28,1,0,5,0,1,356,100,36027,33872,48584,0,-41,-17,-13616,-24,-7810,-19835,0,0,-5,0,14
EUW1_6881453711',6,81,12,1,0,1,0,11,1,274,76,26172,26833,34697,7,30,18,1,0,0,0,6,297,96,30188,29004,33488,0,-23,-20,-4016,-6,-2171,1209,0,0,1,0,5
EUW1_6881365591',4,31,9,1,0,0,0,9,0,387,114,26722,30485,33041,4,28,12,1,0,0,0,0,352,85,27193,29555,30961,0,35,29,-471,-3,930,2080,0,0,0,0,9
EUW1_6881289785',5,28,17,0,0,1,0,8,1,370,82,30018,32322,32101,2,24,4,1,0,0,0,7,352,90,23134,27736,25278,1,18,-8,6884,13,4586,6823,-1,0,1,0,1
EUW1_6881166185',7,31,8,1,0,0,0,10,0,341,101,25963,30688,32196,7,33,14,1,0,1,0,3,384,70,28183,30609,28808,1,-43,31,-2220,-6,79,3388,0,0,-1,0,7
EUW1_6881098333',9,27,21,0,0,2,0,13,0,335,98,30634,30332,36707,4,47,16,1,0,1,0,8,332,76,30299,30454,42100,0,3,22,335,5,-122,-5393,-1,0,1,0,5
EUW1_6881076499',4,36,3,0,0,0,0,11,0,357,94,23861,29017,26463,6,29,18,1,0,3,0,2,387,100,30810,33428,36876,0,-30,-6,-6949,-15,-4411,-10413,-1,0,-3,0,9
EUW1_6880993192',8,27,23,1,1,1,0,9,1,314,92,31294,30416,34073,6,26,10,0,0,1,0,5,359,68,26243,27224,30015,1,-45,24,5051,13,3192,4058,1,1,0,0,4
EUW1_6880924800',2,22,13,1,1,1,0,14,0,336,92,29094,29827,40481,6,30,18,1,0,2,0,5,392,104,31627,31555,38505,0,-56,-12,-2533,-5,-1728,1976,0,1,-1,0,9
EUW1_6880855711',2,32,14,1,0,2,0,5,0,332,90,29000,30713,31153,4,28,17,1,0,0,0,9,368,94,29107,30898,37156,1,-36,-4,-107,-3,-185,-6003,0,0,2,0,-4
EUW1_6880087084',4,27,21,1,0,2,0,6,1,332,86,31280,28760,45641,2,30,15,1,0,0,0,8,299,73,27175,28653,36665,1,33,13,4105,6,107,8976,0,0,2,0,-2
EUW1_6880032201',2,23,14,1,0,0,0,10,0,337,78,25870,28766,35464,8,35,11,0,0,1,0,1,320,85,26256,27716,36403,0,17,-7,-386,3,1050,-939,1,0,-1,0,9
EUW1_6879995572',2,25,8,2,0,0,0,11,0,332,82,24205,30468,30029,4,31,11,0,0,1,0,2,380,106,27880,30991,31013,0,-48,-24,-3675,-3,-523,-984,2,0,-1,0,9
EUW1_6879804711',8,190,5,0,0,0,0,10,0,318,64,23311,26971,21565,9,33,15,2,0,1,0,3,402,87,30440,31441,33420,0,-84,-23,-7129,-10,-4470,-11855,-2,0,-1,0,7
EUW1_6879738916',3,37,10,2,0,0,0,5,0,315,90,24947,28811,28822,3,23,11,0,0,0,0,2,356,80,25681,30440,28892,0,-41,10,-734,-1,-1629,-70,2,0,0,0,3
EUW1_6880155403',4,37,15,1,0,1,0,8,1,400,72,30158,32780,37786,1,29,8,1,0,1,0,7,348,64,24416,29782,23314,1,52,8,5742,7,2998,14472,0,0,0,0,1
EUW1_6880102382',4,18,19,0,0,1,0,9,1,359,91,29354,31183,33163,1,22,8,2,0,1,0,4,373,96,26430,28888,30699,1,-14,-5,2924,11,2295,2464,-2,0,0,0,5
EUW1_6879751642',3,24,14,1,1,0,0,7,0,398,100,28609,32796,32415,6,37,8,1,0,1,0,5,345,83,25055,29582,28744,1,53,17,3554,6,3214,3671,0,1,-1,0,2
EUW1_6879559388',6,39,14,1,0,0,0,9,1,344,74,26481,29920,33261,3,67,9,1,0,1,0,2,372,92,26167,29335,26001,0,-28,-18,314,5,585,7260,0,0,-1,0,7
EUW1_6878148035',4,27,20,0,1,2,0,9,0,370,93,31132,33234,38899,4,26,14,1,0,1,0,4,371,56,29225,28966,33251,1,-1,37,1907,6,4268,5648,-1,1,1,0,5
EUW1_6877390223',3,25,15,1,0,1,0,6,1,344,69,28283,29187,37007,2,31,12,1,0,0,0,5,312,79,25970,28505,30912,1,32,-10,2313,3,682,6095,0,0,1,0,1
EUW1_6877323983',1,25,13,0,0,0,0,12,1,295,96,27823,28923,37067,1,29,15,0,0,1,0,0,355,76,29367,30682,43480,0,-60,20,-1544,-2,-1759,-6413,0,0,-1,0,12
EUW1_6877277833',1,20,13,1,0,2,0,12,1,333,90,29641,30395,32512,4,22,22,1,0,0,0,6,343,66,29915,32229,36414,0,-10,24,-274,-9,-1834,-3902,0,0,2,0,6
EUW1_6877025607',1,56,20,2,0,1,0,14,1,269,75,29940,28686,37839,4,60,15,0,0,2,0,4,328,96,29808,30041,36293,1,-59,-21,132,5,-1355,1546,2,0,-1,0,10
EUW1_6876745346',5,21,14,2,0,0,0,7,1,370,86,29487,30043,33924,3,26,11,0,0,0,0,6,391,88,26919,30324,25796,1,-21,-2,2568,3,-281,8128,2,0,0,0,1
EUW1_6876700415',6,32,10,2,0,0,0,8,0,364,90,25437,30134,27868,4,50,10,0,0,1,0,1,368,88,27067,29520,29884,1,-4,2,-1630,0,614,-2016,2,0,-1,0,7
EUW1_6875936719',1,30,12,2,0,0,0,6,1,357,96,27567,29900,34007,2,26,10,0,0,1,0,2,335,108,26916,31119,34107,0,22,-12,651,2,-1219,-100,2,0,-1,0,4
EUW1_6875838296',3,23,12,1,0,1,0,12,1,272,64,27316,26100,25897,1,27,12,1,0,4,0,6,380,72,30032,27999,28293,0,-108,-8,-2716,0,-1899,-2396,0,0,-3,0,6
EUW1_6874082305',1,131,10,2,0,0,0,5,1,399,115,27309,30612,24456,0,21,7,0,1,0,0,3,408,78,24960,29168,15042,1,-9,37,2349,3,1444,9414,2,-1,0,0,2
EUW1_6874051659',6,173,4,0,0,0,0,9,0,318,96,22197,26282,19504,3,29,10,2,0,2,0,1,375,91,26806,29335,23677,0,-57,5,-4609,-6,-3053,-4173,-2,0,-2,0,8
EUW1_6871405030',3,27,14,0,1,2,0,6,1,352,94,29971,30530,46025,4,36,13,1,0,0,0,8,313,78,26159,29152,39464,1,39,16,3812,1,1378,6561,-1,1,2,0,-2
EUW1_6871379802',5,45,7,1,0,0,0,14,0,336,80,24371,26423,26272,2,24,19,1,1,2,0,0,378,96,33175,32940,32690,0,-42,-16,-8804,-12,-6517,-6418,0,-1,-2,0,14
EUW1_6871340028',3,23,14,2,0,1,0,4,1,382,104,28984,30789,34704,1,27,5,0,0,0,0,7,384,91,23855,29565,27108,1,-2,13,5129,9,1224,7596,2,0,1,0,-3
EUW1_6882650415',2,20,7,0,0,0,0,8,1,347,64,24963,26983,32230,6,25,17,2,0,1,0,3,351,92,26883,30534,33615,1,-4,-28,-1920,-10,-3551,-1385,-2,0,-1,0,5
EUW1_6882625692',3,26,15,0,0,1,0,4,1,352,72,28867,29397,29932,3,24,7,2,0,0,0,5,364,88,25331,29632,25990,0,-12,-16,3536,8,-235,3942,-2,0,1,0,-1
EUW1_6881803766',2,28,14,1,0,1,0,9,0,371,104,31082,32175,30743,5,27,12,0,0,1,0,6,333,87,27246,30417,28210,0,38,17,3836,2,1758,2533,1,0,0,0,3
EUW1_6881698589',10,38,5,0,0,0,0,12,1,362,110,23756,29747,23206,7,27,8,2,0,1,0,1,324,102,25477,30217,21392,1,38,8,-1721,-3,-470,1814,-2,0,-1,0,11
EUW1_6880012899',4,23,11,1,0,0,0,5,1,345,98,26563,28116,40523,4,26,15,1,0,0,0,3,327,97,27266,30242,31814,0,18,1,-703,-4,-2126,8709,0,0,0,0,2
EUW1_6879889542',3,57,11,1,0,0,0,12,1,384,64,27074,30958,33682,2,27,12,0,0,1,0,2,409,80,28993,31569,35160,1,-25,-16,-1919,-1,-611,-1478,1,0,-1,0,10
EUW1_6879812006',4,24,10,0,0,0,0,9,1,364,83,26164,30446,22497,1,39,7,2,0,3,0,0,377,128,27358,31388,31440,1,-13,-45,-1194,3,-942,-8943,-2,0,-3,0,9
EUW1_6879650389',3,26,14,1,0,0,0,6,1,271,104,25833,27596,33349,3,22,12,1,0,0,0,0,358,67,26953,28133,33968,1,-87,37,-1120,2,-537,-619,0,0,0,0,6
EUW1_6879621484',4,22,5,1,0,0,0,7,1,346,88,23415,28084,19271,3,26,5,1,1,0,0,2,379,84,23769,30069,21586,0,-33,4,-354,0,-1985,-2315,0,-1,0,0,5
EUW1_6879510269',2,22,18,0,0,0,0,7,0,345,102,29678,30846,33186,5,31,17,2,0,0,0,3,280,106,26494,29507,34544,0,65,-4,3184,1,1339,-1358,-2,0,0,0,4
EUW1_6879494476',3,23,6,1,0,0,0,7,0,325,100,25014,28812,26922,2,89,16,1,0,1,0,6,374,99,29729,32441,33591,0,-49,1,-4715,-10,-3629,-6669,0,0,-1,0,1
EUW1_6879369028',3,24,6,1,0,0,0,10,0,336,88,24188,28534,27248,7,25,16,1,0,1,0,3,355,83,29650,32105,33324,0,-19,5,-5462,-10,-3571,-6076,0,0,-1,0,7
EUW1_6878283023',2,52,9,0,0,0,0,5,1,323,81,23929,28144,27720,6,38,2,1,0,0,0,4,311,90,20987,25146,20762,1,12,-9,2942,7,2998,6958,-1,0,0,0,1
EUW1_6878229093',2,27,8,1,0,0,0,4,0,366,112,25718,29059,32486,3,91,16,0,0,0,0,3,380,80,27878,31604,31935,0,-14,32,-2160,-8,-2545,551,1,0,0,0,1
EUW1_6878021694',3,22,15,0,0,0,0,12,0,311,77,26836,28737,30554,2,28,12,2,0,1,0,1,316,86,25630,27748,36028,1,-5,-9,1206,3,989,-5474,-2,0,-1,0,11
EUW1_6876557281',8,33,9,1,0,1,0,5,0,388,90,26361,28968,39502,2,24,10,1,0,0,0,4,355,106,26507,29604,31475,0,33,-16,-146,-1,-636,8027,0,0,1,0,1
EUW1_6876478506',5,30,16,1,0,1,0,6,1,371,92,28662,29791,28921,3,23,10,1,0,1,0,5,311,78,26280,27230,22066,1,60,14,2382,6,2561,6855,0,0,0,0,1
EUW1_6876459337',6,32,8,0,0,0,0,12,1,319,77,24158,27730,28208,5,24,9,2,0,3,0,0,394,106,29875,31449,33313,0,-75,-29,-5717,-1,-3719,-5105,-2,0,-3,0,12
EUW1_6875217018',6,23,12,1,0,0,0,10,1,317,89,25695,28160,26818,5,27,20,1,1,3,0,1,352,80,31882,31957,37904,1,-35,9,-6187,-8,-3797,-11086,0,-1,-3,0,9
EUW1_6882912608',2,139,13,0,0,0,0,10,1,343,96,27367,30340,32803,1,22,12,1,0,1,0,2,355,90,27229,30325,31898,0,-12,6,138,1,15,905,-1,0,-1,0,8
EUW1_6882848942',6,32,11,1,0,1,0,14,1,364,64,27197,27408,34313,5,34,19,1,0,3,0,2,400,123,34493,33989,36800,0,-36,-59,-7296,-8,-6581,-2487,0,0,-2,0,12
EUW1_6882787301',4,27,17,0,0,1,0,12,0,372,78,31565,32172,45334,3,31,12,1,0,2,0,5,347,89,28745,28721,32642,1,25,-11,2820,5,3451,12692,-1,0,-1,0,7
EUW1_6882743842',1,29,19,1,0,2,0,7,1,370,92,29784,32575,35174,1,24,10,0,0,1,0,10,338,86,25237,27279,26516,1,32,6,4547,9,5296,8658,1,0,1,0,-3
EUW1_6882698617',4,26,9,0,0,0,0,8,1,330,100,26221,29371,25228,2,27,7,1,0,3,0,7,313,100,25320,27724,23504,1,17,0,901,2,1647,1724,-1,0,-3,0,1
EUW1_6882667496',4,31,15,1,1,0,0,7,1,393,80,29972,30881,29008,4,27,8,1,0,1,0,7,375,88,25141,28554,20231,1,18,-8,4831,7,2327,8777,0,1,-1,0,0
EUW1_6882617352',5,23,10,0,0,1,0,8,0,374,93,27784,29781,22650,3,42,12,1,0,0,0,4,365,86,28354,30099,28083,0,9,7,-570,-2,-318,-5433,-1,0,1,0,4
EUW1_6882600787',6,38,21,1,1,2,0,5,0,385,100,33404,32775,43610,4,25,9,0,0,1,0,5,343,92,25803,29273,24425,1,42,8,7601,12,3502,19185,1,1,1,0,0
EUW1_6881915617',0,26,8,0,0,0,0,7,0,335,92,24515,28374,27555,1,26,20,2,1,0,0,3,329,104,29493,32140,38070,0,6,-12,-4978,-12,-3766,-10515,-2,-1,0,0,4
EUW1_6881845087',8,29,12,2,0,0,0,7,1,344,86,26671,28847,28474,4,92,9,0,0,0,0,3,364,92,25574,29502,35698,0,-20,-6,1097,3,-655,-7224,2,0,0,0,4
EUW1_6881779634',7,27,13,0,0,1,0,9,0,294,70,26587,26860,36235,5,100,16,1,0,1,0,5,348,70,27389,30242,33996,0,-54,0,-802,-3,-3382,2239,-1,0,0,0,4
EUW1_6881646720',5,57,10,1,1,0,0,4,1,371,89,26132,30015,25875,2,26,5,0,0,0,0,7,318,65,22121,25715,19044,0,53,24,4011,5,4300,6831,1,1,0,0,-3
EUW1_6881595792',2,23,14,0,0,2,0,5,1,419,100,32092,33281,34439,2,18,10,2,0,0,0,7,322,95,24534,29085,25646,1,97,5,7558,4,4196,8793,-2,0,2,0,-2
EUW1_6881552608',4,28,15,2,0,4,0,4,0,421,96,31273,32261,32619,2,31,1,0,0,0,0,9,314,71,19807,24019,19636,1,107,25,11466,14,8242,12983,2,0,4,0,-5
EUW1_6881413422',3,57,12,1,0,0,0,3,1,366,94,27142,30997,26945,2,56,6,1,0,1,0,4,331,95,23190,29518,25628,1,35,-1,3952,6,1479,1317,0,0,-1,0,-1
EUW1_6881369883',2,28,19,0,0,1,0,9,0,345,88,30043,30101,36869,6,31,14,1,0,1,0,7,323,79,28383,28398,35632,1,22,9,1660,5,1703,1237,-1,0,0,0,2
EUW1_6881293378',3,24,13,1,0,1,0,7,1,355,85,30896,30393,31192,4,90,22,1,0,0,0,5,320,99,30539,30242,36612,0,35,-14,357,-9,151,-5420,0,0,1,0,2
EUW1_6881248857',2,109,4,0,0,0,0,6,1,324,98,22204,27336,23217,4,29,9,2,0,0,0,0,359,118,25667,30163,27396,0,-35,-20,-3463,-5,-2827,-4179,-2,0,0,0,6
EUW1_6881136039',7,31,16,0,0,2,0,8,0,364,70,30050,31059,33020,4,27,13,1,0,0,0,2,390,79,27654,29722,34161,1,-26,-9,2396,3,1337,-1141,-1,0,2,0,6
EUW1_6879804681',3,33,10,2,0,0,0,5,1,330,78,25878,28578,30304,3,20,16,0,1,0,0,4,349,102,27779,30454,35295,1,-19,-24,-1901,-6,-1876,-4991,2,-1,0,0,1
EUW1_6873963460',1,23,9,0,0,0,0,4,0,339,82,24986,26743,26606,8,60,21,1,1,1,0,1,326,97,30887,31609,35661,0,13,-15,-5901,-12,-4866,-9055,-1,-1,-1,0,3
EUW1_6872660569',3,25,12,1,0,0,0,15,0,298,76,26901,28137,30419,1,37,10,0,0,2,0,1,384,102,29304,30605,30741,1,-86,-26,-2403,2,-2468,-322,1,0,-2,0,14
EUW1_6872622754',5,23,15,1,0,0,0,7,0,329,102,27892,29274,34292,3,24,12,0,0,1,0,2,355,78,27774,29603,35534,1,-26,24,118,3,-329,-1242,1,0,-1,0,5
EUW1_6872590516',5,36,17,2,0,3,0,7,0,385,87,32198,31766,32477,1,38,5,0,0,0,0,8,342,107,23119,28527,21816,1,43,-20,9079,12,3239,10661,2,0,3,0,-1
EUW1_6872506945',3,26,9,1,0,1,0,6,1,381,98,26765,29950,28874,6,30,10,1,0,0,0,5,364,93,25310,30084,26740,1,17,5,1455,-1,-134,2134,0,0,1,0,1
EUW1_6871684883',1,24,12,1,0,2,0,6,1,383,82,28689,30572,44491,3,408,16,1,0,1,0,8,348,69,27325,30100,41245,0,35,13,1364,-4,472,3246,0,0,1,0,-2
EUW1_6871630571',4,32,11,2,0,1,0,10,1,394,78,28550,30928,33714,5,25,11,0,0,0,0,3,382,91,27452,31089,27295,1,12,-13,1098,0,-161,6419,2,0,1,0,7
EUW1_6871572138',7,37,15,0,0,1,0,8,1,378,81,28951,30788,34911,6,34,14,2,0,0,0,3,323,106,26304,28903,26636,1,55,-25,2647,1,1885,8275,-2,0,1,0,5
EUW1_6871522056',3,257,9,0,0,0,0,9,0,363,72,25832,29800,29709,2,61,14,1,0,0,0,2,403,106,29764,32627,36727,0,-40,-34,-3932,-5,-2827,-7018,-1,0,0,0,7
EUW1_6871256603',3,24,9,1,0,0,0,10,0,381,104,25579,30955,25289,4,31,11,1,0,0,0,4,431,100,28390,33206,31812,1,-50,4,-2811,-2,-2251,-6523,0,0,0,0,6
EUW1_6871228492',3,16,17,0,1,0,0,9,1,365,86,28710,31255,36755,1,26,10,2,0,1,0,3,368,74,27051,29038,35007,0,-3,12,1659,7,2217,1748,-2,1,-1,0,6
EUW1_6871187148',1,24,19,1,0,0,0,10,1,317,106,29985,29574,38956,4,26,15,1,0,1,0,0,315,74,29660,27994,36671,0,2,32,325,4,1580,2285,0,0,-1,0,10
EUW1_6883364565',3,31,14,0,0,1,0,6,1,384,76,28921,31082,27048,2,39,12,1,0,0,0,3,363,96,27688,30181,29030,1,21,-20,1233,2,901,-1982,-1,0,1,0,3
EUW1_6883220049',6,152,18,1,0,3,0,7,1,390,93,32396,32003,39865,2,22,11,1,0,0,0,8,339,69,25247,28314,21944,0,51,24,7149,7,3689,17921,0,0,3,0,-1
EUW1_6881990903',2,27,7,1,0,0,0,7,0,376,96,25128,30667,23492,2,23,8,1,0,1,0,1,382,95,25664,28880,23256,0,-6,1,-536,-1,1787,236,0,0,-1,0,6
EUW1_6881914887',3,21,9,0,0,1,0,4,1,343,66,25283,27832,26058,5,26,20,1,0,0,0,4,335,62,27007,30537,28751,0,8,4,-1724,-11,-2705,-2693,-1,0,1,0,0
EUW1_6881788507',3,26,17,2,0,1,0,8,1,393,98,30987,33895,36083,1,22,11,0,0,1,0,2,355,86,24994,29475,30284,1,38,12,5993,6,4420,5799,2,0,0,0,6
EUW1_6881331002',5,25,13,0,0,1,0,6,1,393,96,28317,31845,31406,1,39,3,1,0,0,0,3,400,72,23967,29287,25869,0,-7,24,4350,10,2558,5537,-1,0,1,0,3
EUW1_6881282259',6,25,8,0,0,0,0,9,0,304,82,23898,26896,24776,4,69,12,2,0,3,0,1,418,98,30385,31952,26816,0,-114,-16,-6487,-4,-5056,-2040,-2,0,-3,0,8
EUW1_6881241640',5,29,21,2,0,2,0,8,1,347,84,33022,32127,33942,2,23,14,0,0,0,0,6,339,83,27122,29214,27413,1,8,1,5900,7,2913,6529,2,0,2,0,2
EUW1_6880571580',5,31,10,1,0,0,0,10,1,397,82,27430,29488,23121,1,24,18,1,0,2,0,2,389,81,32765,31994,37065,0,8,1,-5335,-8,-2506,-13944,0,0,-2,0,8
EUW1_6880490262',4,25,4,1,1,0,0,6,1,370,80,23949,27145,24157,4,24,8,1,0,0,0,5,368,92,25209,28488,27276,0,2,-12,-1260,-4,-1343,-3119,0,1,0,0,1
EUW1_6880419279',2,23,5,0,0,0,0,8,1,283,76,22605,25822,23891,2,23,19,1,0,2,0,3,376,94,30307,32549,42518,0,-93,-18,-7702,-14,-6727,-18627,-1,0,-2,0,5
EUW1_6880322981',2,28,12,0,0,0,0,9,0,329,91,26750,28983,34367,2,28,15,1,0,1,0,2,303,88,27768,28772,33870,0,26,3,-1018,-3,211,497,-1,0,-1,0,7
EUW1_6880246318',4,43,12,1,0,0,0,7,0,381,96,28003,32395,35491,6,37,6,0,0,0,0,3,370,77,24407,28568,20799,1,11,19,3596,6,3827,14692,1,0,0,0,4
EUW1_6880149506',0,42,8,1,0,0,0,8,1,314,89,24080,28662,24708,2,24,9,0,0,0,0,2,385,74,25413,29646,27709,0,-71,15,-1333,-1,-984,-3001,1,0,0,0,6
EUW1_6880073212',2,21,4,0,0,0,0,7,0,371,86,23640,28841,31365,5,22,10,2,0,0,0,0,376,106,26505,31929,24740,0,-5,-20,-2865,-6,-3088,6625,-2,0,0,0,7
EUW1_6879848019',6,32,14,2,0,0,0,6,0,319,80,27902,29968,41193,1,23,9,0,0,0,0,5,351,108,25798,30304,28336,1,-32,-28,2104,5,-336,12857,2,0,0,0,1
EUW1_6879806309',5,114,21,1,0,3,0,4,0,343,95,31910,32714,36278,3,62,6,0,0,0,0,11,287,84,23074,26529,27485,1,56,11,8836,15,6185,8793,1,0,3,0,-7
EUW1_6879712006',2,24,10,0,0,0,0,5,0,358,72,25512,28909,33906,3,21,9,1,0,0,0,5,342,76,26025,28499,26971,1,16,-4,-513,1,410,6935,-1,0,0,0,0
EUW1_6881968291',6,26,12,0,0,0,0,15,1,349,80,26927,29958,29049,7,33,11,1,0,2,0,1,385,96,28916,30188,34471,0,-36,-16,-1989,1,-230,-5422,-1,0,-2,0,14
EUW1_6881909372',3,25,13,2,0,2,0,7,1,393,74,30080,30932,35699,2,28,6,0,0,0,0,9,349,92,24293,28672,22622,1,44,-18,5787,7,2260,13077,2,0,2,0,-2
EUW1_6881858380',7,140,16,1,0,1,0,7,1,337,84,28957,29794,29521,7,49,13,1,0,1,0,7,370,92,27964,32293,33759,1,-33,-8,993,3,-2499,-4238,0,0,0,0,0
EUW1_6881801448',3,25,24,0,0,2,0,14,1,323,94,32719,29369,47468,9,34,14,0,0,1,0,5,300,54,27768,26256,34579,1,23,40,4951,10,3113,12889,0,0,1,0,9
EUW1_6881737593',8,36,8,1,0,0,0,8,1,357,110,25702,29138,29915,3,30,12,0,0,0,0,3,325,86,26317,29524,33807,1,32,24,-615,-4,-386,-3892,1,0,0,0,5
EUW1_6881565909',9,49,15,1,1,1,0,8,1,370,98,29613,32190,40864,2,264,12,1,0,0,0,5,346,86,25776,29846,30886,1,24,12,3837,3,2344,9978,0,1,1,0,3
EUW1_6881491843',4,49,9,0,0,0,0,8,0,382,90,26547,29416,29360,0,22,12,1,0,0,0,4,354,77,26398,29383,30979,1,28,13,149,-3,33,-1619,-1,0,0,0,4
EUW1_6880496967',4,37,5,2,0,0,0,14,0,357,90,23970,27969,24503,6,33,16,0,1,3,0,0,435,113,32660,33967,32095,0,-78,-23,-8690,-11,-5998,-7592,2,-1,-3,0,14
EUW1_6880436308',2,27,13,1,0,1,0,12,1,324,88,28259,29174,38684,3,121,18,0,0,0,0,4,350,94,28946,31104,35304,0,-26,-6,-687,-5,-1930,3380,1,0,1,0,8
EUW1_6880376276',1,74,13,0,0,0,0,11,0,296,87,25935,29329,26947,4,25,15,2,1,1,0,0,365,96,28751,30756,35973,0,-69,-9,-2816,-2,-1427,-9026,-2,-1,-1,0,11
EUW1_6880205230',4,33,13,0,0,0,0,10,0,348,84,28133,29465,27606,2,43,14,2,0,1,0,6,357,91,29430,29104,30505,1,-9,-7,-1297,-1,361,-2899,-2,0,-1,0,4
EUW1_6880134383',2,46,13,0,0,0,0,9,0,355,82,26983,28056,30831,8,230,12,1,0,1,0,3,329,86,26517,28332,32113,0,26,-4,466,1,-276,-1282,-1,0,-1,0,6
EUW1_6880022015',3,22,7,0,0,0,0,14,0,329,90,24607,28766,29471,3,67,14,1,0,1,0,1,428,86,30171,33196,39780,0,-99,4,-5564,-7,-4430,-10309,-1,0,-1,0,13
EUW1_6879946391',5,27,20,0,0,1,0,5,0,400,64,33543,30497,35328,6,36,17,1,0,1,0,7,349,81,30670,29390,35948,1,51,-17,2873,3,1107,-620,-1,0,0,0,-2
EUW1_6879922930',1,24,5,0,0,0,0,9,0,330,98,22915,27860,24890,6,188,16,1,0,1,0,2,369,78,30323,31622,37217,0,-39,20,-7408,-11,-3762,-12327,-1,0,-1,0,7
EUW1_6879874534',7,30,10,1,1,1,0,6,1,349,110,27684,28556,29331,6,27,9,1,0,0,0,8,361,96,25952,30690,23936,1,-12,14,1732,1,-2134,5395,0,1,1,0,-2
EUW1_6879805963',7,35,13,1,0,0,0,8,1,312,76,26374,27387,31496,3,38,13,0,0,1,0,2,347,71,28041,29338,35500,1,-35,5,-1667,0,-1951,-4004,1,0,-1,0,6
EUW1_6883463176',2,23,6,0,0,0,0,10,1,318,86,22900,27002,30313,2,28,15,0,0,2,0,0,395,92,29136,32976,36979,0,-77,-6,-6236,-9,-5974,-6666,0,0,-2,0,10
EUW1_6883411656',2,21,11,1,0,1,0,11,0,324,106,26593,28958,27883,3,27,13,1,0,1,0,7,347,77,27577,30170,33165,0,-23,29,-984,-2,-1212,-5282,0,0,0,0,4
EUW1_6881258632',5,29,14,1,0,0,0,8,1,322,92,27706,28849,33269,3,24,12,0,0,0,0,5,359,80,26422,28844,29537,1,-37,12,1284,2,5,3732,1,0,0,0,3
EUW1_6880442233',4,28,15,1,0,0,0,8,0,343,92,28445,29659,45932,0,20,13,1,0,0,0,3,328,91,28183,28381,35711,1,15,1,262,2,1278,10221,0,0,0,0,5
EUW1_6879838439',5,31,14,2,0,2,0,7,1,344,74,28035,28867,36479,5,27,7,0,0,0,0,3,331,102,24227,27719,24575,1,13,-28,3808,7,1148,11904,2,0,2,0,4
EUW1_6879794878',2,24,7,0,0,0,0,14,1,340,69,25331,27152,24286,5,30,20,1,1,2,0,2,382,94,32355,32105,38501,1,-42,-25,-7024,-13,-4953,-14215,-1,-1,-2,0,12
EUW1_6881556918',5,27,20,1,0,1,0,11,1,354,89,32391,30216,39588,5,30,13,1,0,0,0,6,316,64,26958,26764,34347,1,38,25,5433,7,3452,5241,0,0,1,0,5
EUW1_6881479062',2,24,9,2,0,0,0,7,0,344,72,24996,28866,30116,2,354,13,0,1,1,0,5,314,88,27441,28639,31810,0,30,-16,-2445,-4,227,-1694,2,-1,-1,0,2
EUW1_6880261620',5,22,13,2,0,1,0,11,1,365,76,27624,29260,31463,4,31,16,0,0,1,0,5,289,99,28603,28773,29540,1,76,-23,-979,-3,487,1923,2,0,0,0,6
EUW1_6880130535',2,79,11,2,0,1,0,8,1,343,74,26739,29628,25827,5,42,15,0,0,2,0,5,373,73,29560,31651,36854,0,-30,1,-2821,-4,-2023,-11027,2,0,-1,0,3
EUW1_6880064203',6,31,18,2,0,3,0,8,1,374,74,32102,31220,34386,6,28,12,0,0,1,0,10,318,122,27483,29913,31061,1,56,-48,4619,6,1307,3325,2,0,2,0,-2
EUW1_6880005278',1,82,14,1,0,2,0,12,0,299,84,28506,28175,35884,5,37,20,1,0,2,0,2,326,60,30525,27746,39154,1,-27,24,-2019,-6,429,-3270,0,0,0,0,10
EUW1_6879846787',3,18,13,1,0,0,0,14,0,332,76,26648,27656,30924,5,22,15,0,0,1,0,2,352,91,29234,30672,35791,0,-20,-15,-2586,-2,-3016,-4867,1,0,-1,0,12
EUW1_6879778402',4,33,12,1,1,1,0,5,1,354,116,28127,31357,30472,2,13,11,1,0,0,0,4,374,74,26443,30266,32085,0,-20,42,1684,1,1091,-1613,0,1,1,0,1
EUW1_6879563697',6,26,11,1,0,0,0,11,1,330,108,25865,29568,26874,4,27,8,0,0,1,0,2,363,88,26935,29600,31159,0,-33,20,-1070,3,-32,-4285,1,0,-1,0,9
EUW1_6879523281',3,25,16,2,0,0,0,10,1,329,90,29869,29845,36800,2,60,13,0,0,1,0,3,337,100,26939,30581,29354,1,-8,-10,2930,3,-736,7446,2,0,-1,0,7
EUW1_6878938413',4,23,12,2,0,1,0,8,1,308,94,28102,29676,28849,3,25,12,0,0,1,0,5,398,74,27555,30624,29297,0,-90,20,547,0,-948,-448,2,0,0,0,3
EUW1_6878890799',14,33,5,1,0,0,0,10,0,323,82,23183,25759,24929,4,35,15,1,0,2,0,1,335,82,28830,28347,32037,0,-12,0,-5647,-10,-2588,-7108,0,0,-2,0,9
EUW1_6878853666',5,45,17,1,0,1,0,10,1,319,108,29504,29078,25241,6,49,5,1,0,2,0,4,346,99,24301,27251,21782,1,-27,9,5203,12,1827,3459,0,0,-1,0,6
EUW1_6878616977',4,147,15,1,1,2,0,6,1,374,96,30910,30962,34353,2,27,15,1,0,0,0,9,345,80,27535,29737,30001,0,29,16,3375,0,1225,4352,0,1,2,0,-3
EUW1_6878587896',3,22,17,1,0,1,0,10,1,323,102,29880,30652,38714,3,35,8,1,0,0,0,4,303,70,23141,25439,26837,1,20,32,6739,9,5213,11877,0,0,1,0,6
EUW1_6878506617',5,43,15,0,1,1,0,5,1,364,92,30654,30928,34099,5,144,10,2,0,1,0,6,369,99,27331,29103,29696,0,-5,-7,3323,5,1825,4403,-2,1,0,0,-1
EUW1_6877376454',4,136,12,1,0,1,0,8,1,308,86,28115,28311,28676,2,38,18,1,0,0,0,6,355,102,29962,30001,40219,0,-47,-16,-1847,-6,-1690,-11543,0,0,1,0,2
EUW1_6876240179',4,18,9,1,0,0,0,13,0,266,82,23317,27099,17150,5,67,21,1,0,4,0,0,395,101,34296,33322,43578,0,-129,-19,-10979,-12,-6223,-26428,0,0,-4,0,13
EUW1_6876197604',2,41,6,1,0,3,0,6,1,372,76,26729,27630,23899,6,26,6,1,1,0,0,6,376,82,24499,27595,23185,1,-4,-6,2230,0,35,714,0,-1,3,0,0
EUW1_6883354166',4,29,13,2,0,2,0,5,0,383,86,28687,30767,30151,7,27,13,0,0,0,0,9,389,84,27853,30285,32384,1,-6,2,834,0,482,-2233,2,0,2,0,-4
EUW1_6883296869',6,21,11,0,1,1,0,17,0,339,76,27025,28126,27748,4,31,18,1,0,3,0,1,345,80,30717,29382,36809,0,-6,-4,-3692,-7,-1256,-9061,-1,1,-2,0,16
EUW1_6883236630',4,23,15,0,0,0,0,10,1,329,71,28259,28940,38753,3,28,18,1,0,1,0,2,293,81,27605,30195,48199,0,36,-10,654,-3,-1255,-9446,-1,0,-1,0,8
EUW1_6883134385',3,22,5,1,0,0,0,2,0,378,88,23096,29600,19379,5,25,8,0,0,1,0,1,339,94,24526,30007,21339,1,39,-6,-1430,-3,-407,-1960,1,0,-1,0,1
EUW1_6882954159',3,45,14,1,0,0,0,6,1,336,82,26972,28472,31838,5,32,10,0,0,0,0,4,327,89,25524,27970,27056,1,9,-7,1448,4,502,4782,1,0,0,0,2
EUW1_6882897934',3,28,6,1,0,1,0,7,1,374,94,25739,28371,27539,3,47,12,1,0,0,0,5,405,96,28168,32757,24624,1,-31,-2,-2429,-6,-4386,2915,0,0,1,0,2
EUW1_6882847974',7,31,9,0,0,0,0,12,1,285,68,24040,26127,26394,3,36,15,1,0,1,0,1,380,131,30462,32279,35725,0,-95,-63,-6422,-6,-6152,-9331,-1,0,-1,0,11
EUW1_6882747602',2,22,9,2,0,2,0,7,0,404,83,28801,29058,26493,5,28,13,0,0,2,0,9,345,112,29140,32432,34047,0,59,-29,-339,-4,-3374,-7554,2,0,0,0,-2
EUW1_6881994347',2,20,6,1,0,1,0,1,1,393,110,25727,29801,21880,4,30,1,1,0,0,0,4,370,102,22303,28215,15360,0,23,8,3424,5,1586,6520,0,0,1,0,-3
EUW1_6881939567',2,24,13,1,0,0,0,11,1,354,83,29566,28049,34827,5,30,19,0,0,2,0,4,333,104,30878,30910,40387,0,21,-21,-1312,-6,-2861,-5560,1,0,-2,0,7
EUW1_6881856838',5,31,9,2,0,0,0,11,0,312,95,23992,28506,27389,3,38,7,0,0,1,0,1,381,80,25983,29279,25386,1,-69,15,-1991,2,-773,2003,2,0,-1,0,10
EUW1_6881769069',1,38,4,1,1,1,0,3,1,373,79,24258,28127,22548,5,25,16,1,0,0,0,5,326,104,26686,30850,29646,1,47,-25,-2428,-12,-2723,-7098,0,1,1,0,-2
EUW1_6880450074',1,22,18,1,0,1,0,12,0,295,106,28936,30186,33769,4,57,23,1,0,2,0,6,310,72,32389,30378,50227,1,-15,34,-3453,-5,-192,-16458,0,0,-1,0,6
EUW1_6880349452',6,31,4,0,0,0,0,12,0,338,120,23504,28326,22345,4,23,5,1,1,1,0,2,381,70,25094,28663,21550,0,-43,50,-1590,-1,-337,795,-1,-1,-1,0,10
EUW1_6880278898',2,40,12,2,0,0,0,7,0,344,80,26911,28156,31301,4,75,10,0,0,1,0,2,298,99,25631,27370,26392,1,46,-19,1280,2,786,4909,2,0,-1,0,5
EUW1_6879945225',0,20,16,0,1,1,0,11,1,352,87,29932,31358,37858,7,31,18,1,0,1,0,6,327,84,29638,30165,37427,0,25,3,294,-2,1193,431,-1,1,0,0,5
EUW1_6879898345',6,29,10,1,1,2,0,16,0,333,80,28298,28248,29140,5,25,20,1,0,2,0,7,363,100,31857,31797,35391,0,-30,-20,-3559,-10,-3549,-6251,0,1,0,0,9
EUW1_6879784252',6,26,11,0,0,2,0,12,0,352,72,27427,27956,34709,7,27,16,1,0,2,0,7,325,92,29671,30298,41963,0,27,-20,-2244,-5,-2342,-7254,-1,0,0,0,5
EUW1_6879717082',3,24,3,0,0,0,0,8,0,377,92,22900,30475,20279,7,30,11,1,0,1,0,1,376,72,26902,30249,28684,0,1,20,-4002,-8,226,-8405,-1,0,-1,0,7
EUW1_6879013882',3,23,6,1,0,0,0,12,0,312,84,23209,26683,26871,2,36,25,1,1,3,0,0,388,116,34512,34596,44751,0,-76,-32,-11303,-19,-7913,-17880,0,-1,-3,0,12
EUW1_6878171136',4,18,6,0,1,0,0,11,1,316,95,22464,27116,26667,5,34,9,1,0,2,0,1,340,76,25674,29207,23156,0,-24,19,-3210,-3,-2091,3511,-1,1,-2,0,10
EUW1_6878135603',12,34,16,0,1,0,0,11,1,368,80,29303,28401,35230,1,29,14,1,0,1,0,3,353,80,28501,27576,33566,0,15,0,802,2,825,1664,-1,1,-1,0,8
EUW1_6873283290',6,148,12,0,0,0,0,9,0,331,71,25547,28549,38403,0,26,17,1,0,1,0,5,347,80,29445,29578,38588,0,-16,-9,-3898,-5,-1029,-185,-1,0,-1,0,4
EUW1_6873172991',4,64,16,1,0,2,0,11,1,377,96,29263,32020,38804,3,28,10,1,0,1,0,4,324,86,26180,29197,37008,1,53,10,3083,6,2823,1796,0,0,1,0,7
EUW1_6873055017',4,25,14,0,0,0,0,11,0,379,77,28773,30992,31585,1,381,8,2,0,2,0,5,338,96,25371,28649,32277,1,41,-19,3402,6,2343,-692,-2,0,-2,0,6
EUW1_6871504875',4,37,8,1,0,0,0,9,0,341,95,25135,28060,26725,1,39,13,1,0,0,0,2,381,108,28717,32730,31943,0,-40,-13,-3582,-5,-4670,-5218,0,0,0,0,7
EUW1_6871453457',3,30,11,0,0,0,0,10,0,400,94,27189,30380,27349,2,137,10,1,0,1,0,3,376,76,27040,28730,25577,1,24,18,149,1,1650,1772,-1,0,-1,0,7
EUW1_6871402317',3,30,7,0,0,0,0,14,0,304,84,22647,25631,24686,2,106,12,1,0,3,0,0,377,71,28617,30767,28795,0,-73,13,-5970,-5,-5136,-4109,-1,0,-3,0,14
EUW1_6871328450',7,39,6,0,1,0,0,5,0,360,91,24090,28064,24496,6,25,13,2,0,0,0,5,350,92,26489,30427,26396,0,10,-1,-2399,-7,-2363,-1900,-2,1,0,0,0
EUW1_6869518437',5,63,15,1,0,0,0,9,0,343,88,27651,29906,30066,2,60,9,0,0,1,0,3,380,96,28463,30692,24832,1,-37,-8,-812,6,-786,5234,1,0,-1,0,6
EUW1_6882774039',5,31,13,2,0,1,0,14,1,399,101,29599,32164,32114,3,77,10,0,0,2,0,5,387,82,28707,31228,27165,1,12,19,892,3,936,4949,2,0,-1,0,9
EUW1_6879889191',6,104,9,0,0,1,0,6,0,345,94,26368,28705,28401,3,89,14,2,0,0,0,3,300,64,26991,26443,29589,0,45,30,-623,-5,2262,-1188,-2,0,1,0,3
EUW1_6879834079',0,24,7,1,0,0,0,7,0,347,92,25038,27307,32119,2,20,13,1,0,0,0,4,348,60,26590,27787,28394,1,-1,32,-1552,-6,-480,3725,0,0,0,0,3
EUW1_6879786985',2,34,6,0,0,1,0,9,0,374,90,25590,29108,29633,4,31,12,2,0,1,0,5,362,70,27898,29482,27693,1,12,20,-2308,-6,-374,1940,-2,0,0,0,4
EUW1_6879720405',3,238,10,0,0,1,0,10,0,332,70,26417,26048,29748,3,28,21,2,0,1,0,4,357,74,31392,29236,39979,0,-25,-4,-4975,-11,-3188,-10231,-2,0,0,0,6
EUW1_6879689674',0,173,11,0,0,0,0,7,0,333,70,26709,28069,29997,3,23,24,1,0,2,0,3,339,78,31612,29342,44398,0,-6,-8,-4903,-13,-1273,-14401,-1,0,-2,0,4
EUW1_6879659928',1,205,6,1,0,0,0,14,0,285,93,22645,27499,28234,3,24,20,0,1,3,0,0,392,113,32925,34061,34065,0,-107,-20,-10280,-14,-6562,-5831,1,-1,-3,0,14
EUW1_6872800878',7,39,7,1,0,0,0,8,0,364,67,24183,26272,24693,7,32,12,1,0,0,0,3,344,104,27036,27429,34110,0,20,-37,-2853,-5,-1157,-9417,0,0,0,0,5
EUW1_6872762644',7,40,23,1,0,4,0,7,1,370,84,34897,31683,44055,7,31,12,0,0,0,0,10,277,58,25270,25244,29028,1,93,26,9627,11,6439,15027,1,0,4,0,-3
EUW1_6871409675',4,23,19,0,1,1,0,8,0,280,90,29162,29245,40196,7,43,12,2,0,2,0,6,304,72,27924,27640,48991,1,-24,18,1238,7,1605,-8795,-2,1,-1,0,2
EUW1_6871377531',4,27,6,1,0,0,0,9,0,314,82,22979,26903,26739,9,33,23,1,1,1,0,0,363,136,33650,35451,38346,0,-49,-54,-10671,-17,-8548,-11607,0,-1,-1,0,9
EUW1_6870063856',6,32,7,2,0,1,0,10,0,347,82,24804,27256,28653,4,27,15,0,1,1,0,0,356,94,28469,30491,31393,0,-9,-12,-3665,-8,-3235,-2740,2,-1,0,0,10
EUW1_6870001328',4,33,11,1,1,2,0,8,0,381,77,27765,32293,28327,2,26,7,0,0,0,0,5,360,72,23120,29566,22797,1,21,5,4645,4,2727,5530,1,1,2,0,3
EUW1_6869948991',9,33,15,2,0,1,0,8,0,367,96,28907,31527,39415,4,37,8,0,0,0,0,3,291,80,24114,25435,29288,1,76,16,4793,7,6092,10127,2,0,1,0,5
EUW1_6868368806',6,33,10,0,0,1,0,11,1,375,96,27629,31685,28715,3,496,9,2,0,1,0,5,391,80,26562,29754,28258,0,-16,16,1067,1,1931,457,-2,0,0,0,6
EUW1_6868295111',4,33,8,1,0,0,0,6,0,332,94,24543,28368,24536,5,28,9,1,0,0,0,1,356,89,26042,29190,26444,1,-24,5,-1499,-1,-822,-1908,0,0,0,0,5
EUW1_6883221694',2,19,19,0,0,1,0,9,0,334,76,29011,28427,38806,2,28,14,2,0,0,0,4,291,88,27872,27568,34740,0,43,-12,1139,5,859,4066,-2,0,1,0,5
EUW1_6883159551',2,22,20,1,0,0,0,9,1,348,87,30081,32735,39242,7,304,11,0,0,0,0,2,330,62,25958,26457,30780,1,18,25,4123,9,6278,8462,1,0,0,0,7
EUW1_6882835315',3,25,3,0,0,0,0,4,0,351,92,22054,28380,29008,5,27,11,2,0,0,0,0,408,99,26493,31825,27681,0,-57,-7,-4439,-8,-3445,1327,-2,0,0,0,4
EUW1_6882800768',4,32,14,0,1,1,0,6,1,368,108,28769,33114,30924,2,24,5,2,0,0,0,9,343,92,22945,27640,24543,1,25,16,5824,9,5474,6381,-2,1,1,0,-3
EUW1_6882756231',0,244,11,1,1,0,0,9,0,354,102,27036,30037,30681,3,32,10,1,0,0,0,4,396,98,27113,30185,21511,0,-42,4,-77,1,-148,9170,0,1,0,0,5
EUW1_6881473957',2,80,16,1,0,2,0,7,1,349,88,29754,31841,26247,3,245,7,1,0,0,0,6,363,100,24177,29960,33399,0,-14,-12,5577,9,1881,-7152,0,0,2,0,1
EUW1_6880258874',2,29,7,1,0,1,0,7,0,379,68,25189,29153,25741,3,36,6,0,0,0,0,6,363,120,24697,30275,26806,1,16,-52,492,1,-1122,-1065,1,0,1,0,1
EUW1_6880186999',3,243,12,2,0,2,0,7,1,336,114,28485,29774,30408,0,65,12,0,1,0,0,8,346,80,26930,30156,33102,1,-10,34,1555,0,-382,-2694,2,-1,2,0,-1
EUW1_6879581512',3,243,16,1,1,2,0,8,1,364,96,31001,31036,34373,3,25,11,0,0,1,0,9,331,104,27075,30125,28843,1,33,-8,3926,5,911,5530,1,1,1,0,-1
EUW1_6879550541',3,275,11,0,1,1,0,10,1,317,86,26336,27375,28692,3,32,14,1,0,1,0,5,361,72,26826,30647,33809,0,-44,14,-490,-3,-3272,-5117,-1,1,0,0,5
EUW1_6879505444',2,299,3,0,0,1,0,7,0,371,69,23654,26899,26580,5,172,16,2,0,1,0,3,346,93,28985,31129,29204,0,25,-24,-5331,-13,-4230,-2624,-2,0,0,0,4
EUW1_6878867614',3,319,8,0,0,0,0,6,0,357,71,25308,28565,27950,6,30,10,1,0,0,0,2,374,75,25949,29451,26396,0,-17,-4,-641,-2,-886,1554,-1,0,0,0,4
EUW1_6878815863',3,286,9,0,0,0,0,12,0,330,74,25053,27317,30660,1,23,15,1,0,0,0,4,350,87,27710,29468,34510,0,-20,-13,-2657,-6,-2151,-3850,-1,0,0,0,8
EUW1_6883791811',4,27,14,2,0,0,0,11,1,405,112,28362,31882,31757,3,28,5,0,0,0,0,1,350,84,23707,28193,23080,1,55,28,4655,9,3689,8677,2,0,0,0,10
EUW1_6883745969',2,38,9,0,0,1,0,4,1,377,83,26756,28961,34985,2,28,11,2,0,1,0,2,336,92,25847,30216,32770,0,41,-9,909,-2,-1255,2215,-2,0,0,0,2
EUW1_6883226899',3,77,11,0,0,0,0,11,0,288,64,25486,27491,26968,10,36,11,1,0,3,0,0,368,107,28857,29976,27571,0,-80,-43,-3371,0,-2485,-603,-1,0,-3,0,11
EUW1_6883149275',6,33,8,1,0,2,0,7,0,305,92,26022,27333,29916,3,25,14,1,0,0,0,8,297,72,26120,26785,31756,0,8,20,-98,-6,548,-1840,0,0,2,0,-1
EUW1_6883109595',4,26,10,0,0,1,0,12,0,332,71,25978,27017,26561,1,41,17,1,0,1,0,3,319,98,28907,30543,28628,0,13,-27,-2929,-7,-3526,-2067,-1,0,0,0,9
EUW1_6883024471',2,29,9,1,0,1,0,7,1,363,114,26332,29214,25360,1,23,9,1,0,1,0,5,390,66,27139,28749,24926,0,-27,48,-807,0,465,434,0,0,0,0,2
EUW1_6881800097',3,30,11,1,0,0,0,10,0,351,100,27054,28597,29490,8,39,17,0,0,0,0,2,361,88,29759,30353,33048,0,-10,12,-2705,-6,-1756,-3558,1,0,0,0,8
EUW1_6881725867',8,108,2,0,0,0,0,4,1,405,116,23425,29874,14648,5,28,5,2,0,0,0,0,365,112,24094,30476,18932,1,40,4,-669,-3,-602,-4284,-2,0,0,0,4
EUW1_6881548592',5,228,11,0,0,0,0,10,0,321,77,25017,28609,31334,3,88,6,1,0,0,0,2,328,76,22515,26545,21782,1,-7,1,2502,5,2064,9552,-1,0,0,0,8
EUW1_6881505048',3,36,14,1,0,0,0,9,1,310,76,26262,26912,36341,3,28,21,0,0,0,0,4,316,88,31025,30651,38575,0,-6,-12,-4763,-7,-3739,-2234,1,0,0,0,5
EUW1_6881432306',2,368,11,1,0,0,0,14,0,276,98,24570,27928,29671,4,27,19,1,0,2,0,0,358,97,30598,30717,45057,0,-82,1,-6028,-8,-2789,-15386,0,0,-2,0,14
EUW1_6880589921',3,27,13,1,0,0,0,12,1,334,72,27298,27314,27923,10,32,14,0,0,2,0,3,315,84,28014,27415,28131,1,19,-12,-716,-1,-101,-208,1,0,-2,0,9
EUW1_6880532293',3,134,6,0,0,1,0,8,0,369,90,26053,29379,25327,8,25,11,2,0,0,0,3,359,84,25710,29694,23013,0,10,6,343,-5,-315,2314,-2,0,1,0,5
EUW1_6880456245',2,26,13,1,1,1,0,8,1,356,112,30325,30076,38806,7,35,18,1,0,2,0,6,338,52,28182,28709,40076,0,18,60,2143,-5,1367,-1270,0,1,-1,0,2
EUW1_6883430875',4,25,15,0,0,1,0,6,1,371,64,28233,28965,35866,4,26,8,2,0,1,0,9,313,90,25476,28023,30025,0,58,-26,2757,7,942,5841,-2,0,0,0,-3
EUW1_6883354952',6,72,17,1,0,2,0,8,1,310,89,29696,29624,33756,4,25,12,1,0,0,0,7,302,89,25976,28446,37466,0,8,0,3720,5,1178,-3710,0,0,2,0,1
EUW1_6883291841',3,24,8,0,0,0,0,12,1,339,48,23969,26061,27102,4,23,16,2,0,2,0,2,354,85,29531,31921,35354,0,-15,-37,-5562,-8,-5860,-8252,-2,0,-2,0,10
EUW1_6883230566',2,27,6,1,0,1,0,10,1,369,76,25398,29055,23811,10,42,18,1,0,0,0,5,368,100,29418,31553,31679,0,1,-24,-4020,-12,-2498,-7868,0,0,1,0,5
EUW1_6883168652',1,20,8,1,0,1,0,11,1,372,76,25332,29620,25795,3,31,10,1,0,0,0,1,347,124,26382,30863,23279,1,25,-48,-1050,-2,-1243,2516,0,0,1,0,10
EUW1_6882845875',4,33,10,2,0,2,0,7,0,330,86,28637,29081,27787,2,22,17,0,0,0,0,9,334,82,27958,29744,31668,1,-4,4,679,-7,-663,-3881,2,0,2,0,-2
EUW1_6882806650',4,25,11,0,0,2,0,5,1,429,92,28431,32231,34320,2,31,6,1,0,0,0,8,333,88,24302,28656,27734,1,96,4,4129,5,3575,6586,-1,0,2,0,-3
EUW1_6882756858',3,31,9,0,0,1,0,4,0,348,84,26152,29417,29464,3,27,8,2,0,0,0,7,352,91,25852,29580,30801,0,-4,-7,300,1,-163,-1337,-2,0,1,0,-3
EUW1_6882701058',3,33,12,1,0,0,0,11,0,336,81,26385,28760,33531,4,26,16,1,0,1,0,4,339,94,27673,30270,32609,0,-3,-13,-1288,-4,-1510,922,0,0,-1,0,7
EUW1_6882645665',4,40,16,0,0,0,0,8,0,336,76,28293,30041,33167,7,34,13,2,1,0,0,3,364,100,27542,30577,30842,0,-28,-24,751,3,-536,2325,-2,-1,0,0,5
EUW1_6882597745',3,25,9,2,0,1,0,8,0,348,111,26387,29582,26433,2,32,11,0,0,0,0,5,370,75,26685,29916,24234,0,-22,36,-298,-2,-334,2199,2,0,1,0,3
EUW1_6882561023',5,25,7,0,0,0,0,10,0,331,98,24769,28093,24683,2,25,18,2,0,2,0,1,368,92,31452,31871,36635,0,-37,6,-6683,-11,-3778,-11952,-2,0,-2,0,9
EUW1_6882474324',4,42,14,1,0,0,0,6,1,372,79,27667,28704,31095,2,29,10,0,0,1,0,2,327,88,26408,28858,27642,1,45,-9,1259,4,-154,3453,1,0,-1,0,4
EUW1_6882108883',5,20,12,0,0,0,0,5,0,377,96,26960,31258,28716,4,49,9,2,0,0,0,3,360,84,25365,29514,27361,0,17,12,1595,3,1744,1355,-2,0,0,0,2
EUW1_6882054432',5,45,9,0,1,1,0,8,0,351,101,25326,30083,29733,7,80,11,2,0,1,0,3,361,78,27865,29676,31499,1,-10,23,-2539,-2,407,-1766,-2,1,0,0,5
EUW1_6882005829',2,27,15,1,1,1,0,8,1,376,96,30467,31037,35934,9,175,14,1,0,2,0,7,322,94,27919,29862,36870,0,54,2,2548,1,1175,-936,0,1,-1,0,1
EUW1_6881933222',2,186,19,2,0,1,0,11,0,315,102,30238,28863,29915,1,34,15,0,0,1,0,7,310,74,28098,27327,39090,1,5,28,2140,4,1536,-9175,2,0,0,0,4
EUW1_6881856301',3,23,3,2,0,1,0,12,1,338,89,23119,27077,21732,2,25,11,0,1,1,0,4,415,90,28506,31659,31480,1,-77,-1,-5387,-8,-4582,-9748,2,-1,0,0,8
EUW1_6881799940',7,34,11,0,0,2,0,13,1,345,62,27847,28537,28245,2,86,15,1,0,3,0,3,348,110,31290,31599,33726,0,-3,-48,-3443,-4,-3062,-5481,-1,0,-1,0,10
EUW1_6882194709',5,25,17,1,0,1,0,4,0,330,100,29220,34047,36816,4,47,8,0,0,0,0,7,362,82,25002,28842,30425,1,-32,18,4218,9,5205,6391,1,0,1,0,-3
EUW1_6882136434',2,27,10,0,0,2,0,12,1,338,98,28289,27637,39628,5,31,20,2,1,2,0,4,383,82,31303,33464,36209,0,-45,16,-3014,-10,-5827,3419,-2,-1,0,0,8
EUW1_6882101963',6,35,8,1,0,0,0,9,1,288,72,23022,26427,27616,6,36,13,1,0,1,0,0,347,92,28021,29648,28732,0,-59,-20,-4999,-5,-3221,-1116,0,0,-1,0,9
EUW1_6879039520',0,24,14,0,0,0,0,7,0,329,90,27666,29250,34216,3,30,17,2,0,1,0,3,344,98,29929,30427,30427,0,-15,-8,-2263,-3,-1177,3789,-2,0,-1,0,4
EUW1_6878740259',7,33,11,1,0,0,0,6,0,356,95,26065,29198,32705,2,28,7,0,0,0,0,3,344,88,24691,29871,33706,0,12,7,1374,4,-673,-1001,1,0,0,0,3
EUW1_6876250254',4,29,18,1,1,1,0,5,0,336,85,30128,30299,34696,2,23,10,0,0,0,0,8,326,66,25241,26693,37595,1,10,19,4887,8,3606,-2899,1,1,1,0,-3
EUW1_6876067992',8,31,7,0,0,1,0,8,1,302,92,24378,26196,26198,3,32,15,2,0,3,0,7,338,79,28687,30863,35807,0,-36,13,-4309,-8,-4667,-9609,-2,0,-2,0,1
EUW1_6875820354',3,30,19,2,0,0,0,10,1,329,68,30255,32000,37007,4,22,11,0,0,1,0,5,341,90,27542,28186,36376,1,-12,-22,2713,8,3814,631,2,0,-1,0,5
EUW1_6874956533',2,46,15,0,0,1,0,9,1,293,87,28003,27025,29956,1,42,18,2,0,2,0,4,309,85,29346,28066,38667,0,-16,2,-1343,-3,-1041,-8711,-2,0,-1,0,5
EUW1_6874104783',6,32,22,0,1,2,0,9,0,289,95,31820,28646,40713,4,24,15,1,0,1,0,8,304,68,28606,27986,35524,0,-15,27,3214,7,660,5189,-1,1,1,0,1
EUW1_6873692842',5,25,16,1,0,1,0,4,1,374,102,30037,33183,39596,3,16,7,1,0,0,0,8,322,97,24273,28538,18482,1,52,5,5764,9,4645,21114,0,0,1,0,-4
EUW1_6873591224',2,26,17,1,0,1,0,8,0,296,82,27805,30730,29445,3,23,10,1,0,0,0,7,293,108,24846,28651,31841,1,3,-26,2959,7,2079,-2396,0,0,1,0,1
EUW1_6869116001',1,24,10,0,0,0,0,14,0,318,76,25518,26790,23743,2,26,15,2,0,2,0,0,333,100,30150,29956,34521,0,-15,-24,-4632,-5,-3166,-10778,-2,0,-2,0,14
EUW1_6883085801',4,23,16,1,1,0,0,4,1,360,92,28595,30436,36366,6,70,9,1,0,0,0,3,335,96,25182,28184,28141,1,25,-4,3413,7,2252,8225,0,1,0,0,1
EUW1_6882977001',4,31,19,0,1,1,0,4,1,391,95,31636,32921,32702,3,30,7,1,0,0,0,3,330,69,23741,27433,25362,1,61,26,7895,12,5488,7340,-1,1,1,0,1
EUW1_6882811971',1,20,14,1,0,1,0,15,1,336,86,28057,30861,36128,3,23,15,1,0,1,0,3,378,89,29941,32310,35542,1,-42,-3,-1884,-1,-1449,586,0,0,0,0,12
EUW1_6882036598',3,22,3,0,0,0,0,9,0,353,78,22080,26577,18413,3,254,11,2,0,1,0,0,387,82,27585,30072,25818,0,-34,-4,-5505,-8,-3495,-7405,-2,0,-1,0,9
EUW1_6883622638',4,27,31,1,0,0,0,17,1,329,79,33863,33754,40168,0,17,11,0,1,3,0,4,322,103,28746,28785,34945,1,7,-24,5117,20,4969,5223,1,-1,-3,0,13
EUW1_6883596088',5,28,19,2,1,2,0,11,1,359,90,30521,31185,33267,0,24,7,0,0,1,0,5,321,84,23581,28019,22428,1,38,6,6940,12,3166,10839,2,1,1,0,6
EUW1_6883531916',1,254,6,0,0,0,0,16,0,307,83,23380,26067,20699,4,34,14,2,0,4,0,2,361,96,30117,29413,29876,0,-54,-13,-6737,-8,-3346,-9177,-2,0,-4,0,14
EUW1_6883486089',6,32,12,2,0,0,0,4,1,378,77,27196,30583,29498,6,33,9,0,0,0,0,5,368,86,23851,26880,22899,1,10,-9,3345,3,3703,6599,2,0,0,0,-1
EUW1_6883443661',5,27,22,1,0,1,0,11,1,320,92,30530,29951,34888,3,24,8,1,0,0,0,4,316,97,26226,27560,34068,1,4,-5,4304,14,2391,820,0,0,1,0,7
EUW1_6883341332',1,22,16,0,0,3,0,4,0,357,83,30977,29122,38649,8,43,19,1,0,0,0,12,290,80,28959,29100,38622,0,67,3,2018,-3,22,27,-1,0,3,0,-8
EUW1_6883283297',3,20,15,1,0,1,0,13,0,318,80,27688,26453,29205,3,28,27,1,0,2,0,4,340,4,30904,28227,40201,0,-22,76,-3216,-12,-1774,-10996,0,0,-1,0,9
EUW1_6882900041',4,23,19,1,0,0,0,10,1,321,64,29228,28473,36984,4,19,8,0,0,1,0,3,313,70,24345,26992,25111,1,8,-6,4883,11,1481,11873,1,0,-1,0,7
EUW1_6882826401',3,23,14,1,0,0,0,8,1,349,89,27343,29346,30996,3,26,10,0,0,1,0,4,333,90,24484,29078,31180,1,16,-1,2859,4,268,-184,1,0,-1,0,4
EUW1_6882270551',3,58,11,1,0,1,0,10,0,313,93,27550,30025,35014,4,58,11,1,0,1,0,8,342,90,27147,29757,29570,1,-29,3,403,0,268,5444,0,0,0,0,2
EUW1_6882238096',2,26,18,0,0,1,0,16,1,277,64,30065,29393,35536,4,27,25,1,1,3,0,4,304,97,34441,30333,40196,0,-27,-33,-4376,-7,-940,-4660,-1,-1,-2,0,12
EUW1_6882214990',4,51,20,2,1,2,0,5,1,354,104,31370,33188,38088,4,25,11,0,0,1,0,10,314,62,25331,27837,25568,1,40,42,6039,9,5351,12520,2,1,1,0,-5
EUW1_6882191504',4,28,3,0,0,0,0,13,0,350,68,22355,27074,26424,3,21,13,2,0,1,0,3,397,91,28605,31768,29016,0,-47,-23,-6250,-10,-4694,-2592,-2,0,-1,0,10
EUW1_6881316007',4,29,9,0,0,0,0,7,1,340,82,25530,29272,32275,8,77,16,2,1,0,0,1,321,94,28007,29913,32827,0,19,-12,-2477,-7,-641,-552,-2,-1,0,0,6
EUW1_6881241190',4,24,20,0,0,1,0,10,1,347,66,29887,30492,38852,5,26,9,1,0,0,0,2,312,82,24962,26983,28322,1,35,-16,4925,11,3509,10530,-1,0,1,0,8
EUW1_6881184024',3,26,7,0,0,0,0,6,0,351,73,24304,27225,26754,4,33,12,1,1,0,0,4,341,78,26190,28920,35013,0,10,-5,-1886,-5,-1695,-8259,-1,-1,0,0,2
EUW1_6880726602',3,27,16,0,0,1,0,8,0,331,88,28688,29048,36692,4,28,14,1,0,2,0,2,326,89,28243,27517,38315,0,5,-1,445,2,1531,-1623,-1,0,-1,0,6
EUW1_6879090518',4,26,13,0,0,0,0,11,0,316,94,26116,30203,35262,0,28,16,2,0,0,0,1,358,82,29124,31734,33893,0,-42,12,-3008,-3,-1531,1369,-2,0,0,0,10
EUW1_6879032011',2,22,16,0,0,0,0,16,1,359,94,30500,29624,34949,4,37,14,1,0,6,0,8,304,94,31077,29687,42438,0,55,0,-577,2,-63,-7489,-1,0,-6,0,8
EUW1_6883530356',7,47,6,1,0,1,0,9,0,371,94,25540,29722,27264,5,27,5,1,0,0,0,4,394,81,24084,29041,21988,1,-23,13,1456,1,681,5276,0,0,1,0,5
EUW1_6883501701',7,29,13,1,0,1,0,14,0,333,76,27107,28112,29518,8,35,17,0,0,1,0,2,321,104,29858,29237,34775,0,12,-28,-2751,-4,-1125,-5257,1,0,0,0,12
EUW1_6883433857',2,24,13,0,0,0,0,6,0,408,76,28166,31083,31785,7,29,13,1,0,0,0,5,362,96,28402,30955,32228,1,46,-20,-236,0,128,-443,-1,0,0,0,1
EUW1_6883212737',6,26,5,0,0,0,0,8,0,338,99,24056,27663,22008,2,51,9,1,0,0,0,2,406,80,26031,30626,29242,1,-68,19,-1975,-4,-2963,-7234,-1,0,0,0,6
EUW1_6882865946',4,35,7,2,0,0,0,4,0,354,102,24662,31525,26784,2,36,5,0,1,0,0,3,412,86,24705,29627,26479,1,-58,16,-43,2,1898,305,2,-1,0,0,1
EUW1_6882810752',2,24,11,1,1,0,0,9,0,387,100,28809,31138,33077,7,29,17,1,0,1,0,5,369,84,29895,30049,36196,1,18,16,-1086,-6,1089,-3119,0,1,-1,0,4
EUW1_6882762808',2,25,10,0,0,0,0,12,1,389,82,26819,29094,22888,7,211,14,2,0,2,0,6,359,98,29137,31302,32634,0,30,-16,-2318,-4,-2208,-9746,-2,0,-2,0,6
EUW1_6882717096',0,217,8,0,0,0,0,8,0,328,77,24724,25942,32782,8,29,17,0,0,1,0,2,290,102,28910,29015,37140,0,38,-25,-4186,-9,-3073,-4358,0,0,-1,0,6
EUW1_6882684080',3,37,24,1,0,2,0,4,1,343,102,33407,33054,38014,2,19,10,1,0,0,0,7,325,74,25408,28002,29988,1,18,28,7999,14,5052,8026,0,0,2,0,-3
EUW1_6882483010',0,26,16,2,0,2,0,9,1,380,84,30570,32042,44031,4,34,10,0,0,0,0,4,314,78,24571,29365,30141,1,66,6,5999,6,2677,13890,2,0,2,0,5
EUW1_6882450871',6,26,12,1,0,1,0,6,0,394,98,28067,31180,35667,6,149,11,1,0,1,0,2,343,75,27692,30077,32682,1,51,23,375,1,1103,2985,0,0,0,0,4
EUW1_6882425346',4,21,3,0,0,0,0,13,0,318,79,21250,26430,30232,4,27,25,2,0,4,0,1,319,112,34514,32727,41639,0,-1,-33,-13264,-22,-6297,-11407,-2,0,-4,0,12
EUW1_6883358274',2,29,14,1,0,3,0,5,0,365,100,30279,30165,42773,3,27,12,1,0,0,0,9,299,96,24963,27727,27565,1,66,4,5316,2,2438,15208,0,0,3,0,-4
EUW1_6880411969',5,26,8,0,0,0,0,7,0,322,100,23861,26617,30110,5,27,14,1,0,0,0,0,356,52,26158,27878,32478,0,-34,48,-2297,-6,-1261,-2368,-1,0,0,0,7
EUW1_6879667290',6,222,15,0,1,1,0,11,1,278,88,28253,26413,27467,2,31,17,2,0,2,0,2,343,93,30437,30966,38141,0,-65,-5,-2184,-2,-4553,-10674,-2,1,-1,0,9
EUW1_6879628014',3,28,10,0,0,1,0,10,1,323,78,25967,27368,30115,5,32,17,2,1,1,0,3,318,98,29134,27890,38039,0,5,-20,-3167,-7,-522,-7924,-2,-1,0,0,7
EUW1_6879600944',4,42,15,0,0,0,0,11,0,303,78,27072,27413,32899,3,18,16,2,0,3,0,2,345,98,30514,29629,30423,0,-42,-20,-3442,-1,-2216,2476,-2,0,-3,0,9
EUW1_6879176846',0,29,22,2,0,2,0,6,0,360,102,33311,32342,42573,2,30,11,0,0,0,0,7,309,70,25565,26807,34780,1,51,32,7746,11,5535,7793,2,0,2,0,-1
EUW1_6879090468',1,17,10,2,1,0,0,6,0,317,114,27357,28076,28319,3,31,9,0,0,2,0,7,338,60,25244,26653,27282,1,-21,54,2113,1,1423,1037,2,1,-2,0,-1
EUW1_6878363720',5,29,10,1,1,1,0,5,0,384,80,27620,30571,24686,3,138,8,1,0,0,0,5,357,104,24664,29108,22776,1,27,-24,2956,2,1463,1910,0,1,1,0,0
EUW1_6878303375',4,207,11,2,0,0,0,7,1,400,86,26759,31474,36840,3,27,5,0,0,0,0,0,350,80,23640,28254,23493,1,50,6,3119,6,3220,13347,2,0,0,0,7
EUW1_6878026034',2,84,17,1,0,1,0,3,1,292,91,28392,28604,34063,0,24,11,1,0,0,0,3,326,68,25331,27822,34711,1,-34,23,3061,6,782,-648,0,0,1,0,0
EUW1_6877684866',3,20,12,0,0,0,0,4,1,334,108,26581,30705,28215,8,26,12,2,1,0,0,2,316,98,26167,29074,31051,0,18,10,414,0,1631,-2836,-2,-1,0,0,2
EUW1_6877629251',4,31,10,0,0,1,0,11,0,313,81,26283,26757,32153,7,24,21,1,1,1,0,3,343,91,30679,31890,42535,1,-30,-10,-4396,-11,-5133,-10382,-1,-1,0,0,8
EUW1_6877576511',1,25,13,1,1,1,0,5,1,416,114,29844,32630,35632,1,32,7,1,0,0,0,6,318,106,24085,27812,24542,1,98,8,5759,6,4818,11090,0,1,1,0,-1
EUW1_6877511923',2,28,4,0,0,0,0,7,0,357,99,23646,30631,17275,4,22,6,2,0,1,0,4,378,93,24954,28970,24723,0,-21,6,-1308,-2,1661,-7448,-2,0,-1,0,3
EUW1_6870684303',3,47,14,0,0,1,0,13,0,314,94,27358,29589,34553,1,22,14,1,0,1,0,2,336,87,28341,30540,34699,0,-22,7,-983,0,-951,-146,-1,0,0,0,11
EUW1_6870603839',3,24,9,0,0,1,0,8,0,323,93,25764,27860,30499,3,23,11,1,0,1,0,2,373,79,26628,29284,25194,0,-50,14,-864,-2,-1424,5305,-1,0,0,0,6
EUW1_6879745161',3,20,9,0,0,0,0,12,0,358,79,25162,30323,27649,2,24,9,2,0,2,0,3,358,103,27079,29409,32773,0,0,-24,-1917,0,914,-5124,-2,0,-2,0,9
EUW1_6879714561',4,25,17,2,0,3,0,9,1,372,96,31644,32404,43929,5,31,10,0,0,0,0,11,353,84,26764,30913,34377,1,19,12,4880,7,1491,9552,2,0,3,0,-2
EUW1_6879667497',3,26,7,0,0,1,0,11,0,360,80,25495,29072,30129,3,23,15,0,0,0,0,3,369,84,28636,29988,35525,1,-9,-4,-3141,-8,-916,-5396,0,0,1,0,8
EUW1_6879176780',4,23,10,1,1,0,0,8,1,345,106,25794,30188,35919,3,29,9,0,0,0,0,5,332,81,24372,28793,32282,1,13,25,1422,1,1395,3637,1,1,0,0,3
EUW1_6879088190',3,31,14,1,0,0,0,11,1,309,79,26654,27441,28351,5,27,12,1,0,2,0,3,380,92,28696,31666,34803,0,-71,-13,-2042,2,-4225,-6452,0,0,-2,0,8
EUW1_6879027411',4,27,5,1,0,0,0,11,0,310,100,22765,27176,34877,5,37,11,1,0,2,0,0,341,96,27966,30786,32670,0,-31,4,-5201,-6,-3610,2207,0,0,-2,0,11
EUW1_6878593528',4,23,10,1,1,0,0,6,1,374,78,26392,28989,27655,7,32,11,1,0,0,0,2,371,77,25791,29867,31493,1,3,1,601,-1,-878,-3838,0,1,0,0,4
EUW1_6743818039',4,38,10,2,0,0,0,13,0,355,72,25548,28692,30381,3,21,10,0,1,4,0,1,353,95,27340,30685,27306,1,2,-23,-1792,0,-1993,3075,2,-1,-4,0,12
EUW1_6743760089',2,38,12,1,1,0,0,10,0,356,79,27350,29299,32400,3,46,10,0,0,1,0,3,300,68,25648,28059,33487,1,56,11,1702,2,1240,-1087,1,1,-1,0,7
EUW1_6743697368',4,21,12,1,1,1,0,13,1,329,90,26622,27591,28651,2,28,18,1,0,1,0,4,330,81,31191,30399,40628,0,-1,9,-4569,-6,-2808,-11977,0,1,0,0,9
EUW1_6702756603',5,34,17,0,1,1,0,8,0,337,80,29616,29552,38553,4,45,11,2,0,0,0,8,330,96,25996,28822,28498,1,7,-16,3620,6,730,10055,-2,1,1,0,0
EUW1_6702694184',4,82,5,0,1,0,0,11,1,302,72,21980,26235,19458,7,27,14,1,0,1,0,3,380,84,28146,29579,31950,0,-78,-12,-6166,-9,-3344,-12492,-1,1,-1,0,8
EUW1_6702631053',3,25,11,0,1,1,0,9,1,349,55,27600,27737,25876,2,29,15,2,0,1,0,7,331,132,29359,31501,28580,1,18,-77,-1759,-4,-3764,-2704,-2,1,0,0,2
EUW1_6693366896',1,17,10,1,1,0,0,8,1,367,72,26653,29259,19507,4,39,10,0,0,1,0,4,346,104,27802,30422,25347,0,21,-32,-1149,0,-1163,-5840,1,1,-1,0,4
EUW1_6693275267',4,38,12,0,1,1,0,6,1,350,96,28244,31159,30413,3,23,8,1,0,1,0,6,343,95,26126,30788,25505,0,7,1,2118,4,371,4908,-1,1,0,0,0
EUW1_6686001615',4,20,15,1,1,0,0,7,1,344,64,26543,29057,32643,6,32,15,0,0,1,0,4,329,83,28140,29953,31997,0,15,-19,-1597,0,-896,646,1,1,-1,0,3
EUW1_6685918614',1,22,9,1,0,0,0,8,1,320,80,24580,28116,23444,0,16,10,0,1,2,0,2,376,84,26951,30994,26321,0,-56,-4,-2371,-1,-2878,-2877,1,-1,-2,0,6
EUW1_6684219943',1,20,15,0,1,2,0,8,1,331,84,29581,29864,38862,0,54,10,1,0,0,0,7,337,85,26514,31055,35806,1,-6,-1,3067,5,-1191,3056,-1,1,2,0,1
EUW1_6880736628',3,304,10,0,0,0,0,12,1,317,75,24378,26828,25270,4,155,18,2,0,1,0,5,356,120,30950,33399,37502,0,-39,-45,-6572,-8,-6571,-12232,-2,0,-1,0,7
EUW1_6879236575',5,29,10,1,0,0,0,8,1,340,89,26127,27800,31981,1,23,16,0,0,0,0,6,330,94,28479,31112,30187,1,10,-5,-2352,-6,-3312,1794,1,0,0,0,2
EUW1_6878939339',10,30,10,0,0,1,0,5,0,363,80,27433,29082,31869,2,18,11,1,0,0,0,4,326,64,25139,28470,23412,1,37,16,2294,-1,612,8457,-1,0,1,0,1
EUW1_6867465695',4,136,17,1,1,1,0,9,0,287,92,28702,28766,37407,5,34,9,0,0,1,0,4,361,70,26552,27974,33662,1,-74,22,2150,8,792,3745,1,1,0,0,5
EUW1_6867415558',6,26,14,1,0,1,0,8,0,357,91,29143,30506,33298,5,31,9,0,0,0,0,7,349,82,25901,29739,32819,1,8,9,3242,5,767,479,1,0,1,0,1
EUW1_6857902667',7,165,13,1,0,2,0,11,1,366,106,29277,33352,27034,2,18,2,1,0,2,0,1,379,88,23060,27446,19096,1,-13,18,6217,11,5906,7938,0,0,0,0,10
EUW1_6856593112',2,24,17,1,0,0,0,9,1,288,100,28599,29782,36564,2,24,19,1,0,1,0,1,364,80,30473,30177,44931,1,-76,20,-1874,-2,-395,-8367,0,0,-1,0,8
EUW1_6855939283',5,150,12,1,1,1,0,5,1,328,112,28275,29878,37496,6,23,10,0,0,0,0,6,340,80,25136,29379,25331,0,-12,32,3139,2,499,12165,1,1,1,0,-1
EUW1_6855011648',7,32,12,0,0,1,0,6,1,373,98,29318,30491,30606,3,28,17,2,1,0,0,3,343,87,28897,29528,34807,0,30,11,421,-5,963,-4201,-2,-1,1,0,3
EUW1_6854144900',6,35,16,1,1,0,0,7,0,360,108,29532,30933,30743,5,45,7,1,0,0,0,3,300,91,24079,26402,23984,1,60,17,5453,9,4531,6759,0,1,0,0,4
EUW1_6853929509',4,28,16,0,0,1,0,9,0,338,84,30964,30082,39280,5,23,17,1,0,0,0,7,361,70,29100,29427,35843,1,-23,14,1864,-1,655,3437,-1,0,1,0,2
EUW1_6853578618',5,21,21,0,0,0,0,11,0,293,67,30439,29280,35980,3,26,21,1,0,1,0,3,344,103,31851,31095,38988,0,-51,-36,-1412,0,-1815,-3008,-1,0,-1,0,8
EUW1_6883797762',6,27,10,0,0,1,0,9,1,392,84,27494,32402,25971,5,40,9,1,0,0,0,4,359,89,26282,29728,29266,1,33,-5,1212,1,2674,-3295,-1,0,1,0,5
EUW1_6883779118',4,30,16,1,1,1,0,8,1,370,96,30060,30944,34474,5,26,6,1,0,1,0,6,328,100,24294,28347,24371,1,42,-4,5766,10,2597,10103,0,1,0,0,2
EUW1_6883571117',2,47,15,0,0,0,0,6,1,366,82,27953,28464,31933,6,35,9,2,0,0,0,0,359,102,26624,28662,32194,0,7,-20,1329,6,-198,-261,-2,0,0,0,6
EUW1_6883535271',3,25,11,1,0,0,0,14,1,339,84,25868,30538,24611,6,79,5,0,0,1,0,1,391,98,26639,30604,27913,0,-52,-14,-771,6,-66,-3302,1,0,-1,0,13
EUW1_6883484129',4,25,17,1,0,1,0,7,1,353,88,30675,30795,34523,6,41,12,1,0,0,0,8,327,91,26485,28626,31207,0,26,-3,4190,5,2169,3316,0,0,1,0,-1
EUW1_6883402587',2,27,8,2,0,0,0,10,0,349,81,24398,28504,26949,6,70,13,0,0,1,0,5,382,107,29065,31290,30805,1,-33,-26,-4667,-5,-2786,-3856,2,0,-1,0,5
EUW1_6883305453',2,39,9,1,0,1,0,7,0,364,112,27949,30594,30894,2,32,14,1,0,0,0,8,370,84,28175,30920,36922,1,-6,28,-226,-5,-326,-6028,0,0,1,0,-1
EUW1_6883227296',3,66,8,1,0,0,0,8,0,330,73,23908,27437,25574,4,248,15,0,1,1,0,2,354,92,28652,29949,31032,1,-24,-19,-4744,-7,-2512,-5458,1,-1,-1,0,6
EUW1_6882904595',4,37,10,0,0,0,0,8,0,339,81,26017,27711,20040,2,31,11,1,0,0,0,1,348,98,27196,29157,27010,0,-9,-17,-1179,-1,-1446,-6970,-1,0,0,0,7
EUW1_6882821750',2,28,9,0,0,0,0,16,0,342,107,26361,28913,29771,2,27,17,2,0,3,0,3,377,88,31376,32451,36393,0,-35,19,-5015,-8,-3538,-6622,-2,0,-3,0,13
EUW1_6882773620',0,20,8,1,0,1,0,5,1,350,80,24722,27890,26950,1,26,5,0,1,0,0,1,365,84,23981,27255,21517,0,-15,-4,741,3,635,5433,1,-1,1,0,4
EUW1_6882713732',3,31,9,0,0,0,0,4,1,332,88,24249,27508,22540,1,41,5,2,0,0,0,1,384,90,24491,30284,25050,0,-52,-2,-242,4,-2776,-2510,-2,0,0,0,3
EUW1_6882618321',6,33,19,1,0,1,0,7,1,379,73,30085,30399,44857,2,23,7,1,0,0,0,3,336,78,23907,27075,28059,1,43,-5,6178,12,3324,16798,0,0,1,0,4
EUW1_6882543839',5,37,13,1,0,1,0,2,1,350,84,28211,30254,25645,4,35,5,0,0,0,0,3,364,74,22473,26708,24354,1,-14,10,5738,8,3546,1291,1,0,1,0,-1
EUW1_6882513075',1,33,12,2,0,0,0,10,1,348,106,27588,30207,31693,2,27,14,0,0,0,0,1,362,76,26673,30277,32053,1,-14,30,915,-2,-70,-360,2,0,0,0,9
EUW1_6882264773',3,26,19,1,1,1,0,9,1,285,77,29460,27999,38405,6,31,17,1,0,0,0,0,370,84,29749,30989,39247,0,-85,-7,-289,2,-2990,-842,0,1,1,0,9
EUW1_6882203267',7,36,15,1,0,0,0,12,0,343,89,26698,28648,33790,2,28,12,0,0,1,0,0,326,74,27057,26360,30475,1,17,15,-359,3,2288,3315,1,0,-1,0,12
EUW1_6882170363',4,169,5,2,0,0,0,12,0,345,104,23833,29404,22069,2,89,10,0,0,2,0,1,392,92,28632,30444,24197,0,-47,12,-4799,-5,-1040,-2128,2,0,-2,0,11
EUW1_6882117813',3,26,18,1,0,4,0,10,0,361,104,34366,31565,40354,0,27,17,0,0,4,0,12,281,77,29651,27217,36266,0,80,27,4715,1,4348,4088,1,0,0,0,-2
EUW1_6880218259',3,361,11,1,0,0,0,5,1,412,94,28032,30674,34059,3,22,8,1,0,0,0,7,329,86,24227,29315,25883,1,83,8,3805,3,1359,8176,0,0,0,0,-2
EUW1_6880177660',2,28,6,0,0,0,0,11,0,378,71,24131,28127,26258,7,35,20,1,0,1,0,1,381,111,31694,33369,33387,0,-3,-40,-7563,-14,-5242,-7129,-1,0,-1,0,10
EUW1_6879228438',2,140,9,0,0,0,0,5,1,323,62,24173,28014,36690,6,41,16,1,0,0,0,2,315,82,27495,29388,33230,0,8,-20,-3322,-7,-1374,3460,-1,0,0,0,3
EUW1_6879204029',4,26,6,0,0,0,0,15,0,316,90,23407,27049,21159,4,36,14,1,1,3,0,0,374,110,30639,31769,32437,0,-58,-20,-7232,-8,-4720,-11278,-1,-1,-3,0,15
EUW1_6879173918',2,27,10,1,0,0,0,13,0,341,100,26359,29310,32841,6,35,19,0,0,1,0,0,358,80,32591,31894,33642,0,-17,20,-6232,-9,-2584,-801,1,0,-1,0,13
EUW1_6878936382',5,29,6,0,0,0,0,12,0,337,88,23697,27511,25040,4,27,10,1,0,1,0,4,337,98,27052,28518,25977,0,0,-10,-3355,-4,-1007,-937,-1,0,-1,0,8
EUW1_6878880943',2,27,17,1,0,0,0,6,1,322,84,27258,29789,28565,4,195,8,1,0,1,0,1,336,96,26514,29020,30511,0,-14,-12,744,9,769,-1946,0,0,-1,0,5
EUW1_6878829803',6,28,10,1,0,1,0,11,0,347,97,26273,29575,28382,1,27,11,0,0,1,0,2,385,78,27789,31630,26573,1,-38,19,-1516,-1,-2055,1809,1,0,0,0,9
EUW1_6878776841',2,25,6,1,0,0,0,14,0,304,78,22350,26364,22058,3,21,13,1,0,2,0,2,359,82,28496,30481,29309,0,-55,-4,-6146,-7,-4117,-7251,0,0,-2,0,12
EUW1_6878686036',4,180,9,1,0,0,0,12,1,370,76,27523,29375,29564,1,16,9,0,0,2,0,4,341,82,25955,28236,20534,0,29,-6,1568,0,1139,9030,1,0,-2,0,8
EUW1_6878633167',5,31,10,0,0,1,0,8,1,338,64,26572,27577,25774,4,25,13,0,0,0,0,5,339,70,25681,28253,30265,0,-1,-6,891,-3,-676,-4491,0,0,1,0,3
EUW1_6878587579',3,26,18,1,0,0,0,13,1,373,78,31556,30161,38152,3,30,15,0,0,1,0,5,339,86,28794,29588,37970,1,34,-8,2762,3,573,182,1,0,-1,0,8
EUW1_6878477253',3,23,18,0,0,1,0,12,0,313,86,29391,30150,35979,5,188,13,1,0,0,0,4,337,85,27394,28174,34821,0,-24,1,1997,5,1976,1158,-1,0,1,0,8
EUW1_6878438761',8,190,5,1,0,0,0,7,1,362,83,23677,27945,29313,1,22,6,1,0,1,0,4,352,72,24614,27758,26391,0,10,11,-937,-1,187,2922,0,0,-1,0,3
EUW1_6878371075',7,33,6,1,0,1,0,7,0,382,80,25572,28582,25226,3,23,8,0,0,1,0,8,341,77,25439,29291,25927,1,41,3,133,-2,-709,-701,1,0,0,0,-1
EUW1_6878319064',3,34,8,1,1,1,0,10,0,333,80,25621,29126,30559,7,107,5,1,0,0,0,4,331,92,24333,28189,26501,0,2,-12,1288,3,937,4058,0,1,1,0,6
EUW1_6878263910',4,51,9,1,0,0,0,10,1,342,62,24177,27729,27164,7,43,9,0,0,0,0,2,338,88,25587,28641,27320,1,4,-26,-1410,0,-912,-156,1,0,0,0,8
EUW1_6878236974',3,21,23,2,0,4,0,3,1,364,114,32731,33314,41316,1,39,5,0,0,0,0,12,280,74,21719,24191,30440,1,84,40,11012,18,9123,10876,2,0,4,0,-9
EUW1_6876305135',5,42,10,0,0,0,0,10,0,314,78,25316,26733,29551,8,33,13,1,0,2,0,1,338,92,28950,29078,28024,0,-24,-14,-3634,-3,-2345,1527,-1,0,-2,0,9
EUW1_6879008846',4,60,19,0,1,2,0,14,1,345,102,29858,34252,35966,5,57,6,1,0,0,0,3,321,85,23224,26871,25071,1,24,17,6634,13,7381,10895,-1,1,2,0,11
EUW1_6880133571',5,30,21,1,0,0,0,9,0,322,85,31088,29578,41634,4,31,21,1,0,0,0,5,312,70,32168,29102,42429,0,10,15,-1080,0,476,-795,0,0,0,0,4
EUW1_6880080292',4,31,19,2,0,2,0,10,1,362,104,32653,31634,34691,3,23,5,0,0,1,0,9,329,80,23052,27352,25503,1,33,24,9601,14,4282,9188,2,0,1,0,1
EUW1_6879902225',4,134,9,1,0,0,0,6,0,323,93,25451,27337,24890,5,35,15,0,0,0,0,4,350,65,27219,28111,29275,1,-27,28,-1768,-6,-774,-4385,1,0,0,0,2
EUW1_6879684151',2,25,22,1,0,2,0,3,0,373,71,33282,32215,39323,4,51,23,0,0,0,0,9,313,96,31408,29685,41295,0,60,-25,1874,-1,2530,-1972,1,0,2,0,-6
EUW1_6879637496',4,27,11,0,0,0,0,9,1,372,84,27054,31638,24003,7,30,7,2,0,2,0,6,406,96,27079,30490,24291,0,-34,-12,-25,4,1148,-288,-2,0,-2,0,3
EUW1_6879591515',8,148,17,1,0,1,0,6,0,383,94,31476,31550,32819,10,34,19,1,0,0,0,5,382,94,31056,29886,34542,1,1,0,420,-2,1664,-1723,0,0,1,0,1
EUW1_6879523563',5,30,14,0,0,0,0,11,0,262,98,26273,27137,34010,1,131,15,2,0,2,0,1,356,94,31591,29914,34351,0,-94,4,-5318,-1,-2777,-341,-2,0,-2,0,10
EUW1_6879490001',2,82,14,0,0,0,0,6,0,340,102,27650,30061,29743,2,171,13,1,0,0,0,3,363,73,27077,29549,30948,1,-23,29,573,1,512,-1205,-1,0,0,0,3
EUW1_6879179881',4,56,15,1,0,0,0,9,0,302,73,27475,29487,44545,2,23,14,1,0,1,0,1,296,91,27233,28152,33291,1,6,-18,242,1,1335,11254,0,0,-1,0,8
EUW1_6879149715',3,75,12,0,0,1,0,7,0,388,109,28457,32596,25725,0,22,7,2,0,1,0,2,354,83,25032,28433,25811,1,34,26,3425,5,4163,-86,-2,0,0,0,5
EUW1_6879106519',5,33,12,1,0,2,0,6,1,381,105,28998,31058,30992,2,25,8,1,0,0,0,5,355,90,25763,28093,32388,0,26,15,3235,4,2965,-1396,0,0,2,0,1
EUW1_6878894634',4,212,18,0,1,2,0,5,0,340,100,31719,29721,41086,3,32,17,1,0,1,0,8,318,84,28294,28612,33498,0,22,16,3425,1,1109,7588,-1,1,1,0,-3
EUW1_6878837655',3,39,14,1,0,0,0,7,1,332,94,27302,29572,35659,5,27,10,0,1,0,0,1,283,102,25180,29515,29743,1,49,-8,2122,4,57,5916,1,-1,0,0,6
EUW1_6879852729',5,27,19,1,1,2,0,7,1,338,102,32765,31456,38621,3,91,13,1,0,1,0,10,312,88,26683,29448,27300,1,26,14,6082,6,2008,11321,0,1,1,0,-3
EUW1_6879807716',4,29,22,2,0,2,0,12,0,348,96,31773,32403,32915,4,33,11,0,0,2,0,7,334,79,26621,28351,33229,1,14,17,5152,11,4052,-314,2,0,0,0,5
EUW1_6879734317',3,30,16,1,1,2,0,11,1,380,92,30434,30866,44851,2,22,10,0,0,0,0,7,299,64,24846,26851,32375,0,81,28,5588,6,4015,12476,1,1,2,0,4
EUW1_6879158226',1,101,13,0,0,1,0,7,0,333,85,29462,30672,27947,3,57,14,1,0,1,0,5,332,74,27358,29119,33645,1,1,11,2104,-1,1553,-5698,-1,0,0,0,2
EUW1_6878950477',6,187,7,0,1,0,0,7,0,391,84,27086,29664,30088,2,23,11,1,0,1,0,7,383,94,26877,30490,26015,0,8,-10,209,-4,-826,4073,-1,1,-1,0,0
EUW1_6878719027',2,24,12,1,0,0,0,7,0,352,96,26104,29705,33427,3,26,12,1,0,1,0,1,313,86,26352,28399,31960,0,39,10,-248,0,1306,1467,0,0,-1,0,6
EUW1_6877765293',2,20,8,0,0,0,0,8,1,335,95,25116,29440,21129,8,40,14,2,0,2,0,2,382,85,28745,31506,30925,0,-47,10,-3629,-6,-2066,-9796,-2,0,-2,0,6
EUW1_6876721349',1,31,9,1,0,1,0,11,0,349,76,25959,29510,35618,1,21,15,1,0,1,0,1,371,104,30101,31826,35654,0,-22,-28,-4142,-6,-2316,-36,0,0,0,0,10
EUW1_6876306052',8,31,14,0,0,0,0,8,0,368,95,27460,31240,34745,2,41,9,2,0,0,0,1,373,80,25815,29164,21806,1,-5,15,1645,5,2076,12939,-2,0,0,0,7
EUW1_6876054717',1,18,16,0,1,2,0,10,0,339,80,31516,31238,39589,3,147,16,1,0,2,0,6,318,92,29583,28102,33879,1,21,-12,1933,0,3136,5710,-1,1,0,0,4
EUW1_6875425365',4,24,11,0,0,0,0,12,0,296,65,24744,25399,27255,5,140,21,1,1,3,0,0,346,97,32794,31628,43506,0,-50,-32,-8050,-10,-6229,-16251,-1,-1,-3,0,12
EUW1_6875385361',1,19,11,1,0,1,0,8,0,312,94,27464,27952,30955,3,26,15,1,0,0,0,4,295,52,25598,26564,29644,1,17,42,1866,-4,1388,1311,0,0,1,0,4
EUW1_6854521115',6,63,8,0,0,0,0,9,1,300,64,24329,28169,24590,6,63,17,2,0,2,0,0,395,100,30544,31443,34745,0,-95,-36,-6215,-9,-3274,-10155,-2,0,-2,0,9
EUW1_6853390033',4,23,10,2,0,0,0,10,1,315,78,26340,26449,31338,10,32,13,0,0,0,0,3,332,81,27238,28815,31359,1,-17,-3,-898,-3,-2366,-21,2,0,0,0,7
EUW1_6853342408',7,31,13,2,0,1,0,7,1,326,90,28005,26663,28555,10,107,12,0,0,0,0,6,313,72,25755,27579,28406,1,13,18,2250,1,-916,149,2,0,1,0,1
EUW1_6847594046',8,25,20,1,0,0,0,9,0,277,86,27700,28519,36174,1,22,9,1,1,1,0,4,352,90,26977,29106,31372,0,-75,-4,723,11,-587,4802,0,-1,-1,0,5
EUW1_6847559386',5,33,8,0,0,0,0,12,1,345,55,24995,26560,29109,5,28,18,1,0,1,0,2,372,108,30674,32496,36716,0,-27,-53,-5679,-10,-5936,-7607,-1,0,-1,0,10
EUW1_6883074303',3,89,5,1,0,0,0,8,0,313,82,22685,27203,19030,6,21,12,1,1,0,0,5,350,76,26306,29526,31167,1,-37,6,-3621,-7,-2323,-12137,0,-1,0,0,3
EUW1_6882995414',4,24,10,0,0,0,0,10,0,375,100,27518,31009,31012,2,18,11,2,0,1,0,2,345,100,27950,31364,33129,0,30,0,-432,-1,-355,-2117,-2,0,-1,0,8
EUW1_6882950898',1,33,10,0,0,1,0,12,0,366,79,27530,28257,30974,3,86,15,2,0,1,0,6,339,100,28710,30780,33573,1,27,-21,-1180,-5,-2523,-2599,-2,0,0,0,6
EUW1_6882907772',3,28,12,0,1,0,0,11,0,334,98,26759,29215,33465,2,23,17,2,0,1,0,1,379,108,30331,32702,34533,0,-45,-10,-3572,-5,-3487,-1068,-2,1,-1,0,10
EUW1_6882770815',4,31,7,1,0,0,0,10,0,368,74,24264,28589,28367,4,81,16,1,0,0,0,3,332,92,28340,30180,31958,0,36,-18,-4076,-9,-1591,-3591,0,0,0,0,7
EUW1_6882727705',9,31,7,0,0,0,0,11,0,346,92,24052,26954,32981,5,31,20,2,0,1,0,2,368,86,31118,31503,41464,0,-22,6,-7066,-13,-4549,-8483,-2,0,-1,0,9
EUW1_6882686811',2,23,10,0,0,1,0,6,0,405,86,28735,30529,36584,1,37,14,2,0,0,0,5,368,86,27036,31423,32429,0,37,0,1699,-4,-894,4155,-2,0,1,0,1
EUW1_6881651938',2,29,16,2,0,2,0,6,1,384,105,31191,32140,40687,6,32,10,0,0,1,0,7,328,75,25913,28858,33056,1,56,30,5278,6,3282,7631,2,0,1,0,-1
EUW1_6881615051',4,25,18,1,0,1,0,10,0,347,92,31231,32156,44320,2,31,10,1,0,1,0,5,328,78,25383,27533,31321,1,19,14,5848,8,4623,12999,0,0,0,0,5
EUW1_6881555980',8,72,8,0,0,0,0,13,0,290,53,23631,24775,29942,5,24,16,1,0,3,0,1,386,90,31039,29803,36295,0,-96,-37,-7408,-8,-5028,-6353,-1,0,-3,0,12
EUW1_6881506724',1,22,12,1,0,0,0,12,0,336,88,25943,30277,24926,3,134,13,1,0,1,0,1,382,92,28498,29643,40195,1,-46,-4,-2555,-1,634,-15269,0,0,-1,0,11
EUW1_6881453877',4,47,12,0,0,0,0,13,1,313,61,25023,27337,32016,2,22,10,1,0,3,0,1,381,83,28237,30985,30392,0,-68,-22,-3214,2,-3648,1624,-1,0,-3,0,12
EUW1_6881398258',2,31,5,2,0,0,0,12,0,346,82,22724,26784,31479,2,21,24,0,0,2,0,2,305,80,31308,33280,38193,0,41,2,-8584,-19,-6496,-6714,2,0,-2,0,10
EUW1_6881338797',4,26,12,0,0,0,0,7,1,383,88,27675,30999,39247,1,22,10,2,1,1,0,2,380,84,27579,32396,27508,1,3,4,96,2,-1397,11739,-2,-1,-1,0,5
EUW1_6881282175',0,18,12,2,0,0,0,8,1,371,109,29428,30244,30334,5,28,10,0,0,1,0,6,368,83,25670,29681,27617,1,3,26,3758,2,563,2717,2,0,-1,0,2
EUW1_6881236522',2,79,12,1,0,1,0,8,0,350,98,27262,30822,32375,4,144,13,0,0,1,0,2,385,82,28955,31580,31331,0,-35,16,-1693,-1,-758,1044,1,0,0,0,6
EUW1_6881184892',2,26,15,0,0,1,0,5,0,354,86,29714,29890,36069,2,26,13,1,0,1,0,7,365,106,28701,30590,30534,1,-11,-20,1013,2,-700,5535,-1,0,0,0,-2
EUW1_6881084225',5,82,8,0,0,0,0,9,1,304,75,24148,26369,28284,5,22,18,2,0,2,0,2,317,96,29311,30769,43852,0,-13,-21,-5163,-10,-4400,-15568,-2,0,-2,0,7
EUW1_6880316660',3,19,7,0,0,0,0,8,0,412,70,25645,29808,33932,4,41,13,1,0,1,0,4,351,98,28813,31275,34530,0,61,-28,-3168,-6,-1467,-598,-1,0,-1,0,4
EUW1_6880151858',3,31,22,2,0,1,0,8,1,335,107,31402,32342,44314,3,22,12,0,1,0,0,4,354,76,28383,29727,33118,1,-19,31,3019,10,2615,11196,2,-1,1,0,4
EUW1_6879593066',1,21,8,0,0,0,0,6,1,363,90,26032,29208,33100,1,164,13,2,0,0,0,1,374,114,27900,33240,38387,0,-11,-24,-1868,-5,-4032,-5287,-2,0,0,0,5
EUW1_6879556721',1,26,8,0,0,0,0,9,0,376,82,25313,31003,23259,6,142,13,2,0,1,0,0,377,110,27946,31976,31058,0,-1,-28,-2633,-5,-973,-7799,-2,0,-1,0,9
EUW1_6879147582',2,28,4,0,0,0,0,3,0,359,72,22885,27324,27350,4,25,10,2,0,1,0,1,392,107,27264,32276,30049,1,-33,-35,-4379,-6,-4952,-2699,-2,0,-1,0,2
EUW1_6879099959',3,24,16,0,0,0,0,9,0,359,107,29897,32324,33685,2,22,23,2,0,2,0,5,324,75,32150,31039,37281,0,35,32,-2253,-7,1285,-3596,-2,0,-2,0,4
EUW1_6882917173',3,29,9,1,0,0,0,14,0,362,92,26977,29046,26952,3,18,20,1,0,3,0,3,350,112,33117,32660,39932,1,12,-20,-6140,-11,-3614,-12980,0,0,-3,0,11
EUW1_6882870186',4,44,17,2,1,0,0,6,1,318,84,28505,31835,34615,5,28,17,0,0,1,0,4,342,92,29561,32542,32435,0,-24,-8,-1056,0,-707,2180,2,1,-1,0,2
EUW1_6882843612',4,30,11,2,0,0,0,4,1,451,104,28563,33782,30620,5,17,2,0,0,1,0,4,378,84,21950,29045,12850,1,73,20,6613,9,4737,17770,2,0,-1,0,0
EUW1_6882805592',5,37,17,0,0,0,0,14,1,290,84,28363,26508,33476,2,96,20,0,1,3,0,3,313,84,32127,29668,40117,0,-23,0,-3764,-3,-3160,-6641,0,-1,-3,0,11
EUW1_6882750318',2,100,14,1,0,0,0,9,0,347,82,27169,28374,34883,4,24,13,1,0,0,0,1,340,82,26913,28990,34511,0,7,0,256,1,-616,372,0,0,0,0,8
EUW1_6882721549',3,18,10,0,0,0,0,6,0,345,67,24953,28700,32200,5,27,11,2,0,0,0,4,351,108,28223,29970,36080,0,-6,-41,-3270,-1,-1270,-3880,-2,0,0,0,2
EUW1_6882179768',4,13,8,0,0,1,0,7,0,395,92,26452,30306,18445,4,23,12,1,0,0,0,6,366,108,28072,32331,29101,0,29,-16,-1620,-4,-2025,-10656,-1,0,1,0,1
EUW1_6882143786',1,182,13,2,0,0,0,8,1,336,92,26896,29370,24012,7,26,11,0,0,1,0,3,383,88,27825,29465,24219,0,-47,4,-929,2,-95,-207,2,0,-1,0,5
EUW1_6882096443',6,19,8,1,1,0,0,6,1,368,96,25449,28860,26228,3,64,14,1,0,1,0,2,345,84,27616,30964,38385,1,23,12,-2167,-6,-2104,-12157,0,1,-1,0,4
EUW1_6882062064',3,27,12,0,0,0,0,12,0,315,79,27012,28499,31211,4,24,23,2,1,1,0,2,384,100,33228,32730,41468,0,-69,-21,-6216,-11,-4231,-10257,-2,-1,-1,0,10
EUW1_6882022470',3,13,7,0,0,0,0,13,1,326,72,24337,27347,23004,3,28,18,2,0,4,0,0,398,95,32237,31748,38640,0,-72,-23,-7900,-11,-4401,-15636,-2,0,-4,0,13
EUW1_6881968494',2,39,13,0,0,0,0,15,0,329,74,27362,28587,28331,5,21,21,1,1,3,0,3,365,88,34233,31769,34986,0,-36,-14,-6871,-8,-3182,-6655,-1,-1,-3,0,12
EUW1_6881615209',4,25,17,1,0,0,0,10,0,331,89,29231,30187,37757,7,25,13,0,0,1,0,4,371,83,29679,30792,31679,0,-40,6,-448,4,-605,6078,1,0,-1,0,6
EUW1_6881578609',1,19,6,1,0,0,0,11,0,273,100,22095,26316,24174,4,22,26,1,0,2,0,2,326,92,32759,32444,45204,0,-53,8,-10664,-20,-6128,-21030,0,0,-2,0,9
EUW1_6881512332',3,19,18,2,1,1,0,9,0,373,114,33121,32025,34991,1,72,13,0,0,1,0,6,290,90,25922,27503,30118,0,83,24,7199,5,4522,4873,2,1,0,0,3
EUW1_6881462657',4,19,13,1,1,1,0,5,1,395,102,29413,31310,30101,1,23,5,1,0,0,0,7,346,84,22565,27867,24205,1,49,18,6848,8,3443,5896,0,1,1,0,-2
EUW1_6881405193',2,20,15,1,0,0,0,7,1,362,84,28855,30150,37031,4,22,11,0,0,0,0,3,329,76,26437,29106,33169,1,33,8,2418,4,1044,3862,1,0,0,0,4
EUW1_6881152258',9,27,12,2,1,1,0,7,1,354,78,27460,30696,29235,3,25,6,0,0,1,0,7,358,120,25389,31197,25461,1,-4,-42,2071,6,-501,3774,2,1,0,0,0
EUW1_6881112378',5,35,14,1,0,3,0,9,1,377,92,30198,30762,29664,4,24,7,1,0,0,0,5,331,97,24055,28186,17596,1,46,-5,6143,7,2576,12068,0,0,3,0,4
EUW1_6880660060',4,27,14,1,0,1,0,9,1,313,86,27213,28926,30550,2,25,5,1,0,0,0,3,354,86,23555,28538,28830,1,-41,0,3658,9,388,1720,0,0,1,0,6
EUW1_6880663673',2,31,13,2,0,1,0,8,1,372,108,28367,31205,29717,2,29,6,0,0,0,0,1,344,88,24443,27325,26239,1,28,20,3924,7,3880,3478,2,0,1,0,7
EUW1_6880619379',4,26,9,2,0,0,0,4,1,360,74,25464,29936,29253,5,32,6,0,0,0,0,4,338,90,22861,29503,30032,1,22,-16,2603,3,433,-779,2,0,0,0,0
EUW1_6880577157',6,26,14,0,0,1,0,6,0,323,79,28295,28850,40129,1,26,18,1,0,0,0,5,332,76,28623,30624,35728,0,-9,3,-328,-4,-1774,4401,-1,0,1,0,1
EUW1_6880519050',3,26,18,0,0,0,0,13,1,338,88,30301,29041,40950,1,23,19,1,0,2,0,5,332,82,30293,30292,37245,1,6,6,8,-1,-1251,3705,-1,0,-2,0,8
EUW1_6880319372',2,26,7,0,0,1,0,9,0,370,88,25595,29434,26089,4,22,17,2,0,1,0,1,383,76,29156,30611,32053,0,-13,12,-3561,-10,-1177,-5964,-2,0,0,0,8
EUW1_6880268941',1,32,4,0,0,0,0,9,0,367,89,23691,27802,27802,1,27,13,1,0,1,0,3,325,86,26614,31000,31196,0,42,3,-2923,-9,-3198,-3394,-1,0,-1,0,6
EUW1_6880207919',6,112,20,0,0,1,0,8,0,340,67,29760,31261,43405,3,34,8,1,0,0,0,6,304,88,24932,27610,25701,1,36,-21,4828,12,3651,17704,-1,0,1,0,2
EUW1_6879964224',4,187,16,1,0,0,0,14,0,335,93,27611,29379,27579,3,52,19,1,1,3,0,5,376,86,32393,32112,38307,1,-41,7,-4782,-3,-2733,-10728,0,-1,-3,0,9
EUW1_6879926995',3,25,23,1,1,5,0,7,1,362,98,35293,31301,40592,4,381,4,0,0,0,0,12,298,65,21713,23628,22480,1,64,33,13580,19,7673,18112,1,1,5,0,-5
EUW1_6879884676',1,226,2,0,0,0,0,12,0,360,76,22000,28010,25734,4,29,15,1,0,0,0,1,383,100,28482,33399,28647,0,-23,-24,-6482,-13,-5389,-2913,-1,0,0,0,11
EUW1_6879825452',5,25,5,1,0,0,0,9,0,350,77,24115,27688,27447,2,224,19,1,0,0,0,2,377,98,27925,32439,35060,0,-27,-21,-3810,-14,-4751,-7613,0,0,0,0,7
EUW1_6879199553',2,19,7,0,0,0,0,9,0,302,74,24271,27775,22571,6,38,14,2,0,2,0,1,389,97,29378,31703,30282,0,-87,-23,-5107,-7,-3928,-7711,-2,0,-2,0,8
EUW1_6879148301',3,32,20,2,0,0,0,7,0,365,81,30053,29854,36607,7,51,13,0,0,0,0,6,327,59,27233,26892,32042,1,38,22,2820,7,2962,4565,2,0,0,0,1
EUW1_6879100232',5,129,15,1,0,1,0,14,1,345,94,29519,30372,24229,2,32,10,1,1,2,0,6,367,84,28617,28687,27528,1,-22,10,902,5,1685,-3299,0,-1,-1,0,8
EUW1_6879004089',3,17,7,0,0,0,0,12,0,299,82,23526,26535,28989,4,29,15,2,0,1,0,0,333,94,27971,29315,37150,0,-34,-12,-4445,-8,-2780,-8161,-2,0,-1,0,12
EUW1_6878962711',0,25,19,2,0,2,0,12,1,356,109,31960,31916,31511,1,39,8,0,0,1,0,4,320,60,23570,24482,27120,1,36,49,8390,11,7434,4391,2,0,1,0,8
EUW1_6878875971',3,26,13,1,0,0,0,9,1,296,87,27024,27015,30676,4,29,20,0,0,2,0,1,358,91,32076,32149,38712,1,-62,-4,-5052,-7,-5134,-8036,1,0,-2,0,8
EUW1_6878650384',3,27,14,1,0,1,0,7,1,373,96,30297,31124,37349,3,37,11,1,0,1,0,8,351,100,26982,29856,30560,0,22,-4,3315,3,1268,6789,0,0,0,0,-1
EUW1_6880917208',3,21,24,1,0,1,0,5,0,361,92,30624,31435,35654,5,23,6,0,0,0,0,5,333,84,23412,27376,27222,1,28,8,7212,18,4059,8432,1,0,1,0,0
EUW1_6880905575',3,26,9,0,0,0,0,7,0,382,94,26354,30693,29018,7,27,4,1,0,0,0,3,317,100,22371,26035,23329,1,65,-6,3983,5,4658,5689,-1,0,0,0,4
EUW1_6880880120',2,53,13,2,0,1,0,10,0,370,80,28199,31217,38586,5,35,12,0,0,1,0,6,341,88,26742,28733,34877,1,29,-8,1457,1,2484,3709,2,0,0,0,4
EUW1_6883334404',4,26,10,0,0,1,0,10,0,372,83,27436,28960,26855,3,28,13,1,0,0,0,5,390,98,28574,29589,25783,0,-18,-15,-1138,-3,-629,1072,-1,0,1,0,5
EUW1_6883270248',4,27,10,2,0,0,0,8,0,394,92,26737,31626,26550,9,30,8,0,0,2,0,3,403,88,27126,31784,29729,1,-9,4,-389,2,-158,-3179,2,0,-2,0,5
EUW1_6883206124',6,35,13,2,0,1,0,7,0,360,90,28199,30070,26564,4,131,8,0,0,1,0,6,337,82,24671,27444,24944,1,23,8,3528,5,2626,1620,2,0,0,0,1
EUW1_6883140613',5,142,11,1,0,1,0,8,0,354,98,27138,29225,33743,2,22,7,1,0,1,0,3,371,86,25779,28247,30578,1,-17,12,1359,4,978,3165,0,0,0,0,5
EUW1_6882696055',1,17,5,0,0,0,0,10,0,325,74,22626,25364,27241,4,97,21,2,0,1,0,7,367,89,30119,33117,34148,0,-42,-15,-7493,-16,-7753,-6907,-2,0,-1,0,3
EUW1_6882652861',3,141,14,1,0,1,0,10,1,276,95,28707,29261,42567,2,28,17,1,0,1,0,4,323,78,28110,28552,31459,1,-47,17,597,-3,709,11108,0,0,0,0,6
EUW1_6882617554',4,26,9,0,1,1,0,10,1,360,91,27166,29680,31896,8,186,20,2,0,2,0,2,343,106,30735,30632,37409,0,17,-15,-3569,-11,-952,-5513,-2,1,-1,0,8
EUW1_6882584595',3,221,15,0,0,1,0,9,1,363,110,29465,32062,28651,6,36,9,1,0,1,0,5,372,63,26159,28530,26610,1,-9,47,3306,6,3532,2041,-1,0,0,0,4
EUW1_6882548155',6,197,8,2,0,1,0,11,0,343,116,26578,30498,28015,12,42,14,0,0,2,0,7,345,108,28687,32120,25363,0,-2,8,-2109,-6,-1622,2652,2,0,-1,0,4
EUW1_6880216580',4,189,11,2,0,0,0,6,0,332,100,25463,30455,29421,4,29,13,0,0,0,0,2,357,108,27059,30768,34102,1,-25,-8,-1596,-2,-313,-4681,2,0,0,0,4
EUW1_6880147186',3,148,14,0,0,1,0,11,0,316,90,28174,29099,40022,5,25,25,1,0,1,0,6,292,86,32009,29739,42249,0,24,4,-3835,-11,-640,-2227,-1,0,0,0,5
EUW1_6880117954',2,165,11,2,0,1,0,8,0,392,78,28731,29774,37500,2,27,13,0,0,1,0,6,297,94,26594,28746,27177,1,95,-16,2137,-2,1028,10323,2,0,0,0,2
EUW1_6879755552',5,46,5,1,0,0,0,5,1,395,78,24570,29413,25623,4,180,5,0,0,0,0,4,369,85,24454,29946,23979,1,26,-7,116,0,-533,1644,1,0,0,0,1
EUW1_6879704452',4,152,2,0,0,0,0,13,0,341,88,22221,26332,29421,7,32,18,2,1,2,0,3,388,91,30710,33012,33117,0,-47,-3,-8489,-16,-6680,-3696,-2,-1,-2,0,10
EUW1_6883188389',2,17,13,0,1,0,0,7,1,312,102,26180,32245,34967,5,22,5,2,0,0,0,2,337,106,23022,28019,23121,0,-25,-4,3158,8,4226,11846,-2,1,0,0,5
EUW1_6883139608',2,56,10,0,0,1,0,14,1,335,77,26147,28529,25084,6,59,21,1,0,1,0,3,343,65,29921,30495,34878,0,-8,12,-3774,-11,-1966,-9794,-1,0,0,0,11
EUW1_6882214942',4,27,13,1,0,1,0,7,1,355,104,28592,30135,40052,3,25,7,1,0,1,0,5,289,80,23935,27728,30147,1,66,24,4657,6,2407,9905,0,0,0,0,2
EUW1_6882163005',2,142,15,2,0,0,0,5,1,372,68,27234,29372,31976,7,33,15,0,0,0,0,4,318,83,26665,30298,31480,1,54,-15,569,0,-926,496,2,0,0,0,1
EUW1_6882118547',1,20,15,0,0,0,0,7,1,320,93,26577,28736,34540,2,25,15,1,0,0,0,0,341,80,27209,30142,34310,0,-21,13,-632,0,-1406,230,-1,0,0,0,7
EUW1_6879196649',4,35,7,0,0,0,0,13,0,311,84,23459,26888,23625,2,40,13,2,0,3,0,3,371,116,29974,31153,35639,0,-60,-32,-6515,-6,-4265,-12014,-2,0,-3,0,10
EUW1_6879155023',4,42,8,0,0,0,0,8,0,397,93,27908,30363,26604,7,23,17,1,0,2,0,7,343,78,28812,29186,27603,1,54,15,-904,-9,1177,-999,-1,0,-2,0,1
EUW1_6879118347',5,23,9,0,0,0,0,12,1,275,74,23789,27385,28675,7,32,18,2,0,1,0,0,322,94,29862,32872,41129,0,-47,-20,-6073,-9,-5487,-12454,-2,0,-1,0,12
EUW1_6879061561',6,27,11,2,0,0,0,13,0,364,81,27541,30202,24190,1,220,13,0,0,2,0,2,380,92,28792,30371,33636,1,-16,-11,-1251,-2,-169,-9446,2,0,-2,0,11
EUW1_6878288821',6,153,2,1,0,0,0,8,1,387,84,22895,28566,17412,3,26,8,1,0,0,0,1,409,112,26848,32177,18666,0,-22,-28,-3953,-6,-3611,-1254,0,0,0,0,7
EUW1_6876886729',1,21,15,2,0,0,0,10,1,321,92,26726,32615,31582,5,24,4,0,0,1,0,2,358,84,24250,27587,27852,1,-37,8,2476,11,5028,3730,2,0,-1,0,8
EUW1_6876851061',3,24,18,2,0,2,0,9,1,331,102,29534,30135,37784,2,16,6,0,0,0,0,9,290,81,22665,25153,27500,1,41,21,6869,12,4982,10284,2,0,2,0,0
EUW1_6876800936',0,17,11,0,0,1,0,8,1,347,94,26889,31016,33682,3,24,7,1,0,0,0,4,351,100,25013,28497,28560,0,-4,-6,1876,4,2519,5122,-1,0,1,0,4
EUW1_6876352328',3,415,8,0,0,0,0,4,0,321,66,24650,28184,28061,6,26,17,2,1,1,0,4,367,94,30430,32592,33187,0,-46,-28,-5780,-9,-4408,-5126,-2,-1,-1,0,0
EUW1_6876308104',3,25,19,2,0,0,0,11,1,337,108,30534,30964,35670,3,315,14,0,0,1,0,2,321,76,27476,28128,24565,1,16,32,3058,5,2836,11105,2,0,-1,0,9
EUW1_6876272170',1,269,14,1,0,0,0,1,1,332,92,27124,27117,32256,3,27,13,0,0,0,0,6,284,84,25733,28054,33623,1,48,8,1391,1,-937,-1367,1,0,0,0,-5
EUW1_6876226758',5,26,13,1,1,2,0,9,0,372,90,29414,30178,25450,2,28,10,0,0,0,0,2,346,90,26122,30098,26580,1,26,0,3292,3,80,-1130,1,1,2,0,7
EUW1_6874593258',2,18,14,1,1,0,0,7,1,356,68,27676,30050,32841,4,25,8,1,0,1,0,3,287,90,23743,26514,24878,1,69,-22,3933,6,3536,7963,0,1,-1,0,4
EUW1_6861526530',6,57,6,0,1,1,0,7,0,364,94,24971,29195,22486,4,20,6,2,0,1,0,3,318,94,24130,29424,24134,1,46,0,841,0,-229,-1648,-2,1,0,0,4
EUW1_6861465788',3,28,24,1,0,1,0,9,0,337,88,31563,31219,40355,6,214,7,1,1,2,0,4,368,88,27246,28485,32216,1,-31,0,4317,17,2734,8139,0,-1,-1,0,5
EUW1_6882733156',5,40,9,0,0,0,0,9,1,349,93,26633,30292,30623,3,24,12,2,0,0,0,6,359,82,26716,29669,27533,1,-10,11,-83,-3,623,3090,-2,0,0,0,3
EUW1_6882670985',4,27,20,0,0,3,0,7,1,344,81,31541,31750,43893,1,24,15,1,0,0,0,6,333,66,27161,29772,36057,0,11,15,4380,5,1978,7836,-1,0,3,0,1
EUW1_6881269507',4,33,22,1,0,2,0,6,1,372,116,33583,32332,46139,6,22,12,1,0,0,0,9,306,63,26173,27816,29852,1,66,53,7410,10,4516,16287,0,0,2,0,-3
EUW1_6879155792',3,25,16,2,0,1,0,7,0,406,90,31696,32355,42637,3,35,11,0,1,1,0,7,296,81,24806,28423,29447,1,110,9,6890,5,3932,13190,2,-1,0,0,0
EUW1_6878926585',2,37,9,1,0,0,0,9,0,343,106,26202,29113,26350,2,26,14,0,0,1,0,5,360,61,27369,30484,29238,1,-17,45,-1167,-5,-1371,-2888,1,0,-1,0,4
EUW1_6878880571',5,47,17,2,0,2,0,4,0,378,107,31236,33729,38935,2,19,7,0,0,0,0,5,333,84,23541,27417,27491,1,45,23,7695,10,6312,11444,2,0,2,0,-1
EUW1_6878567628',5,35,12,0,0,1,0,9,1,343,87,27845,30367,28307,4,27,9,2,0,0,0,6,371,108,26583,29192,32142,1,-28,-21,1262,3,1175,-3835,-2,0,1,0,3
EUW1_6878524433',4,29,23,1,0,1,0,9,0,364,116,32495,33182,43144,3,32,8,1,0,1,0,7,323,56,24722,26214,30733,1,41,60,7773,15,6968,12411,0,0,0,0,2
EUW1_6878467584',2,25,14,1,0,1,0,6,0,399,75,28985,31562,29777,5,28,11,1,0,0,0,4,396,94,27269,30134,28040,0,3,-19,1716,3,1428,1737,0,0,1,0,2
EUW1_6878409887',2,28,8,0,1,0,0,11,0,389,107,26587,30318,23912,8,32,8,2,0,1,0,3,376,91,26868,29287,24024,0,13,16,-281,0,1031,-112,-2,1,-1,0,8
EUW1_6878366629',4,24,15,0,0,0,0,9,0,357,105,28324,32032,33414,0,23,9,2,0,0,0,2,350,82,25147,28113,24927,1,7,23,3177,6,3919,8487,-2,0,0,0,7
EUW1_6878304540',6,27,8,0,0,0,0,4,0,387,77,26516,29052,25831,3,27,7,1,0,1,0,8,384,90,25302,29414,24215,1,3,-13,1214,1,-362,1616,-1,0,-1,0,-4
EUW1_6877858828',4,139,12,0,0,0,0,10,0,256,74,25971,27280,33878,2,59,19,2,0,2,0,0,391,94,31939,32501,43158,0,-135,-20,-5968,-7,-5221,-9280,-2,0,-2,0,10
EUW1_6877825067',4,34,16,0,0,0,0,7,1,303,90,28284,29208,30655,2,32,12,2,0,2,0,3,351,80,27179,27445,27968,0,-48,10,1105,4,1763,2687,-2,0,-2,0,4
EUW1_6877803446',5,26,21,1,1,3,0,5,1,407,104,34639,32407,38301,3,22,5,0,0,1,0,12,292,88,23052,26788,23756,1,115,16,11587,16,5619,14545,1,1,2,0,-7
EUW1_6877766757',8,80,7,0,0,1,0,9,1,358,88,26085,28326,28397,4,248,12,2,0,0,0,4,338,96,27522,29466,33102,1,20,-8,-1437,-5,-1140,-4705,-2,0,1,0,5
EUW1_6877723936',5,29,7,1,0,1,0,8,0,370,67,25612,28945,27549,4,48,13,0,0,0,0,4,351,96,27041,30993,26167,1,19,-29,-1429,-6,-2048,1382,1,0,1,0,4
EUW1_6877647025',3,29,17,1,0,1,0,8,0,368,88,29541,29723,39048,3,90,13,0,0,0,0,6,310,84,26689,27994,33118,1,58,4,2852,4,1729,5930,1,0,1,0,2
EUW1_6877585273',4,29,8,0,0,1,0,10,0,313,72,25158,28285,22768,6,26,11,1,0,1,0,3,342,112,27317,29850,31577,0,-29,-40,-2159,-3,-1565,-8809,-1,0,0,0,7
EUW1_6881362397',1,19,5,0,0,0,0,7,0,357,107,24746,29312,27143,3,259,8,2,0,1,0,5,347,96,25483,31359,28837,0,10,11,-737,-3,-2047,-1694,-2,0,-1,0,2
EUW1_6880962507',1,18,15,1,0,2,0,9,1,370,82,29660,30961,40108,2,14,14,1,0,0,0,5,264,78,24695,27606,28834,1,106,4,4965,1,3355,11274,0,0,2,0,4
EUW1_6880932527',0,16,11,0,0,0,0,12,0,329,93,26588,29363,32111,1,27,22,2,0,3,0,2,373,100,32845,32251,36638,0,-44,-7,-6257,-11,-2888,-4527,-2,0,-3,0,10
EUW1_6880902156',5,30,9,0,0,1,0,8,1,363,84,26844,27933,28168,5,36,6,1,0,1,0,7,360,76,24722,29346,19861,1,3,8,2122,3,-1413,8307,-1,0,0,0,1
EUW1_6880055445',2,18,17,0,0,0,0,17,1,279,88,26549,26263,30039,2,26,19,2,0,2,0,3,340,26,30460,27096,31645,0,-61,62,-3911,-2,-833,-1606,-2,0,-2,0,14
EUW1_6880018634',2,24,20,0,1,1,0,7,1,332,83,30350,29216,34907,3,27,11,1,0,0,0,5,286,77,24692,26016,32411,1,46,6,5658,9,3200,2496,-1,1,1,0,2
EUW1_6878927541',2,18,12,0,0,2,0,4,1,402,104,28995,32346,32484,5,24,4,2,0,0,0,5,338,101,22210,28494,21766,1,64,3,6785,8,3852,10718,-2,0,2,0,-1
EUW1_6878864776',2,20,11,0,0,1,0,8,0,329,110,27130,28649,27842,3,39,11,2,0,1,0,6,365,81,27245,30113,29777,0,-36,29,-115,0,-1464,-1935,-2,0,0,0,2
EUW1_6878807176',1,25,10,0,0,0,0,10,1,357,81,27034,30050,32461,3,19,14,1,0,2,0,4,356,74,28679,29944,32988,0,1,7,-1645,-4,106,-527,-1,0,-2,0,6
EUW1_6878779840',4,26,17,0,0,0,0,9,0,320,64,28022,26023,31544,1,27,24,2,1,0,0,1,329,97,32993,30482,46357,0,-9,-33,-4971,-7,-4459,-14813,-2,-1,0,0,8
EUW1_6877455192',5,105,16,1,1,2,0,10,1,365,105,29974,31560,31743,2,28,7,1,0,0,0,6,339,94,24395,29180,25792,1,26,11,5579,9,2380,5951,0,1,2,0,4
EUW1_6877402827',1,38,10,1,0,1,0,9,1,369,100,28224,30794,24349,6,105,11,1,0,0,0,6,327,91,24892,29901,29193,0,42,9,3332,-1,893,-4844,0,0,1,0,3
EUW1_6877319315',2,30,10,0,0,1,0,5,1,341,74,26633,27891,31738,4,43,12,2,0,0,0,1,342,86,25837,30025,32335,1,-1,-12,796,-2,-2134,-597,-2,0,1,0,4
EUW1_6877224896',1,23,14,0,0,1,0,11,1,308,84,27986,27159,27725,2,25,10,2,1,0,0,3,332,106,25367,27855,22226,1,-24,-22,2619,4,-696,5499,-2,-1,1,0,8
EUW1_6876880836',5,25,9,1,1,1,0,3,0,378,108,27329,31435,25470,2,26,9,1,0,0,0,3,387,112,27210,31594,25554,0,-9,-4,119,0,-159,-84,0,1,1,0,0
EUW1_6876546981',3,136,9,0,0,0,0,11,0,318,78,24823,27385,27645,1,17,14,2,0,1,0,3,353,90,28610,29949,30444,0,-35,-12,-3787,-5,-2564,-2799,-2,0,-1,0,8
EUW1_6875741866',2,35,12,0,0,0,0,10,0,306,84,26323,28769,33594,3,50,21,1,0,2,0,2,330,84,30196,29527,37113,1,-24,0,-3873,-9,-758,-3519,-1,0,-2,0,8
EUW1_6875696927',2,19,15,2,0,0,0,9,0,401,122,29691,34127,33723,3,31,11,0,0,0,0,4,351,69,25962,28368,28585,1,50,53,3729,4,5759,5138,2,0,0,0,5
EUW1_6870104511',3,30,8,1,0,0,0,6,1,357,98,25365,29331,23902,5,27,7,1,0,1,0,5,369,90,25006,29615,24645,1,-12,8,359,1,-284,-743,0,0,-1,0,1
EUW1_6882797331',5,32,9,2,0,1,0,10,1,342,82,25192,26190,25088,2,24,12,0,0,0,0,5,332,68,26415,26591,34451,0,10,14,-1223,-3,-401,-9363,2,0,1,0,5
EUW1_6882737236',2,26,17,2,0,0,0,14,0,315,90,28371,29628,29285,1,23,18,0,0,2,0,4,333,101,30233,29080,35809,1,-18,-11,-1862,-1,548,-6524,2,0,-2,0,10
EUW1_6882692963',4,36,8,0,1,0,0,7,0,369,98,25343,30645,24087,8,33,12,1,0,0,0,2,410,79,26415,30810,24342,0,-41,19,-1072,-4,-165,-255,-1,1,0,0,5
EUW1_6882636929',3,25,10,2,0,0,0,8,1,344,87,25219,27851,30433,6,217,12,0,0,2,0,2,380,108,28742,31217,29877,0,-36,-21,-3523,-2,-3366,556,2,0,-2,0,6
EUW1_6882020945',2,24,7,0,0,0,0,11,0,359,86,24652,28499,21691,3,145,18,2,1,2,0,4,376,86,31271,33467,34567,0,-17,0,-6619,-11,-4968,-12876,-2,-1,-2,0,7
EUW1_6881913024',3,27,18,1,0,0,0,7,1,331,94,28931,29209,36408,1,28,15,1,0,0,0,2,347,80,27850,30668,37582,0,-16,14,1081,3,-1459,-1174,0,0,0,0,5
EUW1_6881863673',3,24,26,2,0,0,0,6,1,299,96,32408,30378,41672,3,65,12,0,0,1,0,2,304,80,26070,26142,32573,1,-5,16,6338,14,4236,9099,2,0,-1,0,4
EUW1_6881787005',2,27,11,0,1,1,0,17,0,349,95,26913,30126,35491,5,94,17,2,0,2,0,1,346,75,31089,31627,41083,0,3,20,-4176,-6,-1501,-5592,-2,1,-1,0,16
EUW1_6881734900',5,30,6,1,0,1,0,11,1,357,87,25398,27559,26670,3,27,12,1,0,1,0,3,388,87,28143,30144,32797,0,-31,0,-2745,-6,-2585,-6127,0,0,0,0,8
EUW1_6881659425',6,27,16,0,0,1,0,15,1,340,92,29664,28748,34848,7,29,18,2,1,2,0,2,339,88,31671,29635,31569,0,1,4,-2007,-2,-887,3279,-2,-1,-1,0,13
EUW1_6880042747',3,24,10,2,0,1,0,7,1,374,92,27747,28852,36517,4,46,18,0,1,0,0,5,314,88,28770,30906,43837,0,60,4,-1023,-8,-2054,-7320,2,-1,1,0,2
EUW1_6879251531',6,24,6,0,0,0,0,8,1,364,110,24405,29167,20004,3,94,8,2,0,0,0,3,378,92,25759,30850,23963,0,-14,18,-1354,-2,-1683,-3959,-2,0,0,0,5
EUW1_6879210889',3,27,19,0,0,1,0,3,1,336,73,29861,30550,35306,5,20,9,2,0,1,0,7,282,130,23738,29045,26992,0,54,-57,6123,10,1505,8314,-2,0,0,0,-4
EUW1_6879170894',3,29,13,1,0,0,0,10,0,307,51,27218,27846,36633,3,30,27,0,0,0,0,2,349,108,33278,31425,42335,1,-42,-57,-6060,-14,-3579,-5702,1,0,0,0,8
EUW1_6879149467',3,24,15,2,0,3,0,6,0,392,95,33133,32525,32722,3,22,5,0,0,2,0,10,316,84,22332,27354,19005,1,76,11,10801,10,5171,13717,2,0,1,0,-4
EUW1_6879101896',5,28,9,0,0,0,0,12,0,307,90,25020,28515,22419,3,22,18,2,0,1,0,6,389,78,29533,31097,35566,0,-82,12,-4513,-9,-2582,-13147,-2,0,-1,0,6
EUW1_6879049571',3,66,9,0,0,1,0,3,0,419,118,28653,32002,32961,8,31,13,1,0,0,0,4,370,94,27334,30035,33624,0,49,24,1319,-4,1967,-663,-1,0,1,0,-1
EUW1_6882707922',4,21,10,0,1,0,0,10,1,368,80,26376,29563,27914,2,25,12,2,0,1,0,3,386,114,29402,31962,26837,0,-18,-34,-3026,-2,-2399,1077,-2,1,-1,0,7
EUW1_6882546978',2,36,17,1,0,0,0,9,1,317,82,28612,28696,39216,2,26,13,0,0,0,0,4,318,89,27258,29189,33321,1,-1,-7,1354,4,-493,5895,1,0,0,0,5
EUW1_6880387497',4,22,21,1,0,1,0,8,1,372,75,30566,31291,37252,3,26,9,1,0,0,0,3,290,85,24630,27113,34474,1,82,-10,5936,12,4178,2778,0,0,1,0,5
EUW1_6879833436',2,30,11,0,0,0,0,12,1,316,70,24917,26956,26762,1,21,19,2,1,2,0,2,349,92,30980,31497,33707,0,-33,-22,-6063,-8,-4541,-6945,-2,-1,-2,0,10
EUW1_6879766097',2,25,8,0,0,0,0,9,0,329,84,24654,29126,28600,3,31,15,2,0,1,0,3,324,87,26828,30166,33542,0,5,-3,-2174,-7,-1040,-4942,-2,0,-1,0,6
EUW1_6878938488',6,32,15,2,0,1,0,11,0,385,90,29091,30596,31380,0,21,9,0,0,0,0,4,355,75,24790,29023,24360,1,30,15,4301,6,1573,7020,2,0,1,0,7
EUW1_6878861938',3,24,6,1,0,0,0,5,0,346,94,24582,27795,25392,2,20,7,1,0,0,0,4,315,88,23722,27994,22622,0,31,6,860,-1,-199,2770,0,0,0,0,1
EUW1_6878537015',4,22,17,0,0,1,0,12,0,311,86,29804,32917,33079,8,36,16,1,1,2,0,7,371,102,30825,31739,39012,1,-60,-16,-1021,1,1178,-5933,-1,-1,-1,0,5
EUW1_6877325345',7,40,23,0,0,3,0,7,1,333,80,33490,30668,44741,7,46,20,1,0,0,0,10,284,75,29407,29077,36439,1,49,5,4083,3,1591,8302,-1,0,3,0,-3
EUW1_6877276629',3,32,11,0,0,0,0,9,0,367,72,26280,29700,32703,2,28,15,2,0,0,0,3,377,78,28853,31591,33029,0,-10,-6,-2573,-4,-1891,-326,-2,0,0,0,6
EUW1_6875449627',2,26,4,0,0,1,0,9,0,341,118,24770,27524,26070,3,41,11,2,0,0,0,7,322,74,24932,27465,26950,1,19,44,-162,-7,59,-880,-2,0,1,0,2
EUW1_6875207515',5,24,12,1,0,0,0,7,1,326,84,26481,27416,31955,3,30,7,0,1,2,0,6,349,80,26438,27160,28789,0,-23,4,43,5,256,3166,1,-1,-2,0,1
EUW1_6874630724',2,35,9,1,0,0,0,10,0,384,72,26199,29241,24649,7,23,9,1,0,1,0,3,398,88,26983,32181,33375,0,-14,-16,-784,0,-2940,-8726,0,0,-1,0,7
EUW1_6872479245',1,19,9,0,0,0,0,10,0,325,98,25603,28554,28298,5,33,16,2,0,1,0,5,302,93,28888,29923,36747,0,23,5,-3285,-7,-1369,-8449,-2,0,-1,0,5
EUW1_6869877420',0,36,8,0,0,1,0,8,0,345,78,25426,27418,23883,3,29,17,1,1,2,0,7,386,67,30110,30955,33486,0,-41,11,-4684,-9,-3537,-9603,-1,-1,-1,0,1
EUW1_6869651511',9,248,11,0,0,1,0,9,1,328,86,26808,27349,31505,8,22,12,2,1,0,0,7,369,106,27237,32199,33638,0,-41,-20,-429,-1,-4850,-2133,-2,-1,1,0,2
EUW1_6868335016',3,26,12,1,0,0,0,12,1,293,104,25646,26972,31092,4,17,13,0,0,2,0,1,362,64,28089,29591,30552,0,-69,40,-2443,-1,-2619,540,1,0,-2,0,11
EUW1_6868283969',3,27,17,1,0,2,0,5,1,391,105,31816,32571,39862,2,89,9,0,0,0,0,7,326,58,25462,29074,42192,1,65,47,6354,8,3497,-2330,1,0,2,0,-2
EUW1_6882439799',5,30,15,1,0,0,0,13,0,360,106,28112,31684,37861,1,21,13,1,0,1,0,4,364,90,28935,29950,29179,0,-4,16,-823,2,1734,8682,0,0,-1,0,9
EUW1_6882420591',1,22,9,0,0,1,0,9,1,370,82,26702,29497,30263,3,26,8,0,0,0,0,3,333,96,24278,26919,28894,1,37,-14,2424,1,2578,1369,0,0,1,0,6
EUW1_6881992788',5,26,8,1,0,0,0,12,1,308,72,23978,26254,24844,6,29,23,1,1,4,0,1,374,87,35106,32111,37904,0,-66,-15,-11128,-15,-5857,-13060,0,-1,-4,0,11
EUW1_6881928432',0,19,25,2,1,1,0,7,1,366,88,34708,31008,39713,4,19,15,0,0,1,0,4,288,76,26571,26679,30435,1,78,12,8137,10,4329,9278,2,1,0,0,3
EUW1_6879421633',0,21,13,2,0,2,0,9,1,343,77,27833,28695,28884,3,17,11,0,0,0,0,2,349,90,25764,28446,27703,1,-6,-13,2069,2,249,1181,2,0,2,0,7
EUW1_6879147751',2,18,9,0,0,0,0,11,1,379,76,26577,28378,36823,4,127,15,2,0,2,0,8,365,96,29574,32711,36128,0,14,-20,-2997,-6,-4333,695,-2,0,-2,0,3
EUW1_6879104602',3,17,18,1,1,1,0,8,0,329,108,31268,30452,33776,1,24,17,1,0,1,0,5,310,72,27232,27033,36663,1,19,36,4036,1,3419,-2887,0,1,0,0,3
EUW1_6879048780',2,25,12,2,0,2,0,7,0,313,99,26986,28123,29229,2,25,11,0,0,1,0,7,308,76,25653,26334,28370,1,5,23,1333,1,1789,859,2,0,1,0,0
EUW1_6878269645',3,17,17,1,0,0,0,7,0,358,112,29402,30259,34140,1,25,15,0,0,0,0,1,326,108,28382,30729,31373,1,32,4,1020,2,-470,2767,1,0,0,0,6
EUW1_6878171519',3,34,9,0,0,0,0,9,1,339,73,25229,28225,35126,1,23,15,1,0,1,0,4,371,115,29484,32038,37867,0,-32,-42,-4255,-6,-3813,-2741,-1,0,-1,0,5
EUW1_6878122891',3,27,21,1,0,0,0,10,1,371,94,31246,34252,36253,6,38,12,1,0,2,0,1,339,80,28373,27755,30012,1,32,14,2873,9,6497,6241,0,0,-2,0,9
EUW1_6875370123',3,21,19,2,0,0,0,11,1,276,80,27745,28245,37908,1,21,13,0,0,0,0,2,340,82,27358,27646,35940,1,-64,-2,387,6,599,1968,2,0,0,0,9
EUW1_6875169904',1,164,22,1,0,1,0,7,0,320,90,31418,30983,38586,2,24,13,1,0,0,0,6,365,81,27965,29796,30785,1,-45,9,3453,9,1187,7801,0,0,1,0,1
EUW1_6875130414',0,23,9,1,0,0,0,5,0,357,76,24936,30098,24583,5,28,12,1,0,0,0,2,384,84,26219,31796,23877,1,-27,-8,-1283,-3,-1698,706,0,0,0,0,3
EUW1_6874726251',6,28,27,1,0,1,0,7,1,275,76,31440,30246,50704,1,19,13,1,0,0,0,7,271,82,26872,26410,31882,1,4,-6,4568,14,3836,18822,0,0,1,0,0
EUW1_6883136068',2,26,8,0,0,1,0,4,0,364,76,26779,27061,31913,4,38,15,2,1,0,0,7,346,94,28449,30168,32117,0,18,-18,-1670,-7,-3107,-204,-2,-1,1,0,-3
EUW1_6883071639',6,32,14,1,0,0,0,14,0,335,83,29046,28715,36742,6,38,15,0,0,1,0,2,355,76,28305,28388,36590,1,-20,7,741,-1,327,152,1,0,-1,0,12
EUW1_6882984960',3,22,13,0,0,0,0,7,1,313,80,26302,28157,37359,5,52,18,1,0,1,0,3,354,87,30863,31583,43396,0,-41,-7,-4561,-5,-3426,-6037,-1,0,-1,0,4
EUW1_6882923117',3,19,11,1,0,0,0,5,1,412,77,27300,31057,33794,3,27,11,1,0,0,0,5,387,82,26936,31075,32397,0,25,-5,364,0,-18,1397,0,0,0,0,0
EUW1_6882712467',10,37,5,0,0,0,0,14,0,325,76,22569,26009,23129,3,24,18,1,0,2,0,1,387,114,32036,32403,36997,0,-62,-38,-9467,-13,-6394,-13868,-1,0,-2,0,13
EUW1_6881337798',1,20,6,0,0,0,0,8,0,347,70,23929,29133,19118,3,23,10,1,0,2,0,3,382,110,27493,31496,34959,0,-35,-40,-3564,-4,-2363,-15841,-1,0,-2,0,5
EUW1_6881286557',2,20,18,0,0,0,0,11,1,297,62,28457,30009,42341,3,260,13,1,1,2,0,0,368,100,29720,29711,36965,0,-71,-38,-1263,5,298,5376,-1,-1,-2,0,11
EUW1_6880950237',2,24,9,1,1,0,0,13,0,351,98,26408,27868,27711,3,30,14,1,0,1,0,0,320,90,28040,27679,32400,0,31,8,-1632,-5,189,-4689,0,1,-1,0,13
EUW1_6880922046',4,132,9,0,0,1,0,5,0,368,82,27643,29165,30175,4,28,8,2,0,0,0,9,306,104,24170,28138,29513,1,62,-22,3473,1,1027,662,-2,0,1,0,-4
EUW1_6880893052',8,29,15,0,0,0,0,8,0,324,70,26673,27538,36089,3,18,11,1,0,0,0,2,341,94,26543,28847,30530,0,-17,-24,130,4,-1309,5559,-1,0,0,0,6
EUW1_6880871369',3,26,10,0,0,0,0,10,0,315,86,24643,27053,33612,1,21,18,2,0,0,0,0,403,104,29523,33576,42260,0,-88,-18,-4880,-8,-6523,-8648,-2,0,0,0,10
EUW1_6883183642',2,26,21,0,0,2,0,8,1,347,87,30754,29921,38521,5,23,10,1,0,0,0,3,317,71,25248,24994,38254,0,30,16,5506,11,4927,267,-1,0,2,0,5
EUW1_6883097503',2,26,14,1,1,1,0,6,1,389,98,29025,33100,36704,5,19,7,1,0,0,0,4,342,84,24182,27784,26505,1,47,14,4843,7,5316,10199,0,1,1,0,2
EUW1_6883041920',2,26,9,0,0,1,0,12,0,373,78,26541,28788,29349,4,40,18,1,0,2,0,7,381,114,30997,33264,41755,0,-8,-36,-4456,-9,-4476,-12406,-1,0,-1,0,5
EUW1_6882154886',2,149,22,2,0,1,0,12,0,364,68,32780,32864,40732,7,78,18,0,0,1,0,7,333,70,29166,28401,41474,1,31,-2,3614,4,4463,-742,2,0,0,0,5
EUW1_6882126394',2,25,7,0,0,0,0,16,0,295,66,22854,26289,21416,1,15,26,2,0,3,0,0,425,113,36695,34500,48228,0,-130,-47,-13841,-19,-8211,-26812,-2,0,-3,0,16
EUW1_6881319298',7,30,15,0,0,0,0,8,0,318,100,28743,31875,36804,2,26,12,2,0,2,0,3,360,88,27714,28406,40033,0,-42,12,1029,3,3469,-3229,-2,0,-2,0,5
EUW1_6880691147',5,30,25,1,1,3,0,9,1,343,108,34701,31829,43944,4,25,9,0,0,0,0,8,320,80,25754,27677,30332,1,23,28,8947,16,4152,13612,1,1,3,0,1
EUW1_6881859418',1,28,12,0,0,0,0,13,0,318,94,25884,28806,33599,4,23,18,1,0,1,0,1,333,94,28979,29756,43269,1,-15,0,-3095,-6,-950,-9670,-1,0,-1,0,12
EUW1_6879182219',5,28,14,0,0,1,0,6,0,343,69,27764,31261,39069,1,55,15,2,0,0,0,2,302,71,26880,29565,39336,1,41,-2,884,-1,1696,-267,-2,0,1,0,4
EUW1_6879013822',5,24,7,1,0,0,0,8,0,382,72,23706,27442,25301,6,33,12,1,0,1,0,3,345,99,27730,29917,26593,0,37,-27,-4024,-5,-2475,-1292,0,0,-1,0,5
EUW1_6878959368',5,32,14,2,0,1,0,7,1,325,96,27642,27608,29277,4,28,7,0,0,0,0,5,360,87,24175,28677,25008,1,-35,9,3467,7,-1069,4269,2,0,1,0,2
EUW1_6878791065',3,31,15,1,0,1,0,12,1,384,74,29347,30120,33637,5,30,9,0,0,0,0,4,331,90,25918,30186,23330,1,53,-16,3429,6,-66,10307,1,0,1,0,8
EUW1_6878740536',1,22,14,1,0,1,0,7,0,335,70,27280,27306,35863,4,56,13,0,0,2,0,6,340,87,27737,28700,30836,0,-5,-17,-457,1,-1394,5027,1,0,-1,0,1
EUW1_6875892609',2,26,10,0,0,1,0,9,0,371,113,27479,30760,29564,6,33,14,1,0,1,0,5,371,85,28666,29631,27941,0,0,28,-1187,-4,1129,1623,-1,0,0,0,4
EUW1_6874567343',2,22,11,0,0,0,0,7,1,355,82,26946,28820,26994,3,30,12,1,0,2,0,3,380,89,28781,30695,31643,1,-25,-7,-1835,-1,-1875,-4649,-1,0,-2,0,4
EUW1_6874466668',3,29,20,0,0,1,0,12,0,329,60,30024,29295,44223,2,23,18,2,0,1,0,4,330,88,30798,29531,40732,1,-1,-28,-774,2,-236,3491,-2,0,0,0,8
EUW1_6873002246',3,30,13,2,0,1,0,13,0,363,94,27848,30777,35811,0,21,13,0,0,1,0,3,350,94,27643,30647,34990,0,13,0,205,0,130,821,2,0,0,0,10
EUW1_6872943716',2,22,11,0,0,0,0,8,0,287,75,24590,26571,29052,4,24,15,1,0,1,0,0,345,90,28676,30479,29103,0,-58,-15,-4086,-4,-3908,-51,-1,0,-1,0,8
EUW1_6871879824',2,21,19,2,0,4,0,7,1,376,96,33383,32778,41389,2,19,14,0,0,0,0,11,339,84,27576,30022,42532,1,37,12,5807,5,2756,-1143,2,0,4,0,-4
EUW1_6865378176',5,98,9,2,0,1,0,10,1,334,68,25151,28395,23915,5,147,4,0,0,1,0,3,402,104,24258,29107,21979,0,-68,-36,893,5,-712,1936,2,0,0,0,7
EUW1_6881761703',5,47,22,0,1,3,0,6,1,369,78,33591,30944,46515,6,43,12,2,0,0,0,9,294,78,25823,26369,31938,1,75,0,7768,10,4575,14577,-2,1,3,0,-3
EUW1_6881680775',1,39,16,1,0,1,0,4,1,358,86,30372,30710,32655,7,53,13,0,0,0,0,8,336,66,25980,29594,32667,0,22,20,4392,3,1116,-12,1,0,1,0,-4
EUW1_6875718932',4,29,7,0,1,0,0,8,0,370,96,25799,30454,26270,1,25,5,1,0,0,0,4,404,90,24426,30312,19963,0,-34,6,1373,2,142,6307,-1,1,0,0,4
EUW1_6875658774',4,36,10,0,0,0,0,9,1,384,80,26711,29368,33405,5,31,10,2,0,2,0,4,407,76,28361,30225,27816,1,-23,4,-1650,0,-857,5589,-2,0,-2,0,5
EUW1_6870345118',3,21,14,0,0,2,0,4,0,384,80,29294,31628,37541,5,26,3,2,0,0,0,5,355,68,22057,26431,27540,1,29,12,7237,11,5197,10001,-2,0,2,0,-1
EUW1_6870279846',2,141,12,2,0,0,0,3,1,364,86,27381,30453,34531,3,24,10,0,0,1,0,3,291,72,24451,27083,33912,1,73,14,2930,2,3370,619,2,0,-1,0,0
EUW1_6870195005',4,30,7,0,0,0,0,6,0,345,100,24866,28631,25651,2,27,7,1,0,0,0,2,412,88,25805,29276,28422,0,-67,12,-939,0,-645,-2771,-1,0,0,0,4
EUW1_6850939780',6,209,11,1,0,1,0,6,0,293,84,26084,27296,32884,3,24,9,0,0,0,0,6,363,78,25237,29386,27389,0,-70,6,847,2,-2090,5495,1,0,1,0,0
EUW1_6840407132',2,60,14,1,0,2,0,10,0,346,99,29505,32878,41125,2,42,14,0,0,1,0,4,323,70,26527,30901,33769,1,23,29,2978,0,1977,7356,1,0,1,0,6
EUW1_6840348749',5,34,16,1,0,0,0,12,1,326,82,28098,29728,35121,4,28,19,1,0,1,0,1,322,102,29853,29120,45909,0,4,-20,-1755,-3,608,-10788,0,0,-1,0,11
EUW1_6839789570',1,25,15,0,1,0,0,12,0,333,82,27439,31087,39132,4,24,13,2,0,1,0,0,322,64,26874,26717,39878,1,11,18,565,2,4370,-746,-2,1,-1,0,12
EUW1_6839728041',6,34,8,1,1,0,0,6,0,342,122,26637,29411,39578,4,32,14,1,0,1,0,5,366,90,27491,31543,30534,0,-24,32,-854,-6,-2132,9044,0,1,-1,0,1
EUW1_6839678482',6,29,7,0,0,0,0,11,1,379,81,25434,29849,26274,3,39,11,2,0,1,0,2,361,83,27508,29683,36419,0,18,-2,-2074,-4,166,-10145,-2,0,-1,0,9
EUW1_6883474242',2,483,9,0,0,3,0,2,1,365,71,27516,27891,35577,4,28,8,1,0,0,0,9,314,95,23565,27948,27022,1,51,-24,3951,1,-57,8555,-1,0,3,0,-7
EUW1_6883433592',3,23,16,2,0,0,0,11,0,318,88,28297,30160,37709,1,15,24,0,0,2,0,5,358,80,32390,31475,42357,0,-40,8,-4093,-8,-1315,-4648,2,0,-2,0,6
EUW1_6883303044',3,87,13,0,0,1,0,13,1,354,72,27447,30356,42630,2,27,18,2,0,1,0,4,345,104,29894,34517,41823,0,9,-32,-2447,-5,-4161,807,-2,0,0,0,9
EUW1_6883222032',2,40,8,1,0,1,0,8,1,420,84,27381,30486,28194,6,61,11,0,0,1,0,4,358,112,27076,32190,19077,1,62,-28,305,-3,-1704,9117,1,0,0,0,4
EUW1_6882647599',0,24,10,1,0,0,0,4,0,347,79,25803,28508,30092,7,29,16,0,0,0,0,3,336,66,27639,28709,36718,0,11,13,-1836,-6,-201,-6626,1,0,0,0,1
EUW1_6882604068',3,30,12,1,0,1,0,5,1,338,108,28180,28549,38052,4,50,15,1,0,0,0,5,348,68,27329,29597,37784,1,-10,40,851,-3,-1048,268,0,0,1,0,0
EUW1_6882165719',1,22,16,1,0,2,0,8,1,365,86,30192,30328,41655,2,28,14,1,0,1,0,8,305,76,27335,28573,34066,0,60,10,2857,2,1755,7589,0,0,1,0,0
EUW1_6882134499',2,28,17,1,0,1,0,5,1,356,94,30171,31575,38722,4,30,15,1,0,0,0,7,357,99,29046,31407,35286,0,-1,-5,1125,2,168,3436,0,0,1,0,-2
EUW1_6882073505',0,22,22,1,0,1,0,11,1,326,87,31212,30841,49759,2,27,11,0,0,1,0,6,310,84,26058,27542,39941,1,16,3,5154,11,3299,9818,1,0,0,0,5
EUW1_6881951748',9,31,17,1,0,1,0,11,0,277,82,28614,29845,30186,3,57,14,1,0,0,0,2,342,102,27834,29746,32503,1,-65,-20,780,3,99,-2317,0,0,1,0,9
EUW1_6881881398',7,28,8,0,0,1,0,10,1,325,94,25320,28191,28387,2,26,16,1,1,0,0,4,329,110,29040,30145,31734,0,-4,-16,-3720,-8,-1954,-3347,-1,-1,1,0,6
EUW1_6881825843',2,20,20,2,0,1,0,10,1,330,78,29927,28581,36376,6,28,13,0,0,2,0,7,300,104,28225,27104,27710,1,30,-26,1702,7,1477,8666,2,0,-1,0,3
EUW1_6881751019',1,26,19,1,1,0,0,9,0,326,92,29186,29604,34368,3,33,11,1,0,1,0,6,367,96,28037,29720,27995,1,-41,-4,1149,8,-116,6373,0,1,-1,0,3
EUW1_6881694789',4,219,15,0,0,2,0,5,0,378,90,30759,31920,37634,6,33,13,2,0,1,0,8,359,94,27472,31265,30980,1,19,-4,3287,2,655,6654,-2,0,1,0,-3
EUW1_6881627946',6,27,21,2,0,1,0,11,1,345,78,30840,30446,36525,4,22,13,0,0,2,0,3,358,77,26963,27956,29728,1,-13,1,3877,8,2490,6797,2,0,-1,0,8
EUW1_6881443012',3,23,10,0,0,1,0,8,0,353,90,27494,30051,31728,3,26,20,0,1,0,0,6,332,87,28751,29925,37433,0,21,3,-1257,-10,126,-5705,0,-1,1,0,2
EUW1_6881399030',0,17,7,0,0,0,0,15,0,261,82,23064,25308,20199,9,35,13,2,1,3,0,3,341,114,30357,29019,31453,0,-80,-32,-7293,-6,-3711,-11254,-2,-1,-3,0,12
EUW1_6881338582',1,25,13,1,0,0,0,9,0,347,88,27694,29595,35221,7,35,16,0,1,1,0,6,359,80,29385,29925,38477,0,-12,8,-1691,-3,-330,-3256,1,-1,-1,0,3
EUW1_6882934106',9,35,10,0,0,0,0,12,0,348,88,26316,28722,32070,7,34,22,2,0,2,0,3,360,92,33294,30580,37194,0,-12,-4,-6978,-12,-1858,-5124,-2,0,-2,0,9
EUW1_6882885904',2,34,11,0,0,0,0,13,1,347,61,26800,26956,31358,8,33,12,2,0,2,0,3,369,98,28329,29856,31138,1,-22,-37,-1529,-1,-2900,220,-2,0,-2,0,10
EUW1_6882693410',3,26,8,1,0,0,0,13,0,399,111,26033,30712,23597,9,37,8,1,0,1,0,2,380,84,26689,29253,20107,1,19,27,-656,0,1459,3490,0,0,-1,0,11
EUW1_6882653954',6,29,11,1,0,0,0,12,0,367,94,28203,30761,31390,5,71,15,1,0,1,0,4,372,66,26866,31004,29580,1,-5,28,1337,-4,-243,1810,0,0,-1,0,8
EUW1_6882468350',6,29,7,0,0,1,0,7,0,398,70,24757,28640,26037,4,24,9,2,0,1,0,0,413,94,27342,30173,27740,0,-15,-24,-2585,-2,-1533,-1703,-2,0,0,0,7
EUW1_6881334634',2,23,11,2,0,1,0,6,0,366,85,27373,29924,31488,4,28,8,0,0,0,0,6,359,86,25407,28939,28085,0,7,-1,1966,3,985,3403,2,0,1,0,0
EUW1_6881259913',7,43,14,1,0,1,0,9,1,400,84,30796,30520,34092,5,35,12,1,0,1,0,6,349,88,27289,28085,26740,0,51,-4,3507,2,2435,7352,0,0,0,0,3
EUW1_6881201026',7,21,10,1,0,1,0,11,1,293,78,26120,26132,28084,2,93,16,1,0,2,0,4,316,85,28961,28423,34794,0,-23,-7,-2841,-6,-2291,-6710,0,0,-1,0,7
EUW1_6880244084',5,22,7,0,0,0,0,6,0,389,88,25972,28912,20587,2,21,12,1,0,1,0,1,365,84,27986,31236,30077,0,24,4,-2014,-5,-2324,-9490,-1,0,-1,0,5
EUW1_6880187770',5,31,8,1,0,1,0,3,1,393,120,26822,31690,25061,5,28,6,0,0,0,0,3,363,67,22468,28629,24337,1,30,53,4354,2,3061,724,1,0,1,0,0
EUW1_6879806182',2,24,10,1,1,1,0,16,0,308,98,24775,29736,21701,4,29,17,1,0,3,0,3,361,110,30902,31505,40380,0,-53,-12,-6127,-7,-1769,-18679,0,1,-2,0,13
EUW1_6878376893',1,21,9,0,0,0,0,10,1,329,86,24692,27256,24072,5,28,9,2,1,2,0,2,354,108,27595,31924,28697,0,-25,-22,-2903,0,-4668,-4625,-2,-1,-2,0,8
EUW1_6878338482',1,130,5,2,0,0,0,3,1,343,84,23174,28985,21875,5,27,6,0,0,1,0,1,390,98,24954,30725,22244,0,-47,-14,-1780,-1,-1740,-369,2,0,-1,0,2
EUW1_6881271560',1,24,12,0,0,0,0,12,0,323,72,25057,27587,22401,2,28,15,1,1,2,0,3,331,96,29948,30111,31942,0,-8,-24,-4891,-3,-2524,-9541,-1,-1,-2,0,9
EUW1_6881203900',4,292,7,2,0,1,0,6,0,413,88,27754,30509,31107,4,28,6,0,0,1,0,6,368,82,23626,28311,22735,0,45,6,4128,1,2198,8372,2,0,0,0,0
EUW1_6881157059',1,26,8,0,0,0,0,4,0,363,116,26913,30492,27055,3,28,9,2,0,1,0,5,362,68,24400,27432,25888,1,1,48,2513,-1,3060,1167,-2,0,-1,0,-1
EUW1_6881107039',3,29,9,2,0,0,0,7,1,360,88,24690,29610,28822,2,25,7,0,0,1,0,2,370,76,25574,31894,28279,1,-10,12,-884,2,-2284,543,2,0,-1,0,5
EUW1_6879009409',5,31,15,1,1,0,0,6,1,328,88,27763,31424,29473,3,46,16,1,0,1,0,3,354,96,29640,30125,33336,0,-26,-8,-1877,-1,1299,-3863,0,1,-1,0,3
EUW1_6878954715',8,28,10,1,1,0,0,7,1,364,128,26554,30112,25755,2,35,6,1,0,0,0,2,344,87,24443,28017,21396,0,20,41,2111,4,2095,4359,0,1,0,0,5
EUW1_6878823398',3,136,1,0,0,0,0,10,0,328,87,21192,25756,15701,1,134,14,2,0,0,0,2,410,96,28353,32374,31235,0,-82,-9,-7161,-13,-6618,-15534,-2,0,0,0,8
EUW1_6878500428',7,19,10,1,0,0,0,9,0,341,84,25337,29380,30386,4,24,14,1,0,1,0,4,331,72,27770,30655,32223,0,10,12,-2433,-4,-1275,-1837,0,0,-1,0,5
EUW1_6878469970',4,23,15,1,0,0,0,3,0,353,88,27539,28890,29808,8,31,10,0,1,0,0,3,342,99,26777,30675,25227,1,11,-11,762,5,-1785,4581,1,-1,0,0,0
EUW1_6865278919',4,27,13,0,0,3,0,5,0,366,89,29751,31654,37569,8,45,15,2,0,0,0,5,324,87,27873,29126,29819,1,42,2,1878,-2,2528,7750,-2,0,3,0,0
EUW1_6812699085',3,24,15,1,0,0,0,5,0,339,103,28325,30913,31335,4,27,13,1,0,0,0,3,343,88,27620,29131,38451,1,-4,15,705,2,1782,-7116,0,0,0,0,2
EUW1_6812628751',0,19,8,0,1,0,0,9,1,303,96,25392,29447,24994,6,34,11,2,0,0,0,1,383,90,26856,29325,27388,0,-80,6,-1464,-3,122,-2394,-2,1,0,0,8
EUW1_6812583826',0,21,9,0,0,0,0,13,0,330,98,24942,29342,34679,3,78,20,2,1,2,0,1,379,122,32399,33971,37356,0,-49,-24,-7457,-11,-4629,-2677,-2,-1,-2,0,12
EUW1_6801613354',4,44,8,1,0,0,0,8,0,317,100,24775,27731,23792,3,22,15,1,0,1,0,1,331,99,27392,31318,35017,0,-14,1,-2617,-7,-3587,-11225,0,0,-1,0,7
EUW1_6798972705',10,74,14,1,0,0,0,9,1,313,113,27525,29461,30517,5,24,12,1,0,2,0,0,361,74,27303,29483,31164,0,-48,39,222,2,-22,-647,0,0,-2,0,9
EUW1_6883273828',3,26,18,1,0,3,0,11,0,365,118,32103,32366,33358,2,19,3,1,0,1,0,9,327,73,22091,24200,21050,1,38,45,10012,15,8166,12308,0,0,2,0,2
EUW1_6883195131',3,23,14,2,1,0,0,6,1,333,93,27108,28694,35266,3,48,11,0,0,1,0,4,375,90,27312,29554,31665,0,-42,3,-204,3,-860,3601,2,1,-1,0,2
EUW1_6882516108',5,32,9,0,0,0,0,10,1,332,70,25348,27231,32460,1,41,14,1,0,2,0,4,363,90,29436,30334,36445,0,-31,-20,-4088,-5,-3103,-3985,-1,0,-2,0,6
EUW1_6882486842',4,30,16,1,0,1,0,15,1,352,86,29430,30406,32840,3,26,14,0,0,2,0,2,330,81,29573,28907,34417,1,22,5,-143,2,1499,-1577,1,0,-1,0,13
EUW1_6882460934',4,27,12,1,0,1,0,9,0,350,78,27909,29358,26749,3,34,10,1,1,1,0,8,304,88,25797,28787,29435,1,46,-10,2112,2,571,-2686,0,-1,0,0,1
EUW1_6881942909',1,61,13,1,0,1,0,9,0,292,82,26502,28066,36576,4,64,18,1,0,1,0,2,329,77,28519,30358,39826,0,-37,5,-2017,-5,-2292,-3250,0,0,0,0,7
EUW1_6881790441',3,36,12,0,0,1,0,9,1,351,92,27584,30612,26286,3,32,7,1,0,0,0,3,353,86,24938,29788,25374,1,-2,6,2646,5,824,912,-1,0,1,0,6
EUW1_6880975112',6,22,11,1,0,1,0,11,0,298,87,25857,28275,30345,5,25,14,1,0,1,0,3,321,96,27909,29021,31655,0,-23,-9,-2052,-3,-746,-1310,0,0,0,0,8
EUW1_6880962719',2,25,20,2,0,3,0,7,1,371,96,33431,31994,41983,3,30,6,0,0,2,0,11,330,72,23657,27004,23147,1,41,24,9774,14,4990,18836,2,0,1,0,-4
EUW1_6880927696',3,27,8,1,0,0,0,7,1,420,89,25789,31112,22736,1,37,1,1,0,0,0,1,414,96,22484,28936,20633,0,6,-7,3305,7,2176,2103,0,0,0,0,6
EUW1_6878813222',5,26,17,1,0,1,0,10,1,323,82,29020,29412,38996,3,24,19,1,0,1,0,3,331,90,30545,31087,34139,1,-8,-8,-1525,-2,-1675,4857,0,0,0,0,7
EUW1_6877045487',4,26,12,1,0,0,0,6,1,359,101,26900,32487,33665,1,39,10,0,0,0,0,2,348,86,25141,29584,27535,0,11,15,1759,2,2903,6130,1,0,0,0,4
EUW1_6876991808',3,208,12,1,0,1,0,8,1,272,82,25859,26737,27980,3,25,13,1,0,0,0,2,339,86,27138,30292,31535,0,-67,-4,-1279,-1,-3555,-3555,0,0,1,0,6
EUW1_6876957491',7,37,10,1,0,0,0,4,0,368,124,25996,30745,29051,5,26,6,1,0,0,0,2,393,60,24668,28810,21792,1,-25,64,1328,4,1935,7259,0,0,0,0,2
EUW1_6876558730',3,24,19,2,1,2,0,6,1,382,92,31114,32811,40134,4,22,6,0,0,0,0,8,331,88,23028,28040,26012,1,51,4,8086,13,4771,14122,2,1,2,0,-2
EUW1_6876530711',10,40,10,0,0,0,0,13,1,336,84,26430,28628,27318,7,24,14,2,0,1,0,3,331,102,28596,29014,35387,0,5,-18,-2166,-4,-386,-8069,-2,0,-1,0,10
EUW1_6875662720',0,24,8,2,0,0,0,9,0,281,88,23132,27736,29776,4,27,18,0,0,1,0,0,372,84,30005,32033,34622,0,-91,4,-6873,-10,-4297,-4846,2,0,-1,0,9
EUW1_6875603034',5,30,5,2,0,0,0,6,1,346,68,22660,28434,23750,3,24,5,0,0,0,0,3,320,80,22395,27351,24079,1,26,-12,265,0,1083,-329,2,0,0,0,3
EUW1_6883782284',1,27,15,0,0,1,0,6,0,357,98,29064,30689,32745,2,23,8,1,0,0,0,3,330,74,24010,26590,25331,1,27,24,5054,7,4099,7414,-1,0,1,0,3
EUW1_6883752294',4,26,14,2,0,0,0,9,1,372,106,29145,30858,26868,2,24,8,0,0,2,0,6,349,72,26158,29001,24331,0,23,34,2987,6,1857,2537,2,0,-2,0,3
EUW1_6883747902',3,73,7,0,1,0,0,10,0,345,72,24005,27308,24412,5,46,16,1,0,1,0,1,330,82,28592,30725,38501,0,15,-10,-4587,-9,-3417,-14089,-1,1,-1,0,9
EUW1_6883724808',1,18,18,1,0,2,0,7,1,372,60,30309,29239,37158,3,23,12,1,0,1,0,5,302,103,26380,26951,27067,1,70,-43,3929,6,2288,10091,0,0,1,0,2
EUW1_6883718659',4,15,16,2,0,0,0,10,1,355,78,28024,31927,32751,3,25,9,0,0,1,0,4,349,82,26761,29698,31799,1,6,-4,1263,7,2229,952,2,0,-1,0,6
EUW1_6883661432',5,27,20,1,0,1,0,12,0,351,76,31346,31463,39434,3,39,13,1,0,1,0,3,313,100,27913,28389,32949,0,38,-24,3433,7,3074,6485,0,0,0,0,9
EUW1_6883657896',2,24,5,1,0,1,0,11,1,362,64,23689,27276,20569,4,42,14,1,1,2,0,4,395,100,29799,32717,29478,0,-33,-36,-6110,-9,-5441,-8909,0,-1,-1,0,7
EUW1_6883646578',8,33,13,1,1,1,0,9,0,328,98,28124,29641,27585,0,221,15,1,0,2,0,6,367,105,29743,32006,29011,1,-39,-7,-1619,-2,-2365,-1426,0,1,-1,0,3
EUW1_6883623744',4,31,18,0,1,1,0,12,0,375,86,30236,31547,33290,0,22,10,1,0,1,0,4,337,76,27532,27538,29564,1,38,10,2704,8,4009,3726,-1,1,0,0,8
EUW1_6883598137',3,28,21,1,0,1,0,4,1,354,84,31037,29435,41667,1,28,13,0,0,0,0,6,310,66,27964,27339,38401,1,44,18,3073,8,2096,3266,1,0,1,0,-2
EUW1_6883567954',4,63,22,0,0,5,0,15,1,415,112,35893,35016,40629,1,30,10,1,0,0,0,8,321,91,26770,27680,31512,1,94,21,9123,12,7336,9117,-1,0,5,0,7
EUW1_6883529808',4,308,15,0,0,3,0,5,1,385,92,30931,33053,34615,5,27,15,2,0,0,0,8,335,84,27486,30162,39105,1,50,8,3445,0,2891,-4490,-2,0,3,0,-3
EUW1_6883488125',5,34,18,0,0,2,0,6,1,397,100,32898,32241,41334,1,92,16,2,0,1,0,10,268,107,27507,29728,31459,1,129,-7,5391,2,2513,9875,-2,0,1,0,-4
EUW1_6883450082',1,143,17,2,0,2,0,5,1,371,106,31127,32340,33627,4,26,8,0,0,0,0,10,349,70,24707,29174,24464,1,22,36,6420,9,3166,9163,2,0,2,0,-5
EUW1_6883406747',4,27,2,0,0,0,0,12,1,355,80,22007,26289,20915,4,36,13,1,0,1,0,1,332,95,28061,29943,25866,0,23,-15,-6054,-11,-3654,-4951,-1,0,-1,0,11
EUW1_6883121004',3,22,13,2,0,0,0,14,0,313,79,26412,29124,26768,1,24,20,0,0,2,0,2,337,94,31683,29891,35315,1,-24,-15,-5271,-7,-767,-8547,2,0,-2,0,12
EUW1_6883075755',4,31,9,1,0,0,0,10,1,340,92,26559,28863,27933,5,32,6,1,0,4,0,4,367,76,24681,28387,19186,1,-27,16,1878,3,476,8747,0,0,-4,0,6
EUW1_6883033593',7,74,11,0,0,2,0,9,1,400,76,28371,28328,29229,3,27,15,2,1,0,0,3,333,99,28167,30784,30798,0,67,-23,204,-4,-2456,-1569,-2,-1,2,0,6
EUW1_6883122435',1,21,12,0,0,1,0,15,1,347,99,29475,29886,32444,3,37,24,1,0,2,0,4,382,84,33192,31274,40481,0,-35,15,-3717,-12,-1388,-8037,-1,0,-1,0,11
EUW1_6882569742',7,32,13,0,0,1,0,15,1,358,74,28067,30200,32806,7,45,11,1,0,2,0,2,376,65,27247,28413,33836,0,-18,9,820,2,1787,-1030,-1,0,-1,0,13
EUW1_6882533637',4,26,14,0,0,0,0,13,1,346,81,29740,28965,33549,4,26,17,2,0,4,0,6,346,103,31552,30671,39009,1,0,-22,-1812,-3,-1706,-5460,-2,0,-4,0,7
EUW1_6881907318',5,75,24,1,0,2,0,11,1,317,67,33047,29758,36716,4,28,15,1,0,2,0,7,286,80,26795,26916,35081,1,31,-13,6252,9,2842,1635,0,0,0,0,4
EUW1_6881838392',3,40,14,2,0,0,0,6,1,328,73,26780,29521,35485,3,28,8,0,0,0,0,2,349,97,24477,29205,25346,1,-21,-24,2303,6,316,10139,2,0,0,0,4
EUW1_6879578662',3,24,16,2,0,0,0,8,1,418,102,30367,34041,35093,5,35,9,0,0,1,0,5,353,98,25377,30641,23491,1,65,4,4990,7,3400,11602,2,0,-1,0,3
EUW1_6879543489',7,31,8,1,0,0,0,5,1,393,94,26851,29590,33813,5,33,8,1,0,0,0,4,347,97,24672,29481,27116,1,46,-3,2179,0,109,6697,0,0,0,0,1
EUW1_6879503031',2,22,18,0,0,1,0,11,1,353,80,30655,31098,34332,5,30,11,1,1,0,0,6,328,92,26341,29604,33370,1,25,-12,4314,7,1494,962,-1,-1,1,0,5
EUW1_6878992333',5,25,9,0,0,1,0,6,0,359,120,27879,31238,33041,5,65,15,1,0,0,0,4,362,84,28741,30326,32010,1,-3,36,-862,-6,912,1031,-1,0,1,0,2
EUW1_6878538483',4,28,17,2,0,0,0,9,1,354,100,28150,31398,36843,2,26,9,0,0,0,0,1,348,79,25003,28120,33300,1,6,21,3147,8,3278,3543,2,0,0,0,8
EUW1_6883321372',2,15,14,0,0,0,0,6,0,320,68,26475,28475,37728,4,409,12,0,0,0,0,1,352,62,26268,29160,34479,0,-32,6,207,2,-685,3249,0,0,0,0,5
EUW1_6880364578',1,27,12,2,0,0,0,5,0,342,89,27925,30504,36067,5,183,9,0,0,1,0,5,337,66,24306,28833,24331,1,5,23,3619,3,1671,11736,2,0,-1,0,0
EUW1_6880265563',7,32,9,1,0,0,0,9,1,338,96,24998,28180,28944,6,28,9,1,0,0,0,1,378,84,25036,29050,23321,1,-40,12,-38,0,-870,5623,0,0,0,0,8
EUW1_6880139297',1,36,5,0,0,0,0,8,1,316,71,22911,26286,29336,5,25,15,1,0,0,0,0,376,106,28905,31388,37528,0,-60,-35,-5994,-10,-5102,-8192,-1,0,0,0,8
EUW1_6879775546',1,17,10,0,1,1,0,13,0,334,100,27268,29912,27971,4,43,10,2,0,2,0,4,378,76,26947,29215,26840,0,-44,24,321,0,697,1131,-2,1,-1,0,9
EUW1_6879718468',1,36,8,1,0,0,0,8,0,339,98,24457,30144,27739,4,21,10,1,0,1,0,0,326,78,25533,27500,25092,0,13,20,-1076,-2,2644,2647,0,0,-1,0,8
EUW1_6879673532',5,19,8,1,1,1,0,7,1,318,120,25316,29107,17814,3,21,9,1,0,1,0,3,289,76,24201,26394,24592,0,29,44,1115,-1,2713,-6778,0,1,0,0,4
EUW1_6879542742',1,26,11,1,0,0,0,8,1,352,88,26489,29977,32691,8,25,9,0,0,1,0,5,359,93,26554,29823,27012,0,-7,-5,-65,2,154,5679,1,0,-1,0,3
EUW1_6879494353',8,43,14,0,0,0,0,6,1,340,74,27841,28584,36230,8,26,17,1,0,0,0,6,326,87,29142,28406,34836,0,14,-13,-1301,-3,178,1394,-1,0,0,0,0
EUW1_6878882431',5,30,12,1,0,1,0,5,1,343,103,27394,30887,27469,1,24,7,0,0,0,0,3,320,120,23852,28465,25843,0,23,-17,3542,5,2422,1626,1,0,1,0,2
EUW1_6878227986',4,22,16,1,0,1,0,4,1,373,108,30782,30959,35428,5,29,7,1,0,1,0,5,326,91,24292,27312,22826,1,47,17,6490,9,3647,12602,0,0,0,0,-1
EUW1_6878175633',6,135,15,1,0,0,0,7,0,344,69,28349,31096,34710,1,25,16,1,0,0,0,4,335,116,28868,31931,35523,0,9,-47,-519,-1,-835,-813,0,0,0,0,3
EUW1_6878128942',3,23,13,0,0,0,0,12,0,315,78,26602,27291,35757,3,16,19,1,0,1,0,2,287,94,29974,29004,34811,0,28,-16,-3372,-6,-1713,946,-1,0,-1,0,10
EUW1_6877539266',8,26,19,2,0,1,0,8,1,363,82,29888,31532,28075,3,25,4,0,0,1,0,6,274,106,23048,26170,27687,1,89,-24,6840,15,5362,388,2,0,0,0,2
EUW1_6877294485',8,34,13,1,0,2,0,11,1,359,66,29774,28238,30622,3,25,17,1,0,2,0,9,323,105,30350,30716,31634,0,36,-39,-576,-4,-2478,-1012,0,0,0,0,2
EUW1_6876927774',0,27,17,2,0,1,0,9,1,370,90,29929,30223,32244,5,27,11,0,0,0,0,2,334,74,26032,26730,30425,1,36,16,3897,6,3493,1819,2,0,1,0,7
EUW1_6883628142',5,26,11,1,0,3,0,3,1,380,87,29058,30270,27806,2,22,5,1,1,0,0,12,337,96,22650,28669,16898,1,43,-9,6408,6,1601,10908,0,-1,3,0,-9
EUW1_6883615539',5,197,6,1,0,0,0,3,1,358,68,23554,27011,28774,5,102,5,1,0,0,0,5,367,99,23570,29965,21311,0,-9,-31,-16,1,-2954,7463,0,0,0,0,-2
EUW1_6883591478',3,39,8,0,0,0,0,10,0,295,78,24130,25689,31502,7,26,22,2,0,0,0,3,337,100,27967,29703,33977,1,-42,-22,-3837,-14,-4014,-2475,-2,0,0,0,7
EUW1_6882256965',4,23,12,2,0,0,0,13,1,378,82,26653,29733,27609,6,24,8,0,0,0,0,2,390,77,26529,30816,28891,0,-12,5,124,4,-1083,-1282,2,0,0,0,11
EUW1_6882227212',5,28,12,0,0,1,0,8,1,366,98,28668,29651,31791,7,27,16,1,0,1,0,5,400,95,30318,32319,35403,0,-34,3,-1650,-4,-2668,-3612,-1,0,0,0,3
EUW1_6882158485',4,48,11,2,0,1,0,4,1,379,84,27553,30419,27332,0,24,4,0,0,0,0,4,349,92,22403,28322,18867,0,30,-8,5150,7,2097,8465,2,0,1,0,0
EUW1_6882072634',3,33,16,1,1,3,0,13,1,361,70,31849,28805,34852,1,36,13,1,0,1,0,8,280,102,26295,27392,27325,0,81,-32,5554,3,1413,7527,0,1,2,0,5
EUW1_6881993793',2,27,22,0,0,4,0,9,1,351,88,33938,31328,34148,5,28,10,0,0,0,0,8,362,92,26847,29747,29934,0,-11,-4,7091,12,1581,4214,0,0,4,0,1
EUW1_6881922316',7,46,8,0,0,0,0,8,1,295,78,23910,26410,26365,3,142,15,2,1,0,0,0,371,88,27913,30482,39092,0,-76,-10,-4003,-7,-4072,-12727,-2,-1,0,0,8
EUW1_6881849829',6,32,8,0,1,0,0,8,0,357,82,24942,30276,25506,3,19,9,2,0,0,0,3,366,105,25166,29055,20137,0,-9,-23,-224,-1,1221,5369,-2,1,0,0,5
EUW1_6881764551',1,22,7,1,0,1,0,6,1,353,100,24858,31577,22715,2,26,8,0,0,0,0,2,356,92,24962,30190,25889,0,-3,8,-104,-1,1387,-3174,1,0,1,0,4
EUW1_6881644216',2,30,13,0,0,2,0,9,1,346,90,28814,28048,26334,5,37,15,1,0,1,0,8,388,103,30665,32914,35882,1,-42,-13,-1851,-2,-4866,-9548,-1,0,1,0,1
EUW1_6881591839',4,39,13,0,0,2,0,4,1,392,84,28799,31233,36060,3,25,9,1,0,0,0,6,304,80,24051,27390,20032,1,88,4,4748,4,3843,16028,-1,0,2,0,-2
EUW1_6881513444',4,25,12,0,0,1,0,9,1,374,77,28593,31348,32067,2,23,9,2,0,1,0,6,362,93,26344,28157,31613,0,12,-16,2249,3,3191,454,-2,0,0,0,3
EUW1_6881401132',5,32,17,0,0,0,0,6,1,330,79,28603,29823,34348,3,37,17,1,0,0,0,6,369,92,29400,31001,35016,1,-39,-13,-797,0,-1178,-668,-1,0,0,0,0
EUW1_6881282476',5,25,14,0,0,0,0,6,0,382,111,29118,33669,32748,2,28,11,1,0,0,0,5,386,93,27585,30763,34298,1,-4,18,1533,3,2906,-1550,-1,0,0,0,1
EUW1_6881225284',5,31,14,2,0,3,0,4,1,410,103,32899,30826,37469,1,21,11,0,0,0,0,10,338,88,26189,28017,25063,1,72,15,6710,3,2809,12406,2,0,3,0,-6
EUW1_6880716862',1,46,15,0,0,0,0,6,1,361,67,27370,30103,31863,2,37,15,1,0,0,0,1,337,80,27263,29001,38154,1,24,-13,107,0,1102,-6291,-1,0,0,0,5
EUW1_6880690207',3,28,26,2,0,2,0,9,1,361,103,34823,32104,43752,3,27,11,0,0,1,0,10,324,76,27203,26421,33096,1,37,27,7620,15,5683,10656,2,0,1,0,-1
EUW1_6881806473',3,22,12,0,0,0,0,13,0,363,56,26875,28725,31255,2,26,13,1,0,1,0,2,327,87,28749,31996,31740,0,36,-31,-1874,-1,-3271,-485,-1,0,-1,0,11
EUW1_6881745909',2,20,11,1,1,1,0,10,0,402,90,29590,31824,48004,3,23,10,1,0,2,0,5,358,74,26320,27952,22908,1,44,16,3270,1,3872,25096,0,1,-1,0,5
EUW1_6881684725',1,24,11,0,0,0,0,19,1,318,76,26310,28620,28559,1,91,18,2,0,3,0,2,356,106,31747,31504,36166,0,-38,-30,-5437,-7,-2884,-7607,-2,0,-3,0,17
EUW1_6881647798',4,29,24,1,0,7,0,7,1,386,94,37649,33207,42247,3,37,4,0,0,0,0,11,273,70,20701,22518,26704,1,113,24,16948,20,10689,15543,1,0,7,0,-4
EUW1_6880316160',3,28,6,0,0,0,0,11,0,324,94,24393,26954,28160,12,58,18,2,0,1,0,2,346,82,29605,29508,38779,1,-22,12,-5212,-12,-2554,-10619,-2,0,-1,0,9
EUW1_6880004572',2,26,10,0,0,0,0,8,0,356,98,26656,30685,28429,4,25,16,1,1,1,0,2,413,66,30708,31412,38466,0,-57,32,-4052,-6,-727,-10037,-1,-1,-1,0,6
EUW1_6879943854',4,33,4,0,0,0,0,5,0,424,87,25128,30430,25323,3,207,9,2,0,1,0,2,401,92,26593,30221,24766,0,23,-5,-1465,-5,209,557,-2,0,-1,0,3
EUW1_6879887851',1,25,11,2,0,1,0,10,1,360,76,27596,27992,36267,4,50,13,0,1,0,0,4,326,66,26362,26418,32333,1,34,10,1234,-2,1574,3934,2,-1,1,0,6
EUW1_6879579062',3,34,7,1,0,0,0,8,0,380,62,24843,29417,23765,3,21,11,1,0,0,0,4,354,110,26776,30003,28804,0,26,-48,-1933,-4,-586,-5039,0,0,0,0,4
EUW1_6879544963',7,29,21,2,0,2,0,8,0,344,96,31925,29997,43304,2,20,12,0,0,0,0,6,299,68,26266,26670,33738,1,45,28,5659,9,3327,9566,2,0,2,0,2
EUW1_6878994003',4,23,18,0,0,1,0,11,1,328,98,30322,30574,44296,5,30,17,2,0,1,0,5,344,108,30797,30565,38624,0,-16,-10,-475,1,9,5672,-2,0,0,0,6
EUW1_6878941774',7,289,21,2,0,0,0,7,1,359,94,30965,34401,47538,1,23,8,0,0,1,0,2,337,78,25176,29777,28263,1,22,16,5789,13,4624,19275,2,0,-1,0,5
EUW1_6878882228',3,22,15,2,0,1,0,7,1,360,99,28954,32052,34589,1,26,4,0,0,0,0,2,313,84,22040,26073,29266,1,47,15,6914,11,5979,5323,2,0,1,0,5
EUW1_6878777190',1,73,6,0,0,0,0,13,1,312,84,23385,28098,26244,4,133,16,1,1,4,0,2,353,86,30716,30068,32271,0,-41,-2,-7331,-10,-1970,-6027,-1,-1,-4,0,11
EUW1_6878716776',4,36,6,0,0,0,0,11,1,351,71,23550,26844,22567,6,158,7,2,0,2,0,3,378,108,26655,30388,29402,0,-27,-37,-3105,-1,-3544,-6835,-2,0,-2,0,8
EUW1_6878672545',5,28,9,0,0,0,0,13,0,324,86,25573,28510,27581,2,131,12,2,0,1,0,2,332,100,27322,29931,35503,0,-8,-14,-1749,-3,-1421,-7922,-2,0,-1,0,11
EUW1_6878407764',2,25,14,0,0,1,0,11,0,346,92,28935,29437,42795,0,17,15,2,0,0,0,5,346,111,29552,31970,35824,1,0,-19,-617,-1,-2533,6971,-2,0,1,0,6
EUW1_6883777090',2,27,10,2,0,0,0,7,0,323,80,25646,28509,29711,5,27,15,0,0,1,0,3,353,88,28745,30299,36773,0,-30,-8,-3099,-5,-1790,-7062,2,0,-1,0,4
EUW1_6881804552',3,26,8,0,1,0,0,14,0,337,74,23759,29051,27124,3,28,12,1,0,2,0,1,356,85,28604,31013,35187,0,-19,-11,-4845,-4,-1962,-8063,-1,1,-2,0,13
EUW1_6881752854',3,42,20,2,0,2,0,5,1,375,96,32252,32595,37111,2,25,6,0,0,1,0,8,329,60,22808,26527,20708,1,46,36,9444,14,6068,16403,2,0,1,0,-3
EUW1_6881521239',4,29,11,0,0,0,0,8,1,339,96,26326,30081,23738,2,27,9,2,1,1,0,2,342,101,25689,29026,24253,0,-3,-5,637,2,1055,-515,-2,-1,-1,0,6
EUW1_6881464154',1,31,9,0,0,0,0,8,0,306,64,24158,26628,31894,3,349,18,1,0,1,0,0,331,71,28434,28346,34056,0,-25,-7,-4276,-9,-1718,-2162,-1,0,-1,0,8
EUW1_6881224833',2,24,8,1,0,0,0,11,0,302,70,23864,28440,25937,6,27,20,0,0,0,0,0,373,97,30397,30817,32189,0,-71,-27,-6533,-12,-2377,-6252,1,0,0,0,11
EUW1_6881175531',3,75,12,1,0,1,0,9,1,374,90,27415,31184,34570,5,30,9,0,0,0,0,5,347,78,25181,27809,32333,1,27,12,2234,3,3375,2237,1,0,1,0,4
EUW1_6881135005',2,30,14,2,0,2,0,8,1,405,92,29631,31748,33106,3,24,6,0,0,0,0,4,345,92,23794,28138,23932,1,60,0,5837,8,3610,9174,2,0,2,0,4
EUW1_6881103302',2,23,14,0,0,0,0,11,0,373,86,29018,30024,30052,5,44,20,2,0,1,0,4,322,81,29908,29150,32794,0,51,5,-890,-6,874,-2742,-2,0,-1,0,7
EUW1_6880981287',3,45,18,0,0,0,0,7,1,365,82,30520,30012,34601,4,32,10,1,1,0,0,5,328,86,26227,27101,27867,1,37,-4,4293,8,2911,6734,-1,-1,0,0,2
EUW1_6879711916',4,35,9,1,0,0,0,9,1,382,66,25149,28369,24282,5,30,10,1,0,1,0,2,412,98,28162,31792,29506,0,-30,-32,-3013,-1,-3423,-5224,0,0,-1,0,7
EUW1_6879667616',2,45,16,2,0,0,0,2,1,327,98,28595,29411,32090,1,24,13,0,0,0,0,2,326,84,26316,27798,29420,0,1,14,2279,3,1613,2670,2,0,0,0,0
EUW1_6879124167',3,41,12,0,0,0,0,5,0,315,95,26706,27474,30268,7,31,18,1,0,0,0,0,346,83,28989,29943,35113,1,-31,12,-2283,-6,-2469,-4845,-1,0,0,0,5
EUW1_6879077091',5,32,13,1,0,1,0,7,1,338,78,27836,27490,34960,5,352,14,1,0,0,0,2,306,88,27399,27821,28435,1,32,-10,437,-1,-331,6525,0,0,1,0,5
EUW1_6878877951',2,22,13,0,0,0,0,12,1,271,85,26118,26967,35224,3,91,15,2,1,2,0,1,335,74,28374,29630,35552,1,-64,11,-2256,-2,-2663,-328,-2,-1,-2,0,11
EUW1_6878663276',3,26,12,1,0,0,0,6,0,290,81,25590,27305,34080,3,24,10,1,0,0,0,3,304,103,25757,27745,32631,0,-14,-22,-167,2,-440,1449,0,0,0,0,3
EUW1_6878525112',3,38,17,0,0,1,0,6,1,330,92,28811,30018,31805,6,28,7,1,1,0,0,4,334,97,23804,28672,23619,1,-4,-5,5007,10,1346,8186,-1,-1,1,0,2
EUW1_6877341939',0,30,11,0,1,0,0,9,1,339,112,28230,29473,26969,3,36,15,1,0,1,0,6,341,108,27038,30732,33576,0,-2,4,1192,-4,-1259,-6607,-1,1,-1,0,3
EUW1_6876140297',4,28,7,0,0,0,0,11,1,325,79,24707,27800,27471,7,28,18,1,0,2,0,3,366,76,29359,31344,41989,0,-41,3,-4652,-11,-3544,-14518,-1,0,-2,0,8
EUW1_6871843649',3,21,10,2,0,0,0,17,0,335,82,25302,29283,29260,4,27,17,0,0,3,0,6,355,86,30748,29965,36495,0,-20,-4,-5446,-7,-682,-7235,2,0,-3,0,11
EUW1_6870477531',1,22,8,1,0,1,0,8,1,370,84,26225,29589,27608,3,27,8,1,0,0,0,3,373,120,26170,30391,27851,1,-3,-36,55,0,-802,-243,0,0,1,0,5
EUW1_6869909866',6,27,11,0,0,0,0,5,1,342,102,25993,30752,30274,4,25,6,1,0,1,0,2,350,90,24908,27930,25297,0,-8,12,1085,5,2822,4977,-1,0,-1,0,3
EUW1_6869834160',1,24,6,2,0,2,0,9,0,349,84,25907,28821,24076,3,20,14,0,0,1,0,2,382,102,28807,31371,31806,0,-33,-18,-2900,-8,-2550,-7730,2,0,1,0,7
EUW1_6869775152',4,25,14,1,0,0,0,6,0,340,92,26090,30236,35750,2,17,8,0,0,0,0,1,328,96,25743,30402,25065,1,12,-4,347,6,-166,10685,1,0,0,0,5
EUW1_6868940052',4,28,24,1,0,2,0,8,1,328,77,32420,30566,38293,1,22,15,0,0,0,0,7,301,70,26760,28328,30885,1,27,7,5660,9,2238,7408,1,0,2,0,1
EUW1_6868769539',1,50,14,1,1,0,0,9,1,334,56,26519,27457,33811,3,23,16,1,0,0,0,3,290,90,27199,29335,37870,0,44,-34,-680,-2,-1878,-4059,0,1,0,0,6
EUW1_6868480148',5,23,17,2,0,0,0,8,1,341,80,27598,29623,34521,4,132,8,0,0,0,0,1,339,82,24751,27563,29030,1,2,-2,2847,9,2060,5491,2,0,0,0,7
EUW1_6868440685',3,51,8,1,1,1,0,10,0,320,84,24788,28948,28534,0,52,17,1,0,1,0,5,325,77,29413,30392,38705,0,-5,7,-4625,-9,-1444,-10171,0,1,0,0,5
EUW1_6856233391',3,30,8,2,0,0,0,11,0,360,114,26522,30951,34290,1,96,10,0,1,2,0,3,360,82,26997,29559,25640,1,0,32,-475,-2,1392,8650,2,-1,-2,0,8
EUW1_6855986912',6,32,11,2,0,1,0,7,0,386,100,28931,30555,29631,3,37,11,0,0,0,0,6,345,91,25924,29298,24045,1,41,9,3007,0,1257,5586,2,0,1,0,1
EUW1_6855913756',2,26,12,0,0,0,0,12,1,351,90,27463,27978,33750,5,27,16,1,0,1,0,2,356,94,29238,30047,29356,0,-5,-4,-1775,-4,-2069,4394,-1,0,-1,0,10
EUW1_6855093181',4,24,12,1,1,0,0,10,1,374,89,29266,30457,27098,6,154,16,1,0,2,0,5,366,78,29007,28844,32892,0,8,11,259,-4,1613,-5794,0,1,-2,0,5
EUW1_6882811493',4,31,16,0,0,0,0,9,0,301,88,27710,26768,43802,8,51,13,1,0,1,0,3,342,75,28174,27555,46148,1,-41,13,-464,3,-787,-2346,-1,0,-1,0,6
EUW1_6880212568',9,52,15,0,0,1,0,8,1,331,70,26440,30718,33099,2,21,4,0,0,0,0,3,382,86,23527,29504,26595,1,-51,-16,2913,11,1214,6504,0,0,1,0,5
EUW1_6879915292',3,33,18,1,0,1,0,8,0,398,84,31342,32204,39242,1,100,11,0,0,0,0,6,344,86,26071,28665,31297,1,54,-2,5271,7,3539,7945,1,0,1,0,2
EUW1_6879861124',2,23,9,0,0,0,0,10,1,388,88,25920,30626,28866,3,22,16,1,0,1,0,0,365,84,29593,31895,34893,0,23,4,-3673,-7,-1269,-6027,-1,0,-1,0,10
EUW1_6878761174',0,19,15,0,0,0,0,13,0,331,66,28901,29198,29823,1,73,16,2,0,1,0,3,385,96,30894,31290,43269,0,-54,-30,-1993,-1,-2092,-13446,-2,0,-1,0,10
EUW1_6874064897',4,196,20,1,0,4,0,7,1,354,84,33433,29696,38471,6,30,11,0,0,0,0,10,299,67,25753,26029,28671,1,55,17,7680,9,3667,9800,1,0,4,0,-3
EUW1_6873631588',3,28,4,0,0,1,0,10,0,354,106,25074,28805,18546,4,30,11,1,0,1,0,5,328,84,25658,28547,28992,0,26,22,-584,-7,258,-10446,-1,0,0,0,5
EUW1_6878877815',11,42,10,0,0,0,0,5,1,383,70,24935,28895,29629,3,24,4,1,0,1,0,2,333,91,22811,26959,18187,1,50,-21,2124,6,1936,11442,-1,0,-1,0,3
EUW1_6875126396',1,26,15,2,0,0,0,11,0,299,83,28957,29440,42792,2,24,29,0,0,1,0,4,346,66,34968,33223,44158,0,-47,17,-6011,-14,-3783,-1366,2,0,-1,0,7
EUW1_6875111115',5,32,12,1,0,0,0,9,0,298,78,26379,28821,27012,4,27,17,1,0,0,0,2,365,94,29957,30955,38551,0,-67,-16,-3578,-5,-2134,-11539,0,0,0,0,7
EUW1_6869604612',9,33,12,1,1,0,0,4,1,363,98,28176,29441,30974,5,29,4,0,0,0,0,4,361,101,23859,26797,25932,1,2,-3,4317,8,2644,5042,1,1,0,0,0
EUW1_6869555167',2,143,12,2,0,1,0,8,1,394,107,29496,31082,39288,6,33,3,0,0,2,0,6,337,91,22893,27336,18839,1,57,16,6603,9,3746,20449,2,0,-1,0,2
EUW1_6869509920',3,59,7,1,1,0,0,3,0,377,87,25424,29667,30160,2,61,11,1,0,1,0,3,344,98,26400,28914,28646,1,33,-11,-976,-4,753,1514,0,1,-1,0,0
EUW1_6868881576',5,27,4,0,0,0,0,9,0,294,74,21172,25880,12760,5,39,12,2,0,1,0,0,407,111,29540,31791,31781,0,-113,-37,-8368,-8,-5911,-19021,-2,0,-1,0,9
EUW1_6868821783',3,40,6,0,0,0,0,8,1,334,88,23092,26538,28507,4,25,14,2,0,1,0,1,363,112,28329,31100,32904,0,-29,-24,-5237,-8,-4562,-4397,-2,0,-1,0,7
EUW1_6868090572',0,28,13,2,0,2,0,6,1,362,96,30186,31229,34944,6,26,12,0,0,1,0,8,309,94,26546,28063,27641,1,53,2,3640,1,3166,7303,2,0,1,0,-2
EUW1_6882794381',6,21,8,0,0,0,0,9,1,335,83,24282,28738,29207,4,26,10,2,0,1,0,1,359,96,26838,29195,28791,0,-24,-13,-2556,-2,-457,416,-2,0,-1,0,8
EUW1_6881939892',3,30,8,1,0,0,0,7,0,376,90,26026,30075,29703,7,31,13,1,0,0,0,4,358,106,26169,30983,26590,1,18,-16,-143,-5,-908,3113,0,0,0,0,3
EUW1_6883757406',7,27,10,0,0,0,0,4,0,408,98,27023,29956,24649,2,305,5,2,0,1,0,0,389,90,23491,29489,20719,0,19,8,3532,5,467,3930,-2,0,-1,0,4
EUW1_6883721396',2,25,5,0,0,0,0,7,1,335,92,22582,26140,23736,8,34,15,1,1,1,0,2,361,96,28797,31899,37067,0,-26,-4,-6215,-10,-5759,-13331,-1,-1,-1,0,5
EUW1_6883714569',3,15,14,0,0,2,0,10,0,355,55,29112,27037,32019,4,35,15,2,0,1,0,6,304,80,27147,25976,30820,1,51,-25,1965,-1,1061,1199,-2,0,1,0,4
EUW1_6883696880',1,31,24,0,0,1,0,4,1,395,57,32468,31172,40045,6,205,13,1,0,0,0,4,325,70,27270,28549,36061,1,70,-13,5198,11,2623,3984,-1,0,1,0,0
EUW1_6882545562',7,55,14,2,0,0,0,6,1,410,69,28743,30391,33518,3,29,5,0,0,1,0,6,332,91,22685,26918,21674,1,78,-22,6058,9,3473,11844,2,0,-1,0,0
EUW1_6882508667',1,28,4,0,0,0,0,3,0,392,100,23796,29774,17057,2,39,11,2,0,0,0,1,386,80,26274,29774,25646,0,6,20,-2478,-7,0,-8589,-2,0,0,0,2
EUW1_6881331130',6,33,12,0,0,1,0,8,0,372,69,27949,30315,30717,8,29,10,1,0,2,0,9,337,90,26187,28169,26941,0,35,-21,1762,2,2146,3776,-1,0,-1,0,-1
EUW1_6881289245',1,30,8,1,0,0,0,11,0,415,83,27389,30036,22678,3,29,19,1,0,2,0,2,372,93,32012,33534,39581,0,43,-10,-4623,-11,-3498,-16903,0,0,-2,0,9
EUW1_6881248680',5,22,14,1,1,1,0,8,1,349,86,27913,30021,32841,2,26,10,0,0,0,0,4,312,78,25014,25565,26478,1,37,8,2899,4,4456,6363,1,1,1,0,4
EUW1_6881202556',3,23,14,1,0,2,0,8,1,394,126,30679,31178,31269,5,67,5,1,0,0,0,7,303,76,22254,26178,25342,1,91,50,8425,9,5000,5927,0,0,2,0,1
EUW1_6881017573',3,26,8,0,0,0,0,16,0,331,74,24939,26855,26064,2,24,17,2,0,1,0,0,337,100,29994,28934,37655,1,-6,-26,-5055,-9,-2079,-11591,-2,0,-1,0,16
EUW1_6880960952',7,40,14,1,0,1,0,9,1,355,99,29499,30650,36982,8,34,8,1,0,1,0,6,312,85,25067,27459,26387,1,43,14,4432,6,3191,10595,0,0,0,0,3
EUW1_6879598845',4,32,10,0,0,0,0,7,0,316,69,24314,27557,29785,6,28,19,1,0,1,0,0,390,77,30421,31745,36330,0,-74,-8,-6107,-9,-4188,-6545,-1,0,-1,0,7
EUW1_6879448877',3,25,11,0,0,0,0,14,0,323,78,25767,28171,30466,4,31,20,2,1,2,0,0,393,94,32748,32488,39301,0,-70,-16,-6981,-9,-4317,-8835,-2,-1,-2,0,14
EUW1_6878346395',3,26,9,1,0,0,0,8,1,317,68,23767,27137,26636,0,25,8,0,0,1,0,2,348,76,25178,28903,28922,0,-31,-8,-1411,1,-1766,-2286,1,0,-1,0,6
EUW1_6878293004',8,25,15,2,0,0,0,4,0,314,86,26647,28280,29346,2,33,11,0,0,0,0,3,351,78,26517,28826,27292,1,-37,8,130,4,-546,2054,2,0,0,0,1
EUW1_6878029914',10,34,8,1,0,1,0,10,1,327,86,25557,27462,24237,1,30,3,1,0,0,0,0,399,96,24327,28648,21279,0,-72,-10,1230,5,-1186,2958,0,0,1,0,10
EUW1_6877998196',5,29,6,0,0,0,0,8,0,368,82,24531,28569,30512,1,20,19,2,0,0,0,1,367,94,30249,30383,37155,0,1,-12,-5718,-13,-1814,-6643,-2,0,0,0,7
EUW1_6877981636',5,32,5,1,0,0,0,5,0,402,106,24673,31130,20192,3,30,6,1,0,0,0,2,431,82,25252,30653,22727,0,-29,24,-579,-1,477,-2535,0,0,0,0,3
EUW1_6876601059',1,23,12,2,0,1,0,10,0,355,84,28443,27741,33826,1,27,13,0,0,2,0,4,373,84,29679,29376,27026,1,-18,0,-1236,-1,-1635,6800,2,0,-1,0,6
EUW1_6882618209',3,28,22,0,1,1,0,10,0,335,92,31781,31864,39066,2,22,17,2,0,1,0,5,331,92,29270,29439,39036,1,4,0,2511,5,2425,30,-2,1,0,0,5
EUW1_6882560913',1,24,16,1,0,0,0,8,0,333,70,27561,30286,35260,1,344,14,1,0,0,0,1,314,88,27207,28777,37086,1,19,-18,354,2,1509,-1826,0,0,0,0,7
EUW1_6882545705',4,69,24,2,0,3,0,5,1,397,109,37756,34196,43118,2,22,6,0,0,2,0,10,282,52,21388,24168,24922,1,115,57,16368,18,10028,18196,2,0,1,0,-5
EUW1_6882506425',0,33,11,0,0,3,0,10,1,331,86,27332,28666,35634,3,22,9,2,0,2,0,4,366,84,27054,29646,29653,0,-35,2,278,2,-980,5981,-2,0,1,0,6
EUW1_6882486329',1,24,19,1,0,2,0,8,1,357,88,31410,31048,37436,2,20,8,1,0,1,0,5,307,94,24205,27116,27932,1,50,-6,7205,11,3932,9504,0,0,1,0,3
EUW1_6882455412',2,27,8,1,0,1,0,5,0,353,77,25672,29249,31731,4,33,10,1,0,1,0,6,330,98,25300,29592,22996,1,23,-21,372,-2,-343,8735,0,0,0,0,-1
EUW1_6882233021',2,17,10,1,0,0,0,4,1,382,62,25277,28932,26504,3,28,13,1,0,0,0,3,383,88,27762,29810,33196,1,-1,-26,-2485,-3,-878,-6692,0,0,0,0,1
EUW1_6882199088',3,32,15,0,0,1,0,8,0,336,68,28961,28439,34406,3,23,12,1,0,0,0,7,338,76,27472,28786,28755,1,-2,-8,1489,3,-347,5651,-1,0,1,0,1
EUW1_6882178303',4,36,9,0,0,0,0,16,0,338,95,24597,28863,22883,1,24,11,2,0,2,0,2,372,86,28098,31726,33758,0,-34,9,-3501,-2,-2863,-10875,-2,0,-2,0,14
EUW1_6882160573',3,25,9,0,0,3,0,7,0,391,86,28716,29573,37311,2,21,12,2,0,0,0,9,319,80,26865,31256,27788,1,72,6,1851,-3,-1683,9523,-2,0,3,0,-2
EUW1_6882114098',4,41,24,1,1,2,0,11,1,354,88,32714,33361,44057,3,19,13,0,0,1,0,8,314,78,27755,29024,31262,1,40,10,4959,11,4337,12795,1,1,1,0,3
EUW1_6881920435',4,24,10,0,0,1,0,7,0,352,66,27112,28071,27950,3,21,15,1,0,1,0,6,341,85,28180,29340,32533,0,11,-19,-1068,-5,-1269,-4583,-1,0,0,0,1
EUW1_6881867566',5,27,12,0,0,0,0,9,1,331,80,26353,28397,29090,2,89,11,2,0,1,0,5,325,102,26298,29539,27504,0,6,-22,55,1,-1142,1586,-2,0,-1,0,4
EUW1_6881704625',6,33,9,0,0,0,0,10,0,364,87,26546,28799,25643,4,28,20,2,0,2,0,1,371,96,32715,30716,32710,0,-7,-9,-6169,-11,-1917,-7067,-2,0,-2,0,9
EUW1_6881643193',3,23,11,0,0,0,0,10,0,380,112,27737,33289,29133,0,24,7,2,0,2,0,4,383,92,26596,30743,25387,1,-3,20,1141,4,2546,3746,-2,0,-2,0,6
EUW1_6881586327',0,22,17,1,0,1,0,11,1,358,88,30613,30098,34555,2,27,13,1,0,1,0,2,310,90,27330,29244,28949,1,48,-2,3283,4,854,5606,0,0,0,0,9
EUW1_6880214287',5,29,11,0,0,0,0,6,1,324,76,25819,26788,30654,8,41,13,1,0,0,0,3,323,114,26705,29811,33424,1,1,-38,-886,-2,-3023,-2770,-1,0,0,0,3
EUW1_6880172592',4,47,27,2,0,0,0,14,0,363,77,32823,31426,44057,8,29,8,0,0,1,0,1,331,70,26532,25704,29601,1,32,7,6291,19,5722,14456,2,0,-1,0,13
EUW1_6880114629',4,103,8,1,1,0,0,10,1,360,98,26078,29069,25152,3,22,5,1,0,2,0,3,365,70,24111,28945,17144,1,-5,28,1967,3,124,8008,0,1,-2,0,7
EUW1_6879924789',2,26,5,1,0,1,0,10,1,371,84,24602,26941,28561,2,30,9,1,0,0,0,3,339,113,25750,29154,24083,0,32,-29,-1148,-4,-2213,4478,0,0,1,0,7
EUW1_6883266080',3,37,18,0,0,1,0,9,0,316,84,30232,28369,32343,2,23,14,2,0,1,0,4,287,92,26746,28695,34423,0,29,-8,3486,4,-326,-2080,-2,0,0,0,5
EUW1_6883220727',4,24,18,2,1,0,0,7,1,367,112,30703,31013,30749,2,36,7,0,0,1,0,5,332,76,24216,26804,24562,1,35,36,6487,11,4209,6187,2,1,-1,0,2
EUW1_6879863909',1,25,11,1,0,0,0,4,0,340,76,24748,29632,29338,4,21,15,1,0,1,0,1,353,80,28842,30875,32359,0,-13,-4,-4094,-4,-1243,-3021,0,0,-1,0,3
EUW1_6879095048',2,23,14,1,0,1,0,8,1,341,100,28373,30262,32341,1,36,5,0,0,0,0,2,368,88,23304,27448,22324,0,-27,12,5069,9,2814,10017,1,0,1,0,6
EUW1_6879036771',0,18,25,1,0,3,0,11,0,353,79,33219,29048,43111,0,13,10,1,0,1,0,8,256,68,24694,22701,34214,1,97,11,8525,15,6347,8897,0,0,2,0,3
EUW1_6878972076',1,26,11,1,0,1,0,8,1,374,93,28186,31404,29011,2,30,4,0,0,1,0,5,371,88,23000,28835,24030,1,3,5,5186,7,2569,4981,1,0,0,0,3
EUW1_6878912165',2,16,4,0,0,0,0,11,0,350,78,22703,27294,16896,2,28,17,2,0,1,0,0,392,93,29294,32433,32783,0,-42,-15,-6591,-13,-5139,-15887,-2,0,-1,0,11
EUW1_6878733433',2,23,7,0,0,0,0,15,0,345,82,25120,26668,20475,4,20,13,2,0,3,0,2,330,130,29419,29949,34044,0,15,-48,-4299,-6,-3281,-13569,-2,0,-3,0,13
EUW1_6878689438',3,28,12,0,0,0,0,16,1,345,82,27287,30977,34316,3,27,13,2,0,2,0,2,348,101,28885,31051,34418,0,-3,-19,-1598,-1,-74,-102,-2,0,-2,0,14
EUW1_6878647157',7,27,17,0,0,0,0,12,1,312,81,28617,26973,38565,6,31,21,1,0,0,0,0,343,82,30008,29734,40801,0,-31,-1,-1391,-4,-2761,-2236,-1,0,0,0,12
EUW1_6878589901',2,21,15,0,0,0,0,8,1,322,77,26565,28859,32370,3,27,12,1,0,2,0,2,333,84,26460,29584,36077,0,-11,-7,105,3,-725,-3707,-1,0,-2,0,6
EUW1_6878521610',7,97,11,0,0,0,0,5,0,334,87,25247,28728,28312,3,29,12,2,0,1,0,2,359,84,27364,30634,32879,0,-25,3,-2117,-1,-1906,-4567,-2,0,-1,0,3
EUW1_6883069452',3,29,11,2,0,0,0,12,0,346,90,27722,28821,30256,5,30,13,0,0,2,0,5,311,79,26621,27062,28158,1,35,11,1101,-2,1759,2098,2,0,-2,0,7
EUW1_6882706329',4,25,13,0,0,0,0,6,0,374,94,27748,31734,32486,1,79,13,1,0,0,0,3,360,104,27443,29762,29254,1,14,-10,305,0,1972,3232,-1,0,0,0,3
EUW1_6882652741',2,30,11,0,0,0,0,11,0,328,98,26320,30079,30664,4,40,11,1,0,0,0,5,330,82,26322,27734,33600,0,-2,16,-2,0,2345,-2936,-1,0,0,0,6
EUW1_6882572582',6,23,14,1,0,1,0,6,1,396,108,30119,32005,32772,1,24,7,0,0,1,0,9,333,87,23267,27794,21774,1,63,21,6852,7,4211,10998,1,0,0,0,-3
EUW1_6881558249',8,44,11,0,0,0,0,10,1,376,81,26296,30459,32586,3,70,12,2,0,0,0,2,302,114,26842,29411,34250,1,74,-33,-546,-1,1048,-1664,-2,0,0,0,8
EUW1_6881410070',3,22,18,0,0,1,0,9,0,360,84,29257,30765,46056,2,24,11,2,0,1,0,5,351,88,26863,31448,36165,0,9,-4,2394,7,-683,9891,-2,0,0,0,4
EUW1_6881371124',1,24,9,1,0,0,0,10,0,339,84,25216,27512,24446,4,29,21,1,0,2,0,2,359,96,32835,32010,37557,0,-20,-12,-7619,-12,-4498,-13111,0,0,-2,0,8
EUW1_6881324143',4,24,18,1,1,2,0,9,0,378,92,31981,31959,37227,5,31,8,0,0,1,0,4,303,84,25161,27359,25696,1,75,8,6820,10,4600,11531,1,1,1,0,5
EUW1_6881183429',4,28,15,1,0,0,0,9,1,342,88,28272,28758,31732,6,25,8,1,1,1,0,3,331,76,25632,27814,22400,1,11,12,2640,7,944,9332,0,-1,-1,0,6
EUW1_6881109474',3,28,8,1,0,0,0,10,0,308,86,24911,27932,29305,6,37,13,1,0,1,0,1,377,114,29429,32018,33599,0,-69,-28,-4518,-5,-4086,-4294,0,0,-1,0,9
EUW1_6881059271',4,29,10,1,0,1,0,12,0,374,94,27069,31401,30738,9,38,8,1,0,0,0,3,348,108,25017,28374,28044,1,26,-14,2052,2,3027,2694,0,0,1,0,9
EUW1_6881006881',4,22,9,0,0,0,0,11,1,387,60,26183,30766,28876,0,21,20,1,0,1,0,1,329,120,31542,31801,42825,1,58,-60,-5359,-11,-1035,-13949,-1,0,-1,0,10
EUW1_6879759036',2,27,21,2,0,3,0,9,1,384,118,32915,33551,37798,2,125,9,0,0,1,0,6,311,82,25052,28856,29251,1,73,36,7863,12,4695,8547,2,0,2,0,3
EUW1_6879731913',5,24,15,2,0,0,0,4,1,410,102,30892,32691,32601,7,36,6,0,0,0,0,4,351,81,23609,27712,26581,1,59,21,7283,9,4979,6020,2,0,0,0,0
EUW1_6881938148',4,31,8,2,0,1,0,7,1,358,85,25793,29113,26706,4,26,7,0,0,0,0,5,349,83,23577,28454,23617,1,9,2,2216,1,659,3089,2,0,1,0,2
EUW1_6881867281',3,25,7,0,0,0,0,10,0,304,64,23479,26727,28491,6,26,18,2,0,2,0,3,346,100,31329,29600,44070,0,-42,-36,-7850,-11,-2873,-15579,-2,0,-2,0,7
EUW1_6881799387',4,28,17,2,0,1,0,12,0,377,84,30062,31451,33924,7,31,9,0,1,3,0,5,340,102,27788,29808,20852,1,37,-18,2274,8,1643,13072,2,-1,-2,0,7
EUW1_6881740915',5,29,11,0,0,0,0,10,0,305,75,25480,26546,32062,6,26,18,1,0,1,0,2,318,80,28855,29428,39589,0,-13,-5,-3375,-7,-2882,-7527,-1,0,-1,0,8
EUW1_6881483746',3,17,19,1,0,0,0,13,1,295,60,29301,26825,36505,3,56,20,0,0,2,0,2,347,99,32711,30802,39496,0,-52,-39,-3410,-1,-3977,-2991,1,0,-2,0,11
EUW1_6881371951',5,21,18,1,0,1,0,10,1,382,84,30441,30961,34700,3,29,6,0,0,1,0,4,367,104,24798,29929,26310,1,15,-20,5643,12,1032,8390,1,0,0,0,6
EUW1_6881299784',6,149,16,1,0,0,0,5,0,336,78,27174,30082,34729,5,20,11,0,0,0,0,2,339,78,26344,29072,30709,0,-3,0,830,5,1010,4020,1,0,0,0,3
EUW1_6881235936',5,24,10,2,0,0,0,11,0,360,92,26476,28792,29455,4,61,12,0,0,0,0,0,341,84,26441,29416,28483,1,19,8,35,-2,-624,972,2,0,0,0,11
EUW1_6881194946',5,32,10,2,0,0,0,6,1,298,80,24785,27737,36918,4,34,15,0,0,1,0,4,366,84,29233,31001,35565,0,-68,-4,-4448,-5,-3264,1353,2,0,-1,0,2
EUW1_6881150473',4,39,10,0,0,0,0,8,0,340,98,26267,29749,34228,11,36,12,2,0,1,0,3,343,89,27141,30465,28291,1,-3,9,-874,-2,-716,5937,-2,0,-1,0,5
EUW1_6879772841',4,28,8,1,0,0,0,9,0,302,82,24830,27051,27178,3,146,17,0,0,2,0,1,351,77,30159,29512,33450,0,-49,5,-5329,-9,-2461,-6272,1,0,-2,0,8
EUW1_6879717326',6,31,12,1,0,0,0,9,1,358,91,26672,29360,38239,4,23,10,1,0,0,0,4,360,100,27763,30388,25190,0,-2,-9,-1091,2,-1028,13049,0,0,0,0,5
EUW1_6879680584',3,25,20,1,0,0,0,3,0,354,58,29869,30058,39850,5,32,21,0,0,0,0,4,322,96,28911,30492,42100,0,32,-38,958,-1,-434,-2250,1,0,0,0,-1
EUW1_6879629168',3,29,10,0,0,0,0,5,0,374,102,27542,29633,30467,2,93,14,1,0,1,0,5,313,80,25695,28462,29791,0,61,22,1847,-4,1171,676,-1,0,-1,0,0
EUW1_6880456994',3,30,8,2,0,0,0,5,0,307,64,23617,28683,31197,4,28,5,0,0,0,0,3,338,95,23077,28016,24706,1,-31,-31,540,3,667,6491,2,0,0,0,2
EUW1_6880368182',2,29,10,1,0,0,0,7,1,350,86,25507,28187,25513,2,25,11,0,0,1,0,4,397,82,27167,30278,30376,0,-47,4,-1660,-1,-2091,-4863,1,0,-1,0,3
EUW1_6880288665',3,129,16,0,0,2,0,9,1,322,86,28139,28433,37323,4,29,24,1,0,1,0,3,320,78,30323,28506,41181,1,2,8,-2184,-8,-73,-3858,-1,0,1,0,6
EUW1_6880226714',7,30,18,2,1,1,0,6,1,374,93,30902,31455,34028,0,23,9,0,0,0,0,4,354,93,25412,29316,21442,1,20,0,5490,9,2139,12586,2,1,1,0,2
EUW1_6880117503',0,25,15,0,0,0,0,14,1,298,90,27647,27935,40778,3,26,18,1,0,1,0,2,338,74,29580,29788,43256,0,-40,16,-1933,-3,-1853,-2478,-1,0,-1,0,12
EUW1_6880006243',3,55,17,0,0,0,0,11,0,310,79,29544,28564,42182,5,25,13,2,0,1,0,2,316,68,25433,26924,26467,1,-6,11,4111,4,1640,15715,-2,0,-1,0,9
EUW1_6879959298',5,35,11,2,0,1,0,10,1,362,92,27791,28444,31609,4,33,14,0,0,1,0,5,306,80,26514,26442,32979,1,56,12,1277,-3,2002,-1370,2,0,0,0,5
EUW1_6879926490',5,19,9,1,0,1,0,10,0,287,105,25162,27180,31729,3,20,21,1,0,1,0,4,340,98,29973,33248,36300,0,-53,7,-4811,-12,-6068,-4571,0,0,0,0,6
EUW1_6879832679',4,32,15,0,0,0,0,10,1,366,92,28093,29505,25955,3,28,4,2,0,0,0,2,346,87,22494,28688,30786,0,20,5,5599,11,817,-4831,-2,0,0,0,8
EUW1_6879741348',5,25,17,0,0,1,0,10,0,304,55,27624,28501,32957,2,23,14,1,0,2,0,1,311,100,28333,28743,37088,0,-7,-45,-709,3,-242,-4131,-1,0,-1,0,9
EUW1_6879718752',1,25,8,1,0,0,0,14,0,286,88,23088,23515,37703,1,28,20,0,0,2,0,3,323,82,32288,29406,40796,0,-37,6,-9200,-12,-5891,-3093,1,0,-2,0,11
EUW1_6879670748',4,31,12,2,0,0,0,6,0,313,104,26695,29158,30123,5,26,11,0,0,0,0,3,315,68,26230,28231,26811,1,-2,36,465,1,927,3312,2,0,0,0,3
EUW1_6879634648',4,28,13,0,0,2,0,10,1,381,112,29065,31886,31073,2,39,8,1,0,1,0,5,324,86,25724,27528,26595,1,57,26,3341,5,4358,4478,-1,0,1,0,5
EUW1_6879590752',4,38,12,1,0,0,0,10,0,341,79,26371,28252,32432,4,28,13,1,0,1,0,1,356,102,28672,30067,31291,1,-15,-23,-2301,-1,-1815,1141,0,0,-1,0,9
EUW1_6879560843',4,21,26,1,0,0,0,9,1,351,82,30772,30965,52979,4,23,16,1,0,0,0,4,281,66,28384,26751,36796,1,70,16,2388,10,4214,16183,0,0,0,0,5
EUW1_6879537689',2,20,30,0,0,2,0,9,1,354,75,33768,32437,51942,0,21,7,0,0,1,0,10,303,61,25340,25522,24889,1,51,14,8428,23,6915,27053,0,0,1,0,-1
EUW1_6879501862',3,21,14,2,1,1,0,6,0,323,100,28269,29668,38111,3,28,13,0,0,0,0,5,320,93,27797,32192,31091,0,3,7,472,1,-2524,7020,2,1,1,0,1
EUW1_6879018706',6,39,16,0,0,0,0,6,1,336,82,28406,30781,34027,4,34,12,0,0,1,0,5,362,102,27646,29147,34909,1,-26,-20,760,4,1634,-882,0,0,-1,0,1
EUW1_6883279272',5,129,14,0,0,2,0,6,0,366,84,29879,29054,34002,5,29,14,2,0,0,0,8,279,76,26371,25334,31747,1,87,8,3508,0,3720,2255,-2,0,2,0,-2
EUW1_6883210003',4,30,14,0,0,0,0,10,0,276,98,26330,27295,38405,0,18,21,1,0,1,0,2,377,80,32136,32047,44003,0,-101,18,-5806,-7,-4752,-5598,-1,0,-1,0,8
EUW1_6881754603',5,50,15,0,0,0,0,16,1,332,72,28601,29551,33261,2,22,15,2,0,3,0,1,355,116,30169,30452,29380,1,-23,-44,-1568,0,-901,3881,-2,0,-3,0,15
EUW1_6880512174',3,137,8,0,0,1,0,13,0,329,73,26207,27052,32901,3,26,21,1,0,2,0,4,328,94,31120,28371,32830,1,1,-21,-4913,-13,-1319,71,-1,0,-1,0,9
EUW1_6880452187',5,29,12,1,0,1,0,6,0,340,94,28592,30319,24154,2,17,6,0,0,1,0,7,275,86,22723,25833,22890,1,65,8,5869,6,4486,1264,1,0,0,0,-1
EUW1_6880388677',2,122,15,0,0,0,0,9,1,337,86,27963,28568,30451,7,23,11,2,0,1,0,2,342,86,27086,29036,31251,1,-5,0,877,4,-468,-800,-2,0,-1,0,7
EUW1_6879971061',5,29,9,0,0,0,0,5,0,405,102,26146,30916,30091,4,23,10,0,0,0,0,1,367,74,26062,29895,22735,1,38,28,84,-1,1021,7356,0,0,0,0,4
EUW1_6879914827',7,27,13,1,0,0,0,8,1,356,78,27311,29527,32986,0,19,10,0,0,0,0,3,344,84,26019,30189,33011,0,12,-6,1292,3,-662,-25,1,0,0,0,5
EUW1_6878403582',3,24,6,0,0,0,0,12,0,352,92,24022,28298,25695,2,19,11,1,0,2,0,1,411,86,28684,30302,26143,0,-59,6,-4662,-5,-2004,-448,-1,0,-2,0,11
EUW1_6878315504',4,32,14,1,0,0,0,10,1,325,84,27271,27705,31031,3,27,17,1,1,1,0,0,353,98,30099,31275,34255,0,-28,-14,-2828,-3,-3570,-3224,0,-1,-1,0,10
EUW1_6878287531',4,25,22,1,0,2,0,7,1,347,81,31616,32348,43748,5,20,8,1,0,1,0,4,326,69,24040,26075,34366,1,21,12,7576,14,6273,9382,0,0,1,0,3
EUW1_6878240170',4,24,6,0,0,0,0,13,0,343,104,23883,28229,25239,3,137,13,2,1,1,0,2,345,92,28478,30619,30690,0,-2,12,-4595,-7,-2390,-5451,-2,-1,-1,0,11
EUW1_6877259581',5,27,7,0,1,0,0,10,1,379,87,25851,28892,21213,6,26,11,2,0,0,0,5,368,78,27954,29460,28796,0,11,9,-2103,-4,-568,-7583,-2,1,0,0,5
EUW1_6875994878',8,35,15,1,0,1,0,8,1,415,82,28829,33365,32724,1,32,4,0,0,1,0,3,328,102,23175,27361,28057,1,87,-20,5654,11,6004,4667,1,0,0,0,5
EUW1_6875938280',3,21,9,0,0,0,0,9,1,361,71,25031,28053,24489,1,27,15,2,0,2,0,1,341,100,29284,31079,35879,0,20,-29,-4253,-6,-3026,-11390,-2,0,-2,0,8
EUW1_6875885070',1,20,16,0,0,1,0,10,0,373,72,29530,28993,35109,4,21,16,2,0,2,0,4,287,94,29071,28673,32805,0,86,-22,459,0,320,2304,-2,0,-1,0,6
EUW1_6874772859',4,28,13,2,0,2,0,6,1,363,88,29097,30407,32680,5,28,13,0,0,1,0,3,329,90,26445,30305,28157,1,34,-2,2652,0,102,4523,2,0,1,0,3
EUW1_6874710808',5,149,11,2,0,1,0,6,1,388,99,27966,29637,31269,1,27,10,0,0,0,0,6,363,86,26732,29963,22872,0,25,13,1234,1,-326,8397,2,0,1,0,0
EUW1_6882525869',4,25,16,0,0,1,0,8,1,318,90,27855,29830,29363,5,86,9,0,0,1,0,3,323,83,25698,29118,29222,1,-5,7,2157,7,712,141,0,0,0,0,5
EUW1_6882502689',2,51,13,0,0,1,0,9,0,294,70,26992,26411,30576,6,26,18,2,1,0,0,5,328,89,28489,29047,31705,0,-34,-19,-1497,-5,-2636,-1129,-2,-1,1,0,4
EUW1_6880167596',6,170,8,1,0,1,0,7,0,367,98,26588,30323,23619,4,81,6,0,0,0,0,6,306,110,24151,27685,21043,1,61,-12,2437,2,2638,2576,1,0,1,0,1
EUW1_6879851843',3,134,11,0,0,0,0,13,0,324,77,24960,26712,34421,3,274,14,2,0,2,0,1,399,94,31090,31581,31549,0,-75,-17,-6130,-3,-4869,2872,-2,0,-2,0,12
EUW1_6879685785',1,21,10,1,0,1,0,4,1,373,92,26963,28902,29604,3,31,8,1,0,1,0,3,320,72,24141,28085,26765,1,53,20,2822,2,817,2839,0,0,0,0,1
EUW1_6879453459',2,20,27,2,0,2,0,5,1,391,75,33227,32985,44261,1,23,10,0,0,1,0,9,331,106,28243,29597,34329,1,60,-31,4984,17,3388,9932,2,0,1,0,-4
EUW1_6879419820',5,42,6,1,0,0,0,6,1,337,107,24200,28856,26817,2,22,8,1,0,0,0,4,348,88,25147,30564,22485,1,-11,19,-947,-2,-1708,4332,0,0,0,0,2
EUW1_6879374009',3,50,13,0,1,1,0,8,1,335,81,28541,29889,32966,4,32,8,2,0,1,0,4,375,98,25642,28059,30436,0,-40,-17,2899,5,1830,2530,-2,1,0,0,4
EUW1_6879365645',4,20,16,1,0,0,0,10,0,295,88,29112,28134,33725,3,28,16,1,0,3,0,4,348,92,30355,30418,32298,0,-53,-4,-1243,0,-2284,1427,0,0,-3,0,6
EUW1_6879330009',5,30,18,0,0,0,0,8,1,308,82,28450,27733,37012,3,33,18,2,0,0,0,2,317,90,28950,29030,37187,1,-9,-8,-500,0,-1297,-175,-2,0,0,0,6
EUW1_6879846126',3,24,18,0,0,2,0,7,1,371,88,31827,30839,38281,3,23,10,2,0,2,0,10,294,88,26422,25546,30583,1,77,0,5405,8,5293,7698,-2,0,0,0,-3
EUW1_6878976849',3,133,19,1,0,1,0,9,0,360,102,30170,31152,38586,4,27,12,0,0,0,0,5,326,76,27419,27219,27588,1,34,26,2751,7,3933,10998,1,0,1,0,4
EUW1_6878913920',3,27,11,1,0,0,0,11,1,348,98,27010,28738,31599,4,20,17,1,0,1,0,2,367,65,30894,31299,36206,1,-19,33,-3884,-6,-2561,-4607,0,0,-1,0,9
EUW1_6878826725',1,15,6,0,0,0,0,13,0,282,100,22986,27236,24663,4,97,13,1,1,3,0,3,355,96,29182,31338,33894,0,-73,4,-6196,-7,-4102,-9231,-1,-1,-3,0,10
EUW1_6878770258',2,37,8,0,0,0,0,13,0,369,85,24651,30889,28475,3,26,9,1,0,2,0,4,391,74,27695,28720,31084,1,-22,11,-3044,-1,2169,-2609,-1,0,-2,0,9
EUW1_6878677071',6,30,17,2,0,3,0,4,1,355,88,30519,31282,34802,4,23,6,0,0,0,0,8,298,96,23145,26585,25485,1,57,-8,7374,11,4697,9317,2,0,3,0,-4
EUW1_6878625854',1,39,16,0,0,0,0,9,0,321,73,28333,31077,37456,0,29,22,1,0,2,0,0,339,84,31087,32569,39427,0,-18,-11,-2754,-6,-1492,-1971,-1,0,-2,0,9
EUW1_6878579573',6,36,11,0,1,0,0,8,1,333,76,25635,29637,28334,1,22,9,1,0,1,0,0,372,100,26277,30132,26172,1,-39,-24,-642,2,-495,2162,-1,1,-1,0,8
EUW1_6878299748',4,33,3,2,0,0,0,9,0,364,84,22802,26656,24043,2,22,12,0,0,3,0,3,369,112,29150,30665,32273,0,-5,-28,-6348,-9,-4009,-8230,2,0,-3,0,6
EUW1_6878254980',3,23,9,0,0,0,0,8,0,325,85,24328,27000,30827,4,20,14,2,0,0,0,2,350,99,27414,29326,35516,0,-25,-14,-3086,-5,-2326,-4689,-2,0,0,0,6
EUW1_6878105526',2,22,15,2,0,1,0,10,1,340,82,28347,28538,33486,4,28,13,0,1,1,0,7,347,94,28303,31235,27283,1,-7,-12,44,2,-2697,6203,2,-1,0,0,3
EUW1_6878066743',6,30,16,0,0,0,0,9,0,317,94,27320,27447,32929,3,54,14,2,0,0,0,4,326,94,28957,28987,31554,0,-9,0,-1637,2,-1540,1375,-2,0,0,0,5
EUW1_6878036851',3,35,17,0,0,2,0,14,1,332,90,30909,27440,37234,2,25,16,2,0,1,0,8,320,89,29064,28249,32535,1,12,1,1845,1,-809,4699,-2,0,1,0,6
EUW1_6875920877',5,28,15,0,1,2,0,9,1,380,78,30764,30765,36403,8,38,21,1,0,1,0,5,329,50,30227,28579,36172,0,51,28,537,-6,2186,231,-1,1,1,0,4
EUW1_6875807530',10,33,14,2,0,0,0,10,0,355,56,27331,27627,30730,3,144,18,0,0,3,0,5,361,96,31202,29937,40641,1,-6,-40,-3871,-4,-2310,-9911,2,0,-3,0,5
EUW1_6875750754',0,26,1,0,0,0,0,10,0,345,67,20779,27052,21396,5,39,14,1,0,0,0,2,353,78,27855,30962,26154,0,-8,-11,-7076,-13,-3910,-4758,-1,0,0,0,8
EUW1_6879067102',4,32,17,1,0,0,0,10,1,335,104,28509,31447,37430,2,20,8,0,0,1,0,2,379,70,26288,28538,27625,1,-44,34,2221,9,2909,9805,1,0,-1,0,8
EUW1_6878988941',1,22,19,0,0,2,0,8,1,349,84,31406,29253,34882,1,23,16,0,0,0,0,6,284,66,28950,26611,30992,0,65,18,2456,3,2642,3890,0,0,2,0,2
EUW1_6878954824',1,305,6,0,0,0,0,17,0,221,76,21718,22694,22806,1,15,19,1,1,5,0,0,406,88,33151,30235,32205,0,-185,-12,-11433,-13,-7541,-9399,-1,-1,-5,0,17
EUW1_6878891055',4,33,13,0,0,0,0,15,0,324,81,27220,28025,37596,1,43,20,1,0,2,0,1,311,68,29601,28182,45168,0,13,13,-2381,-7,-157,-7572,-1,0,-2,0,14
EUW1_6878634095',1,30,17,1,0,2,0,17,1,309,81,29142,27958,37502,8,208,15,0,0,2,0,5,324,70,30348,28245,39338,0,-15,11,-1206,2,-287,-1836,1,0,0,0,12
EUW1_6878579339',6,34,18,1,0,1,0,15,0,269,76,28612,27027,37517,4,149,11,0,0,1,0,0,365,64,27563,28108,34928,0,-96,12,1049,7,-1081,2589,1,0,0,0,15
EUW1_6878525752',3,26,20,0,0,1,0,9,1,383,96,31064,31815,33507,2,20,13,2,0,2,0,7,327,104,29322,28697,35145,0,56,-8,1742,7,3118,-1638,-2,0,-1,0,2
EUW1_6878462132',4,31,13,0,0,1,0,9,1,390,80,28422,29149,27901,3,24,11,1,1,1,0,3,357,98,26090,31266,29095,0,33,-18,2332,2,-2117,-1194,-1,-1,0,0,6
EUW1_6878373516',4,24,8,2,0,1,0,10,0,387,101,26128,29977,26245,9,27,12,0,0,0,0,3,363,94,27397,29407,30505,0,24,7,-1269,-4,570,-4260,2,0,1,0,7
EUW1_6878312256',4,32,13,2,0,1,0,9,0,324,88,27187,28873,33998,6,36,16,0,0,1,0,5,321,100,29121,29246,35764,1,3,-12,-1934,-3,-373,-1766,2,0,0,0,4
EUW1_6878256777',9,35,9,1,0,0,0,6,1,349,92,25871,27931,24748,3,48,8,0,0,1,0,4,404,92,27303,30032,35070,1,-55,0,-1432,1,-2101,-10322,1,0,-1,0,2
EUW1_6878209624',1,29,10,0,1,0,0,7,0,342,88,25287,28747,27871,9,34,13,2,0,1,0,3,367,71,27377,29854,33029,0,-25,17,-2090,-3,-1107,-5158,-2,1,-1,0,4
EUW1_6878168935',3,27,16,1,0,5,1,5,1,347,112,33055,29504,34282,1,160,7,0,0,0,0,12,312,66,22915,25409,20209,1,35,46,10140,9,4095,14073,1,0,5,1,-7
EUW1_6878118394',3,29,15,0,0,1,0,5,1,311,96,29074,28389,38109,3,29,16,0,0,0,0,5,355,76,27831,28830,40234,0,-44,20,1243,-1,-441,-2125,0,0,1,0,0
EUW1_6878100370',0,348,16,2,1,3,1,8,1,391,120,33014,31588,32379,0,17,6,0,0,2,0,4,237,0,19629,23382,15248,1,154,120,13385,10,8206,17131,2,1,1,1,4
EUW1_6878063443',0,26,10,0,0,0,0,13,0,242,91,25141,24399,28505,5,28,23,1,0,3,0,2,365,84,33330,30821,39757,0,-123,7,-8189,-13,-6422,-11252,-1,0,-3,0,11
EUW1_6876798131',4,22,12,0,0,1,0,5,0,407,92,29722,31896,30774,2,29,11,2,0,0,0,5,284,96,24709,28404,29319,0,123,-4,5013,1,3492,1455,-2,0,1,0,0
EUW1_6876762030',0,18,14,0,0,0,0,12,0,299,64,26350,26799,35282,1,26,19,1,0,2,0,1,353,88,31911,30208,40309,0,-54,-24,-5561,-5,-3409,-5027,-1,0,-2,0,11
EUW1_6876717285',4,61,11,0,0,0,0,10,0,296,85,25410,29462,29025,5,61,16,2,1,1,0,2,368,98,29547,31152,31935,0,-72,-13,-4137,-5,-1690,-2910,-2,-1,-1,0,8
EUW1_6876673294',2,46,8,0,0,1,0,9,1,347,78,26312,28863,27125,4,156,13,2,0,0,0,5,366,86,26994,30075,29586,0,-19,-8,-682,-5,-1212,-2461,-2,0,1,0,4
EUW1_6882870309',1,30,17,0,1,1,0,10,1,283,67,28434,28037,42410,3,24,14,1,0,1,0,4,329,78,27951,26984,45444,0,-46,-11,483,3,1053,-3034,-1,1,0,0,6
EUW1_6882682511',4,22,13,2,0,1,0,11,0,361,88,27913,32425,30184,1,18,3,0,0,1,0,2,376,112,23251,28238,27527,1,-15,-24,4662,10,4187,2657,2,0,0,0,9
EUW1_6882627195',5,27,7,0,0,0,0,12,1,312,83,23738,26641,23291,3,34,20,1,0,3,0,1,397,80,32876,31758,34853,0,-85,3,-9138,-13,-5117,-11562,-1,0,-3,0,11
EUW1_6882599457',3,38,21,0,0,2,0,10,1,334,56,30760,28209,45540,5,26,14,1,0,0,0,6,331,70,27982,27651,31054,1,3,-14,2778,7,558,14486,-1,0,2,0,4
EUW1_6882553407',4,27,11,0,0,0,0,12,0,324,60,25241,27792,25267,7,35,17,1,0,1,0,2,353,82,30070,30179,34057,0,-29,-22,-4829,-6,-2387,-8790,-1,0,-1,0,10
EUW1_6882472643',4,33,14,0,1,1,0,7,1,387,96,30202,31404,31373,3,21,7,2,0,2,0,7,340,84,23451,26882,25281,1,47,12,6751,7,4522,6092,-2,1,-1,0,0
EUW1_6882443931',4,31,14,1,0,2,0,10,1,359,70,28846,28565,30350,5,31,14,0,0,1,0,3,379,94,29104,30173,29998,0,-20,-24,-258,0,-1608,352,1,0,1,0,7
EUW1_6882419220',5,30,9,1,0,0,0,6,1,364,90,25950,29730,22781,2,24,8,1,0,1,0,3,418,118,27570,32257,27130,0,-54,-28,-1620,1,-2527,-4349,0,0,-1,0,3
EUW1_6882399855',4,26,10,1,0,1,0,10,0,394,76,26060,28963,23775,3,23,12,1,0,0,0,3,346,92,26880,29298,23841,1,48,-16,-820,-2,-335,-66,0,0,1,0,7
EUW1_6881679181',4,25,17,1,0,0,0,9,0,320,80,27847,30614,37477,8,190,12,1,0,0,0,0,370,80,26838,30079,37203,1,-50,0,1009,5,535,274,0,0,0,0,9
EUW1_6881613776',3,22,11,2,0,1,0,7,0,343,98,28347,29318,29310,5,27,12,0,0,1,0,8,321,82,26599,28241,29068,0,22,16,1748,-1,1077,242,2,0,0,0,-1
EUW1_6880993645',5,26,14,1,0,0,0,7,1,359,78,26700,30331,31980,4,28,5,1,0,1,0,1,361,91,23977,28708,29235,1,-2,-13,2723,9,1623,2745,0,0,-1,0,6
EUW1_6880938266',7,30,11,2,0,1,0,9,0,394,118,29344,31445,33586,5,23,5,0,0,2,0,7,362,78,25283,28831,26936,0,32,40,4061,6,2614,6650,2,0,-1,0,2
EUW1_6880923699',5,28,7,0,0,0,0,10,0,338,83,25803,27975,31303,8,31,12,2,0,3,0,1,358,108,28624,32279,28758,0,-20,-25,-2821,-5,-4304,2545,-2,0,-3,0,9
EUW1_6880106825',5,29,9,0,0,0,0,11,0,335,84,26351,28789,25963,4,34,9,2,0,2,0,6,363,106,26676,28782,24138,1,-28,-22,-325,0,7,1825,-2,0,-2,0,5
EUW1_6880066802',5,78,9,1,0,1,0,5,0,401,102,27531,30944,23564,2,37,4,0,0,0,0,7,355,82,22774,27480,17554,1,46,20,4757,5,3464,6010,1,0,1,0,-2
EUW1_6879867821',3,27,9,1,1,1,0,8,1,407,72,27203,30019,26637,3,84,9,1,0,0,0,5,355,100,25474,31148,25141,1,52,-28,1729,0,-1129,1496,0,1,1,0,3
EUW1_6879817761',3,32,10,0,0,0,0,13,1,324,93,25452,27737,27793,6,34,15,1,0,2,0,3,361,93,29824,30605,30916,1,-37,0,-4372,-5,-2868,-3123,-1,0,-2,0,10
EUW1_6879764984',5,30,13,1,1,1,0,9,0,394,90,28332,32307,26685,3,43,11,0,0,1,0,4,353,113,27279,29188,25103,1,41,-23,1053,2,3119,1582,1,1,0,0,5
EUW1_6879533127',4,45,14,1,1,1,0,3,0,391,98,30149,31088,27183,4,135,8,1,0,1,0,5,333,94,24605,26831,25782,1,58,4,5544,6,4257,1401,0,1,0,0,-2
EUW1_6883218875',5,31,9,2,0,1,0,6,1,365,96,26906,29490,27883,2,29,4,0,0,0,0,5,355,76,22600,28593,20560,1,10,20,4306,5,897,7323,2,0,1,0,1
EUW1_6883137403',1,27,12,1,0,0,0,18,0,328,94,26166,30251,27709,4,35,13,1,0,3,0,0,378,103,30312,31686,36281,1,-50,-9,-4146,-1,-1435,-8572,0,0,-3,0,18
EUW1_6883087145',6,31,16,1,0,0,0,6,0,330,103,27600,31368,32279,2,23,6,1,0,0,0,3,344,96,22872,28401,28010,1,-14,7,4728,10,2967,4269,0,0,0,0,3
EUW1_6883046647',2,25,4,0,0,0,0,9,0,321,80,22125,27216,29700,4,30,17,2,0,2,0,2,360,96,29455,32904,35893,0,-39,-16,-7330,-13,-5688,-6193,-2,0,-2,0,7
EUW1_6879795028',3,30,5,2,0,1,0,10,0,323,72,23110,28412,21337,4,50,7,0,0,1,0,4,377,102,25744,30533,28778,0,-54,-30,-2634,-2,-2121,-7441,2,0,0,0,6
EUW1_6879748272',7,29,9,1,0,0,0,10,0,349,71,25129,28613,36507,3,25,16,1,0,0,0,2,362,89,28213,30117,33299,0,-13,-18,-3084,-7,-1504,3208,0,0,0,0,8
EUW1_6878264772',4,62,7,0,0,0,0,7,0,352,66,23327,27413,26267,1,30,8,2,0,0,0,0,371,88,25314,29239,22144,0,-19,-22,-1987,-1,-1826,4123,-2,0,0,0,7
EUW1_6878235618',0,28,9,1,0,1,0,12,1,335,84,27209,26856,25343,1,23,18,1,0,2,0,7,344,84,31877,30713,35658,0,-9,0,-4668,-9,-3857,-10315,0,0,-1,0,5
EUW1_6878175078',2,23,10,0,0,0,0,12,1,358,82,27008,29553,30743,6,24,12,2,1,2,0,3,368,98,28418,30350,40569,0,-10,-16,-1410,-2,-797,-9826,-2,-1,-2,0,9
EUW1_6876868393',2,28,19,1,0,0,0,13,1,329,61,30636,27214,43894,6,98,10,0,0,1,0,3,313,89,26190,26761,32825,0,16,-28,4446,9,453,11069,1,0,-1,0,10
EUW1_6876634274',3,147,9,0,0,1,0,6,1,396,110,27558,32115,27995,1,217,14,0,1,1,0,5,364,98,28325,31619,25687,1,32,12,-767,-5,496,2308,0,-1,0,0,1
EUW1_6876544405',2,30,18,1,0,0,0,13,0,317,100,28517,31030,33269,6,36,12,0,0,2,0,4,387,84,29044,30306,31031,0,-70,16,-527,6,724,2238,1,0,-2,0,9
EUW1_6876461060',3,30,17,0,0,0,0,7,1,316,88,30263,30069,41689,7,34,20,1,0,1,0,6,294,76,28521,28688,33959,1,22,12,1742,-3,1381,7730,-1,0,-1,0,1
EUW1_6873825541',5,34,13,0,1,0,0,5,1,329,82,27256,29556,28633,9,33,4,2,0,0,0,3,355,84,23667,27707,24168,1,-26,-2,3589,9,1849,4465,-2,1,0,0,2
EUW1_6873809481',1,23,6,0,0,0,0,10,1,295,87,22437,26868,23169,7,30,16,1,1,2,0,1,388,68,29785,31758,33561,0,-93,19,-7348,-10,-4890,-10392,-1,-1,-2,0,9
EUW1_6873788300',4,25,12,1,0,2,0,5,1,376,76,28745,31020,29510,7,28,5,0,0,0,0,9,278,96,22129,25384,25316,1,98,-20,6616,7,5636,4194,1,0,2,0,-4
EUW1_6872498019',1,40,8,2,0,0,0,14,0,386,82,26904,30591,22158,2,129,14,0,1,2,0,4,388,124,31080,33243,32138,1,-2,-42,-4176,-6,-2652,-9980,2,-1,-2,0,10
EUW1_6872481622',2,30,20,1,0,2,0,11,1,314,88,31291,31052,41584,3,20,16,1,0,1,0,8,304,75,28875,30177,33108,1,10,13,2416,4,875,8476,0,0,1,0,3
EUW1_6883017068',1,23,12,0,0,0,0,11,1,384,100,28330,31369,34973,2,20,12,2,0,2,0,5,340,78,28367,29005,28647,0,44,22,-37,0,2364,6326,-2,0,-2,0,6
EUW1_6882923956',7,104,12,0,1,1,0,7,0,384,106,28514,32407,33686,4,26,11,1,0,0,0,4,364,73,25653,28960,30428,1,20,33,2861,1,3447,3258,-1,1,1,0,3
EUW1_6882872490',5,86,15,0,0,2,0,8,0,359,70,30654,30400,34274,3,29,10,1,0,1,0,3,328,82,25340,27494,35055,1,31,-12,5314,5,2906,-781,-1,0,1,0,5
EUW1_6882819192',8,23,10,0,0,0,0,7,0,329,74,25342,28419,27367,7,31,14,1,0,1,0,2,354,83,27585,30866,34017,0,-25,-9,-2243,-4,-2447,-6650,-1,0,-1,0,5
EUW1_6882417164',4,29,15,1,0,1,0,4,0,352,108,29726,32116,37005,3,30,6,0,0,1,0,5,347,88,24120,29259,23396,1,5,20,5606,9,2857,13609,1,0,0,0,-1
EUW1_6882397119',3,35,23,0,0,2,0,9,0,307,66,30962,29465,41936,9,28,17,2,0,2,0,5,345,82,28936,29105,40145,1,-38,-16,2026,6,360,1791,-2,0,0,0,4
EUW1_6882388545',5,30,12,0,0,0,0,8,0,323,70,24631,28262,28398,4,31,15,1,1,1,0,1,360,82,29358,28632,33681,0,-37,-12,-4727,-3,-370,-5283,-1,-1,-1,0,7
EUW1_6882369968',1,26,10,1,0,1,0,4,0,363,96,27633,30536,24486,3,44,13,1,0,0,0,3,349,108,26465,29653,28459,1,14,-12,1168,-3,883,-3973,0,0,1,0,1
EUW1_6882357934',1,25,14,1,0,1,0,10,0,294,98,27921,30031,33723,1,19,9,1,0,1,0,4,341,88,25787,28573,29747,1,-47,10,2134,5,1458,3976,0,0,0,0,6
EUW1_6881984134',3,30,9,0,0,0,0,13,0,319,94,26033,28565,24380,6,126,14,0,0,2,0,0,401,90,30750,31465,32559,0,-82,4,-4717,-5,-2900,-8179,0,0,-2,0,13
EUW1_6881924332',8,26,8,1,0,1,0,4,0,376,72,26374,28983,29040,5,225,11,0,0,0,0,5,308,104,26341,30053,26956,1,68,-32,33,-3,-1070,2084,1,0,1,0,-1
EUW1_6881872322',6,27,11,2,0,2,0,8,1,365,102,28739,31347,31622,2,320,7,0,0,1,0,5,331,98,24186,30565,24264,1,34,4,4553,4,782,7358,2,0,1,0,3
EUW1_6881670491',2,33,18,1,0,2,0,9,1,334,86,31710,31110,34303,1,26,14,1,0,1,0,4,289,82,27459,27343,33724,1,45,4,4251,4,3767,579,0,0,1,0,5
EUW1_6881594075',4,27,7,2,0,0,0,10,0,365,109,25991,31096,20867,7,76,11,0,0,1,0,3,421,74,28131,30562,26226,1,-56,35,-2140,-4,534,-5359,2,0,-1,0,7
EUW1_6881532147',4,50,12,1,0,1,0,8,1,359,78,28245,31760,39822,6,24,10,1,0,0,0,9,354,95,25562,30289,28812,1,5,-17,2683,2,1471,11010,0,0,1,0,-1
EUW1_6881464655',3,43,12,1,0,1,0,7,0,315,70,26539,28020,26768,3,25,13,0,0,0,0,5,370,66,26807,30099,31828,0,-55,4,-268,-1,-2079,-5060,1,0,1,0,2
EUW1_6881417556',7,32,21,1,0,0,0,5,1,360,100,31057,30787,35867,9,30,13,1,0,0,0,2,329,92,27767,26582,33281,1,31,8,3290,8,4205,2586,0,0,0,0,3
EUW1_6881030153',2,247,10,0,0,0,0,6,1,372,100,26737,30193,20891,2,25,8,2,1,0,0,2,382,92,25363,29999,24881,1,-10,8,1374,2,194,-3990,-2,-1,0,0,4
EUW1_6881007001',3,23,11,1,1,0,0,10,1,337,92,26634,29482,28328,7,27,10,1,0,0,0,4,365,72,26258,28309,24309,0,-28,20,376,1,1173,4019,0,1,0,0,6
EUW1_6880970823',2,24,16,1,0,0,0,10,0,374,102,28382,31644,28431,7,29,7,0,1,1,0,2,373,74,23882,29298,23990,1,1,28,4500,9,2346,4441,1,-1,-1,0,8
EUW1_6882576224',2,22,14,1,0,0,0,6,1,336,88,27312,30008,28873,4,28,13,1,1,0,0,2,317,112,27389,31088,34739,1,19,-24,-77,1,-1080,-5866,0,-1,0,0,4
EUW1_6880940328',5,32,8,1,0,0,0,7,0,364,80,24777,28655,28954,7,80,11,1,0,2,0,3,354,81,26387,29970,31453,1,10,-1,-1610,-3,-1315,-2499,0,0,-2,0,4
EUW1_6878909910',5,31,23,2,0,0,0,4,1,328,78,29893,31225,43055,3,22,9,0,0,0,0,5,259,81,23923,24781,28541,1,69,-3,5970,14,6444,14514,2,0,0,0,-1
EUW1_6878725483',4,23,13,0,0,0,0,13,0,283,92,27160,27653,34530,5,33,17,2,0,3,0,2,362,84,31712,31008,39654,0,-79,8,-4552,-4,-3355,-5124,-2,0,-3,0,11
EUW1_6878671062',5,174,3,1,0,0,0,6,0,365,75,22063,28396,23056,1,22,9,0,1,1,0,0,387,100,26831,30710,31209,0,-22,-25,-4768,-6,-2314,-8153,1,-1,-1,0,6
EUW1_6878502592',3,24,23,0,0,2,0,6,1,391,144,32338,35692,38149,2,33,3,1,0,0,0,7,300,76,21599,25605,18743,1,91,68,10739,20,10087,19406,-1,0,2,0,-1
EUW1_6877627562',7,46,10,0,0,0,0,7,1,358,89,25757,29053,32796,4,39,12,0,0,0,0,4,335,90,26132,30818,24655,0,23,-1,-375,-2,-1765,8141,0,0,0,0,3
EUW1_6877558865',6,29,14,1,1,0,0,6,0,353,98,27613,33432,31455,4,18,6,0,0,0,0,1,363,94,24849,28923,32294,1,-10,4,2764,8,4509,-839,1,1,0,0,5
EUW1_6877499047',3,25,14,2,0,1,0,11,1,362,106,29230,32118,32421,2,103,6,0,0,1,0,6,349,82,25263,27672,24270,1,13,24,3967,8,4446,8151,2,0,0,0,5
EUW1_6876798186',3,31,10,0,0,1,0,8,0,389,98,28665,31061,23422,2,24,12,2,0,1,0,5,361,84,27240,29391,28273,1,28,14,1425,-2,1670,-4851,-2,0,0,0,3
EUW1_6876749631',6,32,9,0,0,0,0,9,0,340,89,24687,29470,27925,4,29,11,2,1,2,0,2,366,92,27891,31657,26270,0,-26,-3,-3204,-2,-2187,1655,-2,-1,-2,0,7
EUW1_6868283665',2,21,7,0,0,0,0,12,1,325,80,23953,26996,31568,5,42,16,2,0,0,0,0,359,88,28986,32134,34995,0,-34,-8,-5033,-9,-5138,-3427,-2,0,0,0,12
EUW1_6862418358',1,23,16,2,0,0,0,7,1,323,100,27960,30465,35447,5,25,9,0,0,0,0,3,249,70,23341,26659,29264,1,74,30,4619,7,3806,6183,2,0,0,0,4
EUW1_6862380169',3,20,9,1,0,0,0,13,0,298,80,24576,28391,35998,3,25,19,1,0,2,0,1,363,100,31329,31727,44545,0,-65,-20,-6753,-10,-3336,-8547,0,0,-2,0,12
EUW1_6880136654',6,51,19,0,0,2,0,14,1,333,78,30335,29032,40624,3,33,17,1,0,1,0,4,282,94,30135,28157,30967,1,51,-16,200,2,875,9657,-1,0,1,0,10
EUW1_6879914145',4,30,4,1,0,0,0,10,0,321,93,22195,27678,22717,4,215,11,1,0,1,0,0,391,110,28240,31573,31323,0,-70,-17,-6045,-7,-3895,-8606,0,0,-1,0,10
EUW1_6879868510',5,27,13,1,1,1,0,9,0,396,112,29334,31319,26994,7,48,10,1,0,1,0,5,391,78,27185,28139,29291,1,5,34,2149,3,3180,-2297,0,1,0,0,4
EUW1_6879637786',6,37,18,1,1,1,0,9,1,395,112,30666,33026,38152,5,210,13,0,0,1,0,3,336,78,27431,29641,25947,1,59,34,3235,5,3385,12205,1,1,0,0,6
EUW1_6879590821',4,24,6,0,0,0,0,7,1,355,74,24370,28111,22211,7,34,12,2,0,1,0,3,381,118,27772,31269,33552,0,-26,-44,-3402,-6,-3158,-11341,-2,0,-1,0,4
EUW1_6879570661',0,18,5,0,0,0,0,17,0,307,73,22471,25358,22517,3,32,15,2,0,7,1,1,409,118,33724,32997,33267,0,-102,-45,-11253,-10,-7639,-10750,-2,0,-7,-1,16
EUW1_6879537835',5,28,15,0,0,1,0,10,1,409,102,30550,32400,43495,2,18,6,1,0,1,0,5,342,86,25385,28897,24049,1,67,16,5165,9,3503,19446,-1,0,0,0,5
EUW1_6879516817',5,30,17,2,0,2,0,8,0,414,101,32317,34777,38073,4,31,9,0,0,0,0,6,342,97,26406,29446,26547,1,72,4,5911,8,5331,11526,2,0,2,0,2
EUW1_6879481795',6,25,8,0,1,0,0,8,1,371,78,24912,28700,24215,4,95,8,1,0,0,0,1,372,93,25633,29551,31274,0,-1,-15,-721,0,-851,-7059,-1,1,0,0,7
EUW1_6879449043',9,28,11,0,1,1,0,7,0,362,94,27877,29297,25979,6,31,16,2,0,1,0,6,402,94,30238,30778,30126,1,-40,0,-2361,-5,-1481,-4147,-2,1,0,0,1
EUW1_6879432555',2,141,18,0,0,0,0,10,1,321,72,28397,27686,40951,4,32,16,1,0,0,0,1,304,74,28180,28727,38566,1,17,-2,217,2,-1041,2385,-1,0,0,0,9
EUW1_6879410721',4,28,16,1,0,2,0,11,1,367,72,30132,31040,38319,5,99,13,1,0,0,0,4,283,92,26524,27697,32044,1,84,-20,3608,3,3343,6275,0,0,2,0,7
EUW1_6878461369',5,39,7,0,0,0,0,8,1,337,65,23805,26998,20336,4,29,7,2,1,1,0,2,378,100,25724,29979,30896,0,-41,-35,-1919,0,-2981,-10560,-2,-1,-1,0,6
EUW1_6878411522',3,30,16,0,0,0,0,11,0,318,101,28695,31730,35658,1,24,12,2,1,1,0,2,364,106,27648,30263,35909,0,-46,-5,1047,4,1467,-251,-2,-1,-1,0,9
EUW1_6878355704',4,31,13,0,1,3,0,8,1,359,103,31032,31647,36432,5,23,15,1,0,0,0,8,329,96,27667,30726,34562,0,30,7,3365,-2,921,1870,-1,1,3,0,0
EUW1_6878115343',7,28,16,1,0,0,0,7,1,367,90,28434,31009,34670,4,28,12,0,0,1,0,3,369,74,27647,30247,32924,1,-2,16,787,4,762,1746,1,0,-1,0,4
EUW1_6878088588',11,29,14,1,0,0,0,12,1,353,73,28908,30100,37931,7,34,17,1,0,2,0,2,399,113,31879,32318,37275,1,-46,-40,-2971,-3,-2218,656,0,0,-2,0,10
EUW1_6880875956',5,25,11,1,0,0,0,15,0,371,61,26588,28766,27678,3,18,16,0,0,2,0,5,375,95,30700,30363,34599,0,-4,-34,-4112,-5,-1597,-6921,1,0,-2,0,10
EUW1_6878259257',6,47,9,0,0,0,0,10,0,377,73,25607,29348,28981,2,15,13,2,0,2,0,0,395,102,29640,31279,28765,0,-18,-29,-4033,-4,-1931,216,-2,0,-2,0,10
EUW1_6883779095',4,30,15,1,0,0,0,9,0,361,70,26793,30105,32591,2,42,10,0,0,0,0,3,349,76,24551,29286,28526,1,12,-6,2242,5,819,4065,1,0,0,0,6
EUW1_6883760586',5,29,12,1,0,0,0,14,0,323,78,25100,25989,31905,2,19,17,0,0,3,0,2,326,91,30200,30650,31838,0,-3,-13,-5100,-5,-4661,67,1,0,-3,0,12
EUW1_6883736220',3,31,12,2,0,1,0,7,1,396,104,28455,30968,28846,3,37,4,0,1,0,0,6,370,88,24216,29246,16952,0,26,16,4239,8,1722,11894,2,-1,1,0,1
EUW1_6883716214',5,39,16,0,0,1,0,10,1,331,78,28106,29428,42238,5,25,9,2,0,0,0,6,344,90,26686,27582,28596,0,-13,-12,1420,7,1846,13642,-2,0,1,0,4
EUW1_6883719578',1,22,17,0,0,0,0,9,0,321,90,29395,30902,29791,3,28,18,2,0,4,0,7,377,82,32027,30557,35260,0,-56,8,-2632,-1,345,-5469,-2,0,-4,0,2
EUW1_6883696925',1,312,12,1,1,1,0,8,1,365,80,29137,29711,34614,2,20,15,1,0,2,0,4,330,96,29285,31112,27271,1,35,-16,-148,-3,-1401,7343,0,1,-1,0,4
EUW1_6883202094',5,25,19,2,0,1,0,14,1,344,81,31189,30455,43587,4,23,19,0,0,0,0,6,325,90,31142,29562,34694,1,19,-9,47,0,893,8893,2,0,1,0,8
EUW1_6883131196',5,50,16,1,0,0,0,8,1,323,86,28766,28272,34704,7,38,14,1,0,1,0,4,323,74,28354,28564,36603,1,0,12,412,2,-292,-1899,0,0,-1,0,4
EUW1_6883087040',8,35,23,1,1,1,0,7,0,374,108,32185,34009,42718,1,21,10,0,0,0,0,2,325,80,25437,27328,28803,1,49,28,6748,13,6681,13915,1,1,1,0,5
EUW1_6883024972',6,25,13,0,0,0,0,10,1,286,86,27504,28266,29530,3,27,16,2,0,2,0,5,316,109,29134,28471,31927,1,-30,-23,-1630,-3,-205,-2397,-2,0,-2,0,5
EUW1_6882947229',2,18,13,0,0,0,0,9,0,283,93,26812,29582,28847,3,24,13,2,0,0,0,4,392,94,28834,31793,32787,0,-109,-1,-2022,0,-2211,-3940,-2,0,0,0,5
EUW1_6882883736',1,22,12,1,0,1,0,9,1,344,94,27566,29142,26600,5,23,13,0,0,1,0,1,346,86,28388,30009,27621,0,-2,8,-822,-1,-867,-1021,1,0,0,0,8
EUW1_6882741921',3,26,7,0,0,0,0,11,0,319,96,25218,28873,36432,5,28,13,2,0,4,0,7,349,96,29562,29905,34866,0,-30,0,-4344,-6,-1032,1566,-2,0,-4,0,4
EUW1_6882703006',2,29,9,0,0,0,0,4,0,341,82,24958,28435,28333,5,28,12,2,0,1,0,1,346,94,27143,29979,30822,1,-5,-12,-2185,-3,-1544,-2489,-2,0,-1,0,3
EUW1_6882648988',7,41,14,1,0,0,0,9,0,338,80,26521,27802,34796,3,25,14,0,0,1,0,4,371,92,28389,30416,37344,0,-33,-12,-1868,0,-2614,-2548,1,0,-1,0,5
EUW1_6882612221',2,23,16,1,0,1,0,13,1,356,66,29557,28720,31823,2,23,15,1,0,2,0,5,334,90,29473,29713,34223,0,22,-24,84,1,-993,-2400,0,0,-1,0,8
EUW1_6882579864',5,35,7,0,0,1,0,9,0,373,104,25590,29719,25371,7,26,11,2,0,0,0,2,361,90,26608,30062,30872,1,12,14,-1018,-4,-343,-5501,-2,0,1,0,7
EUW1_6882552486',2,28,18,1,0,1,0,12,1,347,103,30452,30891,39504,1,25,12,1,0,3,0,4,299,80,26673,27775,31983,0,48,23,3779,6,3116,7521,0,0,-2,0,8
EUW1_6882519107',1,31,12,0,0,0,0,12,0,346,89,27022,29627,35964,4,130,12,2,0,1,0,2,297,90,26599,27951,37119,1,49,-1,423,0,1676,-1155,-2,0,-1,0,10
EUW1_6882870166',8,37,6,2,0,0,0,10,0,348,92,23843,27344,28728,3,44,12,0,1,1,0,2,375,81,28210,30155,30377,0,-27,11,-4367,-6,-2811,-1649,2,-1,-1,0,8
EUW1_6882502764',3,26,13,1,0,3,0,14,1,369,87,29093,30230,31424,2,22,12,0,0,0,0,8,267,71,25252,26531,26574,1,102,16,3841,1,3699,4850,1,0,3,0,6
EUW1_6881379538',2,21,9,0,0,1,0,12,1,365,72,27236,27939,27951,2,40,16,0,0,1,0,6,387,74,29542,31503,32211,0,-22,-2,-2306,-7,-3564,-4260,0,0,0,0,6
EUW1_6881320700',8,43,8,1,0,1,0,7,1,402,78,26774,29068,20712,5,132,8,0,0,0,0,6,383,93,26008,31384,24100,1,19,-15,766,0,-2316,-3388,1,0,1,0,1
EUW1_6881229038',2,23,6,1,0,0,0,11,1,357,91,23899,28475,20958,1,25,7,1,0,1,0,1,403,68,26020,30389,23703,0,-46,23,-2121,-1,-1914,-2745,0,0,-1,0,10
EUW1_6881191991',5,30,10,1,0,1,0,7,0,383,100,29384,31878,36412,6,23,5,1,0,1,0,9,332,76,22614,26309,19660,1,51,24,6770,5,5569,16752,0,0,0,0,-2
EUW1_6879529696',3,23,7,1,0,0,0,4,0,382,94,24943,29121,20900,4,29,6,1,0,0,0,0,359,82,23325,27807,22950,1,23,12,1618,1,1314,-2050,0,0,0,0,4
EUW1_6879474495',2,40,15,0,0,1,0,7,1,364,94,29054,29809,33593,2,26,12,2,1,0,0,2,367,82,27895,30284,24550,0,-3,12,1159,3,-475,9043,-2,-1,1,0,5
EUW1_6878629516',3,24,6,0,0,0,0,7,0,320,100,24511,28504,28503,1,31,14,1,0,1,0,5,369,95,28845,30960,27900,0,-49,5,-4334,-8,-2456,603,-1,0,-1,0,2
EUW1_6878266726',1,23,10,1,0,0,0,9,1,340,88,25813,29814,24718,2,29,15,1,1,1,0,3,369,87,29777,30134,27747,1,-29,1,-3964,-5,-320,-3029,0,-1,-1,0,6
EUW1_6878212216',4,22,9,0,0,0,0,10,0,363,91,25975,30247,25657,4,143,11,2,1,2,0,1,368,104,28604,30512,25670,1,-5,-13,-2629,-2,-265,-13,-2,-1,-2,0,9
EUW1_6877383306',3,25,7,0,0,0,0,9,1,333,54,23994,28350,27660,3,30,11,2,1,1,0,0,403,110,27305,31476,28728,0,-70,-56,-3311,-4,-3126,-1068,-2,-1,-1,0,9
EUW1_6876909579',1,20,11,2,0,0,0,13,1,293,90,25053,28428,30959,1,24,17,0,0,1,0,2,315,89,30896,29026,35672,1,-22,1,-5843,-6,-598,-4713,2,0,-1,0,11
EUW1_6876856426',4,190,13,0,0,0,0,7,0,344,82,27027,28520,29883,3,28,13,2,0,1,0,4,370,96,28684,30824,29324,0,-26,-14,-1657,0,-2304,559,-2,0,-1,0,3
EUW1_6883023220',4,308,17,0,0,0,0,9,1,338,95,28476,30347,35362,3,23,12,2,0,1,0,2,366,90,26933,31792,33753,1,-28,5,1543,5,-1445,1609,-2,0,-1,0,7
EUW1_6882956261',2,30,13,1,0,0,0,11,0,339,77,28070,29491,32325,3,34,12,1,1,1,0,5,368,112,28180,31684,26113,1,-29,-35,-110,1,-2193,6212,0,-1,-1,0,6
EUW1_6882785638',3,25,14,0,0,2,0,7,1,377,104,29768,32087,35099,0,144,7,1,0,0,0,7,343,68,24188,26868,24347,1,34,36,5580,7,5219,10752,-1,0,2,0,0
EUW1_6882755040',3,39,15,2,0,1,0,7,1,360,78,28701,29921,33266,1,25,5,0,0,0,0,5,296,92,21517,25609,18304,1,64,-14,7184,10,4312,14962,2,0,1,0,2
EUW1_6882717077',2,27,10,2,1,0,0,15,0,369,100,27913,29577,32447,4,131,7,0,0,3,0,2,341,115,25859,29184,26442,0,28,-15,2054,3,393,6005,2,1,-3,0,13
EUW1_6882580682',1,25,7,1,1,0,0,3,1,402,106,26309,30509,24443,4,28,9,1,0,0,0,3,357,98,25138,29258,24639,1,45,8,1171,-2,1251,-196,0,1,0,0,0
EUW1_6882549713',2,43,6,0,0,0,0,8,1,319,60,22099,25468,21939,6,30,13,2,0,1,0,1,400,109,29704,32093,38608,0,-81,-49,-7605,-7,-6625,-16669,-2,0,-1,0,7
EUW1_6882523699',4,27,6,0,0,1,0,5,1,367,108,25806,29944,29175,5,26,7,1,0,0,0,3,391,88,25085,31203,24454,0,-24,20,721,-1,-1259,4721,-1,0,1,0,2
EUW1_6882453941',5,34,10,0,0,0,0,12,0,325,109,25721,29901,26228,3,20,11,2,0,1,0,0,370,74,27382,29219,29208,0,-45,35,-1661,-1,682,-2980,-2,0,-1,0,12
EUW1_6882438604',5,31,16,1,0,1,0,13,0,397,90,31072,31409,38901,3,29,10,1,0,1,0,4,332,114,27046,28042,32287,1,65,-24,4026,6,3367,6614,0,0,0,0,9
EUW1_6882401326',2,22,10,1,0,1,0,14,1,313,93,26849,28565,30297,1,24,13,1,0,1,0,1,351,102,28518,31379,31614,1,-38,-9,-1669,-3,-2814,-1317,0,0,0,0,13
EUW1_6882394511',2,23,7,0,0,0,0,6,0,403,94,25778,29793,29313,8,48,10,2,0,0,0,2,374,108,27423,29736,25943,0,29,-14,-1645,-3,57,3370,-2,0,0,0,4
EUW1_6882038875',0,20,15,2,0,0,0,14,1,326,89,27025,29444,33821,1,61,17,0,0,3,0,1,331,96,30357,29560,39266,1,-5,-7,-3332,-2,-116,-5445,2,0,-3,0,13
EUW1_6881922636',5,26,17,1,0,0,0,4,1,354,124,29960,33290,39466,5,34,5,1,0,0,0,5,327,84,22905,26941,24700,1,27,40,7055,12,6349,14766,0,0,0,0,-1
EUW1_6881835343',4,26,9,0,0,0,0,6,0,365,76,25560,29764,25305,6,28,9,2,0,1,0,1,367,116,26133,30031,36558,0,-2,-40,-573,0,-267,-11253,-2,0,-1,0,5
EUW1_6881767111',2,25,11,1,0,0,0,7,1,344,126,27283,29196,30337,3,28,14,1,0,0,0,3,343,66,27132,29578,29417,0,1,60,151,-3,-382,920,0,0,0,0,4
EUW1_6881705240',5,50,12,0,0,1,0,6,0,351,74,28801,28316,32928,4,106,16,1,0,1,0,3,334,84,28128,29412,33835,0,17,-10,673,-4,-1096,-907,-1,0,0,0,3
EUW1_6881286242',3,68,10,0,0,0,0,6,0,378,107,26901,30836,32685,3,23,10,2,0,0,0,6,363,100,25821,29342,30200,1,15,7,1080,0,1494,2485,-2,0,0,0,0
EUW1_6883782423',3,26,21,0,0,1,0,9,1,336,79,30705,31645,43707,4,73,11,1,0,3,0,5,330,88,27942,28088,35640,0,6,-9,2763,10,3557,8067,-1,0,-2,0,4
EUW1_6883758763',4,29,10,1,0,0,0,11,0,323,75,25589,29935,30969,5,26,8,1,0,3,0,2,375,103,27969,30124,29957,0,-52,-28,-2380,2,-189,1012,0,0,-3,0,9
EUW1_6883303721',4,22,16,0,0,0,0,13,0,316,71,27571,29120,29505,1,35,15,2,0,1,0,2,376,87,29735,29553,30713,1,-60,-16,-2164,1,-433,-1208,-2,0,-1,0,11
EUW1_6883201189',3,96,16,0,0,0,0,10,1,316,78,28759,28575,37922,6,32,19,1,0,0,0,2,326,71,28318,27678,38141,1,-10,7,441,-3,897,-219,-1,0,0,0,8
EUW1_6883167486',0,9,4,0,0,0,0,16,0,194,74,19448,22202,20283,2,21,14,2,0,7,1,1,395,117,33876,31478,33963,0,-201,-43,-14428,-10,-9276,-13680,-2,0,-7,-1,15
EUW1_6883117538',6,27,6,1,0,0,0,12,0,348,104,24428,28822,24818,2,23,17,0,0,2,0,1,401,84,31566,32861,31940,0,-53,20,-7138,-11,-4039,-7122,1,0,-2,0,11
EUW1_6883021257',2,28,12,1,0,0,0,11,1,376,106,28094,31101,23839,2,27,5,1,0,2,0,4,367,101,24102,28544,26853,1,9,5,3992,7,2557,-3014,0,0,-2,0,7
EUW1_6882981103',7,30,9,2,0,2,0,4,0,383,98,28290,31423,29919,4,24,7,0,0,0,0,7,340,92,23623,28302,22293,1,43,6,4667,2,3121,7626,2,0,2,0,-3
EUW1_6882788700',0,36,17,0,0,2,0,10,1,318,90,29801,31007,35165,5,28,14,1,0,1,0,7,274,60,26507,26447,31496,1,44,30,3294,3,4560,3669,-1,0,1,0,3
EUW1_6882737903',9,31,7,1,0,0,0,8,1,342,94,24117,28660,25302,2,28,10,1,0,0,0,2,360,97,26515,29211,29986,0,-18,-3,-2398,-3,-551,-4684,0,0,0,0,6
EUW1_6882686283',6,30,4,0,0,0,0,11,0,376,67,23223,28555,30934,5,41,11,1,0,1,0,1,362,109,27590,31641,40969,0,14,-42,-4367,-7,-3086,-10035,-1,0,-1,0,10
EUW1_6882649060',7,22,19,1,0,3,0,6,1,370,86,32609,32240,36497,3,25,7,0,0,0,0,4,351,78,23094,27630,25161,1,19,8,9515,12,4610,11336,1,0,3,0,2
EUW1_6882593332',1,25,0,0,0,0,0,13,0,343,92,20669,27401,18904,3,28,13,2,1,3,0,2,446,102,30773,34406,25400,0,-103,-10,-10104,-13,-7005,-6496,-2,-1,-3,0,11
EUW1_6878481910',3,353,14,2,0,0,0,10,1,370,90,27884,31644,35424,4,308,8,0,0,1,0,3,304,96,25214,27751,30064,1,66,-6,2670,6,3893,5360,2,0,-1,0,7
EUW1_6878430273',2,26,5,1,1,0,0,12,0,366,101,24747,30027,24512,5,32,11,1,0,1,0,1,407,90,28507,32177,28914,0,-41,11,-3760,-6,-2150,-4402,0,1,-1,0,11
EUW1_6878363081',3,25,6,1,0,1,0,8,0,400,86,25614,28598,27893,4,22,15,1,0,1,0,2,373,109,29563,31703,31623,0,27,-23,-3949,-9,-3105,-3730,0,0,0,0,6
EUW1_6878325717',2,22,15,0,0,1,0,14,0,285,72,28577,27287,33665,3,86,19,2,0,3,0,5,330,98,30422,31146,38823,0,-45,-26,-1845,-4,-3859,-5158,-2,0,-2,0,9
EUW1_6878201794',7,29,17,1,0,2,0,9,0,358,96,30496,31917,33472,4,22,11,0,0,0,0,4,357,92,27154,29017,28776,0,1,4,3342,6,2900,4696,1,0,2,0,5
EUW1_6878119698',5,31,5,0,0,1,0,10,0,370,106,25510,29841,18434,3,20,11,2,1,2,0,2,371,89,27157,32064,27014,0,-1,17,-1647,-6,-2223,-8580,-2,-1,-1,0,8
EUW1_6882286581',8,35,12,0,0,1,0,7,0,397,91,27860,30791,31499,4,28,5,1,0,0,0,5,339,60,22243,26419,20303,1,58,31,5617,7,4372,11196,-1,0,1,0,2
EUW1_6882265904',3,22,17,0,0,1,0,4,0,359,73,28602,31626,35013,5,28,9,1,0,0,0,4,279,96,24727,27103,31233,1,80,-23,3875,8,4523,3780,-1,0,1,0,0
EUW1_6882245167',7,28,18,2,0,0,0,6,1,358,116,30747,34966,33680,3,27,11,0,0,2,0,9,362,84,27683,29080,37123,1,-4,32,3064,7,5886,-3443,2,0,-2,0,-3
EUW1_6882226677',3,57,19,1,1,1,0,11,1,288,91,29789,29094,40380,5,26,15,1,0,2,0,1,318,67,29551,28029,35512,1,-30,24,238,4,1065,4868,0,1,-1,0,10
EUW1_6882200536',5,64,29,2,0,3,0,11,1,363,110,36235,33822,51510,3,54,14,0,0,0,0,4,310,62,27805,26894,27009,1,53,48,8430,15,6928,24501,2,0,3,0,7
EUW1_6882167692',2,29,20,2,0,1,0,7,0,357,97,32468,30112,42590,4,29,16,0,0,1,0,8,308,78,27919,27348,34004,1,49,19,4549,4,2764,8586,2,0,0,0,-1
EUW1_6882106908',2,28,7,1,0,0,0,5,1,392,86,24972,28464,25284,4,28,3,0,0,0,0,4,414,89,24069,29371,21269,0,-22,-3,903,4,-907,4015,1,0,0,0,1
EUW1_6879907000',5,28,11,1,0,1,0,7,1,334,67,26173,27036,29813,4,26,12,1,1,1,0,5,314,112,26814,29551,28610,0,20,-45,-641,-1,-2515,1203,0,-1,0,0,2
EUW1_6879868802',2,83,6,0,0,0,0,12,0,308,70,21778,25894,22195,7,29,20,1,1,2,0,1,372,80,31452,30625,38152,0,-64,-10,-9674,-14,-4731,-15957,-1,-1,-2,0,11
EUW1_6879812235',5,23,17,1,0,1,0,5,1,390,76,30275,30850,33891,6,29,7,1,1,0,0,1,351,96,24487,27683,27593,1,39,-20,5788,10,3167,6298,0,-1,1,0,4
EUW1_6879770840',7,85,15,0,0,1,0,9,0,365,89,28553,29372,28056,6,34,11,1,0,1,0,1,367,98,28052,29014,26133,1,-2,-9,501,4,358,1923,-1,0,0,0,8
EUW1_6879675016',3,26,10,1,0,1,0,9,0,299,86,25348,27807,28321,5,31,13,0,0,1,0,5,349,74,27465,29504,33722,0,-50,12,-2117,-3,-1697,-5401,1,0,0,0,4
EUW1_6879638944',3,28,11,0,0,0,0,9,1,323,59,25527,26973,32075,5,30,6,2,0,1,0,3,339,104,25685,27876,34466,0,-16,-45,-158,5,-903,-2391,-2,0,-1,0,6
EUW1_6878844538',3,22,6,0,0,2,0,14,1,328,84,26761,26232,27328,0,24,13,2,0,3,0,8,336,76,26987,29873,25642,0,-8,8,-226,-7,-3641,1686,-2,0,-1,0,6
EUW1_6878763169',5,29,10,0,0,0,0,12,0,307,72,24999,26646,22486,5,168,13,2,0,0,0,1,364,87,26937,28726,32742,0,-57,-15,-1938,-3,-2080,-10256,-2,0,0,0,11
EUW1_6878643254',2,93,23,1,0,1,0,7,0,319,89,29459,31627,36262,3,25,15,1,0,0,0,6,329,98,27162,29552,35186,1,-10,-9,2297,8,2075,1076,0,0,1,0,1
EUW1_6878588310',5,28,17,1,0,0,0,10,1,332,92,29227,30444,48228,0,112,18,1,0,1,0,3,305,90,29559,30598,39872,0,27,2,-332,-1,-154,8356,0,0,-1,0,7
EUW1_6878537000',3,41,9,0,0,0,0,9,0,343,77,24500,28623,22479,5,35,10,1,0,1,0,2,373,88,27249,28666,28704,0,-30,-11,-2749,-1,-43,-6225,-1,0,-1,0,7
EUW1_6878500548',2,23,15,0,0,0,0,9,0,357,83,28121,30816,39497,6,64,15,1,0,2,0,2,333,88,29312,29431,35645,0,24,-5,-1191,0,1385,3852,-1,0,-2,0,7
EUW1_6878439412',6,29,9,1,0,0,0,11,0,321,103,27096,28160,31093,6,28,14,1,0,1,0,1,337,72,26418,29214,35936,0,-16,31,678,-5,-1054,-4843,0,0,-1,0,10
EUW1_6878148438',1,25,14,1,0,0,0,8,0,370,90,29151,30109,33519,2,47,6,0,0,1,0,9,318,102,25004,27383,27851,1,52,-12,4147,8,2726,5668,1,0,-1,0,-1
EUW1_6878123347',1,23,15,2,0,0,0,10,0,332,92,28042,30884,32429,6,37,8,0,0,0,0,2,366,74,26531,27986,29151,1,-34,18,1511,7,2898,3278,2,0,0,0,8
EUW1_6877943614',7,31,8,1,0,1,0,4,1,334,80,25233,27914,29170,3,32,10,0,0,0,0,2,323,94,24862,28320,30266,1,11,-14,371,-2,-406,-1096,1,0,1,0,2
EUW1_6877928939',5,28,19,1,0,0,0,14,0,272,74,27728,28981,37530,3,130,18,1,0,2,0,1,311,94,29863,27739,43515,0,-39,-20,-2135,1,1242,-5985,0,0,-2,0,13
EUW1_6877392793',3,28,12,2,0,1,0,12,0,371,97,28358,32261,29596,1,28,8,0,0,1,0,4,361,78,26263,28565,27495,1,10,19,2095,4,3696,2101,2,0,0,0,8
EUW1_6877322386',6,298,11,2,0,0,0,13,0,315,84,27301,27665,27247,3,26,20,0,1,2,0,2,367,100,31888,31851,35346,0,-52,-16,-4587,-9,-4186,-8099,2,-1,-2,0,11
EUW1_6877272155',4,31,21,1,0,0,0,10,1,331,74,30028,29992,37114,5,89,12,0,1,2,0,2,331,75,26821,28773,32990,1,0,-1,3207,9,1219,4124,1,-1,-2,0,8
EUW1_6883736904',3,67,4,0,0,1,0,9,0,311,92,22626,26392,18553,7,300,6,2,0,1,0,3,391,76,25246,28614,24532,1,-80,16,-2620,-2,-2222,-5979,-2,0,0,0,6
EUW1_6883714664',8,29,14,1,0,1,0,9,0,319,79,28128,29832,31774,4,25,12,1,1,1,0,8,384,112,29152,30179,27902,1,-65,-33,-1024,2,-347,3872,0,-1,0,0,1
EUW1_6882038679',6,33,4,1,1,0,0,10,0,386,84,23982,29722,21520,5,30,5,1,0,2,0,3,365,99,26025,29844,26955,0,21,-15,-2043,-1,-122,-5435,0,1,-2,0,7
EUW1_6881973977',1,22,14,1,0,1,0,6,1,381,94,28555,31197,33697,4,20,8,1,0,0,0,8,314,94,24122,27430,23953,1,67,0,4433,6,3767,9744,0,0,1,0,-2
EUW1_6881910483',7,34,11,0,0,0,0,8,0,286,82,25928,27997,26104,3,38,19,1,1,0,0,2,366,94,30118,31339,39362,0,-80,-12,-4190,-8,-3342,-13258,-1,-1,0,0,6
EUW1_6881758469',7,40,7,1,0,0,0,11,0,374,90,25210,29307,27640,7,39,8,1,1,2,0,2,331,93,25706,27144,24034,0,43,-3,-496,-1,2163,3606,0,-1,-2,0,9
EUW1_6881712704',3,31,8,0,0,0,0,14,0,332,66,24517,27966,39134,2,175,26,2,0,1,0,2,334,115,33603,33667,43694,0,-2,-49,-9086,-18,-5701,-4560,-2,0,-1,0,12
EUW1_6881484159',3,25,4,1,0,0,0,6,1,411,101,25246,30039,25135,5,35,6,1,0,1,0,4,398,94,24816,30662,20255,0,13,7,430,-2,-623,4880,0,0,-1,0,2
EUW1_6881417518',4,23,8,1,0,0,0,6,1,367,72,24646,28207,26425,8,31,10,0,0,1,0,5,357,76,26795,29008,31153,1,10,-4,-2149,-2,-801,-4728,1,0,-1,0,1
EUW1_6881366610',7,28,18,0,0,0,0,11,0,410,79,29325,33351,41733,0,27,12,1,0,1,0,3,353,104,29172,31574,31367,0,57,-25,153,6,1777,10366,-1,0,-1,0,8
EUW1_6881160828',2,30,16,2,0,3,0,7,1,361,92,32416,32150,37608,1,23,8,0,0,1,0,6,347,66,24021,27521,26418,1,14,26,8395,8,4629,11190,2,0,2,0,1
EUW1_6881105248',3,25,9,1,0,1,0,9,0,338,92,27034,29888,26844,3,22,3,1,0,1,0,6,358,76,23173,27771,19443,1,-20,16,3861,6,2117,7401,0,0,0,0,3
EUW1_6879774908',1,23,18,0,0,1,0,8,1,356,99,30675,31055,34337,2,24,9,1,0,0,0,3,367,80,25534,27617,27136,1,-11,19,5141,9,3438,7201,-1,0,1,0,5
EUW1_6879732495',1,36,11,1,0,1,0,3,1,402,81,27597,30645,27726,4,29,9,1,0,0,0,2,376,95,25722,28730,25264,1,26,-14,1875,2,1915,2462,0,0,1,0,1
EUW1_6879650623',4,25,20,2,0,5,0,7,1,342,93,33727,31752,36422,2,32,7,0,0,0,0,11,324,62,23584,25393,24187,1,18,31,10143,13,6359,12235,2,0,5,0,-4
EUW1_6879615182',6,31,15,2,1,3,0,7,1,353,98,29659,30138,29237,5,25,4,0,0,0,0,7,335,102,22524,28774,24896,1,18,-4,7135,11,1364,4341,2,1,3,0,0
EUW1_6879567393',3,74,13,0,0,0,0,6,0,277,84,26451,28688,32159,4,98,14,2,1,1,0,4,384,79,28360,30308,36071,1,-107,5,-1909,-1,-1620,-3912,-2,-1,-1,0,2
EUW1_6882167973',1,25,13,0,1,1,0,7,0,318,104,27667,30697,35762,3,30,9,2,0,1,0,9,312,84,25834,26901,25424,1,6,20,1833,4,3796,10338,-2,1,0,0,-2
EUW1_6882123172',2,23,8,0,0,1,0,13,0,331,84,25454,27731,35049,5,30,11,2,0,1,0,5,358,87,27361,31401,31200,0,-27,-3,-1907,-3,-3670,3849,-2,0,0,0,8
EUW1_6882067325',3,25,9,1,0,1,0,9,0,315,96,25168,27616,27946,1,19,14,0,0,0,0,5,344,84,25608,31668,36128,1,-29,12,-440,-5,-4052,-8182,1,0,1,0,4
EUW1_6882007091',4,21,14,1,0,1,0,11,1,348,72,27210,29721,26882,2,25,12,1,0,2,0,4,339,92,28335,31026,29359,1,9,-20,-1125,2,-1305,-2477,0,0,-1,0,7
EUW1_6881939435',2,26,14,1,0,0,0,6,1,383,62,26651,32811,39049,4,27,11,0,0,0,0,2,359,84,26481,29613,32404,0,24,-22,170,3,3198,6645,1,0,0,0,4
EUW1_6881783197',3,21,11,2,0,1,0,11,1,325,100,27294,29384,29793,1,88,13,0,0,2,0,4,381,80,29346,30780,31765,0,-56,20,-2052,-2,-1396,-1972,2,0,-1,0,7
EUW1_6881722226',3,22,8,1,0,0,0,3,1,418,95,26477,31111,23335,4,32,6,1,0,0,0,0,391,100,25302,30843,21145,1,27,-5,1175,2,268,2190,0,0,0,0,3
EUW1_6881672761',4,31,10,1,0,0,0,7,1,330,86,25210,27205,31578,1,25,12,0,0,1,0,4,349,94,28440,30699,27862,0,-19,-8,-3230,-2,-3494,3716,1,0,-1,0,3
EUW1_6881630297',3,30,23,0,0,0,0,9,1,359,80,30826,32687,38964,3,26,6,1,0,0,0,4,319,104,23007,27468,20751,1,40,-24,7819,17,5219,18213,-1,0,0,0,5
EUW1_6881586783',1,30,12,2,0,0,0,8,0,428,126,29913,33823,34068,2,24,5,0,0,1,0,8,318,76,23142,26936,22683,1,110,50,6771,7,6887,11385,2,0,-1,0,0
EUW1_6881526819',1,25,13,0,0,0,0,11,0,291,86,26925,27584,35594,3,27,17,1,0,0,0,4,287,90,27582,29774,42268,1,4,-4,-657,-4,-2190,-6674,-1,0,0,0,7
EUW1_6880705149',2,243,14,1,0,1,0,9,1,344,114,29455,33048,37397,4,172,6,1,0,0,0,6,347,78,24247,29168,31143,1,-3,36,5208,8,3880,6254,0,0,1,0,3
EUW1_6880676347',7,25,16,2,0,0,0,3,1,379,89,30123,32105,30872,5,31,6,0,0,0,0,4,346,90,24661,28645,24704,1,33,-1,5462,10,3460,6168,2,0,0,0,-1
EUW1_6880635086',2,24,14,1,0,0,0,7,1,312,90,26971,27507,37690,0,50,14,0,0,1,0,2,368,96,28947,29888,32999,1,-56,-6,-1976,0,-2381,4691,1,0,-1,0,5
EUW1_6880573878',4,23,4,0,1,0,0,5,1,403,90,24161,30198,20790,6,37,4,1,0,0,0,1,377,72,24178,29382,22660,1,26,18,-17,0,816,-1870,-1,1,0,0,4
EUW1_6880514192',3,23,8,0,0,0,0,14,1,361,92,25473,29789,27032,6,26,23,1,1,2,0,2,373,96,32317,34664,34883,0,-12,-4,-6844,-15,-4875,-7851,-1,-1,-2,0,12
EUW1_6880451738',7,28,9,2,0,0,0,6,0,368,101,26630,31071,30136,3,30,7,0,0,1,0,4,367,96,25068,30186,25417,1,1,5,1562,2,885,4719,2,0,-1,0,2
EUW1_6880324776',0,20,13,0,0,1,0,13,1,330,93,28611,30970,36232,5,29,15,1,0,1,0,4,332,76,28403,30793,35954,0,-2,17,208,-2,177,278,-1,0,0,0,9
EUW1_6880254165',3,206,13,1,0,0,0,6,0,350,86,27120,29743,28516,5,27,6,0,0,0,0,1,323,82,23090,26567,30012,1,27,4,4030,7,3176,-1496,1,0,0,0,5
EUW1_6882225620',4,29,10,2,0,0,0,11,1,332,118,25852,29730,27232,4,24,16,0,0,0,0,6,354,74,28595,31107,28994,1,-22,44,-2743,-6,-1377,-1762,2,0,0,0,5
EUW1_6882129185',2,25,7,1,0,0,0,5,0,393,80,24895,32244,33619,4,22,12,0,0,0,0,6,371,84,27138,31689,30689,1,22,-4,-2243,-5,555,2930,1,0,0,0,-1
EUW1_6880273458',4,28,9,1,0,0,0,11,0,327,81,24726,28012,24724,5,282,17,1,0,1,0,1,368,90,30025,31384,34130,0,-41,-9,-5299,-8,-3372,-9406,0,0,-1,0,10
EUW1_6879174826',0,22,7,0,0,0,0,10,1,326,81,23383,27821,26501,3,35,12,1,1,1,0,1,380,82,28328,30916,32336,0,-54,-1,-4945,-5,-3095,-5835,-1,-1,-1,0,9
EUW1_6882887327',6,28,20,1,0,0,0,6,1,342,105,29786,31305,40500,1,41,9,0,0,0,0,5,317,90,24014,27128,28288,1,25,15,5772,11,4177,12212,1,0,0,0,1
EUW1_6881877745',1,18,16,2,0,0,0,11,0,362,80,28192,32526,34980,4,29,15,0,1,2,0,0,349,92,29745,30924,42291,0,13,-12,-1553,1,1602,-7311,2,-1,-2,0,11
EUW1_6881801071',9,33,12,0,0,0,0,8,1,317,52,26261,27094,30369,0,28,15,2,0,1,0,0,374,109,29916,31736,36067,0,-57,-57,-3655,-3,-4642,-5698,-2,0,-1,0,8
EUW1_6881740403',8,156,19,1,1,0,0,8,1,346,90,29456,31447,42022,2,182,9,1,0,0,0,5,351,76,26440,28828,35055,1,-5,14,3016,10,2619,6967,0,1,0,0,3
EUW1_6881635764',2,19,7,1,0,0,0,13,1,336,86,24855,29696,22524,7,30,11,1,1,2,0,1,418,114,29941,32474,30077,0,-82,-28,-5086,-4,-2778,-7553,0,-1,-2,0,12
EUW1_6880564350',4,25,10,2,0,1,0,7,0,342,88,26957,28794,30948,3,29,14,0,0,1,0,5,346,80,27988,28427,28201,1,-4,8,-1031,-4,367,2747,2,0,0,0,2
EUW1_6880531479',0,18,15,0,0,1,0,8,1,325,106,29050,28927,35846,7,24,19,2,0,0,0,1,339,84,29303,29784,40564,0,-14,22,-253,-4,-857,-4718,-2,0,1,0,7
EUW1_6880459764',3,25,10,2,0,1,0,15,1,341,92,27244,27590,26774,4,25,12,0,0,2,0,4,368,84,28804,29713,31793,0,-27,8,-1560,-2,-2123,-5019,2,0,-1,0,11
EUW1_6879188476',4,21,18,1,0,1,0,7,1,384,79,30387,32626,36004,4,26,17,1,0,0,0,3,317,100,26979,30776,29198,1,67,-21,3408,1,1850,6806,0,0,1,0,4
EUW1_6878887458',4,24,11,0,0,0,0,5,0,359,72,27258,28411,35558,4,28,19,1,0,1,0,2,334,75,28264,29610,33883,0,25,-3,-1006,-8,-1199,1675,-1,0,-1,0,3
EUW1_6878830687',2,21,5,0,0,1,0,10,0,335,88,23839,28894,24249,6,52,15,1,0,1,0,6,368,97,29799,32592,35894,0,-33,-9,-5960,-10,-3698,-11645,-1,0,0,0,4
EUW1_6878213434',3,26,11,0,0,1,0,12,0,352,94,27698,30589,24052,3,27,16,2,0,2,0,6,382,77,29046,30185,35102,0,-30,17,-1348,-5,404,-11050,-2,0,-1,0,6
EUW1_6874045380',5,30,15,0,0,0,0,5,1,346,116,28485,31829,34102,2,31,13,1,0,1,0,4,356,80,27384,30271,28952,0,-10,36,1101,2,1558,5150,-1,0,-1,0,1
EUW1_6874020799',7,28,11,1,0,1,0,9,1,352,82,27177,27987,37079,3,24,12,1,0,1,0,6,302,102,26368,30380,28691,1,50,-20,809,-1,-2393,8388,0,0,0,0,3
EUW1_6873982334',1,24,19,0,0,0,0,9,0,318,85,31424,30058,39836,5,48,16,2,0,1,0,4,310,90,27237,25909,33275,1,8,-5,4187,3,4149,6561,-2,0,-1,0,5
EUW1_6873959491',1,38,7,0,0,0,0,12,1,293,67,23306,23936,27419,3,28,17,2,1,1,0,2,355,102,29980,30051,34766,0,-62,-35,-6674,-10,-6115,-7347,-2,-1,-1,0,10
EUW1_6873923616',7,31,10,1,0,1,0,10,1,379,86,26675,29365,29709,4,28,6,0,0,0,0,2,396,78,25127,28304,24143,1,-17,8,1548,4,1061,5566,1,0,1,0,8
EUW1_6873888410',4,47,20,0,0,0,0,6,0,333,90,30368,31854,34153,5,23,10,1,0,0,0,4,331,90,26059,27337,32577,1,2,0,4309,10,4517,1576,-1,0,0,0,2
EUW1_6873861361',6,25,14,0,0,1,0,6,1,352,81,28035,28733,27829,0,28,6,1,0,0,0,5,365,102,24832,29352,26693,1,-13,-21,3203,8,-619,1136,-1,0,1,0,1
EUW1_6882945431',4,25,7,1,0,1,0,7,1,351,64,24747,26816,25136,10,40,15,0,0,0,0,4,366,93,27933,31482,29304,0,-15,-29,-3186,-8,-4666,-4168,1,0,1,0,3
EUW1_6882730814',3,33,9,0,0,0,0,7,0,403,98,27526,29617,32958,4,34,9,2,0,1,0,5,267,88,23630,26814,23826,0,136,10,3896,0,2803,9132,-2,0,-1,0,2
EUW1_6882672237',3,26,7,0,0,0,0,14,0,368,116,28068,31247,25769,3,25,12,2,0,1,0,2,384,87,27612,30884,27946,0,-16,29,456,-5,363,-2177,-2,0,-1,0,12
EUW1_6878242035',3,22,16,1,1,1,0,7,1,368,84,28995,31466,34092,0,32,8,0,0,2,0,7,308,100,26071,28519,25548,1,60,-16,2924,8,2947,8544,1,1,-1,0,0
EUW1_6878117979',5,28,9,2,0,1,0,8,0,357,66,25842,28146,26844,4,30,10,0,0,0,0,5,362,94,26353,29993,30786,1,-5,-28,-511,-1,-1847,-3942,2,0,1,0,3
EUW1_6878003527',5,22,19,1,0,1,0,5,0,321,66,29474,30967,37087,2,30,13,1,0,0,0,4,332,78,27309,28290,32861,0,-11,-12,2165,6,2677,4226,0,0,1,0,1
EUW1_6872784865',4,36,9,1,0,0,0,7,1,353,80,25001,27934,26039,2,25,10,1,1,1,0,2,364,107,26966,31564,26489,0,-11,-27,-1965,-1,-3630,-450,0,-1,-1,0,5
EUW1_6868133305',4,29,10,1,1,0,0,8,0,328,84,25117,29379,34265,3,26,13,1,0,1,0,1,317,85,26558,30259,31430,0,11,-1,-1441,-3,-880,2835,0,1,-1,0,7
EUW1_6868070983',4,18,13,1,0,0,0,8,1,330,60,26446,29419,33939,3,27,12,0,0,0,0,0,364,100,27506,30073,37938,1,-34,-40,-1060,1,-654,-3999,1,0,0,0,8
EUW1_6867885190',3,25,6,1,0,2,0,6,0,388,92,26997,29706,28293,3,23,10,0,0,0,0,9,355,80,25907,29741,26084,1,33,12,1090,-4,-35,2209,1,0,2,0,-3
EUW1_6867840121',5,24,11,0,0,0,0,11,0,356,80,26654,26950,26999,5,31,16,2,0,0,0,2,372,86,28842,29583,41093,0,-16,-6,-2188,-5,-2633,-14094,-2,0,0,0,9
EUW1_6867801715',3,28,13,1,0,0,0,6,1,384,80,28955,31510,34320,3,22,1,0,0,2,0,4,347,100,21999,26914,23911,1,37,-20,6956,12,4596,10409,1,0,-2,0,2
EUW1_6867755956',3,24,9,1,0,1,0,11,0,370,90,25900,30507,26223,1,23,13,1,1,2,0,7,375,86,29162,31110,32540,1,-5,4,-3262,-4,-603,-6317,0,-1,-1,0,4
EUW1_6866820225',7,32,14,0,0,0,0,7,0,338,80,28911,30272,33526,5,148,19,1,0,0,0,1,345,106,28544,33763,37169,1,-7,-26,367,-5,-3491,-3643,-1,0,0,0,6
EUW1_6866665081',4,27,9,0,0,0,0,4,0,362,104,25580,30854,27408,9,20,9,2,0,0,0,2,327,76,23872,29162,24227,1,35,28,1708,0,1692,3181,-2,0,0,0,2
EUW1_6865574747',3,135,5,0,0,0,0,9,1,345,88,22961,28680,21509,1,30,13,1,0,2,0,0,394,84,29062,33155,33310,0,-49,4,-6101,-8,-4475,-11801,-1,0,-2,0,9
EUW1_6863816925',3,22,4,0,0,0,0,10,0,352,84,23106,26788,26544,3,25,13,2,0,1,0,1,388,100,28310,31049,36052,0,-36,-16,-5204,-9,-4261,-9508,-2,0,-1,0,9
EUW1_6863767687',2,41,9,0,0,1,0,7,1,354,85,26151,30206,27230,2,52,10,2,0,1,0,5,364,87,26273,29367,27926,0,-10,-2,-122,-1,839,-696,-2,0,0,0,2
EUW1_6862636223',4,22,13,0,0,0,0,9,0,324,75,26466,28154,36767,7,29,16,2,0,1,0,4,305,96,29418,29670,34859,0,19,-21,-2952,-3,-1516,1908,-2,0,-1,0,5
EUW1_6861271936',4,30,17,2,1,3,0,2,1,362,120,32357,33588,39902,2,23,4,0,0,0,0,9,353,75,22827,26532,21043,1,9,45,9530,13,7056,18859,2,1,3,0,-7
EUW1_6881728753',1,29,10,0,0,1,0,11,0,331,68,26584,26558,32276,7,30,18,2,0,1,0,4,335,87,29029,31292,38922,0,-4,-19,-2445,-8,-4734,-6646,-2,0,0,0,7
EUW1_6879093223',3,28,16,1,0,1,0,8,1,385,100,30907,31571,36897,6,27,8,1,0,1,0,2,330,84,25121,28240,26846,1,55,16,5786,8,3331,10051,0,0,0,0,6
EUW1_6879047582',2,25,16,1,1,1,0,8,1,337,85,31461,28817,40206,3,146,12,0,0,3,0,11,296,52,26319,27049,30805,1,41,33,5142,4,1768,9401,1,1,-2,0,-3
EUW1_6878084309',2,26,2,0,0,0,0,12,0,315,76,20913,25270,19227,2,20,14,2,0,3,0,2,378,114,30649,31797,34138,0,-63,-38,-9736,-12,-6527,-14911,-2,0,-3,0,10
EUW1_6878042277',8,35,9,0,1,1,0,9,0,354,88,27491,30226,24782,5,30,10,1,0,1,0,6,368,80,27431,29097,29876,0,-14,8,60,-1,1129,-5094,-1,1,0,0,3
EUW1_6877115784',3,180,13,2,0,1,0,10,1,397,126,29766,31687,29665,0,22,9,0,0,1,0,4,373,49,26332,28108,24561,1,24,77,3434,4,3579,5104,2,0,0,0,6
EUW1_6875508093',2,27,10,2,0,0,0,8,1,355,118,25890,31755,32841,2,71,2,0,0,2,0,2,372,64,22430,26457,27080,1,-17,54,3460,8,5298,5761,2,0,-2,0,6
EUW1_6875456408',3,27,13,1,0,1,0,5,1,377,88,28664,30044,37041,4,25,11,1,0,0,0,4,303,74,24786,26640,26657,1,74,14,3878,2,3404,10384,0,0,1,0,1
EUW1_6869553276',7,26,14,0,0,0,0,8,0,342,100,28376,29701,38823,5,34,21,1,0,0,0,2,307,72,30256,31468,40281,0,35,28,-1880,-7,-1767,-1458,-1,0,0,0,6
EUW1_6869283053',4,28,7,1,0,0,0,7,1,343,81,24702,26577,26164,0,48,18,1,0,1,0,2,289,97,27847,30072,27683,0,54,-16,-3145,-11,-3495,-1519,0,0,-1,0,5
EUW1_6869273231',3,27,12,1,0,0,0,7,0,332,93,27277,28167,40041,1,25,19,1,0,0,0,2,312,86,28345,29481,33011,1,20,7,-1068,-7,-1314,7030,0,0,0,0,5
EUW1_6869172168',4,28,10,1,0,0,0,15,0,360,74,25797,28997,30238,4,37,19,1,0,0,0,1,337,82,29853,31341,42804,1,23,-8,-4056,-9,-2344,-12566,0,0,0,0,14
EUW1_6869145777',0,29,8,1,0,1,0,11,0,317,87,24777,27126,22161,1,28,12,1,0,1,0,5,342,85,27091,30260,28445,1,-25,2,-2314,-4,-3134,-6284,0,0,0,0,6
EUW1_6883464702',1,42,16,1,0,0,0,16,0,353,90,29030,30982,32951,3,23,27,0,0,2,0,1,350,85,33656,33208,42900,0,3,5,-4626,-11,-2226,-9949,1,0,-2,0,15
EUW1_6883402865',0,25,11,1,0,1,0,15,0,329,68,26878,28357,29917,4,36,15,0,0,1,0,4,348,72,28466,29073,37150,0,-19,-4,-1588,-4,-716,-7233,1,0,0,0,11
EUW1_6883265524',0,18,5,0,0,0,0,10,1,348,55,22284,25337,22226,0,24,14,1,1,3,0,0,384,102,30235,31430,31156,1,-36,-47,-7951,-9,-6093,-8930,-1,-1,-3,0,10
EUW1_6883083880',3,83,22,0,0,1,0,6,1,288,93,31805,29763,38120,6,26,12,1,0,1,0,8,280,86,25301,27120,25824,1,8,7,6504,10,2643,12296,-1,0,0,0,-2
EUW1_6883026742',4,330,11,1,0,0,0,6,1,314,60,26288,26725,30567,2,25,22,1,0,1,0,4,348,96,31804,31531,32331,0,-34,-36,-5516,-11,-4806,-1764,0,0,-1,0,2
EUW1_6882612978',2,149,13,1,0,1,0,9,0,339,78,28618,27823,33384,6,36,15,0,0,1,0,6,298,66,25854,27574,33266,0,41,12,2764,-2,249,118,1,0,0,0,3
EUW1_6882571973',2,26,9,1,0,0,0,7,1,328,76,24873,27832,28581,3,29,11,0,0,1,0,5,333,104,26671,28827,31562,1,-5,-28,-1798,-2,-995,-2981,1,0,-1,0,2
EUW1_6882531314',5,53,13,1,1,0,0,4,1,363,92,27925,30948,27499,1,28,10,1,0,0,0,4,369,100,25808,30390,25558,1,-6,-8,2117,3,558,1941,0,1,0,0,0
EUW1_6882513046',6,30,9,1,1,0,0,6,1,380,83,25364,29664,22784,3,22,8,1,0,1,0,2,387,92,26377,30724,25265,0,-7,-9,-1013,1,-1060,-2481,0,1,-1,0,4
EUW1_6882480744',3,28,9,2,0,0,0,8,1,373,98,26235,30819,22923,5,28,13,0,0,0,0,3,347,106,27945,31596,32643,0,26,-8,-1710,-4,-777,-9720,2,0,0,0,5
EUW1_6882448149',2,23,22,1,0,0,0,4,1,344,92,30122,31781,35086,0,20,10,0,0,0,0,5,343,84,25479,28925,36259,1,1,8,4643,12,2856,-1173,1,0,0,0,-1
EUW1_6882438522',7,26,19,0,1,4,0,3,1,374,104,33027,32028,34406,3,32,7,2,0,1,0,9,288,76,22159,26143,32443,1,86,28,10868,12,5885,1963,-2,1,3,0,-6
EUW1_6882416298',3,22,19,1,0,3,0,5,1,356,92,30508,31240,34668,0,214,7,0,0,0,0,9,328,73,24024,27785,25281,1,28,19,6484,12,3455,9387,1,0,3,0,-4
EUW1_6881767148',5,25,7,0,0,0,0,11,0,271,70,22653,26673,24007,4,26,17,1,0,2,0,1,353,110,29635,31224,36730,0,-82,-40,-6982,-10,-4551,-12723,-1,0,-2,0,10
EUW1_6881173674',2,26,13,1,0,1,0,11,0,307,76,27715,30874,38177,2,36,13,1,0,1,0,6,360,92,26638,29861,29932,0,-53,-16,1077,0,1013,8245,0,0,0,0,5
EUW1_6881131168',3,293,10,0,1,0,0,10,0,354,76,26442,28411,37373,6,32,14,1,0,1,0,4,334,101,28786,30552,32500,0,20,-25,-2344,-4,-2141,4873,-1,1,-1,0,6
EUW1_6881087910',1,27,6,1,0,1,0,8,0,354,104,24611,28213,25261,6,26,9,0,0,0,0,1,328,84,24786,26663,27300,0,26,20,-175,-3,1550,-2039,1,0,1,0,7
EUW1_6883550745',0,133,13,0,0,0,0,7,0,361,76,29381,27940,40997,5,114,15,1,0,1,0,4,336,99,28165,30311,39729,0,25,-23,1216,-2,-2371,1268,-1,0,-1,0,3
EUW1_6883509716',4,25,11,1,0,0,0,6,1,333,86,26586,26427,35190,4,37,21,0,0,2,0,1,325,66,31028,29586,41999,1,8,20,-4442,-10,-3159,-6809,1,0,-2,0,5
EUW1_6883470551',6,37,19,1,0,1,0,8,0,289,97,31015,29181,41427,8,34,17,1,0,0,0,2,284,75,27789,27817,33638,1,5,22,3226,2,1364,7789,0,0,1,0,6
EUW1_6882068001',1,21,14,1,0,0,0,11,1,325,88,26825,30859,32325,2,31,4,1,0,1,0,3,346,114,24424,30198,28380,1,-21,-26,2401,10,661,3945,0,0,-1,0,8
EUW1_6881554665',7,44,5,0,0,0,0,9,0,333,77,22630,28690,23842,4,24,9,1,0,1,0,1,387,102,26681,30943,30513,0,-54,-25,-4051,-4,-2253,-6671,-1,0,-1,0,8
EUW1_6881475711',1,22,15,2,0,2,0,9,1,352,110,30089,31720,42900,6,61,8,0,0,1,0,7,341,66,25157,28567,31473,0,11,44,4932,7,3153,11427,2,0,1,0,2
EUW1_6881408905',1,19,16,2,0,1,0,9,0,319,85,28284,29253,36638,3,34,13,0,0,0,0,4,307,94,26294,27854,40133,1,12,-9,1990,3,1399,-3495,2,0,1,0,5
EUW1_6881181892',0,191,7,2,0,1,0,12,0,348,72,24502,28699,29310,3,34,17,0,0,1,0,0,406,100,31108,32415,31652,0,-58,-28,-6606,-10,-3716,-2342,2,0,0,0,12
EUW1_6881136537',6,35,9,0,0,0,0,15,1,330,89,26479,28904,29347,1,25,14,0,0,3,0,2,406,82,30828,32025,36511,0,-76,7,-4349,-5,-3121,-7164,0,0,-3,0,13
EUW1_6880586078',1,26,8,1,0,0,0,12,0,339,95,24863,29448,26992,4,41,16,1,0,2,0,2,360,80,29646,31791,35069,0,-21,15,-4783,-8,-2343,-8077,0,0,-2,0,10
EUW1_6880525560',1,134,7,0,1,0,0,9,1,357,99,24503,29354,21997,4,79,10,2,0,1,0,1,393,80,27802,31018,29814,0,-36,19,-3299,-3,-1664,-7817,-2,1,-1,0,8
EUW1_6880101173',5,27,14,1,0,1,0,5,1,405,70,28435,31673,37329,2,148,11,0,0,1,0,4,344,61,26382,28763,31214,1,61,9,2053,3,2910,6115,1,0,0,0,1
EUW1_6880039934',4,21,19,0,0,1,0,12,1,348,88,32132,27904,36115,6,35,20,2,0,1,0,4,341,72,30173,27764,36659,1,7,16,1959,-1,140,-544,-2,0,0,0,8
EUW1_6879990110',2,26,11,0,0,0,0,10,0,334,88,26192,26706,29849,3,32,18,2,0,1,0,2,351,103,30594,31839,37942,0,-17,-15,-4402,-7,-5133,-8093,-2,0,-1,0,8
EUW1_6879932331',1,31,15,2,0,1,0,18,1,337,98,28959,31605,38425,3,141,10,0,0,4,0,3,332,90,30059,27928,34442,1,5,8,-1100,5,3677,3983,2,0,-3,0,15
EUW1_6878957494',5,159,15,0,1,1,0,6,1,402,106,29913,32560,34114,0,24,4,2,0,0,0,2,353,105,22941,29610,19763,1,49,1,6972,11,2950,14351,-2,1,1,0,4
EUW1_6878893864',7,32,5,0,1,1,0,7,0,356,108,24744,28902,30027,3,29,8,2,0,1,0,3,372,124,27166,33864,26298,0,-16,-16,-2422,-3,-4962,3729,-2,1,0,0,4
EUW1_6882949770',1,24,15,1,0,1,0,10,0,360,62,28897,29231,38731,3,26,13,1,0,1,0,6,308,98,27990,29101,31660,1,52,-36,907,2,130,7071,0,0,0,0,4
EUW1_6879625257',7,29,19,1,1,1,0,8,1,356,86,30769,32788,35483,5,24,14,0,0,0,0,6,342,98,27821,30478,33943,1,14,-12,2948,5,2310,1540,1,1,1,0,2
EUW1_6878253300',4,22,20,1,0,0,0,10,0,347,98,31608,32358,36783,4,41,13,0,0,1,0,5,337,81,27386,28302,31271,1,10,17,4222,7,4056,5512,1,0,-1,0,5
EUW1_6878150436',5,25,14,1,1,0,0,9,1,307,70,26097,27723,27677,3,24,9,1,0,1,0,4,364,116,27221,31383,32654,0,-57,-46,-1124,5,-3660,-4977,0,1,-1,0,5
EUW1_6877983834',1,23,12,1,0,0,0,4,1,353,68,28142,27677,35989,6,33,20,1,0,1,0,5,308,84,30102,28453,37228,0,45,-16,-1960,-8,-776,-1239,0,0,-1,0,-1
EUW1_6877457743',2,57,13,0,1,2,0,9,0,368,98,30192,30599,28821,0,59,22,1,0,1,0,4,310,74,31019,27888,39148,0,58,24,-827,-9,2711,-10327,-1,1,1,0,5
EUW1_6875350566',2,25,6,1,0,0,0,10,0,290,82,21647,25809,25784,5,27,15,1,0,1,0,1,354,94,29991,31161,32698,0,-64,-12,-8344,-9,-5352,-6914,0,0,-1,0,9
EUW1_6873283039',5,33,8,1,0,0,0,9,0,393,90,25960,29786,28252,3,25,8,0,0,0,0,4,372,93,25257,30626,27224,1,21,-3,703,0,-840,1028,1,0,0,0,5
EUW1_6872977396',7,27,13,2,0,2,0,8,0,398,70,29049,31487,34037,5,27,9,0,1,0,0,6,314,98,24151,31187,26329,1,84,-28,4898,4,300,7708,2,-1,2,0,2
EUW1_6872531909',4,26,10,1,0,1,0,9,0,369,94,26496,30655,31653,3,27,13,1,0,0,0,5,356,97,25764,30486,29385,1,13,-3,732,-3,169,2268,0,0,1,0,4
EUW1_6871970648',3,28,12,2,0,0,0,5,0,361,84,26463,30088,30021,0,43,11,0,0,1,0,2,365,100,27838,29895,30614,0,-4,-16,-1375,1,193,-593,2,0,-1,0,3
EUW1_6871645917',3,30,11,1,0,0,0,8,1,355,104,27340,29635,31300,4,36,8,1,0,0,0,1,368,104,26683,29935,25717,0,-13,0,657,3,-300,5583,0,0,0,0,7
EUW1_6871186888',2,33,12,1,0,0,0,9,0,362,76,26186,29713,29692,5,28,7,1,0,1,0,4,315,72,24280,26741,25499,1,47,4,1906,5,2972,4193,0,0,-1,0,5
EUW1_6871141160',2,31,11,0,0,1,0,6,0,382,54,27048,30901,31023,3,31,20,1,0,0,0,4,364,94,30616,32971,37795,0,18,-40,-3568,-9,-2070,-6772,-1,0,1,0,2
EUW1_6871112054',6,41,4,0,0,0,0,10,1,407,102,25452,31195,19727,4,24,5,2,0,1,0,5,393,102,25834,30567,20881,0,14,0,-382,-1,628,-1154,-2,0,-1,0,5
EUW1_6870048557',4,23,15,2,0,0,0,10,1,310,92,28460,26292,39982,0,30,18,0,0,1,0,5,321,84,29073,31134,35525,0,-11,8,-613,-3,-4842,4457,2,0,-1,0,5
EUW1_6869955694',4,28,11,1,0,0,0,6,0,371,74,26252,30174,32681,7,31,13,0,0,0,0,1,377,74,27509,29911,36839,0,-6,0,-1257,-2,263,-4158,1,0,0,0,5
EUW1_6869735823',2,25,11,0,0,0,0,5,1,342,88,26034,28608,29622,1,20,16,2,0,0,0,1,303,99,27501,30619,32758,0,39,-11,-1467,-5,-2011,-3136,-2,0,0,0,4
EUW1_6869673394',3,29,15,1,0,1,0,7,0,425,86,29635,31888,36569,3,332,4,1,0,0,0,3,338,90,22566,28461,28038,1,87,-4,7069,11,3427,8531,0,0,1,0,4
EUW1_6881853803',5,26,15,1,0,0,0,8,1,338,92,27285,29599,31328,6,142,12,0,0,1,0,3,350,75,27726,30164,36609,1,-12,17,-441,3,-565,-5281,1,0,-1,0,5
EUW1_6881788763',3,145,10,0,1,1,0,12,0,297,89,26591,27597,39024,2,27,25,2,0,1,0,5,304,105,31428,32843,47363,0,-7,-16,-4837,-15,-5246,-8339,-2,1,0,0,7
EUW1_6881714436',6,29,8,1,0,1,0,12,0,349,76,25262,28490,32455,2,31,12,0,0,2,0,4,360,96,28972,30600,28016,0,-11,-20,-3710,-4,-2110,4439,1,0,-1,0,8
EUW1_6881641994',4,32,11,1,1,0,0,9,0,329,96,26659,29855,32736,2,234,13,1,0,1,0,4,357,65,27195,29001,32156,1,-28,31,-536,-2,854,580,0,1,-1,0,5
EUW1_6881560931',3,18,11,0,0,0,0,9,1,361,70,25929,28876,20467,6,28,12,2,0,0,0,4,319,98,27003,28825,35139,0,42,-28,-1074,-1,51,-14672,-2,0,0,0,5
EUW1_6881464770',8,42,15,0,0,0,0,8,0,394,88,29512,33677,33546,2,21,10,1,0,0,0,2,376,80,26406,28771,34024,0,18,8,3106,5,4906,-478,-1,0,0,0,6
EUW1_6879893263',5,38,17,2,0,1,0,7,1,330,90,28764,29193,30463,5,28,7,0,1,1,0,3,377,86,25616,27153,28054,1,-47,4,3148,10,2040,2409,2,-1,0,0,4
EUW1_6879844788',0,25,13,0,0,1,0,16,0,319,86,27604,29310,36152,4,22,20,2,0,3,0,2,356,98,31991,33017,35218,0,-37,-12,-4387,-7,-3707,934,-2,0,-2,0,14
EUW1_6878956068',4,34,9,1,1,1,0,8,0,400,76,26896,32308,26295,5,25,7,1,0,0,0,5,400,115,25742,30581,26496,1,0,-39,1154,2,1727,-201,0,1,1,0,3
EUW1_6878877328',5,29,14,0,0,0,0,5,1,347,78,27083,29361,35258,1,42,17,0,0,0,0,4,302,86,27309,31021,34293,1,45,-8,-226,-3,-1660,965,0,0,0,0,1
EUW1_6878823866',6,28,10,1,1,1,0,11,1,383,72,27419,29765,28808,2,26,5,0,0,0,0,2,356,86,22800,27998,21848,1,27,-14,4619,5,1767,6960,1,1,1,0,9
EUW1_6878761403',7,27,16,0,0,0,0,3,0,328,66,27916,27637,42315,1,26,19,2,0,1,0,5,344,76,29990,31269,36218,0,-16,-10,-2074,-3,-3632,6097,-2,0,-1,0,-2
EUW1_6878707094',3,28,8,1,0,0,0,6,1,341,84,25033,27732,28638,2,90,11,0,0,0,0,3,344,72,25952,30849,26800,0,-3,12,-919,-3,-3117,1838,1,0,0,0,3
EUW1_6878659824',3,137,7,1,0,1,0,6,1,382,88,25687,29219,30401,5,36,11,1,0,1,0,5,354,90,26253,30131,26490,1,28,-2,-566,-4,-912,3911,0,0,0,0,1
EUW1_6878608487',3,22,12,0,0,0,0,3,0,383,68,27560,29699,29930,5,38,6,2,0,0,0,1,375,104,24041,28730,21241,1,8,-36,3519,6,969,8689,-2,0,0,0,2
EUW1_6878551816',5,20,11,0,1,0,0,7,0,315,74,24561,28992,28393,2,22,10,2,0,0,0,0,342,106,26420,31341,34164,1,-27,-32,-1859,1,-2349,-5771,-2,1,0,0,7
EUW1_6878503829',1,23,15,1,0,3,0,12,0,355,94,30139,29749,33326,1,306,15,1,0,1,0,5,342,77,28734,29407,24061,0,13,17,1405,0,342,9265,0,0,2,0,7
EUW1_6878444190',7,29,15,1,0,1,0,7,1,326,62,28077,29028,33239,1,21,11,1,1,0,0,3,345,105,27557,29940,31246,1,-19,-43,520,4,-912,1993,0,-1,1,0,4
EUW1_6882539238',5,24,13,0,0,0,0,8,0,401,90,28264,30623,30874,8,28,6,1,0,1,0,2,330,108,23972,29318,22087,1,71,-18,4292,7,1305,8787,-1,0,-1,0,6
EUW1_6882523813',7,27,16,1,0,3,0,6,1,390,104,32864,31400,30492,3,235,3,1,0,1,0,10,311,72,21885,26679,16090,1,79,32,10979,13,4721,14402,0,0,2,0,-4
EUW1_6882136684',5,26,8,0,0,0,0,10,0,359,78,24850,28680,28965,6,34,13,2,0,0,0,1,318,85,26010,30372,29688,1,41,-7,-1160,-5,-1692,-723,-2,0,0,0,9
EUW1_6882088160',6,27,13,2,0,0,0,7,1,341,91,27032,30212,33280,2,24,9,0,0,1,0,6,362,92,25970,30566,33469,1,-21,-1,1062,4,-354,-189,2,0,-1,0,1
EUW1_6881458873',4,48,9,0,1,0,0,12,0,354,100,25870,29655,23724,5,33,12,2,0,1,0,2,375,88,28062,31133,31152,1,-21,12,-2192,-3,-1478,-7428,-2,1,-1,0,10
EUW1_6881262820',1,36,5,0,0,0,0,10,0,306,64,21720,26603,24352,1,17,21,2,0,1,0,1,374,111,29818,31188,34537,0,-68,-47,-8098,-16,-4585,-10185,-2,0,-1,0,9
EUW1_6881217979',4,22,20,1,0,4,0,7,1,374,97,33241,33083,34403,4,19,6,0,0,0,0,9,271,58,22435,25951,27779,1,103,39,10806,14,7132,6624,1,0,4,0,-2
EUW1_6880570747',4,27,18,1,0,1,0,17,0,335,84,30163,30336,30191,5,25,22,0,0,3,0,2,358,96,33706,32703,39681,1,-23,-12,-3543,-4,-2367,-9490,1,0,-2,0,15
EUW1_6878157322',7,32,12,1,0,0,0,12,1,347,88,28115,28472,24665,3,223,10,1,1,2,0,6,349,83,27171,29849,28087,1,-2,5,944,2,-1377,-3422,0,-1,-2,0,6
EUW1_6877613407',6,228,14,1,0,1,0,9,1,358,74,28409,29955,33796,4,28,11,1,0,1,0,5,312,76,25902,27527,30106,0,46,-2,2507,3,2428,3690,0,0,0,0,4
EUW1_6881990056',3,138,16,1,0,2,0,3,1,382,86,31363,30835,34745,3,26,5,1,0,0,0,8,328,82,22766,24912,25585,1,54,4,8597,11,5923,9160,0,0,2,0,-5
EUW1_6881924020',5,24,11,0,0,0,0,2,0,347,92,25862,29281,29897,2,25,11,1,0,0,0,3,360,84,26177,30061,32609,0,-13,8,-315,0,-780,-2712,-1,0,0,0,-1
EUW1_6880991900',3,25,20,1,0,0,0,7,1,330,62,29626,29472,39140,2,25,15,1,0,0,0,5,346,102,29656,30969,36078,1,-16,-40,-30,5,-1497,3062,0,0,0,0,2
EUW1_6880962955',5,30,14,2,0,0,0,8,0,351,73,27350,29405,32702,5,22,8,0,0,1,0,5,345,62,25132,26646,36814,1,6,11,2218,6,2759,-4112,2,0,-1,0,3
EUW1_6879861365',7,145,6,2,1,1,0,7,0,371,115,26658,29479,27776,6,29,10,0,0,0,0,9,356,84,26188,30026,24003,1,15,31,470,-4,-547,3773,2,1,1,0,-2
EUW1_6878160512',1,27,4,0,0,1,0,14,0,373,101,25001,28839,22859,3,25,15,2,0,1,0,0,383,94,28987,33416,33093,0,-10,7,-3986,-11,-4577,-10234,-2,0,0,0,14
EUW1_6878082396',5,21,11,2,0,0,0,6,1,344,98,25696,29894,33235,4,25,10,0,0,1,0,3,350,85,26764,29914,31761,1,-6,13,-1068,1,-20,1474,2,0,-1,0,3
EUW1_6877141661',2,22,5,0,0,0,0,11,0,357,85,23125,28584,28487,3,28,9,2,0,0,0,0,313,92,25273,29074,28202,1,44,-7,-2148,-4,-490,285,-2,0,0,0,11
EUW1_6876555504',4,25,7,1,0,1,0,9,0,300,88,25722,26547,23340,7,32,11,0,0,0,0,4,337,92,25583,27333,32369,0,-37,-4,139,-4,-786,-9029,1,0,1,0,5
EUW1_6876522374',2,29,8,0,0,0,0,8,0,332,82,24774,28458,27551,3,26,9,1,0,0,0,1,341,88,25390,27851,28011,1,-9,-6,-616,-1,607,-460,-1,0,0,0,7
EUW1_6876512808',6,29,13,0,0,0,0,8,1,388,69,27238,29619,32819,3,22,8,2,0,0,0,4,376,94,27020,29254,24888,0,12,-25,218,5,365,7931,-2,0,0,0,4
EUW1_6876501506',7,41,5,1,0,0,0,6,1,351,73,22986,26764,23560,5,33,10,1,1,0,0,1,375,93,25841,30393,27387,0,-24,-20,-2855,-5,-3629,-3827,0,-1,0,0,5
EUW1_6876486835',3,38,21,0,0,2,0,5,1,362,72,32067,29293,38419,4,28,10,1,0,0,0,8,259,72,24532,26700,31181,1,103,0,7535,11,2593,7238,-1,0,2,0,-3
EUW1_6875263010',1,23,13,0,0,1,0,10,0,370,81,27122,31605,35255,5,26,11,1,0,0,0,4,335,86,26272,28555,36271,0,35,-5,850,2,3050,-1016,-1,0,1,0,6
EUW1_6878299261',3,23,12,0,0,0,0,4,0,295,102,25835,28823,32460,5,37,9,1,0,0,0,2,311,80,24487,26604,27138,1,-16,22,1348,3,2219,5322,-1,0,0,0,2
EUW1_6879505457',2,22,19,1,0,1,0,8,0,328,94,30581,30875,34242,3,31,15,0,0,0,0,2,380,66,27894,28320,35179,1,-52,28,2687,4,2555,-937,1,0,1,0,6
EUW1_6878138365',2,29,6,1,0,0,0,10,1,296,104,24106,26066,22454,3,23,11,1,1,2,0,3,377,91,26816,29630,24422,1,-81,13,-2710,-5,-3564,-1968,0,-1,-2,0,7
EUW1_6878116636',7,35,12,0,0,0,0,10,0,322,74,25640,26019,31947,8,34,23,1,1,0,0,2,371,113,32805,33287,42191,0,-49,-39,-7165,-11,-7268,-10244,-1,-1,0,0,8
EUW1_6878078533',4,74,21,0,0,0,0,3,0,338,67,30195,30021,41766,5,28,13,1,0,1,0,7,292,72,25966,25467,34422,1,46,-5,4229,8,4554,7344,-1,0,-1,0,-4
EUW1_6876694671',5,82,14,2,0,1,0,9,0,309,92,26547,27681,28353,1,19,11,0,0,2,0,4,393,87,29182,31370,25176,0,-84,5,-2635,3,-3689,3177,2,0,-1,0,5
EUW1_6875813305',2,21,15,0,1,0,0,11,0,345,78,27967,30366,32128,2,27,14,1,0,0,0,2,341,92,26950,29623,29552,0,4,-14,1017,1,743,2576,-1,1,0,0,9
EUW1_6875766679',2,57,15,0,0,1,0,7,0,315,92,28452,30674,33176,0,54,14,2,0,0,0,4,324,100,27514,29804,33888,1,-9,-8,938,1,870,-712,-2,0,1,0,3
EUW1_6874664711',4,28,9,0,0,0,0,5,1,335,106,24945,29836,28821,2,142,6,1,0,0,0,3,337,84,23234,29349,19392,1,-2,22,1711,3,487,9429,-1,0,0,0,2
EUW1_6873391526',5,29,11,1,0,0,0,10,0,358,79,26815,29636,31835,2,27,15,1,0,1,0,0,376,70,28297,29043,32771,1,-18,9,-1482,-4,593,-936,0,0,-1,0,10
EUW1_6873313834',6,29,11,1,0,0,0,7,0,334,85,26317,29805,27049,2,25,15,1,0,0,0,5,331,96,26707,30728,32390,1,3,-11,-390,-4,-923,-5341,0,0,0,0,2
EUW1_6855216142',1,26,11,0,0,0,0,8,0,348,89,27743,29392,29432,2,27,23,1,0,1,0,3,338,102,31797,33089,39238,0,10,-13,-4054,-12,-3697,-9806,-1,0,-1,0,5
EUW1_6855164746',4,143,14,1,0,0,0,4,1,297,76,25282,27474,33649,1,22,15,1,0,0,0,3,305,104,27332,28492,32681,0,-8,-28,-2050,-1,-1018,968,0,0,0,0,1
EUW1_6854835448',4,141,16,1,0,0,0,12,1,322,90,30155,28216,36540,7,23,15,0,0,1,0,3,337,86,29064,29829,32492,1,-15,4,1091,1,-1613,4048,1,0,-1,0,9
EUW1_6852583259',2,41,12,1,0,0,0,11,1,301,82,26665,27414,36754,4,30,13,1,0,2,0,2,350,73,28709,28829,32958,1,-49,9,-2044,-1,-1415,3796,0,0,-2,0,9
EUW1_6852350973',3,23,6,1,0,0,0,5,1,308,96,24031,27418,28853,1,23,10,1,0,1,0,2,324,80,25886,28390,23110,1,-16,16,-1855,-4,-972,5743,0,0,-1,0,3
EUW1_6881022066',1,24,8,1,0,0,0,16,0,378,88,25287,28917,21007,4,249,14,1,0,4,0,2,345,76,29900,30940,36072,0,33,12,-4613,-6,-2023,-15065,0,0,-4,0,14
EUW1_6880978732',6,140,12,0,1,0,0,6,0,322,88,26657,29263,28882,9,32,13,2,0,0,0,0,369,88,27881,29536,30699,0,-47,0,-1224,-1,-273,-1817,-2,1,0,0,6
EUW1_6880926221',6,31,8,1,0,0,0,6,0,326,84,23473,28411,23170,4,29,11,0,0,0,0,1,364,72,25642,29918,28109,1,-38,12,-2169,-3,-1507,-4939,1,0,0,0,5
EUW1_6879889785',5,147,18,1,0,0,0,8,0,349,100,29503,33393,36151,8,32,10,1,1,0,0,5,345,84,26895,29629,32990,1,4,16,2608,8,3764,3161,0,-1,0,0,3
EUW1_6879824077',4,20,14,1,0,1,0,9,1,377,90,29202,30776,32300,7,59,7,0,0,1,0,5,332,78,25242,26121,34845,0,45,12,3960,7,4655,-2545,1,0,0,0,4
EUW1_6879777291',2,28,6,0,0,0,0,11,0,389,96,24070,29855,20681,5,28,7,2,1,3,0,2,382,100,27753,30242,26295,0,7,-4,-3683,-1,-387,-5614,-2,-1,-3,0,9
EUW1_6879616067',3,17,12,0,0,0,0,12,0,341,80,27037,29936,28744,1,19,13,1,0,0,0,4,384,80,28237,29536,32101,0,-43,0,-1200,-1,400,-3357,-1,0,0,0,8
EUW1_6879569364',3,25,9,1,1,4,0,10,1,378,89,29404,28808,23351,5,26,5,1,0,0,0,8,308,97,22866,26380,18317,1,70,-8,6538,4,2428,5034,0,1,4,0,2
EUW1_6879498221',5,35,8,0,0,1,0,9,0,392,71,26259,30121,23123,1,128,5,1,0,0,0,6,342,104,23135,29180,20583,1,50,-33,3124,3,941,2540,-1,0,1,0,3
EUW1_6879480460',5,39,11,2,0,0,0,8,0,340,92,26426,30904,29226,6,89,11,0,0,0,0,1,345,100,26379,30942,30549,1,-5,-8,47,0,-38,-1323,2,0,0,0,7
EUW1_6879449466',5,28,4,1,0,0,0,5,0,326,110,22639,28518,24070,7,28,11,1,0,0,0,0,391,86,26825,30546,25437,0,-65,24,-4186,-7,-2028,-1367,0,0,0,0,5
EUW1_6883497799',4,27,14,0,0,2,0,10,1,363,94,28948,32230,31990,1,23,14,2,0,0,0,4,343,94,27817,31571,35903,1,20,0,1131,0,659,-3913,-2,0,2,0,6
EUW1_6883431518',2,26,12,0,0,1,0,6,0,356,87,27204,29463,29780,3,171,5,1,0,0,0,2,334,72,22528,25854,18977,0,22,15,4676,7,3609,10803,-1,0,1,0,4
EUW1_6883336303',6,30,14,2,0,0,0,5,0,330,106,27481,29710,38988,2,30,8,0,0,0,0,8,306,78,23133,26457,23025,1,24,28,4348,6,3253,15963,2,0,0,0,-3
EUW1_6882910441',5,19,13,0,1,0,0,9,1,366,92,26961,31585,37594,1,29,10,2,0,1,0,0,334,108,26631,29378,25711,1,32,-16,330,3,2207,11883,-2,1,-1,0,9
EUW1_6882869851',3,25,9,0,0,1,0,12,1,341,94,27138,28578,24710,2,28,16,2,0,1,0,8,352,110,29967,31701,27763,0,-11,-16,-2829,-7,-3123,-3053,-2,0,0,0,4
EUW1_6882815204',9,28,14,1,1,3,0,13,1,375,104,31119,30028,31193,2,27,6,1,0,0,0,9,375,84,24304,28245,22881,1,0,20,6815,8,1783,8312,0,1,3,0,4
EUW1_6882753380',2,29,14,1,0,1,0,11,1,317,96,27220,29950,30051,2,25,10,0,0,0,0,0,326,80,25048,29461,29202,0,-9,16,2172,4,489,849,1,0,1,0,11
EUW1_6882608935',2,62,13,2,0,1,0,10,0,283,96,26454,29354,27156,2,115,8,0,0,2,0,3,365,62,25564,27187,29332,0,-82,34,890,5,2167,-2176,2,0,-1,0,7
EUW1_6882367259',3,28,10,1,0,0,0,8,0,349,88,25838,29004,22638,4,22,10,1,0,1,0,2,357,112,27212,29817,21307,1,-8,-24,-1374,0,-813,1331,0,0,-1,0,6
EUW1_6881448809',3,27,20,1,1,2,0,6,1,370,108,32345,32108,36923,5,29,11,1,0,0,0,7,320,71,25327,27565,25629,1,50,37,7018,9,4543,11294,0,1,2,0,-1
EUW1_6881402810',2,30,18,1,0,0,0,12,0,275,80,28599,28754,37070,0,105,18,1,0,1,0,5,308,59,29782,28954,42525,0,-33,21,-1183,0,-200,-5455,0,0,-1,0,7
EUW1_6880717651',1,26,17,2,0,1,0,11,1,318,64,28326,29499,35571,1,16,11,0,0,2,0,4,333,115,27287,30537,27846,0,-15,-51,1039,6,-1038,7725,2,0,-1,0,7
EUW1_6880681063',6,29,10,1,0,0,0,7,0,377,97,25969,29275,32679,1,24,11,1,1,0,0,1,375,82,25809,29984,29687,1,2,15,160,-1,-709,2992,0,-1,0,0,6
EUW1_6880646502',7,30,11,0,0,1,0,8,0,296,78,26800,29078,34432,2,31,14,0,0,0,0,3,352,80,27146,29031,31116,1,-56,-2,-346,-3,47,3316,0,0,1,0,5
EUW1_6880601977',0,19,10,0,0,0,0,11,0,364,74,26121,28907,22179,2,25,16,2,0,2,0,3,353,108,30084,30809,31675,0,11,-34,-3963,-6,-1902,-9496,-2,0,-2,0,8
EUW1_6879151417',1,20,7,1,0,0,0,9,1,357,85,24111,29157,26578,1,49,13,0,1,0,0,3,362,92,26872,32245,35589,1,-5,-7,-2761,-6,-3088,-9011,1,-1,0,0,6
EUW1_6879104972',3,65,17,1,0,0,0,9,1,354,86,28392,32362,33099,0,75,8,1,0,0,0,4,339,78,24599,28331,30729,0,15,8,3793,9,4031,2370,0,0,0,0,5
EUW1_6879062849',0,27,1,1,0,0,0,5,0,282,106,20370,24223,19403,6,37,10,1,0,0,0,0,370,102,26134,30760,22845,0,-88,4,-5764,-9,-6537,-3442,0,0,0,0,5
EUW1_6878994449',4,29,5,0,0,0,0,4,0,323,96,23338,28711,23464,2,25,9,1,0,1,0,2,365,80,25169,30857,29694,0,-42,16,-1831,-4,-2146,-6230,-1,0,-1,0,2
EUW1_6878933095',1,25,16,1,1,1,0,11,0,300,94,27865,28546,30793,5,31,18,1,0,1,0,4,342,81,30528,29566,36545,0,-42,13,-2663,-2,-1020,-5752,0,1,0,0,7
EUW1_6883217488',4,27,15,0,0,1,0,9,0,364,60,27235,28762,33904,1,40,23,2,0,2,0,2,341,74,31761,30573,42858,0,23,-14,-4526,-8,-1811,-8954,-2,0,-1,0,7
EUW1_6883129810',5,31,13,1,0,1,0,2,1,384,104,28928,32025,34441,5,26,10,0,0,0,0,5,329,79,25466,29127,23741,1,55,25,3462,3,2898,10700,1,0,1,0,-3
